iteration,job object,job ID,job Length,job ressource requirement,job enter time,job start time,job finish time,job waiting time,current time
1,<environment.Job instance at 0x7efbe4b69aa0>,1,22,[11  3],2,-1,24,-1,2
1,<environment.Job instance at 0x7efbe4b69910>,2,22,[4 8],3,-1,25,-1,3
1,<environment.Job instance at 0x7efbdb584690>,9,18,[11  5],10,-1,28,-1,10
1,<environment.Job instance at 0x7efbdb584820>,11,15,[4 8],12,-1,27,-1,12
1,<environment.Job instance at 0x7efbdb584910>,12,26,[ 1 10],13,-1,39,-1,13
1,<environment.Job instance at 0x7efbdb5848c0>,13,18,[ 4 10],14,-1,32,-1,14
1,<environment.Job instance at 0x7efbdb584aa0>,15,18,[2 8],16,-1,34,-1,16
1,<environment.Job instance at 0x7efbdb584be0>,16,16,[3 5],17,-1,33,-1,17
1,<environment.Job instance at 0x7efbdb584e10>,19,14,[3 5],20,-1,34,-1,20
1,<environment.Job instance at 0x7efbdb587230>,23,27,[1 6],24,-1,51,-1,24
1,<environment.Job instance at 0x7efbdb5872d0>,24,18,[2 6],25,-1,43,-1,25
1,<environment.Job instance at 0x7efbdb587500>,26,3,[3 7],27,-1,30,-1,27
1,<environment.Job instance at 0x7efbdb587690>,27,15,[8 4],28,-1,43,-1,28
1,<environment.Job instance at 0x7efbdb587410>,28,23,[10  4],29,-1,52,-1,29
1,<environment.Job instance at 0x7efbdb587780>,29,12,[5 4],30,-1,42,-1,30
1,<environment.Job instance at 0x7efbdb587820>,30,14,[5 2],31,-1,45,-1,31
1,<environment.Job instance at 0x7efbdb5878c0>,31,14,[2 5],32,-1,46,-1,32
1,<environment.Job instance at 0x7efbdb587b90>,34,24,[1 8],35,-1,59,-1,35
1,<environment.Job instance at 0x7efbdb587d20>,35,15,[9 5],36,-1,51,-1,36
1,<environment.Job instance at 0x7efbdb589140>,40,15,[10  3],41,-1,59,-1,44
1,<environment.Job instance at 0x7efbdb589320>,43,18,[5 5],44,-1,63,-1,45
1,<environment.Job instance at 0x7efbdb584550>,1,22,[11  3],2,-1,24,-1,2
1,<environment.Job instance at 0x7efbdb5870a0>,9,18,[11  5],10,-1,32,-1,14
1,<environment.Job instance at 0x7efbdb589f50>,12,26,[ 1 10],13,-1,82,-1,56
1,<environment.Job instance at 0x7efbdb58c640>,23,27,[1 6],24,-1,87,-1,60
1,<environment.Job instance at 0x7efbdb58c960>,28,23,[10  4],29,-1,97,-1,74
1,<environment.Job instance at 0x7efbdb58cfa0>,34,24,[1 8],35,-1,117,-1,93
1,<environment.Job instance at 0x7efbdb58ce60>,36,13,[ 3 14],37,-1,106,-1,93
1,<environment.Job instance at 0x7efbdb58e730>,46,17,[12  2],47,-1,134,-1,117
1,<environment.Job instance at 0x7efbdacc54b0>,3,17,[5 7],4,-1,21,-1,4
1,<environment.Job instance at 0x7efbdaca4460>,6,17,[8 5],7,-1,25,-1,8
1,<environment.Job instance at 0x7efbdacbf2d0>,9,17,[1 6],10,-1,27,-1,10
1,<environment.Job instance at 0x7efbdadd7050>,14,18,[2 9],15,-1,33,-1,15
1,<environment.Job instance at 0x7efbdacbfc80>,15,20,[2 6],16,-1,36,-1,16
1,<environment.Job instance at 0x7efbdada5320>,17,27,[ 1 10],18,-1,45,-1,18
1,<environment.Job instance at 0x7efbdb589e10>,19,13,[ 3 12],20,-1,33,-1,20
1,<environment.Job instance at 0x7efbdada2280>,28,12,[10  2],29,-1,46,-1,34
1,<environment.Job instance at 0x7efbdada2e60>,29,13,[9 4],30,-1,47,-1,34
1,<environment.Job instance at 0x7efbdada2f00>,26,19,[4 8],27,-1,53,-1,34
1,<environment.Job instance at 0x7efbdaca4e10>,7,18,[2 8],8,-1,52,-1,34
1,<environment.Job instance at 0x7efbdae2d3c0>,30,14,[2 6],31,-1,48,-1,34
1,<environment.Job instance at 0x7efbdae53410>,31,15,[5 9],32,-1,49,-1,34
1,<environment.Job instance at 0x7efbdae53eb0>,32,16,[ 4 10],33,-1,50,-1,34
1,<environment.Job instance at 0x7efbdaddfaa0>,33,20,[7 1],34,-1,56,-1,36
1,<environment.Job instance at 0x7efbdae03960>,36,18,[9 2],37,-1,55,-1,37
1,<environment.Job instance at 0x7efbdae03730>,34,18,[3 7],35,-1,55,-1,37
1,<environment.Job instance at 0x7efbdaddfb90>,35,17,[3 9],36,-1,65,-1,48
1,<environment.Job instance at 0x7efbdab453c0>,0,16,[12  2],1,-1,17,-1,1
1,<environment.Job instance at 0x7efbdb58e550>,4,13,[13  1],5,-1,18,-1,5
1,<environment.Job instance at 0x7efbdb58e370>,10,3,[12  3],11,-1,14,-1,11
1,<environment.Job instance at 0x7efbdb58ce10>,17,27,[ 1 10],18,-1,54,-1,27
1,<environment.Job instance at 0x7efbdb58cd70>,19,13,[ 3 12],20,-1,40,-1,27
1,<environment.Job instance at 0x7efbdb58c640>,25,14,[ 4 11],26,-1,47,-1,33
1,<environment.Job instance at 0x7efbdad1e230>,47,2,[ 5 11],48,-1,127,-1,125
1,<environment.Job instance at 0x7efbdab85c30>,0,18,[2 7],1,-1,19,-1,1
1,<environment.Job instance at 0x7efbdab85be0>,1,18,[ 1 10],2,-1,22,-1,4
1,<environment.Job instance at 0x7efbdab85c80>,2,16,[3 9],3,-1,21,-1,5
1,<environment.Job instance at 0x7efbdab85500>,4,15,[1 9],5,-1,21,-1,6
1,<environment.Job instance at 0x7efbdab85dc0>,7,17,[9 3],8,-1,25,-1,8
1,<environment.Job instance at 0x7efbdab85960>,15,16,[7 5],16,-1,32,-1,16
1,<environment.Job instance at 0x7efbdab855f0>,5,14,[14  5],6,-1,40,-1,26
1,<environment.Job instance at 0x7efbdab7a190>,28,23,[ 2 14],29,-1,54,-1,31
1,<environment.Job instance at 0x7efbdab78f00>,23,12,[ 4 11],24,-1,43,-1,31
1,<environment.Job instance at 0x7efbdab78230>,25,21,[4 5],26,-1,54,-1,33
1,<environment.Job instance at 0x7efbdab7af00>,32,13,[ 5 10],33,-1,46,-1,33
1,<environment.Job instance at 0x7efbdab7acd0>,30,15,[8 3],31,-1,48,-1,33
1,<environment.Job instance at 0x7efbdab7afa0>,33,16,[ 3 10],34,-1,52,-1,36
1,<environment.Job instance at 0x7efbdabb23c0>,37,20,[9 2],38,-1,58,-1,38
1,<environment.Job instance at 0x7efbdab7ad20>,35,14,[ 2 10],36,-1,60,-1,46
1,<environment.Job instance at 0x7efbdabc3b90>,38,16,[11  2],39,-1,62,-1,46
1,<environment.Job instance at 0x7efbdab7a280>,27,22,[4 5],28,-1,69,-1,47
1,<environment.Job instance at 0x7efbdab70f00>,46,17,[1 7],47,-1,65,-1,48
1,<environment.Job instance at 0x7efbdab7aaf0>,5,14,[14  5],6,-1,20,-1,6
1,<environment.Job instance at 0x7efbdab85a50>,6,15,[11  1],7,-1,22,-1,7
1,<environment.Job instance at 0x7efbdab70a00>,16,3,[ 1 12],17,-1,38,-1,35
1,<environment.Job instance at 0x7efbdab6d640>,22,3,[ 4 12],23,-1,49,-1,46
1,<environment.Job instance at 0x7efbdab6d460>,23,12,[ 4 11],24,-1,58,-1,46
1,<environment.Job instance at 0x7efbdab6d5a0>,28,23,[ 2 14],29,-1,74,-1,51
1,<environment.Job instance at 0x7efbdab40e10>,11,26,[ 5 10],12,-1,77,-1,51
1,<environment.Job instance at 0x7efbdab69cd0>,38,16,[11  2],39,-1,95,-1,79
1,<environment.Job instance at 0x7efbdab69370>,39,18,[ 1 12],40,-1,97,-1,79
1,<environment.Job instance at 0x7efbdab69230>,43,15,[ 1 12],44,-1,102,-1,87
1,<environment.Job instance at 0x7efbdab69320>,45,3,[ 4 13],46,-1,93,-1,90
1,<environment.Job instance at 0x7efbdab65dc0>,47,1,[ 1 14],48,-1,93,-1,92
1,<environment.Job instance at 0x7efbdac6b0a0>,1,15,[10  4],2,-1,18,-1,3
1,<environment.Job instance at 0x7efbdac6b7d0>,4,14,[8 4],5,-1,19,-1,5
1,<environment.Job instance at 0x7efbdb24e0f0>,8,14,[9 5],9,-1,23,-1,9
1,<environment.Job instance at 0x7efbdb1d6370>,11,15,[1 7],12,-1,27,-1,12
1,<environment.Job instance at 0x7efbdb23b320>,13,15,[5 2],14,-1,29,-1,14
1,<environment.Job instance at 0x7efbdb5875f0>,2,14,[1 8],3,-1,30,-1,16
1,<environment.Job instance at 0x7efbdac62e60>,23,18,[6 5],24,-1,42,-1,24
1,<environment.Job instance at 0x7efbdb0b5820>,24,19,[6 1],25,-1,44,-1,25
1,<environment.Job instance at 0x7efbdb53a460>,25,16,[ 2 10],26,-1,42,-1,26
1,<environment.Job instance at 0x7efbdb53a6e0>,27,21,[ 3 10],28,-1,49,-1,28
1,<environment.Job instance at 0x7efbdad15870>,32,14,[2 9],33,-1,47,-1,33
1,<environment.Job instance at 0x7efbdad4f550>,38,21,[9 4],39,-1,61,-1,40
1,<environment.Job instance at 0x7efbdad4ff00>,39,12,[9 3],40,-1,52,-1,40
1,<environment.Job instance at 0x7efbdad4f820>,40,18,[10  3],41,-1,60,-1,42
1,<environment.Job instance at 0x7efbdad4ffa0>,41,17,[10  2],42,-1,59,-1,42
1,<environment.Job instance at 0x7efbdad45dc0>,46,14,[5 5],47,-1,61,-1,47
1,<environment.Job instance at 0x7efbdad45370>,10,3,[13  3],11,-1,21,-1,18
1,<environment.Job instance at 0x7efbdab697d0>,15,13,[ 1 14],16,-1,34,-1,21
1,<environment.Job instance at 0x7efbdab6daf0>,26,2,[11  5],27,-1,43,-1,41
1,<environment.Job instance at 0x7efbdab6d5a0>,28,3,[14  4],29,-1,46,-1,43
1,<environment.Job instance at 0x7efbdacbfdc0>,48,12,[14  4],49,-1,113,-1,101
1,<environment.Job instance at 0x7efbe4ab3870>,0,13,[10  5],1,-1,15,-1,2
1,<environment.Job instance at 0x7efbdb274460>,2,14,[2 7],3,-1,17,-1,3
1,<environment.Job instance at 0x7efbdb274320>,3,14,[7 5],4,-1,18,-1,4
1,<environment.Job instance at 0x7efbdb2843c0>,5,14,[10  2],6,-1,20,-1,6
1,<environment.Job instance at 0x7efbdbc1ed70>,14,16,[7 2],15,-1,31,-1,15
1,<environment.Job instance at 0x7efbe4ab3730>,16,12,[ 3 10],17,-1,29,-1,17
1,<environment.Job instance at 0x7efbdb285a00>,20,18,[4 5],21,-1,39,-1,21
1,<environment.Job instance at 0x7efbdb285be0>,21,18,[2 8],22,-1,40,-1,22
1,<environment.Job instance at 0x7efbdb285370>,24,16,[9 4],25,-1,41,-1,25
1,<environment.Job instance at 0x7efbdb285f00>,26,14,[10  1],27,-1,42,-1,28
1,<environment.Job instance at 0x7efbdbc1eaf0>,27,16,[9 2],28,-1,44,-1,28
1,<environment.Job instance at 0x7efbdb1aec30>,32,20,[1 7],33,-1,53,-1,33
1,<environment.Job instance at 0x7efbdb40b190>,36,19,[2 7],37,-1,57,-1,38
1,<environment.Job instance at 0x7efbdb365460>,38,18,[6 3],39,-1,62,-1,44
1,<environment.Job instance at 0x7efbdb1c1d20>,44,16,[7 5],45,-1,61,-1,45
1,<environment.Job instance at 0x7efbdb1c14b0>,46,16,[7 4],47,-1,65,-1,49
1,<environment.Job instance at 0x7efbdb285460>,8,2,[13  1],9,-1,16,-1,14
1,<environment.Job instance at 0x7efbdb1c1aa0>,11,3,[13  5],12,-1,21,-1,18
1,<environment.Job instance at 0x7efbdb1c1550>,12,2,[ 1 12],13,-1,20,-1,18
1,<environment.Job instance at 0x7efbdab6da00>,22,1,[ 4 13],23,-1,37,-1,36
1,<environment.Job instance at 0x7efbdab70870>,23,14,[11  3],24,-1,50,-1,36
1,<environment.Job instance at 0x7efbdab69af0>,40,24,[ 1 10],41,-1,127,-1,103
1,<environment.Job instance at 0x7efbdac6b8c0>,43,24,[7 4],44,-1,131,-1,107
1,<environment.Job instance at 0x7efbdb4ac370>,45,3,[12  3],46,-1,110,-1,107
1,<environment.Job instance at 0x7efbdb2779b0>,1,27,[4 7],2,-1,29,-1,2
1,<environment.Job instance at 0x7efbe4bf51e0>,2,26,[8 4],3,-1,29,-1,3
1,<environment.Job instance at 0x7efbdb25db90>,3,12,[9 1],4,-1,17,-1,5
1,<environment.Job instance at 0x7efbdb25d320>,7,17,[5 2],8,-1,25,-1,8
1,<environment.Job instance at 0x7efbdb25db40>,8,18,[4 5],9,-1,27,-1,9
1,<environment.Job instance at 0x7efbdb25d9b0>,10,25,[ 3 10],11,-1,36,-1,11
1,<environment.Job instance at 0x7efbdb255c30>,17,13,[9 2],18,-1,31,-1,18
1,<environment.Job instance at 0x7efbdb255550>,18,15,[3 6],19,-1,34,-1,19
1,<environment.Job instance at 0x7efbdb255410>,20,17,[2 6],21,-1,38,-1,21
1,<environment.Job instance at 0x7efbdb255e60>,21,15,[8 4],22,-1,37,-1,22
1,<environment.Job instance at 0x7efbdb255f00>,23,23,[10  1],24,-1,47,-1,24
1,<environment.Job instance at 0x7efbdafb4500>,26,28,[6 5],27,-1,55,-1,27
1,<environment.Job instance at 0x7efbdafb4c80>,27,18,[5 9],28,-1,46,-1,28
1,<environment.Job instance at 0x7efbdafb48c0>,34,15,[10  4],35,-1,50,-1,35
1,<environment.Job instance at 0x7efbdafba190>,39,28,[5 3],40,-1,68,-1,40
1,<environment.Job instance at 0x7efbdafbaaf0>,42,18,[8 2],43,-1,61,-1,43
1,<environment.Job instance at 0x7efbdafba8c0>,45,17,[4 6],46,-1,63,-1,46
1,<environment.Job instance at 0x7efbdafd3dc0>,47,14,[ 1 10],48,-1,62,-1,48
1,<environment.Job instance at 0x7efbdb25d6e0>,1,27,[4 7],2,-1,29,-1,2
1,<environment.Job instance at 0x7efbdb2556e0>,2,26,[8 4],3,-1,29,-1,3
1,<environment.Job instance at 0x7efbdafb49b0>,5,16,[14  1],6,-1,22,-1,6
1,<environment.Job instance at 0x7efbdb277b40>,10,25,[ 3 10],11,-1,41,-1,16
1,<environment.Job instance at 0x7efbdafd30f0>,23,23,[10  1],24,-1,76,-1,53
1,<environment.Job instance at 0x7efbdafd3e60>,26,28,[6 5],27,-1,81,-1,53
1,<environment.Job instance at 0x7efbdafc1f50>,31,15,[14  1],32,-1,70,-1,55
1,<environment.Job instance at 0x7efbdafc1780>,35,18,[11  3],36,-1,89,-1,71
1,<environment.Job instance at 0x7efbdafc11e0>,39,28,[5 3],40,-1,102,-1,74
1,<environment.Job instance at 0x7efbdb3f8870>,2,25,[6 3],3,-1,28,-1,3
1,<environment.Job instance at 0x7efbdab53410>,4,17,[9 4],5,-1,23,-1,6
1,<environment.Job instance at 0x7efbdab53640>,6,2,[5 5],7,-1,9,-1,7
1,<environment.Job instance at 0x7efbdab536e0>,7,13,[1 9],8,-1,21,-1,8
1,<environment.Job instance at 0x7efbdab53780>,8,17,[3 6],9,-1,26,-1,9
1,<environment.Job instance at 0x7efbdab53820>,9,15,[ 5 10],10,-1,25,-1,10
1,<environment.Job instance at 0x7efbdab538c0>,10,1,[ 1 10],11,-1,12,-1,11
1,<environment.Job instance at 0x7efbdab53960>,11,14,[8 2],12,-1,26,-1,12
1,<environment.Job instance at 0x7efbdab53a00>,12,1,[5 9],13,-1,14,-1,13
1,<environment.Job instance at 0x7efbdab53aa0>,13,20,[2 6],14,-1,34,-1,14
1,<environment.Job instance at 0x7efbdab53b40>,14,15,[5 1],15,-1,30,-1,15
1,<environment.Job instance at 0x7efbdab53be0>,15,3,[5 2],16,-1,19,-1,16
1,<environment.Job instance at 0x7efbdab53550>,5,13,[6 4],6,-1,31,-1,18
1,<environment.Job instance at 0x7efbdab3c690>,26,15,[2 7],27,-1,42,-1,27
1,<environment.Job instance at 0x7efbdab3c730>,28,15,[7 5],29,-1,44,-1,29
1,<environment.Job instance at 0x7efbdab3c8c0>,29,15,[ 3 10],30,-1,45,-1,30
1,<environment.Job instance at 0x7efbdab3c820>,30,24,[2 8],31,-1,55,-1,31
1,<environment.Job instance at 0x7efbdab3c910>,2,25,[6 3],3,-1,30,-1,5
1,<environment.Job instance at 0x7efbdafc14b0>,19,18,[13  1],20,-1,48,-1,30
1,<environment.Job instance at 0x7efbdafc12d0>,22,3,[ 3 11],23,-1,34,-1,31
1,<environment.Job instance at 0x7efbdb1ae370>,30,24,[2 8],31,-1,84,-1,60
1,<environment.Job instance at 0x7efbdb2856e0>,31,24,[9 1],32,-1,97,-1,73
1,<environment.Job instance at 0x7efbdb1c1550>,33,24,[10  5],34,-1,97,-1,73
1,<environment.Job instance at 0x7efbdb2850f0>,34,23,[10  2],35,-1,96,-1,73
1,<environment.Job instance at 0x7efbdb277aa0>,35,15,[ 1 11],36,-1,88,-1,73
1,<environment.Job instance at 0x7efbdab3d6e0>,47,15,[ 3 12],48,-1,117,-1,102
1,<environment.Job instance at 0x7efbdb3bc910>,0,14,[8 3],1,-1,17,-1,3
1,<environment.Job instance at 0x7efbdac99cd0>,4,18,[3 6],5,-1,23,-1,5
1,<environment.Job instance at 0x7efbdac99b90>,2,12,[8 1],3,-1,18,-1,6
1,<environment.Job instance at 0x7efbdac99f50>,6,16,[9 2],7,-1,24,-1,8
1,<environment.Job instance at 0x7efbdac99410>,7,16,[9 4],8,-1,24,-1,8
1,<environment.Job instance at 0x7efbdac99370>,10,27,[ 5 10],11,-1,38,-1,11
1,<environment.Job instance at 0x7efbdac994b0>,11,17,[7 5],12,-1,29,-1,12
1,<environment.Job instance at 0x7efbdac99730>,16,25,[ 5 10],17,-1,42,-1,17
1,<environment.Job instance at 0x7efbdac99e60>,18,18,[1 5],19,-1,37,-1,19
1,<environment.Job instance at 0x7efbdae94c80>,27,1,[5 5],28,-1,29,-1,28
1,<environment.Job instance at 0x7efbdb2e5e10>,30,14,[7 5],31,-1,45,-1,31
1,<environment.Job instance at 0x7efbdb298370>,35,16,[10  4],36,-1,54,-1,38
1,<environment.Job instance at 0x7efbdb298b90>,38,14,[7 5],39,-1,53,-1,39
1,<environment.Job instance at 0x7efbdb298730>,40,18,[9 5],41,-1,59,-1,41
1,<environment.Job instance at 0x7efbdab78370>,44,17,[7 2],45,-1,65,-1,48
1,<environment.Job instance at 0x7efbdb298280>,10,27,[ 5 10],11,-1,50,-1,23
1,<environment.Job instance at 0x7efbdafb49b0>,16,25,[ 5 10],17,-1,69,-1,44
1,<environment.Job instance at 0x7efbdaf99820>,32,17,[12  4],33,-1,89,-1,72
1,<environment.Job instance at 0x7efbdab3c1e0>,45,2,[ 4 11],46,-1,114,-1,112
1,<environment.Job instance at 0x7efbdb7c7730>,1,17,[2 6],2,-1,19,-1,2
1,<environment.Job instance at 0x7efbdb7c7780>,2,19,[8 2],3,-1,24,-1,5
1,<environment.Job instance at 0x7efbdb7c7960>,4,17,[ 5 14],5,-1,22,-1,5
1,<environment.Job instance at 0x7efbdbed90f0>,9,17,[9 1],10,-1,28,-1,11
1,<environment.Job instance at 0x7efbdb7c7c30>,10,18,[3 5],11,-1,29,-1,11
1,<environment.Job instance at 0x7efbdbaa1e60>,18,14,[4 6],19,-1,34,-1,20
1,<environment.Job instance at 0x7efbdbaa1140>,19,15,[10  2],20,-1,35,-1,20
1,<environment.Job instance at 0x7efbdbaa1050>,21,12,[5 5],22,-1,34,-1,22
1,<environment.Job instance at 0x7efbdc04c370>,23,13,[4 9],24,-1,37,-1,24
1,<environment.Job instance at 0x7efbdc04cc80>,25,14,[7 4],26,-1,40,-1,26
1,<environment.Job instance at 0x7efbdc04ce60>,30,16,[10  2],31,-1,47,-1,31
1,<environment.Job instance at 0x7efbdc04c820>,34,21,[7 2],35,-1,56,-1,35
1,<environment.Job instance at 0x7efbdc07db90>,35,12,[ 1 10],36,-1,48,-1,36
1,<environment.Job instance at 0x7efbdc07d960>,38,16,[6 3],39,-1,56,-1,40
1,<environment.Job instance at 0x7efbdc07d870>,40,18,[4 7],41,-1,59,-1,41
1,<environment.Job instance at 0x7efbdc07d910>,41,14,[1 5],42,-1,56,-1,42
1,<environment.Job instance at 0x7efbdc07de10>,42,14,[ 1 11],43,-1,57,-1,43
1,<environment.Job instance at 0x7efbdc07dcd0>,43,14,[2 7],44,-1,58,-1,44
1,<environment.Job instance at 0x7efbdc07deb0>,44,3,[14  4],45,-1,48,-1,45
1,<environment.Job instance at 0x7efbdc07d6e0>,45,2,[5 5],46,-1,48,-1,46
1,<environment.Job instance at 0x7efbdc07df00>,46,2,[13  4],47,-1,49,-1,47
1,<environment.Job instance at 0x7efbdc07d5f0>,47,3,[3 5],48,-1,51,-1,48
1,<environment.Job instance at 0x7efbdc07d730>,48,15,[8 5],49,-1,64,-1,49
1,<environment.Job instance at 0x7efbdc04c0a0>,3,2,[ 2 14],4,-1,6,-1,4
1,<environment.Job instance at 0x7efbdc04c410>,4,17,[ 5 14],5,-1,22,-1,5
1,<environment.Job instance at 0x7efbdc07d410>,6,2,[11  3],7,-1,9,-1,7
1,<environment.Job instance at 0x7efbdc07d2d0>,7,2,[12  2],8,-1,10,-1,8
1,<environment.Job instance at 0x7efbdc07d7d0>,12,2,[12  5],13,-1,15,-1,13
1,<environment.Job instance at 0x7efbdc07d460>,14,1,[14  4],15,-1,16,-1,15
1,<environment.Job instance at 0x7efbe471daf0>,33,1,[ 5 12],34,-1,81,-1,80
1,<environment.Job instance at 0x7efbdbedb320>,42,14,[ 1 11],43,-1,126,-1,112
1,<environment.Job instance at 0x7efbdbedb7d0>,44,3,[14  4],45,-1,115,-1,112
1,<environment.Job instance at 0x7efbdbedb410>,46,2,[13  4],47,-1,119,-1,117
1,<environment.Job instance at 0x7efbdb5d91e0>,11,3,[9 2],12,-1,15,-1,12
1,<environment.Job instance at 0x7efbdb5d9550>,12,18,[6 3],13,-1,31,-1,13
1,<environment.Job instance at 0x7efbdb5d95f0>,13,2,[9 1],14,-1,16,-1,14
1,<environment.Job instance at 0x7efbdb5d9910>,14,2,[1 8],15,-1,17,-1,15
1,<environment.Job instance at 0x7efbdb5d9b90>,15,16,[6 3],16,-1,32,-1,16
1,<environment.Job instance at 0x7efbdb5d9410>,16,25,[3 8],17,-1,42,-1,17
1,<environment.Job instance at 0x7efbdb5d9500>,19,27,[9 3],20,-1,47,-1,20
1,<environment.Job instance at 0x7efbdb5d9780>,20,15,[7 5],21,-1,36,-1,21
1,<environment.Job instance at 0x7efbe46d36e0>,22,24,[ 3 10],23,-1,47,-1,23
1,<environment.Job instance at 0x7efbe46d3910>,24,17,[8 5],25,-1,42,-1,25
1,<environment.Job instance at 0x7efbdb66e5a0>,28,27,[1 7],29,-1,56,-1,29
1,<environment.Job instance at 0x7efbdb918be0>,34,16,[10  3],35,-1,51,-1,35
1,<environment.Job instance at 0x7efbdb66edc0>,33,12,[1 8],34,-1,52,-1,40
1,<environment.Job instance at 0x7efbdb918e60>,38,14,[10  3],39,-1,59,-1,45
1,<environment.Job instance at 0x7efbdbe520f0>,42,18,[10  4],43,-1,63,-1,45
1,<environment.Job instance at 0x7efbdbe52be0>,41,18,[2 9],42,-1,63,-1,45
1,<environment.Job instance at 0x7efbdb4015f0>,5,14,[ 5 12],6,-1,20,-1,6
1,<environment.Job instance at 0x7efbdb401a50>,7,19,[14  4],8,-1,27,-1,8
1,<environment.Job instance at 0x7efbdc07d140>,9,14,[ 5 11],10,-1,24,-1,10
1,<environment.Job instance at 0x7efbdbaa17d0>,16,25,[3 8],17,-1,53,-1,28
1,<environment.Job instance at 0x7efbdbaa1050>,18,3,[ 5 14],19,-1,31,-1,28
1,<environment.Job instance at 0x7efbdbaa1fa0>,19,27,[9 3],20,-1,55,-1,28
1,<environment.Job instance at 0x7efbdb79fbe0>,22,24,[ 3 10],23,-1,57,-1,33
1,<environment.Job instance at 0x7efbdb79f9b0>,27,12,[ 2 12],28,-1,48,-1,36
1,<environment.Job instance at 0x7efbdb79f870>,28,27,[1 7],29,-1,65,-1,38
1,<environment.Job instance at 0x7efbdc06b870>,45,2,[14  5],46,-1,107,-1,105
1,<environment.Job instance at 0x7efbdba8bf50>,3,18,[5 9],4,-1,22,-1,4
1,<environment.Job instance at 0x7efbdba8b910>,5,21,[2 5],6,-1,27,-1,6
1,<environment.Job instance at 0x7efbdba8b4b0>,8,14,[5 9],9,-1,23,-1,9
1,<environment.Job instance at 0x7efbdba8b2d0>,9,19,[9 1],10,-1,29,-1,10
1,<environment.Job instance at 0x7efbdba8baf0>,11,16,[6 5],12,-1,28,-1,12
1,<environment.Job instance at 0x7efbdacc3960>,13,27,[1 8],14,-1,41,-1,14
1,<environment.Job instance at 0x7efbdba8b9b0>,16,14,[3 9],17,-1,31,-1,17
1,<environment.Job instance at 0x7efbdbd1f9b0>,19,13,[5 9],20,-1,33,-1,20
1,<environment.Job instance at 0x7efbdb9dcc80>,21,18,[8 4],22,-1,40,-1,22
1,<environment.Job instance at 0x7efbdaac1b40>,24,17,[3 9],25,-1,42,-1,25
1,<environment.Job instance at 0x7efbdad15730>,25,13,[10  4],26,-1,40,-1,27
1,<environment.Job instance at 0x7efbdad15fa0>,27,22,[1 7],28,-1,50,-1,28
1,<environment.Job instance at 0x7efbdafbd8c0>,28,2,[5 7],29,-1,31,-1,29
1,<environment.Job instance at 0x7efbdb2d9550>,29,15,[7 1],30,-1,45,-1,30
1,<environment.Job instance at 0x7efbdaee22d0>,30,14,[6 4],31,-1,45,-1,31
1,<environment.Job instance at 0x7efbe4c158c0>,31,18,[3 6],32,-1,50,-1,32
1,<environment.Job instance at 0x7efbe4c15280>,32,1,[9 3],33,-1,34,-1,33
1,<environment.Job instance at 0x7efbdaac1f00>,26,16,[5 5],27,-1,50,-1,34
1,<environment.Job instance at 0x7efbe4c15050>,35,25,[6 3],36,-1,61,-1,36
1,<environment.Job instance at 0x7efbe4c15460>,38,16,[8 5],39,-1,55,-1,39
1,<environment.Job instance at 0x7efbe4c15eb0>,39,18,[7 5],40,-1,58,-1,40
1,<environment.Job instance at 0x7efbdba86e60>,42,16,[9 2],43,-1,59,-1,43
1,<environment.Job instance at 0x7efbdc07ed20>,43,15,[6 3],44,-1,59,-1,44
1,<environment.Job instance at 0x7efbdc07ef00>,45,18,[7 5],46,-1,64,-1,46
1,<environment.Job instance at 0x7efbdb642050>,48,17,[10  3],49,-1,66,-1,49
1,<environment.Job instance at 0x7efbdb79f5f0>,13,27,[1 8],14,-1,49,-1,22
1,<environment.Job instance at 0x7efbdada5640>,33,3,[ 3 14],34,-1,94,-1,91
1,<environment.Job instance at 0x7efbdada5910>,35,25,[6 3],36,-1,130,-1,105
1,<environment.Job instance at 0x7efbe4c159b0>,40,2,[ 5 11],41,-1,110,-1,108
1,<environment.Job instance at 0x7efbda760f00>,1,22,[ 1 10],2,-1,25,-1,3
1,<environment.Job instance at 0x7efbda760460>,2,18,[5 1],3,-1,22,-1,4
1,<environment.Job instance at 0x7efbdbff5280>,9,15,[ 1 10],10,-1,25,-1,10
1,<environment.Job instance at 0x7efbdbff5690>,12,15,[1 6],13,-1,28,-1,13
1,<environment.Job instance at 0x7efbe4bb6370>,14,12,[4 6],15,-1,27,-1,15
1,<environment.Job instance at 0x7efbe4bb60f0>,15,17,[7 1],16,-1,33,-1,16
1,<environment.Job instance at 0x7efbdac9d3c0>,17,18,[1 7],18,-1,36,-1,18
1,<environment.Job instance at 0x7efbdbd0bb90>,19,14,[10  1],20,-1,35,-1,21
1,<environment.Job instance at 0x7efbdc0918c0>,21,14,[10  4],22,-1,36,-1,22
1,<environment.Job instance at 0x7efbdb58c140>,22,18,[5 5],23,-1,41,-1,23
1,<environment.Job instance at 0x7efbe4a64a50>,24,12,[8 4],25,-1,37,-1,25
1,<environment.Job instance at 0x7efbdb88f370>,25,15,[7 4],26,-1,41,-1,26
1,<environment.Job instance at 0x7efbdbf76140>,27,14,[6 2],28,-1,42,-1,28
1,<environment.Job instance at 0x7efbdc0234b0>,28,21,[5 8],29,-1,50,-1,29
1,<environment.Job instance at 0x7efbdc098b90>,29,17,[7 2],30,-1,47,-1,30
1,<environment.Job instance at 0x7efbda760050>,20,15,[1 6],21,-1,46,-1,31
1,<environment.Job instance at 0x7efbe4a98f00>,31,28,[2 8],32,-1,60,-1,32
1,<environment.Job instance at 0x7efbdbd01820>,32,18,[5 1],33,-1,51,-1,33
1,<environment.Job instance at 0x7efbdbfaeaa0>,33,27,[9 3],34,-1,61,-1,34
1,<environment.Job instance at 0x7efbda825190>,16,13,[11  1],17,-1,40,-1,27
1,<environment.Job instance at 0x7efbdbf94b40>,18,12,[ 5 12],19,-1,42,-1,30
1,<environment.Job instance at 0x7efbdb039640>,33,27,[9 3],34,-1,126,-1,99
1,<environment.Job instance at 0x7efbda84ceb0>,31,28,[2 8],32,-1,130,-1,102
1,<environment.Job instance at 0x7efbdb03afa0>,36,28,[1 7],37,-1,130,-1,102
1,<environment.Job instance at 0x7efbdb04b640>,39,2,[ 4 11],40,-1,114,-1,112
1,<environment.Job instance at 0x7efbdb028730>,44,3,[11  1],45,-1,120,-1,117
1,<environment.Job instance at 0x7efbda82b370>,46,28,[9 2],47,-1,149,-1,121
1,<environment.Job instance at 0x7efbdac92780>,8,15,[ 3 11],9,-1,25,-1,10
1,<environment.Job instance at 0x7efbdac8be60>,10,14,[6 4],11,-1,25,-1,11
1,<environment.Job instance at 0x7efbdac8b730>,14,15,[9 1],15,-1,30,-1,15
1,<environment.Job instance at 0x7efbdac8b550>,16,23,[7 4],17,-1,40,-1,17
1,<environment.Job instance at 0x7efbdac8ceb0>,20,15,[9 4],21,-1,38,-1,23
1,<environment.Job instance at 0x7efbdac8c050>,23,20,[5 4],24,-1,44,-1,24
1,<environment.Job instance at 0x7efbdb11fa50>,39,17,[5 9],40,-1,57,-1,40
1,<environment.Job instance at 0x7efbdad175a0>,35,20,[4 7],36,-1,73,-1,53
1,<environment.Job instance at 0x7efbdb11f0a0>,43,17,[8 5],44,-1,70,-1,53
1,<environment.Job instance at 0x7efbdb0c8410>,36,21,[6 5],37,-1,77,-1,56
1,<environment.Job instance at 0x7efbdb11f460>,46,25,[8 3],47,-1,81,-1,56
1,<environment.Job instance at 0x7efbdb11fc80>,45,16,[4 5],46,-1,72,-1,56
1,<environment.Job instance at 0x7efbdb11fa00>,47,13,[13  1],48,-1,69,-1,56
1,<environment.Job instance at 0x7efbdac92d20>,7,3,[ 1 12],8,-1,11,-1,8
1,<environment.Job instance at 0x7efbdac92730>,8,15,[ 3 11],9,-1,24,-1,9
1,<environment.Job instance at 0x7efbdc113e10>,15,15,[ 2 11],16,-1,31,-1,16
1,<environment.Job instance at 0x7efbdc113be0>,16,23,[7 4],17,-1,42,-1,19
1,<environment.Job instance at 0x7efbdb8e08c0>,30,16,[14  3],31,-1,72,-1,56
1,<environment.Job instance at 0x7efbdab20730>,41,27,[5 1],42,-1,104,-1,77
1,<environment.Job instance at 0x7efbdbefec80>,46,25,[8 3],47,-1,117,-1,92
1,<environment.Job instance at 0x7efbdbefe730>,47,13,[13  1],48,-1,105,-1,92
1,<environment.Job instance at 0x7efbdb5f4690>,0,16,[9 2],1,-1,18,-1,2
1,<environment.Job instance at 0x7efbdae7a5f0>,1,19,[10  1],2,-1,21,-1,2
1,<environment.Job instance at 0x7efbdac70820>,6,25,[ 5 10],7,-1,32,-1,7
1,<environment.Job instance at 0x7efbdafc7eb0>,12,18,[5 9],13,-1,31,-1,13
1,<environment.Job instance at 0x7efbdbddd190>,13,16,[6 5],14,-1,30,-1,14
1,<environment.Job instance at 0x7efbdb7de500>,18,18,[1 9],19,-1,37,-1,19
1,<environment.Job instance at 0x7efbdc0860a0>,20,15,[3 9],21,-1,36,-1,21
1,<environment.Job instance at 0x7efbe4a5acd0>,24,17,[9 5],25,-1,42,-1,25
1,<environment.Job instance at 0x7efbdb53e6e0>,25,16,[5 3],26,-1,42,-1,26
1,<environment.Job instance at 0x7efbdc080910>,28,14,[9 4],29,-1,44,-1,30
1,<environment.Job instance at 0x7efbdba5c9b0>,30,26,[6 3],31,-1,57,-1,31
1,<environment.Job instance at 0x7efbdc0982d0>,31,14,[4 6],32,-1,46,-1,32
1,<environment.Job instance at 0x7efbdc0987d0>,32,17,[ 2 11],33,-1,50,-1,33
1,<environment.Job instance at 0x7efbdb2385a0>,35,23,[7 1],36,-1,59,-1,36
1,<environment.Job instance at 0x7efbdb238910>,37,17,[4 9],38,-1,55,-1,38
1,<environment.Job instance at 0x7efbdb238eb0>,39,14,[6 1],40,-1,54,-1,40
1,<environment.Job instance at 0x7efbdba6ceb0>,41,17,[10  4],42,-1,59,-1,42
1,<environment.Job instance at 0x7efbdba6cf50>,42,14,[3 9],43,-1,57,-1,43
1,<environment.Job instance at 0x7efbdba6ca00>,45,18,[10  3],46,-1,64,-1,46
1,<environment.Job instance at 0x7efbdba6c550>,47,18,[3 6],48,-1,66,-1,48
1,<environment.Job instance at 0x7efbdb7de460>,6,25,[ 5 10],7,-1,33,-1,8
1,<environment.Job instance at 0x7efbdba170a0>,26,2,[13  5],27,-1,46,-1,44
1,<environment.Job instance at 0x7efbe4aa6320>,30,26,[6 3],31,-1,99,-1,73
1,<environment.Job instance at 0x7efbe4aa66e0>,32,17,[ 2 11],33,-1,90,-1,73
1,<environment.Job instance at 0x7efbe4aa6820>,35,23,[7 1],36,-1,102,-1,79
1,<environment.Job instance at 0x7efbdb7c7a00>,43,12,[ 1 14],44,-1,116,-1,104
1,<environment.Job instance at 0x7efbdb7c7c80>,46,13,[13  3],47,-1,131,-1,118
1,<environment.Job instance at 0x7efbdb7c78c0>,48,1,[ 3 14],49,-1,122,-1,121
1,<environment.Job instance at 0x7efbdaf2d820>,4,18,[4 7],5,-1,23,-1,5
1,<environment.Job instance at 0x7efbdaf2d500>,6,17,[5 5],7,-1,24,-1,7
1,<environment.Job instance at 0x7efbdaf2deb0>,12,17,[1 6],13,-1,30,-1,13
1,<environment.Job instance at 0x7efbdaf2db40>,13,16,[4 9],14,-1,30,-1,14
1,<environment.Job instance at 0x7efbdaf45460>,19,18,[9 5],20,-1,38,-1,20
1,<environment.Job instance at 0x7efbdaf455f0>,25,23,[5 3],26,-1,49,-1,26
1,<environment.Job instance at 0x7efbdaf45aa0>,27,16,[ 5 10],28,-1,55,-1,39
1,<environment.Job instance at 0x7efbdaf4bc30>,47,18,[10  5],48,-1,129,-1,111
1,<environment.Job instance at 0x7efbdb7c7190>,11,14,[ 3 14],12,-1,32,-1,18
1,<environment.Job instance at 0x7efbe4aa62d0>,15,13,[ 1 12],16,-1,35,-1,22
1,<environment.Job instance at 0x7efbe4aa6d70>,16,17,[11  2],17,-1,39,-1,22
1,<environment.Job instance at 0x7efbe4aa6640>,20,28,[5 6],21,-1,66,-1,38
1,<environment.Job instance at 0x7efbdba5bf00>,23,28,[ 1 11],24,-1,68,-1,40
1,<environment.Job instance at 0x7efbdba17500>,25,23,[5 3],26,-1,66,-1,43
1,<environment.Job instance at 0x7efbdac6b190>,26,14,[13  5],27,-1,57,-1,43
1,<environment.Job instance at 0x7efbdbc120a0>,30,13,[12  5],31,-1,69,-1,56
1,<environment.Job instance at 0x7efbdac8c500>,38,15,[ 3 13],39,-1,97,-1,82
1,<environment.Job instance at 0x7efbdbf941e0>,46,18,[ 3 13],47,-1,146,-1,128
1,<environment.Job instance at 0x7efbdaf256e0>,8,14,[1 7],9,-1,23,-1,9
1,<environment.Job instance at 0x7efbdaf25050>,9,17,[9 4],10,-1,27,-1,10
1,<environment.Job instance at 0x7efbdb5c3e60>,11,18,[4 8],12,-1,30,-1,12
1,<environment.Job instance at 0x7efbdb5c31e0>,13,15,[10  4],14,-1,30,-1,15
1,<environment.Job instance at 0x7efbdb5c3460>,16,15,[ 5 10],17,-1,32,-1,17
1,<environment.Job instance at 0x7efbdb5c3a50>,19,14,[9 5],20,-1,34,-1,20
1,<environment.Job instance at 0x7efbdb5c3730>,20,25,[2 8],21,-1,46,-1,21
1,<environment.Job instance at 0x7efbdb5c3b90>,21,13,[5 8],22,-1,35,-1,22
1,<environment.Job instance at 0x7efbdb5c30f0>,22,18,[9 4],23,-1,41,-1,23
1,<environment.Job instance at 0x7efbdb5c3960>,23,18,[ 4 10],24,-1,42,-1,24
1,<environment.Job instance at 0x7efbdb5d40a0>,27,15,[ 5 10],28,-1,43,-1,28
1,<environment.Job instance at 0x7efbdb5d4320>,28,17,[5 7],29,-1,46,-1,29
1,<environment.Job instance at 0x7efbdb5d4c30>,31,16,[ 4 10],32,-1,48,-1,32
1,<environment.Job instance at 0x7efbdb5d4a00>,34,15,[ 2 10],35,-1,51,-1,36
1,<environment.Job instance at 0x7efbdb5d4af0>,36,18,[9 4],37,-1,55,-1,37
1,<environment.Job instance at 0x7efbdb5d4aa0>,35,16,[4 6],36,-1,55,-1,39
1,<environment.Job instance at 0x7efbdb5d4410>,39,16,[2 8],40,-1,58,-1,42
1,<environment.Job instance at 0x7efbdaf4ac80>,42,18,[5 1],43,-1,61,-1,43
1,<environment.Job instance at 0x7efbdaf4a780>,43,18,[ 5 10],44,-1,62,-1,44
1,<environment.Job instance at 0x7efbdaf4af00>,44,20,[9 5],45,-1,65,-1,45
1,<environment.Job instance at 0x7efbdaf4a0f0>,45,17,[7 4],46,-1,63,-1,46
1,<environment.Job instance at 0x7efbdaf4a5a0>,46,18,[4 6],47,-1,65,-1,47
1,<environment.Job instance at 0x7efbdaf4adc0>,47,14,[5 5],48,-1,62,-1,48
1,<environment.Job instance at 0x7efbdaf250f0>,7,2,[ 4 14],8,-1,10,-1,8
1,<environment.Job instance at 0x7efbe4aa6820>,14,2,[ 1 12],15,-1,23,-1,21
1,<environment.Job instance at 0x7efbdaf4ab90>,20,25,[2 8],21,-1,77,-1,52
1,<environment.Job instance at 0x7efbdaf4a5f0>,24,3,[ 3 14],25,-1,65,-1,62
1,<environment.Job instance at 0x7efbdaf4a640>,29,2,[13  5],30,-1,85,-1,83
1,<environment.Job instance at 0x7efbdaf2c6e0>,38,1,[ 3 12],39,-1,126,-1,125
1,<environment.Job instance at 0x7efbdb29f690>,3,17,[10  5],4,-1,21,-1,4
1,<environment.Job instance at 0x7efbdb29fe60>,4,17,[3 6],5,-1,22,-1,5
1,<environment.Job instance at 0x7efbdb2c6280>,11,16,[2 7],12,-1,28,-1,12
1,<environment.Job instance at 0x7efbdb2c6730>,14,13,[5 4],15,-1,28,-1,15
1,<environment.Job instance at 0x7efbdb2c6870>,15,15,[9 1],16,-1,31,-1,16
1,<environment.Job instance at 0x7efbdb2c6d70>,17,25,[9 4],18,-1,43,-1,18
1,<environment.Job instance at 0x7efbdb2c6690>,20,16,[2 8],21,-1,37,-1,21
1,<environment.Job instance at 0x7efbdb2c60a0>,22,17,[1 7],23,-1,40,-1,23
1,<environment.Job instance at 0x7efbdb2c6fa0>,23,17,[6 4],24,-1,41,-1,24
1,<environment.Job instance at 0x7efbdb2c6140>,25,16,[1 6],26,-1,42,-1,26
1,<environment.Job instance at 0x7efbda899e10>,31,18,[9 3],32,-1,52,-1,34
1,<environment.Job instance at 0x7efbda8990a0>,34,25,[7 4],35,-1,60,-1,35
1,<environment.Job instance at 0x7efbda899b90>,36,22,[ 4 10],37,-1,59,-1,37
1,<environment.Job instance at 0x7efbda899f50>,38,16,[2 7],39,-1,55,-1,39
1,<environment.Job instance at 0x7efbda899d70>,39,16,[ 3 10],40,-1,56,-1,40
1,<environment.Job instance at 0x7efbda899050>,42,18,[5 8],43,-1,61,-1,43
1,<environment.Job instance at 0x7efbda899cd0>,33,12,[4 9],34,-1,60,-1,48
1,<environment.Job instance at 0x7efbdb29f2d0>,5,18,[14  2],6,-1,24,-1,6
1,<environment.Job instance at 0x7efbdb5c33c0>,17,25,[9 4],18,-1,64,-1,39
1,<environment.Job instance at 0x7efbdaf250f0>,21,3,[ 4 12],22,-1,44,-1,41
1,<environment.Job instance at 0x7efbdb166e10>,26,16,[14  3],27,-1,73,-1,57
1,<environment.Job instance at 0x7efbdb1660f0>,27,14,[12  5],28,-1,71,-1,57
1,<environment.Job instance at 0x7efbdb166140>,34,25,[7 4],35,-1,111,-1,86
1,<environment.Job instance at 0x7efbdc0d61e0>,45,23,[8 2],46,-1,145,-1,122
1,<environment.Job instance at 0x7efbdbbbb320>,0,16,[5 9],1,-1,17,-1,1
1,<environment.Job instance at 0x7efbdbbbb910>,1,15,[9 5],2,-1,18,-1,3
1,<environment.Job instance at 0x7efbdaf4a4b0>,2,14,[9 1],3,-1,17,-1,3
1,<environment.Job instance at 0x7efbdb0f9f50>,9,16,[ 4 10],10,-1,26,-1,10
1,<environment.Job instance at 0x7efbdb0f9960>,10,18,[5 8],11,-1,30,-1,12
1,<environment.Job instance at 0x7efbdb0df0a0>,12,23,[7 1],13,-1,36,-1,13
1,<environment.Job instance at 0x7efbdb0f9870>,11,17,[3 7],12,-1,31,-1,14
1,<environment.Job instance at 0x7efbdb0f9a00>,14,14,[10  1],15,-1,35,-1,21
1,<environment.Job instance at 0x7efbdb6d3f00>,21,15,[7 5],22,-1,37,-1,22
1,<environment.Job instance at 0x7efbdb42c230>,26,17,[9 3],27,-1,44,-1,27
1,<environment.Job instance at 0x7efbdb94d960>,29,15,[5 6],30,-1,45,-1,30
1,<environment.Job instance at 0x7efbdb0dfd70>,3,18,[ 2 11],4,-1,22,-1,4
1,<environment.Job instance at 0x7efbdb406140>,5,3,[11  2],6,-1,9,-1,6
1,<environment.Job instance at 0x7efbdb3dcbe0>,12,23,[7 1],13,-1,60,-1,37
1,<environment.Job instance at 0x7efbdb3dc5f0>,15,3,[13  2],16,-1,40,-1,37
1,<environment.Job instance at 0x7efbdc0d6690>,18,1,[13  4],19,-1,48,-1,47
1,<environment.Job instance at 0x7efbdaf16d70>,22,13,[14  4],23,-1,65,-1,52
1,<environment.Job instance at 0x7efbdb166370>,31,23,[ 3 13],32,-1,117,-1,94
1,<environment.Job instance at 0x7efbdb3520f0>,1,18,[3 7],2,-1,20,-1,2
1,<environment.Job instance at 0x7efbdb3528c0>,2,17,[1 9],3,-1,20,-1,3
1,<environment.Job instance at 0x7efbdb3287d0>,4,22,[9 5],5,-1,27,-1,5
1,<environment.Job instance at 0x7efbdb3286e0>,7,16,[5 8],8,-1,24,-1,8
1,<environment.Job instance at 0x7efbdb328780>,8,16,[1 6],9,-1,25,-1,9
1,<environment.Job instance at 0x7efbdb328cd0>,13,15,[4 9],14,-1,30,-1,15
1,<environment.Job instance at 0x7efbdb3285f0>,15,12,[ 3 10],16,-1,28,-1,16
1,<environment.Job instance at 0x7efbdb3280a0>,16,12,[9 4],17,-1,29,-1,17
1,<environment.Job instance at 0x7efbdb328b90>,18,12,[10  1],19,-1,31,-1,19
1,<environment.Job instance at 0x7efbdb328730>,19,21,[1 7],20,-1,41,-1,20
1,<environment.Job instance at 0x7efbdb328500>,20,16,[9 2],21,-1,37,-1,21
1,<environment.Job instance at 0x7efbdb343d20>,27,17,[8 2],28,-1,45,-1,28
1,<environment.Job instance at 0x7efbdb343230>,28,17,[1 6],29,-1,46,-1,29
1,<environment.Job instance at 0x7efbdb343640>,29,17,[9 2],30,-1,47,-1,30
1,<environment.Job instance at 0x7efbdb3430a0>,30,2,[8 1],31,-1,33,-1,31
1,<environment.Job instance at 0x7efbdb343910>,31,1,[9 4],32,-1,33,-1,32
1,<environment.Job instance at 0x7efbdb343be0>,32,15,[2 9],33,-1,48,-1,33
1,<environment.Job instance at 0x7efbdb3430f0>,33,2,[1 7],34,-1,36,-1,34
1,<environment.Job instance at 0x7efbdb352460>,14,14,[10  4],15,-1,49,-1,35
1,<environment.Job instance at 0x7efbda8ed5f0>,43,18,[ 2 10],44,-1,63,-1,45
1,<environment.Job instance at 0x7efbdb343cd0>,5,3,[ 1 14],6,-1,9,-1,6
1,<environment.Job instance at 0x7efbdb352910>,10,13,[11  4],11,-1,31,-1,18
1,<environment.Job instance at 0x7efbdb352640>,11,12,[ 1 13],12,-1,30,-1,18
1,<environment.Job instance at 0x7efbdb0df690>,22,17,[ 2 14],23,-1,77,-1,60
1,<environment.Job instance at 0x7efbdc0cac80>,35,16,[11  3],36,-1,124,-1,108
1,<environment.Job instance at 0x7efbdc0982d0>,46,1,[11  2],47,-1,131,-1,130
1,<environment.Job instance at 0x7efbdb7ebf00>,5,17,[ 2 10],6,-1,26,-1,9
1,<environment.Job instance at 0x7efbdb7ec1e0>,8,19,[7 1],9,-1,28,-1,9
1,<environment.Job instance at 0x7efbdb7ec0a0>,10,18,[9 2],11,-1,32,-1,14
1,<environment.Job instance at 0x7efbdb7ec6e0>,14,12,[7 4],15,-1,27,-1,15
1,<environment.Job instance at 0x7efbdb7ec960>,17,14,[11  2],18,-1,32,-1,18
1,<environment.Job instance at 0x7efbdb7ec910>,19,18,[1 5],20,-1,38,-1,20
1,<environment.Job instance at 0x7efbdb7ecb40>,20,27,[7 4],21,-1,48,-1,21
1,<environment.Job instance at 0x7efbdb7ecc80>,22,16,[10  2],23,-1,39,-1,23
1,<environment.Job instance at 0x7efbdb7ece10>,23,15,[4 8],24,-1,39,-1,24
1,<environment.Job instance at 0x7efbdb4b75f0>,26,13,[9 5],27,-1,40,-1,27
1,<environment.Job instance at 0x7efbdb7ec550>,13,14,[5 5],14,-1,41,-1,27
1,<environment.Job instance at 0x7efbdb4b7190>,28,14,[ 4 10],29,-1,44,-1,30
1,<environment.Job instance at 0x7efbdb4b7b40>,31,14,[9 5],32,-1,46,-1,32
1,<environment.Job instance at 0x7efbdb4b7e10>,32,15,[7 3],33,-1,48,-1,33
1,<environment.Job instance at 0x7efbdb4b79b0>,34,19,[9 1],35,-1,54,-1,35
1,<environment.Job instance at 0x7efbdb4b7230>,38,13,[3 7],39,-1,52,-1,39
1,<environment.Job instance at 0x7efbdb4b7320>,39,15,[8 5],40,-1,55,-1,40
1,<environment.Job instance at 0x7efbdb4b73c0>,41,13,[9 4],42,-1,55,-1,42
1,<environment.Job instance at 0x7efbdb4b7870>,42,16,[1 7],43,-1,59,-1,43
1,<environment.Job instance at 0x7efbdb4b00a0>,44,15,[6 4],45,-1,60,-1,45
1,<environment.Job instance at 0x7efbdb4b02d0>,47,16,[7 2],48,-1,64,-1,48
1,<environment.Job instance at 0x7efbdc0aa050>,17,14,[11  2],18,-1,39,-1,25
1,<environment.Job instance at 0x7efbdc0cac80>,18,15,[ 3 14],19,-1,40,-1,25
1,<environment.Job instance at 0x7efbdc0aa320>,20,27,[7 4],21,-1,56,-1,29
1,<environment.Job instance at 0x7efbdc0ca6e0>,25,2,[ 1 12],26,-1,43,-1,41
1,<environment.Job instance at 0x7efbdb94d0f0>,30,25,[ 1 14],31,-1,86,-1,61
1,<environment.Job instance at 0x7efbdb3dcbe0>,33,1,[ 4 13],34,-1,75,-1,74
1,<environment.Job instance at 0x7efbdb3dcaf0>,35,3,[ 4 11],36,-1,88,-1,85
1,<environment.Job instance at 0x7efbdb328690>,48,3,[11  1],49,-1,137,-1,134
1,<environment.Job instance at 0x7fe3fa8308c0>,0,13,[9 3],1,-1,15,-1,2
1,<environment.Job instance at 0x7fe3fa830aa0>,1,22,[11  3],2,-1,24,-1,2
1,<environment.Job instance at 0x7fe3fa830910>,2,22,[4 8],3,-1,25,-1,3
1,<environment.Job instance at 0x7fe3f1248690>,9,18,[11  5],10,-1,28,-1,10
1,<environment.Job instance at 0x7fe3f1248820>,11,15,[4 8],12,-1,27,-1,12
1,<environment.Job instance at 0x7fe3f12488c0>,13,18,[ 4 10],14,-1,32,-1,14
1,<environment.Job instance at 0x7fe3f1248aa0>,15,18,[2 8],16,-1,34,-1,16
1,<environment.Job instance at 0x7fe3f1248be0>,16,16,[3 5],17,-1,33,-1,17
1,<environment.Job instance at 0x7fe3f1248e10>,19,14,[3 5],20,-1,34,-1,20
1,<environment.Job instance at 0x7fe3f1248fa0>,21,1,[6 5],22,-1,23,-1,22
1,<environment.Job instance at 0x7fe3f124c0a0>,22,1,[2 7],23,-1,24,-1,23
1,<environment.Job instance at 0x7fe3f124c140>,23,27,[1 6],24,-1,51,-1,24
1,<environment.Job instance at 0x7fe3f1248f50>,20,1,[7 5],21,-1,26,-1,25
1,<environment.Job instance at 0x7fe3f124c1e0>,24,18,[2 6],25,-1,43,-1,25
1,<environment.Job instance at 0x7fe3f124c4b0>,27,15,[8 4],28,-1,43,-1,28
1,<environment.Job instance at 0x7fe3f124c5f0>,28,23,[10  4],29,-1,52,-1,29
1,<environment.Job instance at 0x7fe3f124c6e0>,30,14,[5 2],31,-1,45,-1,31
1,<environment.Job instance at 0x7fe3f124c870>,31,14,[2 5],32,-1,46,-1,32
1,<environment.Job instance at 0x7fe3f124c640>,32,3,[5 1],33,-1,36,-1,33
1,<environment.Job instance at 0x7fe3f124c960>,33,14,[5 5],34,-1,48,-1,34
1,<environment.Job instance at 0x7fe3f124ca00>,34,24,[1 8],35,-1,59,-1,35
1,<environment.Job instance at 0x7fe3f124caa0>,35,15,[9 5],36,-1,51,-1,36
1,<environment.Job instance at 0x7fe3f124cfa0>,40,15,[10  3],41,-1,59,-1,44
1,<environment.Job instance at 0x7fe3f124e0f0>,43,18,[5 5],44,-1,62,-1,44
1,<environment.Job instance at 0x7fe3f124e500>,48,15,[10  1],49,-1,65,-1,50
1,<environment.Job instance at 0x7fe3f124ec30>,53,17,[5 7],54,-1,71,-1,54
1,<environment.Job instance at 0x7fe3f1248550>,1,22,[11  3],2,-1,24,-1,2
1,<environment.Job instance at 0x7fe3f124ef00>,9,18,[11  5],10,-1,32,-1,14
1,<environment.Job instance at 0x7fe3f1243fa0>,12,26,[ 1 10],13,-1,82,-1,56
1,<environment.Job instance at 0x7fe3f1251dc0>,23,27,[1 6],24,-1,87,-1,60
1,<environment.Job instance at 0x7fe3f12530f0>,28,23,[10  4],29,-1,97,-1,74
1,<environment.Job instance at 0x7fe3f1253640>,34,24,[1 8],35,-1,117,-1,93
1,<environment.Job instance at 0x7fe3f1253780>,36,13,[ 3 14],37,-1,106,-1,93
1,<environment.Job instance at 0x7fe3f1253fa0>,46,17,[12  2],47,-1,134,-1,117
1,<environment.Job instance at 0x7fe3f11d7140>,50,16,[12  2],51,-1,146,-1,130
1,<environment.Job instance at 0x7fe3f11d73c0>,54,13,[13  1],55,-1,158,-1,145
1,<environment.Job instance at 0x7fe3f09d04b0>,2,22,[6 4],3,-1,25,-1,3
1,<environment.Job instance at 0x7fe3f09873c0>,4,18,[2 9],5,-1,24,-1,6
1,<environment.Job instance at 0x7fe3f09d0320>,5,20,[2 6],6,-1,27,-1,7
1,<environment.Job instance at 0x7fe3f098cb90>,16,19,[4 8],17,-1,36,-1,17
1,<environment.Job instance at 0x7fe3f098c4b0>,17,13,[8 5],18,-1,31,-1,18
1,<environment.Job instance at 0x7fe3f098c910>,18,12,[10  2],19,-1,32,-1,20
1,<environment.Job instance at 0x7fe3f0989140>,20,14,[2 6],21,-1,35,-1,21
1,<environment.Job instance at 0x7fe3f0989640>,21,15,[5 9],22,-1,37,-1,22
1,<environment.Job instance at 0x7fe3f0989780>,22,16,[ 4 10],23,-1,39,-1,23
1,<environment.Job instance at 0x7fe3f0989320>,23,20,[7 1],24,-1,44,-1,24
1,<environment.Job instance at 0x7fe3f09892d0>,24,18,[3 7],25,-1,43,-1,25
1,<environment.Job instance at 0x7fe3f0989960>,25,17,[3 9],26,-1,43,-1,26
1,<environment.Job instance at 0x7fe3f0989af0>,26,18,[9 2],27,-1,45,-1,27
1,<environment.Job instance at 0x7fe3f0981eb0>,29,14,[5 3],30,-1,44,-1,30
1,<environment.Job instance at 0x7fe3f0981960>,32,20,[1 5],33,-1,53,-1,33
1,<environment.Job instance at 0x7fe3f0986e10>,35,15,[5 7],36,-1,51,-1,36
1,<environment.Job instance at 0x7fe3f08c1c80>,40,18,[2 7],41,-1,59,-1,41
1,<environment.Job instance at 0x7fe3f08d3550>,41,18,[ 1 10],42,-1,64,-1,46
1,<environment.Job instance at 0x7fe3f08c5cd0>,47,17,[9 3],48,-1,75,-1,58
1,<environment.Job instance at 0x7fe3f08c8730>,45,14,[14  5],46,-1,73,-1,59
1,<environment.Job instance at 0x7fe3f1251730>,0,3,[12  3],1,-1,4,-1,1
1,<environment.Job instance at 0x7fe3f124ec80>,9,13,[ 3 12],10,-1,23,-1,10
1,<environment.Job instance at 0x7fe3f1251320>,7,27,[ 1 10],8,-1,54,-1,27
1,<environment.Job instance at 0x7fe3f1253370>,15,14,[ 4 11],16,-1,41,-1,27
1,<environment.Job instance at 0x7fe3f0a3d4b0>,37,2,[ 5 11],38,-1,104,-1,102
1,<environment.Job instance at 0x7fe3f12531e0>,39,18,[12  5],40,-1,123,-1,105
1,<environment.Job instance at 0x7fe3f09e3910>,45,14,[14  5],46,-1,149,-1,135
1,<environment.Job instance at 0x7fe3f09e0910>,46,15,[11  1],47,-1,150,-1,135
1,<environment.Job instance at 0x7fe3f0a44280>,51,26,[ 5 10],52,-1,192,-1,166
1,<environment.Job instance at 0x7fe3f09ea1e0>,56,3,[ 1 12],57,-1,171,-1,168
1,<environment.Job instance at 0x7fe3f08c8690>,7,22,[4 5],8,-1,30,-1,8
1,<environment.Job instance at 0x7fe3f07ee910>,13,16,[ 3 10],14,-1,30,-1,14
1,<environment.Job instance at 0x7fe3f07ee550>,17,20,[9 2],18,-1,50,-1,30
1,<environment.Job instance at 0x7fe3f07ee140>,20,16,[2 8],21,-1,46,-1,30
1,<environment.Job instance at 0x7fe3f07ee3c0>,21,13,[5 6],22,-1,43,-1,30
1,<environment.Job instance at 0x7fe3f07eea50>,23,15,[ 1 12],24,-1,45,-1,30
1,<environment.Job instance at 0x7fe3f07eef50>,26,17,[1 7],27,-1,48,-1,31
1,<environment.Job instance at 0x7fe3f07ee190>,29,12,[4 9],30,-1,44,-1,32
1,<environment.Job instance at 0x7fe3fa99ecd0>,31,15,[10  4],32,-1,49,-1,34
1,<environment.Job instance at 0x7fe3f07eeb90>,27,1,[ 1 14],28,-1,35,-1,34
1,<environment.Job instance at 0x7fe3fa99e0a0>,32,14,[1 8],33,-1,48,-1,34
1,<environment.Job instance at 0x7fe3fa9a8140>,34,14,[8 4],35,-1,49,-1,35
1,<environment.Job instance at 0x7fe3f08d3370>,38,14,[9 5],39,-1,53,-1,39
1,<environment.Job instance at 0x7fe3f08d3280>,41,15,[1 7],42,-1,58,-1,43
1,<environment.Job instance at 0x7fe3f08d3be0>,43,15,[5 2],44,-1,59,-1,44
1,<environment.Job instance at 0x7fe3f08d3f00>,48,19,[6 4],49,-1,69,-1,50
1,<environment.Job instance at 0x7fe3fa85b230>,53,18,[6 5],54,-1,72,-1,54
1,<environment.Job instance at 0x7fe3fa85b780>,54,19,[6 1],55,-1,75,-1,56
1,<environment.Job instance at 0x7fe3fa85b190>,55,16,[ 2 10],56,-1,72,-1,56
1,<environment.Job instance at 0x7fe3fa9a8410>,2,3,[ 4 12],3,-1,6,-1,3
1,<environment.Job instance at 0x7fe3fa99e0f0>,3,12,[ 4 11],4,-1,16,-1,4
1,<environment.Job instance at 0x7fe3f07eea00>,8,23,[ 2 14],9,-1,32,-1,9
1,<environment.Job instance at 0x7fe3f1253410>,18,16,[11  2],19,-1,44,-1,28
1,<environment.Job instance at 0x7fe3f1253af0>,19,18,[ 1 12],20,-1,46,-1,28
1,<environment.Job instance at 0x7fe3f1253b90>,23,15,[ 1 12],24,-1,57,-1,42
1,<environment.Job instance at 0x7fe3f1253be0>,25,3,[ 4 13],26,-1,46,-1,43
1,<environment.Job instance at 0x7fe3f1253eb0>,27,1,[ 1 14],28,-1,46,-1,45
1,<environment.Job instance at 0x7fe3f08c57d0>,40,3,[13  3],41,-1,97,-1,94
1,<environment.Job instance at 0x7fe3f08c54b0>,45,13,[ 1 14],46,-1,113,-1,100
1,<environment.Job instance at 0x7fe3fa9ad9b0>,56,2,[11  5],57,-1,132,-1,130
1,<environment.Job instance at 0x7fe3fa9ad140>,58,3,[14  4],59,-1,135,-1,132
1,<environment.Job instance at 0x7fe3f0cf4410>,8,21,[9 4],9,-1,30,-1,9
1,<environment.Job instance at 0x7fe3f0cf4190>,9,12,[9 3],10,-1,23,-1,11
1,<environment.Job instance at 0x7fe3f0cf40a0>,11,17,[10  2],12,-1,30,-1,13
1,<environment.Job instance at 0x7fe3f08090a0>,10,18,[10  3],11,-1,31,-1,13
1,<environment.Job instance at 0x7fe3f0a62910>,20,13,[10  5],21,-1,35,-1,22
1,<environment.Job instance at 0x7fe3f0a62960>,23,14,[7 5],24,-1,38,-1,24
1,<environment.Job instance at 0x7fe3f0a627d0>,25,14,[10  2],26,-1,40,-1,26
1,<environment.Job instance at 0x7fe3f0d94780>,34,16,[7 2],35,-1,51,-1,35
1,<environment.Job instance at 0x7fe3f0d94eb0>,36,12,[ 3 10],37,-1,49,-1,37
1,<environment.Job instance at 0x7fe3f0d945a0>,40,18,[4 5],41,-1,59,-1,41
1,<environment.Job instance at 0x7fe3f09326e0>,41,18,[2 8],42,-1,60,-1,42
1,<environment.Job instance at 0x7fe3f0932550>,43,14,[11  3],44,-1,58,-1,44
1,<environment.Job instance at 0x7fe3f0932e10>,44,16,[9 4],45,-1,61,-1,45
1,<environment.Job instance at 0x7fe3f09320a0>,46,14,[10  1],47,-1,62,-1,48
1,<environment.Job instance at 0x7fe3f0932b40>,47,16,[9 2],48,-1,64,-1,48
1,<environment.Job instance at 0x7fe3f09322d0>,50,13,[7 4],51,-1,64,-1,51
1,<environment.Job instance at 0x7fe3f0932dc0>,52,20,[1 7],53,-1,73,-1,53
1,<environment.Job instance at 0x7fe3f07d7320>,55,1,[10  1],56,-1,57,-1,56
1,<environment.Job instance at 0x7fe3f07d7dc0>,56,19,[2 7],57,-1,76,-1,57
1,<environment.Job instance at 0x7fe3f07d7730>,58,18,[6 3],59,-1,77,-1,59
1,<environment.Job instance at 0x7fe3f07d7870>,18,12,[14  4],19,-1,44,-1,32
1,<environment.Job instance at 0x7fe3f0835500>,28,2,[13  1],29,-1,63,-1,61
1,<environment.Job instance at 0x7fe3f08354b0>,31,3,[13  5],32,-1,73,-1,70
1,<environment.Job instance at 0x7fe3f0835640>,32,2,[ 1 12],33,-1,72,-1,70
1,<environment.Job instance at 0x7fe3f0958230>,42,1,[ 4 13],43,-1,91,-1,90
1,<environment.Job instance at 0x7fe3f09584b0>,43,14,[11  3],44,-1,104,-1,90
1,<environment.Job instance at 0x7fe3f0f24a50>,4,16,[7 5],5,-1,23,-1,7
1,<environment.Job instance at 0x7fe3f0f24cd0>,6,16,[7 4],7,-1,23,-1,7
1,<environment.Job instance at 0x7fe3f0f24f50>,8,18,[4 6],9,-1,30,-1,12
1,<environment.Job instance at 0x7fe3f0f48050>,12,26,[8 4],13,-1,39,-1,13
1,<environment.Job instance at 0x7fe3f0f480a0>,14,14,[5 5],15,-1,29,-1,15
1,<environment.Job instance at 0x7fe3f0f244b0>,11,27,[4 7],12,-1,43,-1,16
1,<environment.Job instance at 0x7fe3f0f49500>,18,18,[4 5],19,-1,38,-1,20
1,<environment.Job instance at 0x7fe3f0c7e7d0>,27,13,[9 2],28,-1,42,-1,29
1,<environment.Job instance at 0x7fe3f0c70d20>,28,15,[3 6],29,-1,44,-1,29
1,<environment.Job instance at 0x7fe3f1098dc0>,30,17,[2 6],31,-1,48,-1,31
1,<environment.Job instance at 0x7fe3f10a3f00>,33,23,[10  1],34,-1,57,-1,34
1,<environment.Job instance at 0x7fe3f10a45f0>,36,28,[6 5],37,-1,65,-1,37
1,<environment.Job instance at 0x7fe3f10b7f00>,37,18,[5 9],38,-1,56,-1,38
1,<environment.Job instance at 0x7fe3f10b4d20>,44,15,[10  4],45,-1,61,-1,46
1,<environment.Job instance at 0x7fe3f10a0960>,48,13,[8 5],49,-1,62,-1,49
1,<environment.Job instance at 0x7fe3f10a0730>,49,28,[5 3],50,-1,78,-1,50
1,<environment.Job instance at 0x7fe3f10a05a0>,50,18,[6 1],51,-1,69,-1,51
1,<environment.Job instance at 0x7fe3f10a0820>,52,18,[8 2],53,-1,71,-1,53
1,<environment.Job instance at 0x7fe3f102b780>,55,17,[4 6],56,-1,73,-1,56
1,<environment.Job instance at 0x7fe3f0f24370>,0,24,[ 1 10],1,-1,25,-1,1
1,<environment.Job instance at 0x7fe3f0f32eb0>,3,24,[7 4],4,-1,28,-1,4
1,<environment.Job instance at 0x7fe3f0c7e3c0>,5,3,[12  3],6,-1,9,-1,6
1,<environment.Job instance at 0x7fe3f0f17c80>,11,27,[4 7],12,-1,49,-1,22
1,<environment.Job instance at 0x7fe3f10b4aa0>,12,26,[8 4],13,-1,48,-1,22
1,<environment.Job instance at 0x7fe3f0d915f0>,15,16,[14  1],16,-1,38,-1,22
1,<environment.Job instance at 0x7fe3f0d91370>,20,25,[ 3 10],21,-1,68,-1,43
1,<environment.Job instance at 0x7fe3f08356e0>,33,23,[10  1],34,-1,89,-1,66
1,<environment.Job instance at 0x7fe3f08355f0>,36,28,[6 5],37,-1,95,-1,67
1,<environment.Job instance at 0x7fe3f0835960>,41,15,[14  1],42,-1,95,-1,80
1,<environment.Job instance at 0x7fe3f07d7eb0>,45,18,[11  3],46,-1,102,-1,84
1,<environment.Job instance at 0x7fe3f07d7910>,49,28,[5 3],50,-1,130,-1,102
1,<environment.Job instance at 0x7fe3f0bcc500>,2,25,[6 3],3,-1,28,-1,3
1,<environment.Job instance at 0x7fe3f0bcccd0>,4,17,[9 4],5,-1,23,-1,6
1,<environment.Job instance at 0x7fe3fa8b87d0>,5,13,[6 4],6,-1,20,-1,7
1,<environment.Job instance at 0x7fe3f0941870>,8,17,[3 6],9,-1,26,-1,9
1,<environment.Job instance at 0x7fe3f0941500>,9,15,[ 5 10],10,-1,25,-1,10
1,<environment.Job instance at 0x7fe3f1dc5140>,11,14,[8 2],12,-1,28,-1,14
1,<environment.Job instance at 0x7fe3f1dc5500>,13,20,[2 6],14,-1,38,-1,18
1,<environment.Job instance at 0x7fe3f169a4b0>,26,15,[2 7],27,-1,42,-1,27
1,<environment.Job instance at 0x7fe3f169aaf0>,28,15,[7 5],29,-1,44,-1,29
1,<environment.Job instance at 0x7fe3f169ad70>,29,15,[ 3 10],30,-1,45,-1,30
1,<environment.Job instance at 0x7fe3f16a1140>,30,24,[2 8],31,-1,56,-1,32
1,<environment.Job instance at 0x7fe3f169a820>,31,24,[9 1],32,-1,56,-1,32
1,<environment.Job instance at 0x7fe3f16a1280>,41,17,[10  3],42,-1,59,-1,42
1,<environment.Job instance at 0x7fe3f16a1050>,35,15,[ 1 11],36,-1,58,-1,43
1,<environment.Job instance at 0x7fe3f0bc8410>,45,12,[ 4 10],46,-1,58,-1,46
1,<environment.Job instance at 0x7fe3f0bc8370>,50,14,[8 3],51,-1,66,-1,52
1,<environment.Job instance at 0x7fe3f0bc8dc0>,54,18,[3 6],55,-1,73,-1,55
1,<environment.Job instance at 0x7fe3f0bc8320>,56,16,[9 2],57,-1,75,-1,59
1,<environment.Job instance at 0x7fe3f1dc5eb0>,2,25,[6 3],3,-1,30,-1,5
1,<environment.Job instance at 0x7fe3f0f21cd0>,19,18,[13  1],20,-1,48,-1,30
1,<environment.Job instance at 0x7fe3f0bb3e10>,22,3,[ 3 11],23,-1,34,-1,31
1,<environment.Job instance at 0x7fe3f0bb3eb0>,30,24,[2 8],31,-1,84,-1,60
1,<environment.Job instance at 0x7fe3f0bb3730>,31,24,[9 1],32,-1,97,-1,73
1,<environment.Job instance at 0x7fe3f0ba2c80>,33,24,[10  5],34,-1,97,-1,73
1,<environment.Job instance at 0x7fe3f0ba2690>,34,23,[10  2],35,-1,96,-1,73
1,<environment.Job instance at 0x7fe3f0ba21e0>,35,15,[ 1 11],36,-1,88,-1,73
1,<environment.Job instance at 0x7fe3f0ba26e0>,47,15,[ 3 12],48,-1,117,-1,102
1,<environment.Job instance at 0x7fe3f093a910>,0,27,[ 5 10],1,-1,28,-1,1
1,<environment.Job instance at 0x7fe3f093a050>,1,17,[7 5],2,-1,19,-1,2
1,<environment.Job instance at 0x7fe3f0c9fd70>,4,15,[4 6],5,-1,20,-1,5
1,<environment.Job instance at 0x7fe3f0c9fe10>,6,25,[ 5 10],7,-1,32,-1,7
1,<environment.Job instance at 0x7fe3f0c9f6e0>,8,18,[1 5],9,-1,27,-1,9
1,<environment.Job instance at 0x7fe3f0cc0b40>,20,14,[7 5],21,-1,35,-1,21
1,<environment.Job instance at 0x7fe3f0cc0e60>,25,16,[10  4],26,-1,44,-1,28
1,<environment.Job instance at 0x7fe3f0ca0370>,28,14,[7 5],29,-1,43,-1,29
1,<environment.Job instance at 0x7fe3f0ca0460>,30,18,[9 5],31,-1,49,-1,31
1,<environment.Job instance at 0x7fe3f0ca0820>,34,17,[7 2],35,-1,52,-1,35
1,<environment.Job instance at 0x7fe3f0ca0c80>,37,15,[2 9],38,-1,53,-1,38
1,<environment.Job instance at 0x7fe3f0ca0cd0>,39,17,[8 1],40,-1,57,-1,40
1,<environment.Job instance at 0x7fe3f0ca0e10>,41,17,[2 6],42,-1,59,-1,42
1,<environment.Job instance at 0x7fe3f0ca8140>,42,19,[8 2],43,-1,62,-1,43
1,<environment.Job instance at 0x7fe3f0ca8780>,48,14,[ 2 10],49,-1,63,-1,49
1,<environment.Job instance at 0x7fe3f0ca88c0>,49,17,[9 1],50,-1,67,-1,50
1,<environment.Job instance at 0x7fe3f0ca8690>,50,18,[3 5],51,-1,69,-1,51
1,<environment.Job instance at 0x7fe3f0ca36e0>,55,13,[ 1 10],56,-1,69,-1,56
1,<environment.Job instance at 0x7fe3f0ca3af0>,58,14,[4 6],59,-1,73,-1,59
1,<environment.Job instance at 0x7fe3f0cc0140>,0,27,[ 5 10],1,-1,28,-1,1
1,<environment.Job instance at 0x7fe3f0ca06e0>,6,25,[ 5 10],7,-1,40,-1,15
1,<environment.Job instance at 0x7fe3f0ba29b0>,22,17,[12  4],23,-1,61,-1,44
1,<environment.Job instance at 0x7fe3f0ba2140>,35,2,[ 4 11],36,-1,63,-1,61
1,<environment.Job instance at 0x7fe3f0f32f50>,43,2,[ 2 14],44,-1,94,-1,92
1,<environment.Job instance at 0x7fe3f0c7e3c0>,44,17,[ 5 14],45,-1,109,-1,92
1,<environment.Job instance at 0x7fe3f0f49190>,46,2,[11  3],47,-1,94,-1,92
1,<environment.Job instance at 0x7fe3f0f24910>,47,2,[12  2],48,-1,94,-1,92
1,<environment.Job instance at 0x7fe3f169a8c0>,52,2,[12  5],53,-1,126,-1,124
1,<environment.Job instance at 0x7fe3f1dc50f0>,54,1,[14  4],55,-1,125,-1,124
1,<environment.Job instance at 0x7fe3f09cbf00>,3,13,[4 9],4,-1,17,-1,4
1,<environment.Job instance at 0x7fe3f09cb0a0>,5,14,[7 4],6,-1,20,-1,6
1,<environment.Job instance at 0x7fe3f09dc5a0>,10,16,[10  2],11,-1,27,-1,11
1,<environment.Job instance at 0x7fe3f09dce60>,14,21,[7 2],15,-1,36,-1,15
1,<environment.Job instance at 0x7fe3f09dc5f0>,15,12,[ 1 10],16,-1,28,-1,16
1,<environment.Job instance at 0x7fe3f0a80be0>,18,16,[6 3],19,-1,35,-1,19
1,<environment.Job instance at 0x7fe3f0a80af0>,19,14,[5 7],20,-1,34,-1,20
1,<environment.Job instance at 0x7fe3f0a800a0>,20,18,[4 7],21,-1,39,-1,21
1,<environment.Job instance at 0x7fe3f0a801e0>,28,15,[8 5],29,-1,45,-1,30
1,<environment.Job instance at 0x7fe3f1e0f5f0>,29,27,[1 5],30,-1,57,-1,30
1,<environment.Job instance at 0x7fe3f0cefaf0>,36,18,[4 6],37,-1,55,-1,37
1,<environment.Job instance at 0x7fe3f0bb2410>,49,27,[9 3],50,-1,77,-1,50
1,<environment.Job instance at 0x7fe3f0cefe10>,38,17,[7 4],39,-1,68,-1,51
1,<environment.Job instance at 0x7fe3f0bb2640>,50,15,[7 5],51,-1,68,-1,53
1,<environment.Job instance at 0x7fe3f0bb2910>,13,1,[ 5 12],14,-1,18,-1,17
1,<environment.Job instance at 0x7fe3f0f483c0>,22,14,[ 1 11],23,-1,62,-1,48
1,<environment.Job instance at 0x7fe3f0ba2af0>,24,3,[14  4],25,-1,59,-1,56
1,<environment.Job instance at 0x7fe3f0ba2b40>,26,2,[13  4],27,-1,64,-1,62
1,<environment.Job instance at 0x7fe3f0ba2d20>,29,27,[1 5],30,-1,94,-1,67
1,<environment.Job instance at 0x7fe3f0cb37d0>,35,14,[ 5 12],36,-1,99,-1,85
1,<environment.Job instance at 0x7fe3f0cb3b40>,37,19,[14  4],38,-1,104,-1,85
1,<environment.Job instance at 0x7fe3f0cb3be0>,39,14,[ 5 11],40,-1,102,-1,88
1,<environment.Job instance at 0x7fe3f0ca0b90>,46,25,[3 8],47,-1,135,-1,110
1,<environment.Job instance at 0x7fe3f0ca0910>,48,3,[ 5 14],49,-1,113,-1,110
1,<environment.Job instance at 0x7fe3f169b0a0>,49,27,[9 3],50,-1,139,-1,112
1,<environment.Job instance at 0x7fe3f0cc05f0>,52,24,[ 3 10],53,-1,148,-1,124
1,<environment.Job instance at 0x7fe3f09f6be0>,57,12,[ 2 12],58,-1,139,-1,127
1,<environment.Job instance at 0x7fe3f09f6f00>,58,27,[1 7],59,-1,156,-1,129
1,<environment.Job instance at 0x7fe3f174f6e0>,4,16,[10  3],5,-1,21,-1,5
1,<environment.Job instance at 0x7fe3fa414dc0>,8,14,[10  3],9,-1,23,-1,9
1,<environment.Job instance at 0x7fe3fa4149b0>,10,19,[1 5],11,-1,30,-1,11
1,<environment.Job instance at 0x7fe3fa414140>,11,18,[2 9],12,-1,30,-1,12
1,<environment.Job instance at 0x7fe3fa414f50>,12,18,[10  4],13,-1,31,-1,13
1,<environment.Job instance at 0x7fe3fa414280>,13,13,[6 5],14,-1,32,-1,19
1,<environment.Job instance at 0x7fe3fa414190>,19,15,[9 5],20,-1,35,-1,20
1,<environment.Job instance at 0x7fe3fa414c80>,21,13,[5 3],22,-1,35,-1,22
1,<environment.Job instance at 0x7fe3fa414910>,23,18,[5 9],24,-1,49,-1,31
1,<environment.Job instance at 0x7fe3fa414be0>,24,12,[6 4],25,-1,43,-1,31
1,<environment.Job instance at 0x7fe3f18d0460>,28,14,[5 9],29,-1,45,-1,31
1,<environment.Job instance at 0x7fe3f18d01e0>,29,19,[9 1],30,-1,51,-1,32
1,<environment.Job instance at 0x7fe3f18d0b40>,31,16,[6 5],32,-1,50,-1,34
1,<environment.Job instance at 0x7fe3f18d0b90>,30,12,[2 5],31,-1,47,-1,35
1,<environment.Job instance at 0x7fe3f18d02d0>,33,27,[1 8],34,-1,62,-1,35
1,<environment.Job instance at 0x7fe3fa8d7af0>,36,14,[3 9],37,-1,55,-1,41
1,<environment.Job instance at 0x7fe3fa371370>,41,18,[8 4],42,-1,60,-1,42
1,<environment.Job instance at 0x7fe3fa371af0>,45,13,[10  4],46,-1,59,-1,46
1,<environment.Job instance at 0x7fe3fa3712d0>,46,16,[5 5],47,-1,78,-1,62
1,<environment.Job instance at 0x7fe3fa371690>,51,18,[3 6],52,-1,83,-1,65
1,<environment.Job instance at 0x7fe3fa371500>,44,17,[3 9],45,-1,82,-1,65
1,<environment.Job instance at 0x7fe3fa371f00>,54,14,[7 1],55,-1,79,-1,65
1,<environment.Job instance at 0x7fe3fa489500>,58,16,[8 5],59,-1,84,-1,68
1,<environment.Job instance at 0x7fe3f0c6b140>,15,2,[14  5],16,-1,36,-1,34
1,<environment.Job instance at 0x7fe3f09f6be0>,33,27,[1 8],34,-1,127,-1,100
1,<environment.Job instance at 0x7fe3f1bd7780>,53,3,[ 3 14],54,-1,184,-1,181
1,<environment.Job instance at 0x7fe3fa3df3c0>,55,25,[6 3],56,-1,208,-1,183
1,<environment.Job instance at 0x7fe3f18f0820>,2,16,[9 2],3,-1,20,-1,4
1,<environment.Job instance at 0x7fe3f18f0cd0>,4,1,[5 7],5,-1,6,-1,5
1,<environment.Job instance at 0x7fe3f18f0910>,5,18,[7 5],6,-1,24,-1,6
1,<environment.Job instance at 0x7fe3f18f03c0>,3,15,[6 3],4,-1,21,-1,6
1,<environment.Job instance at 0x7fe3f1da6aa0>,8,17,[10  3],9,-1,27,-1,10
1,<environment.Job instance at 0x7fe3f1da6be0>,10,1,[6 3],11,-1,12,-1,11
1,<environment.Job instance at 0x7fe3f1da6dc0>,11,22,[ 1 10],12,-1,34,-1,12
1,<environment.Job instance at 0x7fe3f1da6a50>,12,18,[5 1],13,-1,31,-1,13
1,<environment.Job instance at 0x7fe3f1da69b0>,13,2,[5 6],14,-1,16,-1,14
1,<environment.Job instance at 0x7fe3f1da6d20>,14,2,[2 5],15,-1,17,-1,15
1,<environment.Job instance at 0x7fe3f1da6730>,15,3,[6 5],16,-1,19,-1,16
1,<environment.Job instance at 0x7fe3f1da6a00>,16,3,[8 2],17,-1,20,-1,17
1,<environment.Job instance at 0x7fe3f1da6320>,17,13,[7 3],18,-1,31,-1,18
1,<environment.Job instance at 0x7fe3f1da65f0>,18,20,[6 2],19,-1,39,-1,19
1,<environment.Job instance at 0x7fe3f1da64b0>,19,15,[ 1 10],20,-1,35,-1,20
1,<environment.Job instance at 0x7fe3f18f0fa0>,9,27,[ 5 10],10,-1,47,-1,20
1,<environment.Job instance at 0x7fe3f0cef870>,25,17,[7 1],26,-1,43,-1,26
1,<environment.Job instance at 0x7fe3f0cef0a0>,27,18,[1 7],28,-1,46,-1,28
1,<environment.Job instance at 0x7fe3f0cef690>,29,14,[10  1],30,-1,46,-1,32
1,<environment.Job instance at 0x7fe3f0cef7d0>,32,18,[5 5],33,-1,51,-1,33
1,<environment.Job instance at 0x7fe3f0cef6e0>,34,12,[8 4],35,-1,47,-1,35
1,<environment.Job instance at 0x7fe3f0cef730>,35,15,[7 4],36,-1,51,-1,36
1,<environment.Job instance at 0x7fe3fa4444b0>,38,21,[5 8],39,-1,60,-1,39
1,<environment.Job instance at 0x7fe3fa444320>,39,17,[7 2],40,-1,57,-1,40
1,<environment.Job instance at 0x7fe3fa444fa0>,41,28,[2 8],42,-1,70,-1,42
1,<environment.Job instance at 0x7fe3fa444820>,42,18,[5 1],43,-1,61,-1,43
1,<environment.Job instance at 0x7fe3fa4448c0>,43,27,[9 3],44,-1,71,-1,44
1,<environment.Job instance at 0x7fe3fa444730>,44,12,[6 5],45,-1,57,-1,45
1,<environment.Job instance at 0x7fe3fa444870>,46,28,[1 7],47,-1,75,-1,47
1,<environment.Job instance at 0x7fe3f0cef410>,31,14,[10  4],32,-1,61,-1,47
1,<environment.Job instance at 0x7fe3f0cef1e0>,0,2,[ 5 11],1,-1,3,-1,1
1,<environment.Job instance at 0x7fe3fa3df690>,9,27,[ 5 10],10,-1,46,-1,19
1,<environment.Job instance at 0x7fe3f0ca0b90>,26,13,[11  1],27,-1,68,-1,55
1,<environment.Job instance at 0x7fe3f107cc80>,28,12,[ 5 12],29,-1,67,-1,55
1,<environment.Job instance at 0x7fe3f1979320>,41,28,[2 8],42,-1,150,-1,122
1,<environment.Job instance at 0x7fe3f1979820>,43,27,[9 3],44,-1,166,-1,139
1,<environment.Job instance at 0x7fe3f1701f50>,46,28,[1 7],47,-1,167,-1,139
1,<environment.Job instance at 0x7fe3f1701280>,49,2,[ 4 11],50,-1,149,-1,147
1,<environment.Job instance at 0x7fe3f1701f00>,54,3,[11  1],55,-1,155,-1,152
1,<environment.Job instance at 0x7fe3f1701960>,56,28,[9 2],57,-1,184,-1,156
1,<environment.Job instance at 0x7fe3f12b8820>,14,15,[9 1],15,-1,31,-1,16
1,<environment.Job instance at 0x7fe3f1a2f0f0>,15,15,[ 2 11],16,-1,31,-1,16
1,<environment.Job instance at 0x7fe3f12b8c80>,16,23,[7 4],17,-1,40,-1,17
1,<environment.Job instance at 0x7fe3f09ce7d0>,18,17,[5 5],19,-1,46,-1,29
1,<environment.Job instance at 0x7fe3f0d835f0>,20,15,[9 4],21,-1,50,-1,35
1,<environment.Job instance at 0x7fe3f16c4280>,34,15,[10  3],35,-1,50,-1,35
1,<environment.Job instance at 0x7fe3f16c4730>,35,20,[4 7],36,-1,56,-1,36
1,<environment.Job instance at 0x7fe3f16c41e0>,36,21,[6 5],37,-1,59,-1,38
1,<environment.Job instance at 0x7fe3fa44f230>,23,20,[5 4],24,-1,60,-1,40
1,<environment.Job instance at 0x7fe3f16c4fa0>,38,1,[ 3 10],39,-1,41,-1,40
1,<environment.Job instance at 0x7fe3fa489af0>,39,17,[5 9],40,-1,57,-1,40
1,<environment.Job instance at 0x7fe3fa489fa0>,40,15,[4 5],41,-1,57,-1,42
1,<environment.Job instance at 0x7fe3fa4892d0>,42,21,[1 6],43,-1,64,-1,43
1,<environment.Job instance at 0x7fe3fa489280>,43,17,[8 5],44,-1,61,-1,44
1,<environment.Job instance at 0x7fe3fa489d70>,45,16,[4 5],46,-1,62,-1,46
1,<environment.Job instance at 0x7fe3f11a0b40>,48,16,[ 5 10],49,-1,68,-1,52
1,<environment.Job instance at 0x7fe3f0c6a960>,56,25,[ 5 10],57,-1,84,-1,59
1,<environment.Job instance at 0x7fe3fa4890a0>,7,3,[ 1 12],8,-1,11,-1,8
1,<environment.Job instance at 0x7fe3f11a07d0>,8,15,[ 3 11],9,-1,24,-1,9
1,<environment.Job instance at 0x7fe3f1701370>,15,15,[ 2 11],16,-1,31,-1,16
1,<environment.Job instance at 0x7fe3f1701c80>,16,23,[7 4],17,-1,42,-1,19
1,<environment.Job instance at 0x7fe3f1c594b0>,30,16,[14  3],31,-1,72,-1,56
1,<environment.Job instance at 0x7fe3f0abd190>,41,27,[5 1],42,-1,104,-1,77
1,<environment.Job instance at 0x7fe3f18f05f0>,46,25,[8 3],47,-1,117,-1,92
1,<environment.Job instance at 0x7fe3f0cef1e0>,47,13,[13  1],48,-1,105,-1,92
1,<environment.Job instance at 0x7fe3f0c6a8c0>,56,25,[ 5 10],57,-1,160,-1,135
1,<environment.Job instance at 0x7fe3f1707780>,2,18,[5 9],3,-1,21,-1,3
1,<environment.Job instance at 0x7fe3f0c04140>,3,16,[6 5],4,-1,20,-1,4
1,<environment.Job instance at 0x7fe3f0c04f00>,8,18,[1 9],9,-1,27,-1,9
1,<environment.Job instance at 0x7fe3f0c04410>,10,15,[3 9],11,-1,26,-1,11
1,<environment.Job instance at 0x7fe3f0b13f50>,14,17,[9 5],15,-1,32,-1,15
1,<environment.Job instance at 0x7fe3f1a3ba50>,15,16,[5 3],16,-1,32,-1,16
1,<environment.Job instance at 0x7fe3f15d57d0>,18,14,[9 4],19,-1,33,-1,19
1,<environment.Job instance at 0x7fe3f1858c80>,19,13,[3 6],20,-1,34,-1,21
1,<environment.Job instance at 0x7fe3f15e1a00>,20,26,[6 3],21,-1,47,-1,21
1,<environment.Job instance at 0x7fe3f144bbe0>,21,14,[4 6],22,-1,36,-1,22
1,<environment.Job instance at 0x7fe3f0914640>,27,17,[4 9],28,-1,47,-1,30
1,<environment.Job instance at 0x7fe3f1a13280>,31,17,[10  4],32,-1,50,-1,33
1,<environment.Job instance at 0x7fe3f08e05a0>,35,18,[10  3],36,-1,54,-1,36
1,<environment.Job instance at 0x7fe3f1851050>,44,18,[4 7],45,-1,73,-1,55
1,<environment.Job instance at 0x7fe3f1e1d640>,53,16,[4 9],54,-1,71,-1,55
1,<environment.Job instance at 0x7fe3f04da9b0>,16,2,[13  5],17,-1,40,-1,38
1,<environment.Job instance at 0x7fe3f0500d20>,20,26,[6 3],21,-1,83,-1,57
1,<environment.Job instance at 0x7fe3f0500320>,22,17,[ 2 11],23,-1,74,-1,57
1,<environment.Job instance at 0x7fe3f0fa3870>,25,23,[7 1],26,-1,83,-1,60
1,<environment.Job instance at 0x7fe3f04f5730>,33,12,[ 1 14],34,-1,90,-1,78
1,<environment.Job instance at 0x7fe3f05169b0>,36,13,[13  3],37,-1,105,-1,92
1,<environment.Job instance at 0x7fe3f0516280>,38,1,[ 3 14],39,-1,93,-1,92
1,<environment.Job instance at 0x7fe3f14c4640>,51,14,[ 3 14],52,-1,159,-1,145
1,<environment.Job instance at 0x7fe3f18b46e0>,55,13,[ 1 12],56,-1,173,-1,160
1,<environment.Job instance at 0x7fe3f0cedeb0>,56,17,[11  2],57,-1,177,-1,160
1,<environment.Job instance at 0x7fe3f18e8460>,0,28,[5 6],1,-1,29,-1,1
1,<environment.Job instance at 0x7fe3f18e8320>,4,17,[6 5],5,-1,23,-1,6
1,<environment.Job instance at 0x7fe3f1850280>,5,23,[5 3],6,-1,29,-1,6
1,<environment.Job instance at 0x7fe3f18c5410>,7,16,[ 5 10],8,-1,27,-1,11
1,<environment.Job instance at 0x7fe3f18c50f0>,12,16,[9 4],13,-1,30,-1,14
1,<environment.Job instance at 0x7fe3f18bf960>,23,18,[ 1 10],24,-1,47,-1,29
1,<environment.Job instance at 0x7fe3f18c5af0>,16,15,[9 5],17,-1,45,-1,30
1,<environment.Job instance at 0x7fe3f18bfa50>,27,18,[10  5],28,-1,48,-1,30
1,<environment.Job instance at 0x7fe3f18c7b40>,39,17,[9 4],40,-1,82,-1,65
1,<environment.Job instance at 0x7fe3f18c7410>,43,15,[10  4],44,-1,80,-1,65
1,<environment.Job instance at 0x7fe3f18c7370>,41,18,[4 8],42,-1,85,-1,67
1,<environment.Job instance at 0x7fe3f17ab140>,46,15,[ 5 10],47,-1,82,-1,67
1,<environment.Job instance at 0x7fe3f0e40690>,52,18,[9 4],53,-1,112,-1,94
1,<environment.Job instance at 0x7fe3f142ea00>,53,18,[ 4 10],54,-1,112,-1,94
1,<environment.Job instance at 0x7fe3f18c5d20>,0,28,[5 6],1,-1,29,-1,1
1,<environment.Job instance at 0x7fe3f18bf0f0>,3,28,[ 1 11],4,-1,32,-1,4
1,<environment.Job instance at 0x7fe3f0ad8a50>,5,23,[5 3],6,-1,29,-1,6
1,<environment.Job instance at 0x7fe3f18e8c30>,6,14,[13  5],7,-1,21,-1,7
1,<environment.Job instance at 0x7fe3f0811b90>,10,13,[12  5],11,-1,24,-1,11
1,<environment.Job instance at 0x7fe3f07d8140>,18,15,[ 3 13],19,-1,39,-1,24
1,<environment.Job instance at 0x7fe3f1a3b4b0>,26,18,[ 3 13],27,-1,74,-1,56
1,<environment.Job instance at 0x7fe3f0ae3910>,37,2,[ 4 14],38,-1,92,-1,90
1,<environment.Job instance at 0x7fe3f0981870>,44,2,[ 1 12],45,-1,108,-1,106
1,<environment.Job instance at 0x7fe3f0968e60>,50,25,[2 8],51,-1,165,-1,140
1,<environment.Job instance at 0x7fe3f044d8c0>,54,3,[ 3 14],55,-1,156,-1,153
1,<environment.Job instance at 0x7fe3f0b09410>,1,16,[ 4 10],2,-1,19,-1,3
1,<environment.Job instance at 0x7fe3f0af5f00>,4,15,[ 2 10],5,-1,21,-1,6
1,<environment.Job instance at 0x7fe3f0bb4dc0>,6,18,[9 4],7,-1,25,-1,7
1,<environment.Job instance at 0x7fe3f0b09190>,5,16,[4 6],6,-1,24,-1,8
1,<environment.Job instance at 0x7fe3f129a370>,9,16,[2 8],10,-1,27,-1,11
1,<environment.Job instance at 0x7fe3f0b085a0>,13,18,[ 5 10],14,-1,32,-1,14
1,<environment.Job instance at 0x7fe3f0b087d0>,14,20,[9 5],15,-1,35,-1,15
1,<environment.Job instance at 0x7fe3f0b08190>,15,17,[7 4],16,-1,33,-1,16
1,<environment.Job instance at 0x7fe3f0b08140>,16,18,[4 6],17,-1,35,-1,17
1,<environment.Job instance at 0x7fe3f1da1e60>,23,17,[10  5],24,-1,41,-1,24
1,<environment.Job instance at 0x7fe3f1da12d0>,24,17,[3 6],25,-1,42,-1,25
1,<environment.Job instance at 0x7fe3fa76df50>,31,16,[2 7],32,-1,48,-1,32
1,<environment.Job instance at 0x7fe3f0b7b0a0>,32,15,[3 8],33,-1,49,-1,34
1,<environment.Job instance at 0x7fe3f1dcab90>,34,13,[5 4],35,-1,48,-1,35
1,<environment.Job instance at 0x7fe3f0aec0f0>,37,25,[9 4],38,-1,63,-1,38
1,<environment.Job instance at 0x7fe3f1095dc0>,35,15,[9 1],36,-1,56,-1,41
1,<environment.Job instance at 0x7fe3f0aec410>,40,16,[2 8],41,-1,58,-1,42
1,<environment.Job instance at 0x7fe3f08e0c30>,42,17,[1 7],43,-1,61,-1,44
1,<environment.Job instance at 0x7fe3f08e08c0>,43,17,[6 4],44,-1,61,-1,44
1,<environment.Job instance at 0x7fe3f08e03c0>,45,16,[1 6],46,-1,62,-1,46
1,<environment.Job instance at 0x7fe3f0adfbe0>,51,18,[9 3],52,-1,72,-1,54
1,<environment.Job instance at 0x7fe3f0b15a00>,54,25,[7 4],55,-1,84,-1,59
1,<environment.Job instance at 0x7fe3f0ae80a0>,8,1,[ 3 12],9,-1,10,-1,9
1,<environment.Job instance at 0x7fe3f0b11e10>,25,18,[14  2],26,-1,86,-1,68
1,<environment.Job instance at 0x7fe3f1314500>,37,25,[9 4],38,-1,153,-1,128
1,<environment.Job instance at 0x7fe3f1314af0>,41,3,[ 4 12],42,-1,133,-1,130
1,<environment.Job instance at 0x7fe3f11f55a0>,46,16,[14  3],47,-1,162,-1,146
1,<environment.Job instance at 0x7fe3f11f5730>,47,14,[12  5],48,-1,160,-1,146
1,<environment.Job instance at 0x7fe3f11f5f00>,54,25,[7 4],55,-1,205,-1,180
1,<environment.Job instance at 0x7fe3f1000c80>,2,18,[5 8],3,-1,21,-1,3
1,<environment.Job instance at 0x7fe3f1000f00>,5,23,[8 2],6,-1,29,-1,6
1,<environment.Job instance at 0x7fe3f0e873c0>,10,16,[5 9],11,-1,27,-1,11
1,<environment.Job instance at 0x7fe3f0e87460>,11,15,[9 5],12,-1,27,-1,12
1,<environment.Job instance at 0x7fe3f0e87140>,12,14,[9 1],13,-1,28,-1,14
1,<environment.Job instance at 0x7fe3f0e87640>,15,3,[11  2],16,-1,19,-1,16
1,<environment.Job instance at 0x7fe3f0e87500>,17,12,[5 4],18,-1,30,-1,18
1,<environment.Job instance at 0x7fe3f0e87960>,18,14,[8 1],19,-1,33,-1,19
1,<environment.Job instance at 0x7fe3f0981870>,13,18,[ 2 11],14,-1,37,-1,19
1,<environment.Job instance at 0x7fe3f0e879b0>,19,16,[ 4 10],20,-1,36,-1,20
1,<environment.Job instance at 0x7fe3f0e87a50>,20,18,[5 8],21,-1,39,-1,21
1,<environment.Job instance at 0x7fe3f0e87af0>,21,17,[3 7],22,-1,39,-1,22
1,<environment.Job instance at 0x7fe3f0e8e3c0>,31,15,[7 5],32,-1,47,-1,32
1,<environment.Job instance at 0x7fe3f0e8e6e0>,32,13,[14  4],33,-1,46,-1,33
1,<environment.Job instance at 0x7fe3f0e8e5a0>,33,16,[8 2],34,-1,50,-1,34
1,<environment.Job instance at 0x7fe3f0e8e7d0>,34,2,[5 2],35,-1,37,-1,35
1,<environment.Job instance at 0x7fe3f0e8e910>,36,17,[9 3],37,-1,54,-1,37
1,<environment.Job instance at 0x7fe3f0e8ecd0>,39,15,[5 6],40,-1,55,-1,40
1,<environment.Job instance at 0x7fe3f0e8ee10>,40,15,[9 1],41,-1,56,-1,41
1,<environment.Job instance at 0x7fe3f0e8ef50>,43,16,[ 4 10],44,-1,60,-1,44
1,<environment.Job instance at 0x7fe3f0e6c410>,44,18,[1 8],45,-1,64,-1,46
1,<environment.Job instance at 0x7fe3f0fea870>,48,18,[5 8],49,-1,67,-1,49
1,<environment.Job instance at 0x7fe3f0feae60>,50,20,[9 5],51,-1,71,-1,51
1,<environment.Job instance at 0x7fe3f0fea500>,54,15,[7 5],55,-1,70,-1,55
1,<environment.Job instance at 0x7fe3f0e8e960>,5,23,[8 2],6,-1,31,-1,8
1,<environment.Job instance at 0x7fe3f1000af0>,13,18,[ 2 11],14,-1,34,-1,16
1,<environment.Job instance at 0x7fe3f11f5320>,15,3,[11  2],16,-1,21,-1,18
1,<environment.Job instance at 0x7fe3f11f5a00>,22,23,[7 1],23,-1,76,-1,53
1,<environment.Job instance at 0x7fe3f11f5820>,25,3,[13  2],26,-1,71,-1,68
1,<environment.Job instance at 0x7fe3f1314b40>,28,1,[13  4],29,-1,70,-1,69
1,<environment.Job instance at 0x7fe3f1314780>,32,13,[14  4],33,-1,96,-1,83
1,<environment.Job instance at 0x7fe3f18bf820>,41,23,[ 3 13],42,-1,142,-1,119
1,<environment.Job instance at 0x7fe3f0fe37d0>,1,18,[3 7],2,-1,20,-1,2
1,<environment.Job instance at 0x7fe3f0fe3dc0>,2,17,[1 9],3,-1,20,-1,3
1,<environment.Job instance at 0x7fe3f0feafa0>,4,22,[9 5],5,-1,27,-1,5
1,<environment.Job instance at 0x7fe3f0feaf00>,7,16,[5 8],8,-1,24,-1,8
1,<environment.Job instance at 0x7fe3f0feaf50>,8,16,[1 6],9,-1,25,-1,9
1,<environment.Job instance at 0x7fe3f0fd7460>,13,15,[4 9],14,-1,30,-1,15
1,<environment.Job instance at 0x7fe3f0fd7fa0>,15,12,[ 3 10],16,-1,28,-1,16
1,<environment.Job instance at 0x7fe3f0fd7a50>,16,12,[9 4],17,-1,29,-1,17
1,<environment.Job instance at 0x7fe3f0fd7140>,18,12,[10  1],19,-1,31,-1,19
1,<environment.Job instance at 0x7fe3f0fd70a0>,19,21,[1 7],20,-1,41,-1,20
1,<environment.Job instance at 0x7fe3f1c534b0>,20,16,[9 2],21,-1,37,-1,21
1,<environment.Job instance at 0x7fe3f1c53690>,26,12,[6 4],27,-1,39,-1,27
1,<environment.Job instance at 0x7fe3f0ea0cd0>,27,17,[8 2],28,-1,45,-1,28
1,<environment.Job instance at 0x7fe3f0ea0e10>,28,17,[1 6],29,-1,46,-1,29
1,<environment.Job instance at 0x7fe3f0ea0b90>,29,17,[9 2],30,-1,47,-1,30
1,<environment.Job instance at 0x7fe3f0ea0a50>,32,15,[2 9],33,-1,48,-1,33
1,<environment.Job instance at 0x7fe3f1c61960>,35,16,[11  3],36,-1,52,-1,36
1,<environment.Job instance at 0x7fe3f1c613c0>,37,16,[3 5],38,-1,54,-1,38
1,<environment.Job instance at 0x7fe3f1c5f550>,43,18,[ 2 10],44,-1,62,-1,44
1,<environment.Job instance at 0x7fe3f1c5faf0>,44,17,[8 3],45,-1,62,-1,45
1,<environment.Job instance at 0x7fe3f1c5fbe0>,47,17,[7 4],48,-1,65,-1,48
1,<environment.Job instance at 0x7fe3f1c5f9b0>,48,15,[8 3],49,-1,64,-1,49
1,<environment.Job instance at 0x7fe3f1c5f190>,49,16,[10  5],50,-1,66,-1,50
1,<environment.Job instance at 0x7fe3f1c5f140>,51,16,[5 3],52,-1,68,-1,52
1,<environment.Job instance at 0x7fe3f0fea190>,14,14,[10  4],15,-1,68,-1,54
1,<environment.Job instance at 0x7fe3f0eb8eb0>,55,17,[ 2 10],56,-1,76,-1,59
1,<environment.Job instance at 0x7fe3f1c5fb40>,5,3,[ 1 14],6,-1,9,-1,6
1,<environment.Job instance at 0x7fe3f0fe3d20>,10,13,[11  4],11,-1,31,-1,18
1,<environment.Job instance at 0x7fe3f0feaaa0>,11,12,[ 1 13],12,-1,30,-1,18
1,<environment.Job instance at 0x7fe3f0eb8b40>,22,17,[ 2 14],23,-1,77,-1,60
1,<environment.Job instance at 0x7fe3f0eb8820>,35,16,[11  3],36,-1,124,-1,108
1,<environment.Job instance at 0x7fe3f0877320>,46,1,[11  2],47,-1,131,-1,130
1,<environment.Job instance at 0x7fe3fa44fd20>,0,18,[9 2],1,-1,22,-1,4
1,<environment.Job instance at 0x7fe3f0888190>,4,12,[7 4],5,-1,17,-1,5
1,<environment.Job instance at 0x7fe3f1e71e10>,7,14,[11  2],8,-1,22,-1,8
1,<environment.Job instance at 0x7fe3f1e71b40>,9,18,[1 5],10,-1,28,-1,10
1,<environment.Job instance at 0x7fe3f1e71be0>,10,27,[7 4],11,-1,38,-1,11
1,<environment.Job instance at 0x7fe3f0888be0>,3,14,[5 5],4,-1,25,-1,11
1,<environment.Job instance at 0x7fe3f1771eb0>,12,16,[10  2],13,-1,30,-1,14
1,<environment.Job instance at 0x7fe3f1771500>,14,12,[1 8],15,-1,27,-1,15
1,<environment.Job instance at 0x7fe3f1e71fa0>,13,15,[4 8],14,-1,31,-1,16
1,<environment.Job instance at 0x7fe3f1771460>,16,13,[9 5],17,-1,31,-1,18
1,<environment.Job instance at 0x7fe3f17712d0>,17,18,[6 2],18,-1,36,-1,18
1,<environment.Job instance at 0x7fe3f1771d20>,21,14,[9 5],22,-1,36,-1,22
1,<environment.Job instance at 0x7fe3f1771280>,24,19,[9 1],25,-1,44,-1,25
1,<environment.Job instance at 0x7fe3f1013a50>,28,13,[3 7],29,-1,43,-1,30
1,<environment.Job instance at 0x7fe3f1013c30>,29,15,[8 5],30,-1,45,-1,30
1,<environment.Job instance at 0x7fe3f180a780>,31,13,[9 4],32,-1,46,-1,33
1,<environment.Job instance at 0x7fe3f180a410>,34,15,[6 4],35,-1,50,-1,35
1,<environment.Job instance at 0x7fe3f180adc0>,35,1,[5 2],36,-1,37,-1,36
1,<environment.Job instance at 0x7fe3f180a370>,36,3,[8 3],37,-1,40,-1,37
1,<environment.Job instance at 0x7fe3f180a4b0>,37,16,[7 2],38,-1,54,-1,38
1,<environment.Job instance at 0x7fe3f180ae10>,32,16,[1 7],33,-1,57,-1,41
1,<environment.Job instance at 0x7fe3f180a960>,42,14,[9 3],43,-1,57,-1,43
1,<environment.Job instance at 0x7fe3f0aa6c80>,46,16,[4 9],47,-1,63,-1,47
1,<environment.Job instance at 0x7fe3f0aa6f50>,47,22,[6 1],48,-1,71,-1,49
1,<environment.Job instance at 0x7fe3f0aa6c30>,50,12,[5 9],51,-1,63,-1,51
1,<environment.Job instance at 0x7fe3f0aa61e0>,51,18,[5 9],52,-1,70,-1,52
1,<environment.Job instance at 0x7fe3f0c959b0>,55,17,[10  3],56,-1,73,-1,56
1,<environment.Job instance at 0x7fe3f0c95410>,57,16,[8 4],58,-1,74,-1,58
1,<environment.Job instance at 0x7fe3fa44f6e0>,7,14,[11  2],8,-1,22,-1,8
1,<environment.Job instance at 0x7fe3fa44fa50>,8,15,[ 3 14],9,-1,24,-1,9
1,<environment.Job instance at 0x7fe3f0888f50>,10,27,[7 4],11,-1,46,-1,19
1,<environment.Job instance at 0x7fe3f0888230>,15,2,[ 1 12],16,-1,23,-1,21
1,<environment.Job instance at 0x7fe3f0e8e0a0>,20,25,[ 1 14],21,-1,73,-1,48
1,<environment.Job instance at 0x7fe3f0c95460>,23,1,[ 4 13],24,-1,61,-1,60
1,<environment.Job instance at 0x7fe3f0c95050>,25,3,[ 4 11],26,-1,65,-1,62
1,<environment.Job instance at 0x7fe3fa85dfa0>,38,3,[11  1],39,-1,120,-1,117
1,<environment.Job instance at 0x7fe3fa615a00>,0,17,[8 4],1,-1,18,-1,1
1,<environment.Job instance at 0x7fe3f0a70eb0>,2,19,[8 3],3,-1,22,-1,3
1,<environment.Job instance at 0x7fe3f0a70e10>,4,17,[8 5],5,-1,22,-1,5
1,<environment.Job instance at 0x7fe3f0a70a00>,6,23,[5 5],7,-1,30,-1,7
1,<environment.Job instance at 0x7fe3f0a75460>,8,14,[9 5],9,-1,24,-1,10
1,<environment.Job instance at 0x7fe3f08882d0>,9,25,[7 3],10,-1,35,-1,10
1,<environment.Job instance at 0x7fe3f0a750f0>,14,17,[4 7],15,-1,32,-1,15
1,<environment.Job instance at 0x7fe3f0a95050>,16,13,[10  5],17,-1,31,-1,18
1,<environment.Job instance at 0x7fe3f0a8a320>,22,14,[10  1],23,-1,37,-1,23
1,<environment.Job instance at 0x7fe3f16bf5a0>,24,15,[8 1],25,-1,40,-1,25
1,<environment.Job instance at 0x7fe3f16bff50>,25,14,[5 7],26,-1,40,-1,26
1,<environment.Job instance at 0x7fe3f16bfaf0>,27,15,[3 9],28,-1,43,-1,28
1,<environment.Job instance at 0x7fe3f1268d70>,28,15,[ 4 10],29,-1,44,-1,29
1,<environment.Job instance at 0x7fe3f13d5f50>,30,18,[5 4],31,-1,49,-1,31
1,<environment.Job instance at 0x7fe3f13da780>,32,19,[6 2],33,-1,52,-1,33
1,<environment.Job instance at 0x7fe3f0df4e10>,38,18,[ 4 10],39,-1,57,-1,39
1,<environment.Job instance at 0x7fe3f13cb9b0>,39,13,[7 2],40,-1,53,-1,40
1,<environment.Job instance at 0x7fe3f13cbf50>,40,14,[2 6],41,-1,55,-1,41
1,<environment.Job instance at 0x7fe3f0df4780>,43,16,[3 8],44,-1,60,-1,44
1,<environment.Job instance at 0x7fe3f0de42d0>,44,16,[9 2],45,-1,61,-1,45
1,<environment.Job instance at 0x7fe3f0de4230>,46,18,[3 6],47,-1,65,-1,47
1,<environment.Job instance at 0x7fe3f0de44b0>,47,18,[5 5],48,-1,66,-1,48
1,<environment.Job instance at 0x7fe3f0ddf960>,53,18,[4 5],54,-1,72,-1,54
1,<environment.Job instance at 0x7fe3f0ddfaf0>,54,15,[3 5],55,-1,70,-1,55
1,<environment.Job instance at 0x7fe3f0ddf320>,55,18,[5 8],56,-1,74,-1,56
1,<environment.Job instance at 0x7fe3f0ddf9b0>,56,18,[3 9],57,-1,75,-1,57
1,<environment.Job instance at 0x7fe3f0e03410>,6,23,[5 5],7,-1,39,-1,16
1,<environment.Job instance at 0x7fe3f0de41e0>,10,1,[12  5],11,-1,19,-1,18
1,<environment.Job instance at 0x7fe3f0de40f0>,9,25,[7 3],10,-1,43,-1,18
1,<environment.Job instance at 0x7fe3f16e11e0>,21,3,[ 3 11],22,-1,52,-1,49
1,<environment.Job instance at 0x7fe3f0c954b0>,35,3,[14  4],36,-1,93,-1,90
1,<environment.Job instance at 0x7fe3f0c95be0>,36,17,[ 1 13],37,-1,107,-1,90
1,<environment.Job instance at 0x7fe3f0c95640>,37,18,[ 3 12],38,-1,108,-1,90
1,<environment.Job instance at 0x7fe3f1c5f690>,41,2,[11  4],42,-1,108,-1,106
1,<environment.Job instance at 0x7fe3f0888230>,48,22,[ 1 13],49,-1,149,-1,127
1,<environment.Job instance at 0x7fe3f180af00>,58,2,[11  2],59,-1,171,-1,169
1,<environment.Job instance at 0x7fe3f1d5c960>,1,16,[6 5],2,-1,18,-1,2
1,<environment.Job instance at 0x7fe3f1d5c190>,5,16,[6 5],6,-1,22,-1,6
1,<environment.Job instance at 0x7fe3f1d5c280>,6,12,[ 1 10],7,-1,20,-1,8
1,<environment.Job instance at 0x7fe3f0bb2aa0>,7,18,[9 4],8,-1,26,-1,8
1,<environment.Job instance at 0x7fe3f1d5cd70>,8,15,[1 8],9,-1,24,-1,9
1,<environment.Job instance at 0x7fe3f178d9b0>,19,18,[1 9],20,-1,38,-1,20
1,<environment.Job instance at 0x7fe3f178d5f0>,23,14,[4 8],24,-1,38,-1,24
1,<environment.Job instance at 0x7fe3f178da00>,24,17,[3 7],25,-1,42,-1,25
1,<environment.Job instance at 0x7fe3f1d5fb40>,26,14,[7 5],27,-1,41,-1,27
1,<environment.Job instance at 0x7fe3f1d5f500>,29,18,[2 9],30,-1,48,-1,30
1,<environment.Job instance at 0x7fe3f1d5f230>,30,18,[5 5],31,-1,49,-1,31
1,<environment.Job instance at 0x7fe3f1d5f8c0>,31,14,[ 1 10],32,-1,46,-1,32
1,<environment.Job instance at 0x7fe3f1d5fd20>,33,18,[5 2],34,-1,53,-1,35
1,<environment.Job instance at 0x7fe3f1d5f550>,35,1,[5 6],36,-1,37,-1,36
1,<environment.Job instance at 0x7fe3f1d5f3c0>,34,16,[7 5],35,-1,52,-1,36
1,<environment.Job instance at 0x7fe3f13bc3c0>,41,13,[9 1],42,-1,55,-1,42
1,<environment.Job instance at 0x7fe3f13bc410>,44,15,[10  2],45,-1,61,-1,46
1,<environment.Job instance at 0x7fe3f13bc5f0>,45,20,[10  3],46,-1,66,-1,46
1,<environment.Job instance at 0x7fe3f1d74280>,52,18,[9 2],53,-1,71,-1,53
1,<environment.Job instance at 0x7fe3f1d74320>,54,14,[5 9],55,-1,69,-1,55
1,<environment.Job instance at 0x7fe3f1d74050>,57,23,[6 1],58,-1,81,-1,58
1,<environment.Job instance at 0x7fe3f1d5c1e0>,2,13,[14  2],3,-1,16,-1,3
1,<environment.Job instance at 0x7fe3f0c95910>,20,2,[ 4 14],21,-1,46,-1,44
1,<environment.Job instance at 0x7fe3f1d74be0>,43,17,[14  2],44,-1,157,-1,140
1,<environment.Job instance at 0x7fe3f160b870>,56,2,[ 5 12],57,-1,164,-1,162
1,<environment.Job instance at 0x7fe3f160b820>,57,23,[6 1],58,-1,188,-1,165
1,<environment.Job instance at 0x7fe3f0fdc640>,6,18,[ 2 10],7,-1,25,-1,7
1,<environment.Job instance at 0x7fe3f0fdc730>,7,17,[5 5],8,-1,25,-1,8
1,<environment.Job instance at 0x7fe3f0fdc5f0>,8,14,[9 5],9,-1,23,-1,9
1,<environment.Job instance at 0x7fe3f0fdc7d0>,9,14,[8 5],10,-1,24,-1,10
1,<environment.Job instance at 0x7fe3f0fdc870>,10,25,[9 4],11,-1,36,-1,11
1,<environment.Job instance at 0x7fe3f0fdc9b0>,12,17,[1 5],13,-1,30,-1,13
1,<environment.Job instance at 0x7fe3f0fdcaa0>,14,28,[ 5 10],15,-1,43,-1,15
1,<environment.Job instance at 0x7fe3f0fdceb0>,17,27,[2 9],18,-1,45,-1,18
1,<environment.Job instance at 0x7fe3f0fdce10>,18,26,[4 9],19,-1,45,-1,19
1,<environment.Job instance at 0x7fe3f10090a0>,20,18,[5 4],21,-1,39,-1,21
1,<environment.Job instance at 0x7fe3f10091e0>,21,14,[8 4],22,-1,36,-1,22
1,<environment.Job instance at 0x7fe3f1009500>,24,16,[8 1],25,-1,41,-1,25
1,<environment.Job instance at 0x7fe3f1009640>,28,19,[2 7],29,-1,48,-1,29
1,<environment.Job instance at 0x7fe3f1009cd0>,32,22,[5 4],33,-1,55,-1,33
1,<environment.Job instance at 0x7fe3f1009f00>,35,13,[5 5],36,-1,50,-1,37
1,<environment.Job instance at 0x7fe3f0fe9280>,38,17,[7 5],39,-1,56,-1,39
1,<environment.Job instance at 0x7fe3f0fe9410>,39,13,[4 8],40,-1,53,-1,40
1,<environment.Job instance at 0x7fe3f0fe9320>,40,17,[10  1],41,-1,58,-1,41
1,<environment.Job instance at 0x7fe3f0fe9500>,41,16,[2 5],42,-1,58,-1,42
1,<environment.Job instance at 0x7fe3f0fe95a0>,42,15,[2 5],43,-1,58,-1,43
1,<environment.Job instance at 0x7fe3f0fe9640>,43,16,[1 5],44,-1,60,-1,44
1,<environment.Job instance at 0x7fe3f0fe9780>,45,15,[5 4],46,-1,61,-1,46
1,<environment.Job instance at 0x7fe3f0fe9aa0>,49,16,[5 6],50,-1,66,-1,50
1,<environment.Job instance at 0x7fe3f0fe9c80>,50,18,[4 5],51,-1,69,-1,51
1,<environment.Job instance at 0x7fe3f0fe9870>,51,18,[4 9],52,-1,70,-1,52
1,<environment.Job instance at 0x7fe3f0fe9dc0>,53,13,[9 3],54,-1,67,-1,54
1,<environment.Job instance at 0x7fe3f0fe9f50>,54,19,[2 5],55,-1,74,-1,55
1,<environment.Job instance at 0x7fe3f0fe9e10>,55,14,[ 3 10],56,-1,70,-1,56
1,<environment.Job instance at 0x7fe3f0fdcbe0>,10,25,[9 4],11,-1,46,-1,21
1,<environment.Job instance at 0x7fe3f160bf00>,14,28,[ 5 10],15,-1,65,-1,37
1,<environment.Job instance at 0x7fe3f160bdc0>,17,27,[2 9],18,-1,65,-1,38
1,<environment.Job instance at 0x7fe3f160ba50>,18,26,[4 9],19,-1,64,-1,38
1,<environment.Job instance at 0x7fe3f1d74fa0>,26,16,[ 5 12],27,-1,72,-1,56
1,<environment.Job instance at 0x7fe3f13bc0f0>,46,17,[ 2 14],47,-1,134,-1,117
1,<environment.Job instance at 0x7fe3f1d5fe60>,47,26,[10  5],48,-1,161,-1,135
1,<environment.Job instance at 0x7fa1528bd6e0>,0,13,[9 3],1,-1,15,-1,2
1,<environment.Job instance at 0x7fa1528bd8c0>,1,22,[11  3],2,-1,24,-1,2
1,<environment.Job instance at 0x7fa1528bd730>,2,22,[4 8],3,-1,25,-1,3
1,<environment.Job instance at 0x7fa1492cdfa0>,9,18,[11  5],10,-1,28,-1,10
1,<environment.Job instance at 0x7fa1492d00f0>,11,15,[4 8],12,-1,27,-1,12
1,<environment.Job instance at 0x7fa1492d0320>,12,26,[ 1 10],13,-1,39,-1,13
1,<environment.Job instance at 0x7fa1492d0230>,13,18,[ 4 10],14,-1,32,-1,14
1,<environment.Job instance at 0x7fa1492d0460>,15,18,[2 8],16,-1,34,-1,16
1,<environment.Job instance at 0x7fa1492d0640>,16,16,[3 5],17,-1,33,-1,17
1,<environment.Job instance at 0x7fa1492d0870>,19,14,[3 5],20,-1,34,-1,20
1,<environment.Job instance at 0x7fa1492d0b90>,23,27,[1 6],24,-1,51,-1,24
1,<environment.Job instance at 0x7fa1492d0c30>,24,18,[2 6],25,-1,43,-1,25
1,<environment.Job instance at 0x7fa1492d0e60>,26,3,[3 7],27,-1,30,-1,27
1,<environment.Job instance at 0x7fa1492d0d70>,27,15,[8 4],28,-1,43,-1,28
1,<environment.Job instance at 0x7fa1492d30a0>,28,23,[10  4],29,-1,52,-1,29
1,<environment.Job instance at 0x7fa1492d3140>,29,12,[5 4],30,-1,42,-1,30
1,<environment.Job instance at 0x7fa1492d31e0>,30,14,[5 2],31,-1,45,-1,31
1,<environment.Job instance at 0x7fa1492d3280>,31,14,[2 5],32,-1,46,-1,32
1,<environment.Job instance at 0x7fa1492d33c0>,33,14,[5 5],34,-1,48,-1,34
1,<environment.Job instance at 0x7fa1492d3500>,34,24,[1 8],35,-1,59,-1,35
1,<environment.Job instance at 0x7fa1492d3410>,35,15,[9 5],36,-1,51,-1,36
1,<environment.Job instance at 0x7fa1492d3aa0>,40,15,[10  3],41,-1,59,-1,44
1,<environment.Job instance at 0x7fa1492d3cd0>,43,18,[5 5],44,-1,62,-1,44
1,<environment.Job instance at 0x7fa1492d5140>,48,15,[10  1],49,-1,66,-1,51
1,<environment.Job instance at 0x7fa1492d57d0>,53,17,[5 7],54,-1,71,-1,54
1,<environment.Job instance at 0x7fa1492d5230>,50,16,[12  2],51,-1,70,-1,54
1,<environment.Job instance at 0x7fa1492d5a00>,56,17,[8 5],57,-1,75,-1,58
1,<environment.Job instance at 0x7fa1492d5aa0>,58,14,[2 7],59,-1,73,-1,59
1,<environment.Job instance at 0x7fa1492d5c80>,59,17,[1 6],60,-1,77,-1,60
1,<environment.Job instance at 0x7fa1492d5f50>,62,22,[6 4],63,-1,85,-1,63
1,<environment.Job instance at 0x7fa1492d56e0>,57,18,[2 8],58,-1,81,-1,63
1,<environment.Job instance at 0x7fa1492d9140>,64,18,[2 9],65,-1,84,-1,66
1,<environment.Job instance at 0x7fa1492d9320>,65,20,[2 6],66,-1,88,-1,68
1,<environment.Job instance at 0x7fa1492d0730>,1,22,[11  3],2,-1,24,-1,2
1,<environment.Job instance at 0x7fa1492d5e60>,9,18,[11  5],10,-1,32,-1,14
1,<environment.Job instance at 0x7fa1492cd870>,12,26,[ 1 10],13,-1,82,-1,56
1,<environment.Job instance at 0x7fa1492d9f00>,23,27,[1 6],24,-1,87,-1,60
1,<environment.Job instance at 0x7fa1492d7280>,28,23,[10  4],29,-1,97,-1,74
1,<environment.Job instance at 0x7fa1492d7780>,34,24,[1 8],35,-1,117,-1,93
1,<environment.Job instance at 0x7fa1492d78c0>,36,13,[ 3 14],37,-1,106,-1,93
1,<environment.Job instance at 0x7fa1494758c0>,46,17,[12  2],47,-1,134,-1,117
1,<environment.Job instance at 0x7fa1492bb870>,50,16,[12  2],51,-1,146,-1,130
1,<environment.Job instance at 0x7fa1492c4820>,54,13,[13  1],55,-1,158,-1,145
1,<environment.Job instance at 0x7fa1493bf230>,60,3,[12  3],61,-1,169,-1,166
1,<environment.Job instance at 0x7fa149382230>,67,27,[ 1 10],68,-1,216,-1,189
1,<environment.Job instance at 0x7fa148a16410>,6,19,[4 8],7,-1,27,-1,8
1,<environment.Job instance at 0x7fa148a164b0>,8,12,[10  2],9,-1,21,-1,9
1,<environment.Job instance at 0x7fa148a15820>,9,13,[9 4],10,-1,23,-1,10
1,<environment.Job instance at 0x7fa148a159b0>,10,14,[2 6],11,-1,25,-1,11
1,<environment.Job instance at 0x7fa148a15a50>,11,15,[5 9],12,-1,27,-1,12
1,<environment.Job instance at 0x7fa148a15870>,12,16,[ 4 10],13,-1,29,-1,13
1,<environment.Job instance at 0x7fa148a107d0>,7,13,[8 5],8,-1,26,-1,13
1,<environment.Job instance at 0x7fa148a15eb0>,14,18,[3 7],15,-1,34,-1,16
1,<environment.Job instance at 0x7fa148a15c30>,15,17,[3 9],16,-1,33,-1,16
1,<environment.Job instance at 0x7fa148a15190>,16,18,[9 2],17,-1,38,-1,20
1,<environment.Job instance at 0x7fa148a0a460>,22,20,[1 5],23,-1,43,-1,23
1,<environment.Job instance at 0x7fa148a0a0f0>,25,15,[5 7],26,-1,41,-1,26
1,<environment.Job instance at 0x7fa148a0f320>,31,18,[ 1 10],32,-1,50,-1,32
1,<environment.Job instance at 0x7fa148af6550>,32,16,[3 9],33,-1,49,-1,33
1,<environment.Job instance at 0x7fa148c3ea50>,33,16,[1 6],34,-1,50,-1,34
1,<environment.Job instance at 0x7fa148897d70>,37,17,[9 3],38,-1,55,-1,38
1,<environment.Job instance at 0x7fa1488c0640>,55,21,[4 5],56,-1,77,-1,56
1,<environment.Job instance at 0x7fa1489190a0>,57,22,[4 5],58,-1,80,-1,58
1,<environment.Job instance at 0x7fa1492d76e0>,5,14,[ 4 11],6,-1,20,-1,6
1,<environment.Job instance at 0x7fa148a6cfa0>,27,2,[ 5 11],28,-1,75,-1,73
1,<environment.Job instance at 0x7fa148c138c0>,29,18,[12  5],30,-1,92,-1,74
1,<environment.Job instance at 0x7fa148a7e7d0>,35,14,[14  5],36,-1,118,-1,104
1,<environment.Job instance at 0x7fa148a7eaa0>,36,15,[11  1],37,-1,119,-1,104
1,<environment.Job instance at 0x7fa148a6f960>,41,26,[ 5 10],42,-1,162,-1,136
1,<environment.Job instance at 0x7fa148a8b140>,46,3,[ 1 12],47,-1,139,-1,136
1,<environment.Job instance at 0x7fa148a8b0a0>,52,3,[ 4 12],53,-1,144,-1,141
1,<environment.Job instance at 0x7fa148a7bf00>,53,12,[ 4 11],54,-1,153,-1,141
1,<environment.Job instance at 0x7fa148aa0aa0>,58,23,[ 2 14],59,-1,181,-1,158
1,<environment.Job instance at 0x7fa148b00be0>,68,16,[11  2],69,-1,194,-1,178
1,<environment.Job instance at 0x7fa152a37910>,0,16,[2 8],1,-1,18,-1,2
1,<environment.Job instance at 0x7fa152a37a00>,3,15,[ 1 12],4,-1,19,-1,4
1,<environment.Job instance at 0x7fa152a37d70>,5,3,[ 4 13],6,-1,9,-1,6
1,<environment.Job instance at 0x7fa152a374b0>,6,17,[1 7],7,-1,24,-1,7
1,<environment.Job instance at 0x7fa152a36c30>,9,12,[4 9],10,-1,22,-1,10
1,<environment.Job instance at 0x7fa152a36be0>,11,15,[10  4],12,-1,27,-1,12
1,<environment.Job instance at 0x7fa152a36f00>,12,14,[1 8],13,-1,27,-1,13
1,<environment.Job instance at 0x7fa152a36410>,14,14,[8 4],15,-1,29,-1,15
1,<environment.Job instance at 0x7fa152a368c0>,15,1,[9 1],16,-1,17,-1,16
1,<environment.Job instance at 0x7fa152a37dc0>,1,13,[5 6],2,-1,29,-1,16
1,<environment.Job instance at 0x7fa149079d70>,18,14,[9 5],19,-1,36,-1,22
1,<environment.Job instance at 0x7fa149079b40>,23,15,[5 2],24,-1,39,-1,24
1,<environment.Job instance at 0x7fa149079fa0>,21,15,[1 7],22,-1,40,-1,25
1,<environment.Job instance at 0x7fa149079960>,28,19,[6 4],29,-1,48,-1,29
1,<environment.Job instance at 0x7fa1488c7d70>,34,19,[6 1],35,-1,54,-1,35
1,<environment.Job instance at 0x7fa1488c7fa0>,35,16,[ 2 10],36,-1,52,-1,36
1,<environment.Job instance at 0x7fa1488c97d0>,37,21,[ 3 10],38,-1,59,-1,38
1,<environment.Job instance at 0x7fa1488ca7d0>,48,21,[9 4],49,-1,70,-1,49
1,<environment.Job instance at 0x7fa1488ca4b0>,49,12,[9 3],50,-1,63,-1,51
1,<environment.Job instance at 0x7fa1488cac80>,50,18,[10  3],51,-1,69,-1,51
1,<environment.Job instance at 0x7fa1488cad70>,51,17,[10  2],52,-1,72,-1,55
1,<environment.Job instance at 0x7fa14894f370>,55,1,[6 2],56,-1,57,-1,56
1,<environment.Job instance at 0x7fa14894f410>,56,14,[5 5],57,-1,71,-1,57
1,<environment.Job instance at 0x7fa14894fa50>,60,13,[10  5],61,-1,74,-1,61
1,<environment.Job instance at 0x7fa14894f3c0>,61,14,[1 6],62,-1,76,-1,62
1,<environment.Job instance at 0x7fa14894faf0>,62,14,[2 7],63,-1,77,-1,63
1,<environment.Job instance at 0x7fa14894fe10>,63,14,[7 5],64,-1,78,-1,64
1,<environment.Job instance at 0x7fa14894f280>,65,14,[10  2],66,-1,80,-1,66
1,<environment.Job instance at 0x7fa148960870>,3,15,[ 1 12],4,-1,19,-1,4
1,<environment.Job instance at 0x7fa149079500>,5,3,[ 4 13],6,-1,9,-1,6
1,<environment.Job instance at 0x7fa1488c9730>,7,1,[ 1 14],8,-1,9,-1,8
1,<environment.Job instance at 0x7fa152a37c80>,20,3,[13  3],21,-1,39,-1,36
1,<environment.Job instance at 0x7fa1488ff960>,25,13,[ 1 14],26,-1,66,-1,53
1,<environment.Job instance at 0x7fa1488c0550>,36,2,[11  5],37,-1,70,-1,68
1,<environment.Job instance at 0x7fa1488c0e60>,38,3,[14  4],39,-1,76,-1,73
1,<environment.Job instance at 0x7fa1488bad70>,58,12,[14  4],59,-1,144,-1,132
1,<environment.Job instance at 0x7fa1488b5f50>,68,2,[13  1],69,-1,177,-1,175
1,<environment.Job instance at 0x7fa149326320>,6,12,[ 3 10],7,-1,19,-1,7
1,<environment.Job instance at 0x7fa1493ba5f0>,10,18,[4 5],11,-1,29,-1,11
1,<environment.Job instance at 0x7fa1493baaa0>,11,18,[2 8],12,-1,30,-1,12
1,<environment.Job instance at 0x7fa1493ba0f0>,14,16,[9 4],15,-1,33,-1,17
1,<environment.Job instance at 0x7fa1493ba190>,16,14,[10  1],17,-1,31,-1,17
1,<environment.Job instance at 0x7fa1493ba410>,17,16,[9 2],18,-1,35,-1,19
1,<environment.Job instance at 0x7fa1493bad70>,18,15,[7 5],19,-1,35,-1,20
1,<environment.Job instance at 0x7fa1492c78c0>,26,19,[2 7],27,-1,46,-1,27
1,<environment.Job instance at 0x7fa1492c7b90>,28,18,[6 3],29,-1,47,-1,29
1,<environment.Job instance at 0x7fa1492bb6e0>,37,2,[4 5],38,-1,40,-1,38
1,<environment.Job instance at 0x7fa1492bb460>,38,18,[4 6],39,-1,57,-1,39
1,<environment.Job instance at 0x7fa1492bb640>,41,27,[4 7],42,-1,69,-1,42
1,<environment.Job instance at 0x7fa1492bb190>,42,26,[8 4],43,-1,69,-1,43
1,<environment.Job instance at 0x7fa1492bb280>,43,12,[9 1],44,-1,56,-1,44
1,<environment.Job instance at 0x7fa1492bb3c0>,44,14,[5 5],45,-1,59,-1,45
1,<environment.Job instance at 0x7fa1492bbe10>,48,18,[4 5],49,-1,76,-1,58
1,<environment.Job instance at 0x7fa1499060a0>,57,13,[9 2],58,-1,71,-1,58
1,<environment.Job instance at 0x7fa149906910>,58,15,[3 6],59,-1,74,-1,59
1,<environment.Job instance at 0x7fa1499065f0>,60,17,[2 6],61,-1,78,-1,61
1,<environment.Job instance at 0x7fa149906690>,61,15,[8 4],62,-1,77,-1,62
1,<environment.Job instance at 0x7fa1493ba820>,1,3,[13  5],2,-1,5,-1,2
1,<environment.Job instance at 0x7fa1492c7e10>,2,2,[ 1 12],3,-1,5,-1,3
1,<environment.Job instance at 0x7fa149417f50>,12,1,[ 4 13],13,-1,14,-1,13
1,<environment.Job instance at 0x7fa149417d70>,13,14,[11  3],14,-1,28,-1,14
1,<environment.Job instance at 0x7fa1488caa00>,30,24,[ 1 10],31,-1,91,-1,67
1,<environment.Job instance at 0x7fa149965c80>,33,24,[7 4],34,-1,95,-1,71
1,<environment.Job instance at 0x7fa149965320>,35,3,[12  3],36,-1,74,-1,71
1,<environment.Job instance at 0x7fa1499655f0>,41,27,[4 7],42,-1,118,-1,91
1,<environment.Job instance at 0x7fa1499650f0>,42,26,[8 4],43,-1,117,-1,91
1,<environment.Job instance at 0x7fa149965a00>,45,16,[14  1],46,-1,108,-1,92
1,<environment.Job instance at 0x7fa149764a00>,50,25,[ 3 10],51,-1,148,-1,123
1,<environment.Job instance at 0x7fa149764820>,66,28,[6 5],67,-1,200,-1,172
1,<environment.Job instance at 0x7fa1497642d0>,63,23,[10  1],64,-1,199,-1,176
1,<environment.Job instance at 0x7fa148fd26e0>,4,15,[10  4],5,-1,21,-1,6
1,<environment.Job instance at 0x7fa148fd2820>,5,18,[11  3],6,-1,24,-1,6
1,<environment.Job instance at 0x7fa148fbb280>,9,28,[5 3],10,-1,38,-1,10
1,<environment.Job instance at 0x7fa149e0a690>,12,18,[8 2],13,-1,31,-1,13
1,<environment.Job instance at 0x7fa148fa7b90>,15,17,[4 6],16,-1,33,-1,16
1,<environment.Job instance at 0x7fa148fbd050>,19,16,[9 4],20,-1,36,-1,20
1,<environment.Job instance at 0x7fa149e089b0>,22,25,[6 3],23,-1,48,-1,23
1,<environment.Job instance at 0x7fa149dfd5f0>,24,17,[9 4],25,-1,42,-1,25
1,<environment.Job instance at 0x7fa148fa43c0>,27,13,[1 9],28,-1,42,-1,29
1,<environment.Job instance at 0x7fa148fa44b0>,29,15,[ 5 10],30,-1,45,-1,30
1,<environment.Job instance at 0x7fa148c48500>,31,14,[8 2],32,-1,46,-1,32
1,<environment.Job instance at 0x7fa149728960>,33,20,[2 6],34,-1,54,-1,34
1,<environment.Job instance at 0x7fa148c52f00>,34,15,[5 1],35,-1,50,-1,35
1,<environment.Job instance at 0x7fa148c2c9b0>,44,12,[5 9],45,-1,57,-1,45
1,<environment.Job instance at 0x7fa148c2c2d0>,46,15,[2 7],47,-1,62,-1,47
1,<environment.Job instance at 0x7fa148c2cfa0>,48,15,[7 5],49,-1,64,-1,49
1,<environment.Job instance at 0x7fa148c540a0>,49,15,[ 3 10],50,-1,65,-1,50
1,<environment.Job instance at 0x7fa148c54c30>,50,24,[2 8],51,-1,75,-1,51
1,<environment.Job instance at 0x7fa148c54190>,51,24,[9 1],52,-1,76,-1,52
1,<environment.Job instance at 0x7fa148c54320>,53,24,[10  5],54,-1,78,-1,54
1,<environment.Job instance at 0x7fa1490acdc0>,54,23,[10  2],55,-1,78,-1,55
1,<environment.Job instance at 0x7fa1490ac640>,55,15,[ 1 11],56,-1,71,-1,56
1,<environment.Job instance at 0x7fa1490ace60>,56,16,[ 5 10],57,-1,73,-1,57
1,<environment.Job instance at 0x7fa1490a5370>,61,17,[10  3],62,-1,79,-1,62
1,<environment.Job instance at 0x7fa1490a5550>,62,13,[1 6],63,-1,76,-1,63
1,<environment.Job instance at 0x7fa1490a5640>,64,14,[1 5],65,-1,79,-1,65
1,<environment.Job instance at 0x7fa1490a57d0>,65,12,[ 4 10],66,-1,78,-1,66
1,<environment.Job instance at 0x7fa1490a58c0>,67,15,[ 3 12],68,-1,83,-1,68
1,<environment.Job instance at 0x7fa148fa70a0>,1,15,[14  1],2,-1,17,-1,2
1,<environment.Job instance at 0x7fa148fa42d0>,5,18,[11  3],6,-1,24,-1,6
1,<environment.Job instance at 0x7fa149724e10>,9,28,[5 3],10,-1,38,-1,10
1,<environment.Job instance at 0x7fa149764cd0>,22,25,[6 3],23,-1,73,-1,48
1,<environment.Job instance at 0x7fa149965320>,39,18,[13  1],40,-1,118,-1,100
1,<environment.Job instance at 0x7fa149965230>,42,3,[ 3 11],43,-1,105,-1,102
1,<environment.Job instance at 0x7fa1488c08c0>,50,24,[2 8],51,-1,169,-1,145
1,<environment.Job instance at 0x7fa1488c0190>,51,24,[9 1],52,-1,169,-1,145
1,<environment.Job instance at 0x7fa1488c0b40>,53,24,[10  5],54,-1,170,-1,146
1,<environment.Job instance at 0x7fa1488c01e0>,54,23,[10  2],55,-1,169,-1,146
1,<environment.Job instance at 0x7fa1488c0c30>,55,15,[ 1 11],56,-1,161,-1,146
1,<environment.Job instance at 0x7fa1492bb780>,67,15,[ 3 12],68,-1,194,-1,179
1,<environment.Job instance at 0x7fa149728730>,4,18,[3 6],5,-1,23,-1,5
1,<environment.Job instance at 0x7fa149728280>,6,16,[9 2],7,-1,24,-1,8
1,<environment.Job instance at 0x7fa1497359b0>,7,16,[9 4],8,-1,25,-1,9
1,<environment.Job instance at 0x7fa149728780>,10,27,[ 5 10],11,-1,38,-1,11
1,<environment.Job instance at 0x7fa149728500>,11,17,[7 5],12,-1,29,-1,12
1,<environment.Job instance at 0x7fa149728190>,14,15,[4 6],15,-1,30,-1,15
1,<environment.Job instance at 0x7fa1496fa6e0>,16,25,[ 5 10],17,-1,42,-1,17
1,<environment.Job instance at 0x7fa1496fa690>,18,18,[1 5],19,-1,37,-1,19
1,<environment.Job instance at 0x7fa1496fa5f0>,27,1,[5 5],28,-1,29,-1,28
1,<environment.Job instance at 0x7fa148cfc2d0>,30,14,[7 5],31,-1,45,-1,31
1,<environment.Job instance at 0x7fa148cfc320>,32,17,[12  4],33,-1,50,-1,33
1,<environment.Job instance at 0x7fa148cfc140>,35,16,[10  4],36,-1,52,-1,36
1,<environment.Job instance at 0x7fa148cfc410>,38,14,[7 5],39,-1,53,-1,39
1,<environment.Job instance at 0x7fa148cfc9b0>,39,3,[5 5],40,-1,43,-1,40
1,<environment.Job instance at 0x7fa148cfc190>,40,18,[9 5],41,-1,64,-1,46
1,<environment.Job instance at 0x7fa148cfcb40>,41,3,[9 4],42,-1,50,-1,47
1,<environment.Job instance at 0x7fa148d2e280>,47,15,[2 9],48,-1,63,-1,48
1,<environment.Job instance at 0x7fa148cfc4b0>,44,17,[7 2],45,-1,67,-1,50
1,<environment.Job instance at 0x7fa148d2eb90>,49,17,[8 1],50,-1,68,-1,51
1,<environment.Job instance at 0x7fa148d2e6e0>,51,17,[2 6],52,-1,69,-1,52
1,<environment.Job instance at 0x7fa148d2e0a0>,52,19,[8 2],53,-1,72,-1,53
1,<environment.Job instance at 0x7fa148cff280>,60,18,[3 5],61,-1,79,-1,61
1,<environment.Job instance at 0x7fa148cffd70>,65,13,[ 1 10],66,-1,82,-1,69
1,<environment.Job instance at 0x7fa148cfff50>,68,14,[4 6],69,-1,83,-1,69
1,<environment.Job instance at 0x7fa1497350f0>,10,27,[ 5 10],11,-1,50,-1,23
1,<environment.Job instance at 0x7fa148c2c370>,16,25,[ 5 10],17,-1,69,-1,44
1,<environment.Job instance at 0x7fa149724b40>,32,17,[12  4],33,-1,89,-1,72
1,<environment.Job instance at 0x7fa149724550>,45,2,[ 4 11],46,-1,114,-1,112
1,<environment.Job instance at 0x7fa148d47b90>,53,2,[ 2 14],54,-1,148,-1,146
1,<environment.Job instance at 0x7fa148d47cd0>,54,17,[ 5 14],55,-1,163,-1,146
1,<environment.Job instance at 0x7fa148d47320>,56,2,[11  3],57,-1,148,-1,146
1,<environment.Job instance at 0x7fa148d474b0>,57,2,[12  2],58,-1,148,-1,146
1,<environment.Job instance at 0x7fa148d47550>,62,2,[12  5],63,-1,177,-1,175
1,<environment.Job instance at 0x7fa148d47d70>,64,1,[14  4],65,-1,176,-1,175
1,<environment.Job instance at 0x7fa14907dfa0>,3,13,[4 9],4,-1,17,-1,4
1,<environment.Job instance at 0x7fa14907de60>,5,14,[7 4],6,-1,20,-1,6
1,<environment.Job instance at 0x7fa14907c690>,10,16,[10  2],11,-1,27,-1,11
1,<environment.Job instance at 0x7fa14907cdc0>,14,21,[7 2],15,-1,36,-1,15
1,<environment.Job instance at 0x7fa14907c870>,15,12,[ 1 10],16,-1,31,-1,19
1,<environment.Job instance at 0x7fa149092e60>,19,14,[5 7],20,-1,34,-1,20
1,<environment.Job instance at 0x7fa149092370>,20,18,[4 7],21,-1,39,-1,21
1,<environment.Job instance at 0x7fa149092f00>,21,14,[1 5],22,-1,36,-1,22
1,<environment.Job instance at 0x7fa1490924b0>,22,14,[ 1 11],23,-1,38,-1,24
1,<environment.Job instance at 0x7fa148e2cc30>,28,15,[8 5],29,-1,44,-1,29
1,<environment.Job instance at 0x7fa148d42550>,29,27,[1 5],30,-1,57,-1,30
1,<environment.Job instance at 0x7fa148e32960>,35,14,[ 5 12],36,-1,51,-1,37
1,<environment.Job instance at 0x7fa148e32190>,36,18,[4 6],37,-1,55,-1,37
1,<environment.Job instance at 0x7fa149ced140>,38,17,[7 4],39,-1,57,-1,40
1,<environment.Job instance at 0x7fa149ced230>,39,14,[ 5 11],40,-1,55,-1,41
1,<environment.Job instance at 0x7fa148d2d640>,49,27,[9 3],50,-1,77,-1,50
1,<environment.Job instance at 0x7fa148d2deb0>,52,24,[ 3 10],53,-1,79,-1,55
1,<environment.Job instance at 0x7fa148d2d050>,46,25,[3 8],47,-1,80,-1,55
1,<environment.Job instance at 0x7fa148d2dc80>,50,15,[7 5],51,-1,71,-1,56
1,<environment.Job instance at 0x7fa148d2da50>,54,17,[8 5],55,-1,76,-1,59
1,<environment.Job instance at 0x7fa148d33dc0>,58,27,[1 7],59,-1,89,-1,62
1,<environment.Job instance at 0x7fa148d33fa0>,60,19,[6 3],61,-1,81,-1,62
1,<environment.Job instance at 0x7fa148d47910>,13,1,[ 5 12],14,-1,18,-1,17
1,<environment.Job instance at 0x7fa148c27f50>,22,14,[ 1 11],23,-1,62,-1,48
1,<environment.Job instance at 0x7fa148cfffa0>,24,3,[14  4],25,-1,59,-1,56
1,<environment.Job instance at 0x7fa1528ff190>,26,2,[13  4],27,-1,64,-1,62
1,<environment.Job instance at 0x7fa149dcc320>,29,27,[1 5],30,-1,94,-1,67
1,<environment.Job instance at 0x7fa149e05af0>,35,14,[ 5 12],36,-1,99,-1,85
1,<environment.Job instance at 0x7fa148c19050>,37,19,[14  4],38,-1,104,-1,85
1,<environment.Job instance at 0x7fa149e05410>,39,14,[ 5 11],40,-1,102,-1,88
1,<environment.Job instance at 0x7fa149d15af0>,46,25,[3 8],47,-1,135,-1,110
1,<environment.Job instance at 0x7fa148fbbb90>,48,3,[ 5 14],49,-1,113,-1,110
1,<environment.Job instance at 0x7fa148eceeb0>,49,27,[9 3],50,-1,139,-1,112
1,<environment.Job instance at 0x7fa1494fec30>,52,24,[ 3 10],53,-1,148,-1,124
1,<environment.Job instance at 0x7fa14965dd20>,57,12,[ 2 12],58,-1,139,-1,127
1,<environment.Job instance at 0x7fa149d59d20>,58,27,[1 7],59,-1,156,-1,129
1,<environment.Job instance at 0x7fa148fe86e0>,0,19,[1 5],1,-1,21,-1,2
1,<environment.Job instance at 0x7fa149906c30>,1,18,[2 9],2,-1,20,-1,2
1,<environment.Job instance at 0x7fa148fe8820>,2,18,[10  4],3,-1,22,-1,4
1,<environment.Job instance at 0x7fa148fe8a50>,5,2,[14  5],6,-1,8,-1,6
1,<environment.Job instance at 0x7fa1496b25a0>,7,18,[5 1],8,-1,26,-1,8
1,<environment.Job instance at 0x7fa148fe8af0>,3,13,[6 5],4,-1,22,-1,9
1,<environment.Job instance at 0x7fa15a6f7500>,9,15,[9 5],10,-1,27,-1,12
1,<environment.Job instance at 0x7fa1496b2230>,12,15,[5 1],13,-1,28,-1,13
1,<environment.Job instance at 0x7fa1496b20a0>,13,18,[5 9],14,-1,32,-1,14
1,<environment.Job instance at 0x7fa1496b26e0>,14,12,[6 4],15,-1,27,-1,15
1,<environment.Job instance at 0x7fa1496b28c0>,15,21,[2 5],16,-1,37,-1,16
1,<environment.Job instance at 0x7fa1496b23c0>,18,14,[5 9],19,-1,33,-1,19
1,<environment.Job instance at 0x7fa1496b27d0>,19,19,[9 1],20,-1,39,-1,20
1,<environment.Job instance at 0x7fa1496b2410>,20,12,[2 5],21,-1,33,-1,21
1,<environment.Job instance at 0x7fa1496b2d20>,21,16,[6 5],22,-1,38,-1,22
1,<environment.Job instance at 0x7fa1496b2500>,23,27,[1 8],24,-1,51,-1,24
1,<environment.Job instance at 0x7fa1496b2870>,25,12,[2 9],26,-1,38,-1,26
1,<environment.Job instance at 0x7fa1496b2910>,26,14,[3 9],27,-1,41,-1,27
1,<environment.Job instance at 0x7fa149811960>,29,13,[5 9],30,-1,43,-1,30
1,<environment.Job instance at 0x7fa1496b2780>,11,13,[5 3],12,-1,44,-1,31
1,<environment.Job instance at 0x7fa149811b90>,31,18,[8 4],32,-1,50,-1,32
1,<environment.Job instance at 0x7fa1498117d0>,34,17,[3 9],35,-1,52,-1,35
1,<environment.Job instance at 0x7fa149811820>,35,13,[10  4],36,-1,50,-1,37
1,<environment.Job instance at 0x7fa149811eb0>,36,16,[5 5],37,-1,53,-1,37
1,<environment.Job instance at 0x7fa149811be0>,37,22,[1 7],38,-1,61,-1,39
1,<environment.Job instance at 0x7fa149811a00>,41,18,[3 6],42,-1,60,-1,42
1,<environment.Job instance at 0x7fa148a10870>,45,25,[6 3],46,-1,71,-1,46
1,<environment.Job instance at 0x7fa148a10c30>,48,16,[8 5],49,-1,65,-1,49
1,<environment.Job instance at 0x7fa148a10820>,49,18,[7 5],50,-1,68,-1,50
1,<environment.Job instance at 0x7fa148a10be0>,51,14,[5 8],52,-1,66,-1,52
1,<environment.Job instance at 0x7fa148a102d0>,52,16,[9 2],53,-1,69,-1,53
1,<environment.Job instance at 0x7fa148a10fa0>,54,1,[5 7],55,-1,57,-1,56
1,<environment.Job instance at 0x7fa148a10500>,56,2,[2 9],57,-1,59,-1,57
1,<environment.Job instance at 0x7fa148a103c0>,55,18,[7 5],56,-1,77,-1,59
1,<environment.Job instance at 0x7fa148a10f50>,59,27,[ 5 10],60,-1,87,-1,60
1,<environment.Job instance at 0x7fa148a106e0>,58,17,[10  3],59,-1,77,-1,60
1,<environment.Job instance at 0x7fa149e089b0>,61,22,[ 1 10],62,-1,84,-1,62
1,<environment.Job instance at 0x7fa149e08230>,62,18,[5 1],63,-1,81,-1,63
1,<environment.Job instance at 0x7fa149e08140>,68,20,[6 2],69,-1,89,-1,69
1,<environment.Job instance at 0x7fa149e057d0>,5,2,[14  5],6,-1,8,-1,6
1,<environment.Job instance at 0x7fa148d47690>,23,27,[1 8],24,-1,89,-1,62
1,<environment.Job instance at 0x7fa149e08370>,43,3,[ 3 14],44,-1,142,-1,139
1,<environment.Job instance at 0x7fa149e08e60>,45,25,[6 3],46,-1,168,-1,143
1,<environment.Job instance at 0x7fa149e088c0>,50,2,[ 5 11],51,-1,156,-1,154
1,<environment.Job instance at 0x7fa149df82d0>,59,27,[ 5 10],60,-1,236,-1,209
1,<environment.Job instance at 0x7fa14863f320>,5,17,[7 1],6,-1,23,-1,6
1,<environment.Job instance at 0x7fa14863f1e0>,6,13,[11  1],7,-1,20,-1,7
1,<environment.Job instance at 0x7fa14863f6e0>,7,18,[1 7],8,-1,26,-1,8
1,<environment.Job instance at 0x7fa14863fb90>,9,14,[10  1],10,-1,26,-1,12
1,<environment.Job instance at 0x7fa14863fb40>,11,14,[10  4],12,-1,26,-1,12
1,<environment.Job instance at 0x7fa14863ff50>,12,18,[5 5],13,-1,31,-1,13
1,<environment.Job instance at 0x7fa14863f780>,15,15,[7 4],16,-1,31,-1,16
1,<environment.Job instance at 0x7fa148d1ecd0>,18,21,[5 8],19,-1,40,-1,19
1,<environment.Job instance at 0x7fa148748f00>,19,17,[7 2],20,-1,37,-1,20
1,<environment.Job instance at 0x7fa148748190>,20,12,[8 1],21,-1,33,-1,21
1,<environment.Job instance at 0x7fa148748b90>,21,28,[2 8],22,-1,50,-1,22
1,<environment.Job instance at 0x7fa148748c30>,22,18,[5 1],23,-1,41,-1,23
1,<environment.Job instance at 0x7fa148748500>,23,27,[9 3],24,-1,51,-1,24
1,<environment.Job instance at 0x7fa148748690>,26,28,[1 7],27,-1,55,-1,27
1,<environment.Job instance at 0x7fa1487485a0>,27,12,[ 4 10],28,-1,40,-1,28
1,<environment.Job instance at 0x7fa1487025a0>,36,28,[9 2],37,-1,65,-1,37
1,<environment.Job instance at 0x7fa1487029b0>,39,17,[1 5],40,-1,57,-1,40
1,<environment.Job instance at 0x7fa148702460>,41,13,[1 7],42,-1,55,-1,42
1,<environment.Job instance at 0x7fa148702780>,42,13,[4 8],43,-1,56,-1,43
1,<environment.Job instance at 0x7fa148720050>,50,14,[6 4],51,-1,65,-1,51
1,<environment.Job instance at 0x7fa148720d70>,54,15,[9 1],55,-1,71,-1,56
1,<environment.Job instance at 0x7fa148720460>,56,23,[7 4],57,-1,80,-1,57
1,<environment.Job instance at 0x7fa148df9f50>,58,17,[5 5],59,-1,76,-1,59
1,<environment.Job instance at 0x7fa148df9cd0>,59,14,[3 7],60,-1,74,-1,60
1,<environment.Job instance at 0x7fa148df9e60>,60,15,[9 4],61,-1,76,-1,61
1,<environment.Job instance at 0x7fa149d2dc80>,62,13,[1 5],63,-1,76,-1,63
1,<environment.Job instance at 0x7fa149d2d690>,63,20,[5 4],64,-1,84,-1,64
1,<environment.Job instance at 0x7fa148702870>,6,13,[11  1],7,-1,20,-1,7
1,<environment.Job instance at 0x7fa148cde640>,8,12,[ 5 12],9,-1,21,-1,9
1,<environment.Job instance at 0x7fa148dab1e0>,21,28,[2 8],22,-1,82,-1,54
1,<environment.Job instance at 0x7fa148da7be0>,26,28,[1 7],27,-1,110,-1,82
1,<environment.Job instance at 0x7fa148a47a00>,23,27,[9 3],24,-1,110,-1,83
1,<environment.Job instance at 0x7fa148da7cd0>,29,2,[ 4 11],30,-1,85,-1,83
1,<environment.Job instance at 0x7fa148da2370>,34,3,[11  1],35,-1,100,-1,97
1,<environment.Job instance at 0x7fa148a570a0>,36,28,[9 2],37,-1,127,-1,99
1,<environment.Job instance at 0x7fa148a2caa0>,47,3,[ 1 12],48,-1,118,-1,115
1,<environment.Job instance at 0x7fa148a2c550>,48,15,[ 3 11],49,-1,130,-1,115
1,<environment.Job instance at 0x7fa14961a7d0>,55,15,[ 2 11],56,-1,148,-1,133
1,<environment.Job instance at 0x7fa14925b1e0>,56,23,[7 4],57,-1,157,-1,134
1,<environment.Job instance at 0x7fa148889460>,4,15,[10  3],5,-1,21,-1,6
1,<environment.Job instance at 0x7fa1488897d0>,6,21,[6 5],7,-1,28,-1,7
1,<environment.Job instance at 0x7fa148889870>,7,13,[9 4],8,-1,21,-1,8
1,<environment.Job instance at 0x7fa148889eb0>,9,17,[5 9],10,-1,27,-1,10
1,<environment.Job instance at 0x7fa148889550>,10,15,[4 5],11,-1,26,-1,11
1,<environment.Job instance at 0x7fa148889a00>,11,27,[5 1],12,-1,39,-1,12
1,<environment.Job instance at 0x7fa148889c30>,12,21,[1 6],13,-1,34,-1,13
1,<environment.Job instance at 0x7fa1488891e0>,13,17,[8 5],14,-1,31,-1,14
1,<environment.Job instance at 0x7fa148889320>,15,16,[4 5],16,-1,32,-1,16
1,<environment.Job instance at 0x7fa1488890a0>,16,25,[8 3],17,-1,42,-1,17
1,<environment.Job instance at 0x7fa148889410>,18,16,[ 5 10],19,-1,35,-1,19
1,<environment.Job instance at 0x7fa148889f00>,19,18,[7 3],20,-1,38,-1,20
1,<environment.Job instance at 0x7fa1488896e0>,20,16,[9 2],21,-1,37,-1,21
1,<environment.Job instance at 0x7fa148889960>,21,19,[10  1],22,-1,41,-1,22
1,<environment.Job instance at 0x7fa149c1ce60>,26,25,[ 5 10],27,-1,52,-1,27
1,<environment.Job instance at 0x7fa149c1c2d0>,32,18,[5 9],33,-1,51,-1,33
1,<environment.Job instance at 0x7fa149c1cb90>,33,16,[6 5],34,-1,50,-1,34
1,<environment.Job instance at 0x7fa149c1cc30>,37,17,[5 2],38,-1,55,-1,38
1,<environment.Job instance at 0x7fa149c1caa0>,38,18,[1 9],39,-1,57,-1,39
1,<environment.Job instance at 0x7fa149dd45a0>,40,15,[3 9],41,-1,56,-1,41
1,<environment.Job instance at 0x7fa149dd40f0>,44,17,[9 5],45,-1,62,-1,45
1,<environment.Job instance at 0x7fa149dd49b0>,48,14,[9 4],49,-1,63,-1,49
1,<environment.Job instance at 0x7fa149dd4050>,49,13,[3 6],50,-1,63,-1,50
1,<environment.Job instance at 0x7fa149dd46e0>,50,26,[6 3],51,-1,77,-1,51
1,<environment.Job instance at 0x7fa149dd4820>,51,14,[4 6],52,-1,66,-1,52
1,<environment.Job instance at 0x7fa149dd4f00>,52,17,[ 2 11],53,-1,70,-1,53
1,<environment.Job instance at 0x7fa148a6fa50>,55,23,[7 1],56,-1,79,-1,56
1,<environment.Job instance at 0x7fa148a6f230>,57,17,[4 9],58,-1,75,-1,58
1,<environment.Job instance at 0x7fa148a6f7d0>,61,17,[10  4],62,-1,79,-1,62
1,<environment.Job instance at 0x7fa148a6fdc0>,62,14,[3 9],63,-1,77,-1,63
1,<environment.Job instance at 0x7fa148a6f0a0>,65,18,[10  3],66,-1,84,-1,66
1,<environment.Job instance at 0x7fa148a6f500>,67,18,[3 6],68,-1,86,-1,68
1,<environment.Job instance at 0x7fa1488895a0>,0,16,[14  3],1,-1,17,-1,1
1,<environment.Job instance at 0x7fa149b2b730>,11,27,[5 1],12,-1,53,-1,26
1,<environment.Job instance at 0x7fa14961a7d0>,17,13,[13  1],18,-1,43,-1,30
1,<environment.Job instance at 0x7fa14925b780>,16,25,[8 3],17,-1,70,-1,45
1,<environment.Job instance at 0x7fa148dde1e0>,26,25,[ 5 10],27,-1,112,-1,87
1,<environment.Job instance at 0x7fa148da7d70>,46,2,[13  5],47,-1,134,-1,132
1,<environment.Job instance at 0x7fa148dafbe0>,50,26,[6 3],51,-1,181,-1,155
1,<environment.Job instance at 0x7fa148dabaa0>,52,17,[ 2 11],53,-1,172,-1,155
1,<environment.Job instance at 0x7fa148dabd70>,55,23,[7 1],56,-1,185,-1,162
1,<environment.Job instance at 0x7fa1487022d0>,63,12,[ 1 14],64,-1,195,-1,183
1,<environment.Job instance at 0x7fa148748320>,66,13,[13  3],67,-1,214,-1,201
1,<environment.Job instance at 0x7fa148a6fe10>,68,1,[ 3 14],69,-1,215,-1,214
1,<environment.Job instance at 0x7fa152a37320>,4,18,[4 7],5,-1,23,-1,5
1,<environment.Job instance at 0x7fa14907d140>,6,17,[5 5],7,-1,24,-1,7
1,<environment.Job instance at 0x7fa14907d370>,13,16,[4 9],14,-1,30,-1,14
1,<environment.Job instance at 0x7fa14907deb0>,19,18,[9 5],20,-1,38,-1,20
1,<environment.Job instance at 0x7fa149906e60>,24,17,[6 5],25,-1,43,-1,26
1,<environment.Job instance at 0x7fa1498a78c0>,11,14,[ 3 14],12,-1,32,-1,18
1,<environment.Job instance at 0x7fa1493e6140>,15,13,[ 1 12],16,-1,35,-1,22
1,<environment.Job instance at 0x7fa1493e6910>,16,17,[11  2],17,-1,39,-1,22
1,<environment.Job instance at 0x7fa1493e6f50>,20,28,[5 6],21,-1,66,-1,38
1,<environment.Job instance at 0x7fa148702690>,23,28,[ 1 11],24,-1,68,-1,40
1,<environment.Job instance at 0x7fa148dd7cd0>,25,23,[5 3],26,-1,66,-1,43
1,<environment.Job instance at 0x7fa148dd7e10>,26,14,[13  5],27,-1,57,-1,43
1,<environment.Job instance at 0x7fa148dabd70>,30,13,[12  5],31,-1,69,-1,56
1,<environment.Job instance at 0x7fa148dafaf0>,38,15,[ 3 13],39,-1,97,-1,82
1,<environment.Job instance at 0x7fa148a575f0>,46,18,[ 3 13],47,-1,146,-1,128
1,<environment.Job instance at 0x7fa148dde910>,57,2,[ 4 14],58,-1,161,-1,159
1,<environment.Job instance at 0x7fa148819c30>,64,2,[ 1 12],65,-1,179,-1,177
1,<environment.Job instance at 0x7fa148e74500>,2,18,[9 4],3,-1,22,-1,4
1,<environment.Job instance at 0x7fa149308870>,7,15,[ 5 10],8,-1,23,-1,8
1,<environment.Job instance at 0x7fa148e74320>,3,18,[ 4 10],4,-1,26,-1,8
1,<environment.Job instance at 0x7fa148e74eb0>,8,17,[5 7],9,-1,26,-1,9
1,<environment.Job instance at 0x7fa1493082d0>,11,16,[ 4 10],12,-1,31,-1,15
1,<environment.Job instance at 0x7fa1485bddc0>,15,16,[4 6],16,-1,32,-1,16
1,<environment.Job instance at 0x7fa1485bda50>,16,18,[9 4],17,-1,35,-1,17
1,<environment.Job instance at 0x7fa1485bda00>,19,16,[2 8],20,-1,36,-1,20
1,<environment.Job instance at 0x7fa1485bdd70>,23,18,[ 5 10],24,-1,42,-1,24
1,<environment.Job instance at 0x7fa1485bd780>,24,20,[9 5],25,-1,45,-1,25
1,<environment.Job instance at 0x7fa1485bd960>,25,17,[7 4],26,-1,43,-1,26
1,<environment.Job instance at 0x7fa1485bd320>,26,18,[4 6],27,-1,45,-1,27
1,<environment.Job instance at 0x7fa148722b90>,33,17,[10  5],34,-1,51,-1,34
1,<environment.Job instance at 0x7fa148722cd0>,34,17,[3 6],35,-1,52,-1,35
1,<environment.Job instance at 0x7fa148722910>,37,16,[1 5],38,-1,54,-1,38
1,<environment.Job instance at 0x7fa1485bd460>,14,15,[ 2 10],15,-1,53,-1,38
1,<environment.Job instance at 0x7fa148c59b90>,40,13,[9 3],41,-1,54,-1,41
1,<environment.Job instance at 0x7fa148c59d20>,42,15,[3 8],43,-1,62,-1,47
1,<environment.Job instance at 0x7fa148c59410>,47,25,[9 4],48,-1,74,-1,49
1,<environment.Job instance at 0x7fa148c591e0>,50,16,[2 8],51,-1,73,-1,57
1,<environment.Job instance at 0x7fa1485bd3c0>,0,25,[2 8],1,-1,26,-1,1
1,<environment.Job instance at 0x7fa1485bd050>,4,3,[ 3 14],5,-1,8,-1,5
1,<environment.Job instance at 0x7fa148e740f0>,9,2,[13  5],10,-1,17,-1,15
1,<environment.Job instance at 0x7fa1490edc30>,18,1,[ 3 12],19,-1,53,-1,52
1,<environment.Job instance at 0x7fa148f03230>,35,18,[14  2],36,-1,135,-1,117
1,<environment.Job instance at 0x7fa148f10460>,47,25,[9 4],48,-1,205,-1,180
1,<environment.Job instance at 0x7fa148f10730>,51,3,[ 4 12],52,-1,187,-1,184
1,<environment.Job instance at 0x7fa148ef9af0>,56,16,[14  3],57,-1,218,-1,202
1,<environment.Job instance at 0x7fa148ef93c0>,57,14,[12  5],58,-1,216,-1,202
1,<environment.Job instance at 0x7fa148f0c550>,64,25,[7 4],65,-1,260,-1,235
1,<environment.Job instance at 0x7fa1499de410>,2,18,[5 8],3,-1,21,-1,3
1,<environment.Job instance at 0x7fa1499de0f0>,5,23,[8 2],6,-1,29,-1,6
1,<environment.Job instance at 0x7fa1499de280>,10,16,[5 9],11,-1,27,-1,11
1,<environment.Job instance at 0x7fa1499deaa0>,11,15,[9 5],12,-1,27,-1,12
1,<environment.Job instance at 0x7fa14982f3c0>,12,14,[9 1],13,-1,28,-1,14
1,<environment.Job instance at 0x7fa14982fe60>,17,12,[5 4],18,-1,30,-1,18
1,<environment.Job instance at 0x7fa14982f140>,18,14,[8 1],19,-1,33,-1,19
1,<environment.Job instance at 0x7fa1499de190>,13,18,[ 2 11],14,-1,37,-1,19
1,<environment.Job instance at 0x7fa14982f7d0>,19,16,[ 4 10],20,-1,36,-1,20
1,<environment.Job instance at 0x7fa14982f8c0>,20,18,[5 8],21,-1,40,-1,22
1,<environment.Job instance at 0x7fa14982fe10>,21,17,[3 7],22,-1,39,-1,22
1,<environment.Job instance at 0x7fa149586a00>,30,15,[4 9],31,-1,47,-1,32
1,<environment.Job instance at 0x7fa1495867d0>,33,16,[8 2],34,-1,50,-1,34
1,<environment.Job instance at 0x7fa149586050>,36,17,[9 3],37,-1,54,-1,37
1,<environment.Job instance at 0x7fa14958f960>,39,15,[5 6],40,-1,55,-1,40
1,<environment.Job instance at 0x7fa14958f230>,40,15,[9 1],41,-1,56,-1,41
1,<environment.Job instance at 0x7fa14958fa00>,43,16,[ 4 10],44,-1,60,-1,44
1,<environment.Job instance at 0x7fa14958f050>,44,18,[1 8],45,-1,63,-1,45
1,<environment.Job instance at 0x7fa14958f7d0>,45,13,[4 7],46,-1,59,-1,46
1,<environment.Job instance at 0x7fa14958f730>,48,18,[5 8],49,-1,67,-1,49
1,<environment.Job instance at 0x7fa14958f780>,50,20,[9 5],51,-1,71,-1,51
1,<environment.Job instance at 0x7fa14958fd70>,5,23,[8 2],6,-1,31,-1,8
1,<environment.Job instance at 0x7fa149a6c7d0>,13,18,[ 2 11],14,-1,34,-1,16
1,<environment.Job instance at 0x7fa148be4960>,15,3,[11  2],16,-1,21,-1,18
1,<environment.Job instance at 0x7fa148be47d0>,22,23,[7 1],23,-1,76,-1,53
1,<environment.Job instance at 0x7fa148be4410>,25,3,[13  2],26,-1,71,-1,68
1,<environment.Job instance at 0x7fa149a313c0>,28,1,[13  4],29,-1,70,-1,69
1,<environment.Job instance at 0x7fa149a31be0>,32,13,[14  4],33,-1,96,-1,83
1,<environment.Job instance at 0x7fa1495aa410>,41,23,[ 3 13],42,-1,142,-1,119
1,<environment.Job instance at 0x7fa148bf0910>,65,3,[ 1 14],66,-1,218,-1,215
1,<environment.Job instance at 0x7fa149e31a00>,4,14,[10  4],5,-1,20,-1,6
1,<environment.Job instance at 0x7fa149e310a0>,6,12,[9 4],7,-1,19,-1,7
1,<environment.Job instance at 0x7fa1489dbeb0>,8,12,[10  1],9,-1,22,-1,10
1,<environment.Job instance at 0x7fa1495b86e0>,10,16,[9 2],11,-1,27,-1,11
1,<environment.Job instance at 0x7fa1495b8eb0>,16,12,[6 4],17,-1,29,-1,17
1,<environment.Job instance at 0x7fa1495b80a0>,19,17,[9 2],20,-1,39,-1,22
1,<environment.Job instance at 0x7fa1495b84b0>,18,17,[1 6],19,-1,39,-1,22
1,<environment.Job instance at 0x7fa1495b85f0>,17,17,[8 2],18,-1,39,-1,22
1,<environment.Job instance at 0x7fa1495b8a50>,22,15,[2 9],23,-1,38,-1,23
1,<environment.Job instance at 0x7fa149774b90>,25,16,[11  3],26,-1,44,-1,28
1,<environment.Job instance at 0x7fa149774a50>,33,18,[ 2 10],34,-1,52,-1,34
1,<environment.Job instance at 0x7fa149774cd0>,34,17,[8 3],35,-1,52,-1,35
1,<environment.Job instance at 0x7fa149cc6f50>,37,17,[7 4],38,-1,55,-1,38
1,<environment.Job instance at 0x7fa149e31140>,9,21,[1 7],10,-1,68,-1,47
1,<environment.Job instance at 0x7fa149cc6320>,39,16,[10  5],40,-1,63,-1,47
1,<environment.Job instance at 0x7fa149cc6690>,45,17,[ 2 10],46,-1,64,-1,47
1,<environment.Job instance at 0x7fa148c19d70>,50,18,[9 2],51,-1,69,-1,51
1,<environment.Job instance at 0x7fa148c199b0>,53,14,[5 5],54,-1,69,-1,55
1,<environment.Job instance at 0x7fa1495b8690>,12,17,[ 2 14],13,-1,75,-1,58
1,<environment.Job instance at 0x7fa148c195a0>,57,14,[11  2],58,-1,72,-1,58
1,<environment.Job instance at 0x7fa149cc6410>,46,3,[6 2],47,-1,62,-1,59
1,<environment.Job instance at 0x7fa149cc6d70>,48,19,[7 1],49,-1,78,-1,59
1,<environment.Job instance at 0x7fa148c19eb0>,58,15,[ 3 14],59,-1,75,-1,60
1,<environment.Job instance at 0x7fa148c19f50>,59,18,[1 5],60,-1,79,-1,61
1,<environment.Job instance at 0x7fa148c195f0>,60,27,[7 4],61,-1,88,-1,61
1,<environment.Job instance at 0x7fa148c19780>,61,12,[6 3],62,-1,75,-1,63
1,<environment.Job instance at 0x7fa148c19370>,63,15,[4 8],64,-1,79,-1,64
1,<environment.Job instance at 0x7fa148c19cd0>,62,16,[10  2],63,-1,81,-1,65
1,<environment.Job instance at 0x7fa149cd0f50>,64,12,[1 8],65,-1,79,-1,67
1,<environment.Job instance at 0x7fa148c19190>,54,12,[7 4],55,-1,79,-1,67
1,<environment.Job instance at 0x7fa149cd09b0>,67,18,[6 2],68,-1,86,-1,68
1,<environment.Job instance at 0x7fa149cd0640>,68,14,[ 4 10],69,-1,83,-1,69
1,<environment.Job instance at 0x7fa149774f00>,0,13,[11  4],1,-1,14,-1,1
1,<environment.Job instance at 0x7fa149774eb0>,1,12,[ 1 13],2,-1,14,-1,2
1,<environment.Job instance at 0x7fa149e31dc0>,12,17,[ 2 14],13,-1,37,-1,20
1,<environment.Job instance at 0x7fa149a31190>,25,16,[11  3],26,-1,81,-1,65
1,<environment.Job instance at 0x7fa149cd0dc0>,36,1,[11  2],37,-1,89,-1,88
1,<environment.Job instance at 0x7fa1498e6550>,57,14,[11  2],58,-1,175,-1,161
1,<environment.Job instance at 0x7fa1498e6c80>,58,15,[ 3 14],59,-1,176,-1,161
1,<environment.Job instance at 0x7fa148fcbe60>,60,27,[7 4],61,-1,194,-1,167
1,<environment.Job instance at 0x7fa148fcba00>,65,2,[ 1 12],66,-1,182,-1,180
1,<environment.Job instance at 0x7fa1485f09b0>,1,14,[9 5],2,-1,17,-1,3
1,<environment.Job instance at 0x7fa1485f0730>,2,15,[7 3],3,-1,18,-1,3
1,<environment.Job instance at 0x7fa1485f0910>,4,19,[9 1],5,-1,25,-1,6
1,<environment.Job instance at 0x7fa14982b190>,9,15,[8 5],10,-1,27,-1,12
1,<environment.Job instance at 0x7fa14982b2d0>,12,16,[1 7],13,-1,29,-1,13
1,<environment.Job instance at 0x7fa14982beb0>,11,13,[9 4],12,-1,26,-1,13
1,<environment.Job instance at 0x7fa149823e60>,26,16,[4 9],27,-1,45,-1,29
1,<environment.Job instance at 0x7fa149823370>,27,22,[6 1],28,-1,51,-1,29
1,<environment.Job instance at 0x7fa148589e60>,30,12,[5 9],31,-1,44,-1,32
1,<environment.Job instance at 0x7fa148589e10>,29,14,[3 8],30,-1,46,-1,32
1,<environment.Job instance at 0x7fa149814500>,35,17,[10  3],36,-1,54,-1,37
1,<environment.Job instance at 0x7fa148c8ae10>,37,16,[8 4],38,-1,54,-1,38
1,<environment.Job instance at 0x7fa148ba0b40>,38,14,[6 3],39,-1,54,-1,40
1,<environment.Job instance at 0x7fa15246be10>,40,17,[8 4],41,-1,58,-1,41
1,<environment.Job instance at 0x7fa15246b910>,41,14,[ 5 10],42,-1,56,-1,42
1,<environment.Job instance at 0x7fa15246b500>,42,19,[8 3],43,-1,62,-1,43
1,<environment.Job instance at 0x7fa1498140f0>,31,18,[5 9],32,-1,63,-1,45
1,<environment.Job instance at 0x7fa15246b960>,44,17,[8 5],45,-1,62,-1,45
1,<environment.Job instance at 0x7fa149c47820>,46,23,[5 5],47,-1,73,-1,50
1,<environment.Job instance at 0x7fa149820190>,49,25,[7 3],50,-1,75,-1,50
1,<environment.Job instance at 0x7fa149b373c0>,48,14,[9 5],49,-1,68,-1,54
1,<environment.Job instance at 0x7fa15246baf0>,43,13,[8 3],44,-1,67,-1,54
1,<environment.Job instance at 0x7fa14857e0f0>,53,17,[6 4],54,-1,71,-1,54
1,<environment.Job instance at 0x7fa14856d7d0>,22,14,[9 3],23,-1,68,-1,54
1,<environment.Job instance at 0x7fa14857eb40>,54,17,[4 7],55,-1,72,-1,55
1,<environment.Job instance at 0x7fa14857e5f0>,56,13,[10  5],57,-1,70,-1,57
1,<environment.Job instance at 0x7fa14857ee10>,57,14,[2 6],58,-1,72,-1,58
1,<environment.Job instance at 0x7fa14857e5a0>,58,12,[5 1],59,-1,71,-1,59
1,<environment.Job instance at 0x7fa149d5e190>,62,14,[10  1],63,-1,77,-1,63
1,<environment.Job instance at 0x7fa148d800f0>,64,15,[8 1],65,-1,81,-1,66
1,<environment.Job instance at 0x7fa1497a86e0>,66,1,[ 3 10],67,-1,68,-1,67
1,<environment.Job instance at 0x7fa1497a8320>,67,15,[3 9],68,-1,83,-1,68
1,<environment.Job instance at 0x7fa149d269b0>,68,15,[ 4 10],69,-1,84,-1,69
1,<environment.Job instance at 0x7fa148726dc0>,65,14,[5 7],66,-1,83,-1,69
1,<environment.Job instance at 0x7fa14982bcd0>,0,25,[ 1 14],1,-1,26,-1,1
1,<environment.Job instance at 0x7fa14856d960>,3,1,[ 4 13],4,-1,5,-1,4
1,<environment.Job instance at 0x7fa149885780>,5,3,[ 4 11],6,-1,9,-1,6
1,<environment.Job instance at 0x7fa149660820>,18,3,[11  1],19,-1,40,-1,37
1,<environment.Job instance at 0x7fa149e44f50>,46,23,[5 5],47,-1,165,-1,142
1,<environment.Job instance at 0x7fa149e44640>,49,25,[7 3],50,-1,182,-1,157
1,<environment.Job instance at 0x7fa1488dfaf0>,50,1,[12  5],51,-1,158,-1,157
1,<environment.Job instance at 0x7fa1493ff3c0>,61,3,[ 3 11],62,-1,197,-1,194
1,<environment.Job instance at 0x7fa149696640>,0,18,[5 4],1,-1,19,-1,1
1,<environment.Job instance at 0x7fa149696b90>,2,19,[6 2],3,-1,22,-1,3
1,<environment.Job instance at 0x7fa149696050>,8,18,[ 4 10],9,-1,27,-1,9
1,<environment.Job instance at 0x7fa1488ac6e0>,13,16,[3 8],14,-1,30,-1,14
1,<environment.Job instance at 0x7fa1488ac320>,14,16,[9 2],15,-1,33,-1,17
1,<environment.Job instance at 0x7fa1488acb40>,17,18,[5 5],18,-1,36,-1,18
1,<environment.Job instance at 0x7fa1488ac500>,16,18,[3 6],17,-1,36,-1,18
1,<environment.Job instance at 0x7fa149a96280>,23,18,[4 5],24,-1,42,-1,24
1,<environment.Job instance at 0x7fa149a96370>,25,18,[5 8],26,-1,44,-1,26
1,<environment.Job instance at 0x7fa149a969b0>,26,18,[3 9],27,-1,46,-1,28
1,<environment.Job instance at 0x7fa149a96640>,32,13,[14  2],33,-1,50,-1,37
1,<environment.Job instance at 0x7fa149a96a50>,35,16,[6 5],36,-1,53,-1,37
1,<environment.Job instance at 0x7fa149a96320>,37,18,[9 4],38,-1,56,-1,38
1,<environment.Job instance at 0x7fa14907e960>,38,15,[1 8],39,-1,57,-1,42
1,<environment.Job instance at 0x7fa14907efa0>,40,15,[5 1],41,-1,69,-1,54
1,<environment.Job instance at 0x7fa149a96c30>,34,22,[5 8],35,-1,76,-1,54
1,<environment.Job instance at 0x7fa1493ff870>,54,17,[3 7],55,-1,72,-1,55
1,<environment.Job instance at 0x7fa1493fffa0>,56,14,[7 5],57,-1,71,-1,57
1,<environment.Job instance at 0x7fa149e3dd20>,59,18,[2 9],60,-1,78,-1,60
1,<environment.Job instance at 0x7fa149e3dc80>,60,18,[5 5],61,-1,79,-1,61
1,<environment.Job instance at 0x7fa149e3db90>,62,1,[3 9],63,-1,70,-1,69
1,<environment.Job instance at 0x7fa1493ff500>,49,18,[1 9],50,-1,91,-1,73
1,<environment.Job instance at 0x7fa149696960>,7,18,[ 3 12],8,-1,92,-1,74
1,<environment.Job instance at 0x7fa149e3d230>,64,16,[7 5],65,-1,90,-1,74
1,<environment.Job instance at 0x7fa1488acc30>,5,3,[14  4],6,-1,9,-1,6
1,<environment.Job instance at 0x7fa1493ff050>,6,17,[ 1 13],7,-1,24,-1,7
1,<environment.Job instance at 0x7fa1496964b0>,7,18,[ 3 12],8,-1,26,-1,8
1,<environment.Job instance at 0x7fa1493ff820>,11,2,[11  4],12,-1,14,-1,12
1,<environment.Job instance at 0x7fa149a96460>,18,22,[ 1 13],19,-1,47,-1,25
1,<environment.Job instance at 0x7fa1493fa5f0>,28,2,[11  2],29,-1,67,-1,65
1,<environment.Job instance at 0x7fa15249da50>,29,23,[4 9],30,-1,88,-1,65
1,<environment.Job instance at 0x7fa149e3dd70>,32,13,[14  2],33,-1,79,-1,66
1,<environment.Job instance at 0x7fa149dc5fa0>,50,2,[ 4 14],51,-1,137,-1,135
1,<environment.Job instance at 0x7fa148866690>,1,13,[9 1],2,-1,18,-1,5
1,<environment.Job instance at 0x7fa1495440f0>,5,20,[10  3],6,-1,27,-1,7
1,<environment.Job instance at 0x7fa1495446e0>,12,18,[9 2],13,-1,31,-1,13
1,<environment.Job instance at 0x7fa149544870>,14,14,[5 9],15,-1,29,-1,15
1,<environment.Job instance at 0x7fa149544960>,15,14,[6 3],16,-1,30,-1,16
1,<environment.Job instance at 0x7fa149544a50>,17,23,[6 1],18,-1,41,-1,18
1,<environment.Job instance at 0x7fa149544f50>,21,14,[1 5],22,-1,36,-1,22
1,<environment.Job instance at 0x7fa149548050>,22,17,[5 1],23,-1,40,-1,23
1,<environment.Job instance at 0x7fa1495482d0>,25,12,[8 3],26,-1,38,-1,26
1,<environment.Job instance at 0x7fa1495484b0>,26,18,[ 2 10],27,-1,45,-1,27
1,<environment.Job instance at 0x7fa149548230>,27,17,[5 5],28,-1,45,-1,28
1,<environment.Job instance at 0x7fa149548550>,28,14,[9 5],29,-1,43,-1,29
1,<environment.Job instance at 0x7fa1495485f0>,29,14,[8 5],30,-1,44,-1,30
1,<environment.Job instance at 0x7fa149548690>,30,25,[9 4],31,-1,58,-1,33
1,<environment.Job instance at 0x7fa149541f00>,4,15,[10  2],5,-1,48,-1,33
1,<environment.Job instance at 0x7fa149548910>,34,28,[ 5 10],35,-1,63,-1,35
1,<environment.Job instance at 0x7fa149548be0>,36,13,[5 9],37,-1,50,-1,37
1,<environment.Job instance at 0x7fa149548c80>,37,27,[2 9],38,-1,65,-1,38
1,<environment.Job instance at 0x7fa149548c30>,38,26,[4 9],39,-1,65,-1,39
1,<environment.Job instance at 0x7fa149541e10>,3,17,[14  2],4,-1,56,-1,39
1,<environment.Job instance at 0x7fa149548eb0>,40,18,[5 4],41,-1,60,-1,42
1,<environment.Job instance at 0x7fa149570370>,44,16,[8 1],45,-1,61,-1,45
1,<environment.Job instance at 0x7fa149570690>,46,16,[ 5 12],47,-1,64,-1,48
1,<environment.Job instance at 0x7fa1495704b0>,48,19,[2 7],49,-1,68,-1,49
1,<environment.Job instance at 0x7fa149570be0>,52,22,[5 4],53,-1,77,-1,55
1,<environment.Job instance at 0x7fa149570f00>,55,13,[5 5],56,-1,70,-1,57
1,<environment.Job instance at 0x7fa149e2f9b0>,59,13,[4 8],60,-1,76,-1,63
1,<environment.Job instance at 0x7fa149696d20>,58,17,[7 5],59,-1,95,-1,78
1,<environment.Job instance at 0x7fa14955d7d0>,60,17,[10  1],61,-1,95,-1,78
1,<environment.Job instance at 0x7fa149561190>,66,17,[ 2 14],67,-1,101,-1,84
1,<environment.Job instance at 0x7fa14955d140>,61,16,[2 5],62,-1,100,-1,84
1,<environment.Job instance at 0x7fa149570c80>,54,13,[5 8],55,-1,97,-1,84
1,<environment.Job instance at 0x7fa148ed4f50>,3,17,[14  2],4,-1,21,-1,4
1,<environment.Job instance at 0x7fa149dc5640>,16,2,[ 5 12],17,-1,37,-1,35
1,<environment.Job instance at 0x7fa149dc50f0>,17,23,[6 1],18,-1,60,-1,37
1,<environment.Job instance at 0x7fa148ec9320>,30,25,[9 4],31,-1,104,-1,79
1,<environment.Job instance at 0x7fa14906f5a0>,34,28,[ 5 10],35,-1,124,-1,96
1,<environment.Job instance at 0x7fa14907edc0>,37,27,[2 9],38,-1,124,-1,97
1,<environment.Job instance at 0x7fa149a960f0>,38,26,[4 9],39,-1,123,-1,97
1,<environment.Job instance at 0x7fa1491483c0>,46,16,[ 5 12],47,-1,131,-1,115
1,<environment.Job instance at 0x7fa149548b40>,66,17,[ 2 14],67,-1,199,-1,182
1,<environment.Job instance at 0x7fa148d09050>,67,26,[10  5],68,-1,210,-1,184
1,<environment.Job instance at 0x7fa149599be0>,0,18,[4 5],1,-1,19,-1,1
1,<environment.Job instance at 0x7fa149599820>,1,18,[4 9],2,-1,20,-1,2
1,<environment.Job instance at 0x7fa149599640>,3,13,[9 3],4,-1,18,-1,5
1,<environment.Job instance at 0x7fa149599500>,5,14,[ 3 10],6,-1,20,-1,6
1,<environment.Job instance at 0x7fa149599eb0>,6,14,[5 4],7,-1,21,-1,7
1,<environment.Job instance at 0x7fa149df64b0>,4,19,[2 5],5,-1,26,-1,7
1,<environment.Job instance at 0x7fa149989fa0>,13,23,[1 7],14,-1,37,-1,14
1,<environment.Job instance at 0x7fa1499893c0>,14,22,[1 8],15,-1,38,-1,16
1,<environment.Job instance at 0x7fa149599140>,15,18,[ 2 10],16,-1,34,-1,16
1,<environment.Job instance at 0x7fa149989be0>,19,17,[9 1],20,-1,38,-1,21
1,<environment.Job instance at 0x7fa149989b40>,22,26,[1 5],23,-1,49,-1,23
1,<environment.Job instance at 0x7fa1499898c0>,23,17,[ 4 10],24,-1,41,-1,24
1,<environment.Job instance at 0x7fa1490eba00>,25,15,[8 3],26,-1,41,-1,26
1,<environment.Job instance at 0x7fa1490eb140>,27,12,[9 2],28,-1,40,-1,28
1,<environment.Job instance at 0x7fa148898500>,30,13,[10  5],31,-1,44,-1,31
1,<environment.Job instance at 0x7fa1488980f0>,32,22,[5 3],33,-1,55,-1,33
1,<environment.Job instance at 0x7fa148898190>,34,15,[4 7],35,-1,50,-1,35
1,<environment.Job instance at 0x7fa148898870>,37,24,[2 8],38,-1,62,-1,38
1,<environment.Job instance at 0x7fa148898960>,41,16,[4 9],42,-1,58,-1,42
1,<environment.Job instance at 0x7fa1492d74b0>,43,26,[1 8],44,-1,70,-1,44
1,<environment.Job instance at 0x7fa1492d7b40>,45,12,[5 2],46,-1,58,-1,46
1,<environment.Job instance at 0x7fa1492d7d20>,46,18,[7 1],47,-1,65,-1,47
1,<environment.Job instance at 0x7fa149426410>,51,23,[9 4],52,-1,75,-1,52
1,<environment.Job instance at 0x7fa1494265a0>,52,13,[1 9],53,-1,66,-1,53
1,<environment.Job instance at 0x7fa1494266e0>,56,16,[9 3],57,-1,73,-1,57
1,<environment.Job instance at 0x7fa149426550>,58,16,[5 1],59,-1,75,-1,59
1,<environment.Job instance at 0x7fa149426190>,60,17,[4 7],61,-1,78,-1,61
1,<environment.Job instance at 0x7fa1494263c0>,61,14,[3 5],62,-1,76,-1,62
1,<environment.Job instance at 0x7fa152aa3af0>,63,12,[4 5],64,-1,76,-1,64
1,<environment.Job instance at 0x7fa148f2cf00>,67,17,[4 6],68,-1,85,-1,68
1,<environment.Job instance at 0x7fa149426a00>,13,23,[1 7],14,-1,57,-1,34
1,<environment.Job instance at 0x7fa149e87b90>,18,13,[14  3],19,-1,48,-1,35
1,<environment.Job instance at 0x7fa149544140>,22,26,[1 5],23,-1,72,-1,46
1,<environment.Job instance at 0x7fa1490e7be0>,37,24,[2 8],38,-1,127,-1,103
1,<environment.Job instance at 0x7fa152480e10>,39,13,[14  2],40,-1,116,-1,103
1,<environment.Job instance at 0x7fa149e3dc30>,43,26,[1 8],44,-1,146,-1,120
1,<environment.Job instance at 0x7fa149e3d550>,49,15,[ 1 14],50,-1,151,-1,136
1,<environment.Job instance at 0x7fa149dc54b0>,51,23,[9 4],52,-1,162,-1,139
1,<environment.Job instance at 0x7fa149c79b40>,0,18,[3 6],1,-1,19,-1,1
1,<environment.Job instance at 0x7fa148bba5a0>,2,16,[1 9],3,-1,19,-1,3
1,<environment.Job instance at 0x7fa148bba500>,4,12,[10  3],5,-1,19,-1,7
1,<environment.Job instance at 0x7fa149467230>,6,16,[2 7],7,-1,24,-1,8
1,<environment.Job instance at 0x7fa149747f00>,10,14,[1 9],11,-1,25,-1,11
1,<environment.Job instance at 0x7fa1484ec370>,14,17,[10  5],15,-1,32,-1,15
1,<environment.Job instance at 0x7fa1484ec0f0>,15,15,[1 6],16,-1,31,-1,16
1,<environment.Job instance at 0x7fa149eab0a0>,17,16,[11  5],18,-1,34,-1,18
1,<environment.Job instance at 0x7fa15248f5f0>,18,13,[3 6],19,-1,38,-1,25
1,<environment.Job instance at 0x7fa1487ebd20>,25,17,[ 5 10],26,-1,44,-1,27
1,<environment.Job instance at 0x7fa1487eb690>,24,12,[7 2],25,-1,42,-1,30
1,<environment.Job instance at 0x7fa1487eb820>,30,15,[6 2],31,-1,48,-1,33
1,<environment.Job instance at 0x7fa14883fcd0>,33,16,[9 5],34,-1,64,-1,48
1,<environment.Job instance at 0x7fa14883f1e0>,34,16,[8 5],35,-1,65,-1,49
1,<environment.Job instance at 0x7fa14883f280>,37,14,[ 5 10],38,-1,64,-1,50
1,<environment.Job instance at 0x7fa14883f960>,32,16,[5 3],33,-1,66,-1,50
1,<environment.Job instance at 0x7fa1487e16e0>,42,16,[9 3],43,-1,66,-1,50
1,<environment.Job instance at 0x7fa1494518c0>,44,16,[7 3],45,-1,66,-1,50
1,<environment.Job instance at 0x7fa149451b90>,45,22,[5 2],46,-1,72,-1,50
1,<environment.Job instance at 0x7fa14932e780>,48,13,[5 7],49,-1,63,-1,50
1,<environment.Job instance at 0x7fa1496fe690>,50,13,[11  3],51,-1,64,-1,51
1,<environment.Job instance at 0x7fa148be7f50>,51,28,[7 5],52,-1,80,-1,52
1,<environment.Job instance at 0x7fa149451c80>,43,14,[1 6],44,-1,66,-1,52
1,<environment.Job instance at 0x7fa14960f7d0>,55,18,[10  4],56,-1,76,-1,58
1,<environment.Job instance at 0x7fa149979be0>,61,18,[4 9],62,-1,80,-1,62
1,<environment.Job instance at 0x7fa148abcb90>,62,18,[3 6],63,-1,81,-1,63
1,<environment.Job instance at 0x7fa148981af0>,68,18,[8 3],69,-1,90,-1,72
1,<environment.Job instance at 0x7fa1497de5a0>,17,16,[11  5],18,-1,64,-1,48
1,<environment.Job instance at 0x7fa149dc5500>,21,3,[13  1],22,-1,68,-1,65
1,<environment.Job instance at 0x7fa149d5c3c0>,35,1,[ 3 12],36,-1,115,-1,114
1,<environment.Job instance at 0x7fa148898f00>,38,3,[ 5 12],39,-1,122,-1,119
1,<environment.Job instance at 0x7fa14879e140>,46,1,[11  1],47,-1,161,-1,160
1,<environment.Job instance at 0x7fa14879ef00>,50,13,[11  3],51,-1,186,-1,173
1,<environment.Job instance at 0x7fa14879e550>,51,28,[7 5],52,-1,202,-1,174
1,<environment.Job instance at 0x7fa14879e320>,53,2,[14  5],54,-1,176,-1,174
1,<environment.Job instance at 0x7fa14879ea00>,54,26,[7 1],55,-1,202,-1,176
1,<environment.Job instance at 0x7fa1527b3230>,67,13,[13  4],68,-1,229,-1,216
1,<environment.Job instance at 0x7fa149e88230>,3,18,[6 3],4,-1,22,-1,4
1,<environment.Job instance at 0x7fa149e88140>,4,17,[10  3],5,-1,30,-1,13
1,<environment.Job instance at 0x7fa149b375f0>,5,18,[ 2 11],6,-1,32,-1,14
1,<environment.Job instance at 0x7fa149cadfa0>,9,15,[9 3],10,-1,32,-1,17
1,<environment.Job instance at 0x7fa1499a1820>,13,12,[4 8],14,-1,29,-1,17
1,<environment.Job instance at 0x7fa149e7fc80>,16,15,[4 7],17,-1,33,-1,18
1,<environment.Job instance at 0x7fa1527e5780>,18,27,[1 7],19,-1,46,-1,19
1,<environment.Job instance at 0x7fa148a697d0>,30,17,[5 9],31,-1,48,-1,31
1,<environment.Job instance at 0x7fa148ed45f0>,31,17,[9 4],32,-1,49,-1,32
1,<environment.Job instance at 0x7fa148a9dc80>,34,14,[9 5],35,-1,51,-1,37
1,<environment.Job instance at 0x7fa1487aeaf0>,37,18,[ 5 10],38,-1,56,-1,38
1,<environment.Job instance at 0x7fa1487aed20>,38,15,[1 8],39,-1,54,-1,39
1,<environment.Job instance at 0x7fa148794960>,40,13,[7 3],41,-1,54,-1,41
1,<environment.Job instance at 0x7fa14876c960>,42,12,[10  2],43,-1,55,-1,43
1,<environment.Job instance at 0x7fa148792be0>,36,16,[3 8],37,-1,61,-1,45
1,<environment.Job instance at 0x7fa14876c910>,44,18,[ 2 10],45,-1,64,-1,46
1,<environment.Job instance at 0x7fa14876cb40>,46,18,[ 2 10],47,-1,65,-1,47
1,<environment.Job instance at 0x7fa14876cb90>,47,18,[5 9],48,-1,66,-1,48
1,<environment.Job instance at 0x7fa1487825a0>,50,17,[8 2],51,-1,68,-1,51
1,<environment.Job instance at 0x7fa1487823c0>,51,14,[4 9],52,-1,66,-1,52
1,<environment.Job instance at 0x7fa148782780>,52,16,[6 2],53,-1,69,-1,53
1,<environment.Job instance at 0x7fa1487827d0>,54,15,[2 5],55,-1,70,-1,55
1,<environment.Job instance at 0x7fa1485385a0>,58,25,[5 5],59,-1,84,-1,59
1,<environment.Job instance at 0x7fa149847aa0>,0,24,[10  5],1,-1,25,-1,1
1,<environment.Job instance at 0x7fa149b37a50>,1,3,[ 4 12],2,-1,5,-1,2
1,<environment.Job instance at 0x7fa149cadf00>,5,18,[ 2 11],6,-1,24,-1,6
1,<environment.Job instance at 0x7fa149dd2640>,6,13,[11  3],7,-1,20,-1,7
1,<environment.Job instance at 0x7fa1487aa2d0>,8,27,[5 1],9,-1,36,-1,9
1,<environment.Job instance at 0x7fa148538be0>,18,27,[1 7],19,-1,63,-1,36
1,<environment.Job instance at 0x7fa14923a1e0>,19,16,[12  5],20,-1,52,-1,36
1,<environment.Job instance at 0x7fa14879e0a0>,26,1,[14  4],27,-1,42,-1,41
1,<environment.Job instance at 0x7fa14879e320>,27,17,[13  5],28,-1,58,-1,41
1,<environment.Job instance at 0x7fa148981960>,58,25,[5 5],59,-1,210,-1,185
1,<environment.Job instance at 0x7fa149979cd0>,60,18,[14  5],61,-1,203,-1,185
1,<environment.Job instance at 0x7fa148be7c80>,61,15,[ 1 12],62,-1,200,-1,185
1,<environment.Job instance at 0x7f45563ac6e0>,0,13,[9 3],1,-1,15,-1,2
1,<environment.Job instance at 0x7f45563ac8c0>,1,22,[11  3],2,-1,24,-1,2
1,<environment.Job instance at 0x7f45563ac730>,2,22,[4 8],3,-1,25,-1,3
1,<environment.Job instance at 0x7f454cdbcfa0>,9,18,[11  5],10,-1,28,-1,10
1,<environment.Job instance at 0x7f454cdbf0f0>,11,15,[4 8],12,-1,27,-1,12
1,<environment.Job instance at 0x7f454cdbf320>,12,26,[ 1 10],13,-1,39,-1,13
1,<environment.Job instance at 0x7f454cdbf230>,13,18,[ 4 10],14,-1,32,-1,14
1,<environment.Job instance at 0x7f454cdbf460>,15,18,[2 8],16,-1,34,-1,16
1,<environment.Job instance at 0x7f454cdbf640>,16,16,[3 5],17,-1,33,-1,17
1,<environment.Job instance at 0x7f454cdbfb90>,23,27,[1 6],24,-1,51,-1,24
1,<environment.Job instance at 0x7f454cdbfd20>,24,18,[2 6],25,-1,43,-1,25
1,<environment.Job instance at 0x7f454cdc20a0>,27,15,[8 4],28,-1,43,-1,28
1,<environment.Job instance at 0x7f454cdc21e0>,28,23,[10  4],29,-1,52,-1,29
1,<environment.Job instance at 0x7f454cdc2140>,29,12,[5 4],30,-1,42,-1,30
1,<environment.Job instance at 0x7f454cdc2320>,30,14,[5 2],31,-1,46,-1,32
1,<environment.Job instance at 0x7f454cdc2500>,33,14,[5 5],34,-1,48,-1,34
1,<environment.Job instance at 0x7f454cdc2690>,34,24,[1 8],35,-1,59,-1,35
1,<environment.Job instance at 0x7f454cdc2550>,35,15,[9 5],36,-1,51,-1,36
1,<environment.Job instance at 0x7f454cdc2be0>,40,15,[10  3],41,-1,56,-1,41
1,<environment.Job instance at 0x7f454cdc2e10>,43,18,[5 5],44,-1,62,-1,44
1,<environment.Job instance at 0x7f454cdc4230>,48,15,[10  1],49,-1,69,-1,54
1,<environment.Job instance at 0x7f454cdc4be0>,56,17,[8 5],57,-1,74,-1,57
1,<environment.Job instance at 0x7f454cdc4a00>,54,13,[13  1],55,-1,78,-1,65
1,<environment.Job instance at 0x7f454cdc4640>,50,16,[12  2],51,-1,81,-1,65
1,<environment.Job instance at 0x7f454cdc4dc0>,57,18,[2 8],58,-1,83,-1,65
1,<environment.Job instance at 0x7f454cdc6140>,64,18,[2 9],65,-1,83,-1,65
1,<environment.Job instance at 0x7f454cdc65a0>,65,20,[2 6],66,-1,93,-1,73
1,<environment.Job instance at 0x7f454cdc6640>,67,27,[ 1 10],68,-1,100,-1,73
1,<environment.Job instance at 0x7f454cdc6b40>,73,13,[6 3],74,-1,88,-1,75
1,<environment.Job instance at 0x7f454cdc67d0>,69,13,[ 3 12],70,-1,88,-1,75
1,<environment.Job instance at 0x7f454cdc6d70>,75,14,[ 4 11],76,-1,90,-1,76
1,<environment.Job instance at 0x7f454cdc4e60>,59,17,[1 6],60,-1,95,-1,78
1,<environment.Job instance at 0x7f454cdc6f00>,76,19,[4 8],77,-1,98,-1,79
1,<environment.Job instance at 0x7f454cdca0a0>,78,12,[10  2],79,-1,91,-1,79
1,<environment.Job instance at 0x7f454cdbf730>,1,22,[11  3],2,-1,24,-1,2
1,<environment.Job instance at 0x7f454cdc4870>,9,18,[11  5],10,-1,32,-1,14
1,<environment.Job instance at 0x7f454cdc6370>,12,26,[ 1 10],13,-1,82,-1,56
1,<environment.Job instance at 0x7f454cdb3690>,23,27,[1 6],24,-1,87,-1,60
1,<environment.Job instance at 0x7f454cfed8c0>,28,23,[10  4],29,-1,97,-1,74
1,<environment.Job instance at 0x7f454ced5960>,34,24,[1 8],35,-1,117,-1,93
1,<environment.Job instance at 0x7f454ce6eb90>,36,13,[ 3 14],37,-1,106,-1,93
1,<environment.Job instance at 0x7f454cee3050>,46,17,[12  2],47,-1,134,-1,117
1,<environment.Job instance at 0x7f454cddfeb0>,50,16,[12  2],51,-1,146,-1,130
1,<environment.Job instance at 0x7f454ced9140>,54,13,[13  1],55,-1,158,-1,145
1,<environment.Job instance at 0x7f454cde4730>,60,3,[12  3],61,-1,169,-1,166
1,<environment.Job instance at 0x7f454cf13140>,67,27,[ 1 10],68,-1,216,-1,189
1,<environment.Job instance at 0x7f454cedf190>,69,13,[ 3 12],70,-1,202,-1,189
1,<environment.Job instance at 0x7f454ceca4b0>,75,14,[ 4 11],76,-1,215,-1,201
1,<environment.Job instance at 0x7f454c504190>,1,15,[5 9],2,-1,17,-1,2
1,<environment.Job instance at 0x7f454c5043c0>,2,16,[ 4 10],3,-1,19,-1,3
1,<environment.Job instance at 0x7f454c5045a0>,4,18,[3 7],5,-1,23,-1,5
1,<environment.Job instance at 0x7f454c504870>,5,17,[3 9],6,-1,23,-1,6
1,<environment.Job instance at 0x7f454c504780>,6,18,[9 2],7,-1,25,-1,7
1,<environment.Job instance at 0x7f454c506e10>,9,14,[5 3],10,-1,24,-1,10
1,<environment.Job instance at 0x7f454c500f50>,12,20,[1 5],13,-1,33,-1,13
1,<environment.Job instance at 0x7f454c67aaf0>,19,18,[12  5],20,-1,38,-1,20
1,<environment.Job instance at 0x7f454c617aa0>,20,18,[2 7],21,-1,39,-1,21
1,<environment.Job instance at 0x7f454c5e4be0>,21,18,[ 1 10],22,-1,40,-1,22
1,<environment.Job instance at 0x7f454c5e4730>,22,16,[3 9],23,-1,39,-1,23
1,<environment.Job instance at 0x7f454c5e4500>,23,16,[1 6],24,-1,40,-1,24
1,<environment.Job instance at 0x7f454c63c320>,27,17,[9 3],28,-1,49,-1,32
1,<environment.Job instance at 0x7f454c5e26e0>,34,14,[2 5],35,-1,49,-1,35
1,<environment.Job instance at 0x7f454c384fa0>,35,16,[7 5],36,-1,52,-1,36
1,<environment.Job instance at 0x7f454c36d370>,39,20,[2 6],40,-1,60,-1,40
1,<environment.Job instance at 0x7f454ccd6af0>,43,12,[ 4 11],44,-1,56,-1,44
1,<environment.Job instance at 0x7f454c4c7780>,45,21,[4 5],46,-1,67,-1,46
1,<environment.Job instance at 0x7f454cd05f00>,47,22,[4 5],48,-1,70,-1,48
1,<environment.Job instance at 0x7f454c504c30>,50,15,[8 3],51,-1,66,-1,51
1,<environment.Job instance at 0x7f454c3ba0f0>,53,16,[ 3 10],54,-1,70,-1,54
1,<environment.Job instance at 0x7f454c3b5eb0>,55,14,[ 2 10],56,-1,70,-1,56
1,<environment.Job instance at 0x7f454c3baa50>,57,20,[9 2],58,-1,78,-1,58
1,<environment.Job instance at 0x7f454c5e2960>,31,26,[ 5 10],32,-1,96,-1,70
1,<environment.Job instance at 0x7f454c3ebc30>,60,16,[2 8],61,-1,88,-1,72
1,<environment.Job instance at 0x7f454c354550>,72,14,[1 8],73,-1,87,-1,73
1,<environment.Job instance at 0x7f454c353550>,74,14,[8 4],75,-1,89,-1,75
1,<environment.Job instance at 0x7f454c55b640>,17,2,[ 5 11],18,-1,38,-1,36
1,<environment.Job instance at 0x7f454c6072d0>,19,18,[12  5],20,-1,56,-1,38
1,<environment.Job instance at 0x7f454c55d550>,25,14,[14  5],26,-1,75,-1,61
1,<environment.Job instance at 0x7f454c55d640>,26,15,[11  1],27,-1,76,-1,61
1,<environment.Job instance at 0x7f454c5cb280>,31,26,[ 5 10],32,-1,118,-1,92
1,<environment.Job instance at 0x7f454c56dfa0>,36,3,[ 1 12],37,-1,106,-1,103
1,<environment.Job instance at 0x7f454c57c280>,42,3,[ 4 12],43,-1,110,-1,107
1,<environment.Job instance at 0x7f454c57c230>,43,12,[ 4 11],44,-1,119,-1,107
1,<environment.Job instance at 0x7f454c5851e0>,48,23,[ 2 14],49,-1,141,-1,118
1,<environment.Job instance at 0x7f454c56ae10>,58,16,[11  2],59,-1,166,-1,150
1,<environment.Job instance at 0x7f454c56acd0>,59,18,[ 1 12],60,-1,168,-1,150
1,<environment.Job instance at 0x7f454c56af00>,63,15,[ 1 12],64,-1,186,-1,171
1,<environment.Job instance at 0x7f454c6b7a50>,65,3,[ 4 13],66,-1,177,-1,174
1,<environment.Job instance at 0x7f454c6d8be0>,67,1,[ 1 14],68,-1,176,-1,175
1,<environment.Job instance at 0x7f454c438960>,8,19,[6 4],9,-1,28,-1,9
1,<environment.Job instance at 0x7f454c3639b0>,13,18,[6 5],14,-1,32,-1,14
1,<environment.Job instance at 0x7f454c363640>,14,19,[6 1],15,-1,34,-1,15
1,<environment.Job instance at 0x7f454c363fa0>,15,16,[ 2 10],16,-1,33,-1,17
1,<environment.Job instance at 0x7f454c3637d0>,17,21,[ 3 10],18,-1,39,-1,18
1,<environment.Job instance at 0x7f454c363dc0>,22,14,[2 9],23,-1,37,-1,23
1,<environment.Job instance at 0x7f454c368870>,28,21,[9 4],29,-1,50,-1,29
1,<environment.Job instance at 0x7f454c368d70>,29,12,[9 3],30,-1,43,-1,31
1,<environment.Job instance at 0x7f454c368e10>,30,18,[10  3],31,-1,49,-1,31
1,<environment.Job instance at 0x7f454c3684b0>,31,17,[10  2],32,-1,49,-1,32
1,<environment.Job instance at 0x7f454c3688c0>,40,13,[10  5],41,-1,54,-1,41
1,<environment.Job instance at 0x7f4556526dc0>,41,14,[1 6],42,-1,56,-1,42
1,<environment.Job instance at 0x7f4556526370>,43,14,[7 5],44,-1,58,-1,44
1,<environment.Job instance at 0x7f4556526230>,45,14,[10  2],46,-1,60,-1,46
1,<environment.Job instance at 0x7f454c375c80>,53,2,[5 6],54,-1,57,-1,55
1,<environment.Job instance at 0x7f454c3754b0>,55,2,[5 5],56,-1,58,-1,56
1,<environment.Job instance at 0x7f454c375e60>,56,12,[ 3 10],57,-1,70,-1,58
1,<environment.Job instance at 0x7f454c375500>,58,1,[10  5],59,-1,61,-1,60
1,<environment.Job instance at 0x7f454c375190>,60,18,[4 5],61,-1,79,-1,61
1,<environment.Job instance at 0x7f454c3751e0>,61,18,[2 8],62,-1,80,-1,62
1,<environment.Job instance at 0x7f454c375820>,54,16,[7 2],55,-1,79,-1,63
1,<environment.Job instance at 0x7f454c375320>,64,16,[9 4],65,-1,83,-1,67
1,<environment.Job instance at 0x7f454c375b40>,67,16,[9 2],68,-1,84,-1,68
1,<environment.Job instance at 0x7f454c3752d0>,66,14,[10  1],67,-1,82,-1,68
1,<environment.Job instance at 0x7f455651cf00>,69,13,[6 3],70,-1,83,-1,70
1,<environment.Job instance at 0x7f455651cbe0>,70,13,[7 4],71,-1,84,-1,71
1,<environment.Job instance at 0x7f455651c140>,72,20,[1 7],73,-1,93,-1,73
1,<environment.Job instance at 0x7f454c440eb0>,76,19,[2 7],77,-1,96,-1,77
1,<environment.Job instance at 0x7f454c363960>,0,3,[13  3],1,-1,4,-1,1
1,<environment.Job instance at 0x7f454c368b90>,5,13,[ 1 14],6,-1,19,-1,6
1,<environment.Job instance at 0x7f454c438370>,16,2,[11  5],17,-1,19,-1,17
1,<environment.Job instance at 0x7f454c3539b0>,18,3,[14  4],19,-1,24,-1,21
1,<environment.Job instance at 0x7f454c440320>,38,12,[14  4],39,-1,93,-1,81
1,<environment.Job instance at 0x7f454c37ecd0>,48,2,[13  1],49,-1,129,-1,127
1,<environment.Job instance at 0x7f454c37eaa0>,51,3,[13  5],52,-1,132,-1,129
1,<environment.Job instance at 0x7f454c37e1e0>,52,2,[ 1 12],53,-1,131,-1,129
1,<environment.Job instance at 0x7f454c5057d0>,62,1,[ 4 13],63,-1,152,-1,151
1,<environment.Job instance at 0x7f454c505190>,63,14,[11  3],64,-1,165,-1,151
1,<environment.Job instance at 0x7f454d0933c0>,4,16,[7 5],5,-1,23,-1,7
1,<environment.Job instance at 0x7f454d093410>,6,16,[7 4],7,-1,23,-1,7
1,<environment.Job instance at 0x7f454d093690>,8,18,[4 6],9,-1,30,-1,12
1,<environment.Job instance at 0x7f454ca49dc0>,11,27,[4 7],12,-1,39,-1,12
1,<environment.Job instance at 0x7f454ca49d70>,0,24,[ 1 10],1,-1,25,-1,1
1,<environment.Job instance at 0x7f454d1d1050>,3,24,[7 4],4,-1,28,-1,4
1,<environment.Job instance at 0x7f454c4e25a0>,5,3,[12  3],6,-1,9,-1,6
1,<environment.Job instance at 0x7f454ca30500>,11,27,[4 7],12,-1,49,-1,22
1,<environment.Job instance at 0x7f454ca30320>,12,26,[8 4],13,-1,48,-1,22
1,<environment.Job instance at 0x7f454ca30870>,15,16,[14  1],16,-1,38,-1,22
1,<environment.Job instance at 0x7f454d093050>,20,25,[ 3 10],21,-1,68,-1,43
1,<environment.Job instance at 0x7f454c8789b0>,33,23,[10  1],34,-1,89,-1,66
1,<environment.Job instance at 0x7f454c878e60>,36,28,[6 5],37,-1,95,-1,67
1,<environment.Job instance at 0x7f45563d60a0>,41,15,[14  1],42,-1,95,-1,80
1,<environment.Job instance at 0x7f45563d6280>,45,18,[11  3],46,-1,102,-1,84
1,<environment.Job instance at 0x7f454c3ce550>,49,28,[5 3],50,-1,130,-1,102
1,<environment.Job instance at 0x7f454c54c820>,62,25,[6 3],63,-1,163,-1,138
1,<environment.Job instance at 0x7f454cba49b0>,6,15,[2 7],7,-1,22,-1,7
1,<environment.Job instance at 0x7f454cba4870>,8,15,[7 5],9,-1,24,-1,9
1,<environment.Job instance at 0x7f454cba4b90>,9,15,[ 3 10],10,-1,25,-1,10
1,<environment.Job instance at 0x7f454cba47d0>,10,24,[2 8],11,-1,35,-1,11
1,<environment.Job instance at 0x7f454cbbc4b0>,21,17,[10  3],22,-1,39,-1,22
1,<environment.Job instance at 0x7f454cbc2af0>,24,14,[1 5],25,-1,39,-1,25
1,<environment.Job instance at 0x7f454cbbc820>,16,16,[ 5 10],17,-1,42,-1,26
1,<environment.Job instance at 0x7f454cbbcc30>,22,13,[1 6],23,-1,39,-1,26
1,<environment.Job instance at 0x7f454cbbc0a0>,20,15,[7 1],21,-1,41,-1,26
1,<environment.Job instance at 0x7f454c7fe780>,26,1,[2 6],27,-1,28,-1,27
1,<environment.Job instance at 0x7f454d8dcd70>,29,16,[5 4],30,-1,46,-1,30
1,<environment.Job instance at 0x7f454c745dc0>,30,14,[8 3],31,-1,45,-1,31
1,<environment.Job instance at 0x7f454d8c9050>,34,18,[3 6],35,-1,53,-1,35
1,<environment.Job instance at 0x7f454d900050>,36,16,[9 2],37,-1,53,-1,37
1,<environment.Job instance at 0x7f454d8e7190>,37,16,[9 4],38,-1,54,-1,38
1,<environment.Job instance at 0x7f454c72b1e0>,40,27,[ 5 10],41,-1,68,-1,41
1,<environment.Job instance at 0x7f454c7de4b0>,41,17,[7 5],42,-1,59,-1,42
1,<environment.Job instance at 0x7f454c7dee10>,42,12,[3 8],43,-1,55,-1,43
1,<environment.Job instance at 0x7f454d8d2780>,44,15,[4 6],45,-1,60,-1,45
1,<environment.Job instance at 0x7f454c7fe410>,25,12,[ 4 10],26,-1,58,-1,46
1,<environment.Job instance at 0x7f454d1fee60>,65,16,[10  4],66,-1,87,-1,71
1,<environment.Job instance at 0x7f454d1fe7d0>,62,17,[12  4],63,-1,88,-1,71
1,<environment.Job instance at 0x7f454d8d2dc0>,46,25,[ 5 10],47,-1,96,-1,71
1,<environment.Job instance at 0x7f454d1f9140>,70,18,[9 5],71,-1,90,-1,72
1,<environment.Job instance at 0x7f454d1f97d0>,74,17,[7 2],75,-1,97,-1,80
1,<environment.Job instance at 0x7f454d1fef50>,66,3,[6 3],67,-1,84,-1,81
1,<environment.Job instance at 0x7f454d1f9910>,76,12,[8 3],77,-1,93,-1,81
1,<environment.Job instance at 0x7f454cbbc320>,2,3,[ 3 11],3,-1,6,-1,3
1,<environment.Job instance at 0x7f454d902370>,10,24,[2 8],11,-1,42,-1,18
1,<environment.Job instance at 0x7f454d1fe3c0>,11,24,[9 1],12,-1,42,-1,18
1,<environment.Job instance at 0x7f454d1fed70>,13,24,[10  5],14,-1,43,-1,19
1,<environment.Job instance at 0x7f454d1febe0>,14,23,[10  2],15,-1,42,-1,19
1,<environment.Job instance at 0x7f454cb947d0>,15,15,[ 1 11],16,-1,34,-1,19
1,<environment.Job instance at 0x7f454c54c820>,27,15,[ 3 12],28,-1,65,-1,50
1,<environment.Job instance at 0x7f454c3ce9b0>,40,27,[ 5 10],41,-1,134,-1,107
1,<environment.Job instance at 0x7f45563d60a0>,46,25,[ 5 10],47,-1,153,-1,128
1,<environment.Job instance at 0x7f454c37e050>,62,17,[12  4],63,-1,186,-1,169
1,<environment.Job instance at 0x7f454ca309b0>,75,2,[ 4 11],76,-1,205,-1,203
1,<environment.Job instance at 0x7f454c9d1500>,1,17,[2 6],2,-1,19,-1,2
1,<environment.Job instance at 0x7f454c9d1820>,2,19,[8 2],3,-1,24,-1,5
1,<environment.Job instance at 0x7f454c9d1f00>,5,3,[2 5],6,-1,9,-1,6
1,<environment.Job instance at 0x7f454c9d1fa0>,6,2,[11  3],7,-1,9,-1,7
1,<environment.Job instance at 0x7f454c9d1f50>,7,2,[12  2],8,-1,10,-1,8
1,<environment.Job instance at 0x7f454c9d17d0>,8,14,[ 2 10],9,-1,23,-1,9
1,<environment.Job instance at 0x7f454c9d19b0>,9,17,[9 1],10,-1,27,-1,10
1,<environment.Job instance at 0x7f454c835d70>,10,18,[3 5],11,-1,29,-1,11
1,<environment.Job instance at 0x7f454c8355a0>,11,3,[7 3],12,-1,15,-1,12
1,<environment.Job instance at 0x7f454c835f00>,12,2,[12  5],13,-1,15,-1,13
1,<environment.Job instance at 0x7f454c8356e0>,13,1,[1 7],14,-1,15,-1,14
1,<environment.Job instance at 0x7f454c835910>,14,1,[14  4],15,-1,16,-1,15
1,<environment.Job instance at 0x7f454c835a50>,15,13,[ 1 10],16,-1,29,-1,16
1,<environment.Job instance at 0x7f454c835aa0>,16,3,[8 1],17,-1,20,-1,17
1,<environment.Job instance at 0x7f454c835690>,17,2,[6 4],18,-1,20,-1,18
1,<environment.Job instance at 0x7f454c8350a0>,18,14,[4 6],19,-1,33,-1,19
1,<environment.Job instance at 0x7f454c9d1cd0>,4,17,[ 5 14],5,-1,36,-1,19
1,<environment.Job instance at 0x7f454c9d16e0>,19,15,[10  2],20,-1,36,-1,21
1,<environment.Job instance at 0x7f454c835960>,21,12,[5 5],22,-1,34,-1,22
1,<environment.Job instance at 0x7f454c835e60>,22,12,[5 5],23,-1,35,-1,23
1,<environment.Job instance at 0x7f454c835550>,23,13,[4 9],24,-1,37,-1,24
1,<environment.Job instance at 0x7f454c835820>,25,14,[7 4],26,-1,40,-1,26
1,<environment.Job instance at 0x7f454c835870>,30,16,[10  2],31,-1,47,-1,31
1,<environment.Job instance at 0x7f454c8350f0>,31,13,[4 5],32,-1,45,-1,32
1,<environment.Job instance at 0x7f454d1e1a00>,34,21,[7 2],35,-1,56,-1,35
1,<environment.Job instance at 0x7f454d1e1730>,35,12,[ 1 10],36,-1,48,-1,36
1,<environment.Job instance at 0x7f454d1e1d70>,38,16,[6 3],39,-1,55,-1,39
1,<environment.Job instance at 0x7f454d1e1eb0>,39,14,[5 7],40,-1,54,-1,40
1,<environment.Job instance at 0x7f454d1e1e60>,40,18,[4 7],41,-1,59,-1,41
1,<environment.Job instance at 0x7f454d1e1af0>,41,14,[1 5],42,-1,56,-1,42
1,<environment.Job instance at 0x7f454d1e1190>,42,14,[ 1 11],43,-1,57,-1,43
1,<environment.Job instance at 0x7f454d1e1e10>,43,14,[2 7],44,-1,58,-1,44
1,<environment.Job instance at 0x7f454d1e1b90>,47,3,[3 5],48,-1,51,-1,48
1,<environment.Job instance at 0x7f454d1e12d0>,48,15,[8 5],49,-1,64,-1,49
1,<environment.Job instance at 0x7f454d1e1370>,49,27,[1 5],50,-1,77,-1,50
1,<environment.Job instance at 0x7f454c816870>,56,18,[4 6],57,-1,75,-1,57
1,<environment.Job instance at 0x7f454c816be0>,62,18,[6 3],63,-1,81,-1,63
1,<environment.Job instance at 0x7f454c84f140>,65,16,[6 3],66,-1,82,-1,66
1,<environment.Job instance at 0x7f454c84f5f0>,66,25,[3 8],67,-1,92,-1,67
1,<environment.Job instance at 0x7f454c84fe60>,74,17,[8 5],75,-1,92,-1,75
1,<environment.Job instance at 0x7f454d1e17d0>,3,2,[ 2 14],4,-1,6,-1,4
1,<environment.Job instance at 0x7f454c816e10>,4,17,[ 5 14],5,-1,22,-1,5
1,<environment.Job instance at 0x7f454c816c80>,6,2,[11  3],7,-1,9,-1,7
1,<environment.Job instance at 0x7f454c84f690>,7,2,[12  2],8,-1,10,-1,8
1,<environment.Job instance at 0x7f454c9d1370>,12,2,[12  5],13,-1,15,-1,13
1,<environment.Job instance at 0x7f454c9d1a50>,14,1,[14  4],15,-1,16,-1,15
1,<environment.Job instance at 0x7f454cbbc640>,33,1,[ 5 12],34,-1,81,-1,80
1,<environment.Job instance at 0x7f454c7e1550>,42,14,[ 1 11],43,-1,126,-1,112
1,<environment.Job instance at 0x7f454c7e1e60>,44,3,[14  4],45,-1,115,-1,112
1,<environment.Job instance at 0x7f454c7e1dc0>,46,2,[13  4],47,-1,119,-1,117
1,<environment.Job instance at 0x7f454c7e1c30>,49,27,[1 5],50,-1,155,-1,128
1,<environment.Job instance at 0x7f454ca0f4b0>,55,14,[ 5 12],56,-1,149,-1,135
1,<environment.Job instance at 0x7f454ca0f050>,57,19,[14  4],58,-1,155,-1,136
1,<environment.Job instance at 0x7f454ca0f820>,59,14,[ 5 11],60,-1,150,-1,136
1,<environment.Job instance at 0x7f454caaadc0>,66,25,[3 8],67,-1,204,-1,179
1,<environment.Job instance at 0x7f454caaaa00>,68,3,[ 5 14],69,-1,182,-1,179
1,<environment.Job instance at 0x7f454caaad70>,69,27,[9 3],70,-1,208,-1,181
1,<environment.Job instance at 0x7f454cab7550>,72,24,[ 3 10],73,-1,213,-1,189
1,<environment.Job instance at 0x7f454cab7a00>,77,12,[ 2 12],78,-1,207,-1,195
1,<environment.Job instance at 0x7f454cab7cd0>,78,27,[1 7],79,-1,224,-1,197
1,<environment.Job instance at 0x7f454d1b8cd0>,0,19,[6 3],1,-1,20,-1,1
1,<environment.Job instance at 0x7f454c6abd70>,4,16,[10  3],5,-1,24,-1,8
1,<environment.Job instance at 0x7f454c6ab9b0>,8,14,[10  3],9,-1,23,-1,9
1,<environment.Job instance at 0x7f454c6aba50>,9,1,[10  3],10,-1,11,-1,10
1,<environment.Job instance at 0x7f454c6abc80>,10,19,[1 5],11,-1,30,-1,11
1,<environment.Job instance at 0x7f454c697730>,11,18,[2 9],12,-1,30,-1,12
1,<environment.Job instance at 0x7f454c697eb0>,12,18,[10  4],13,-1,31,-1,13
1,<environment.Job instance at 0x7f454c697af0>,13,13,[6 5],14,-1,27,-1,14
1,<environment.Job instance at 0x7f454c6abe60>,7,13,[6 4],8,-1,27,-1,14
1,<environment.Job instance at 0x7f454ced3dc0>,19,15,[9 5],20,-1,35,-1,20
1,<environment.Job instance at 0x7f454d79d280>,23,18,[5 9],24,-1,42,-1,24
1,<environment.Job instance at 0x7f454ca48d70>,25,21,[2 5],26,-1,47,-1,26
1,<environment.Job instance at 0x7f454c6a6410>,26,1,[7 2],27,-1,28,-1,27
1,<environment.Job instance at 0x7f454d7cea00>,28,14,[5 9],29,-1,43,-1,29
1,<environment.Job instance at 0x7f454c6a6550>,29,19,[9 1],30,-1,49,-1,30
1,<environment.Job instance at 0x7f454d7910a0>,31,16,[6 5],32,-1,48,-1,32
1,<environment.Job instance at 0x7f454ca45050>,33,27,[1 8],34,-1,61,-1,34
1,<environment.Job instance at 0x7f454d7d1b90>,36,14,[3 9],37,-1,51,-1,37
1,<environment.Job instance at 0x7f454d4377d0>,39,13,[5 9],40,-1,53,-1,40
1,<environment.Job instance at 0x7f454d7c4c80>,41,18,[8 4],42,-1,60,-1,42
1,<environment.Job instance at 0x7f454d455320>,42,3,[ 1 10],43,-1,46,-1,43
1,<environment.Job instance at 0x7f454ca22c80>,43,3,[7 3],44,-1,47,-1,44
1,<environment.Job instance at 0x7f454d46b370>,44,17,[3 9],45,-1,62,-1,45
1,<environment.Job instance at 0x7f454d46b3c0>,45,13,[10  4],46,-1,59,-1,46
1,<environment.Job instance at 0x7f454d46b4b0>,46,16,[5 5],47,-1,63,-1,47
1,<environment.Job instance at 0x7f454d46b0a0>,47,22,[1 7],48,-1,70,-1,48
1,<environment.Job instance at 0x7f454d46b640>,49,15,[7 1],50,-1,66,-1,51
1,<environment.Job instance at 0x7f454d446730>,51,18,[3 6],52,-1,70,-1,52
1,<environment.Job instance at 0x7f454d4469b0>,52,1,[9 3],53,-1,54,-1,53
1,<environment.Job instance at 0x7f454d46b230>,50,14,[6 4],51,-1,68,-1,54
1,<environment.Job instance at 0x7f454d446d20>,55,25,[6 3],56,-1,81,-1,56
1,<environment.Job instance at 0x7f454d446960>,58,16,[8 5],59,-1,75,-1,59
1,<environment.Job instance at 0x7f454d446550>,59,18,[7 5],60,-1,78,-1,60
1,<environment.Job instance at 0x7f454d46c1e0>,61,14,[5 8],62,-1,76,-1,62
1,<environment.Job instance at 0x7f454d46c320>,62,16,[9 2],63,-1,80,-1,64
1,<environment.Job instance at 0x7f454d46c500>,65,18,[7 5],66,-1,84,-1,66
1,<environment.Job instance at 0x7f454d46c3c0>,63,15,[6 3],64,-1,81,-1,66
1,<environment.Job instance at 0x7f454d46c8c0>,68,17,[10  3],69,-1,87,-1,70
1,<environment.Job instance at 0x7f454d46c870>,70,1,[6 3],71,-1,72,-1,71
1,<environment.Job instance at 0x7f454d46caa0>,71,22,[ 1 10],72,-1,94,-1,72
1,<environment.Job instance at 0x7f454d46cb40>,72,18,[5 1],73,-1,91,-1,73
1,<environment.Job instance at 0x7f454d46ca00>,69,27,[ 5 10],70,-1,100,-1,73
1,<environment.Job instance at 0x7f454d1feb40>,15,2,[14  5],16,-1,36,-1,34
1,<environment.Job instance at 0x7f454c7030f0>,33,27,[1 8],34,-1,127,-1,100
1,<environment.Job instance at 0x7f454c9d1f00>,53,3,[ 3 14],54,-1,184,-1,181
1,<environment.Job instance at 0x7f454d7eb140>,55,25,[6 3],56,-1,208,-1,183
1,<environment.Job instance at 0x7f454c930cd0>,60,2,[ 5 11],61,-1,200,-1,198
1,<environment.Job instance at 0x7f454cca7050>,69,27,[ 5 10],70,-1,279,-1,252
1,<environment.Job instance at 0x7f454c7de460>,5,17,[7 1],6,-1,24,-1,7
1,<environment.Job instance at 0x7f454c7de640>,7,18,[1 7],8,-1,26,-1,8
1,<environment.Job instance at 0x7f454c7de4b0>,11,14,[10  4],12,-1,26,-1,12
1,<environment.Job instance at 0x7f454c7de2d0>,12,18,[5 5],13,-1,31,-1,13
1,<environment.Job instance at 0x7f454d8ef410>,15,15,[7 4],16,-1,31,-1,16
1,<environment.Job instance at 0x7f454d8ef780>,18,21,[5 8],19,-1,40,-1,19
1,<environment.Job instance at 0x7f454d8efa50>,19,17,[7 2],20,-1,37,-1,20
1,<environment.Job instance at 0x7f454c7defa0>,6,13,[11  1],7,-1,36,-1,23
1,<environment.Job instance at 0x7f454c7de9b0>,9,14,[10  1],10,-1,39,-1,25
1,<environment.Job instance at 0x7f454d8ef870>,23,27,[9 3],24,-1,52,-1,25
1,<environment.Job instance at 0x7f454d8ef2d0>,27,12,[ 4 10],28,-1,41,-1,29
1,<environment.Job instance at 0x7f454d8ef6e0>,26,28,[1 7],27,-1,57,-1,29
1,<environment.Job instance at 0x7f455618da50>,39,17,[1 5],40,-1,57,-1,40
1,<environment.Job instance at 0x7f454d8ef370>,24,12,[6 5],25,-1,54,-1,42
1,<environment.Job instance at 0x7f454d8eff50>,22,18,[5 1],23,-1,61,-1,43
1,<environment.Job instance at 0x7f455618dcd0>,42,13,[4 8],43,-1,56,-1,43
1,<environment.Job instance at 0x7f4556005280>,46,12,[7 1],47,-1,60,-1,48
1,<environment.Job instance at 0x7f4556005140>,48,15,[ 3 11],49,-1,64,-1,49
1,<environment.Job instance at 0x7f45560052d0>,50,14,[6 4],51,-1,69,-1,55
1,<environment.Job instance at 0x7f4556005c30>,55,15,[ 2 11],56,-1,71,-1,56
1,<environment.Job instance at 0x7f4556005b40>,56,23,[7 4],57,-1,80,-1,57
1,<environment.Job instance at 0x7f4556005e10>,58,17,[5 5],59,-1,76,-1,59
1,<environment.Job instance at 0x7f4556156d70>,59,14,[3 7],60,-1,74,-1,60
1,<environment.Job instance at 0x7f454c9aca00>,60,15,[9 4],61,-1,76,-1,61
1,<environment.Job instance at 0x7f454c9ac5a0>,63,20,[5 4],64,-1,84,-1,64
1,<environment.Job instance at 0x7f454c9ac5f0>,74,15,[10  3],75,-1,91,-1,76
1,<environment.Job instance at 0x7f454c4e2780>,76,21,[6 5],77,-1,98,-1,77
1,<environment.Job instance at 0x7f4556005a50>,6,13,[11  1],7,-1,20,-1,7
1,<environment.Job instance at 0x7f4556005be0>,8,12,[ 5 12],9,-1,21,-1,9
1,<environment.Job instance at 0x7f454c5f0e60>,21,28,[2 8],22,-1,82,-1,54
1,<environment.Job instance at 0x7f454d1ac0a0>,26,28,[1 7],27,-1,110,-1,82
1,<environment.Job instance at 0x7f454c7bcb40>,23,27,[9 3],24,-1,110,-1,83
1,<environment.Job instance at 0x7f454c835be0>,29,2,[ 4 11],30,-1,85,-1,83
1,<environment.Job instance at 0x7f454c8350f0>,34,3,[11  1],35,-1,100,-1,97
1,<environment.Job instance at 0x7f454ca0fd70>,36,28,[9 2],37,-1,127,-1,99
1,<environment.Job instance at 0x7f454c4e2730>,47,3,[ 1 12],48,-1,118,-1,115
1,<environment.Job instance at 0x7f454c4e28c0>,48,15,[ 3 11],49,-1,130,-1,115
1,<environment.Job instance at 0x7f454c4e2be0>,55,15,[ 2 11],56,-1,148,-1,133
1,<environment.Job instance at 0x7f454c4e2460>,56,23,[7 4],57,-1,157,-1,134
1,<environment.Job instance at 0x7f454d7a0dc0>,70,16,[14  3],71,-1,186,-1,170
1,<environment.Job instance at 0x7f454c190d70>,1,27,[5 1],2,-1,29,-1,2
1,<environment.Job instance at 0x7f454c190050>,3,17,[8 5],4,-1,21,-1,4
1,<environment.Job instance at 0x7f454c190870>,8,16,[ 5 10],9,-1,26,-1,10
1,<environment.Job instance at 0x7f454c1902d0>,10,16,[9 2],11,-1,27,-1,11
1,<environment.Job instance at 0x7f454c200280>,11,19,[10  1],12,-1,31,-1,12
1,<environment.Job instance at 0x7f454c200aa0>,16,25,[ 5 10],17,-1,42,-1,17
1,<environment.Job instance at 0x7f454c200b40>,22,18,[5 9],23,-1,41,-1,23
1,<environment.Job instance at 0x7f454c200960>,23,16,[6 5],24,-1,40,-1,24
1,<environment.Job instance at 0x7f454c217d70>,27,17,[5 2],28,-1,45,-1,28
1,<environment.Job instance at 0x7f454c217e10>,28,18,[1 9],29,-1,47,-1,29
1,<environment.Job instance at 0x7f454c217820>,30,15,[3 9],31,-1,46,-1,31
1,<environment.Job instance at 0x7f454c217280>,38,14,[9 4],39,-1,54,-1,40
1,<environment.Job instance at 0x7f454c217640>,40,26,[6 3],41,-1,67,-1,41
1,<environment.Job instance at 0x7f454c217370>,41,14,[4 6],42,-1,56,-1,42
1,<environment.Job instance at 0x7f454c217960>,42,17,[ 2 11],43,-1,60,-1,43
1,<environment.Job instance at 0x7f454c1d47d0>,45,23,[7 1],46,-1,84,-1,61
1,<environment.Job instance at 0x7f454c1d41e0>,51,17,[10  4],52,-1,78,-1,61
1,<environment.Job instance at 0x7f454c1d4460>,49,14,[6 1],50,-1,75,-1,61
1,<environment.Job instance at 0x7f454c1d4140>,55,18,[10  3],56,-1,167,-1,149
1,<environment.Job instance at 0x7f454c94a1e0>,64,18,[4 7],65,-1,167,-1,149
1,<environment.Job instance at 0x7f454c200910>,1,27,[5 1],2,-1,29,-1,2
1,<environment.Job instance at 0x7f454d694b40>,6,25,[8 3],7,-1,33,-1,8
1,<environment.Job instance at 0x7f454c1905a0>,7,13,[13  1],8,-1,21,-1,8
1,<environment.Job instance at 0x7f454d7a0c80>,16,25,[ 5 10],17,-1,71,-1,46
1,<environment.Job instance at 0x7f455618d0f0>,36,2,[13  5],37,-1,102,-1,100
1,<environment.Job instance at 0x7f454d3e23c0>,40,26,[6 3],41,-1,144,-1,118
1,<environment.Job instance at 0x7f454d57e820>,42,17,[ 2 11],43,-1,135,-1,118
1,<environment.Job instance at 0x7f454d88a190>,45,23,[7 1],46,-1,156,-1,133
1,<environment.Job instance at 0x7f454cde3960>,53,12,[ 1 14],54,-1,162,-1,150
1,<environment.Job instance at 0x7f454c5feeb0>,56,13,[13  3],57,-1,177,-1,164
1,<environment.Job instance at 0x7f454cde02d0>,58,1,[ 3 14],59,-1,178,-1,177
1,<environment.Job instance at 0x7f454c5ec460>,71,14,[ 3 14],72,-1,242,-1,228
1,<environment.Job instance at 0x7f454c93c050>,75,13,[ 1 12],76,-1,253,-1,240
1,<environment.Job instance at 0x7f454c5ef5a0>,76,17,[11  2],77,-1,257,-1,240
1,<environment.Job instance at 0x7f454cc05b90>,0,28,[5 6],1,-1,29,-1,1
1,<environment.Job instance at 0x7f454c4ac190>,4,17,[6 5],5,-1,23,-1,6
1,<environment.Job instance at 0x7f454cc05cd0>,5,23,[5 3],6,-1,29,-1,6
1,<environment.Job instance at 0x7f454c4ac5a0>,7,16,[ 5 10],8,-1,27,-1,11
1,<environment.Job instance at 0x7f454c4acd70>,12,16,[9 4],13,-1,33,-1,17
1,<environment.Job instance at 0x7f454c4ac460>,17,14,[4 7],18,-1,32,-1,18
1,<environment.Job instance at 0x7f454cee3dc0>,39,17,[9 4],40,-1,94,-1,77
1,<environment.Job instance at 0x7f454c3ad730>,41,18,[4 8],42,-1,95,-1,77
1,<environment.Job instance at 0x7f454c3ad370>,53,18,[ 4 10],54,-1,174,-1,156
1,<environment.Job instance at 0x7f454d157d20>,61,16,[ 4 10],62,-1,174,-1,158
1,<environment.Job instance at 0x7f454d1571e0>,64,15,[ 2 10],65,-1,173,-1,158
1,<environment.Job instance at 0x7f454cee3eb0>,26,18,[ 3 13],27,-1,176,-1,158
1,<environment.Job instance at 0x7f454d157690>,58,17,[5 7],59,-1,177,-1,160
1,<environment.Job instance at 0x7f454d1570f0>,65,16,[4 6],66,-1,177,-1,161
1,<environment.Job instance at 0x7f454d157870>,69,16,[2 8],70,-1,177,-1,161
1,<environment.Job instance at 0x7f454d157780>,66,18,[9 4],67,-1,179,-1,161
1,<environment.Job instance at 0x7f454d157460>,71,13,[2 8],72,-1,174,-1,161
1,<environment.Job instance at 0x7f454d157f50>,73,18,[ 5 10],74,-1,179,-1,161
1,<environment.Job instance at 0x7f454d157c80>,74,20,[9 5],75,-1,181,-1,161
1,<environment.Job instance at 0x7f454d157370>,75,17,[7 4],76,-1,178,-1,161
1,<environment.Job instance at 0x7f454d157d70>,76,18,[4 6],77,-1,179,-1,161
1,<environment.Job instance at 0x7f454c4ac9b0>,0,28,[5 6],1,-1,29,-1,1
1,<environment.Job instance at 0x7f454cee3af0>,3,28,[ 1 11],4,-1,32,-1,4
1,<environment.Job instance at 0x7f454c3ad0a0>,5,23,[5 3],6,-1,29,-1,6
1,<environment.Job instance at 0x7f454c3ad460>,6,14,[13  5],7,-1,21,-1,7
1,<environment.Job instance at 0x7f454d873500>,10,13,[12  5],11,-1,24,-1,11
1,<environment.Job instance at 0x7f454d873230>,18,15,[ 3 13],19,-1,39,-1,24
1,<environment.Job instance at 0x7f454c5edeb0>,26,18,[ 3 13],27,-1,74,-1,56
1,<environment.Job instance at 0x7f454cde02d0>,37,2,[ 4 14],38,-1,92,-1,90
1,<environment.Job instance at 0x7f454d3c2460>,44,2,[ 1 12],45,-1,108,-1,106
1,<environment.Job instance at 0x7f454d964690>,50,25,[2 8],51,-1,165,-1,140
1,<environment.Job instance at 0x7f45560051e0>,54,3,[ 3 14],55,-1,156,-1,153
1,<environment.Job instance at 0x7f454c200c30>,59,2,[13  5],60,-1,182,-1,180
1,<environment.Job instance at 0x7f454d717370>,68,1,[ 3 12],69,-1,221,-1,220
1,<environment.Job instance at 0x7f454d944f50>,3,17,[10  5],4,-1,22,-1,5
1,<environment.Job instance at 0x7f454cd3fc30>,4,17,[3 6],5,-1,22,-1,5
1,<environment.Job instance at 0x7f454ca45e60>,7,16,[1 5],8,-1,27,-1,11
1,<environment.Job instance at 0x7f454ca45eb0>,11,16,[2 7],12,-1,28,-1,12
1,<environment.Job instance at 0x7f454ca45b90>,12,15,[3 8],13,-1,28,-1,13
1,<environment.Job instance at 0x7f454ca453c0>,15,15,[9 1],16,-1,31,-1,16
1,<environment.Job instance at 0x7f454d7e0e60>,17,25,[9 4],18,-1,43,-1,18
1,<environment.Job instance at 0x7f454d7e0460>,20,16,[2 8],21,-1,37,-1,21
1,<environment.Job instance at 0x7f454ca45320>,10,13,[9 3],11,-1,34,-1,21
1,<environment.Job instance at 0x7f454d7e0870>,22,17,[1 7],23,-1,40,-1,23
1,<environment.Job instance at 0x7f454ceb4410>,23,17,[6 4],24,-1,41,-1,24
1,<environment.Job instance at 0x7f454d7e0550>,26,16,[14  3],27,-1,43,-1,27
1,<environment.Job instance at 0x7f454ceb42d0>,25,16,[1 6],26,-1,44,-1,28
1,<environment.Job instance at 0x7f454ceb4820>,27,14,[12  5],28,-1,42,-1,28
1,<environment.Job instance at 0x7f454c6b7e60>,31,18,[9 3],32,-1,52,-1,34
1,<environment.Job instance at 0x7f454d303eb0>,34,25,[7 4],35,-1,60,-1,35
1,<environment.Job instance at 0x7f454d303870>,36,22,[ 4 10],37,-1,59,-1,37
1,<environment.Job instance at 0x7f454d3035f0>,38,16,[2 7],39,-1,55,-1,39
1,<environment.Job instance at 0x7f454d303500>,39,16,[ 3 10],40,-1,56,-1,40
1,<environment.Job instance at 0x7f454c024be0>,42,18,[5 8],43,-1,61,-1,43
1,<environment.Job instance at 0x7f454c024af0>,45,23,[8 2],46,-1,69,-1,46
1,<environment.Job instance at 0x7f4555efc230>,50,16,[5 9],51,-1,67,-1,51
1,<environment.Job instance at 0x7f454c5ade60>,51,15,[9 5],52,-1,67,-1,52
1,<environment.Job instance at 0x7f454d58a780>,52,14,[9 1],53,-1,67,-1,53
1,<environment.Job instance at 0x7f454d0b4e10>,53,18,[ 2 11],54,-1,72,-1,54
1,<environment.Job instance at 0x7f454c6ba3c0>,58,14,[8 1],59,-1,73,-1,59
1,<environment.Job instance at 0x7f454c6ba8c0>,59,16,[ 4 10],60,-1,76,-1,60
1,<environment.Job instance at 0x7f454c1eecd0>,60,18,[5 8],61,-1,79,-1,61
1,<environment.Job instance at 0x7f454c1eea50>,61,17,[3 7],62,-1,79,-1,62
1,<environment.Job instance at 0x7f454c83cfa0>,62,23,[7 1],63,-1,86,-1,63
1,<environment.Job instance at 0x7f454cccc910>,64,14,[10  1],65,-1,79,-1,65
1,<environment.Job instance at 0x7f454cda4cd0>,69,13,[ 2 10],70,-1,83,-1,70
1,<environment.Job instance at 0x7f454cccc820>,70,15,[4 9],71,-1,86,-1,71
1,<environment.Job instance at 0x7f454cbb2730>,71,15,[7 5],72,-1,87,-1,72
1,<environment.Job instance at 0x7f454c845140>,76,17,[9 3],77,-1,94,-1,77
1,<environment.Job instance at 0x7f454c024690>,5,18,[14  2],6,-1,24,-1,6
1,<environment.Job instance at 0x7f454c845a50>,17,25,[9 4],18,-1,64,-1,39
1,<environment.Job instance at 0x7f454d7175f0>,21,3,[ 4 12],22,-1,44,-1,41
1,<environment.Job instance at 0x7f454c217410>,26,16,[14  3],27,-1,73,-1,57
1,<environment.Job instance at 0x7f454c217050>,27,14,[12  5],28,-1,71,-1,57
1,<environment.Job instance at 0x7f454d3c2460>,34,25,[7 4],35,-1,111,-1,86
1,<environment.Job instance at 0x7f454cde0870>,45,23,[8 2],46,-1,145,-1,122
1,<environment.Job instance at 0x7f454c5ed0f0>,53,18,[ 2 11],54,-1,166,-1,148
1,<environment.Job instance at 0x7f454c5ec690>,55,3,[11  2],56,-1,156,-1,153
1,<environment.Job instance at 0x7f454d8734b0>,62,23,[7 1],63,-1,212,-1,189
1,<environment.Job instance at 0x7f454d873050>,65,3,[13  2],66,-1,206,-1,203
1,<environment.Job instance at 0x7f454d157910>,68,1,[13  4],69,-1,208,-1,207
1,<environment.Job instance at 0x7f454c4acaf0>,72,13,[14  4],73,-1,235,-1,222
1,<environment.Job instance at 0x7f454c116cd0>,0,15,[9 1],1,-1,17,-1,2
1,<environment.Job instance at 0x7f454c116f50>,2,13,[6 5],3,-1,16,-1,3
1,<environment.Job instance at 0x7f454c1160f0>,3,16,[ 4 10],4,-1,20,-1,4
1,<environment.Job instance at 0x7f454c116dc0>,4,18,[1 8],5,-1,23,-1,5
1,<environment.Job instance at 0x7f454c116aa0>,5,13,[4 7],6,-1,19,-1,6
1,<environment.Job instance at 0x7f454c1160a0>,7,15,[6 1],8,-1,23,-1,8
1,<environment.Job instance at 0x7f454c1165f0>,8,18,[5 8],9,-1,27,-1,9
1,<environment.Job instance at 0x7f454c1166e0>,9,1,[9 4],10,-1,11,-1,10
1,<environment.Job instance at 0x7f454c116190>,10,20,[9 5],11,-1,31,-1,11
1,<environment.Job instance at 0x7f454c1168c0>,14,15,[7 5],15,-1,30,-1,15
1,<environment.Job instance at 0x7f454c267960>,17,15,[ 1 10],18,-1,33,-1,18
1,<environment.Job instance at 0x7f454c267280>,20,1,[8 1],21,-1,22,-1,21
1,<environment.Job instance at 0x7f454c116fa0>,1,23,[ 3 13],2,-1,44,-1,21
1,<environment.Job instance at 0x7f454c116820>,21,18,[3 7],22,-1,40,-1,22
1,<environment.Job instance at 0x7f454c267c30>,22,17,[1 9],23,-1,40,-1,23
1,<environment.Job instance at 0x7f454c267e60>,24,22,[9 5],25,-1,47,-1,25
1,<environment.Job instance at 0x7f454c2676e0>,27,16,[5 8],28,-1,44,-1,28
1,<environment.Job instance at 0x7f454c267820>,28,16,[1 6],29,-1,45,-1,29
1,<environment.Job instance at 0x7f454d203730>,33,15,[4 9],34,-1,50,-1,35
1,<environment.Job instance at 0x7f454d203af0>,35,12,[ 3 10],36,-1,48,-1,36
1,<environment.Job instance at 0x7f454d203690>,36,12,[9 4],37,-1,49,-1,37
1,<environment.Job instance at 0x7f454d203cd0>,38,12,[10  1],39,-1,51,-1,39
1,<environment.Job instance at 0x7f454d203190>,39,21,[1 7],40,-1,61,-1,40
1,<environment.Job instance at 0x7f454d203d20>,40,16,[9 2],41,-1,57,-1,41
1,<environment.Job instance at 0x7f454c386af0>,46,12,[6 4],47,-1,59,-1,47
1,<environment.Job instance at 0x7f454d894780>,47,17,[8 2],48,-1,65,-1,48
1,<environment.Job instance at 0x7f454d894b40>,48,17,[1 6],49,-1,66,-1,49
1,<environment.Job instance at 0x7f454d8945f0>,49,17,[9 2],50,-1,67,-1,50
1,<environment.Job instance at 0x7f454d894cd0>,52,15,[2 9],53,-1,68,-1,53
1,<environment.Job instance at 0x7f454d8940a0>,55,16,[11  3],56,-1,72,-1,56
1,<environment.Job instance at 0x7f454d894050>,57,16,[3 5],58,-1,74,-1,58
1,<environment.Job instance at 0x7f454d2035f0>,34,14,[10  4],35,-1,74,-1,60
1,<environment.Job instance at 0x7f454c5f13c0>,63,18,[ 2 10],64,-1,83,-1,65
1,<environment.Job instance at 0x7f454c2a6c80>,67,17,[7 4],68,-1,85,-1,68
1,<environment.Job instance at 0x7f454c2a62d0>,68,15,[8 3],69,-1,84,-1,69
1,<environment.Job instance at 0x7f454c2a64b0>,69,16,[10  5],70,-1,86,-1,70
1,<environment.Job instance at 0x7f454c2a65f0>,71,16,[5 3],72,-1,88,-1,72
1,<environment.Job instance at 0x7f4555f82aa0>,75,17,[ 2 10],76,-1,93,-1,76
1,<environment.Job instance at 0x7f454ce7eb40>,78,19,[7 1],79,-1,98,-1,79
1,<environment.Job instance at 0x7f454d2034b0>,1,23,[ 3 13],2,-1,25,-1,2
1,<environment.Job instance at 0x7f454cb6d0f0>,25,3,[ 1 14],26,-1,68,-1,65
1,<environment.Job instance at 0x7f454cb6d2d0>,30,13,[11  4],31,-1,97,-1,84
1,<environment.Job instance at 0x7f454cb6db90>,31,12,[ 1 13],32,-1,96,-1,84
1,<environment.Job instance at 0x7f454cf9dbe0>,42,17,[ 2 14],43,-1,148,-1,131
1,<environment.Job instance at 0x7f454cef5eb0>,55,16,[11  3],56,-1,197,-1,181
1,<environment.Job instance at 0x7f4555eecaa0>,66,1,[11  2],67,-1,204,-1,203
1,<environment.Job instance at 0x7f454d18cd70>,0,18,[9 2],1,-1,22,-1,4
1,<environment.Job instance at 0x7f454d18c0f0>,4,12,[7 4],5,-1,17,-1,5
1,<environment.Job instance at 0x7f454d18c050>,3,14,[5 5],4,-1,19,-1,5
1,<environment.Job instance at 0x7f454d184140>,12,16,[10  2],13,-1,30,-1,14
1,<environment.Job instance at 0x7f454d184280>,14,12,[1 8],15,-1,27,-1,15
1,<environment.Job instance at 0x7f454d184410>,16,13,[9 5],17,-1,30,-1,17
1,<environment.Job instance at 0x7f454d184f00>,17,18,[6 2],18,-1,36,-1,18
1,<environment.Job instance at 0x7f454d184d70>,18,14,[ 4 10],19,-1,33,-1,19
1,<environment.Job instance at 0x7f454d184e10>,19,13,[7 5],20,-1,33,-1,20
1,<environment.Job instance at 0x7f454d188640>,21,14,[9 5],22,-1,36,-1,22
1,<environment.Job instance at 0x7f454d188eb0>,24,19,[9 1],25,-1,44,-1,25
1,<environment.Job instance at 0x7f454d188910>,29,15,[8 5],30,-1,45,-1,30
1,<environment.Job instance at 0x7f454d193cd0>,31,13,[9 4],32,-1,45,-1,32
1,<environment.Job instance at 0x7f454d193460>,32,16,[1 7],33,-1,49,-1,33
1,<environment.Job instance at 0x7f454d193370>,34,15,[6 4],35,-1,50,-1,35
1,<environment.Job instance at 0x7f454d193280>,37,16,[7 2],38,-1,54,-1,38
1,<environment.Job instance at 0x7f454d314960>,42,14,[9 3],43,-1,57,-1,43
1,<environment.Job instance at 0x7f454d314780>,46,16,[4 9],47,-1,63,-1,47
1,<environment.Job instance at 0x7f454d314690>,47,22,[6 1],48,-1,70,-1,48
1,<environment.Job instance at 0x7f454d314aa0>,49,14,[3 8],50,-1,64,-1,50
1,<environment.Job instance at 0x7f454d314c30>,51,18,[5 9],52,-1,70,-1,52
1,<environment.Job instance at 0x7f454d1a3dc0>,55,17,[10  3],56,-1,73,-1,56
1,<environment.Job instance at 0x7f454d1a3460>,57,16,[8 4],58,-1,74,-1,58
1,<environment.Job instance at 0x7f454d1a35a0>,58,14,[6 3],59,-1,73,-1,59
1,<environment.Job instance at 0x7f454d18cb90>,13,15,[4 8],14,-1,75,-1,60
1,<environment.Job instance at 0x7f454d1a36e0>,60,17,[8 4],61,-1,78,-1,61
1,<environment.Job instance at 0x7f454d1a34b0>,61,14,[ 5 10],62,-1,77,-1,63
1,<environment.Job instance at 0x7f454d1a31e0>,63,13,[8 3],64,-1,77,-1,64
1,<environment.Job instance at 0x7f454d1a3960>,64,17,[8 5],65,-1,82,-1,65
1,<environment.Job instance at 0x7f454d18b7d0>,65,1,[7 1],66,-1,67,-1,66
1,<environment.Job instance at 0x7f454d1a3500>,62,19,[8 3],63,-1,85,-1,66
1,<environment.Job instance at 0x7f454d1a33c0>,66,23,[5 5],67,-1,90,-1,67
1,<environment.Job instance at 0x7f454d18bdc0>,68,14,[9 5],69,-1,84,-1,70
1,<environment.Job instance at 0x7f454d18bd70>,69,25,[7 3],70,-1,95,-1,70
1,<environment.Job instance at 0x7f454d18b190>,73,17,[6 4],74,-1,92,-1,75
1,<environment.Job instance at 0x7f454d18b730>,76,13,[10  5],77,-1,90,-1,77
1,<environment.Job instance at 0x7f454d18bc80>,77,14,[2 6],78,-1,92,-1,78
1,<environment.Job instance at 0x7f454d18b6e0>,74,17,[4 7],75,-1,96,-1,79
1,<environment.Job instance at 0x7f454d314460>,7,14,[11  2],8,-1,22,-1,8
1,<environment.Job instance at 0x7f454d1a32d0>,8,15,[ 3 14],9,-1,24,-1,9
1,<environment.Job instance at 0x7f454d1a3d20>,10,27,[7 4],11,-1,46,-1,19
1,<environment.Job instance at 0x7f454d18c7d0>,15,2,[ 1 12],16,-1,23,-1,21
1,<environment.Job instance at 0x7f454cf9da00>,20,25,[ 1 14],21,-1,73,-1,48
1,<environment.Job instance at 0x7f454cf9d690>,23,1,[ 4 13],24,-1,61,-1,60
1,<environment.Job instance at 0x7f454cf9d4b0>,25,3,[ 4 11],26,-1,65,-1,62
1,<environment.Job instance at 0x7f454cb6dd70>,38,3,[11  1],39,-1,120,-1,117
1,<environment.Job instance at 0x7f454d183500>,66,23,[5 5],67,-1,247,-1,224
1,<environment.Job instance at 0x7f454d194280>,69,25,[7 3],70,-1,264,-1,239
1,<environment.Job instance at 0x7f454d194d20>,70,1,[12  5],71,-1,240,-1,239
1,<environment.Job instance at 0x7f454c8f2e60>,2,14,[10  1],3,-1,19,-1,5
1,<environment.Job instance at 0x7f454c8f2870>,4,15,[8 1],5,-1,20,-1,5
1,<environment.Job instance at 0x7f454c8d5780>,8,15,[ 4 10],9,-1,24,-1,9
1,<environment.Job instance at 0x7f454c8d5d20>,10,18,[5 4],11,-1,29,-1,11
1,<environment.Job instance at 0x7f454c592500>,12,19,[6 2],13,-1,32,-1,13
1,<environment.Job instance at 0x7f454c5924b0>,18,18,[ 4 10],19,-1,37,-1,19
1,<environment.Job instance at 0x7f454c592a00>,20,14,[2 6],21,-1,38,-1,24
1,<environment.Job instance at 0x7f454c592dc0>,24,16,[9 2],25,-1,41,-1,25
1,<environment.Job instance at 0x7f454c592f00>,26,18,[3 6],27,-1,45,-1,27
1,<environment.Job instance at 0x7f454c4a3140>,27,18,[5 5],28,-1,46,-1,28
1,<environment.Job instance at 0x7f454c4a3730>,33,18,[4 5],34,-1,52,-1,34
1,<environment.Job instance at 0x7f454c4a3870>,34,15,[3 5],35,-1,50,-1,35
1,<environment.Job instance at 0x7f454c4a37d0>,35,18,[5 8],36,-1,54,-1,36
1,<environment.Job instance at 0x7f454c4a3960>,36,18,[3 9],37,-1,55,-1,37
1,<environment.Job instance at 0x7f454c4a3b40>,39,23,[4 9],40,-1,63,-1,40
1,<environment.Job instance at 0x7f454c4a3c80>,41,16,[6 5],42,-1,58,-1,42
1,<environment.Job instance at 0x7f454c4b30a0>,44,22,[5 8],45,-1,67,-1,45
1,<environment.Job instance at 0x7f454c4b31e0>,45,16,[6 5],46,-1,62,-1,46
1,<environment.Job instance at 0x7f454ce7c140>,59,18,[1 9],60,-1,78,-1,60
1,<environment.Job instance at 0x7f454c4b3230>,47,18,[9 4],48,-1,82,-1,64
1,<environment.Job instance at 0x7f454ce7c5a0>,63,14,[4 8],64,-1,78,-1,64
1,<environment.Job instance at 0x7f454ce7c4b0>,64,17,[3 7],65,-1,85,-1,68
1,<environment.Job instance at 0x7f454c592e60>,23,16,[3 8],24,-1,85,-1,69
1,<environment.Job instance at 0x7f454c4a3050>,28,22,[ 1 13],29,-1,99,-1,77
1,<environment.Job instance at 0x7f454ce7cb40>,70,18,[5 5],71,-1,96,-1,78
1,<environment.Job instance at 0x7f454ce7c8c0>,69,18,[2 9],70,-1,96,-1,78
1,<environment.Job instance at 0x7f454ce71be0>,74,16,[7 5],75,-1,94,-1,78
1,<environment.Job instance at 0x7f454ce7cd20>,73,18,[5 2],74,-1,98,-1,80
1,<environment.Job instance at 0x7f454c592190>,1,3,[ 3 11],2,-1,5,-1,2
1,<environment.Job instance at 0x7f454d1942d0>,15,3,[14  4],16,-1,25,-1,22
1,<environment.Job instance at 0x7f454d194b90>,16,17,[ 1 13],17,-1,39,-1,22
1,<environment.Job instance at 0x7f454d194870>,17,18,[ 3 12],18,-1,40,-1,22
1,<environment.Job instance at 0x7f454d194190>,21,2,[11  4],22,-1,38,-1,36
1,<environment.Job instance at 0x7f454d183280>,28,22,[ 1 13],29,-1,90,-1,68
1,<environment.Job instance at 0x7f454d18c7d0>,38,2,[11  2],39,-1,110,-1,108
1,<environment.Job instance at 0x7f454d18cdc0>,39,23,[4 9],40,-1,132,-1,109
1,<environment.Job instance at 0x7f454d188d70>,42,13,[14  2],43,-1,124,-1,111
1,<environment.Job instance at 0x7f454cb6d2d0>,60,2,[ 4 14],61,-1,176,-1,174
1,<environment.Job instance at 0x7f454c58edc0>,1,13,[9 1],2,-1,18,-1,5
1,<environment.Job instance at 0x7f454d7a0a50>,5,20,[10  3],6,-1,26,-1,6
1,<environment.Job instance at 0x7f454c4e33c0>,6,12,[3 5],7,-1,19,-1,7
1,<environment.Job instance at 0x7f4555ffe8c0>,12,18,[9 2],13,-1,31,-1,13
1,<environment.Job instance at 0x7f4555ffe050>,14,14,[5 9],15,-1,29,-1,15
1,<environment.Job instance at 0x7f454d7c1140>,15,14,[6 3],16,-1,30,-1,16
1,<environment.Job instance at 0x7f454d7c15f0>,17,23,[6 1],18,-1,41,-1,18
1,<environment.Job instance at 0x7f454c18a780>,21,14,[1 5],22,-1,36,-1,22
1,<environment.Job instance at 0x7f454c18aa00>,22,17,[5 1],23,-1,40,-1,23
1,<environment.Job instance at 0x7f454c18a320>,26,18,[ 2 10],27,-1,95,-1,77
1,<environment.Job instance at 0x7f454c58e500>,4,15,[10  2],5,-1,92,-1,77
1,<environment.Job instance at 0x7f454c18a140>,29,14,[8 5],30,-1,91,-1,77
1,<environment.Job instance at 0x7f454c58ec80>,3,17,[14  2],4,-1,94,-1,77
1,<environment.Job instance at 0x7f454c18aa50>,28,14,[9 5],29,-1,94,-1,80
1,<environment.Job instance at 0x7f454c7e14b0>,32,17,[1 5],33,-1,98,-1,81
1,<environment.Job instance at 0x7f454cbd7c80>,35,1,[ 1 10],36,-1,82,-1,81
1,<environment.Job instance at 0x7f454c0d3280>,30,25,[9 4],31,-1,108,-1,83
1,<environment.Job instance at 0x7f454ce7ed70>,38,26,[4 9],39,-1,109,-1,83
1,<environment.Job instance at 0x7f454cbd7050>,37,27,[2 9],38,-1,111,-1,84
1,<environment.Job instance at 0x7f454cbd7870>,36,13,[5 9],37,-1,97,-1,84
1,<environment.Job instance at 0x7f454ce7e460>,41,14,[8 4],42,-1,98,-1,84
1,<environment.Job instance at 0x7f454ce7e820>,42,2,[ 2 10],43,-1,86,-1,84
1,<environment.Job instance at 0x7f454ce7ef00>,43,3,[1 6],44,-1,87,-1,84
1,<environment.Job instance at 0x7f454cee6e10>,44,16,[8 1],45,-1,100,-1,84
1,<environment.Job instance at 0x7f454cee6190>,46,16,[ 5 12],47,-1,100,-1,84
1,<environment.Job instance at 0x7f454cee6820>,48,19,[2 7],49,-1,105,-1,86
1,<environment.Job instance at 0x7f454d31c820>,52,22,[5 4],53,-1,108,-1,86
1,<environment.Job instance at 0x7f454d31c0f0>,50,12,[2 6],51,-1,100,-1,88
1,<environment.Job instance at 0x7f454d48ceb0>,55,13,[5 5],56,-1,101,-1,88
1,<environment.Job instance at 0x7f454d48c730>,56,18,[1 5],57,-1,108,-1,90
1,<environment.Job instance at 0x7f454ce7e780>,40,18,[5 4],41,-1,110,-1,92
1,<environment.Job instance at 0x7f454d48cd20>,58,17,[7 5],59,-1,110,-1,93
1,<environment.Job instance at 0x7f454d48cc30>,60,17,[10  1],61,-1,110,-1,93
1,<environment.Job instance at 0x7f454c18a640>,27,17,[5 5],28,-1,111,-1,94
1,<environment.Job instance at 0x7f454d48c7d0>,61,16,[2 5],62,-1,110,-1,94
1,<environment.Job instance at 0x7f454d48c8c0>,63,16,[1 5],64,-1,110,-1,94
1,<environment.Job instance at 0x7f454d48c460>,65,15,[5 4],66,-1,109,-1,94
1,<environment.Job instance at 0x7f454ccb4b90>,70,18,[4 5],71,-1,148,-1,130
1,<environment.Job instance at 0x7f454c18a6e0>,3,17,[14  2],4,-1,21,-1,4
1,<environment.Job instance at 0x7f454c9a0f00>,16,2,[ 5 12],17,-1,37,-1,35
1,<environment.Job instance at 0x7f454c5343c0>,17,23,[6 1],18,-1,60,-1,37
1,<environment.Job instance at 0x7f454cd60730>,30,25,[9 4],31,-1,104,-1,79
1,<environment.Job instance at 0x7f454c4b3870>,34,28,[ 5 10],35,-1,124,-1,96
1,<environment.Job instance at 0x7f454c4a3c30>,37,27,[2 9],38,-1,124,-1,97
1,<environment.Job instance at 0x7f454c8d5fa0>,38,26,[4 9],39,-1,123,-1,97
1,<environment.Job instance at 0x7f454ccca050>,46,16,[ 5 12],47,-1,131,-1,115
1,<environment.Job instance at 0x7f454c682780>,66,17,[ 2 14],67,-1,199,-1,182
1,<environment.Job instance at 0x7f454d39a690>,67,26,[10  5],68,-1,210,-1,184
1,<environment.Job instance at 0x7f454d2e57d0>,4,22,[1 8],5,-1,27,-1,5
1,<environment.Job instance at 0x7f454d2e5d20>,5,18,[ 2 10],6,-1,24,-1,6
1,<environment.Job instance at 0x7f454c9a0870>,9,17,[9 1],10,-1,28,-1,11
1,<environment.Job instance at 0x7f454c9a03c0>,12,26,[1 5],13,-1,39,-1,13
1,<environment.Job instance at 0x7f4556005d70>,13,17,[ 4 10],14,-1,31,-1,14
1,<environment.Job instance at 0x7f454d9405f0>,14,15,[5 3],15,-1,30,-1,15
1,<environment.Job instance at 0x7f454d9403c0>,15,15,[8 3],16,-1,31,-1,16
1,<environment.Job instance at 0x7f454d49bf50>,17,12,[9 2],18,-1,30,-1,18
1,<environment.Job instance at 0x7f454d964fa0>,20,13,[10  5],21,-1,34,-1,21
1,<environment.Job instance at 0x7f454d964280>,21,12,[8 2],22,-1,34,-1,22
1,<environment.Job instance at 0x7f454c524780>,22,22,[5 3],23,-1,45,-1,23
1,<environment.Job instance at 0x7f454d583460>,24,15,[4 7],25,-1,40,-1,25
1,<environment.Job instance at 0x7f454c9da910>,27,24,[2 8],28,-1,52,-1,28
1,<environment.Job instance at 0x7f454c7b0aa0>,31,16,[4 9],32,-1,48,-1,32
1,<environment.Job instance at 0x7f454cae2aa0>,32,15,[1 6],33,-1,48,-1,33
1,<environment.Job instance at 0x7f454d89a280>,33,26,[1 8],34,-1,60,-1,34
1,<environment.Job instance at 0x7f454c6b6410>,36,18,[7 1],37,-1,55,-1,37
1,<environment.Job instance at 0x7f454d44be10>,41,23,[9 4],42,-1,65,-1,42
1,<environment.Job instance at 0x7f454d879b90>,44,14,[2 7],45,-1,59,-1,45
1,<environment.Job instance at 0x7f454d879690>,46,16,[9 3],47,-1,63,-1,47
1,<environment.Job instance at 0x7f454d879960>,48,16,[5 1],49,-1,65,-1,49
1,<environment.Job instance at 0x7f454d879730>,50,17,[4 7],51,-1,68,-1,51
1,<environment.Job instance at 0x7f454d879870>,51,14,[3 5],52,-1,66,-1,52
1,<environment.Job instance at 0x7f454c4dd6e0>,57,17,[4 6],58,-1,75,-1,58
1,<environment.Job instance at 0x7f454cbad910>,60,18,[3 6],61,-1,79,-1,61
1,<environment.Job instance at 0x7f454d8f8b40>,62,16,[1 9],63,-1,79,-1,63
1,<environment.Job instance at 0x7f454d8f8410>,63,13,[6 4],64,-1,77,-1,64
1,<environment.Job instance at 0x7f454d8f8fa0>,64,12,[10  3],65,-1,77,-1,65
1,<environment.Job instance at 0x7f454cd0f3c0>,66,16,[2 7],67,-1,83,-1,67
1,<environment.Job instance at 0x7f454ce02a00>,69,12,[4 8],70,-1,82,-1,70
1,<environment.Job instance at 0x7f454ce02460>,70,14,[1 9],71,-1,85,-1,71
1,<environment.Job instance at 0x7f454ce025a0>,72,12,[1 7],73,-1,85,-1,73
1,<environment.Job instance at 0x7f454ce02640>,74,17,[10  5],75,-1,92,-1,75
1,<environment.Job instance at 0x7f454ccca820>,75,15,[1 6],76,-1,91,-1,76
1,<environment.Job instance at 0x7f454cb957d0>,77,16,[11  5],78,-1,94,-1,78
1,<environment.Job instance at 0x7f454cbb7910>,3,23,[1 7],4,-1,27,-1,4
1,<environment.Job instance at 0x7f454d819fa0>,8,13,[14  3],9,-1,22,-1,9
1,<environment.Job instance at 0x7f454c1f3c30>,12,26,[1 5],13,-1,39,-1,13
1,<environment.Job instance at 0x7f454d0f85f0>,27,24,[2 8],28,-1,94,-1,70
1,<environment.Job instance at 0x7f454d0f8820>,29,13,[14  2],30,-1,83,-1,70
1,<environment.Job instance at 0x7f454d73e550>,33,26,[1 8],34,-1,116,-1,90
1,<environment.Job instance at 0x7f454d1e7280>,39,15,[ 1 14],40,-1,118,-1,103
1,<environment.Job instance at 0x7f454d7a0910>,41,23,[9 4],42,-1,131,-1,108
1,<environment.Job instance at 0x7f454d0232d0>,77,16,[11  5],78,-1,276,-1,260
1,<environment.Job instance at 0x7f454c39ec80>,5,17,[ 5 10],6,-1,23,-1,6
1,<environment.Job instance at 0x7f454ce450f0>,8,12,[6 1],9,-1,23,-1,11
1,<environment.Job instance at 0x7f454ce45640>,12,16,[5 3],13,-1,29,-1,13
1,<environment.Job instance at 0x7f454ce45b90>,13,16,[9 5],14,-1,30,-1,14
1,<environment.Job instance at 0x7f454ce45960>,14,16,[8 5],15,-1,31,-1,15
1,<environment.Job instance at 0x7f454d54f4b0>,19,16,[6 2],20,-1,36,-1,20
1,<environment.Job instance at 0x7f454d27b7d0>,22,16,[9 3],23,-1,40,-1,24
1,<environment.Job instance at 0x7f45564f7a50>,24,16,[7 3],25,-1,41,-1,25
1,<environment.Job instance at 0x7f454d6992d0>,25,22,[5 2],26,-1,49,-1,27
1,<environment.Job instance at 0x7f454d2f4cd0>,31,28,[7 5],32,-1,81,-1,53
1,<environment.Job instance at 0x7f454ce455a0>,10,15,[6 2],11,-1,69,-1,54
1,<environment.Job instance at 0x7f454cfc3d70>,32,14,[6 1],33,-1,68,-1,54
1,<environment.Job instance at 0x7f454ce13140>,28,13,[5 7],29,-1,67,-1,54
1,<environment.Job instance at 0x7f454cb94690>,35,18,[10  4],36,-1,74,-1,56
1,<environment.Job instance at 0x7f454cfec960>,34,26,[7 1],35,-1,82,-1,56
1,<environment.Job instance at 0x7f454d6ce5a0>,41,18,[4 9],42,-1,102,-1,84
1,<environment.Job instance at 0x7f454d856050>,42,18,[3 6],43,-1,102,-1,84
1,<environment.Job instance at 0x7f454ce2a5f0>,45,16,[2 7],46,-1,100,-1,84
1,<environment.Job instance at 0x7f454ceb33c0>,50,24,[10  5],51,-1,108,-1,84
1,<environment.Job instance at 0x7f454d709320>,52,15,[ 2 10],53,-1,99,-1,84
1,<environment.Job instance at 0x7f454ceb3fa0>,48,18,[8 3],49,-1,102,-1,84
1,<environment.Job instance at 0x7f454d709640>,54,17,[10  3],55,-1,101,-1,84
1,<environment.Job instance at 0x7f454d709e10>,55,18,[ 2 11],56,-1,102,-1,84
1,<environment.Job instance at 0x7f454d7091e0>,53,18,[6 3],54,-1,102,-1,84
1,<environment.Job instance at 0x7f454d709050>,57,18,[6 4],58,-1,102,-1,84
1,<environment.Job instance at 0x7f454d709370>,58,27,[5 1],59,-1,111,-1,84
1,<environment.Job instance at 0x7f454d709280>,56,13,[11  3],57,-1,97,-1,84
1,<environment.Job instance at 0x7f454d709b40>,59,15,[9 3],60,-1,99,-1,84
1,<environment.Job instance at 0x7f454d46f0f0>,68,27,[1 7],69,-1,115,-1,88
1,<environment.Job instance at 0x7f454d46f140>,69,16,[12  5],70,-1,104,-1,88
1,<environment.Job instance at 0x7f454d46fe10>,66,15,[4 7],67,-1,103,-1,88
1,<environment.Job instance at 0x7f454d46fc80>,77,17,[13  5],78,-1,106,-1,89
1,<environment.Job instance at 0x7f454d46fa00>,1,3,[13  1],2,-1,5,-1,2
1,<environment.Job instance at 0x7f454c6d11e0>,15,1,[ 3 12],16,-1,23,-1,22
1,<environment.Job instance at 0x7f454d819fa0>,18,3,[ 5 12],19,-1,40,-1,37
1,<environment.Job instance at 0x7f454c6e0730>,26,1,[11  1],27,-1,71,-1,70
1,<environment.Job instance at 0x7f454c2064b0>,30,13,[11  3],31,-1,96,-1,83
1,<environment.Job instance at 0x7f454d8c9780>,31,28,[7 5],32,-1,112,-1,84
1,<environment.Job instance at 0x7f454c1ae3c0>,33,2,[14  5],34,-1,86,-1,84
1,<environment.Job instance at 0x7f454cca5190>,34,26,[7 1],35,-1,112,-1,86
1,<environment.Job instance at 0x7f454c23a780>,47,13,[13  4],48,-1,150,-1,137
1,<environment.Job instance at 0x7f454c1b2460>,51,3,[ 4 12],52,-1,156,-1,153
1,<environment.Job instance at 0x7f454c1b2370>,50,24,[10  5],51,-1,178,-1,154
1,<environment.Job instance at 0x7f454d05d370>,55,18,[ 2 11],56,-1,189,-1,171
1,<environment.Job instance at 0x7f454d05db40>,56,13,[11  3],57,-1,184,-1,171
1,<environment.Job instance at 0x7f454c21baf0>,58,27,[5 1],59,-1,213,-1,186
1,<environment.Job instance at 0x7f454d55b870>,68,27,[1 7],69,-1,246,-1,219
1,<environment.Job instance at 0x7f454d7ddaf0>,69,16,[12  5],70,-1,235,-1,219
1,<environment.Job instance at 0x7f454d7ea460>,76,1,[14  4],77,-1,228,-1,227
1,<environment.Job instance at 0x7f454d7eabe0>,77,17,[13  5],78,-1,244,-1,227
1,<environment.Job instance at 0x7f454d9302d0>,0,17,[5 9],1,-1,18,-1,1
1,<environment.Job instance at 0x7f454d930b40>,1,17,[9 4],2,-1,19,-1,2
1,<environment.Job instance at 0x7f454ccda690>,4,14,[9 5],5,-1,20,-1,6
1,<environment.Job instance at 0x7f454c220dc0>,5,14,[6 1],6,-1,20,-1,6
1,<environment.Job instance at 0x7f454ccda2d0>,6,16,[3 8],7,-1,24,-1,8
1,<environment.Job instance at 0x7f454ccdad20>,8,15,[1 8],9,-1,24,-1,9
1,<environment.Job instance at 0x7f454ccda190>,9,2,[ 3 10],10,-1,12,-1,10
1,<environment.Job instance at 0x7f454ccda0f0>,10,13,[7 3],11,-1,24,-1,11
1,<environment.Job instance at 0x7f454ccdab90>,11,2,[6 2],12,-1,14,-1,12
1,<environment.Job instance at 0x7f454ccda8c0>,12,12,[10  2],13,-1,25,-1,13
1,<environment.Job instance at 0x7f454ccdaf00>,13,1,[5 5],14,-1,15,-1,14
1,<environment.Job instance at 0x7f454cd6be10>,14,18,[ 2 10],15,-1,33,-1,15
1,<environment.Job instance at 0x7f454cd6b2d0>,15,14,[8 4],16,-1,30,-1,16
1,<environment.Job instance at 0x7f454cd6be60>,16,18,[ 2 10],17,-1,35,-1,17
1,<environment.Job instance at 0x7f454cd6b1e0>,17,18,[5 9],18,-1,36,-1,18
1,<environment.Job instance at 0x7f454cd6ba50>,18,3,[6 2],19,-1,22,-1,19
1,<environment.Job instance at 0x7f454cd6b820>,19,1,[6 1],20,-1,21,-1,20
1,<environment.Job instance at 0x7f454cd6bb40>,20,17,[8 2],21,-1,38,-1,21
1,<environment.Job instance at 0x7f454cd6b190>,21,14,[4 9],22,-1,36,-1,22
1,<environment.Job instance at 0x7f454cd6bcd0>,22,16,[6 2],23,-1,39,-1,23
1,<environment.Job instance at 0x7f454cd6bd70>,23,3,[ 2 10],24,-1,27,-1,24
1,<environment.Job instance at 0x7f454cd6b0f0>,24,15,[2 5],25,-1,40,-1,25
1,<environment.Job instance at 0x7f454cd6bc80>,25,13,[2 7],26,-1,39,-1,26
1,<environment.Job instance at 0x7f454cd6baa0>,26,3,[1 8],27,-1,30,-1,27
1,<environment.Job instance at 0x7f454cd6b140>,27,1,[3 5],28,-1,29,-1,28
1,<environment.Job instance at 0x7f454cd6b280>,28,25,[5 5],29,-1,54,-1,29
1,<environment.Job instance at 0x7f454cd6b4b0>,29,2,[5 1],30,-1,32,-1,30
1,<environment.Job instance at 0x7f454cd6b0a0>,30,18,[14  5],31,-1,49,-1,31
1,<environment.Job instance at 0x7f454cd6b3c0>,31,15,[ 1 12],32,-1,47,-1,32
1,<environment.Job instance at 0x7f454cd6b320>,32,13,[3 7],33,-1,46,-1,33
1,<environment.Job instance at 0x7f454cd6ba00>,33,12,[1 8],34,-1,46,-1,34
1,<environment.Job instance at 0x7f454cd6b370>,34,14,[7 4],35,-1,49,-1,35
1,<environment.Job instance at 0x7f454cd6b640>,35,14,[5 9],36,-1,50,-1,36
1,<environment.Job instance at 0x7f454d39ba50>,36,15,[2 7],37,-1,52,-1,37
1,<environment.Job instance at 0x7f454d39b500>,37,16,[3 5],38,-1,54,-1,38
1,<environment.Job instance at 0x7f454d39b8c0>,38,17,[2 7],39,-1,56,-1,39
1,<environment.Job instance at 0x7f454d39b1e0>,39,16,[8 5],40,-1,56,-1,40
1,<environment.Job instance at 0x7f454d39bc30>,40,22,[4 6],41,-1,63,-1,41
1,<environment.Job instance at 0x7f454d39bfa0>,41,2,[1 8],42,-1,44,-1,42
1,<environment.Job instance at 0x7f454d39baf0>,42,18,[5 6],43,-1,61,-1,43
1,<environment.Job instance at 0x7f454d39baa0>,43,14,[4 8],44,-1,58,-1,44
1,<environment.Job instance at 0x7f454d39beb0>,44,18,[10  2],45,-1,63,-1,45
1,<environment.Job instance at 0x7f454d39b190>,45,17,[3 9],46,-1,63,-1,46
1,<environment.Job instance at 0x7f454d39b3c0>,46,1,[6 4],47,-1,48,-1,47
1,<environment.Job instance at 0x7f454d39be10>,47,2,[9 5],48,-1,50,-1,48
1,<environment.Job instance at 0x7f454d39b5f0>,48,12,[10  5],49,-1,61,-1,49
1,<environment.Job instance at 0x7f454d39bbe0>,49,2,[2 5],50,-1,52,-1,50
1,<environment.Job instance at 0x7f454d39b460>,50,3,[7 5],51,-1,54,-1,51
1,<environment.Job instance at 0x7f454ccdaaa0>,7,18,[ 5 10],8,-1,70,-1,52
1,<environment.Job instance at 0x7f454d2d2c80>,28,25,[5 5],29,-1,138,-1,113
1,<environment.Job instance at 0x7f454d05d370>,30,18,[14  5],31,-1,131,-1,113
1,<environment.Job instance at 0x7f454cf0f460>,31,15,[ 1 12],32,-1,128,-1,113
1,<environment.Job instance at 0x7f454c6e03c0>,52,17,[ 3 14],53,-1,227,-1,210
1,<environment.Job instance at 0x7f454c6e0730>,55,16,[ 4 12],56,-1,230,-1,214
1,<environment.Job instance at 0x7f4555f33190>,58,18,[13  3],59,-1,243,-1,225
1,<environment.Job instance at 0x7f454d819fa0>,59,1,[ 4 14],60,-1,226,-1,225
1,<environment.Job instance at 0x7f454cb788c0>,62,16,[14  1],63,-1,246,-1,230
1,<environment.Job instance at 0x7f454c6d1730>,65,1,[ 5 13],66,-1,232,-1,231
1,<environment.Job instance at 0x7f454d6c7fa0>,73,3,[ 5 11],74,-1,266,-1,263
1,<environment.Job instance at 0x7f454cb3b050>,10,12,[10  4],11,-1,24,-1,12
1,<environment.Job instance at 0x7f454cb3b780>,12,18,[ 5 10],13,-1,31,-1,13
1,<environment.Job instance at 0x7f454d8bbb90>,16,16,[ 5 10],17,-1,33,-1,17
1,<environment.Job instance at 0x7f454d48ef50>,24,12,[3 9],25,-1,37,-1,25
1,<environment.Job instance at 0x7f454d462320>,33,15,[8 4],34,-1,49,-1,34
1,<environment.Job instance at 0x7f454d462aa0>,35,13,[5 1],36,-1,49,-1,36
1,<environment.Job instance at 0x7f454cc602d0>,36,20,[4 9],37,-1,57,-1,37
1,<environment.Job instance at 0x7f454d5865a0>,40,16,[6 2],41,-1,57,-1,41
1,<environment.Job instance at 0x7f454d3450f0>,43,21,[5 7],44,-1,65,-1,44
1,<environment.Job instance at 0x7f454d7a0dc0>,44,14,[10  4],45,-1,59,-1,45
1,<environment.Job instance at 0x7f454d7a0d20>,45,17,[4 9],46,-1,63,-1,46
1,<environment.Job instance at 0x7f454d7a08c0>,47,13,[7 4],48,-1,61,-1,48
1,<environment.Job instance at 0x7f454d7a0550>,50,13,[10  1],51,-1,64,-1,51
1,<environment.Job instance at 0x7f454d7a0230>,51,16,[5 7],52,-1,68,-1,52
1,<environment.Job instance at 0x7f454d7a05f0>,52,19,[4 7],53,-1,72,-1,53
1,<environment.Job instance at 0x7f454ce04050>,56,19,[9 4],57,-1,77,-1,58
1,<environment.Job instance at 0x7f454ce04c30>,58,17,[ 2 12],59,-1,78,-1,61
1,<environment.Job instance at 0x7f454ce044b0>,53,25,[9 3],54,-1,100,-1,75
1,<environment.Job instance at 0x7f454d48e820>,27,15,[13  3],28,-1,91,-1,76
1,<environment.Job instance at 0x7f4555ed72d0>,63,18,[10  5],64,-1,94,-1,76
1,<environment.Job instance at 0x7f454ce04230>,57,18,[4 7],58,-1,94,-1,76
1,<environment.Job instance at 0x7f454c985aa0>,68,24,[8 3],69,-1,100,-1,76
1,<environment.Job instance at 0x7f454cbb2af0>,69,14,[3 5],70,-1,90,-1,76
1,<environment.Job instance at 0x7f454d859320>,72,15,[ 3 10],73,-1,91,-1,76
1,<environment.Job instance at 0x7f454d05e640>,74,17,[9 5],75,-1,93,-1,76
1,<environment.Job instance at 0x7f454cb3b7d0>,14,26,[10  2],15,-1,102,-1,76
1,<environment.Job instance at 0x7f454c094370>,75,14,[2 9],76,-1,90,-1,76
1,<environment.Job instance at 0x7f454cb3bc80>,1,3,[ 3 11],2,-1,5,-1,2
1,<environment.Job instance at 0x7f454c0ea730>,8,18,[ 4 12],9,-1,27,-1,9
1,<environment.Job instance at 0x7f454ceac550>,14,26,[10  2],15,-1,50,-1,24
1,<environment.Job instance at 0x7f454d8be460>,27,15,[13  3],28,-1,54,-1,39
1,<environment.Job instance at 0x7f454d598fa0>,41,2,[ 2 13],42,-1,72,-1,70
1,<environment.Job instance at 0x7f454c9da8c0>,48,2,[12  1],49,-1,98,-1,96
1,<environment.Job instance at 0x7f454c9da3c0>,49,27,[ 5 11],50,-1,123,-1,96
1,<environment.Job instance at 0x7f455610a280>,53,25,[9 3],54,-1,136,-1,111
1,<environment.Job instance at 0x7f454c7e1050>,58,17,[ 2 12],59,-1,132,-1,115
1,<environment.Job instance at 0x7f454d1735a0>,60,26,[9 4],61,-1,153,-1,127
1,<environment.Job instance at 0x7f454c511eb0>,65,14,[13  2],66,-1,155,-1,141
1,<environment.Job instance at 0x7f454c8616e0>,68,24,[8 3],69,-1,182,-1,158
1,<environment.Job instance at 0x7f454d4979b0>,4,13,[10  5],5,-1,18,-1,5
1,<environment.Job instance at 0x7f454c5316e0>,5,14,[10  1],6,-1,20,-1,6
1,<environment.Job instance at 0x7f454c531eb0>,7,17,[1 7],8,-1,25,-1,8
1,<environment.Job instance at 0x7f454cbb1be0>,9,17,[8 4],10,-1,27,-1,10
1,<environment.Job instance at 0x7f454d4826e0>,11,16,[2 6],12,-1,28,-1,12
1,<environment.Job instance at 0x7f454cf63d70>,12,17,[8 1],13,-1,30,-1,13
1,<environment.Job instance at 0x7f454cf632d0>,13,26,[2 9],14,-1,40,-1,14
1,<environment.Job instance at 0x7f454cf5c640>,15,17,[1 8],16,-1,33,-1,16
1,<environment.Job instance at 0x7f454cf36190>,22,18,[6 4],23,-1,41,-1,23
1,<environment.Job instance at 0x7f454cba6f00>,23,18,[1 8],24,-1,42,-1,24
1,<environment.Job instance at 0x7f454d77de60>,27,12,[2 5],28,-1,40,-1,28
1,<environment.Job instance at 0x7f454d0ca230>,29,15,[8 4],30,-1,45,-1,30
1,<environment.Job instance at 0x7f454d5867d0>,34,16,[5 3],35,-1,51,-1,35
1,<environment.Job instance at 0x7f454d586190>,35,13,[2 6],36,-1,49,-1,36
1,<environment.Job instance at 0x7f454cf44820>,38,18,[5 6],39,-1,57,-1,39
1,<environment.Job instance at 0x7f454cdcff00>,42,18,[7 3],43,-1,61,-1,43
1,<environment.Job instance at 0x7f454cdcf370>,45,16,[5 7],46,-1,62,-1,46
1,<environment.Job instance at 0x7f454cdcf1e0>,49,23,[5 5],50,-1,77,-1,54
1,<environment.Job instance at 0x7f454cdcf640>,47,16,[3 5],48,-1,70,-1,54
1,<environment.Job instance at 0x7f454cdcf820>,50,17,[8 3],51,-1,72,-1,55
1,<environment.Job instance at 0x7f454cdcf050>,52,12,[5 4],53,-1,67,-1,55
1,<environment.Job instance at 0x7f454c5bb780>,54,17,[5 6],55,-1,72,-1,55
1,<environment.Job instance at 0x7f454d39c960>,55,24,[7 5],56,-1,80,-1,56
1,<environment.Job instance at 0x7f454cdcf410>,51,12,[7 5],52,-1,84,-1,72
1,<environment.Job instance at 0x7f454d39c730>,62,17,[3 8],63,-1,90,-1,73
1,<environment.Job instance at 0x7f454d39c640>,67,14,[9 3],68,-1,87,-1,73
1,<environment.Job instance at 0x7f454d39c7d0>,69,15,[8 4],70,-1,88,-1,73
1,<environment.Job instance at 0x7f4555f7be60>,72,16,[6 3],73,-1,89,-1,73
1,<environment.Job instance at 0x7f454d39c0a0>,71,15,[3 9],72,-1,91,-1,76
1,<environment.Job instance at 0x7f4555f7bc80>,75,19,[8 1],76,-1,97,-1,78
1,<environment.Job instance at 0x7f454d0ca0a0>,8,2,[ 4 12],9,-1,11,-1,9
1,<environment.Job instance at 0x7f454d39c6e0>,16,13,[12  4],17,-1,54,-1,41
1,<environment.Job instance at 0x7f454c5114b0>,13,26,[2 9],14,-1,70,-1,44
1,<environment.Job instance at 0x7f454d7cf050>,21,17,[13  5],22,-1,66,-1,49
1,<environment.Job instance at 0x7f454c0ea6e0>,49,23,[5 5],50,-1,163,-1,140
1,<environment.Job instance at 0x7f454c0ea730>,55,24,[7 5],56,-1,195,-1,171
1,<environment.Job instance at 0x7f4555f7b870>,57,3,[ 2 13],58,-1,174,-1,171
1,<environment.Job instance at 0x7f455618d1e0>,70,1,[13  2],71,-1,214,-1,213
1,<environment.Job instance at 0x7f455618de60>,73,1,[ 2 13],74,-1,227,-1,226
1,<environment.Job instance at 0x7f455618d230>,76,1,[ 4 11],77,-1,242,-1,241
1,<environment.Job instance at 0x7fc0593666e0>,0,13,[9 3],1,-1,15,-1,2
1,<environment.Job instance at 0x7fc0593668c0>,1,22,[11  3],2,-1,24,-1,2
1,<environment.Job instance at 0x7fc059366730>,2,22,[4 8],3,-1,25,-1,3
1,<environment.Job instance at 0x7fc04fd76fa0>,9,18,[11  5],10,-1,28,-1,10
1,<environment.Job instance at 0x7fc04fd790f0>,11,15,[4 8],12,-1,27,-1,12
1,<environment.Job instance at 0x7fc04fd79230>,13,18,[ 4 10],14,-1,32,-1,14
1,<environment.Job instance at 0x7fc04fd79460>,15,18,[2 8],16,-1,34,-1,16
1,<environment.Job instance at 0x7fc04fd79640>,16,16,[3 5],17,-1,33,-1,17
1,<environment.Job instance at 0x7fc04fd79870>,19,14,[3 5],20,-1,35,-1,21
1,<environment.Job instance at 0x7fc04fd7c0a0>,28,23,[10  4],29,-1,52,-1,29
1,<environment.Job instance at 0x7fc04fd799b0>,24,18,[2 6],25,-1,49,-1,31
1,<environment.Job instance at 0x7fc04fd7c190>,30,14,[5 2],31,-1,45,-1,31
1,<environment.Job instance at 0x7fc04fd7c460>,31,14,[2 5],32,-1,46,-1,32
1,<environment.Job instance at 0x7fc04fd79cd0>,27,15,[8 4],28,-1,48,-1,33
1,<environment.Job instance at 0x7fc04fd79a50>,23,27,[1 6],24,-1,64,-1,37
1,<environment.Job instance at 0x7fc04fd7c6e0>,34,24,[1 8],35,-1,61,-1,37
1,<environment.Job instance at 0x7fc04fd7c410>,33,14,[5 5],34,-1,55,-1,41
1,<environment.Job instance at 0x7fc04fd7cc30>,43,18,[5 5],44,-1,62,-1,44
1,<environment.Job instance at 0x7fc04fd7e140>,48,15,[10  1],49,-1,64,-1,49
1,<environment.Job instance at 0x7fc04fd7e230>,46,17,[12  2],47,-1,67,-1,50
1,<environment.Job instance at 0x7fc04fd7e5a0>,49,16,[2 5],50,-1,66,-1,50
1,<environment.Job instance at 0x7fc04fd7ea00>,56,17,[8 5],57,-1,74,-1,57
1,<environment.Job instance at 0x7fc04fd7ec80>,57,18,[2 8],58,-1,76,-1,58
1,<environment.Job instance at 0x7fc04fd7e7d0>,53,17,[5 7],54,-1,78,-1,61
1,<environment.Job instance at 0x7fc04fd83190>,61,2,[4 5],62,-1,64,-1,62
1,<environment.Job instance at 0x7fc04fd83140>,62,22,[6 4],63,-1,85,-1,63
1,<environment.Job instance at 0x7fc04fd7ed20>,59,17,[1 6],60,-1,80,-1,63
1,<environment.Job instance at 0x7fc04fd83280>,64,18,[2 9],65,-1,83,-1,65
1,<environment.Job instance at 0x7fc04fd83410>,65,20,[2 6],66,-1,87,-1,67
1,<environment.Job instance at 0x7fc04fd83d20>,76,19,[4 8],77,-1,98,-1,79
1,<environment.Job instance at 0x7fc04fd7c500>,36,13,[ 3 14],37,-1,92,-1,79
1,<environment.Job instance at 0x7fc04fd7e9b0>,54,13,[13  1],55,-1,95,-1,82
1,<environment.Job instance at 0x7fc04fd83dc0>,75,14,[ 4 11],76,-1,96,-1,82
1,<environment.Job instance at 0x7fc04fd7c690>,35,15,[9 5],36,-1,97,-1,82
1,<environment.Job instance at 0x7fc04fd83c30>,78,12,[10  2],79,-1,94,-1,82
1,<environment.Job instance at 0x7fc04fd84370>,82,16,[ 4 10],83,-1,99,-1,83
1,<environment.Job instance at 0x7fc04fd84410>,83,20,[7 1],84,-1,104,-1,84
1,<environment.Job instance at 0x7fc04fd84140>,84,18,[3 7],85,-1,103,-1,85
1,<environment.Job instance at 0x7fc04fd79730>,1,22,[11  3],2,-1,24,-1,2
1,<environment.Job instance at 0x7fc04fd7ee10>,9,18,[11  5],10,-1,32,-1,14
1,<environment.Job instance at 0x7fc04fd830a0>,12,26,[ 1 10],13,-1,82,-1,56
1,<environment.Job instance at 0x7fc04fd6df50>,23,27,[1 6],24,-1,87,-1,60
1,<environment.Job instance at 0x7fc04fd6daf0>,28,23,[10  4],29,-1,97,-1,74
1,<environment.Job instance at 0x7fc04fe978c0>,34,24,[1 8],35,-1,117,-1,93
1,<environment.Job instance at 0x7fc04fe19a00>,36,13,[ 3 14],37,-1,106,-1,93
1,<environment.Job instance at 0x7fc04fe206e0>,46,17,[12  2],47,-1,134,-1,117
1,<environment.Job instance at 0x7fc04fe81dc0>,50,16,[12  2],51,-1,146,-1,130
1,<environment.Job instance at 0x7fc04fdffe10>,54,13,[13  1],55,-1,158,-1,145
1,<environment.Job instance at 0x7fc04fd9e960>,60,3,[12  3],61,-1,169,-1,166
1,<environment.Job instance at 0x7fc04fe995a0>,67,27,[ 1 10],68,-1,216,-1,189
1,<environment.Job instance at 0x7fc04fe99460>,69,13,[ 3 12],70,-1,202,-1,189
1,<environment.Job instance at 0x7fc04fe842d0>,75,14,[ 4 11],76,-1,215,-1,201
1,<environment.Job instance at 0x7fc04f4c2410>,10,18,[2 7],11,-1,30,-1,12
1,<environment.Job instance at 0x7fc04f4c2550>,12,16,[3 9],13,-1,29,-1,13
1,<environment.Job instance at 0x7fc04f4b6460>,13,16,[1 6],14,-1,30,-1,14
1,<environment.Job instance at 0x7fc04f4b6eb0>,14,15,[1 9],15,-1,30,-1,15
1,<environment.Job instance at 0x7fc04f4b6af0>,17,17,[9 3],18,-1,36,-1,19
1,<environment.Job instance at 0x7fc04f3887d0>,7,2,[ 5 11],8,-1,10,-1,8
1,<environment.Job instance at 0x7fc04f3230a0>,9,18,[12  5],10,-1,28,-1,10
1,<environment.Job instance at 0x7fc0594d18c0>,15,14,[14  5],16,-1,37,-1,23
1,<environment.Job instance at 0x7fc0594d1e10>,16,15,[11  1],17,-1,38,-1,23
1,<environment.Job instance at 0x7fc04f5185a0>,26,3,[ 1 12],27,-1,59,-1,56
1,<environment.Job instance at 0x7fc04f624dc0>,21,26,[ 5 10],22,-1,88,-1,62
1,<environment.Job instance at 0x7fc04f51bc30>,32,3,[ 4 12],33,-1,66,-1,63
1,<environment.Job instance at 0x7fc04f51b640>,33,12,[ 4 11],34,-1,75,-1,63
1,<environment.Job instance at 0x7fc04f5274b0>,38,23,[ 2 14],39,-1,90,-1,67
1,<environment.Job instance at 0x7fc04f53d820>,48,16,[11  2],49,-1,119,-1,103
1,<environment.Job instance at 0x7fc04f53d780>,49,18,[ 1 12],50,-1,121,-1,103
1,<environment.Job instance at 0x7fc04f539c30>,53,15,[ 1 12],54,-1,134,-1,119
1,<environment.Job instance at 0x7fc04f539e10>,55,3,[ 4 13],56,-1,122,-1,119
1,<environment.Job instance at 0x7fc04f5302d0>,57,1,[ 1 14],58,-1,122,-1,121
1,<environment.Job instance at 0x7fc04f5483c0>,70,3,[13  3],71,-1,173,-1,170
1,<environment.Job instance at 0x7fc04f678140>,75,13,[ 1 14],76,-1,198,-1,185
1,<environment.Job instance at 0x7fc04f572190>,86,2,[11  5],87,-1,202,-1,200
1,<environment.Job instance at 0x7fc04f572320>,88,3,[14  4],89,-1,211,-1,208
1,<environment.Job instance at 0x7fc04f342cd0>,8,21,[9 4],9,-1,30,-1,9
1,<environment.Job instance at 0x7fc04f342a50>,9,12,[9 3],10,-1,23,-1,11
1,<environment.Job instance at 0x7fc04f3425f0>,11,17,[10  2],12,-1,30,-1,13
1,<environment.Job instance at 0x7fc0593667d0>,10,18,[10  3],11,-1,31,-1,13
1,<environment.Job instance at 0x7fc04f342230>,17,1,[9 1],18,-1,20,-1,19
1,<environment.Job instance at 0x7fc04f3422d0>,18,12,[14  4],19,-1,31,-1,19
1,<environment.Job instance at 0x7fc04f31c6e0>,20,13,[10  5],21,-1,35,-1,22
1,<environment.Job instance at 0x7fc04f31c140>,22,14,[2 7],23,-1,37,-1,23
1,<environment.Job instance at 0x7fc04f31cd70>,23,14,[7 5],24,-1,38,-1,24
1,<environment.Job instance at 0x7fc04f31cf00>,25,14,[10  2],26,-1,40,-1,26
1,<environment.Job instance at 0x7fc04f31c910>,21,14,[1 6],22,-1,46,-1,32
1,<environment.Job instance at 0x7fc04f388870>,34,16,[7 2],35,-1,51,-1,35
1,<environment.Job instance at 0x7fc04f3882d0>,36,12,[ 3 10],37,-1,49,-1,37
1,<environment.Job instance at 0x7fc04f388c80>,40,18,[4 5],41,-1,59,-1,41
1,<environment.Job instance at 0x7fc04f388910>,41,18,[2 8],42,-1,60,-1,42
1,<environment.Job instance at 0x7fc04f393af0>,44,16,[9 4],45,-1,63,-1,47
1,<environment.Job instance at 0x7fc04f393960>,46,14,[10  1],47,-1,61,-1,47
1,<environment.Job instance at 0x7fc04f393910>,47,16,[9 2],48,-1,65,-1,49
1,<environment.Job instance at 0x7fc04f3934b0>,48,15,[7 5],49,-1,64,-1,49
1,<environment.Job instance at 0x7fc04f321730>,56,19,[2 7],57,-1,76,-1,57
1,<environment.Job instance at 0x7fc04f321e10>,58,18,[6 3],59,-1,82,-1,64
1,<environment.Job instance at 0x7fc04f321230>,64,16,[7 5],65,-1,81,-1,65
1,<environment.Job instance at 0x7fc04f321320>,66,16,[7 4],67,-1,83,-1,67
1,<environment.Job instance at 0x7fc04f3216e0>,68,18,[4 6],69,-1,87,-1,69
1,<environment.Job instance at 0x7fc0594ce6e0>,71,27,[4 7],72,-1,99,-1,72
1,<environment.Job instance at 0x7fc0594cea00>,72,26,[8 4],73,-1,99,-1,73
1,<environment.Job instance at 0x7fc0594ce5f0>,77,17,[5 2],78,-1,95,-1,78
1,<environment.Job instance at 0x7fc0594d27d0>,78,18,[4 5],79,-1,97,-1,79
1,<environment.Job instance at 0x7fc0594d2d70>,80,25,[ 3 10],81,-1,106,-1,81
1,<environment.Job instance at 0x7fc04f5c7a00>,18,12,[14  4],19,-1,44,-1,32
1,<environment.Job instance at 0x7fc04f323820>,28,2,[13  1],29,-1,63,-1,61
1,<environment.Job instance at 0x7fc04f3884b0>,31,3,[13  5],32,-1,73,-1,70
1,<environment.Job instance at 0x7fc04f3887d0>,32,2,[ 1 12],33,-1,72,-1,70
1,<environment.Job instance at 0x7fc04f3fd6e0>,42,1,[ 4 13],43,-1,91,-1,90
1,<environment.Job instance at 0x7fc04f3fd730>,43,14,[11  3],44,-1,104,-1,90
1,<environment.Job instance at 0x7fc05940deb0>,60,24,[ 1 10],61,-1,193,-1,169
1,<environment.Job instance at 0x7fc05940d910>,63,24,[7 4],64,-1,206,-1,182
1,<environment.Job instance at 0x7fc04f3744b0>,65,3,[12  3],66,-1,185,-1,182
1,<environment.Job instance at 0x7fc04f374460>,71,27,[4 7],72,-1,232,-1,205
1,<environment.Job instance at 0x7fc04f374050>,72,26,[8 4],73,-1,231,-1,205
1,<environment.Job instance at 0x7fc04f3743c0>,75,16,[14  1],76,-1,221,-1,205
1,<environment.Job instance at 0x7fc04f3728c0>,80,25,[ 3 10],81,-1,261,-1,236
1,<environment.Job instance at 0x7fc04f8bcf00>,0,17,[2 6],1,-1,18,-1,1
1,<environment.Job instance at 0x7fc04f8bc0a0>,1,15,[8 4],2,-1,19,-1,4
1,<environment.Job instance at 0x7fc04f8bc2d0>,3,23,[10  1],4,-1,27,-1,4
1,<environment.Job instance at 0x7fc04f8bc960>,6,28,[6 5],7,-1,35,-1,7
1,<environment.Job instance at 0x7fc04f8bc6e0>,7,18,[5 9],8,-1,26,-1,8
1,<environment.Job instance at 0x7fc04f513500>,14,15,[10  4],15,-1,31,-1,16
1,<environment.Job instance at 0x7fc04f8bc910>,15,18,[11  3],16,-1,34,-1,16
1,<environment.Job instance at 0x7fc04f513870>,22,18,[8 2],23,-1,44,-1,26
1,<environment.Job instance at 0x7fc04f504d70>,27,14,[ 1 10],28,-1,42,-1,28
1,<environment.Job instance at 0x7fc04f504460>,29,16,[9 4],30,-1,46,-1,30
1,<environment.Job instance at 0x7fc04f504550>,30,15,[8 2],31,-1,46,-1,31
1,<environment.Job instance at 0x7fc04f5040f0>,32,25,[6 3],33,-1,58,-1,33
1,<environment.Job instance at 0x7fc04fd04cd0>,34,17,[9 4],35,-1,52,-1,35
1,<environment.Job instance at 0x7fc04fd04370>,35,13,[6 4],36,-1,49,-1,36
1,<environment.Job instance at 0x7fc04fd04870>,38,17,[3 6],39,-1,56,-1,39
1,<environment.Job instance at 0x7fc04fd04f50>,39,15,[ 5 10],40,-1,55,-1,40
1,<environment.Job instance at 0x7fc04f376140>,41,14,[8 2],42,-1,56,-1,42
1,<environment.Job instance at 0x7fc04f376690>,43,20,[2 6],44,-1,64,-1,44
1,<environment.Job instance at 0x7fc04f376c80>,44,15,[5 1],45,-1,60,-1,45
1,<environment.Job instance at 0x7fc04f855640>,50,12,[9 2],51,-1,63,-1,51
1,<environment.Job instance at 0x7fc04f5135f0>,25,17,[4 6],26,-1,68,-1,51
1,<environment.Job instance at 0x7fc04f855b40>,56,15,[2 7],57,-1,72,-1,57
1,<environment.Job instance at 0x7fc04f855aa0>,58,15,[7 5],59,-1,74,-1,59
1,<environment.Job instance at 0x7fc04f49d410>,59,15,[ 3 10],60,-1,75,-1,60
1,<environment.Job instance at 0x7fc04f49da00>,60,24,[2 8],61,-1,85,-1,61
1,<environment.Job instance at 0x7fc04f49d050>,64,23,[10  2],65,-1,114,-1,91
1,<environment.Job instance at 0x7fc04f49d640>,71,17,[10  3],72,-1,150,-1,133
1,<environment.Job instance at 0x7fc04f341af0>,84,18,[3 6],85,-1,152,-1,134
1,<environment.Job instance at 0x7fc04f3411e0>,87,16,[9 4],88,-1,152,-1,136
1,<environment.Job instance at 0x7fc04f49dfa0>,63,24,[10  5],64,-1,160,-1,136
1,<environment.Job instance at 0x7fc04f513a00>,3,23,[10  1],4,-1,40,-1,17
1,<environment.Job instance at 0x7fc04f504230>,6,28,[6 5],7,-1,45,-1,17
1,<environment.Job instance at 0x7fc04f855b90>,11,15,[14  1],12,-1,32,-1,17
1,<environment.Job instance at 0x7fc04f49ddc0>,15,18,[11  3],16,-1,38,-1,20
1,<environment.Job instance at 0x7fc04f3413c0>,19,28,[5 3],20,-1,54,-1,26
1,<environment.Job instance at 0x7fc04f3237d0>,32,25,[6 3],33,-1,88,-1,63
1,<environment.Job instance at 0x7fc04f86abe0>,49,18,[13  1],50,-1,138,-1,120
1,<environment.Job instance at 0x7fc04f789e60>,52,3,[ 3 11],53,-1,125,-1,122
1,<environment.Job instance at 0x7fc050187f50>,60,24,[2 8],61,-1,180,-1,156
1,<environment.Job instance at 0x7fc0504b1dc0>,61,24,[9 1],62,-1,180,-1,156
1,<environment.Job instance at 0x7fc04fdb1c80>,63,24,[10  5],64,-1,183,-1,159
1,<environment.Job instance at 0x7fc05027aaa0>,64,23,[10  2],65,-1,182,-1,159
1,<environment.Job instance at 0x7fc050024af0>,65,15,[ 1 11],66,-1,174,-1,159
1,<environment.Job instance at 0x7fc04fe3ce60>,77,15,[ 3 12],78,-1,221,-1,206
1,<environment.Job instance at 0x7fc05012de60>,0,27,[ 5 10],1,-1,28,-1,1
1,<environment.Job instance at 0x7fc05012d5f0>,1,17,[7 5],2,-1,19,-1,2
1,<environment.Job instance at 0x7fc04fa6db90>,4,15,[4 6],5,-1,20,-1,5
1,<environment.Job instance at 0x7fc04fa6db40>,6,25,[ 5 10],7,-1,32,-1,7
1,<environment.Job instance at 0x7fc04fa58500>,8,18,[1 5],9,-1,27,-1,9
1,<environment.Job instance at 0x7fc04fa618c0>,25,16,[10  4],26,-1,44,-1,28
1,<environment.Job instance at 0x7fc05019baa0>,28,14,[7 5],29,-1,43,-1,29
1,<environment.Job instance at 0x7fc04f6e50a0>,30,18,[9 5],31,-1,49,-1,31
1,<environment.Job instance at 0x7fc05017f1e0>,34,17,[7 2],35,-1,52,-1,35
1,<environment.Job instance at 0x7fc050171140>,36,12,[8 3],37,-1,49,-1,37
1,<environment.Job instance at 0x7fc0501717d0>,37,15,[2 9],38,-1,53,-1,38
1,<environment.Job instance at 0x7fc05018cf50>,39,17,[8 1],40,-1,57,-1,40
1,<environment.Job instance at 0x7fc05017d0a0>,41,17,[2 6],42,-1,59,-1,42
1,<environment.Job instance at 0x7fc05017d140>,42,19,[8 2],43,-1,62,-1,43
1,<environment.Job instance at 0x7fc05017daf0>,48,14,[ 2 10],49,-1,63,-1,49
1,<environment.Job instance at 0x7fc05017df00>,49,17,[9 1],50,-1,67,-1,50
1,<environment.Job instance at 0x7fc05017da50>,50,18,[3 5],51,-1,69,-1,51
1,<environment.Job instance at 0x7fc0501b30a0>,58,14,[4 6],59,-1,73,-1,59
1,<environment.Job instance at 0x7fc0501b31e0>,59,15,[10  2],60,-1,75,-1,60
1,<environment.Job instance at 0x7fc0501b3190>,60,13,[5 6],61,-1,74,-1,61
1,<environment.Job instance at 0x7fc0501b33c0>,62,12,[5 5],63,-1,75,-1,63
1,<environment.Job instance at 0x7fc0501b3550>,63,13,[4 9],64,-1,77,-1,64
1,<environment.Job instance at 0x7fc0501b3640>,65,14,[7 4],66,-1,80,-1,66
1,<environment.Job instance at 0x7fc0501b3a50>,70,16,[10  2],71,-1,87,-1,71
1,<environment.Job instance at 0x7fc0501b3c30>,71,13,[4 5],72,-1,85,-1,72
1,<environment.Job instance at 0x7fc0501b3eb0>,74,21,[7 2],75,-1,96,-1,75
1,<environment.Job instance at 0x7fc0501b04b0>,78,16,[6 3],79,-1,95,-1,79
1,<environment.Job instance at 0x7fc0501b0640>,79,14,[5 7],80,-1,94,-1,80
1,<environment.Job instance at 0x7fc0501b0410>,80,18,[4 7],81,-1,99,-1,81
1,<environment.Job instance at 0x7fc0501b06e0>,81,14,[1 5],82,-1,96,-1,82
1,<environment.Job instance at 0x7fc0501b0820>,83,14,[2 7],84,-1,98,-1,84
1,<environment.Job instance at 0x7fc0501b0dc0>,88,15,[8 5],89,-1,104,-1,89
1,<environment.Job instance at 0x7fc04fa6daa0>,0,27,[ 5 10],1,-1,28,-1,1
1,<environment.Job instance at 0x7fc04fa79af0>,6,25,[ 5 10],7,-1,40,-1,15
1,<environment.Job instance at 0x7fc050117370>,22,17,[12  4],23,-1,61,-1,44
1,<environment.Job instance at 0x7fc04f9ebdc0>,35,2,[ 4 11],36,-1,63,-1,61
1,<environment.Job instance at 0x7fc04fe95eb0>,43,2,[ 2 14],44,-1,94,-1,92
1,<environment.Job instance at 0x7fc050975dc0>,44,17,[ 5 14],45,-1,109,-1,92
1,<environment.Job instance at 0x7fc050187cd0>,46,2,[11  3],47,-1,94,-1,92
1,<environment.Job instance at 0x7fc04f789370>,47,2,[12  2],48,-1,94,-1,92
1,<environment.Job instance at 0x7fc04f86a0a0>,52,2,[12  5],53,-1,126,-1,124
1,<environment.Job instance at 0x7fc04f86acd0>,54,1,[14  4],55,-1,125,-1,124
1,<environment.Job instance at 0x7fc04f3765f0>,73,1,[ 5 12],74,-1,195,-1,194
1,<environment.Job instance at 0x7fc04f855910>,82,14,[ 1 11],83,-1,233,-1,219
1,<environment.Job instance at 0x7fc04fd04230>,84,3,[14  4],85,-1,229,-1,226
1,<environment.Job instance at 0x7fc04f5042d0>,86,2,[13  4],87,-1,230,-1,228
1,<environment.Job instance at 0x7fc050175730>,9,14,[ 5 11],10,-1,25,-1,11
1,<environment.Job instance at 0x7fc050175f00>,16,25,[3 8],17,-1,42,-1,17
1,<environment.Job instance at 0x7fc04f7f6d70>,19,27,[9 3],20,-1,47,-1,20
1,<environment.Job instance at 0x7fc04f7f6140>,20,15,[7 5],21,-1,36,-1,21
1,<environment.Job instance at 0x7fc04f7f62d0>,22,24,[ 3 10],23,-1,47,-1,23
1,<environment.Job instance at 0x7fc04f7f6280>,24,17,[8 5],25,-1,42,-1,25
1,<environment.Job instance at 0x7fc04f6cfaa0>,34,16,[10  3],35,-1,91,-1,75
1,<environment.Job instance at 0x7fc04f6e52d0>,59,19,[9 1],60,-1,152,-1,133
1,<environment.Job instance at 0x7fc04f6cfa50>,42,18,[10  4],43,-1,165,-1,147
1,<environment.Job instance at 0x7fc04f6cfdc0>,5,14,[ 5 12],6,-1,20,-1,6
1,<environment.Job instance at 0x7fc04fb814b0>,7,19,[14  4],8,-1,27,-1,8
1,<environment.Job instance at 0x7fc04fb52460>,9,14,[ 5 11],10,-1,24,-1,10
1,<environment.Job instance at 0x7fc04fb85b90>,16,25,[3 8],17,-1,53,-1,28
1,<environment.Job instance at 0x7fc0502034b0>,18,3,[ 5 14],19,-1,31,-1,28
1,<environment.Job instance at 0x7fc04f454e10>,19,27,[9 3],20,-1,55,-1,28
1,<environment.Job instance at 0x7fc05019bfa0>,22,24,[ 3 10],23,-1,57,-1,33
1,<environment.Job instance at 0x7fc05019bd70>,27,12,[ 2 12],28,-1,48,-1,36
1,<environment.Job instance at 0x7fc0501b36e0>,28,27,[1 7],29,-1,65,-1,38
1,<environment.Job instance at 0x7fc050784820>,45,2,[14  5],46,-1,107,-1,105
1,<environment.Job instance at 0x7fc058ea5230>,63,27,[1 8],64,-1,198,-1,171
1,<environment.Job instance at 0x7fc05081c3c0>,83,3,[ 3 14],84,-1,250,-1,247
1,<environment.Job instance at 0x7fc05081c280>,85,25,[6 3],86,-1,276,-1,251
1,<environment.Job instance at 0x7fc04f855320>,2,16,[9 2],3,-1,20,-1,4
1,<environment.Job instance at 0x7fc04f7100f0>,3,15,[6 3],4,-1,20,-1,5
1,<environment.Job instance at 0x7fc04f4bafa0>,5,18,[7 5],6,-1,24,-1,6
1,<environment.Job instance at 0x7fc04f6a4dc0>,8,17,[10  3],9,-1,27,-1,10
1,<environment.Job instance at 0x7fc04f6a4d70>,10,1,[6 3],11,-1,12,-1,11
1,<environment.Job instance at 0x7fc04f495e60>,11,22,[ 1 10],12,-1,34,-1,12
1,<environment.Job instance at 0x7fc04f495dc0>,12,18,[5 1],13,-1,31,-1,13
1,<environment.Job instance at 0x7fc04f495230>,13,2,[5 6],14,-1,16,-1,14
1,<environment.Job instance at 0x7fc04f495be0>,14,2,[2 5],15,-1,17,-1,15
1,<environment.Job instance at 0x7fc04f495aa0>,15,3,[6 5],16,-1,19,-1,16
1,<environment.Job instance at 0x7fc04f4a2960>,16,3,[8 2],17,-1,20,-1,17
1,<environment.Job instance at 0x7fc04f4a2aa0>,17,13,[7 3],18,-1,31,-1,18
1,<environment.Job instance at 0x7fc04fc1d190>,18,20,[6 2],19,-1,39,-1,19
1,<environment.Job instance at 0x7fc04f93ea00>,19,15,[ 1 10],20,-1,35,-1,20
1,<environment.Job instance at 0x7fc04f93e8c0>,20,14,[3 6],21,-1,35,-1,21
1,<environment.Job instance at 0x7fc04f93e410>,21,1,[8 5],22,-1,23,-1,22
1,<environment.Job instance at 0x7fc0504eae10>,22,15,[1 6],23,-1,38,-1,23
1,<environment.Job instance at 0x7fc0504ea050>,23,2,[5 5],24,-1,26,-1,24
1,<environment.Job instance at 0x7fc04f4ba190>,9,27,[ 5 10],10,-1,51,-1,24
1,<environment.Job instance at 0x7fc04f497870>,27,18,[1 7],28,-1,46,-1,28
1,<environment.Job instance at 0x7fc04f497910>,29,14,[10  1],30,-1,46,-1,32
1,<environment.Job instance at 0x7fc04f497be0>,32,18,[5 5],33,-1,51,-1,33
1,<environment.Job instance at 0x7fc0504bef50>,35,15,[7 4],36,-1,51,-1,36
1,<environment.Job instance at 0x7fc04fc34320>,37,14,[6 2],38,-1,52,-1,38
1,<environment.Job instance at 0x7fc04f62ed20>,38,21,[5 8],39,-1,60,-1,39
1,<environment.Job instance at 0x7fc04f4a95a0>,39,17,[7 2],40,-1,57,-1,40
1,<environment.Job instance at 0x7fc04f625190>,40,12,[8 1],41,-1,53,-1,41
1,<environment.Job instance at 0x7fc0504cc410>,41,28,[2 8],42,-1,70,-1,42
1,<environment.Job instance at 0x7fc0504cc7d0>,42,18,[5 1],43,-1,61,-1,43
1,<environment.Job instance at 0x7fc04f4b0320>,43,27,[9 3],44,-1,71,-1,44
1,<environment.Job instance at 0x7fc050741230>,46,28,[1 7],47,-1,75,-1,47
1,<environment.Job instance at 0x7fc0504c10a0>,47,12,[ 4 10],48,-1,60,-1,48
1,<environment.Job instance at 0x7fc04fc16190>,56,28,[9 2],57,-1,85,-1,57
1,<environment.Job instance at 0x7fc04fc16c30>,59,17,[1 5],60,-1,77,-1,60
1,<environment.Job instance at 0x7fc04fc16b40>,61,13,[1 7],62,-1,75,-1,62
1,<environment.Job instance at 0x7fc04fc2b730>,62,13,[4 8],63,-1,76,-1,63
1,<environment.Job instance at 0x7fc04fc2bd70>,68,15,[ 3 11],69,-1,84,-1,69
1,<environment.Job instance at 0x7fc04fc2bc80>,70,14,[6 4],71,-1,85,-1,71
1,<environment.Job instance at 0x7fc04f6e9410>,74,15,[9 1],75,-1,90,-1,75
1,<environment.Job instance at 0x7fc04f4972d0>,31,14,[10  4],32,-1,90,-1,76
1,<environment.Job instance at 0x7fc04f6e95a0>,76,23,[7 4],77,-1,102,-1,79
1,<environment.Job instance at 0x7fc04f6e97d0>,79,14,[3 7],80,-1,94,-1,80
1,<environment.Job instance at 0x7fc04f6e9780>,80,15,[9 4],81,-1,96,-1,81
1,<environment.Job instance at 0x7fc04f6e9b90>,83,20,[5 4],84,-1,104,-1,84
1,<environment.Job instance at 0x7fc050741460>,0,2,[ 5 11],1,-1,3,-1,1
1,<environment.Job instance at 0x7fc04f767910>,9,27,[ 5 10],10,-1,46,-1,19
1,<environment.Job instance at 0x7fc04f855140>,26,13,[11  1],27,-1,68,-1,55
1,<environment.Job instance at 0x7fc0502155f0>,28,12,[ 5 12],29,-1,67,-1,55
1,<environment.Job instance at 0x7fc04fc8de60>,41,28,[2 8],42,-1,150,-1,122
1,<environment.Job instance at 0x7fc04fb522d0>,43,27,[9 3],44,-1,166,-1,139
1,<environment.Job instance at 0x7fc05015a190>,46,28,[1 7],47,-1,167,-1,139
1,<environment.Job instance at 0x7fc04fcd4cd0>,49,2,[ 4 11],50,-1,149,-1,147
1,<environment.Job instance at 0x7fc04fbd20f0>,54,3,[11  1],55,-1,155,-1,152
1,<environment.Job instance at 0x7fc04fdf1690>,56,28,[9 2],57,-1,184,-1,156
1,<environment.Job instance at 0x7fc04f4c6b40>,67,3,[ 1 12],68,-1,181,-1,178
1,<environment.Job instance at 0x7fc05010bc30>,68,15,[ 3 11],69,-1,193,-1,178
1,<environment.Job instance at 0x7fc04f835730>,75,15,[ 2 11],76,-1,213,-1,198
1,<environment.Job instance at 0x7fc0500e6500>,76,23,[7 4],77,-1,224,-1,201
1,<environment.Job instance at 0x7fc058f361e0>,4,15,[10  3],5,-1,21,-1,6
1,<environment.Job instance at 0x7fc058f36be0>,6,21,[6 5],7,-1,28,-1,7
1,<environment.Job instance at 0x7fc058f366e0>,7,13,[9 4],8,-1,21,-1,8
1,<environment.Job instance at 0x7fc058f36190>,9,17,[5 9],10,-1,27,-1,10
1,<environment.Job instance at 0x7fc058f367d0>,10,15,[4 5],11,-1,26,-1,11
1,<environment.Job instance at 0x7fc058f36fa0>,11,27,[5 1],12,-1,39,-1,12
1,<environment.Job instance at 0x7fc058f36640>,12,21,[1 6],13,-1,34,-1,13
1,<environment.Job instance at 0x7fc058f36d20>,13,17,[8 5],14,-1,31,-1,14
1,<environment.Job instance at 0x7fc058f36af0>,15,16,[4 5],16,-1,32,-1,16
1,<environment.Job instance at 0x7fc058f36f50>,16,25,[8 3],17,-1,42,-1,17
1,<environment.Job instance at 0x7fc04febec30>,18,16,[ 5 10],19,-1,35,-1,19
1,<environment.Job instance at 0x7fc04febe870>,19,18,[7 3],20,-1,38,-1,20
1,<environment.Job instance at 0x7fc04febe4b0>,20,16,[9 2],21,-1,37,-1,21
1,<environment.Job instance at 0x7fc04febe730>,21,19,[10  1],22,-1,41,-1,22
1,<environment.Job instance at 0x7fc04febee10>,26,25,[ 5 10],27,-1,52,-1,27
1,<environment.Job instance at 0x7fc04febe5a0>,32,18,[5 9],33,-1,51,-1,33
1,<environment.Job instance at 0x7fc04febe140>,33,16,[6 5],34,-1,50,-1,34
1,<environment.Job instance at 0x7fc05044aa50>,37,17,[5 2],38,-1,55,-1,38
1,<environment.Job instance at 0x7fc05044aeb0>,38,18,[1 9],39,-1,57,-1,39
1,<environment.Job instance at 0x7fc05044ad70>,40,15,[3 9],41,-1,56,-1,41
1,<environment.Job instance at 0x7fc04fb6db90>,44,17,[9 5],45,-1,62,-1,45
1,<environment.Job instance at 0x7fc04fb6d7d0>,45,16,[5 3],46,-1,62,-1,46
1,<environment.Job instance at 0x7fc04fb6d460>,48,14,[9 4],49,-1,63,-1,49
1,<environment.Job instance at 0x7fc04fb6d0a0>,50,26,[6 3],51,-1,77,-1,51
1,<environment.Job instance at 0x7fc04fb6daf0>,51,14,[4 6],52,-1,66,-1,52
1,<environment.Job instance at 0x7fc04fb6d730>,52,17,[ 2 11],53,-1,70,-1,53
1,<environment.Job instance at 0x7fc04fb6d6e0>,55,23,[7 1],56,-1,81,-1,58
1,<environment.Job instance at 0x7fc050372be0>,61,17,[10  4],62,-1,79,-1,62
1,<environment.Job instance at 0x7fc0503727d0>,65,18,[10  3],66,-1,84,-1,66
1,<environment.Job instance at 0x7fc050372c30>,57,17,[4 9],58,-1,100,-1,83
1,<environment.Job instance at 0x7fc0503987d0>,5,20,[4 7],6,-1,103,-1,83
1,<environment.Job instance at 0x7fc04febe410>,0,16,[14  3],1,-1,17,-1,1
1,<environment.Job instance at 0x7fc050372d20>,11,27,[5 1],12,-1,53,-1,26
1,<environment.Job instance at 0x7fc058eaf730>,17,13,[13  1],18,-1,43,-1,30
1,<environment.Job instance at 0x7fc050352be0>,16,25,[8 3],17,-1,70,-1,45
1,<environment.Job instance at 0x7fc04ffd5af0>,26,25,[ 5 10],27,-1,112,-1,87
1,<environment.Job instance at 0x7fc04ffecbe0>,46,2,[13  5],47,-1,134,-1,132
1,<environment.Job instance at 0x7fc04fb5e5a0>,50,26,[6 3],51,-1,181,-1,155
1,<environment.Job instance at 0x7fc04fb5ea50>,52,17,[ 2 11],53,-1,172,-1,155
1,<environment.Job instance at 0x7fc04fb5eeb0>,55,23,[7 1],56,-1,185,-1,162
1,<environment.Job instance at 0x7fc04fb5e460>,63,12,[ 1 14],64,-1,195,-1,183
1,<environment.Job instance at 0x7fc04fb5e7d0>,66,13,[13  3],67,-1,214,-1,201
1,<environment.Job instance at 0x7fc04f995910>,68,1,[ 3 14],69,-1,215,-1,214
1,<environment.Job instance at 0x7fc04f995fa0>,81,14,[ 3 14],82,-1,277,-1,263
1,<environment.Job instance at 0x7fc04f9959b0>,85,13,[ 1 12],86,-1,287,-1,274
1,<environment.Job instance at 0x7fc04f995d70>,86,17,[11  2],87,-1,291,-1,274
1,<environment.Job instance at 0x7fc04f1d81e0>,0,28,[5 6],1,-1,29,-1,1
1,<environment.Job instance at 0x7fc04f1d8230>,4,17,[6 5],5,-1,23,-1,6
1,<environment.Job instance at 0x7fc04f1d8910>,5,23,[5 3],6,-1,29,-1,6
1,<environment.Job instance at 0x7fc04f1d8960>,7,16,[ 5 10],8,-1,27,-1,11
1,<environment.Job instance at 0x7fc04f1d8460>,12,16,[9 4],13,-1,33,-1,17
1,<environment.Job instance at 0x7fc04f1d8e60>,17,14,[4 7],18,-1,32,-1,18
1,<environment.Job instance at 0x7fc04f1d6960>,27,18,[10  5],28,-1,56,-1,38
1,<environment.Job instance at 0x7fc04f1d6500>,33,15,[7 2],34,-1,100,-1,85
1,<environment.Job instance at 0x7fc04f0d05f0>,43,15,[10  4],44,-1,100,-1,85
1,<environment.Job instance at 0x7fc04f0d0aa0>,50,25,[2 8],51,-1,324,-1,299
1,<environment.Job instance at 0x7fc04f68ddc0>,73,18,[ 5 10],74,-1,317,-1,299
1,<environment.Job instance at 0x7fc04f6f5730>,87,16,[1 5],88,-1,315,-1,299
1,<environment.Job instance at 0x7fc04f1d8d70>,0,28,[5 6],1,-1,29,-1,1
1,<environment.Job instance at 0x7fc0501c3280>,3,28,[ 1 11],4,-1,32,-1,4
1,<environment.Job instance at 0x7fc04fd9e8c0>,5,23,[5 3],6,-1,29,-1,6
1,<environment.Job instance at 0x7fc04f68d190>,6,14,[13  5],7,-1,21,-1,7
1,<environment.Job instance at 0x7fc0593c4c30>,10,13,[12  5],11,-1,24,-1,11
1,<environment.Job instance at 0x7fc0509a89b0>,18,15,[ 3 13],19,-1,39,-1,24
1,<environment.Job instance at 0x7fc04f995370>,26,18,[ 3 13],27,-1,74,-1,56
1,<environment.Job instance at 0x7fc04fe6cb40>,37,2,[ 4 14],38,-1,92,-1,90
1,<environment.Job instance at 0x7fc04f86f6e0>,44,2,[ 1 12],45,-1,108,-1,106
1,<environment.Job instance at 0x7fc0508ef2d0>,50,25,[2 8],51,-1,165,-1,140
1,<environment.Job instance at 0x7fc0508eff50>,54,3,[ 3 14],55,-1,156,-1,153
1,<environment.Job instance at 0x7fc0508f9910>,59,2,[13  5],60,-1,182,-1,180
1,<environment.Job instance at 0x7fc0505225a0>,68,1,[ 3 12],69,-1,221,-1,220
1,<environment.Job instance at 0x7fc050532a00>,85,18,[14  2],86,-1,323,-1,305
1,<environment.Job instance at 0x7fc058f355f0>,0,13,[9 3],1,-1,15,-1,2
1,<environment.Job instance at 0x7fc0503af730>,1,16,[2 7],2,-1,18,-1,2
1,<environment.Job instance at 0x7fc0504cf410>,2,15,[3 8],3,-1,19,-1,4
1,<environment.Job instance at 0x7fc0504cfe60>,4,13,[5 4],5,-1,18,-1,5
1,<environment.Job instance at 0x7fc0504cfc80>,5,15,[9 1],6,-1,21,-1,6
1,<environment.Job instance at 0x7fc0504cf820>,3,13,[6 5],4,-1,19,-1,6
1,<environment.Job instance at 0x7fc0504cf2d0>,10,16,[2 8],11,-1,29,-1,13
1,<environment.Job instance at 0x7fc0591361e0>,13,17,[6 4],14,-1,31,-1,14
1,<environment.Job instance at 0x7fc050496cd0>,15,16,[1 6],16,-1,32,-1,16
1,<environment.Job instance at 0x7fc050496550>,21,18,[9 3],22,-1,45,-1,27
1,<environment.Job instance at 0x7fc0504965a0>,29,16,[ 3 10],30,-1,46,-1,30
1,<environment.Job instance at 0x7fc04fa54b90>,31,13,[ 3 10],32,-1,45,-1,32
1,<environment.Job instance at 0x7fc050496f50>,28,16,[2 7],29,-1,49,-1,33
1,<environment.Job instance at 0x7fc04fa54820>,32,18,[5 8],33,-1,52,-1,34
1,<environment.Job instance at 0x7fc04fa54d70>,35,23,[8 2],36,-1,60,-1,37
1,<environment.Job instance at 0x7fc04fa54140>,40,16,[5 9],41,-1,57,-1,41
1,<environment.Job instance at 0x7fc04fa54370>,41,15,[9 5],42,-1,57,-1,42
1,<environment.Job instance at 0x7fc050538b40>,43,18,[ 2 11],44,-1,62,-1,44
1,<environment.Job instance at 0x7fc0505386e0>,42,14,[9 1],43,-1,61,-1,47
1,<environment.Job instance at 0x7fc0504969b0>,26,22,[ 4 10],27,-1,74,-1,52
1,<environment.Job instance at 0x7fc0505388c0>,50,18,[5 8],51,-1,70,-1,52
1,<environment.Job instance at 0x7fc050538be0>,51,17,[3 7],52,-1,69,-1,52
1,<environment.Job instance at 0x7fc050496eb0>,17,14,[12  5],18,-1,67,-1,53
1,<environment.Job instance at 0x7fc050538a00>,52,23,[7 1],53,-1,76,-1,53
1,<environment.Job instance at 0x7fc0505389b0>,49,16,[ 4 10],50,-1,69,-1,53
1,<environment.Job instance at 0x7fc0505dd960>,54,14,[10  1],55,-1,73,-1,59
1,<environment.Job instance at 0x7fc0505dda50>,62,13,[14  4],63,-1,80,-1,67
1,<environment.Job instance at 0x7fc0505dde60>,63,16,[8 2],64,-1,84,-1,68
1,<environment.Job instance at 0x7fc0505dd370>,60,15,[4 9],61,-1,83,-1,68
1,<environment.Job instance at 0x7fc0505dd9b0>,61,15,[7 5],62,-1,83,-1,68
1,<environment.Job instance at 0x7fc0505dd5a0>,66,17,[9 3],67,-1,87,-1,70
1,<environment.Job instance at 0x7fc050133f00>,70,15,[9 1],71,-1,92,-1,77
1,<environment.Job instance at 0x7fc050133b40>,69,15,[5 6],70,-1,92,-1,77
1,<environment.Job instance at 0x7fc050133cd0>,74,18,[1 8],75,-1,95,-1,77
1,<environment.Job instance at 0x7fc050133690>,75,13,[4 7],76,-1,91,-1,78
1,<environment.Job instance at 0x7fc050133320>,78,18,[5 8],79,-1,97,-1,79
1,<environment.Job instance at 0x7fc050133190>,80,20,[9 5],81,-1,108,-1,88
1,<environment.Job instance at 0x7fc050496c80>,7,25,[9 4],8,-1,43,-1,18
1,<environment.Job instance at 0x7fc0505dd190>,11,3,[ 4 12],12,-1,23,-1,20
1,<environment.Job instance at 0x7fc0504cf550>,16,16,[14  3],17,-1,49,-1,33
1,<environment.Job instance at 0x7fc050532be0>,17,14,[12  5],18,-1,47,-1,33
1,<environment.Job instance at 0x7fc050516a00>,24,25,[7 4],25,-1,81,-1,56
1,<environment.Job instance at 0x7fc050511b90>,35,23,[8 2],36,-1,123,-1,100
1,<environment.Job instance at 0x7fc0508f96e0>,43,18,[ 2 11],44,-1,142,-1,124
1,<environment.Job instance at 0x7fc0508ef910>,45,3,[11  2],46,-1,134,-1,131
1,<environment.Job instance at 0x7fc0508e6960>,52,23,[7 1],53,-1,188,-1,165
1,<environment.Job instance at 0x7fc04f316fa0>,55,3,[13  2],56,-1,184,-1,181
1,<environment.Job instance at 0x7fc04fe6cb40>,58,1,[13  4],59,-1,184,-1,183
1,<environment.Job instance at 0x7fc0504155a0>,62,13,[14  4],63,-1,211,-1,198
1,<environment.Job instance at 0x7fc04f1d8d70>,71,23,[ 3 13],72,-1,255,-1,232
1,<environment.Job instance at 0x7fc058f42370>,1,18,[3 7],2,-1,20,-1,2
1,<environment.Job instance at 0x7fc04fe6dc80>,2,17,[1 9],3,-1,20,-1,3
1,<environment.Job instance at 0x7fc04f6f56e0>,4,22,[9 5],5,-1,27,-1,5
1,<environment.Job instance at 0x7fc050735fa0>,7,16,[5 8],8,-1,24,-1,8
1,<environment.Job instance at 0x7fc04f48c0a0>,8,16,[1 6],9,-1,25,-1,9
1,<environment.Job instance at 0x7fc04ffa95a0>,13,15,[4 9],14,-1,30,-1,15
1,<environment.Job instance at 0x7fc04f5c7190>,15,12,[ 3 10],16,-1,28,-1,16
1,<environment.Job instance at 0x7fc04f5c7500>,16,12,[9 4],17,-1,29,-1,17
1,<environment.Job instance at 0x7fc04f5c7910>,18,12,[10  1],19,-1,31,-1,19
1,<environment.Job instance at 0x7fc04f5c75a0>,19,21,[1 7],20,-1,41,-1,20
1,<environment.Job instance at 0x7fc04f5c7690>,20,16,[9 2],21,-1,37,-1,21
1,<environment.Job instance at 0x7fc050229690>,26,12,[6 4],27,-1,39,-1,27
1,<environment.Job instance at 0x7fc04fdfbaa0>,27,17,[8 2],28,-1,45,-1,28
1,<environment.Job instance at 0x7fc04fdfbf50>,28,17,[1 6],29,-1,46,-1,29
1,<environment.Job instance at 0x7fc04fdfbb40>,29,17,[9 2],30,-1,47,-1,30
1,<environment.Job instance at 0x7fc04fdfbb90>,32,15,[2 9],33,-1,48,-1,33
1,<environment.Job instance at 0x7fc04ffe3a00>,37,16,[3 5],38,-1,54,-1,38
1,<environment.Job instance at 0x7fc050540820>,43,18,[ 2 10],44,-1,62,-1,44
1,<environment.Job instance at 0x7fc050540140>,44,17,[8 3],45,-1,62,-1,45
1,<environment.Job instance at 0x7fc0505403c0>,47,17,[7 4],48,-1,65,-1,48
1,<environment.Job instance at 0x7fc058f14320>,49,16,[10  5],50,-1,66,-1,50
1,<environment.Job instance at 0x7fc04f31cfa0>,51,16,[5 3],52,-1,68,-1,52
1,<environment.Job instance at 0x7fc04fc34e10>,55,17,[ 2 10],56,-1,73,-1,56
1,<environment.Job instance at 0x7fc04fc25690>,58,19,[7 1],59,-1,78,-1,59
1,<environment.Job instance at 0x7fc050037870>,60,18,[9 2],61,-1,79,-1,61
1,<environment.Job instance at 0x7fc05014c190>,70,27,[7 4],71,-1,155,-1,128
1,<environment.Job instance at 0x7fc04f6e97d0>,80,25,[ 1 14],81,-1,153,-1,128
1,<environment.Job instance at 0x7fc050229870>,5,3,[ 1 14],6,-1,9,-1,6
1,<environment.Job instance at 0x7fc04ffe32d0>,10,13,[11  4],11,-1,31,-1,18
1,<environment.Job instance at 0x7fc04f617690>,11,12,[ 1 13],12,-1,30,-1,18
1,<environment.Job instance at 0x7fc04f6c3910>,22,17,[ 2 14],23,-1,77,-1,60
1,<environment.Job instance at 0x7fc04f1d83c0>,35,16,[11  3],36,-1,124,-1,108
1,<environment.Job instance at 0x7fc0508f7410>,46,1,[11  2],47,-1,131,-1,130
1,<environment.Job instance at 0x7fc0505118c0>,67,14,[11  2],68,-1,225,-1,211
1,<environment.Job instance at 0x7fc0505225a0>,68,15,[ 3 14],69,-1,226,-1,211
1,<environment.Job instance at 0x7fc0508e5960>,70,27,[7 4],71,-1,241,-1,214
1,<environment.Job instance at 0x7fc0504fb2d0>,75,2,[ 1 12],76,-1,228,-1,226
1,<environment.Job instance at 0x7fc0504ff140>,80,25,[ 1 14],81,-1,278,-1,253
1,<environment.Job instance at 0x7fc0504cf870>,83,1,[ 4 13],84,-1,268,-1,267
1,<environment.Job instance at 0x7fc050532be0>,85,3,[ 4 11],86,-1,281,-1,278
1,<environment.Job instance at 0x7fc050492320>,1,13,[9 4],2,-1,16,-1,3
1,<environment.Job instance at 0x7fc050492960>,3,13,[3 7],4,-1,17,-1,4
1,<environment.Job instance at 0x7fc04f09d9b0>,4,15,[6 4],5,-1,20,-1,5
1,<environment.Job instance at 0x7fc04f09d320>,7,16,[7 2],8,-1,24,-1,8
1,<environment.Job instance at 0x7fc04fb41e60>,12,14,[9 3],13,-1,27,-1,13
1,<environment.Job instance at 0x7fc050492a50>,2,16,[1 7],3,-1,29,-1,13
1,<environment.Job instance at 0x7fc04fb416e0>,16,16,[4 9],17,-1,33,-1,17
1,<environment.Job instance at 0x7fc04fb418c0>,20,12,[5 9],21,-1,33,-1,21
1,<environment.Job instance at 0x7fc04fb41820>,21,18,[5 9],22,-1,40,-1,22
1,<environment.Job instance at 0x7fc04fb41fa0>,25,17,[10  3],26,-1,43,-1,26
1,<environment.Job instance at 0x7fc0503515f0>,27,16,[8 4],28,-1,44,-1,28
1,<environment.Job instance at 0x7fc050351e10>,28,14,[6 3],29,-1,43,-1,29
1,<environment.Job instance at 0x7fc050351910>,30,17,[8 4],31,-1,48,-1,31
1,<environment.Job instance at 0x7fc0503516e0>,31,14,[ 5 10],32,-1,46,-1,32
1,<environment.Job instance at 0x7fc050351230>,32,19,[8 3],33,-1,52,-1,33
1,<environment.Job instance at 0x7fc050351a50>,33,13,[8 3],34,-1,47,-1,34
1,<environment.Job instance at 0x7fc050351410>,34,17,[8 5],35,-1,52,-1,35
1,<environment.Job instance at 0x7fc050351c30>,36,23,[5 5],37,-1,60,-1,37
1,<environment.Job instance at 0x7fc050351730>,38,14,[9 5],39,-1,53,-1,39
1,<environment.Job instance at 0x7fc04f16ab40>,39,25,[7 3],40,-1,65,-1,40
1,<environment.Job instance at 0x7fc04f16abe0>,43,17,[6 4],44,-1,61,-1,44
1,<environment.Job instance at 0x7fc04f16aeb0>,44,17,[4 7],45,-1,62,-1,45
1,<environment.Job instance at 0x7fc04f16a280>,46,13,[10  5],47,-1,61,-1,48
1,<environment.Job instance at 0x7fc04f16ac30>,48,12,[5 1],49,-1,61,-1,49
1,<environment.Job instance at 0x7fc04f16a6e0>,52,14,[10  1],53,-1,67,-1,53
1,<environment.Job instance at 0x7fc04f481320>,54,15,[8 1],55,-1,70,-1,55
1,<environment.Job instance at 0x7fc04f481a50>,55,14,[5 7],56,-1,70,-1,56
1,<environment.Job instance at 0x7fc04f481550>,57,15,[3 9],58,-1,73,-1,58
1,<environment.Job instance at 0x7fc04f4815f0>,58,15,[ 4 10],59,-1,74,-1,59
1,<environment.Job instance at 0x7fc04f481820>,60,18,[5 4],61,-1,79,-1,61
1,<environment.Job instance at 0x7fc04f4811e0>,62,19,[6 2],63,-1,82,-1,63
1,<environment.Job instance at 0x7fc04f6ce730>,68,18,[ 4 10],69,-1,87,-1,69
1,<environment.Job instance at 0x7fc04f6cee60>,69,13,[7 2],70,-1,83,-1,70
1,<environment.Job instance at 0x7fc04f6ceb40>,73,16,[3 8],74,-1,90,-1,74
1,<environment.Job instance at 0x7fc04f6ce190>,74,16,[9 2],75,-1,93,-1,77
1,<environment.Job instance at 0x7fc050685320>,77,18,[5 5],78,-1,96,-1,78
1,<environment.Job instance at 0x7fc050685500>,83,18,[4 5],84,-1,102,-1,84
1,<environment.Job instance at 0x7fc050685a50>,84,15,[3 5],85,-1,100,-1,85
1,<environment.Job instance at 0x7fc0506854b0>,85,18,[5 8],86,-1,104,-1,86
1,<environment.Job instance at 0x7fc0506856e0>,86,18,[3 9],87,-1,105,-1,87
1,<environment.Job instance at 0x7fc04f16a730>,8,3,[11  1],9,-1,12,-1,9
1,<environment.Job instance at 0x7fc050345a50>,36,23,[5 5],37,-1,140,-1,117
1,<environment.Job instance at 0x7fc04fd59500>,39,25,[7 3],40,-1,157,-1,132
1,<environment.Job instance at 0x7fc04fd59eb0>,40,1,[12  5],41,-1,133,-1,132
1,<environment.Job instance at 0x7fc05038ccd0>,51,3,[ 3 11],52,-1,175,-1,172
1,<environment.Job instance at 0x7fc0508115f0>,65,3,[14  4],66,-1,235,-1,232
1,<environment.Job instance at 0x7fc050811f00>,66,17,[ 1 13],67,-1,249,-1,232
1,<environment.Job instance at 0x7fc050811410>,67,18,[ 3 12],68,-1,250,-1,232
1,<environment.Job instance at 0x7fc050811960>,71,2,[11  4],72,-1,235,-1,233
1,<environment.Job instance at 0x7fc050811a00>,78,22,[ 1 13],79,-1,285,-1,263
1,<environment.Job instance at 0x7fc0502134b0>,88,2,[11  2],89,-1,310,-1,308
1,<environment.Job instance at 0x7fc04f575c30>,5,16,[6 5],6,-1,22,-1,6
1,<environment.Job instance at 0x7fc04f575c80>,6,12,[ 1 10],7,-1,20,-1,8
1,<environment.Job instance at 0x7fc04f575af0>,7,18,[9 4],8,-1,26,-1,8
1,<environment.Job instance at 0x7fc04f5753c0>,8,15,[1 8],9,-1,27,-1,12
1,<environment.Job instance at 0x7fc050377e60>,19,18,[1 9],20,-1,38,-1,20
1,<environment.Job instance at 0x7fc050377af0>,21,14,[6 1],22,-1,38,-1,24
1,<environment.Job instance at 0x7fc0503772d0>,23,14,[4 8],24,-1,38,-1,24
1,<environment.Job instance at 0x7fc050377690>,24,17,[3 7],25,-1,42,-1,25
1,<environment.Job instance at 0x7fc050377cd0>,26,14,[7 5],27,-1,44,-1,30
1,<environment.Job instance at 0x7fc050377aa0>,30,18,[5 5],31,-1,49,-1,31
1,<environment.Job instance at 0x7fc04f7adb40>,31,14,[ 1 10],32,-1,46,-1,32
1,<environment.Job instance at 0x7fc04f7adf50>,33,18,[5 2],34,-1,52,-1,34
1,<environment.Job instance at 0x7fc04f7ad870>,34,16,[7 5],35,-1,51,-1,35
1,<environment.Job instance at 0x7fc04f7adaf0>,36,12,[8 3],37,-1,49,-1,37
1,<environment.Job instance at 0x7fc04f648f00>,44,15,[10  2],45,-1,60,-1,45
1,<environment.Job instance at 0x7fc04f648d70>,45,20,[10  3],46,-1,66,-1,46
1,<environment.Job instance at 0x7fc04f6485a0>,52,18,[9 2],53,-1,71,-1,53
1,<environment.Job instance at 0x7fc04f648b90>,54,14,[5 9],55,-1,69,-1,55
1,<environment.Job instance at 0x7fc04f648780>,57,23,[6 1],58,-1,81,-1,58
1,<environment.Job instance at 0x7fc04f575280>,10,15,[5 1],11,-1,80,-1,65
1,<environment.Job instance at 0x7fc04fb7e5f0>,65,12,[8 3],66,-1,78,-1,66
1,<environment.Job instance at 0x7fc04fb7e8c0>,66,18,[ 2 10],67,-1,85,-1,67
1,<environment.Job instance at 0x7fc050377f50>,29,18,[2 9],30,-1,85,-1,67
1,<environment.Job instance at 0x7fc04fb7e410>,67,17,[5 5],68,-1,86,-1,69
1,<environment.Job instance at 0x7fc04fb7eaa0>,69,14,[8 5],70,-1,84,-1,70
1,<environment.Job instance at 0x7fc04fb7ed70>,70,25,[9 4],71,-1,96,-1,71
1,<environment.Job instance at 0x7fc04fb7e1e0>,71,15,[7 3],72,-1,87,-1,72
1,<environment.Job instance at 0x7fc04fb7e460>,72,17,[1 5],73,-1,90,-1,73
1,<environment.Job instance at 0x7fc04fb7ef00>,74,28,[ 5 10],75,-1,103,-1,75
1,<environment.Job instance at 0x7fc04feb6aa0>,77,27,[2 9],78,-1,105,-1,78
1,<environment.Job instance at 0x7fc04feb66e0>,78,26,[4 9],79,-1,105,-1,79
1,<environment.Job instance at 0x7fc04feb60a0>,80,18,[5 4],81,-1,99,-1,81
1,<environment.Job instance at 0x7fc04feb6a50>,81,14,[8 4],82,-1,96,-1,82
1,<environment.Job instance at 0x7fc04f616140>,86,16,[ 5 12],87,-1,106,-1,90
1,<environment.Job instance at 0x7fc04f6168c0>,88,19,[2 7],89,-1,109,-1,90
1,<environment.Job instance at 0x7fc050377140>,2,13,[14  2],3,-1,16,-1,3
1,<environment.Job instance at 0x7fc04f575370>,20,2,[ 4 14],21,-1,46,-1,44
1,<environment.Job instance at 0x7fc04fb410f0>,43,17,[14  2],44,-1,157,-1,140
1,<environment.Job instance at 0x7fc04f616230>,56,2,[ 5 12],57,-1,164,-1,162
1,<environment.Job instance at 0x7fc04f616730>,57,23,[6 1],58,-1,188,-1,165
1,<environment.Job instance at 0x7fc04fb4dc30>,70,25,[9 4],71,-1,243,-1,218
1,<environment.Job instance at 0x7fc04fb4d280>,74,28,[ 5 10],75,-1,263,-1,235
1,<environment.Job instance at 0x7fc04fb4d140>,77,27,[2 9],78,-1,263,-1,236
1,<environment.Job instance at 0x7fc04fb4d190>,78,26,[4 9],79,-1,262,-1,236
1,<environment.Job instance at 0x7fc04fb6a410>,86,16,[ 5 12],87,-1,285,-1,269
1,<environment.Job instance at 0x7fc05021db40>,2,22,[5 4],3,-1,25,-1,3
1,<environment.Job instance at 0x7fc05021d6e0>,6,18,[1 5],7,-1,25,-1,7
1,<environment.Job instance at 0x7fc0507244b0>,8,17,[7 5],9,-1,26,-1,9
1,<environment.Job instance at 0x7fc050724b40>,10,17,[10  1],11,-1,28,-1,11
1,<environment.Job instance at 0x7fc050724af0>,11,16,[2 5],12,-1,28,-1,12
1,<environment.Job instance at 0x7fc0507246e0>,12,15,[2 5],13,-1,28,-1,13
1,<environment.Job instance at 0x7fc050724320>,13,16,[1 5],14,-1,30,-1,14
1,<environment.Job instance at 0x7fc050724140>,15,15,[5 4],16,-1,31,-1,16
1,<environment.Job instance at 0x7fc0507240a0>,17,26,[10  5],18,-1,45,-1,19
1,<environment.Job instance at 0x7fc050724d70>,19,16,[5 6],20,-1,36,-1,20
1,<environment.Job instance at 0x7fc050724fa0>,20,18,[4 5],21,-1,39,-1,21
1,<environment.Job instance at 0x7fc050724e60>,21,18,[4 9],22,-1,40,-1,22
1,<environment.Job instance at 0x7fc0501f2140>,23,13,[9 3],24,-1,38,-1,25
1,<environment.Job instance at 0x7fc0501f22d0>,24,19,[2 5],25,-1,44,-1,25
1,<environment.Job instance at 0x7fc0501f2280>,25,14,[ 3 10],26,-1,40,-1,26
1,<environment.Job instance at 0x7fc0501f2500>,28,12,[1 9],29,-1,42,-1,30
1,<environment.Job instance at 0x7fc0501f2870>,31,2,[7 1],32,-1,34,-1,32
1,<environment.Job instance at 0x7fc0501f2aa0>,34,22,[1 8],35,-1,58,-1,36
1,<environment.Job instance at 0x7fc0501f2b40>,35,18,[ 2 10],36,-1,56,-1,38
1,<environment.Job instance at 0x7fc05021c410>,43,17,[ 4 10],44,-1,71,-1,54
1,<environment.Job instance at 0x7fc05021ca50>,50,13,[10  5],51,-1,67,-1,54
1,<environment.Job instance at 0x7fc05021cc80>,52,22,[5 3],53,-1,76,-1,54
1,<environment.Job instance at 0x7fc05021c140>,45,15,[8 3],46,-1,70,-1,55
1,<environment.Job instance at 0x7fc05021ce60>,57,24,[2 8],58,-1,87,-1,63
1,<environment.Job instance at 0x7fc0501ee550>,62,15,[1 6],63,-1,79,-1,64
1,<environment.Job instance at 0x7fc0501f2a00>,33,23,[1 7],34,-1,87,-1,64
1,<environment.Job instance at 0x7fc0501ee320>,63,26,[1 8],64,-1,90,-1,64
1,<environment.Job instance at 0x7fc05021c960>,51,12,[8 2],52,-1,76,-1,64
1,<environment.Job instance at 0x7fc0501ee640>,61,16,[4 9],62,-1,80,-1,64
1,<environment.Job instance at 0x7fc05021cd20>,54,15,[4 7],55,-1,82,-1,67
1,<environment.Job instance at 0x7fc0501eed70>,71,23,[9 4],72,-1,99,-1,76
1,<environment.Job instance at 0x7fc0501eefa0>,74,14,[2 7],75,-1,90,-1,76
1,<environment.Job instance at 0x7fc0501eee10>,72,13,[1 9],73,-1,89,-1,76
1,<environment.Job instance at 0x7fc05020b320>,76,16,[9 3],77,-1,93,-1,77
1,<environment.Job instance at 0x7fc0501ee9b0>,66,18,[7 1],67,-1,107,-1,89
1,<environment.Job instance at 0x7fc0501f2eb0>,39,17,[9 1],40,-1,106,-1,89
1,<environment.Job instance at 0x7fc04fdef500>,80,17,[4 7],81,-1,106,-1,89
1,<environment.Job instance at 0x7fc04fb4d370>,16,17,[ 2 14],17,-1,60,-1,43
1,<environment.Job instance at 0x7fc04f572960>,17,26,[10  5],18,-1,79,-1,53
1,<environment.Job instance at 0x7fc04f6164b0>,33,23,[1 7],34,-1,138,-1,115
1,<environment.Job instance at 0x7fc04f616370>,38,13,[14  3],39,-1,128,-1,115
1,<environment.Job instance at 0x7fc04f5755f0>,42,26,[1 5],43,-1,151,-1,125
1,<environment.Job instance at 0x7fc04f561780>,57,24,[2 8],58,-1,207,-1,183
1,<environment.Job instance at 0x7fc05047bd20>,59,13,[14  2],60,-1,196,-1,183
1,<environment.Job instance at 0x7fc0505dd1e0>,63,26,[1 8],64,-1,231,-1,205
1,<environment.Job instance at 0x7fc04fbadfa0>,69,15,[ 1 14],70,-1,233,-1,218
1,<environment.Job instance at 0x7fc04fbaf7d0>,71,23,[9 4],72,-1,246,-1,223
1,<environment.Job instance at 0x7fc04fdcebe0>,0,18,[3 6],1,-1,19,-1,1
1,<environment.Job instance at 0x7fc04f81e410>,2,16,[1 9],3,-1,19,-1,3
1,<environment.Job instance at 0x7fc04f81e0a0>,4,12,[10  3],5,-1,19,-1,7
1,<environment.Job instance at 0x7fc04f83b1e0>,7,13,[7 1],8,-1,21,-1,8
1,<environment.Job instance at 0x7fc04f83be60>,8,1,[8 3],9,-1,10,-1,9
1,<environment.Job instance at 0x7fc04f83b5f0>,9,12,[4 8],10,-1,22,-1,10
1,<environment.Job instance at 0x7fc04f83bdc0>,10,14,[1 9],11,-1,25,-1,11
1,<environment.Job instance at 0x7fc050907dc0>,12,12,[1 7],13,-1,25,-1,13
1,<environment.Job instance at 0x7fc0502065f0>,6,16,[2 7],7,-1,29,-1,13
1,<environment.Job instance at 0x7fc050907b90>,14,17,[10  5],15,-1,33,-1,16
1,<environment.Job instance at 0x7fc050907e60>,15,15,[1 6],16,-1,32,-1,17
1,<environment.Job instance at 0x7fc05092e5f0>,25,17,[ 5 10],26,-1,44,-1,27
1,<environment.Job instance at 0x7fc0506e5c80>,32,16,[5 3],33,-1,49,-1,33
1,<environment.Job instance at 0x7fc05019ebe0>,33,16,[9 5],34,-1,50,-1,34
1,<environment.Job instance at 0x7fc05019e820>,34,16,[8 5],35,-1,51,-1,35
1,<environment.Job instance at 0x7fc05070bd20>,37,14,[ 5 10],38,-1,52,-1,38
1,<environment.Job instance at 0x7fc05070b460>,39,16,[6 2],40,-1,57,-1,41
1,<environment.Job instance at 0x7fc058f13b40>,42,16,[9 3],43,-1,59,-1,43
1,<environment.Job instance at 0x7fc058f13140>,43,14,[1 6],44,-1,58,-1,44
1,<environment.Job instance at 0x7fc04fefc4b0>,44,16,[7 3],45,-1,61,-1,45
1,<environment.Job instance at 0x7fc04fefce60>,45,22,[5 2],46,-1,68,-1,46
1,<environment.Job instance at 0x7fc0508f8e10>,50,13,[11  3],51,-1,64,-1,51
1,<environment.Job instance at 0x7fc0508f8cd0>,51,28,[7 5],52,-1,80,-1,52
1,<environment.Job instance at 0x7fc050879410>,52,14,[6 1],53,-1,67,-1,53
1,<environment.Job instance at 0x7fc04fcae550>,55,18,[10  4],56,-1,75,-1,57
1,<environment.Job instance at 0x7fc04fcaef00>,57,15,[7 2],58,-1,77,-1,62
1,<environment.Job instance at 0x7fc04f151190>,62,18,[3 6],63,-1,81,-1,63
1,<environment.Job instance at 0x7fc0592a2410>,65,16,[2 7],66,-1,82,-1,66
1,<environment.Job instance at 0x7fc0500812d0>,68,18,[8 3],69,-1,87,-1,69
1,<environment.Job instance at 0x7fc04f639e10>,74,17,[10  3],75,-1,113,-1,96
1,<environment.Job instance at 0x7fc04f408d70>,73,18,[6 3],74,-1,114,-1,96
1,<environment.Job instance at 0x7fc05009d780>,75,18,[ 2 11],76,-1,115,-1,97
1,<environment.Job instance at 0x7fc04fcaec30>,61,18,[4 9],62,-1,120,-1,102
1,<environment.Job instance at 0x7fc05037e9b0>,78,27,[5 1],79,-1,129,-1,102
1,<environment.Job instance at 0x7fc04fcae2d0>,54,26,[7 1],55,-1,128,-1,102
1,<environment.Job instance at 0x7fc04f1515f0>,17,16,[11  5],18,-1,64,-1,48
1,<environment.Job instance at 0x7fc04f616af0>,21,3,[13  1],22,-1,68,-1,65
1,<environment.Job instance at 0x7fc04f311870>,35,1,[ 3 12],36,-1,115,-1,114
1,<environment.Job instance at 0x7fc04f311820>,38,3,[ 5 12],39,-1,122,-1,119
1,<environment.Job instance at 0x7fc050390640>,46,1,[11  1],47,-1,161,-1,160
1,<environment.Job instance at 0x7fc050226140>,50,13,[11  3],51,-1,186,-1,173
1,<environment.Job instance at 0x7fc04f5728c0>,51,28,[7 5],52,-1,202,-1,174
1,<environment.Job instance at 0x7fc04f572f00>,53,2,[14  5],54,-1,176,-1,174
1,<environment.Job instance at 0x7fc04f572640>,54,26,[7 1],55,-1,202,-1,176
1,<environment.Job instance at 0x7fc04f572050>,67,13,[13  4],68,-1,229,-1,216
1,<environment.Job instance at 0x7fc04fdcea00>,71,3,[ 4 12],72,-1,244,-1,241
1,<environment.Job instance at 0x7fc04fdce050>,70,24,[10  5],71,-1,283,-1,259
1,<environment.Job instance at 0x7fc04fc221e0>,75,18,[ 2 11],76,-1,277,-1,259
1,<environment.Job instance at 0x7fc04fc22d20>,76,13,[11  3],77,-1,272,-1,259
1,<environment.Job instance at 0x7fc04fc22960>,78,27,[5 1],79,-1,303,-1,276
1,<environment.Job instance at 0x7fc050492280>,88,27,[1 7],89,-1,325,-1,298
1,<environment.Job instance at 0x7fc04f7ffc80>,10,17,[5 9],11,-1,28,-1,11
1,<environment.Job instance at 0x7fc04f7ffaf0>,11,17,[9 4],12,-1,32,-1,15
1,<environment.Job instance at 0x7fc04f7ffa50>,16,16,[3 8],17,-1,33,-1,17
1,<environment.Job instance at 0x7fc04f7a8910>,17,18,[ 5 10],18,-1,36,-1,18
1,<environment.Job instance at 0x7fc04f7a85a0>,18,15,[1 8],19,-1,34,-1,19
1,<environment.Job instance at 0x7fc04f7a8d20>,20,13,[7 3],21,-1,34,-1,21
1,<environment.Job instance at 0x7fc04f7a86e0>,22,12,[10  2],23,-1,35,-1,23
1,<environment.Job instance at 0x7fc04f7a8410>,24,18,[ 2 10],25,-1,43,-1,25
1,<environment.Job instance at 0x7fc04f7a8280>,25,14,[8 4],26,-1,40,-1,26
1,<environment.Job instance at 0x7fc04f7a8be0>,26,18,[ 2 10],27,-1,45,-1,27
1,<environment.Job instance at 0x7fc04f7a8190>,27,18,[5 9],28,-1,46,-1,28
1,<environment.Job instance at 0x7fc04f7ffeb0>,14,14,[9 5],15,-1,44,-1,30
1,<environment.Job instance at 0x7fc04f7a8460>,30,17,[8 2],31,-1,49,-1,32
1,<environment.Job instance at 0x7fc04f867e60>,38,25,[5 5],39,-1,64,-1,39
1,<environment.Job instance at 0x7fc04f714cd0>,47,16,[3 5],48,-1,70,-1,54
1,<environment.Job instance at 0x7fc04f7142d0>,50,22,[4 6],51,-1,80,-1,58
1,<environment.Job instance at 0x7fc04f714050>,51,2,[1 8],52,-1,60,-1,58
1,<environment.Job instance at 0x7fc04f714230>,52,18,[5 6],53,-1,77,-1,59
1,<environment.Job instance at 0x7fc04f714730>,49,16,[8 5],50,-1,76,-1,60
1,<environment.Job instance at 0x7fc04f3a40a0>,45,14,[5 9],46,-1,74,-1,60
1,<environment.Job instance at 0x7fc04f8672d0>,41,15,[ 1 12],42,-1,75,-1,60
1,<environment.Job instance at 0x7fc04fdcf550>,55,17,[3 9],56,-1,77,-1,60
1,<environment.Job instance at 0x7fc04f7149b0>,53,14,[4 8],54,-1,74,-1,60
1,<environment.Job instance at 0x7fc05084ce60>,59,2,[2 5],60,-1,62,-1,60
1,<environment.Job instance at 0x7fc04f7147d0>,54,18,[10  2],55,-1,80,-1,62
1,<environment.Job instance at 0x7fc05047b280>,58,12,[10  5],59,-1,74,-1,62
1,<environment.Job instance at 0x7fc04f714320>,48,17,[2 7],49,-1,80,-1,63
1,<environment.Job instance at 0x7fc04fdce320>,6,1,[14  4],7,-1,8,-1,7
1,<environment.Job instance at 0x7fc04fdce730>,7,17,[13  5],8,-1,25,-1,8
1,<environment.Job instance at 0x7fc04f5bdd70>,38,25,[5 5],39,-1,152,-1,127
1,<environment.Job instance at 0x7fc0501a8410>,40,18,[14  5],41,-1,145,-1,127
1,<environment.Job instance at 0x7fc04f60c370>,41,15,[ 1 12],42,-1,142,-1,127
1,<environment.Job instance at 0x7fc04ff1a4b0>,62,17,[ 3 14],63,-1,245,-1,228
1,<environment.Job instance at 0x7fc04f70ccd0>,65,16,[ 4 12],66,-1,248,-1,232
1,<environment.Job instance at 0x7fc050095730>,68,18,[13  3],69,-1,260,-1,242
1,<environment.Job instance at 0x7fc050095410>,69,1,[ 4 14],70,-1,243,-1,242
1,<environment.Job instance at 0x7fc04f6edfa0>,72,16,[14  1],73,-1,263,-1,247
1,<environment.Job instance at 0x7fc0505c3f50>,75,1,[ 5 13],76,-1,261,-1,260
1,<environment.Job instance at 0x7fc0504aceb0>,83,3,[ 5 11],84,-1,294,-1,291
1,<environment.Job instance at 0x7fc05042e190>,8,18,[ 4 12],9,-1,27,-1,9
1,<environment.Job instance at 0x7fc05042e820>,10,12,[10  4],11,-1,24,-1,12
1,<environment.Job instance at 0x7fc04fef8b40>,12,18,[ 5 10],13,-1,31,-1,13
1,<environment.Job instance at 0x7fc05020fbe0>,16,16,[ 5 10],17,-1,33,-1,17
1,<environment.Job instance at 0x7fc05042e9b0>,11,12,[4 5],12,-1,29,-1,17
1,<environment.Job instance at 0x7fc04f9aaeb0>,20,1,[7 1],21,-1,22,-1,21
1,<environment.Job instance at 0x7fc05038cd20>,21,2,[2 6],22,-1,24,-1,22
1,<environment.Job instance at 0x7fc0508a37d0>,22,20,[5 2],23,-1,43,-1,23
1,<environment.Job instance at 0x7fc0508a3370>,23,14,[1 8],24,-1,38,-1,24
1,<environment.Job instance at 0x7fc0508a39b0>,24,12,[3 9],25,-1,37,-1,25
1,<environment.Job instance at 0x7fc04f75cc80>,36,20,[4 9],37,-1,57,-1,37
1,<environment.Job instance at 0x7fc0504d2b40>,43,21,[5 7],44,-1,65,-1,44
1,<environment.Job instance at 0x7fc0504d2730>,44,14,[10  4],45,-1,59,-1,45
1,<environment.Job instance at 0x7fc0504d2140>,45,17,[4 9],46,-1,63,-1,46
1,<environment.Job instance at 0x7fc0504d2640>,48,2,[12  1],49,-1,51,-1,49
1,<environment.Job instance at 0x7fc04f147c80>,52,19,[4 7],53,-1,81,-1,62
1,<environment.Job instance at 0x7fc04f147aa0>,57,18,[4 7],58,-1,80,-1,62
1,<environment.Job instance at 0x7fc04f147410>,56,19,[9 4],57,-1,81,-1,62
1,<environment.Job instance at 0x7fc04f147eb0>,49,27,[ 5 11],50,-1,89,-1,62
1,<environment.Job instance at 0x7fc04f147370>,58,17,[ 2 12],59,-1,80,-1,63
1,<environment.Job instance at 0x7fc04f147500>,60,26,[9 4],61,-1,90,-1,64
1,<environment.Job instance at 0x7fc04f147cd0>,50,13,[10  1],51,-1,77,-1,64
1,<environment.Job instance at 0x7fc04f1473c0>,61,14,[2 7],62,-1,78,-1,64
1,<environment.Job instance at 0x7fc04fd7ee10>,63,18,[10  5],64,-1,82,-1,64
1,<environment.Job instance at 0x7fc04fd7e3c0>,66,16,[5 2],67,-1,83,-1,67
1,<environment.Job instance at 0x7fc04fd7ee60>,68,24,[8 3],69,-1,93,-1,69
1,<environment.Job instance at 0x7fc04fd7e5a0>,72,15,[ 3 10],73,-1,88,-1,73
1,<environment.Job instance at 0x7fc04fd7edc0>,74,17,[9 5],75,-1,92,-1,75
1,<environment.Job instance at 0x7fc05081a370>,75,14,[2 9],76,-1,91,-1,77
1,<environment.Job instance at 0x7fc05081a190>,77,12,[ 3 10],78,-1,91,-1,79
1,<environment.Job instance at 0x7fc05081a410>,79,19,[2 9],80,-1,99,-1,80
1,<environment.Job instance at 0x7fc0594d8c30>,87,17,[1 7],88,-1,105,-1,88
1,<environment.Job instance at 0x7fc04f6120f0>,1,3,[ 3 11],2,-1,5,-1,2
1,<environment.Job instance at 0x7fc04f31a550>,8,18,[ 4 12],9,-1,27,-1,9
1,<environment.Job instance at 0x7fc04f311dc0>,14,26,[10  2],15,-1,50,-1,24
1,<environment.Job instance at 0x7fc0502ce410>,27,15,[13  3],28,-1,54,-1,39
1,<environment.Job instance at 0x7fc04f32bf50>,41,2,[ 2 13],42,-1,72,-1,70
1,<environment.Job instance at 0x7fc04fdbfa00>,48,2,[12  1],49,-1,98,-1,96
1,<environment.Job instance at 0x7fc059147690>,49,27,[ 5 11],50,-1,123,-1,96
1,<environment.Job instance at 0x7fc04fb06cd0>,53,25,[9 3],54,-1,136,-1,111
1,<environment.Job instance at 0x7fc04fb065a0>,58,17,[ 2 12],59,-1,132,-1,115
1,<environment.Job instance at 0x7fc04f77b6e0>,60,26,[9 4],61,-1,153,-1,127
1,<environment.Job instance at 0x7fc058ea6dc0>,65,14,[13  2],66,-1,155,-1,141
1,<environment.Job instance at 0x7fc050817500>,68,24,[8 3],69,-1,182,-1,158
1,<environment.Job instance at 0x7fc04fadb140>,88,2,[ 4 12],89,-1,230,-1,228
1,<environment.Job instance at 0x7fc04f7040a0>,1,16,[2 6],2,-1,18,-1,2
1,<environment.Job instance at 0x7fc0500816e0>,2,17,[8 1],3,-1,21,-1,4
1,<environment.Job instance at 0x7fc0500811e0>,4,13,[2 5],5,-1,18,-1,5
1,<environment.Job instance at 0x7fc050081320>,5,17,[1 8],6,-1,23,-1,6
1,<environment.Job instance at 0x7fc0509376e0>,13,18,[1 8],14,-1,32,-1,14
1,<environment.Job instance at 0x7fc050937a00>,19,15,[8 4],20,-1,35,-1,20
1,<environment.Job instance at 0x7fc04f83b140>,28,18,[5 6],29,-1,47,-1,29
1,<environment.Job instance at 0x7fc04f83b460>,32,18,[7 3],33,-1,51,-1,33
1,<environment.Job instance at 0x7fc04f83b230>,35,16,[5 7],36,-1,58,-1,42
1,<environment.Job instance at 0x7fc04f83b5f0>,37,16,[3 5],38,-1,60,-1,44
1,<environment.Job instance at 0x7fc04f83b870>,39,23,[5 5],40,-1,67,-1,44
1,<environment.Job instance at 0x7fc04f83be60>,40,17,[8 3],41,-1,61,-1,44
1,<environment.Job instance at 0x7fc050914cd0>,44,17,[5 6],45,-1,72,-1,55
1,<environment.Job instance at 0x7fc050914460>,43,13,[10  3],44,-1,68,-1,55
1,<environment.Job instance at 0x7fc04f717280>,3,26,[2 9],4,-1,81,-1,55
1,<environment.Job instance at 0x7fc050914a50>,47,3,[ 2 13],48,-1,62,-1,59
1,<environment.Job instance at 0x7fc050914050>,53,3,[5 6],54,-1,62,-1,59
1,<environment.Job instance at 0x7fc050914c80>,52,17,[3 8],53,-1,76,-1,59
1,<environment.Job instance at 0x7fc04fd5a280>,57,14,[9 3],58,-1,77,-1,63
1,<environment.Job instance at 0x7fc0509140a0>,56,13,[ 1 10],57,-1,77,-1,64
1,<environment.Job instance at 0x7fc04fd5a550>,59,15,[8 4],60,-1,82,-1,67
1,<environment.Job instance at 0x7fc050914a00>,50,14,[6 1],51,-1,81,-1,67
1,<environment.Job instance at 0x7fc04fd5af50>,62,16,[6 3],63,-1,86,-1,70
1,<environment.Job instance at 0x7fc04fd5a730>,61,15,[3 9],62,-1,86,-1,71
1,<environment.Job instance at 0x7fc04f7e55a0>,71,23,[7 5],72,-1,127,-1,104
1,<environment.Job instance at 0x7fc04f7e5140>,72,28,[8 2],73,-1,133,-1,105
1,<environment.Job instance at 0x7fc050937730>,3,26,[2 9],4,-1,30,-1,4
1,<environment.Job instance at 0x7fc04f83bf50>,6,13,[12  4],7,-1,20,-1,7
1,<environment.Job instance at 0x7fc04fd5a0a0>,11,17,[13  5],12,-1,35,-1,18
1,<environment.Job instance at 0x7fc04f711f00>,39,23,[5 5],40,-1,121,-1,98
1,<environment.Job instance at 0x7fc059147690>,45,24,[7 5],46,-1,153,-1,129
1,<environment.Job instance at 0x7fc04fb065f0>,47,3,[ 2 13],48,-1,132,-1,129
1,<environment.Job instance at 0x7fc04fae2a50>,60,1,[13  2],61,-1,172,-1,171
1,<environment.Job instance at 0x7fc04f5945a0>,63,1,[ 2 13],64,-1,185,-1,184
1,<environment.Job instance at 0x7fc04f2368c0>,66,1,[ 4 11],67,-1,200,-1,199
1,<environment.Job instance at 0x7fc04ff65780>,71,23,[7 5],72,-1,226,-1,203
1,<environment.Job instance at 0x7fc04ff65dc0>,72,28,[8 2],73,-1,243,-1,215
1,<environment.Job instance at 0x7fc04fed1a00>,3,18,[4 9],4,-1,22,-1,4
1,<environment.Job instance at 0x7fc04fed1e10>,4,26,[7 4],5,-1,31,-1,5
1,<environment.Job instance at 0x7fc04f82dcd0>,8,16,[1 8],9,-1,25,-1,9
1,<environment.Job instance at 0x7fc04f82dc80>,9,12,[9 3],10,-1,24,-1,12
1,<environment.Job instance at 0x7fc04f82d3c0>,14,17,[10  4],15,-1,32,-1,15
1,<environment.Job instance at 0x7fc04fdeeb40>,18,16,[14  5],19,-1,35,-1,19
1,<environment.Job instance at 0x7fc04f57eb40>,20,13,[8 3],21,-1,34,-1,21
1,<environment.Job instance at 0x7fc04f172fa0>,21,16,[8 1],22,-1,38,-1,22
1,<environment.Job instance at 0x7fc05090a3c0>,27,19,[4 7],28,-1,47,-1,28
1,<environment.Job instance at 0x7fc0504cc320>,30,17,[2 8],31,-1,48,-1,31
1,<environment.Job instance at 0x7fc0505d4be0>,32,12,[10  3],33,-1,47,-1,35
1,<environment.Job instance at 0x7fc04f310c30>,36,12,[1 9],37,-1,49,-1,37
1,<environment.Job instance at 0x7fc04f310f50>,37,18,[7 1],38,-1,56,-1,38
1,<environment.Job instance at 0x7fc04f310640>,38,16,[10  3],39,-1,55,-1,39
1,<environment.Job instance at 0x7fc04fc98960>,39,15,[9 3],40,-1,55,-1,40
1,<environment.Job instance at 0x7fc04f310c80>,34,16,[6 3],35,-1,57,-1,41
1,<environment.Job instance at 0x7fc0508595f0>,43,16,[4 9],44,-1,60,-1,44
1,<environment.Job instance at 0x7fc0505c89b0>,44,23,[6 5],45,-1,68,-1,45
1,<environment.Job instance at 0x7fc04f38bb40>,61,16,[ 2 10],62,-1,78,-1,62
1,<environment.Job instance at 0x7fc050679140>,63,15,[10  1],64,-1,81,-1,66
1,<environment.Job instance at 0x7fc04f32b9b0>,55,15,[ 5 11],56,-1,90,-1,75
1,<environment.Job instance at 0x7fc050565410>,69,27,[5 9],70,-1,102,-1,75
1,<environment.Job instance at 0x7fc050565cd0>,68,18,[5 6],69,-1,94,-1,76
1,<environment.Job instance at 0x7fc050565f00>,71,12,[8 3],72,-1,88,-1,76
1,<environment.Job instance at 0x7fc04f2d4280>,73,28,[3 5],74,-1,104,-1,76
1,<environment.Job instance at 0x7fc04fe4d870>,74,16,[5 6],75,-1,92,-1,76
1,<environment.Job instance at 0x7fc04f38b960>,60,26,[5 7],61,-1,102,-1,76
1,<environment.Job instance at 0x7fc04fe4dfa0>,75,16,[10  2],76,-1,92,-1,76
1,<environment.Job instance at 0x7fc04fc086e0>,72,26,[ 1 10],73,-1,104,-1,78
1,<environment.Job instance at 0x7fc04f32be10>,53,21,[7 4],54,-1,102,-1,81
1,<environment.Job instance at 0x7fc04f32b500>,52,17,[1 6],53,-1,98,-1,81
1,<environment.Job instance at 0x7fc0502ad370>,79,12,[ 5 10],80,-1,94,-1,82
1,<environment.Job instance at 0x7fc04f2f6280>,86,18,[3 5],87,-1,105,-1,87
1,<environment.Job instance at 0x7fc04f5aaa00>,87,14,[8 3],88,-1,102,-1,88
1,<environment.Job instance at 0x7fc04f875230>,88,14,[7 5],89,-1,103,-1,89
1,<environment.Job instance at 0x7fc05090adc0>,4,26,[7 4],5,-1,31,-1,5
1,<environment.Job instance at 0x7fc0503877d0>,5,1,[12  3],6,-1,7,-1,6
1,<environment.Job instance at 0x7fc04f2f6f50>,18,16,[14  5],19,-1,37,-1,21
1,<environment.Job instance at 0x7fc050879690>,22,14,[ 2 12],23,-1,39,-1,25
1,<environment.Job instance at 0x7fc04f2eacd0>,25,15,[ 2 12],26,-1,52,-1,37
1,<environment.Job instance at 0x7fc04fd5a190>,44,23,[6 5],45,-1,122,-1,99
1,<environment.Job instance at 0x7fc058eecfa0>,55,15,[ 5 11],56,-1,145,-1,130
1,<environment.Job instance at 0x7fc0501a4af0>,60,26,[5 7],61,-1,172,-1,146
1,<environment.Job instance at 0x7fc0503561e0>,69,27,[5 9],70,-1,194,-1,167
1,<environment.Job instance at 0x7fc04f4fc960>,72,26,[ 1 10],73,-1,193,-1,167
1,<environment.Job instance at 0x7fc04fba77d0>,73,28,[3 5],74,-1,195,-1,167
1,<environment.Job instance at 0x7fc04f8b4d70>,2,16,[11  5],3,-1,19,-1,3
1,<environment.Job instance at 0x7fc04f8b4c80>,4,18,[3 8],5,-1,23,-1,5
1,<environment.Job instance at 0x7fc04f8b4f00>,6,14,[3 9],7,-1,21,-1,7
1,<environment.Job instance at 0x7fc04f891460>,10,14,[5 5],11,-1,25,-1,11
1,<environment.Job instance at 0x7fc04f891550>,11,17,[2 9],12,-1,29,-1,12
1,<environment.Job instance at 0x7fc04f8918c0>,16,12,[9 1],17,-1,31,-1,19
1,<environment.Job instance at 0x7fc04f891c30>,19,1,[6 1],20,-1,21,-1,20
1,<environment.Job instance at 0x7fc04f891af0>,20,12,[3 8],21,-1,33,-1,21
1,<environment.Job instance at 0x7fc04f891d20>,21,1,[6 1],22,-1,23,-1,22
1,<environment.Job instance at 0x7fc04f891dc0>,22,2,[ 4 10],23,-1,25,-1,23
1,<environment.Job instance at 0x7fc04f891e60>,23,2,[4 7],24,-1,26,-1,24
1,<environment.Job instance at 0x7fc04f891f00>,24,18,[6 3],25,-1,43,-1,25
1,<environment.Job instance at 0x7fc04f891fa0>,25,23,[7 4],26,-1,49,-1,26
1,<environment.Job instance at 0x7fc04f8c70a0>,26,23,[5 6],27,-1,50,-1,27
1,<environment.Job instance at 0x7fc04f8c7140>,27,16,[2 6],28,-1,44,-1,28
1,<environment.Job instance at 0x7fc04f8c71e0>,28,25,[ 5 10],29,-1,54,-1,29
1,<environment.Job instance at 0x7fc04f8c7280>,29,15,[5 3],30,-1,45,-1,30
1,<environment.Job instance at 0x7fc04f8c7320>,30,17,[6 4],31,-1,48,-1,31
1,<environment.Job instance at 0x7fc04f891910>,18,14,[7 3],19,-1,45,-1,31
1,<environment.Job instance at 0x7fc04f8c7460>,32,18,[9 5],33,-1,52,-1,34
1,<environment.Job instance at 0x7fc04f8c73c0>,33,17,[5 1],34,-1,51,-1,34
1,<environment.Job instance at 0x7fc04f8c75a0>,35,15,[9 5],36,-1,51,-1,36
1,<environment.Job instance at 0x7fc04f88e0a0>,44,17,[5 7],45,-1,62,-1,45
1,<environment.Job instance at 0x7fc04f88ea50>,54,12,[ 4 10],55,-1,68,-1,56
1,<environment.Job instance at 0x7fc04f88ee10>,58,12,[12  2],59,-1,71,-1,59
1,<environment.Job instance at 0x7fc04f88ef00>,59,14,[8 5],60,-1,74,-1,60
1,<environment.Job instance at 0x7fc04f8ba3c0>,62,1,[ 4 10],63,-1,64,-1,63
1,<environment.Job instance at 0x7fc04f88eaa0>,55,15,[8 2],56,-1,79,-1,64
1,<environment.Job instance at 0x7fc04f8ba140>,63,14,[2 9],64,-1,78,-1,64
1,<environment.Job instance at 0x7fc04f8ba320>,61,18,[6 1],62,-1,83,-1,65
1,<environment.Job instance at 0x7fc04f8baaf0>,70,25,[8 3],71,-1,96,-1,71
1,<environment.Job instance at 0x7fc04f8bac80>,71,27,[8 1],72,-1,99,-1,72
1,<environment.Job instance at 0x7fc04f88c140>,76,17,[3 8],77,-1,94,-1,77
1,<environment.Job instance at 0x7fc04f88c2d0>,77,27,[2 6],78,-1,105,-1,78
1,<environment.Job instance at 0x7fc04f88c3c0>,79,18,[5 2],80,-1,98,-1,80
1,<environment.Job instance at 0x7fc04f88c730>,82,13,[9 4],83,-1,96,-1,83
1,<environment.Job instance at 0x7fc04f88c910>,85,18,[5 5],86,-1,104,-1,86
1,<environment.Job instance at 0x7fc04f88cbe0>,86,14,[10  1],87,-1,102,-1,88
1,<environment.Job instance at 0x7fc04f88cd70>,88,14,[3 7],89,-1,103,-1,89
1,<environment.Job instance at 0x7fc04f88caf0>,87,26,[ 5 10],88,-1,115,-1,89
1,<environment.Job instance at 0x7fc04fb544b0>,2,16,[11  5],3,-1,19,-1,3
1,<environment.Job instance at 0x7fc05044ac80>,25,23,[7 4],26,-1,79,-1,56
1,<environment.Job instance at 0x7fc04f170e10>,26,23,[5 6],27,-1,79,-1,56
1,<environment.Job instance at 0x7fc04f4fc3c0>,28,25,[ 5 10],29,-1,87,-1,62
1,<environment.Job instance at 0x7fc04f4fc910>,31,12,[ 5 11],32,-1,82,-1,70
1,<environment.Job instance at 0x7fc0501a40a0>,37,26,[ 2 10],38,-1,134,-1,108
1,<environment.Job instance at 0x7fc050937370>,43,17,[ 5 12],44,-1,137,-1,120
1,<environment.Job instance at 0x7fc04f7e5e10>,57,2,[ 5 11],58,-1,157,-1,155
1,<environment.Job instance at 0x7fc04f7e5a50>,58,12,[12  2],59,-1,167,-1,155
1,<environment.Job instance at 0x7fc04fb06c30>,60,2,[ 4 14],61,-1,158,-1,156
1,<environment.Job instance at 0x7fc04f3115a0>,71,27,[8 1],72,-1,237,-1,210
1,<environment.Job instance at 0x7fc0502f7aa0>,70,25,[8 3],71,-1,235,-1,210
1,<environment.Job instance at 0x7fc04fbc9fa0>,77,27,[2 6],78,-1,243,-1,216
1,<environment.Job instance at 0x7fc04fa197d0>,87,26,[ 5 10],88,-1,267,-1,241
1,<environment.Job instance at 0x7f33d18fa6e0>,0,13,[9 3],1,-1,15,-1,2
1,<environment.Job instance at 0x7f33d18fa8c0>,1,22,[11  3],2,-1,24,-1,2
1,<environment.Job instance at 0x7f33d18fa730>,2,22,[4 8],3,-1,25,-1,3
1,<environment.Job instance at 0x7f33c830afa0>,9,18,[11  5],10,-1,28,-1,10
1,<environment.Job instance at 0x7f33c830d0f0>,11,15,[4 8],12,-1,27,-1,12
1,<environment.Job instance at 0x7f33c830d230>,13,18,[ 4 10],14,-1,32,-1,14
1,<environment.Job instance at 0x7f33c830d460>,15,18,[2 8],16,-1,34,-1,16
1,<environment.Job instance at 0x7f33c830d640>,16,16,[3 5],17,-1,33,-1,17
1,<environment.Job instance at 0x7f33c830d780>,22,1,[2 7],23,-1,24,-1,23
1,<environment.Job instance at 0x7f33c830db90>,23,27,[1 6],24,-1,51,-1,24
1,<environment.Job instance at 0x7f33c830daf0>,24,18,[2 6],25,-1,43,-1,25
1,<environment.Job instance at 0x7f33c830df50>,27,15,[8 4],28,-1,43,-1,28
1,<environment.Job instance at 0x7f33c8310140>,28,23,[10  4],29,-1,52,-1,29
1,<environment.Job instance at 0x7f33c8310050>,29,12,[5 4],30,-1,43,-1,31
1,<environment.Job instance at 0x7f33c8310370>,31,14,[2 5],32,-1,46,-1,32
1,<environment.Job instance at 0x7f33c8310460>,33,14,[5 5],34,-1,48,-1,34
1,<environment.Job instance at 0x7f33c83105f0>,34,24,[1 8],35,-1,59,-1,35
1,<environment.Job instance at 0x7f33c8310500>,35,15,[9 5],36,-1,51,-1,36
1,<environment.Job instance at 0x7f33c8310b40>,40,15,[10  3],41,-1,59,-1,44
1,<environment.Job instance at 0x7f33c8310eb0>,44,3,[5 5],45,-1,48,-1,45
1,<environment.Job instance at 0x7f33c83120a0>,45,13,[6 5],46,-1,59,-1,46
1,<environment.Job instance at 0x7f33c8312280>,48,15,[10  1],49,-1,64,-1,49
1,<environment.Job instance at 0x7f33c83123c0>,49,16,[2 5],50,-1,66,-1,50
1,<environment.Job instance at 0x7f33c8312730>,53,17,[5 7],54,-1,71,-1,54
1,<environment.Job instance at 0x7f33c8312c30>,59,17,[1 6],60,-1,90,-1,73
1,<environment.Job instance at 0x7f33c830d730>,1,22,[11  3],2,-1,24,-1,2
1,<environment.Job instance at 0x7f33c8312e60>,9,18,[11  5],10,-1,32,-1,14
1,<environment.Job instance at 0x7f33d1930780>,12,26,[ 1 10],13,-1,82,-1,56
1,<environment.Job instance at 0x7f33c8301640>,23,27,[1 6],24,-1,87,-1,60
1,<environment.Job instance at 0x7f33c830a870>,28,23,[10  4],29,-1,97,-1,74
1,<environment.Job instance at 0x7f33c842ddc0>,34,24,[1 8],35,-1,117,-1,93
1,<environment.Job instance at 0x7f33c842d4b0>,36,13,[ 3 14],37,-1,106,-1,93
1,<environment.Job instance at 0x7f33c8332190>,46,17,[12  2],47,-1,134,-1,117
1,<environment.Job instance at 0x7f33c8393820>,50,16,[12  2],51,-1,146,-1,130
1,<environment.Job instance at 0x7f33c8431eb0>,54,13,[13  1],55,-1,158,-1,145
1,<environment.Job instance at 0x7f33c83ba3c0>,60,3,[12  3],61,-1,169,-1,166
1,<environment.Job instance at 0x7f33c83baaf0>,67,27,[ 1 10],68,-1,216,-1,189
1,<environment.Job instance at 0x7f33c83bafa0>,69,13,[ 3 12],70,-1,202,-1,189
1,<environment.Job instance at 0x7f33c83b9a50>,75,14,[ 4 11],76,-1,215,-1,201
1,<environment.Job instance at 0x7f33c82e7fa0>,97,2,[ 5 11],98,-1,294,-1,292
1,<environment.Job instance at 0x7f33c7a53c80>,0,18,[2 7],1,-1,19,-1,1
1,<environment.Job instance at 0x7f33c7a53460>,1,18,[ 1 10],2,-1,21,-1,3
1,<environment.Job instance at 0x7f33c7a53fa0>,3,16,[1 6],4,-1,20,-1,4
1,<environment.Job instance at 0x7f33c7a536e0>,4,15,[1 9],5,-1,20,-1,5
1,<environment.Job instance at 0x7f33c7a53e10>,7,17,[9 3],8,-1,25,-1,8
1,<environment.Job instance at 0x7f33c7a56af0>,15,16,[7 5],16,-1,32,-1,16
1,<environment.Job instance at 0x7f33c7a54280>,19,20,[2 6],20,-1,40,-1,20
1,<environment.Job instance at 0x7f33c7a554b0>,30,15,[8 3],31,-1,59,-1,44
1,<environment.Job instance at 0x7f33c7a51b90>,37,20,[9 2],38,-1,64,-1,44
1,<environment.Job instance at 0x7f33c7a51dc0>,38,16,[11  2],39,-1,60,-1,44
1,<environment.Job instance at 0x7f33c7a51c30>,39,18,[ 1 12],40,-1,62,-1,44
1,<environment.Job instance at 0x7f33c7a51aa0>,40,16,[2 8],41,-1,60,-1,44
1,<environment.Job instance at 0x7f33c7a519b0>,41,13,[5 6],42,-1,57,-1,44
1,<environment.Job instance at 0x7f33c78d8640>,43,15,[ 1 12],44,-1,59,-1,44
1,<environment.Job instance at 0x7f33c7920410>,46,17,[1 7],47,-1,66,-1,49
1,<environment.Job instance at 0x7f33c799a0f0>,51,15,[10  4],52,-1,79,-1,64
1,<environment.Job instance at 0x7f33c7a55550>,27,22,[4 5],28,-1,86,-1,64
1,<environment.Job instance at 0x7f33c799a3c0>,52,14,[1 8],53,-1,79,-1,65
1,<environment.Job instance at 0x7f33c78a0280>,90,18,[10  3],91,-1,216,-1,198
1,<environment.Job instance at 0x7f33c78a0dc0>,91,17,[10  2],92,-1,215,-1,198
1,<environment.Job instance at 0x7f33c78a2b90>,5,14,[14  5],6,-1,20,-1,6
1,<environment.Job instance at 0x7f33c789f0a0>,6,15,[11  1],7,-1,22,-1,7
1,<environment.Job instance at 0x7f33c83ba460>,16,3,[ 1 12],17,-1,38,-1,35
1,<environment.Job instance at 0x7f33c7b0e0f0>,22,3,[ 4 12],23,-1,49,-1,46
1,<environment.Job instance at 0x7f33c8310f50>,23,12,[ 4 11],24,-1,58,-1,46
1,<environment.Job instance at 0x7f33c7bb15f0>,28,23,[ 2 14],29,-1,74,-1,51
1,<environment.Job instance at 0x7f33c789fb90>,11,26,[ 5 10],12,-1,77,-1,51
1,<environment.Job instance at 0x7f33c7abbaf0>,38,16,[11  2],39,-1,95,-1,79
1,<environment.Job instance at 0x7f33c7ac3910>,39,18,[ 1 12],40,-1,97,-1,79
1,<environment.Job instance at 0x7f33c7ab3cd0>,43,15,[ 1 12],44,-1,102,-1,87
1,<environment.Job instance at 0x7f33c7b1b230>,45,3,[ 4 13],46,-1,93,-1,90
1,<environment.Job instance at 0x7f33c7b1b050>,47,1,[ 1 14],48,-1,93,-1,92
1,<environment.Job instance at 0x7f33c7ad6f00>,60,3,[13  3],61,-1,147,-1,144
1,<environment.Job instance at 0x7f33c7ad0f00>,65,13,[ 1 14],66,-1,163,-1,150
1,<environment.Job instance at 0x7f33c7c0aa00>,76,2,[11  5],77,-1,174,-1,172
1,<environment.Job instance at 0x7f33c7aa8a00>,78,3,[14  4],79,-1,180,-1,177
1,<environment.Job instance at 0x7f33c7af8140>,98,12,[14  4],99,-1,280,-1,268
1,<environment.Job instance at 0x7f33c78fafa0>,0,13,[10  5],1,-1,15,-1,2
1,<environment.Job instance at 0x7f33c78f5320>,2,14,[2 7],3,-1,17,-1,3
1,<environment.Job instance at 0x7f33c78f5dc0>,3,14,[7 5],4,-1,18,-1,4
1,<environment.Job instance at 0x7f33c78f5870>,5,14,[10  2],6,-1,20,-1,6
1,<environment.Job instance at 0x7f33c78f5910>,14,16,[7 2],15,-1,31,-1,15
1,<environment.Job instance at 0x7f33c78f2690>,16,12,[ 3 10],17,-1,29,-1,17
1,<environment.Job instance at 0x7f33c78f2820>,20,18,[4 5],21,-1,39,-1,21
1,<environment.Job instance at 0x7f33c78f2960>,21,18,[2 8],22,-1,40,-1,22
1,<environment.Job instance at 0x7f33c78f0780>,24,16,[9 4],25,-1,41,-1,25
1,<environment.Job instance at 0x7f33c78f0190>,26,14,[10  1],27,-1,42,-1,28
1,<environment.Job instance at 0x7f33c78f0e10>,28,15,[7 5],29,-1,44,-1,29
1,<environment.Job instance at 0x7f33c78f0320>,29,13,[6 3],30,-1,43,-1,30
1,<environment.Job instance at 0x7f33c78f0c30>,30,13,[7 4],31,-1,44,-1,31
1,<environment.Job instance at 0x7f33c78f0aa0>,32,20,[1 7],33,-1,53,-1,33
1,<environment.Job instance at 0x7f33c78e0b40>,36,19,[2 7],37,-1,56,-1,37
1,<environment.Job instance at 0x7f33c78e0a50>,38,18,[6 3],39,-1,57,-1,39
1,<environment.Job instance at 0x7f33c78e0870>,40,24,[ 1 10],41,-1,65,-1,41
1,<environment.Job instance at 0x7f33c798e0f0>,43,24,[7 4],44,-1,68,-1,44
1,<environment.Job instance at 0x7f33c798e690>,44,16,[7 5],45,-1,61,-1,45
1,<environment.Job instance at 0x7f33c798eaa0>,46,16,[7 4],47,-1,63,-1,47
1,<environment.Job instance at 0x7f33c798ed70>,48,18,[4 6],49,-1,67,-1,49
1,<environment.Job instance at 0x7f33c798eb40>,51,27,[4 7],52,-1,79,-1,52
1,<environment.Job instance at 0x7f33c798e6e0>,52,26,[8 4],53,-1,79,-1,53
1,<environment.Job instance at 0x7f33c798e280>,53,12,[9 1],54,-1,66,-1,54
1,<environment.Job instance at 0x7f33c798eeb0>,54,14,[5 5],55,-1,69,-1,55
1,<environment.Job instance at 0x7f33c798e640>,57,17,[5 2],58,-1,75,-1,58
1,<environment.Job instance at 0x7f33c798e500>,58,18,[4 5],59,-1,77,-1,59
1,<environment.Job instance at 0x7f33c7925820>,60,25,[ 3 10],61,-1,86,-1,61
1,<environment.Job instance at 0x7f33c78f0b90>,27,16,[9 2],28,-1,77,-1,61
1,<environment.Job instance at 0x7f33c7925410>,67,13,[9 2],68,-1,82,-1,69
1,<environment.Job instance at 0x7f33c7925e10>,70,17,[2 6],71,-1,88,-1,71
1,<environment.Job instance at 0x7f33c7925910>,71,15,[8 4],72,-1,87,-1,72
1,<environment.Job instance at 0x7f33c793c550>,77,18,[5 9],78,-1,96,-1,78
1,<environment.Job instance at 0x7f33c7925a50>,68,15,[3 6],69,-1,104,-1,89
1,<environment.Job instance at 0x7f33c7931870>,85,18,[11  3],86,-1,109,-1,91
1,<environment.Job instance at 0x7f33c7931e60>,89,28,[5 3],90,-1,119,-1,91
1,<environment.Job instance at 0x7f33c7931820>,92,18,[8 2],93,-1,111,-1,93
1,<environment.Job instance at 0x7f33c79fa2d0>,95,17,[4 6],96,-1,113,-1,96
1,<environment.Job instance at 0x7f33c7931eb0>,90,18,[6 1],91,-1,116,-1,98
1,<environment.Job instance at 0x7f33c7925fa0>,8,2,[13  1],9,-1,16,-1,14
1,<environment.Job instance at 0x7f33c79256e0>,11,3,[13  5],12,-1,21,-1,18
1,<environment.Job instance at 0x7f33c7931550>,12,2,[ 1 12],13,-1,20,-1,18
1,<environment.Job instance at 0x7f33d1a45e10>,22,1,[ 4 13],23,-1,37,-1,36
1,<environment.Job instance at 0x7f33c8a88d70>,23,14,[11  3],24,-1,50,-1,36
1,<environment.Job instance at 0x7f33c8949780>,40,24,[ 1 10],41,-1,127,-1,103
1,<environment.Job instance at 0x7f33c7c1c190>,43,24,[7 4],44,-1,131,-1,107
1,<environment.Job instance at 0x7f33c7b76910>,45,3,[12  3],46,-1,110,-1,107
1,<environment.Job instance at 0x7f33c7b78050>,51,27,[4 7],52,-1,165,-1,138
1,<environment.Job instance at 0x7f33c7b78190>,52,26,[8 4],53,-1,164,-1,138
1,<environment.Job instance at 0x7f33c7c27f00>,55,16,[14  1],56,-1,157,-1,141
1,<environment.Job instance at 0x7f33c86a5320>,60,25,[ 3 10],61,-1,186,-1,161
1,<environment.Job instance at 0x7f33c7d4cb90>,73,23,[10  1],74,-1,225,-1,202
1,<environment.Job instance at 0x7f33c7d4cfa0>,76,28,[6 5],77,-1,232,-1,204
1,<environment.Job instance at 0x7f33c7c9c230>,81,15,[14  1],82,-1,234,-1,219
1,<environment.Job instance at 0x7f33c7c0deb0>,85,18,[11  3],86,-1,242,-1,224
1,<environment.Job instance at 0x7f33c7c0d230>,89,28,[5 3],90,-1,258,-1,230
1,<environment.Job instance at 0x7f33c7f9b730>,2,25,[6 3],3,-1,28,-1,3
1,<environment.Job instance at 0x7f33c7f9ba00>,4,17,[9 4],5,-1,23,-1,6
1,<environment.Job instance at 0x7f33c7f9b2d0>,5,13,[6 4],6,-1,20,-1,7
1,<environment.Job instance at 0x7f33c7f9bc30>,8,17,[3 6],9,-1,26,-1,9
1,<environment.Job instance at 0x7f33c7f9b4b0>,9,15,[ 5 10],10,-1,25,-1,10
1,<environment.Job instance at 0x7f33c89b9780>,13,20,[2 6],14,-1,34,-1,14
1,<environment.Job instance at 0x7f33c89b93c0>,24,12,[5 9],25,-1,37,-1,25
1,<environment.Job instance at 0x7f33c8806a50>,28,15,[7 5],29,-1,44,-1,29
1,<environment.Job instance at 0x7f33c8806870>,29,15,[ 3 10],30,-1,45,-1,30
1,<environment.Job instance at 0x7f33c88065a0>,30,24,[2 8],31,-1,55,-1,31
1,<environment.Job instance at 0x7f33c8806f00>,31,24,[9 1],32,-1,56,-1,32
1,<environment.Job instance at 0x7f33c88068c0>,32,3,[7 1],33,-1,36,-1,33
1,<environment.Job instance at 0x7f33c8806a00>,33,24,[10  5],34,-1,58,-1,34
1,<environment.Job instance at 0x7f33c8806730>,34,23,[10  2],35,-1,58,-1,35
1,<environment.Job instance at 0x7f33c8806d70>,35,15,[ 1 11],36,-1,51,-1,36
1,<environment.Job instance at 0x7f33c8806e60>,36,16,[ 5 10],37,-1,53,-1,37
1,<environment.Job instance at 0x7f33c8806500>,39,13,[4 6],40,-1,53,-1,40
1,<environment.Job instance at 0x7f33c8899230>,41,17,[10  3],42,-1,59,-1,42
1,<environment.Job instance at 0x7f33c8899460>,42,13,[1 6],43,-1,56,-1,43
1,<environment.Job instance at 0x7f33c8899320>,44,14,[1 5],45,-1,59,-1,45
1,<environment.Job instance at 0x7f33c886a0f0>,45,12,[ 4 10],46,-1,58,-1,46
1,<environment.Job instance at 0x7f33c886a6e0>,50,14,[8 3],51,-1,65,-1,51
1,<environment.Job instance at 0x7f33c886abe0>,54,18,[3 6],55,-1,73,-1,55
1,<environment.Job instance at 0x7f33c886afa0>,56,16,[9 2],57,-1,74,-1,58
1,<environment.Job instance at 0x7f33c886a370>,57,16,[9 4],58,-1,74,-1,58
1,<environment.Job instance at 0x7f33c871a910>,61,17,[7 5],62,-1,81,-1,64
1,<environment.Job instance at 0x7f33c871ac30>,64,15,[4 6],65,-1,80,-1,65
1,<environment.Job instance at 0x7f33c871a1e0>,66,25,[ 5 10],67,-1,92,-1,67
1,<environment.Job instance at 0x7f33c871aa50>,67,15,[5 3],68,-1,83,-1,68
1,<environment.Job instance at 0x7f33c871a5f0>,68,18,[1 5],69,-1,87,-1,69
1,<environment.Job instance at 0x7f33d1a6faa0>,80,14,[7 5],81,-1,95,-1,81
1,<environment.Job instance at 0x7f33c8750cd0>,85,16,[10  4],86,-1,113,-1,97
1,<environment.Job instance at 0x7f33c88066e0>,2,25,[6 3],3,-1,30,-1,5
1,<environment.Job instance at 0x7f33c7f9b5f0>,19,18,[13  1],20,-1,48,-1,30
1,<environment.Job instance at 0x7f33c7d4cc80>,22,3,[ 3 11],23,-1,34,-1,31
1,<environment.Job instance at 0x7f33c7c610a0>,30,24,[2 8],31,-1,84,-1,60
1,<environment.Job instance at 0x7f33c7c61d20>,31,24,[9 1],32,-1,97,-1,73
1,<environment.Job instance at 0x7f33c7c61910>,33,24,[10  5],34,-1,97,-1,73
1,<environment.Job instance at 0x7f33c7c27f50>,34,23,[10  2],35,-1,96,-1,73
1,<environment.Job instance at 0x7f33c7c27320>,35,15,[ 1 11],36,-1,88,-1,73
1,<environment.Job instance at 0x7f33c8e8f5a0>,47,15,[ 3 12],48,-1,117,-1,102
1,<environment.Job instance at 0x7f33c78f58c0>,60,27,[ 5 10],61,-1,197,-1,170
1,<environment.Job instance at 0x7f33c8a54fa0>,66,25,[ 5 10],67,-1,216,-1,191
1,<environment.Job instance at 0x7f33c8490140>,82,17,[12  4],83,-1,239,-1,222
1,<environment.Job instance at 0x7f33c87ad370>,95,2,[ 4 11],96,-1,259,-1,257
1,<environment.Job instance at 0x7f33c82f5230>,1,17,[2 6],2,-1,19,-1,2
1,<environment.Job instance at 0x7f33c80f0320>,2,19,[8 2],3,-1,24,-1,5
1,<environment.Job instance at 0x7f33c870cf00>,4,17,[ 5 14],5,-1,22,-1,5
1,<environment.Job instance at 0x7f33c80edf50>,9,17,[9 1],10,-1,28,-1,11
1,<environment.Job instance at 0x7f33c80ed910>,10,18,[3 5],11,-1,30,-1,12
1,<environment.Job instance at 0x7f33c80f7d20>,18,14,[4 6],19,-1,34,-1,20
1,<environment.Job instance at 0x7f33c80f70f0>,19,15,[10  2],20,-1,35,-1,20
1,<environment.Job instance at 0x7f33c810d410>,21,12,[5 5],22,-1,34,-1,22
1,<environment.Job instance at 0x7f33c810d3c0>,22,12,[5 5],23,-1,35,-1,23
1,<environment.Job instance at 0x7f33c810d5f0>,23,13,[4 9],24,-1,37,-1,24
1,<environment.Job instance at 0x7f33c7c76be0>,30,16,[10  2],31,-1,47,-1,31
1,<environment.Job instance at 0x7f33c8e1cfa0>,34,21,[7 2],35,-1,56,-1,35
1,<environment.Job instance at 0x7f33c8e24e60>,35,12,[ 1 10],36,-1,48,-1,36
1,<environment.Job instance at 0x7f33c8e4acd0>,38,16,[6 3],39,-1,55,-1,39
1,<environment.Job instance at 0x7f33c7feeaa0>,39,14,[5 7],40,-1,54,-1,40
1,<environment.Job instance at 0x7f33c7feea00>,40,18,[4 7],41,-1,59,-1,41
1,<environment.Job instance at 0x7f33c7fee230>,41,14,[1 5],42,-1,57,-1,43
1,<environment.Job instance at 0x7f33c8e4f640>,43,14,[2 7],44,-1,58,-1,44
1,<environment.Job instance at 0x7f33c8e4fd20>,48,15,[8 5],49,-1,64,-1,49
1,<environment.Job instance at 0x7f33c8e4faf0>,49,27,[1 5],50,-1,77,-1,50
1,<environment.Job instance at 0x7f33c80101e0>,55,14,[ 5 12],56,-1,70,-1,56
1,<environment.Job instance at 0x7f33c8010280>,56,18,[4 6],57,-1,75,-1,57
1,<environment.Job instance at 0x7f33c80103c0>,58,17,[7 4],59,-1,76,-1,59
1,<environment.Job instance at 0x7f33c8e4ad20>,42,14,[ 1 11],43,-1,73,-1,59
1,<environment.Job instance at 0x7f33c80102d0>,59,14,[ 5 11],60,-1,74,-1,60
1,<environment.Job instance at 0x7f33c8010730>,62,18,[6 3],63,-1,81,-1,63
1,<environment.Job instance at 0x7f33c8010aa0>,65,16,[6 3],66,-1,82,-1,66
1,<environment.Job instance at 0x7f33c8010be0>,66,25,[3 8],67,-1,92,-1,67
1,<environment.Job instance at 0x7f33c8010f50>,70,15,[7 5],71,-1,88,-1,73
1,<environment.Job instance at 0x7f33c801b1e0>,73,1,[3 5],74,-1,75,-1,74
1,<environment.Job instance at 0x7f33c801b140>,74,17,[8 5],75,-1,92,-1,75
1,<environment.Job instance at 0x7f33c801b190>,72,24,[ 3 10],73,-1,100,-1,76
1,<environment.Job instance at 0x7f33c801b910>,84,16,[10  3],85,-1,113,-1,97
1,<environment.Job instance at 0x7f33c801bb40>,85,3,[1 5],86,-1,100,-1,97
1,<environment.Job instance at 0x7f33c801bdc0>,87,13,[6 4],88,-1,110,-1,97
1,<environment.Job instance at 0x7f33c801bcd0>,88,14,[10  3],89,-1,111,-1,97
1,<environment.Job instance at 0x7f33c801b3c0>,78,27,[1 7],79,-1,124,-1,97
1,<environment.Job instance at 0x7f33c801bf50>,91,18,[2 9],92,-1,118,-1,100
1,<environment.Job instance at 0x7f33c801bf00>,92,18,[10  4],93,-1,119,-1,101
1,<environment.Job instance at 0x7f33c801bfa0>,90,19,[1 5],91,-1,120,-1,101
1,<environment.Job instance at 0x7f33c7fe7050>,93,13,[6 5],94,-1,114,-1,101
1,<environment.Job instance at 0x7f33c7fe75a0>,97,18,[5 1],98,-1,119,-1,101
1,<environment.Job instance at 0x7f33c80100f0>,57,19,[14  4],58,-1,120,-1,101
1,<environment.Job instance at 0x7f33c8e38050>,3,2,[ 2 14],4,-1,6,-1,4
1,<environment.Job instance at 0x7f33c810d500>,4,17,[ 5 14],5,-1,22,-1,5
1,<environment.Job instance at 0x7f33c8e24a00>,6,2,[11  3],7,-1,9,-1,7
1,<environment.Job instance at 0x7f33c8e4ac30>,7,2,[12  2],8,-1,10,-1,8
1,<environment.Job instance at 0x7f33c8e2a410>,12,2,[12  5],13,-1,15,-1,13
1,<environment.Job instance at 0x7f33c8010780>,14,1,[14  4],15,-1,16,-1,15
1,<environment.Job instance at 0x7f33c838b320>,33,1,[ 5 12],34,-1,81,-1,80
1,<environment.Job instance at 0x7f33c8427460>,42,14,[ 1 11],43,-1,126,-1,112
1,<environment.Job instance at 0x7f33c836ba00>,44,3,[14  4],45,-1,115,-1,112
1,<environment.Job instance at 0x7f33c83c7910>,46,2,[13  4],47,-1,119,-1,117
1,<environment.Job instance at 0x7f33c78f58c0>,49,27,[1 5],50,-1,155,-1,128
1,<environment.Job instance at 0x7f33c8e8f5a0>,55,14,[ 5 12],56,-1,149,-1,135
1,<environment.Job instance at 0x7f33c871a320>,57,19,[14  4],58,-1,155,-1,136
1,<environment.Job instance at 0x7f33c881de10>,59,14,[ 5 11],60,-1,150,-1,136
1,<environment.Job instance at 0x7f33c89dea00>,66,25,[3 8],67,-1,204,-1,179
1,<environment.Job instance at 0x7f33c7d50960>,68,3,[ 5 14],69,-1,182,-1,179
1,<environment.Job instance at 0x7f33c7d50050>,69,27,[9 3],70,-1,208,-1,181
1,<environment.Job instance at 0x7f33c7c27f50>,72,24,[ 3 10],73,-1,213,-1,189
1,<environment.Job instance at 0x7f33c7d4c690>,77,12,[ 2 12],78,-1,207,-1,195
1,<environment.Job instance at 0x7f33c7d4c4b0>,78,27,[1 7],79,-1,224,-1,197
1,<environment.Job instance at 0x7f33c886ab90>,95,2,[14  5],96,-1,267,-1,265
1,<environment.Job instance at 0x7f33c875dd70>,3,18,[5 9],4,-1,22,-1,4
1,<environment.Job instance at 0x7f33c875dc30>,5,21,[2 5],6,-1,27,-1,6
1,<environment.Job instance at 0x7f33c875d960>,8,14,[5 9],9,-1,23,-1,9
1,<environment.Job instance at 0x7f33c875dfa0>,9,19,[9 1],10,-1,29,-1,10
1,<environment.Job instance at 0x7f33c7a0b0f0>,11,16,[6 5],12,-1,28,-1,12
1,<environment.Job instance at 0x7f33c8728e10>,16,14,[3 9],17,-1,33,-1,19
1,<environment.Job instance at 0x7f33c87289b0>,19,13,[5 9],20,-1,35,-1,22
1,<environment.Job instance at 0x7f33c8728050>,21,18,[8 4],22,-1,40,-1,22
1,<environment.Job instance at 0x7f33c7d26fa0>,24,17,[3 9],25,-1,42,-1,25
1,<environment.Job instance at 0x7f33c7d26500>,25,13,[10  4],26,-1,40,-1,27
1,<environment.Job instance at 0x7f33c7d26050>,27,22,[1 7],28,-1,50,-1,28
1,<environment.Job instance at 0x7f33c7d26370>,29,15,[7 1],30,-1,45,-1,30
1,<environment.Job instance at 0x7f33c7d1f500>,30,14,[6 4],31,-1,45,-1,31
1,<environment.Job instance at 0x7f33c7d1f6e0>,31,18,[3 6],32,-1,50,-1,32
1,<environment.Job instance at 0x7f33c7d1f9b0>,32,1,[9 3],33,-1,34,-1,33
1,<environment.Job instance at 0x7f33c7d1f780>,34,14,[7 1],35,-1,49,-1,35
1,<environment.Job instance at 0x7f33c7d1f8c0>,35,25,[6 3],36,-1,61,-1,36
1,<environment.Job instance at 0x7f33c7d26690>,26,16,[5 5],27,-1,53,-1,37
1,<environment.Job instance at 0x7f33c7d1fbe0>,38,16,[8 5],39,-1,56,-1,40
1,<environment.Job instance at 0x7f33c7d1ffa0>,39,18,[7 5],40,-1,58,-1,40
1,<environment.Job instance at 0x7f33c7d1f2d0>,42,16,[9 2],43,-1,59,-1,43
1,<environment.Job instance at 0x7f33c7d1f280>,43,15,[6 3],44,-1,59,-1,44
1,<environment.Job instance at 0x7f33c7d1fa50>,45,18,[7 5],46,-1,64,-1,46
1,<environment.Job instance at 0x7f33c79e4c30>,48,17,[10  3],49,-1,67,-1,50
1,<environment.Job instance at 0x7f33c79e4be0>,50,1,[6 3],51,-1,52,-1,51
1,<environment.Job instance at 0x7f33c79e4e10>,51,22,[ 1 10],52,-1,74,-1,52
1,<environment.Job instance at 0x7f33c79e4820>,52,18,[5 1],53,-1,71,-1,53
1,<environment.Job instance at 0x7f33c79e4870>,53,2,[5 6],54,-1,56,-1,54
1,<environment.Job instance at 0x7f33c79e49b0>,54,2,[2 5],55,-1,57,-1,55
1,<environment.Job instance at 0x7f33c79e4910>,55,3,[6 5],56,-1,59,-1,56
1,<environment.Job instance at 0x7f33c79e4a50>,56,3,[8 2],57,-1,60,-1,57
1,<environment.Job instance at 0x7f33c79e4780>,57,13,[7 3],58,-1,71,-1,58
1,<environment.Job instance at 0x7f33c79e4730>,49,27,[ 5 10],50,-1,85,-1,58
1,<environment.Job instance at 0x7f33c79e4cd0>,59,15,[ 1 10],60,-1,76,-1,61
1,<environment.Job instance at 0x7f33c79e4af0>,62,15,[1 6],63,-1,78,-1,63
1,<environment.Job instance at 0x7f33c870b280>,65,17,[7 1],66,-1,83,-1,66
1,<environment.Job instance at 0x7f33c870b460>,67,18,[1 7],68,-1,86,-1,68
1,<environment.Job instance at 0x7f33c870b3c0>,69,14,[10  1],70,-1,86,-1,72
1,<environment.Job instance at 0x7f33c870bb40>,72,18,[5 5],73,-1,91,-1,73
1,<environment.Job instance at 0x7f33c870b8c0>,74,12,[8 4],75,-1,87,-1,75
1,<environment.Job instance at 0x7f33c870b820>,75,15,[7 4],76,-1,91,-1,76
1,<environment.Job instance at 0x7f33c870bfa0>,78,21,[5 8],79,-1,100,-1,79
1,<environment.Job instance at 0x7f33c8703b40>,79,17,[7 2],80,-1,97,-1,80
1,<environment.Job instance at 0x7f33c8703370>,81,28,[2 8],82,-1,110,-1,82
1,<environment.Job instance at 0x7f33c8703050>,82,18,[5 1],83,-1,101,-1,83
1,<environment.Job instance at 0x7f33c8703eb0>,83,27,[9 3],84,-1,111,-1,84
1,<environment.Job instance at 0x7f33c87037d0>,84,12,[6 5],85,-1,97,-1,85
1,<environment.Job instance at 0x7f33c8703aa0>,86,28,[1 7],87,-1,115,-1,87
1,<environment.Job instance at 0x7f33c8703730>,87,12,[ 4 10],88,-1,100,-1,88
1,<environment.Job instance at 0x7f33c7a1b1e0>,96,28,[9 2],97,-1,125,-1,97
1,<environment.Job instance at 0x7f33c7a1bb40>,13,27,[1 8],14,-1,49,-1,22
1,<environment.Job instance at 0x7f33c8e3e230>,33,3,[ 3 14],34,-1,94,-1,91
1,<environment.Job instance at 0x7f33c7c5e820>,35,25,[6 3],36,-1,130,-1,105
1,<environment.Job instance at 0x7f33c81189b0>,40,2,[ 5 11],41,-1,110,-1,108
1,<environment.Job instance at 0x7f33c874db40>,49,27,[ 5 10],50,-1,186,-1,159
1,<environment.Job instance at 0x7f33c87a7370>,66,13,[11  1],67,-1,213,-1,200
1,<environment.Job instance at 0x7f33c879f050>,68,12,[ 5 12],69,-1,212,-1,200
1,<environment.Job instance at 0x7f33d1a450a0>,81,28,[2 8],82,-1,307,-1,279
1,<environment.Job instance at 0x7f33d1443140>,83,27,[9 3],84,-1,316,-1,289
1,<environment.Job instance at 0x7f33d14c8500>,86,28,[1 7],87,-1,327,-1,299
1,<environment.Job instance at 0x7f33c80d5fa0>,89,2,[ 4 11],90,-1,303,-1,301
1,<environment.Job instance at 0x7f33c7a32f50>,94,3,[11  1],95,-1,312,-1,309
1,<environment.Job instance at 0x7f33c7a32690>,96,28,[9 2],97,-1,340,-1,312
1,<environment.Job instance at 0x7f33c792b5a0>,7,3,[ 1 12],8,-1,11,-1,8
1,<environment.Job instance at 0x7f33c7f7e690>,8,15,[ 3 11],9,-1,24,-1,9
1,<environment.Job instance at 0x7f33c7f7e820>,10,14,[6 4],11,-1,25,-1,11
1,<environment.Job instance at 0x7f33c7f7ee60>,14,15,[9 1],15,-1,30,-1,15
1,<environment.Job instance at 0x7f33c7f7e0a0>,16,23,[7 4],17,-1,40,-1,17
1,<environment.Job instance at 0x7f33c79331e0>,19,14,[3 7],20,-1,34,-1,20
1,<environment.Job instance at 0x7f33c8a26690>,20,15,[9 4],21,-1,36,-1,21
1,<environment.Job instance at 0x7f33c7f9a3c0>,23,20,[5 4],24,-1,44,-1,24
1,<environment.Job instance at 0x7f33c7f79410>,34,15,[10  3],35,-1,51,-1,36
1,<environment.Job instance at 0x7f33c7bbca00>,36,21,[6 5],37,-1,58,-1,37
1,<environment.Job instance at 0x7f33c7bbcc30>,37,13,[9 4],38,-1,51,-1,38
1,<environment.Job instance at 0x7f33c7bbc6e0>,39,17,[5 9],40,-1,57,-1,40
1,<environment.Job instance at 0x7f33c7fa31e0>,40,15,[4 5],41,-1,56,-1,41
1,<environment.Job instance at 0x7f33c7f897d0>,41,27,[5 1],42,-1,69,-1,42
1,<environment.Job instance at 0x7f33c7f890f0>,42,21,[1 6],43,-1,64,-1,43
1,<environment.Job instance at 0x7f33c7f89190>,43,17,[8 5],44,-1,61,-1,44
1,<environment.Job instance at 0x7f33c7f89320>,45,16,[4 5],46,-1,62,-1,46
1,<environment.Job instance at 0x7f33c7f8d280>,46,25,[8 3],47,-1,72,-1,47
1,<environment.Job instance at 0x7f33c7f8d140>,48,16,[ 5 10],49,-1,65,-1,49
1,<environment.Job instance at 0x7f33c7f8d4b0>,49,18,[7 3],50,-1,68,-1,50
1,<environment.Job instance at 0x7f33c7f8d460>,50,16,[9 2],51,-1,67,-1,51
1,<environment.Job instance at 0x7f33c7f8d9b0>,51,19,[10  1],52,-1,76,-1,57
1,<environment.Job instance at 0x7f33c7f8de10>,56,25,[ 5 10],57,-1,82,-1,57
1,<environment.Job instance at 0x7f33c8dff190>,62,18,[5 9],63,-1,82,-1,64
1,<environment.Job instance at 0x7f33c8dff6e0>,67,17,[5 2],68,-1,85,-1,68
1,<environment.Job instance at 0x7f33c8dff690>,68,18,[1 9],69,-1,87,-1,69
1,<environment.Job instance at 0x7f33c8dffb40>,70,15,[3 9],71,-1,86,-1,71
1,<environment.Job instance at 0x7f33c8dffe10>,74,17,[9 5],75,-1,92,-1,75
1,<environment.Job instance at 0x7f33c8dea140>,75,16,[5 3],76,-1,92,-1,76
1,<environment.Job instance at 0x7f33c8dea460>,78,14,[9 4],79,-1,93,-1,79
1,<environment.Job instance at 0x7f33c8dea4b0>,79,13,[3 6],80,-1,93,-1,80
1,<environment.Job instance at 0x7f33c8dea2d0>,80,26,[6 3],81,-1,107,-1,81
1,<environment.Job instance at 0x7f33c8dea640>,81,14,[4 6],82,-1,96,-1,82
1,<environment.Job instance at 0x7f33c8deae60>,91,17,[10  4],92,-1,110,-1,93
1,<environment.Job instance at 0x7f33c8dffd20>,7,3,[ 1 12],8,-1,11,-1,8
1,<environment.Job instance at 0x7f33c8dff910>,8,15,[ 3 11],9,-1,24,-1,9
1,<environment.Job instance at 0x7f33d1443640>,15,15,[ 2 11],16,-1,31,-1,16
1,<environment.Job instance at 0x7f33d14430f0>,16,23,[7 4],17,-1,42,-1,19
1,<environment.Job instance at 0x7f33c84359b0>,30,16,[14  3],31,-1,72,-1,56
1,<environment.Job instance at 0x7f33c80ed5f0>,41,27,[5 1],42,-1,104,-1,77
1,<environment.Job instance at 0x7f33c8118a50>,46,25,[8 3],47,-1,117,-1,92
1,<environment.Job instance at 0x7f33c8010d70>,47,13,[13  1],48,-1,105,-1,92
1,<environment.Job instance at 0x7f33c78a7320>,56,25,[ 5 10],57,-1,160,-1,135
1,<environment.Job instance at 0x7f33c7953370>,76,2,[13  5],77,-1,204,-1,202
1,<environment.Job instance at 0x7f33c7ceb0f0>,80,26,[6 3],81,-1,238,-1,212
1,<environment.Job instance at 0x7f33c831afa0>,82,17,[ 2 11],83,-1,229,-1,212
1,<environment.Job instance at 0x7f33c80bad20>,85,23,[7 1],86,-1,241,-1,218
1,<environment.Job instance at 0x7f33c8a12dc0>,93,12,[ 1 14],94,-1,254,-1,242
1,<environment.Job instance at 0x7f33c8a807d0>,96,13,[13  3],97,-1,269,-1,256
1,<environment.Job instance at 0x7f33c8a80d70>,98,1,[ 3 14],99,-1,261,-1,260
1,<environment.Job instance at 0x7f33c867a370>,4,18,[4 7],5,-1,23,-1,5
1,<environment.Job instance at 0x7f33c867a4b0>,6,17,[5 5],7,-1,24,-1,7
1,<environment.Job instance at 0x7f33c867ac30>,12,17,[1 6],13,-1,30,-1,13
1,<environment.Job instance at 0x7f33c867a230>,13,16,[4 9],14,-1,30,-1,14
1,<environment.Job instance at 0x7f33c842b640>,19,18,[9 5],20,-1,38,-1,20
1,<environment.Job instance at 0x7f33c842b0f0>,20,28,[5 6],21,-1,49,-1,21
1,<environment.Job instance at 0x7f33c842b4b0>,24,17,[6 5],25,-1,57,-1,40
1,<environment.Job instance at 0x7f33c7953370>,11,14,[ 3 14],12,-1,32,-1,18
1,<environment.Job instance at 0x7f33d16db050>,15,13,[ 1 12],16,-1,35,-1,22
1,<environment.Job instance at 0x7f33c853f960>,16,17,[11  2],17,-1,39,-1,22
1,<environment.Job instance at 0x7f33c88d9280>,20,28,[5 6],21,-1,66,-1,38
1,<environment.Job instance at 0x7f33c7d096e0>,23,28,[ 1 11],24,-1,68,-1,40
1,<environment.Job instance at 0x7f33c83dc410>,25,23,[5 3],26,-1,66,-1,43
1,<environment.Job instance at 0x7f33c8e50280>,26,14,[13  5],27,-1,57,-1,43
1,<environment.Job instance at 0x7f33c8dea1e0>,30,13,[12  5],31,-1,69,-1,56
1,<environment.Job instance at 0x7f33c7f9a870>,38,15,[ 3 13],39,-1,97,-1,82
1,<environment.Job instance at 0x7f33c7db18c0>,46,18,[ 3 13],47,-1,146,-1,128
1,<environment.Job instance at 0x7f33c87a1f50>,57,2,[ 4 14],58,-1,161,-1,159
1,<environment.Job instance at 0x7f33c87a1c80>,64,2,[ 1 12],65,-1,179,-1,177
1,<environment.Job instance at 0x7f33c87a1d70>,70,25,[2 8],71,-1,250,-1,225
1,<environment.Job instance at 0x7f33c87a1d20>,74,3,[ 3 14],75,-1,238,-1,235
1,<environment.Job instance at 0x7f33c79fb2d0>,79,2,[13  5],80,-1,258,-1,256
1,<environment.Job instance at 0x7f33c79fb8c0>,88,1,[ 3 12],89,-1,302,-1,301
1,<environment.Job instance at 0x7f33c77eddc0>,3,17,[10  5],4,-1,21,-1,4
1,<environment.Job instance at 0x7f33c77ed6e0>,4,17,[3 6],5,-1,22,-1,5
1,<environment.Job instance at 0x7f33c77ed2d0>,11,16,[2 7],12,-1,28,-1,12
1,<environment.Job instance at 0x7f33c77ed550>,12,15,[3 8],13,-1,28,-1,13
1,<environment.Job instance at 0x7f33c81a99b0>,15,15,[9 1],16,-1,33,-1,18
1,<environment.Job instance at 0x7f33c81a9eb0>,17,25,[9 4],18,-1,43,-1,18
1,<environment.Job instance at 0x7f33c81a92d0>,20,16,[2 8],21,-1,38,-1,22
1,<environment.Job instance at 0x7f33c81a9c80>,22,17,[1 7],23,-1,40,-1,23
1,<environment.Job instance at 0x7f33c81a94b0>,25,16,[1 6],26,-1,42,-1,26
1,<environment.Job instance at 0x7f33c77bb5f0>,31,18,[9 3],32,-1,52,-1,34
1,<environment.Job instance at 0x7f33c77bbd70>,34,25,[7 4],35,-1,60,-1,35
1,<environment.Job instance at 0x7f33c77bb0a0>,36,22,[ 4 10],37,-1,59,-1,37
1,<environment.Job instance at 0x7f33c77bb370>,38,16,[2 7],39,-1,55,-1,39
1,<environment.Job instance at 0x7f33c77bb230>,39,16,[ 3 10],40,-1,56,-1,40
1,<environment.Job instance at 0x7f33c76d8640>,42,18,[5 8],43,-1,61,-1,43
1,<environment.Job instance at 0x7f33c77bb780>,33,12,[4 9],34,-1,60,-1,48
1,<environment.Job instance at 0x7f33c76d8870>,50,16,[5 9],51,-1,67,-1,51
1,<environment.Job instance at 0x7f33c76d8320>,51,15,[9 5],52,-1,67,-1,52
1,<environment.Job instance at 0x7f33c7666640>,53,18,[ 2 11],54,-1,72,-1,54
1,<environment.Job instance at 0x7f33c76d89b0>,45,23,[8 2],46,-1,84,-1,61
1,<environment.Job instance at 0x7f33c76d8140>,46,16,[6 1],47,-1,81,-1,65
1,<environment.Job instance at 0x7f33c8e9e3c0>,59,16,[ 4 10],60,-1,85,-1,69
1,<environment.Job instance at 0x7f33d1a6f690>,62,23,[7 1],63,-1,92,-1,69
1,<environment.Job instance at 0x7f33d1a6f460>,61,17,[3 7],62,-1,87,-1,70
1,<environment.Job instance at 0x7f33c77bb5a0>,27,14,[12  5],28,-1,84,-1,70
1,<environment.Job instance at 0x7f33c792eeb0>,58,14,[8 1],59,-1,84,-1,70
1,<environment.Job instance at 0x7f33c89bff50>,70,15,[4 9],71,-1,86,-1,71
1,<environment.Job instance at 0x7f33c7744870>,71,15,[7 5],72,-1,87,-1,72
1,<environment.Job instance at 0x7f33c81dd410>,72,13,[14  4],73,-1,86,-1,73
1,<environment.Job instance at 0x7f33c76e21e0>,73,16,[8 2],74,-1,90,-1,74
1,<environment.Job instance at 0x7f33c7fbe5a0>,76,17,[9 3],77,-1,94,-1,77
1,<environment.Job instance at 0x7f33d1a6f730>,64,14,[10  1],65,-1,94,-1,80
1,<environment.Job instance at 0x7f33c86db370>,79,15,[5 6],80,-1,95,-1,80
1,<environment.Job instance at 0x7f33c8a0b460>,80,15,[9 1],81,-1,96,-1,81
1,<environment.Job instance at 0x7f33d16db7d0>,82,13,[6 5],83,-1,97,-1,84
1,<environment.Job instance at 0x7f33c7ceb2d0>,84,18,[1 8],85,-1,106,-1,88
1,<environment.Job instance at 0x7f33c8f12f50>,88,18,[5 8],89,-1,109,-1,91
1,<environment.Job instance at 0x7f33c76d8730>,5,18,[14  2],6,-1,24,-1,6
1,<environment.Job instance at 0x7f33c867a7d0>,17,25,[9 4],18,-1,64,-1,39
1,<environment.Job instance at 0x7f33c7c53c30>,21,3,[ 4 12],22,-1,44,-1,41
1,<environment.Job instance at 0x7f33c7a85190>,26,16,[14  3],27,-1,73,-1,57
1,<environment.Job instance at 0x7f33c7a85640>,27,14,[12  5],28,-1,71,-1,57
1,<environment.Job instance at 0x7f33c7a70550>,34,25,[7 4],35,-1,111,-1,86
1,<environment.Job instance at 0x7f33c8925c80>,45,23,[8 2],46,-1,145,-1,122
1,<environment.Job instance at 0x7f33c8d1d5a0>,53,18,[ 2 11],54,-1,166,-1,148
1,<environment.Job instance at 0x7f33c8d1d280>,55,3,[11  2],56,-1,156,-1,153
1,<environment.Job instance at 0x7f33c8928500>,62,23,[7 1],63,-1,212,-1,189
1,<environment.Job instance at 0x7f33c8918870>,65,3,[13  2],66,-1,206,-1,203
1,<environment.Job instance at 0x7f33c8918370>,68,1,[13  4],69,-1,208,-1,207
1,<environment.Job instance at 0x7f33c806ceb0>,72,13,[14  4],73,-1,235,-1,222
1,<environment.Job instance at 0x7f33c7a8ca00>,81,23,[ 3 13],82,-1,279,-1,256
1,<environment.Job instance at 0x7f33c89ac780>,1,18,[3 7],2,-1,20,-1,2
1,<environment.Job instance at 0x7f33c89acc30>,2,17,[1 9],3,-1,20,-1,3
1,<environment.Job instance at 0x7f33c89ac910>,4,22,[9 5],5,-1,27,-1,5
1,<environment.Job instance at 0x7f33c89ac280>,7,16,[5 8],8,-1,24,-1,8
1,<environment.Job instance at 0x7f33c89ac960>,8,16,[1 6],9,-1,25,-1,9
1,<environment.Job instance at 0x7f33c89ac0f0>,13,15,[4 9],14,-1,30,-1,15
1,<environment.Job instance at 0x7f33c86c2fa0>,15,12,[ 3 10],16,-1,28,-1,16
1,<environment.Job instance at 0x7f33c86c2690>,16,12,[9 4],17,-1,29,-1,17
1,<environment.Job instance at 0x7f33c86c25f0>,18,12,[10  1],19,-1,31,-1,19
1,<environment.Job instance at 0x7f33c86c2780>,19,21,[1 7],20,-1,41,-1,20
1,<environment.Job instance at 0x7f33c86c2d70>,20,16,[9 2],21,-1,37,-1,21
1,<environment.Job instance at 0x7f33c86c2be0>,26,12,[6 4],27,-1,39,-1,27
1,<environment.Job instance at 0x7f33c86c2230>,27,17,[8 2],28,-1,45,-1,28
1,<environment.Job instance at 0x7f33c86c2870>,28,17,[1 6],29,-1,46,-1,29
1,<environment.Job instance at 0x7f33c86c2140>,29,17,[9 2],30,-1,47,-1,30
1,<environment.Job instance at 0x7f33c7b8d050>,32,15,[2 9],33,-1,48,-1,33
1,<environment.Job instance at 0x7f33c7b8d0a0>,35,16,[11  3],36,-1,52,-1,36
1,<environment.Job instance at 0x7f33c7b8de10>,37,16,[3 5],38,-1,54,-1,38
1,<environment.Job instance at 0x7f33c842bf50>,14,14,[10  4],15,-1,55,-1,41
1,<environment.Job instance at 0x7f33c7b8d410>,43,18,[ 2 10],44,-1,63,-1,45
1,<environment.Job instance at 0x7f33c80de640>,47,17,[7 4],48,-1,65,-1,48
1,<environment.Job instance at 0x7f33c80de8c0>,48,15,[8 3],49,-1,64,-1,49
1,<environment.Job instance at 0x7f33c80deaf0>,49,16,[10  5],50,-1,66,-1,50
1,<environment.Job instance at 0x7f33c80deb40>,51,16,[5 3],52,-1,68,-1,52
1,<environment.Job instance at 0x7f33c7b8de60>,44,17,[8 3],45,-1,71,-1,54
1,<environment.Job instance at 0x7f33c80de0a0>,55,17,[ 2 10],56,-1,76,-1,59
1,<environment.Job instance at 0x7f33d14a67d0>,60,18,[9 2],61,-1,79,-1,61
1,<environment.Job instance at 0x7f33c80de7d0>,58,19,[7 1],59,-1,86,-1,67
1,<environment.Job instance at 0x7f33d14a6690>,70,27,[7 4],71,-1,109,-1,82
1,<environment.Job instance at 0x7f33c7f3e5a0>,77,18,[6 2],78,-1,100,-1,82
1,<environment.Job instance at 0x7f33c7f3e0a0>,78,14,[ 4 10],79,-1,96,-1,82
1,<environment.Job instance at 0x7f33c7f3e370>,80,25,[ 1 14],81,-1,107,-1,82
1,<environment.Job instance at 0x7f33c7f3e050>,76,13,[9 5],77,-1,95,-1,82
1,<environment.Job instance at 0x7f33c7f3e190>,84,19,[9 1],85,-1,104,-1,85
1,<environment.Job instance at 0x7f33c8153d20>,89,15,[8 5],90,-1,113,-1,98
1,<environment.Job instance at 0x7f33c8153500>,91,13,[9 4],92,-1,111,-1,98
1,<environment.Job instance at 0x7f33c7f3e410>,81,14,[9 5],82,-1,112,-1,98
1,<environment.Job instance at 0x7f33c80de190>,5,3,[ 1 14],6,-1,9,-1,6
1,<environment.Job instance at 0x7f33d14a6730>,10,13,[11  4],11,-1,31,-1,18
1,<environment.Job instance at 0x7f33c7f3e230>,11,12,[ 1 13],12,-1,30,-1,18
1,<environment.Job instance at 0x7f33c7eeeaa0>,22,17,[ 2 14],23,-1,77,-1,60
1,<environment.Job instance at 0x7f33c79a8af0>,35,16,[11  3],36,-1,124,-1,108
1,<environment.Job instance at 0x7f33c7a709b0>,46,1,[11  2],47,-1,131,-1,130
1,<environment.Job instance at 0x7f33c81aa320>,67,14,[11  2],68,-1,225,-1,211
1,<environment.Job instance at 0x7f33c7ec1910>,68,15,[ 3 14],69,-1,226,-1,211
1,<environment.Job instance at 0x7f33c8029960>,70,27,[7 4],71,-1,241,-1,214
1,<environment.Job instance at 0x7f33c8527820>,75,2,[ 1 12],76,-1,228,-1,226
1,<environment.Job instance at 0x7f33c7a8c050>,80,25,[ 1 14],81,-1,278,-1,253
1,<environment.Job instance at 0x7f33c7a8c230>,83,1,[ 4 13],84,-1,268,-1,267
1,<environment.Job instance at 0x7f33c7a8ccd0>,85,3,[ 4 11],86,-1,281,-1,278
1,<environment.Job instance at 0x7f33c8928be0>,98,3,[11  1],99,-1,329,-1,326
1,<environment.Job instance at 0x7f33c8deec80>,2,14,[9 3],3,-1,21,-1,7
1,<environment.Job instance at 0x7f33c822c5a0>,6,16,[4 9],7,-1,23,-1,7
1,<environment.Job instance at 0x7f33c822c1e0>,9,14,[3 8],10,-1,24,-1,10
1,<environment.Job instance at 0x7f33c822c3c0>,11,18,[5 9],12,-1,30,-1,12
1,<environment.Job instance at 0x7f33c822c8c0>,15,17,[10  3],16,-1,33,-1,16
1,<environment.Job instance at 0x7f33c822c7d0>,17,16,[8 4],18,-1,34,-1,18
1,<environment.Job instance at 0x7f33c879f6e0>,18,14,[6 3],19,-1,33,-1,19
1,<environment.Job instance at 0x7f33c879fb90>,19,2,[3 7],20,-1,22,-1,20
1,<environment.Job instance at 0x7f33c879f3c0>,20,17,[8 4],21,-1,51,-1,34
1,<environment.Job instance at 0x7f33c879f230>,24,17,[8 5],25,-1,71,-1,54
1,<environment.Job instance at 0x7f33c879f7d0>,26,23,[5 5],27,-1,77,-1,54
1,<environment.Job instance at 0x7f33c879f730>,28,14,[9 5],29,-1,71,-1,57
1,<environment.Job instance at 0x7f33c822c190>,21,14,[ 5 10],22,-1,79,-1,65
1,<environment.Job instance at 0x7f33c879f640>,34,17,[4 7],35,-1,88,-1,71
1,<environment.Job instance at 0x7f33c845bb40>,36,13,[10  5],37,-1,99,-1,86
1,<environment.Job instance at 0x7f33c879ffa0>,23,13,[8 3],24,-1,100,-1,87
1,<environment.Job instance at 0x7f33c845b5a0>,37,14,[2 6],38,-1,101,-1,87
1,<environment.Job instance at 0x7f33c879f4b0>,33,17,[6 4],34,-1,104,-1,87
1,<environment.Job instance at 0x7f33c879fc30>,22,19,[8 3],23,-1,106,-1,87
1,<environment.Job instance at 0x7f33c845b2d0>,44,15,[8 1],45,-1,102,-1,87
1,<environment.Job instance at 0x7f33c879f9b0>,29,25,[7 3],30,-1,112,-1,87
1,<environment.Job instance at 0x7f33c845bc80>,50,18,[5 4],51,-1,106,-1,88
1,<environment.Job instance at 0x7f33c845bf50>,48,15,[ 4 10],49,-1,103,-1,88
1,<environment.Job instance at 0x7f33c845be10>,42,14,[10  1],43,-1,104,-1,90
1,<environment.Job instance at 0x7f33c7c910a0>,56,17,[ 1 13],57,-1,109,-1,92
1,<environment.Job instance at 0x7f33c7c913c0>,57,18,[ 3 12],58,-1,112,-1,94
1,<environment.Job instance at 0x7f33c7c91cd0>,59,13,[7 2],60,-1,114,-1,101
1,<environment.Job instance at 0x7f33c845bfa0>,47,15,[3 9],48,-1,116,-1,101
1,<environment.Job instance at 0x7f33c7c91d70>,58,18,[ 4 10],59,-1,120,-1,102
1,<environment.Job instance at 0x7f33c7c91320>,64,16,[9 2],65,-1,118,-1,102
1,<environment.Job instance at 0x7f33c7c910f0>,66,18,[3 6],67,-1,120,-1,102
1,<environment.Job instance at 0x7f33c7c91500>,63,16,[3 8],64,-1,119,-1,103
1,<environment.Job instance at 0x7f33c7f79c30>,73,18,[4 5],74,-1,121,-1,103
1,<environment.Job instance at 0x7f33c845b230>,52,19,[6 2],53,-1,122,-1,103
1,<environment.Job instance at 0x7f33c7f79aa0>,67,18,[5 5],68,-1,121,-1,103
1,<environment.Job instance at 0x7f33c7f79640>,79,23,[4 9],80,-1,126,-1,103
1,<environment.Job instance at 0x7f33c7f79f00>,81,16,[6 5],82,-1,119,-1,103
1,<environment.Job instance at 0x7f33c7f79780>,84,22,[5 8],85,-1,126,-1,104
1,<environment.Job instance at 0x7f33c7f79af0>,75,18,[5 8],76,-1,129,-1,111
1,<environment.Job instance at 0x7f33c77607d0>,87,18,[9 4],88,-1,129,-1,111
1,<environment.Job instance at 0x7f33c7f79410>,76,18,[3 9],77,-1,137,-1,119
1,<environment.Job instance at 0x7f33c8e9ef00>,98,14,[7 2],99,-1,133,-1,119
1,<environment.Job instance at 0x7f33c83f70f0>,26,23,[5 5],27,-1,103,-1,80
1,<environment.Job instance at 0x7f33c8e6e3c0>,29,25,[7 3],30,-1,120,-1,95
1,<environment.Job instance at 0x7f33c7a852d0>,30,1,[12  5],31,-1,96,-1,95
1,<environment.Job instance at 0x7f33c7a70c80>,41,3,[ 3 11],42,-1,141,-1,138
1,<environment.Job instance at 0x7f33c7ab5730>,55,3,[14  4],56,-1,193,-1,190
1,<environment.Job instance at 0x7f33c8d1db40>,56,17,[ 1 13],57,-1,207,-1,190
1,<environment.Job instance at 0x7f33c8d1d3c0>,57,18,[ 3 12],58,-1,208,-1,190
1,<environment.Job instance at 0x7f33c7f3e0f0>,61,2,[11  4],62,-1,206,-1,204
1,<environment.Job instance at 0x7f33d14a6730>,68,22,[ 1 13],69,-1,252,-1,230
1,<environment.Job instance at 0x7f33c826ed20>,78,2,[11  2],79,-1,273,-1,271
1,<environment.Job instance at 0x7f33c7d4e780>,79,23,[4 9],80,-1,295,-1,272
1,<environment.Job instance at 0x7f33c864ad20>,82,13,[14  2],83,-1,285,-1,272
1,<environment.Job instance at 0x7f33c7e5dcd0>,4,17,[3 7],5,-1,22,-1,5
1,<environment.Job instance at 0x7f33c7e5de10>,6,14,[7 5],7,-1,21,-1,7
1,<environment.Job instance at 0x7f33d16df370>,9,18,[2 9],10,-1,28,-1,10
1,<environment.Job instance at 0x7f33d16df280>,10,18,[5 5],11,-1,29,-1,11
1,<environment.Job instance at 0x7f33d16df5f0>,11,14,[ 1 10],12,-1,26,-1,12
1,<environment.Job instance at 0x7f33c8970b40>,13,18,[5 2],14,-1,32,-1,14
1,<environment.Job instance at 0x7f33c8970190>,14,16,[7 5],15,-1,31,-1,15
1,<environment.Job instance at 0x7f33c89705a0>,23,17,[14  2],24,-1,42,-1,25
1,<environment.Job instance at 0x7f33c89706e0>,21,13,[9 1],22,-1,39,-1,26
1,<environment.Job instance at 0x7f33c8bf4730>,25,20,[10  3],26,-1,46,-1,26
1,<environment.Job instance at 0x7f33c8970140>,26,12,[3 5],27,-1,41,-1,29
1,<environment.Job instance at 0x7f33c8bf44b0>,32,18,[9 2],33,-1,51,-1,33
1,<environment.Job instance at 0x7f33c8bf4190>,34,14,[5 9],35,-1,49,-1,35
1,<environment.Job instance at 0x7f33c8bf40a0>,35,14,[6 3],36,-1,50,-1,36
1,<environment.Job instance at 0x7f33c8ee7f00>,37,23,[6 1],38,-1,61,-1,38
1,<environment.Job instance at 0x7f33c8ee7910>,41,14,[1 5],42,-1,56,-1,42
1,<environment.Job instance at 0x7f33c8ee75a0>,42,17,[5 1],43,-1,60,-1,43
1,<environment.Job instance at 0x7f33c8ee7550>,45,12,[8 3],46,-1,59,-1,47
1,<environment.Job instance at 0x7f33c7f9cdc0>,47,17,[5 5],48,-1,65,-1,48
1,<environment.Job instance at 0x7f33c7f9cc30>,48,14,[9 5],49,-1,63,-1,49
1,<environment.Job instance at 0x7f33c7f9c320>,49,14,[8 5],50,-1,64,-1,50
1,<environment.Job instance at 0x7f33c7f9c500>,50,25,[9 4],51,-1,76,-1,51
1,<environment.Job instance at 0x7f33c7f9caa0>,51,15,[7 3],52,-1,67,-1,52
1,<environment.Job instance at 0x7f33d1480870>,52,17,[1 5],53,-1,70,-1,53
1,<environment.Job instance at 0x7f33d1480be0>,53,3,[3 9],54,-1,57,-1,54
1,<environment.Job instance at 0x7f33d1480140>,54,28,[ 5 10],55,-1,83,-1,55
1,<environment.Job instance at 0x7f33d1480190>,55,1,[ 1 10],56,-1,57,-1,56
1,<environment.Job instance at 0x7f33d1480780>,56,13,[5 9],57,-1,70,-1,57
1,<environment.Job instance at 0x7f33d1480cd0>,57,27,[2 9],58,-1,85,-1,58
1,<environment.Job instance at 0x7f33d14801e0>,58,26,[4 9],59,-1,85,-1,59
1,<environment.Job instance at 0x7f33d1480b40>,59,1,[10  5],60,-1,61,-1,60
1,<environment.Job instance at 0x7f33c8ee7fa0>,46,18,[ 2 10],47,-1,78,-1,60
1,<environment.Job instance at 0x7f33c7f9c8c0>,60,18,[5 4],61,-1,79,-1,61
1,<environment.Job instance at 0x7f33c8797280>,64,16,[8 1],65,-1,83,-1,67
1,<environment.Job instance at 0x7f33c832c910>,67,3,[5 6],68,-1,71,-1,68
1,<environment.Job instance at 0x7f33c832ce60>,68,19,[2 7],69,-1,88,-1,69
1,<environment.Job instance at 0x7f33c832c460>,69,3,[6 1],70,-1,73,-1,70
1,<environment.Job instance at 0x7f33c87ae5a0>,70,12,[2 6],71,-1,83,-1,71
1,<environment.Job instance at 0x7f33c87ae050>,71,2,[6 2],72,-1,74,-1,72
1,<environment.Job instance at 0x7f33c866e5a0>,72,22,[5 4],73,-1,95,-1,73
1,<environment.Job instance at 0x7f33c866e410>,73,3,[7 2],74,-1,77,-1,74
1,<environment.Job instance at 0x7f33c81ccc30>,74,13,[5 8],75,-1,88,-1,75
1,<environment.Job instance at 0x7f33c81cc730>,75,13,[5 5],76,-1,89,-1,76
1,<environment.Job instance at 0x7f33c8385b90>,76,18,[1 5],77,-1,95,-1,77
1,<environment.Job instance at 0x7f33c8385e60>,77,3,[3 7],78,-1,81,-1,78
1,<environment.Job instance at 0x7f33c8401e60>,78,17,[7 5],79,-1,96,-1,79
1,<environment.Job instance at 0x7f33c7a48780>,79,13,[4 8],80,-1,93,-1,80
1,<environment.Job instance at 0x7f33c8799730>,80,17,[10  1],81,-1,98,-1,81
1,<environment.Job instance at 0x7f33c866dd70>,81,16,[2 5],82,-1,98,-1,82
1,<environment.Job instance at 0x7f33c7c682d0>,66,16,[ 5 12],67,-1,98,-1,82
1,<environment.Job instance at 0x7f33c8a3eb90>,91,18,[4 9],92,-1,110,-1,92
1,<environment.Job instance at 0x7f33c86ab1e0>,93,13,[9 3],94,-1,110,-1,97
1,<environment.Job instance at 0x7f33c77fbe60>,94,19,[2 5],95,-1,118,-1,99
1,<environment.Job instance at 0x7f33c772ef00>,98,12,[1 9],99,-1,111,-1,99
1,<environment.Job instance at 0x7f33d16df140>,0,2,[ 4 14],1,-1,3,-1,1
1,<environment.Job instance at 0x7f33c8a37460>,23,17,[14  2],24,-1,83,-1,66
1,<environment.Job instance at 0x7f33c85e0280>,36,2,[ 5 12],37,-1,96,-1,94
1,<environment.Job instance at 0x7f33c8236eb0>,37,23,[6 1],38,-1,120,-1,97
1,<environment.Job instance at 0x7f33c85f2230>,50,25,[9 4],51,-1,167,-1,142
1,<environment.Job instance at 0x7f33c82320a0>,54,28,[ 5 10],55,-1,187,-1,159
1,<environment.Job instance at 0x7f33c82326e0>,58,26,[4 9],59,-1,199,-1,173
1,<environment.Job instance at 0x7f33c8232230>,57,27,[2 9],58,-1,200,-1,173
1,<environment.Job instance at 0x7f33c8a18870>,66,16,[ 5 12],67,-1,200,-1,184
1,<environment.Job instance at 0x7f33c8a3e190>,86,17,[ 2 14],87,-1,271,-1,254
1,<environment.Job instance at 0x7f33c8a3e690>,87,26,[10  5],88,-1,282,-1,256
1,<environment.Job instance at 0x7f33c85a8c30>,4,22,[1 8],5,-1,27,-1,5
1,<environment.Job instance at 0x7f33c85a8d20>,5,18,[ 2 10],6,-1,24,-1,6
1,<environment.Job instance at 0x7f33c85a8be0>,9,17,[9 1],10,-1,28,-1,11
1,<environment.Job instance at 0x7f33c85a86e0>,12,26,[1 5],13,-1,39,-1,13
1,<environment.Job instance at 0x7f33d14c33c0>,13,17,[ 4 10],14,-1,31,-1,14
1,<environment.Job instance at 0x7f33d14c35a0>,14,15,[5 3],15,-1,30,-1,15
1,<environment.Job instance at 0x7f33d14c3d20>,15,15,[8 3],16,-1,31,-1,16
1,<environment.Job instance at 0x7f33d14c3500>,17,12,[9 2],18,-1,30,-1,18
1,<environment.Job instance at 0x7f33d14c3f00>,20,13,[10  5],21,-1,34,-1,21
1,<environment.Job instance at 0x7f33d14c3c30>,22,22,[5 3],23,-1,45,-1,23
1,<environment.Job instance at 0x7f33d14c3780>,24,15,[4 7],25,-1,40,-1,25
1,<environment.Job instance at 0x7f33d14c37d0>,27,24,[2 8],28,-1,52,-1,28
1,<environment.Job instance at 0x7f33c85e0370>,31,16,[4 9],32,-1,48,-1,32
1,<environment.Job instance at 0x7f33c85e0f00>,33,26,[1 8],34,-1,60,-1,34
1,<environment.Job instance at 0x7f33c85aef50>,34,13,[1 9],35,-1,48,-1,35
1,<environment.Job instance at 0x7f33c85ae8c0>,36,18,[7 1],37,-1,55,-1,37
1,<environment.Job instance at 0x7f33c85ae2d0>,41,23,[9 4],42,-1,65,-1,42
1,<environment.Job instance at 0x7f33c85ae780>,44,14,[2 7],45,-1,59,-1,45
1,<environment.Job instance at 0x7f33c85aed20>,46,16,[9 3],47,-1,63,-1,47
1,<environment.Job instance at 0x7f33c8583280>,50,17,[4 7],51,-1,68,-1,51
1,<environment.Job instance at 0x7f33c8583960>,51,14,[3 5],52,-1,66,-1,52
1,<environment.Job instance at 0x7f33c8583820>,57,17,[4 6],58,-1,75,-1,58
1,<environment.Job instance at 0x7f33c85832d0>,59,1,[10  2],60,-1,61,-1,60
1,<environment.Job instance at 0x7f33c8583050>,60,18,[3 6],61,-1,79,-1,61
1,<environment.Job instance at 0x7f33c879bc80>,62,16,[1 9],63,-1,79,-1,63
1,<environment.Job instance at 0x7f33c879bf50>,63,13,[6 4],64,-1,77,-1,64
1,<environment.Job instance at 0x7f33c879bdc0>,64,12,[10  3],65,-1,77,-1,65
1,<environment.Job instance at 0x7f33c879b190>,66,16,[2 7],67,-1,83,-1,67
1,<environment.Job instance at 0x7f33c7d738c0>,67,13,[7 1],68,-1,81,-1,68
1,<environment.Job instance at 0x7f33c7d732d0>,74,17,[10  5],75,-1,93,-1,76
1,<environment.Job instance at 0x7f33c7d73690>,75,15,[1 6],76,-1,91,-1,76
1,<environment.Job instance at 0x7f33c7d73140>,77,16,[11  5],78,-1,94,-1,78
1,<environment.Job instance at 0x7f33c878dfa0>,78,13,[3 6],79,-1,92,-1,79
1,<environment.Job instance at 0x7f33c83a4aa0>,85,17,[ 5 10],86,-1,107,-1,90
1,<environment.Job instance at 0x7f33c83a4140>,86,12,[5 6],87,-1,102,-1,90
1,<environment.Job instance at 0x7f33c8886f50>,10,16,[4 8],11,-1,107,-1,91
1,<environment.Job instance at 0x7f33c83a42d0>,92,16,[5 3],93,-1,109,-1,93
1,<environment.Job instance at 0x7f33c83a4f50>,93,16,[9 5],94,-1,110,-1,94
1,<environment.Job instance at 0x7f33c83a4690>,94,16,[8 5],95,-1,111,-1,95
1,<environment.Job instance at 0x7f33c89a2c80>,97,14,[ 5 10],98,-1,112,-1,98
1,<environment.Job instance at 0x7f33c85aea00>,3,23,[1 7],4,-1,27,-1,4
1,<environment.Job instance at 0x7f33c8583320>,8,13,[14  3],9,-1,22,-1,9
1,<environment.Job instance at 0x7f33c878df00>,12,26,[1 5],13,-1,39,-1,13
1,<environment.Job instance at 0x7f33c878bc80>,27,24,[2 8],28,-1,94,-1,70
1,<environment.Job instance at 0x7f33c7ca85f0>,29,13,[14  2],30,-1,83,-1,70
1,<environment.Job instance at 0x7f33c83a9af0>,33,26,[1 8],34,-1,116,-1,90
1,<environment.Job instance at 0x7f33c7bb9b90>,39,15,[ 1 14],40,-1,118,-1,103
1,<environment.Job instance at 0x7f33c761df00>,41,23,[9 4],42,-1,131,-1,108
1,<environment.Job instance at 0x7f33d17f7730>,77,16,[11  5],78,-1,276,-1,260
1,<environment.Job instance at 0x7f33d17f7c30>,81,3,[13  1],82,-1,273,-1,270
1,<environment.Job instance at 0x7f33c8575c30>,95,1,[ 3 12],96,-1,316,-1,315
1,<environment.Job instance at 0x7f33c8934a50>,98,3,[ 5 12],99,-1,334,-1,331
1,<environment.Job instance at 0x7f33c8daaa00>,2,16,[9 3],3,-1,20,-1,4
1,<environment.Job instance at 0x7f33c8daa0a0>,4,16,[7 3],5,-1,21,-1,5
1,<environment.Job instance at 0x7f33c858fa00>,5,22,[5 2],6,-1,28,-1,6
1,<environment.Job instance at 0x7f33c858faf0>,8,13,[5 7],9,-1,22,-1,9
1,<environment.Job instance at 0x7f33c858f550>,11,28,[7 5],12,-1,40,-1,12
1,<environment.Job instance at 0x7f33c858f7d0>,14,26,[7 1],15,-1,41,-1,15
1,<environment.Job instance at 0x7f33c858fe10>,15,18,[10  4],16,-1,34,-1,16
1,<environment.Job instance at 0x7f33c78a5be0>,18,1,[5 1],19,-1,20,-1,19
1,<environment.Job instance at 0x7f33c78a55a0>,21,18,[4 9],22,-1,40,-1,22
1,<environment.Job instance at 0x7f33c78a5b90>,22,18,[3 6],23,-1,41,-1,23
1,<environment.Job instance at 0x7f33c78a5780>,25,16,[2 7],26,-1,42,-1,26
1,<environment.Job instance at 0x7f33c78a51e0>,28,18,[8 3],29,-1,47,-1,29
1,<environment.Job instance at 0x7f33c78a5190>,32,15,[ 2 10],33,-1,48,-1,33
1,<environment.Job instance at 0x7f33c7673640>,33,18,[6 3],34,-1,52,-1,34
1,<environment.Job instance at 0x7f33c7673fa0>,34,17,[10  3],35,-1,56,-1,39
1,<environment.Job instance at 0x7f33c7673050>,38,27,[5 1],39,-1,77,-1,50
1,<environment.Job instance at 0x7f33c7673c30>,39,15,[9 3],40,-1,65,-1,50
1,<environment.Job instance at 0x7f33c8b68b90>,46,15,[4 7],47,-1,72,-1,57
1,<environment.Job instance at 0x7f33c7f82230>,60,17,[5 9],61,-1,96,-1,79
1,<environment.Job instance at 0x7f33c7f827d0>,61,17,[9 4],62,-1,96,-1,79
1,<environment.Job instance at 0x7f33c7f82a00>,66,16,[3 8],67,-1,95,-1,79
1,<environment.Job instance at 0x7f33c7f824b0>,67,18,[ 5 10],68,-1,97,-1,79
1,<environment.Job instance at 0x7f33c8b68a00>,6,1,[11  1],7,-1,8,-1,7
1,<environment.Job instance at 0x7f33c7f82aa0>,10,13,[11  3],11,-1,27,-1,14
1,<environment.Job instance at 0x7f33c764e3c0>,13,2,[14  5],14,-1,20,-1,18
1,<environment.Job instance at 0x7f33c7f820a0>,11,28,[7 5],12,-1,47,-1,19
1,<environment.Job instance at 0x7f33c760cc30>,14,26,[7 1],15,-1,45,-1,19
1,<environment.Job instance at 0x7f33c8b8cd70>,27,13,[13  4],28,-1,59,-1,46
1,<environment.Job instance at 0x7f33c7b6ff50>,30,24,[10  5],31,-1,86,-1,62
1,<environment.Job instance at 0x7f33c8884460>,31,3,[ 4 12],32,-1,65,-1,62
1,<environment.Job instance at 0x7f33c76e7aa0>,35,18,[ 2 11],36,-1,96,-1,78
1,<environment.Job instance at 0x7f33c7cbce60>,36,13,[11  3],37,-1,91,-1,78
1,<environment.Job instance at 0x7f33c7de6870>,38,27,[5 1],39,-1,123,-1,96
1,<environment.Job instance at 0x7f33c828f050>,48,27,[1 7],49,-1,143,-1,116
1,<environment.Job instance at 0x7f33c83a42d0>,49,16,[12  5],50,-1,132,-1,116
1,<environment.Job instance at 0x7f33c7d73be0>,56,1,[14  4],57,-1,122,-1,121
1,<environment.Job instance at 0x7f33c8583320>,57,17,[13  5],58,-1,138,-1,121
1,<environment.Job instance at 0x7f33c7b23550>,88,25,[5 5],89,-1,311,-1,286
1,<environment.Job instance at 0x7f33c7b232d0>,90,18,[14  5],91,-1,304,-1,286
1,<environment.Job instance at 0x7f33c7b56c80>,91,15,[ 1 12],92,-1,301,-1,286
1,<environment.Job instance at 0x7f33c7f16aa0>,0,22,[4 6],1,-1,23,-1,1
1,<environment.Job instance at 0x7f33c7f16820>,2,18,[5 6],3,-1,21,-1,3
1,<environment.Job instance at 0x7f33c7eefeb0>,4,18,[10  2],5,-1,23,-1,5
1,<environment.Job instance at 0x7f33c7a74050>,5,17,[3 9],6,-1,23,-1,6
1,<environment.Job instance at 0x7f33c7a60690>,15,16,[ 4 12],16,-1,35,-1,19
1,<environment.Job instance at 0x7f33c8d9ac30>,23,14,[9 2],24,-1,39,-1,25
1,<environment.Job instance at 0x7f33c7a88cd0>,29,15,[4 9],30,-1,45,-1,30
1,<environment.Job instance at 0x7f33c8d9a0f0>,24,15,[3 7],25,-1,46,-1,31
1,<environment.Job instance at 0x7f33c7a88280>,31,22,[2 9],32,-1,56,-1,34
1,<environment.Job instance at 0x7f33c8d9b690>,35,16,[8 5],36,-1,53,-1,37
1,<environment.Job instance at 0x7f33c8d9beb0>,39,18,[7 2],40,-1,58,-1,40
1,<environment.Job instance at 0x7f33c7efbf00>,43,12,[5 8],44,-1,56,-1,44
1,<environment.Job instance at 0x7f33c7efb960>,48,18,[ 4 12],49,-1,67,-1,49
1,<environment.Job instance at 0x7f33c83b8820>,50,12,[10  4],51,-1,63,-1,51
1,<environment.Job instance at 0x7f33c83b8f50>,51,12,[4 5],52,-1,64,-1,52
1,<environment.Job instance at 0x7f33c7f82fa0>,52,18,[ 5 10],53,-1,71,-1,53
1,<environment.Job instance at 0x7f33c89b7370>,54,26,[10  2],55,-1,81,-1,55
1,<environment.Job instance at 0x7f33c77f0820>,56,16,[ 5 10],57,-1,73,-1,57
1,<environment.Job instance at 0x7f33c8d9b4b0>,36,13,[4 5],37,-1,71,-1,58
1,<environment.Job instance at 0x7f33c79def00>,62,20,[5 2],63,-1,83,-1,63
1,<environment.Job instance at 0x7f33c77f07d0>,64,12,[3 9],65,-1,78,-1,66
1,<environment.Job instance at 0x7f33c771a690>,65,15,[5 1],66,-1,81,-1,66
1,<environment.Job instance at 0x7f33c89e7370>,83,21,[5 7],84,-1,106,-1,85
1,<environment.Job instance at 0x7f33c8a6f050>,76,20,[4 9],77,-1,106,-1,86
1,<environment.Job instance at 0x7f33c7c7d4b0>,80,16,[6 2],81,-1,102,-1,86
1,<environment.Job instance at 0x7f33c89e79b0>,84,14,[10  4],85,-1,103,-1,89
1,<environment.Job instance at 0x7f33c8a7f370>,73,15,[8 4],74,-1,105,-1,90
1,<environment.Job instance at 0x7f33c89e7d70>,90,13,[10  1],91,-1,105,-1,92
1,<environment.Job instance at 0x7f33c89e7230>,91,16,[5 7],92,-1,108,-1,92
1,<environment.Job instance at 0x7f33c89e7190>,89,27,[ 5 11],90,-1,121,-1,94
1,<environment.Job instance at 0x7f33c7c6a910>,93,25,[9 3],94,-1,124,-1,99
1,<environment.Job instance at 0x7f33c7c6a960>,92,19,[4 7],93,-1,118,-1,99
1,<environment.Job instance at 0x7f33c7c6a5f0>,96,19,[9 4],97,-1,118,-1,99
1,<environment.Job instance at 0x7f33c89dfaa0>,97,18,[4 7],98,-1,117,-1,99
1,<environment.Job instance at 0x7f33c79e6780>,12,17,[ 3 14],13,-1,40,-1,23
1,<environment.Job instance at 0x7f33c8a870f0>,15,16,[ 4 12],16,-1,42,-1,26
1,<environment.Job instance at 0x7f33c7f16d20>,18,18,[13  3],19,-1,57,-1,39
1,<environment.Job instance at 0x7f33c81907d0>,19,1,[ 4 14],20,-1,40,-1,39
1,<environment.Job instance at 0x7f33c8190370>,22,16,[14  1],23,-1,59,-1,43
1,<environment.Job instance at 0x7f33c8176d20>,25,1,[ 5 13],26,-1,45,-1,44
1,<environment.Job instance at 0x7f33c81819b0>,33,3,[ 5 11],34,-1,78,-1,75
1,<environment.Job instance at 0x7f33c7d27b40>,41,3,[ 3 11],42,-1,98,-1,95
1,<environment.Job instance at 0x7f33c7d36d70>,48,18,[ 4 12],49,-1,126,-1,108
1,<environment.Job instance at 0x7f33c818eaa0>,54,26,[10  2],55,-1,162,-1,136
1,<environment.Job instance at 0x7f33c7cbd8c0>,67,15,[13  3],68,-1,179,-1,164
1,<environment.Job instance at 0x7f33c7de4b40>,81,2,[ 2 13],82,-1,192,-1,190
1,<environment.Job instance at 0x7f33c80b5690>,88,2,[12  1],89,-1,210,-1,208
1,<environment.Job instance at 0x7f33c80b57d0>,89,27,[ 5 11],90,-1,235,-1,208
1,<environment.Job instance at 0x7f33c80b54b0>,93,25,[9 3],94,-1,259,-1,234
1,<environment.Job instance at 0x7f33c76e5050>,98,17,[ 2 12],99,-1,264,-1,247
1,<environment.Job instance at 0x7f33c89f2230>,0,26,[9 4],1,-1,27,-1,1
1,<environment.Job instance at 0x7f33c7a01e60>,3,18,[10  5],4,-1,22,-1,4
1,<environment.Job instance at 0x7f33c89dfeb0>,14,17,[9 5],15,-1,32,-1,15
1,<environment.Job instance at 0x7f33c89df460>,15,14,[2 9],16,-1,30,-1,16
1,<environment.Job instance at 0x7f33c79f9c80>,20,22,[1 9],21,-1,46,-1,24
1,<environment.Job instance at 0x7f33c89ccaf0>,24,13,[10  5],25,-1,38,-1,25
1,<environment.Job instance at 0x7f33c7c80d20>,22,2,[5 7],23,-1,31,-1,29
1,<environment.Job instance at 0x7f33c89cc230>,25,14,[10  1],26,-1,43,-1,29
1,<environment.Job instance at 0x7f33c7d37050>,29,17,[8 4],30,-1,47,-1,30
1,<environment.Job instance at 0x7f33c89f5a00>,27,17,[1 7],28,-1,48,-1,31
1,<environment.Job instance at 0x7f33c7876690>,31,16,[2 6],32,-1,48,-1,32
1,<environment.Job instance at 0x7f33c7866410>,32,17,[8 1],33,-1,51,-1,34
1,<environment.Job instance at 0x7f33c7888190>,35,17,[1 8],36,-1,53,-1,36
1,<environment.Job instance at 0x7f33c788b6e0>,33,26,[2 9],34,-1,65,-1,39
1,<environment.Job instance at 0x7f33c7879d20>,41,17,[13  5],42,-1,76,-1,59
1,<environment.Job instance at 0x7f33c8acd370>,19,19,[2 9],20,-1,79,-1,60
1,<environment.Job instance at 0x7f33c7880640>,43,18,[1 8],44,-1,78,-1,60
1,<environment.Job instance at 0x7f33c78803c0>,49,15,[8 4],50,-1,75,-1,60
1,<environment.Job instance at 0x7f33c7c6b910>,58,18,[5 6],59,-1,78,-1,60
1,<environment.Job instance at 0x7f33c78880a0>,36,13,[12  4],37,-1,81,-1,68
1,<environment.Job instance at 0x7f33c786ba50>,61,12,[7 4],62,-1,80,-1,68
1,<environment.Job instance at 0x7f33c786bfa0>,62,18,[7 3],63,-1,86,-1,68
1,<environment.Job instance at 0x7f33c7e0bd70>,63,13,[4 7],64,-1,81,-1,68
1,<environment.Job instance at 0x7f33c7e0b640>,64,2,[7 3],65,-1,70,-1,68
1,<environment.Job instance at 0x7f33c7e0b960>,65,16,[5 7],66,-1,87,-1,71
1,<environment.Job instance at 0x7f33c7e0b910>,66,12,[4 6],67,-1,83,-1,71
1,<environment.Job instance at 0x7f33c7e0b690>,67,16,[3 5],68,-1,87,-1,71
1,<environment.Job instance at 0x7f33c7e0baa0>,69,23,[5 5],70,-1,94,-1,71
1,<environment.Job instance at 0x7f33c7e0b820>,70,17,[8 3],71,-1,88,-1,71
1,<environment.Job instance at 0x7f33c7e0ba50>,71,12,[7 5],72,-1,84,-1,72
1,<environment.Job instance at 0x7f33c7e11690>,72,12,[5 4],73,-1,85,-1,73
1,<environment.Job instance at 0x7f33c7e11460>,73,13,[10  3],74,-1,87,-1,74
1,<environment.Job instance at 0x7f33c7e11af0>,74,17,[5 6],75,-1,92,-1,75
1,<environment.Job instance at 0x7f33c7e11b40>,75,24,[7 5],76,-1,104,-1,80
1,<environment.Job instance at 0x7f33c7e118c0>,82,17,[3 8],83,-1,100,-1,83
1,<environment.Job instance at 0x7f33c78735a0>,54,16,[5 3],55,-1,103,-1,87
1,<environment.Job instance at 0x7f33c7de1e60>,86,13,[ 1 10],87,-1,101,-1,88
1,<environment.Job instance at 0x7f33c7de10a0>,89,15,[8 4],90,-1,105,-1,90
1,<environment.Job instance at 0x7f33c7de1910>,91,15,[3 9],92,-1,107,-1,92
1,<environment.Job instance at 0x7f33c7de4230>,95,19,[8 1],96,-1,115,-1,96
1,<environment.Job instance at 0x7f33c7de1820>,87,14,[9 3],88,-1,112,-1,98
1,<environment.Job instance at 0x7f33c7a07cd0>,0,26,[9 4],1,-1,27,-1,1
1,<environment.Job instance at 0x7f33c89f54b0>,5,14,[13  2],6,-1,20,-1,6
1,<environment.Job instance at 0x7f33c7c96050>,8,24,[8 3],9,-1,48,-1,24
1,<environment.Job instance at 0x7f33c7a889b0>,28,2,[ 4 12],29,-1,51,-1,49
1,<environment.Job instance at 0x7f33c8a87d70>,33,26,[2 9],34,-1,107,-1,81
1,<environment.Job instance at 0x7f33c7de4af0>,36,13,[12  4],37,-1,101,-1,88
1,<environment.Job instance at 0x7f33c7de4690>,41,17,[13  5],42,-1,122,-1,105
1,<environment.Job instance at 0x7f33c7c9f5a0>,69,23,[5 5],70,-1,235,-1,212
1,<environment.Job instance at 0x7f33c7c9f4b0>,75,24,[7 5],76,-1,248,-1,224
1,<environment.Job instance at 0x7f33c7c9f8c0>,77,3,[ 2 13],78,-1,227,-1,224
1,<environment.Job instance at 0x7f33c756e870>,90,1,[13  2],91,-1,268,-1,267
1,<environment.Job instance at 0x7f33c756eaf0>,93,1,[ 2 13],94,-1,282,-1,281
1,<environment.Job instance at 0x7f33c756e320>,96,1,[ 4 11],97,-1,288,-1,287
1,<environment.Job instance at 0x7f33c76e55f0>,1,23,[7 5],2,-1,25,-1,2
1,<environment.Job instance at 0x7f33c8a89410>,2,28,[8 2],3,-1,31,-1,3
1,<environment.Job instance at 0x7f33c8a89320>,3,22,[5 4],4,-1,26,-1,4
1,<environment.Job instance at 0x7f33c8a89550>,5,17,[ 4 10],6,-1,23,-1,6
1,<environment.Job instance at 0x7f33c8a89b40>,11,17,[6 5],12,-1,29,-1,12
1,<environment.Job instance at 0x7f33c8a89780>,13,18,[10  5],14,-1,32,-1,14
1,<environment.Job instance at 0x7f33c8a89f00>,16,16,[3 6],17,-1,33,-1,17
1,<environment.Job instance at 0x7f33c8ab9780>,23,18,[4 9],24,-1,42,-1,24
1,<environment.Job instance at 0x7f33c8ab9910>,24,26,[7 4],25,-1,51,-1,25
1,<environment.Job instance at 0x7f33c8ab9cd0>,28,16,[1 8],29,-1,45,-1,29
1,<environment.Job instance at 0x7f33c8aa33c0>,34,17,[10  4],35,-1,52,-1,35
1,<environment.Job instance at 0x7f33c8ac04b0>,41,16,[8 1],42,-1,58,-1,42
1,<environment.Job instance at 0x7f33c8a94cd0>,49,15,[6 1],50,-1,66,-1,51
1,<environment.Job instance at 0x7f33c8a943c0>,52,12,[10  3],53,-1,65,-1,53
1,<environment.Job instance at 0x7f33c8a94780>,53,13,[5 1],54,-1,67,-1,54
1,<environment.Job instance at 0x7f33c8a948c0>,54,16,[6 3],55,-1,71,-1,55
1,<environment.Job instance at 0x7f33c8a94500>,56,12,[1 9],57,-1,69,-1,57
1,<environment.Job instance at 0x7f33c8a94410>,57,18,[7 1],58,-1,76,-1,58
1,<environment.Job instance at 0x7f33c8a945f0>,58,16,[10  3],59,-1,75,-1,59
1,<environment.Job instance at 0x7f33c8a94280>,59,15,[9 3],60,-1,75,-1,60
1,<environment.Job instance at 0x7f33c8e706e0>,62,22,[6 2],63,-1,85,-1,63
1,<environment.Job instance at 0x7f33c86e2a50>,63,16,[4 9],64,-1,80,-1,64
1,<environment.Job instance at 0x7f33c7ab5960>,64,23,[6 5],65,-1,88,-1,65
1,<environment.Job instance at 0x7f33c7ac02d0>,71,12,[1 7],72,-1,84,-1,72
1,<environment.Job instance at 0x7f33c8142460>,72,17,[1 6],73,-1,90,-1,73
1,<environment.Job instance at 0x7f33c81423c0>,73,21,[7 4],74,-1,95,-1,74
1,<environment.Job instance at 0x7f33c8133780>,75,15,[ 5 11],76,-1,91,-1,76
1,<environment.Job instance at 0x7f33c7aca960>,80,26,[5 7],81,-1,107,-1,81
1,<environment.Job instance at 0x7f33c7aca500>,81,16,[ 2 10],82,-1,98,-1,82
1,<environment.Job instance at 0x7f33c7acad20>,83,15,[10  1],84,-1,100,-1,85
1,<environment.Job instance at 0x7f33c7aca3c0>,87,15,[1 7],88,-1,103,-1,88
1,<environment.Job instance at 0x7f33c7aca9b0>,88,18,[5 6],89,-1,107,-1,89
1,<environment.Job instance at 0x7f33c7aca730>,89,27,[5 9],90,-1,117,-1,90
1,<environment.Job instance at 0x7f33c7acaeb0>,91,12,[8 3],92,-1,104,-1,92
1,<environment.Job instance at 0x7f33c7aca870>,92,26,[ 1 10],93,-1,119,-1,93
1,<environment.Job instance at 0x7f33c7acacd0>,93,28,[3 5],94,-1,122,-1,94
1,<environment.Job instance at 0x7f33c813cdc0>,94,16,[5 6],95,-1,111,-1,95
1,<environment.Job instance at 0x7f33c813c820>,95,16,[10  2],96,-1,112,-1,96
1,<environment.Job instance at 0x7f33c7abe190>,97,12,[4 7],98,-1,110,-1,98
1,<environment.Job instance at 0x7f33c8ac0050>,1,23,[7 5],2,-1,25,-1,2
1,<environment.Job instance at 0x7f33c8ac0460>,2,28,[8 2],3,-1,31,-1,3
1,<environment.Job instance at 0x7f33c756efa0>,25,1,[12  3],26,-1,50,-1,49
1,<environment.Job instance at 0x7f33c756e280>,24,26,[7 4],25,-1,76,-1,50
1,<environment.Job instance at 0x7f33c7c9f4b0>,38,16,[14  5],39,-1,92,-1,76
1,<environment.Job instance at 0x7f33c7c9f370>,42,14,[ 2 12],43,-1,95,-1,81
1,<environment.Job instance at 0x7f33c7c9f190>,45,15,[ 2 12],46,-1,109,-1,94
1,<environment.Job instance at 0x7f33c7de0d70>,64,23,[6 5],65,-1,214,-1,191
1,<environment.Job instance at 0x7f33c8a87d70>,75,15,[ 5 11],76,-1,225,-1,210
1,<environment.Job instance at 0x7f33c7a88be0>,80,26,[5 7],81,-1,240,-1,214
1,<environment.Job instance at 0x7f33c7de1690>,89,27,[5 9],90,-1,274,-1,247
1,<environment.Job instance at 0x7f33c7c96050>,93,28,[3 5],94,-1,279,-1,251
1,<environment.Job instance at 0x7f33c7c96640>,92,26,[ 1 10],93,-1,277,-1,251
1,<environment.Job instance at 0x7f33c7ac8690>,0,20,[5 8],1,-1,21,-1,1
1,<environment.Job instance at 0x7f33c75ad4b0>,6,18,[3 5],7,-1,25,-1,7
1,<environment.Job instance at 0x7f33c75adf50>,10,21,[5 2],11,-1,32,-1,11
1,<environment.Job instance at 0x7f33c75ad1e0>,12,16,[11  5],13,-1,29,-1,13
1,<environment.Job instance at 0x7f33c75adf00>,14,18,[3 8],15,-1,33,-1,15
1,<environment.Job instance at 0x7f33c7c7f870>,16,14,[3 9],17,-1,31,-1,17
1,<environment.Job instance at 0x7f33c7c7f0f0>,21,17,[2 9],22,-1,39,-1,22
1,<environment.Job instance at 0x7f33c892b7d0>,26,12,[9 1],27,-1,39,-1,27
1,<environment.Job instance at 0x7f33c892b8c0>,28,14,[7 3],29,-1,43,-1,29
1,<environment.Job instance at 0x7f33c8314af0>,33,2,[4 7],34,-1,36,-1,34
1,<environment.Job instance at 0x7f33c83140a0>,34,18,[6 3],35,-1,53,-1,35
1,<environment.Job instance at 0x7f33c8314c80>,35,23,[7 4],36,-1,59,-1,36
1,<environment.Job instance at 0x7f33c8314dc0>,36,23,[5 6],37,-1,60,-1,37
1,<environment.Job instance at 0x7f33c8314eb0>,37,16,[2 6],38,-1,54,-1,38
1,<environment.Job instance at 0x7f33c8314a00>,38,25,[ 5 10],39,-1,64,-1,39
1,<environment.Job instance at 0x7f33c83146e0>,39,15,[5 3],40,-1,55,-1,40
1,<environment.Job instance at 0x7f33c8314410>,40,17,[6 4],41,-1,58,-1,41
1,<environment.Job instance at 0x7f33c8314d70>,42,18,[9 5],43,-1,62,-1,44
1,<environment.Job instance at 0x7f33c8314f00>,45,15,[9 5],46,-1,61,-1,46
1,<environment.Job instance at 0x7f33c8314f50>,48,14,[3 8],49,-1,63,-1,49
1,<environment.Job instance at 0x7f33c866d460>,51,16,[8 5],52,-1,68,-1,52
1,<environment.Job instance at 0x7f33c866d730>,53,17,[ 5 12],54,-1,71,-1,54
1,<environment.Job instance at 0x7f33c866de10>,54,17,[5 7],55,-1,72,-1,55
1,<environment.Job instance at 0x7f33c866db90>,55,12,[5 1],56,-1,68,-1,56
1,<environment.Job instance at 0x7f33c865b190>,58,15,[6 1],59,-1,74,-1,59
1,<environment.Job instance at 0x7f33c865b370>,63,20,[5 2],64,-1,84,-1,64
1,<environment.Job instance at 0x7f33c878f0a0>,64,12,[ 4 10],65,-1,77,-1,65
1,<environment.Job instance at 0x7f33c878fd70>,65,15,[8 2],66,-1,84,-1,69
1,<environment.Job instance at 0x7f33c878f3c0>,69,14,[8 5],70,-1,84,-1,70
1,<environment.Job instance at 0x7f33c7cc8140>,80,25,[8 3],81,-1,106,-1,81
1,<environment.Job instance at 0x7f33c7cc8460>,81,27,[8 1],82,-1,109,-1,82
1,<environment.Job instance at 0x7f33c7cc8640>,86,17,[3 8],87,-1,105,-1,88
1,<environment.Job instance at 0x7f33c7cc8e60>,89,18,[5 2],90,-1,113,-1,95
1,<environment.Job instance at 0x7f33c7f5c230>,92,13,[9 4],93,-1,110,-1,97
1,<environment.Job instance at 0x7f33c83141e0>,47,26,[ 2 10],48,-1,123,-1,97
1,<environment.Job instance at 0x7f33c878f230>,68,12,[12  2],69,-1,109,-1,97
1,<environment.Job instance at 0x7f33c7cc8730>,87,27,[2 6],88,-1,124,-1,97
1,<environment.Job instance at 0x7f33c7f5c410>,95,18,[5 5],96,-1,116,-1,98
1,<environment.Job instance at 0x7f33c7f5cfa0>,97,26,[ 5 10],98,-1,124,-1,98
1,<environment.Job instance at 0x7f33c7f5cb90>,98,14,[3 7],99,-1,113,-1,99
1,<environment.Job instance at 0x7f33c866d7d0>,9,14,[ 1 13],10,-1,24,-1,10
1,<environment.Job instance at 0x7f33c865bd20>,12,16,[11  5],13,-1,37,-1,21
1,<environment.Job instance at 0x7f33c7de01e0>,35,23,[7 4],36,-1,111,-1,88
1,<environment.Job instance at 0x7f33c7de0050>,36,23,[5 6],37,-1,111,-1,88
1,<environment.Job instance at 0x7f33c7de0d20>,41,12,[ 5 11],42,-1,116,-1,104
1,<environment.Job instance at 0x7f33c756eeb0>,47,26,[ 2 10],48,-1,152,-1,126
1,<environment.Job instance at 0x7f33c7de0af0>,38,25,[ 5 10],39,-1,165,-1,140
1,<environment.Job instance at 0x7f33c756ec80>,53,17,[ 5 12],54,-1,157,-1,140
1,<environment.Job instance at 0x7f33c8a94b90>,67,2,[ 5 11],68,-1,184,-1,182
1,<environment.Job instance at 0x7f33c8ac0050>,68,12,[12  2],69,-1,194,-1,182
1,<environment.Job instance at 0x7f33c8ab91e0>,70,2,[ 4 14],71,-1,185,-1,183
1,<environment.Job instance at 0x7f33c8c75730>,80,25,[8 3],81,-1,251,-1,226
1,<environment.Job instance at 0x7f33c7f33870>,81,27,[8 1],82,-1,253,-1,226
1,<environment.Job instance at 0x7f33c88840a0>,87,27,[2 6],88,-1,272,-1,245
1,<environment.Job instance at 0x7f33c7ee2190>,97,26,[ 5 10],98,-1,294,-1,268
1,<environment.Job instance at 0x7f33c8010af0>,0,17,[4 8],1,-1,18,-1,1
1,<environment.Job instance at 0x7f33c8e6aa00>,1,17,[3 6],2,-1,19,-1,2
1,<environment.Job instance at 0x7f33c78cea00>,2,17,[ 4 10],3,-1,21,-1,4
1,<environment.Job instance at 0x7f33c8e0ed70>,9,18,[5 5],10,-1,28,-1,10
1,<environment.Job instance at 0x7f33c8c197d0>,11,18,[5 5],12,-1,30,-1,12
1,<environment.Job instance at 0x7f33c8e0e5a0>,12,28,[5 1],13,-1,41,-1,13
1,<environment.Job instance at 0x7f33c83594b0>,16,17,[3 7],17,-1,34,-1,17
1,<environment.Job instance at 0x7f33c7a30190>,21,17,[ 4 10],22,-1,39,-1,22
1,<environment.Job instance at 0x7f33c7a30870>,24,23,[2 9],25,-1,48,-1,25
1,<environment.Job instance at 0x7f33c7d5e280>,25,18,[5 3],26,-1,44,-1,26
1,<environment.Job instance at 0x7f33c7d1e370>,32,16,[9 2],33,-1,50,-1,34
1,<environment.Job instance at 0x7f33c7d1ea50>,33,15,[5 8],34,-1,50,-1,35
1,<environment.Job instance at 0x7f33c7cf9a00>,38,26,[2 5],39,-1,65,-1,39
1,<environment.Job instance at 0x7f33c7db3dc0>,39,28,[4 8],40,-1,68,-1,40
1,<environment.Job instance at 0x7f33c89bf4b0>,40,28,[1 5],41,-1,69,-1,41
1,<environment.Job instance at 0x7f33c8750910>,43,13,[10  1],44,-1,60,-1,47
1,<environment.Job instance at 0x7f33c8cecaf0>,47,28,[ 1 10],48,-1,76,-1,48
1,<environment.Job instance at 0x7f33c7a506e0>,48,18,[5 5],49,-1,68,-1,50
1,<environment.Job instance at 0x7f33c7d1ee60>,31,17,[6 1],32,-1,67,-1,50
1,<environment.Job instance at 0x7f33d197b6e0>,49,15,[3 6],50,-1,65,-1,50
1,<environment.Job instance at 0x7f33c8a372d0>,54,18,[ 2 10],55,-1,73,-1,55
1,<environment.Job instance at 0x7f33c89f5e10>,58,14,[9 3],59,-1,73,-1,59
1,<environment.Job instance at 0x7f33c79e45f0>,62,18,[7 2],63,-1,81,-1,63
1,<environment.Job instance at 0x7f33c833e460>,64,16,[5 8],65,-1,81,-1,65
1,<environment.Job instance at 0x7f33c7ea2320>,46,22,[7 4],47,-1,87,-1,65
1,<environment.Job instance at 0x7f33c833e280>,65,16,[2 7],66,-1,84,-1,68
1,<environment.Job instance at 0x7f33c7d1ebe0>,30,12,[ 4 10],31,-1,86,-1,74
1,<environment.Job instance at 0x7f33c7c01690>,70,13,[8 2],71,-1,87,-1,74
1,<environment.Job instance at 0x7f33c830ddc0>,74,13,[6 5],75,-1,88,-1,75
1,<environment.Job instance at 0x7f33c830dd20>,75,13,[6 1],76,-1,89,-1,76
1,<environment.Job instance at 0x7f33c830df00>,76,20,[10  4],77,-1,97,-1,77
1,<environment.Job instance at 0x7f33c7cde4b0>,85,17,[5 8],86,-1,103,-1,86
1,<environment.Job instance at 0x7f33c8360c30>,90,16,[8 2],91,-1,107,-1,91
1,<environment.Job instance at 0x7f33c8df8820>,69,16,[ 3 10],70,-1,107,-1,91
1,<environment.Job instance at 0x7f33c8360e10>,91,12,[9 4],92,-1,105,-1,93
1,<environment.Job instance at 0x7f33c81535f0>,93,24,[9 2],94,-1,118,-1,94
1,<environment.Job instance at 0x7f33c84ab3c0>,94,13,[6 5],95,-1,108,-1,95
1,<environment.Job instance at 0x7f33c7a30fa0>,4,1,[ 1 11],5,-1,6,-1,5
1,<environment.Job instance at 0x7f33c80b88c0>,5,1,[ 3 14],6,-1,7,-1,6
1,<environment.Job instance at 0x7f33c8305460>,12,28,[5 1],13,-1,48,-1,20
1,<environment.Job instance at 0x7f33c7cde050>,19,13,[ 1 13],20,-1,55,-1,42
1,<environment.Job instance at 0x7f33c7682370>,24,23,[2 9],25,-1,70,-1,47
1,<environment.Job instance at 0x7f33c7de08c0>,26,3,[14  4],27,-1,50,-1,47
1,<environment.Job instance at 0x7f33c7e11cd0>,38,26,[2 5],39,-1,123,-1,97
1,<environment.Job instance at 0x7f33c7de1f00>,40,28,[1 5],41,-1,128,-1,100
1,<environment.Job instance at 0x7f33c7e11910>,39,28,[4 8],40,-1,138,-1,110
1,<environment.Job instance at 0x7f33c7c7f5a0>,47,28,[ 1 10],48,-1,146,-1,118
1,<environment.Job instance at 0x7f33c7a6c5a0>,93,24,[9 2],94,-1,281,-1,257
1,<environment.Job instance at 0x7f33c8190a50>,0,12,[9 2],1,-1,14,-1,2
1,<environment.Job instance at 0x7f33c85007d0>,2,15,[4 9],3,-1,18,-1,3
1,<environment.Job instance at 0x7f33c7de0280>,1,24,[2 6],2,-1,27,-1,3
1,<environment.Job instance at 0x7f33d151f910>,9,16,[ 1 10],10,-1,26,-1,10
1,<environment.Job instance at 0x7f33c8250050>,13,21,[5 4],14,-1,35,-1,14
1,<environment.Job instance at 0x7f33c862fb40>,16,12,[10  3],17,-1,32,-1,20
1,<environment.Job instance at 0x7f33c8b717d0>,22,18,[10  3],23,-1,41,-1,23
1,<environment.Job instance at 0x7f33c7f82280>,24,24,[5 8],25,-1,49,-1,25
1,<environment.Job instance at 0x7f33c7f82c80>,26,24,[10  2],27,-1,51,-1,27
1,<environment.Job instance at 0x7f33c8b71be0>,27,18,[3 8],28,-1,46,-1,28
1,<environment.Job instance at 0x7f33c83faaf0>,29,12,[1 5],30,-1,42,-1,30
1,<environment.Job instance at 0x7f33c8311870>,32,13,[3 6],33,-1,46,-1,33
1,<environment.Job instance at 0x7f33c8311c80>,33,17,[7 2],34,-1,51,-1,34
1,<environment.Job instance at 0x7f33c8571d70>,34,18,[1 8],35,-1,53,-1,35
1,<environment.Job instance at 0x7f33c8233960>,36,23,[9 5],37,-1,60,-1,37
1,<environment.Job instance at 0x7f33c7f82370>,37,18,[1 8],38,-1,56,-1,38
1,<environment.Job instance at 0x7f33c8405190>,39,17,[6 3],40,-1,57,-1,40
1,<environment.Job instance at 0x7f33c82f5dc0>,42,18,[1 6],43,-1,61,-1,43
1,<environment.Job instance at 0x7f33c82f5f00>,43,17,[10  3],44,-1,61,-1,44
1,<environment.Job instance at 0x7f33c82f0d20>,45,16,[7 4],46,-1,62,-1,46
1,<environment.Job instance at 0x7f33c82e1820>,52,17,[6 3],53,-1,70,-1,53
1,<environment.Job instance at 0x7f33c82e1730>,53,27,[5 6],54,-1,81,-1,54
1,<environment.Job instance at 0x7f33c7bd1870>,56,16,[ 3 11],57,-1,73,-1,57
1,<environment.Job instance at 0x7f33c7bd1e10>,61,12,[10  1],62,-1,77,-1,65
1,<environment.Job instance at 0x7f33c7bbd4b0>,67,18,[4 5],68,-1,86,-1,68
1,<environment.Job instance at 0x7f33c7bbd500>,69,17,[7 5],70,-1,87,-1,70
1,<environment.Job instance at 0x7f33c7bbdb40>,75,27,[4 6],76,-1,107,-1,80
1,<environment.Job instance at 0x7f33c7bbd0f0>,64,27,[3 8],65,-1,107,-1,80
1,<environment.Job instance at 0x7f33c7bd1f50>,62,16,[7 1],63,-1,108,-1,92
1,<environment.Job instance at 0x7f33c7bbda50>,80,16,[10  3],81,-1,113,-1,97
1,<environment.Job instance at 0x7f33c7bb40f0>,83,12,[9 4],84,-1,109,-1,97
1,<environment.Job instance at 0x7f33c7bb4320>,86,15,[5 2],87,-1,112,-1,97
1,<environment.Job instance at 0x7f33c7bbdc80>,77,1,[1 7],78,-1,100,-1,99
1,<environment.Job instance at 0x7f33c7bb45a0>,90,14,[11  5],91,-1,116,-1,102
1,<environment.Job instance at 0x7f33c7bb4640>,91,13,[ 1 10],92,-1,115,-1,102
1,<environment.Job instance at 0x7f33c7bb4870>,92,17,[3 8],93,-1,119,-1,102
1,<environment.Job instance at 0x7f33c7bb41e0>,84,2,[9 3],85,-1,105,-1,103
1,<environment.Job instance at 0x7f33c8e6bf50>,1,24,[2 6],2,-1,26,-1,2
1,<environment.Job instance at 0x7f33c7bd1aa0>,14,17,[11  5],15,-1,38,-1,21
1,<environment.Job instance at 0x7f33c7bbd190>,15,15,[ 2 12],16,-1,36,-1,21
1,<environment.Job instance at 0x7f33c8500be0>,24,24,[5 8],25,-1,73,-1,49
1,<environment.Job instance at 0x7f33c7a6c460>,26,24,[10  2],27,-1,79,-1,55
1,<environment.Job instance at 0x7f33c7a6cc30>,30,2,[14  3],31,-1,58,-1,56
1,<environment.Job instance at 0x7f33c7a6ccd0>,36,23,[9 5],37,-1,129,-1,106
1,<environment.Job instance at 0x7f33d14a6b40>,49,1,[13  5],50,-1,129,-1,128
1,<environment.Job instance at 0x7f33c85bbf50>,53,27,[5 6],54,-1,184,-1,157
1,<environment.Job instance at 0x7f33c870a050>,56,16,[ 3 11],57,-1,173,-1,157
1,<environment.Job instance at 0x7f33c870a5f0>,58,25,[11  1],59,-1,182,-1,157
1,<environment.Job instance at 0x7f33c8e64f50>,64,27,[3 8],65,-1,191,-1,164
1,<environment.Job instance at 0x7f33c7de1690>,70,18,[12  3],71,-1,196,-1,178
1,<environment.Job instance at 0x7f33c7de0b40>,75,27,[4 6],76,-1,231,-1,204
1,<environment.Job instance at 0x7f33c833e050>,90,14,[11  5],91,-1,269,-1,255
1,<environment.Job instance at 0x7f33c87741e0>,94,28,[4 7],95,-1,317,-1,289
1,<environment.Job instance at 0x7fdaee6fd6e0>,0,13,[9 3],1,-1,15,-1,2
1,<environment.Job instance at 0x7fdaee6fd8c0>,1,22,[11  3],2,-1,24,-1,2
1,<environment.Job instance at 0x7fdaee6fd730>,2,22,[4 8],3,-1,25,-1,3
1,<environment.Job instance at 0x7fdae510dfa0>,9,18,[11  5],10,-1,28,-1,10
1,<environment.Job instance at 0x7fdae51100f0>,11,15,[4 8],12,-1,27,-1,12
1,<environment.Job instance at 0x7fdae5110320>,12,26,[ 1 10],13,-1,39,-1,13
1,<environment.Job instance at 0x7fdae5110230>,13,18,[ 4 10],14,-1,32,-1,14
1,<environment.Job instance at 0x7fdae5110460>,15,18,[2 8],16,-1,34,-1,16
1,<environment.Job instance at 0x7fdae5110640>,16,16,[3 5],17,-1,33,-1,17
1,<environment.Job instance at 0x7fdae5110870>,19,14,[3 5],20,-1,34,-1,20
1,<environment.Job instance at 0x7fdae5110b90>,23,27,[1 6],24,-1,51,-1,24
1,<environment.Job instance at 0x7fdae5110c30>,24,18,[2 6],25,-1,43,-1,25
1,<environment.Job instance at 0x7fdae5110e60>,26,3,[3 7],27,-1,30,-1,27
1,<environment.Job instance at 0x7fdae5110d70>,27,15,[8 4],28,-1,43,-1,28
1,<environment.Job instance at 0x7fdae51130a0>,28,23,[10  4],29,-1,52,-1,29
1,<environment.Job instance at 0x7fdae5113140>,29,12,[5 4],30,-1,42,-1,30
1,<environment.Job instance at 0x7fdae51131e0>,30,14,[5 2],31,-1,45,-1,31
1,<environment.Job instance at 0x7fdae5113460>,33,14,[5 5],34,-1,48,-1,34
1,<environment.Job instance at 0x7fdae51135f0>,34,24,[1 8],35,-1,59,-1,35
1,<environment.Job instance at 0x7fdae5113550>,35,15,[9 5],36,-1,51,-1,36
1,<environment.Job instance at 0x7fdae5113640>,40,15,[10  3],41,-1,59,-1,44
1,<environment.Job instance at 0x7fdae5113af0>,43,18,[5 5],44,-1,62,-1,44
1,<environment.Job instance at 0x7fdae5115190>,48,15,[10  1],49,-1,65,-1,50
1,<environment.Job instance at 0x7fdae51157d0>,53,17,[5 7],54,-1,71,-1,54
1,<environment.Job instance at 0x7fdae5115a00>,56,17,[8 5],57,-1,74,-1,57
1,<environment.Job instance at 0x7fdae5115d70>,59,17,[1 6],60,-1,77,-1,60
1,<environment.Job instance at 0x7fdae51190a0>,62,22,[6 4],63,-1,85,-1,63
1,<environment.Job instance at 0x7fdae5119190>,64,18,[2 9],65,-1,83,-1,65
1,<environment.Job instance at 0x7fdae5119410>,65,20,[2 6],66,-1,86,-1,66
1,<environment.Job instance at 0x7fdae51195f0>,69,13,[ 3 12],70,-1,90,-1,77
1,<environment.Job instance at 0x7fdae5119dc0>,75,14,[ 4 11],76,-1,92,-1,78
1,<environment.Job instance at 0x7fdae5119d70>,77,13,[8 5],78,-1,91,-1,78
1,<environment.Job instance at 0x7fdae5119c80>,78,12,[10  2],79,-1,91,-1,79
1,<environment.Job instance at 0x7fdae5119e60>,76,19,[4 8],77,-1,99,-1,80
1,<environment.Job instance at 0x7fdae511c140>,79,13,[9 4],80,-1,93,-1,80
1,<environment.Job instance at 0x7fdae511c1e0>,81,15,[5 9],82,-1,105,-1,90
1,<environment.Job instance at 0x7fdae5115370>,49,16,[2 5],50,-1,106,-1,90
1,<environment.Job instance at 0x7fdae511c640>,86,18,[9 2],87,-1,108,-1,90
1,<environment.Job instance at 0x7fdae511c500>,84,18,[3 7],85,-1,108,-1,90
1,<environment.Job instance at 0x7fdae5110730>,1,22,[11  3],2,-1,24,-1,2
1,<environment.Job instance at 0x7fdae5115e10>,9,18,[11  5],10,-1,32,-1,14
1,<environment.Job instance at 0x7fdae51190f0>,12,26,[ 1 10],13,-1,82,-1,56
1,<environment.Job instance at 0x7fdae55dcaa0>,23,27,[1 6],24,-1,87,-1,60
1,<environment.Job instance at 0x7fdae51cf550>,28,23,[10  4],29,-1,97,-1,74
1,<environment.Job instance at 0x7fdae5130e60>,34,24,[1 8],35,-1,117,-1,93
1,<environment.Job instance at 0x7fdae519e190>,36,13,[ 3 14],37,-1,106,-1,93
1,<environment.Job instance at 0x7fdae5135230>,46,17,[12  2],47,-1,134,-1,117
1,<environment.Job instance at 0x7fdae5135cd0>,50,16,[12  2],51,-1,146,-1,130
1,<environment.Job instance at 0x7fdae5234370>,54,13,[13  1],55,-1,158,-1,145
1,<environment.Job instance at 0x7fdae52308c0>,60,3,[12  3],61,-1,169,-1,166
1,<environment.Job instance at 0x7fdae51bdf00>,67,27,[ 1 10],68,-1,216,-1,189
1,<environment.Job instance at 0x7fdae51bd3c0>,69,13,[ 3 12],70,-1,202,-1,189
1,<environment.Job instance at 0x7fdae51bd2d0>,75,14,[ 4 11],76,-1,215,-1,201
1,<environment.Job instance at 0x7fdae5148be0>,97,2,[ 5 11],98,-1,294,-1,292
1,<environment.Job instance at 0x7fdae5148460>,99,18,[12  5],100,-1,312,-1,294
1,<environment.Job instance at 0x7fdae5166e10>,105,14,[14  5],106,-1,341,-1,327
1,<environment.Job instance at 0x7fdae5166190>,106,15,[11  1],107,-1,342,-1,327
1,<environment.Job instance at 0x7fdae485a730>,1,26,[ 5 10],2,-1,28,-1,2
1,<environment.Job instance at 0x7fdae50a8730>,5,16,[7 5],6,-1,22,-1,6
1,<environment.Job instance at 0x7fdae48581e0>,9,20,[2 6],10,-1,30,-1,10
1,<environment.Job instance at 0x7fdae4854a50>,15,21,[4 5],16,-1,38,-1,17
1,<environment.Job instance at 0x7fdae48543c0>,17,22,[4 5],18,-1,40,-1,18
1,<environment.Job instance at 0x7fdae484f410>,23,16,[ 3 10],24,-1,40,-1,24
1,<environment.Job instance at 0x7fdae49385a0>,28,16,[11  2],29,-1,51,-1,35
1,<environment.Job instance at 0x7fdae4990780>,31,13,[5 6],32,-1,48,-1,35
1,<environment.Job instance at 0x7fdae4938780>,27,20,[9 2],28,-1,57,-1,37
1,<environment.Job instance at 0x7fdae46d0550>,36,17,[1 7],37,-1,55,-1,38
1,<environment.Job instance at 0x7fdae4982d70>,30,16,[2 8],31,-1,69,-1,53
1,<environment.Job instance at 0x7fdae4730190>,41,15,[10  4],42,-1,69,-1,54
1,<environment.Job instance at 0x7fdae4790d70>,44,14,[8 4],45,-1,69,-1,55
1,<environment.Job instance at 0x7fdae4ffe9b0>,48,14,[9 5],49,-1,70,-1,56
1,<environment.Job instance at 0x7fdaee7277d0>,42,14,[1 8],43,-1,71,-1,57
1,<environment.Job instance at 0x7fdae4858050>,53,15,[5 2],54,-1,86,-1,71
1,<environment.Job instance at 0x7fdae4996fa0>,33,15,[ 1 12],34,-1,116,-1,101
1,<environment.Job instance at 0x7fdae46a5460>,63,18,[6 5],64,-1,119,-1,101
1,<environment.Job instance at 0x7fdae46a53c0>,67,21,[ 3 10],68,-1,122,-1,101
1,<environment.Job instance at 0x7fdae46a8af0>,71,13,[8 5],72,-1,114,-1,101
1,<environment.Job instance at 0x7fdae46a58c0>,72,14,[2 9],73,-1,115,-1,101
1,<environment.Job instance at 0x7fdae46a5280>,66,2,[11  5],67,-1,103,-1,101
1,<environment.Job instance at 0x7fdae46a84b0>,75,2,[5 2],76,-1,103,-1,101
1,<environment.Job instance at 0x7fdae46a8370>,77,1,[2 9],78,-1,102,-1,101
1,<environment.Job instance at 0x7fdae46a8190>,78,21,[9 4],79,-1,126,-1,105
1,<environment.Job instance at 0x7fdae46a85f0>,79,12,[9 3],80,-1,117,-1,105
1,<environment.Job instance at 0x7fdae46a8d70>,80,18,[10  3],81,-1,123,-1,105
1,<environment.Job instance at 0x7fdae46a8140>,81,17,[10  2],82,-1,122,-1,105
1,<environment.Job instance at 0x7fdae4855d70>,82,3,[10  2],83,-1,108,-1,105
1,<environment.Job instance at 0x7fdae46a5140>,69,14,[2 6],70,-1,119,-1,105
1,<environment.Job instance at 0x7fdae4855690>,84,12,[3 8],85,-1,117,-1,105
1,<environment.Job instance at 0x7fdae4855460>,86,14,[5 5],87,-1,119,-1,105
1,<environment.Job instance at 0x7fdae470caf0>,91,14,[1 6],92,-1,119,-1,105
1,<environment.Job instance at 0x7fdae46af4b0>,90,13,[10  5],91,-1,118,-1,105
1,<environment.Job instance at 0x7fdae48555f0>,85,1,[6 2],86,-1,107,-1,106
1,<environment.Job instance at 0x7fdae46a71e0>,93,14,[7 5],94,-1,120,-1,106
1,<environment.Job instance at 0x7fdae46a7be0>,95,14,[10  2],96,-1,120,-1,106
1,<environment.Job instance at 0x7fdae46a75a0>,94,3,[9 2],95,-1,109,-1,106
1,<environment.Job instance at 0x7fdae46a7dc0>,98,2,[13  1],99,-1,108,-1,106
1,<environment.Job instance at 0x7fdae46a7460>,92,14,[2 7],93,-1,120,-1,106
1,<environment.Job instance at 0x7fdae46a6690>,99,2,[10  4],100,-1,108,-1,106
1,<environment.Job instance at 0x7fdae482a730>,55,13,[ 1 14],56,-1,120,-1,107
1,<environment.Job instance at 0x7fdae470c550>,88,12,[14  4],89,-1,124,-1,112
1,<environment.Job instance at 0x7fdae46a3730>,104,16,[7 2],105,-1,128,-1,112
1,<environment.Job instance at 0x7fdae46b6370>,106,12,[ 3 10],107,-1,125,-1,113
1,<environment.Job instance at 0x7fdae4858820>,1,26,[ 5 10],2,-1,28,-1,2
1,<environment.Job instance at 0x7fdae46a3cd0>,6,3,[ 1 12],7,-1,10,-1,7
1,<environment.Job instance at 0x7fdaee868e60>,12,3,[ 4 12],13,-1,22,-1,19
1,<environment.Job instance at 0x7fdae48e7b90>,13,12,[ 4 11],14,-1,31,-1,19
1,<environment.Job instance at 0x7fdae48b1190>,18,23,[ 2 14],19,-1,44,-1,21
1,<environment.Job instance at 0x7fdae48af870>,28,16,[11  2],29,-1,55,-1,39
1,<environment.Job instance at 0x7fdae48b92d0>,29,18,[ 1 12],30,-1,57,-1,39
1,<environment.Job instance at 0x7fdae48c4eb0>,33,15,[ 1 12],34,-1,63,-1,48
1,<environment.Job instance at 0x7fdae48b50f0>,35,3,[ 4 13],36,-1,54,-1,51
1,<environment.Job instance at 0x7fdae48b5910>,37,1,[ 1 14],38,-1,54,-1,53
1,<environment.Job instance at 0x7fdae4915a00>,50,3,[13  3],51,-1,114,-1,111
1,<environment.Job instance at 0x7fdae48d7870>,55,13,[ 1 14],56,-1,129,-1,116
1,<environment.Job instance at 0x7fdae48c1280>,66,2,[11  5],67,-1,139,-1,137
1,<environment.Job instance at 0x7fdae48ddfa0>,68,3,[14  4],69,-1,147,-1,144
1,<environment.Job instance at 0x7fdae4947f50>,88,12,[14  4],89,-1,240,-1,228
1,<environment.Job instance at 0x7fdae48780a0>,98,2,[13  1],99,-1,271,-1,269
1,<environment.Job instance at 0x7fdae48e1b90>,101,3,[13  5],102,-1,274,-1,271
1,<environment.Job instance at 0x7fdae48e1370>,102,2,[ 1 12],103,-1,273,-1,271
1,<environment.Job instance at 0x7fdae485d8c0>,0,18,[4 5],1,-1,19,-1,1
1,<environment.Job instance at 0x7fdae485d410>,1,18,[2 8],2,-1,20,-1,2
1,<environment.Job instance at 0x7fdae485de60>,4,16,[9 4],5,-1,23,-1,7
1,<environment.Job instance at 0x7fdae485d870>,6,14,[10  1],7,-1,21,-1,7
1,<environment.Job instance at 0x7fdae485d2d0>,7,16,[9 2],8,-1,25,-1,9
1,<environment.Job instance at 0x7fdaee86deb0>,8,15,[7 5],9,-1,24,-1,9
1,<environment.Job instance at 0x7fdaee86d050>,16,19,[2 7],17,-1,36,-1,17
1,<environment.Job instance at 0x7fdae46b6f50>,23,24,[7 4],24,-1,49,-1,25
1,<environment.Job instance at 0x7fdae46b6b90>,26,16,[7 4],27,-1,43,-1,27
1,<environment.Job instance at 0x7fdae46b6460>,28,18,[4 6],29,-1,47,-1,29
1,<environment.Job instance at 0x7fdae4789140>,31,27,[4 7],32,-1,59,-1,32
1,<environment.Job instance at 0x7fdae4789230>,32,26,[8 4],33,-1,59,-1,33
1,<environment.Job instance at 0x7fdae46b6cd0>,24,16,[7 5],25,-1,53,-1,37
1,<environment.Job instance at 0x7fdae4789af0>,37,17,[5 2],38,-1,55,-1,38
1,<environment.Job instance at 0x7fdae4789690>,38,18,[4 5],39,-1,57,-1,39
1,<environment.Job instance at 0x7fdae470c140>,48,15,[3 6],49,-1,65,-1,50
1,<environment.Job instance at 0x7fdae470c7d0>,50,17,[2 6],51,-1,68,-1,51
1,<environment.Job instance at 0x7fdae47895a0>,2,1,[ 4 13],3,-1,4,-1,3
1,<environment.Job instance at 0x7fdae4704fa0>,3,14,[11  3],4,-1,18,-1,4
1,<environment.Job instance at 0x7fdae4d41aa0>,20,24,[ 1 10],21,-1,68,-1,44
1,<environment.Job instance at 0x7fdae5c51370>,23,24,[7 4],24,-1,75,-1,51
1,<environment.Job instance at 0x7fdaf6238190>,25,3,[12  3],26,-1,54,-1,51
1,<environment.Job instance at 0x7fdae4a64960>,31,27,[4 7],32,-1,97,-1,70
1,<environment.Job instance at 0x7fdae4a64af0>,32,26,[8 4],33,-1,99,-1,73
1,<environment.Job instance at 0x7fdae4a10d20>,35,16,[14  1],36,-1,92,-1,76
1,<environment.Job instance at 0x7fdae5893f50>,40,25,[ 3 10],41,-1,122,-1,97
1,<environment.Job instance at 0x7fdae4a4cd20>,56,28,[6 5],57,-1,177,-1,149
1,<environment.Job instance at 0x7fdae493eeb0>,53,23,[10  1],54,-1,181,-1,158
1,<environment.Job instance at 0x7fdae4a27dc0>,61,15,[14  1],62,-1,173,-1,158
1,<environment.Job instance at 0x7fdae4a27730>,65,18,[11  3],66,-1,178,-1,160
1,<environment.Job instance at 0x7fdae4f947d0>,69,28,[5 3],70,-1,193,-1,165
1,<environment.Job instance at 0x7fdae492c190>,82,25,[6 3],83,-1,239,-1,214
1,<environment.Job instance at 0x7fdae4d38fa0>,99,18,[13  1],100,-1,286,-1,268
1,<environment.Job instance at 0x7fdae494f460>,102,3,[ 3 11],103,-1,273,-1,270
1,<environment.Job instance at 0x7fdae4ee3230>,6,16,[ 5 10],7,-1,44,-1,28
1,<environment.Job instance at 0x7fdae4704280>,24,18,[3 6],25,-1,46,-1,28
1,<environment.Job instance at 0x7fdae4704500>,19,16,[5 4],20,-1,44,-1,28
1,<environment.Job instance at 0x7fdae4ee3e10>,3,24,[10  5],4,-1,130,-1,106
1,<environment.Job instance at 0x7fdae4d9c8c0>,30,27,[ 5 10],31,-1,133,-1,106
1,<environment.Job instance at 0x7fdae4d9c4b0>,32,12,[3 8],33,-1,118,-1,106
1,<environment.Job instance at 0x7fdae4d9c0a0>,36,25,[ 5 10],37,-1,132,-1,107
1,<environment.Job instance at 0x7fdae4d9c5a0>,37,15,[5 3],38,-1,122,-1,107
1,<environment.Job instance at 0x7fdae4d9c910>,34,15,[4 6],35,-1,124,-1,109
1,<environment.Job instance at 0x7fdae4ee32d0>,11,17,[10  3],12,-1,126,-1,109
1,<environment.Job instance at 0x7fdae4d858c0>,50,14,[7 5],51,-1,124,-1,110
1,<environment.Job instance at 0x7fdae4bebeb0>,0,24,[2 8],1,-1,25,-1,1
1,<environment.Job instance at 0x7fdae4aaa4b0>,1,24,[9 1],2,-1,26,-1,2
1,<environment.Job instance at 0x7fdae4ee35f0>,3,24,[10  5],4,-1,30,-1,6
1,<environment.Job instance at 0x7fdae50b0050>,4,23,[10  2],5,-1,29,-1,6
1,<environment.Job instance at 0x7fdae4ee3500>,5,15,[ 1 11],6,-1,21,-1,6
1,<environment.Job instance at 0x7fdae4a27c80>,17,15,[ 3 12],18,-1,41,-1,26
1,<environment.Job instance at 0x7fdae4ec50a0>,30,27,[ 5 10],31,-1,97,-1,70
1,<environment.Job instance at 0x7fdae5a814b0>,36,25,[ 5 10],37,-1,116,-1,91
1,<environment.Job instance at 0x7fdaee877370>,52,17,[12  4],53,-1,149,-1,132
1,<environment.Job instance at 0x7fdae488baf0>,65,2,[ 4 11],66,-1,170,-1,168
1,<environment.Job instance at 0x7fdae4becf00>,73,2,[ 2 14],74,-1,204,-1,202
1,<environment.Job instance at 0x7fdae488be60>,74,17,[ 5 14],75,-1,219,-1,202
1,<environment.Job instance at 0x7fdae4becc30>,76,2,[11  3],77,-1,204,-1,202
1,<environment.Job instance at 0x7fdae4becbe0>,77,2,[12  2],78,-1,204,-1,202
1,<environment.Job instance at 0x7fdae4bec0a0>,82,2,[12  5],83,-1,233,-1,231
1,<environment.Job instance at 0x7fdae4bec1e0>,84,1,[14  4],85,-1,232,-1,231
1,<environment.Job instance at 0x7fdae470edc0>,103,1,[ 5 12],104,-1,303,-1,302
1,<environment.Job instance at 0x7fdae4f5d5f0>,0,18,[4 7],1,-1,19,-1,1
1,<environment.Job instance at 0x7fdae4df8190>,8,15,[8 5],9,-1,25,-1,10
1,<environment.Job instance at 0x7fdae4c18140>,9,27,[1 5],10,-1,39,-1,12
1,<environment.Job instance at 0x7fdae5c35b40>,20,12,[8 5],21,-1,37,-1,25
1,<environment.Job instance at 0x7fdae4dfcb40>,17,19,[14  4],18,-1,44,-1,25
1,<environment.Job instance at 0x7fdae4e1bc30>,22,18,[6 3],23,-1,43,-1,25
1,<environment.Job instance at 0x7fdae4de5280>,19,14,[ 5 11],20,-1,39,-1,25
1,<environment.Job instance at 0x7fdae4e1be60>,26,25,[3 8],27,-1,52,-1,27
1,<environment.Job instance at 0x7fdae47f3f00>,32,24,[ 3 10],33,-1,57,-1,33
1,<environment.Job instance at 0x7fdae5533500>,30,15,[7 5],31,-1,48,-1,33
1,<environment.Job instance at 0x7fdae5c33140>,34,17,[8 5],35,-1,52,-1,35
1,<environment.Job instance at 0x7fdae4e1b460>,25,16,[6 3],26,-1,77,-1,61
1,<environment.Job instance at 0x7fdae47e5190>,38,27,[1 7],39,-1,88,-1,61
1,<environment.Job instance at 0x7fdae5c49820>,29,27,[9 3],30,-1,102,-1,75
1,<environment.Job instance at 0x7fdae55535a0>,40,19,[6 3],41,-1,94,-1,75
1,<environment.Job instance at 0x7fdae4809c80>,44,16,[10  3],45,-1,91,-1,75
1,<environment.Job instance at 0x7fdae480f640>,48,14,[10  3],49,-1,89,-1,75
1,<environment.Job instance at 0x7fdae47e8190>,52,18,[10  4],53,-1,96,-1,78
1,<environment.Job instance at 0x7fdae480fbe0>,50,19,[1 5],51,-1,100,-1,81
1,<environment.Job instance at 0x7fdae47e84b0>,57,18,[5 1],58,-1,101,-1,83
1,<environment.Job instance at 0x7fdae47e8550>,59,15,[9 5],60,-1,98,-1,83
1,<environment.Job instance at 0x7fdae47fb3c0>,41,13,[5 5],42,-1,107,-1,94
1,<environment.Job instance at 0x7fdae47e8460>,51,18,[2 9],52,-1,114,-1,96
1,<environment.Job instance at 0x7fdae5549820>,62,15,[5 1],63,-1,113,-1,98
1,<environment.Job instance at 0x7fdae55497d0>,63,18,[5 9],64,-1,118,-1,100
1,<environment.Job instance at 0x7fdae4dfccd0>,18,17,[7 4],19,-1,117,-1,100
1,<environment.Job instance at 0x7fdae5549b90>,69,19,[9 1],70,-1,124,-1,105
1,<environment.Job instance at 0x7fdae5549eb0>,73,27,[1 8],74,-1,132,-1,105
1,<environment.Job instance at 0x7fdae5549910>,65,21,[2 5],66,-1,126,-1,105
1,<environment.Job instance at 0x7fdae5540410>,76,14,[3 9],77,-1,119,-1,105
1,<environment.Job instance at 0x7fdae55403c0>,75,12,[2 9],76,-1,117,-1,105
1,<environment.Job instance at 0x7fdae5540820>,79,13,[5 9],80,-1,118,-1,105
1,<environment.Job instance at 0x7fdae5549d70>,71,16,[6 5],72,-1,121,-1,105
1,<environment.Job instance at 0x7fdae5540230>,81,18,[8 4],82,-1,123,-1,105
1,<environment.Job instance at 0x7fdae5540d20>,84,17,[3 9],85,-1,122,-1,105
1,<environment.Job instance at 0x7fdae5540d70>,85,13,[10  4],86,-1,118,-1,105
1,<environment.Job instance at 0x7fdae5540b40>,82,3,[ 1 10],83,-1,108,-1,105
1,<environment.Job instance at 0x7fdae5540e10>,86,16,[5 5],87,-1,127,-1,111
1,<environment.Job instance at 0x7fdae5540cd0>,89,15,[7 1],90,-1,126,-1,111
1,<environment.Job instance at 0x7fdae5540eb0>,87,22,[1 7],88,-1,133,-1,111
1,<environment.Job instance at 0x7fdae5540fa0>,90,14,[6 4],91,-1,125,-1,111
1,<environment.Job instance at 0x7fdae55424b0>,94,14,[7 1],95,-1,125,-1,111
1,<environment.Job instance at 0x7fdae55420a0>,95,25,[6 3],96,-1,136,-1,111
1,<environment.Job instance at 0x7fdae5542190>,91,18,[3 6],92,-1,129,-1,111
1,<environment.Job instance at 0x7fdae55427d0>,98,16,[8 5],99,-1,127,-1,111
1,<environment.Job instance at 0x7fdae5549870>,64,12,[6 4],65,-1,123,-1,111
1,<environment.Job instance at 0x7fdae5542aa0>,102,16,[9 2],103,-1,128,-1,112
1,<environment.Job instance at 0x7fdae5542960>,103,15,[6 3],104,-1,127,-1,112
1,<environment.Job instance at 0x7fdae5542be0>,105,18,[7 5],106,-1,133,-1,115
1,<environment.Job instance at 0x7fdae5559140>,108,17,[10  3],109,-1,132,-1,115
1,<environment.Job instance at 0x7fdae4de5a00>,2,14,[ 1 11],3,-1,17,-1,3
1,<environment.Job instance at 0x7fdae484f050>,4,3,[14  4],5,-1,8,-1,5
1,<environment.Job instance at 0x7fdae47f3d20>,6,2,[13  4],7,-1,9,-1,7
1,<environment.Job instance at 0x7fdae47e8cd0>,9,27,[1 5],10,-1,43,-1,16
1,<environment.Job instance at 0x7fdae5540730>,15,14,[ 5 12],16,-1,35,-1,21
1,<environment.Job instance at 0x7fdae55405f0>,17,19,[14  4],18,-1,41,-1,22
1,<environment.Job instance at 0x7fdae5542910>,19,14,[ 5 11],20,-1,38,-1,24
1,<environment.Job instance at 0x7fdae470e0f0>,26,25,[3 8],27,-1,71,-1,46
1,<environment.Job instance at 0x7fdae470eb40>,28,3,[ 5 14],29,-1,49,-1,46
1,<environment.Job instance at 0x7fdae470e9b0>,29,27,[9 3],30,-1,79,-1,52
1,<environment.Job instance at 0x7fdaee8725a0>,32,24,[ 3 10],33,-1,79,-1,55
1,<environment.Job instance at 0x7fdae4beca50>,37,12,[ 2 12],38,-1,76,-1,64
1,<environment.Job instance at 0x7fdae4bec0a0>,38,27,[1 7],39,-1,93,-1,66
1,<environment.Job instance at 0x7fdaee75b960>,55,2,[14  5],56,-1,134,-1,132
1,<environment.Job instance at 0x7fdae4704af0>,73,27,[1 8],74,-1,230,-1,203
1,<environment.Job instance at 0x7fdae4ba2190>,93,3,[ 3 14],94,-1,285,-1,282
1,<environment.Job instance at 0x7fdae4a2e280>,95,25,[6 3],96,-1,319,-1,294
1,<environment.Job instance at 0x7fdae4a27c80>,100,2,[ 5 11],101,-1,299,-1,297
1,<environment.Job instance at 0x7fdae4a76e10>,1,22,[ 1 10],2,-1,25,-1,3
1,<environment.Job instance at 0x7fdae4a76dc0>,2,18,[5 1],3,-1,21,-1,3
1,<environment.Job instance at 0x7fdae4a9c640>,9,15,[ 1 10],10,-1,25,-1,10
1,<environment.Job instance at 0x7fdae4a9c050>,10,14,[3 6],11,-1,25,-1,11
1,<environment.Job instance at 0x7fdae4a9c550>,12,15,[1 6],13,-1,28,-1,13
1,<environment.Job instance at 0x7fdae4a9c500>,15,17,[7 1],16,-1,33,-1,16
1,<environment.Job instance at 0x7fdae4a9c7d0>,17,18,[1 7],18,-1,36,-1,18
1,<environment.Job instance at 0x7fdae4a9c9b0>,19,14,[10  1],20,-1,35,-1,21
1,<environment.Job instance at 0x7fdae4a9c8c0>,21,14,[10  4],22,-1,36,-1,22
1,<environment.Job instance at 0x7fdae4a9ce60>,22,18,[5 5],23,-1,41,-1,23
1,<environment.Job instance at 0x7fdae5c425a0>,25,15,[7 4],26,-1,41,-1,26
1,<environment.Job instance at 0x7fdae5c42960>,27,14,[6 2],28,-1,42,-1,28
1,<environment.Job instance at 0x7fdae5c42780>,28,21,[5 8],29,-1,50,-1,29
1,<environment.Job instance at 0x7fdae5c42af0>,29,17,[7 2],30,-1,47,-1,30
1,<environment.Job instance at 0x7fdae5c42aa0>,32,18,[5 1],33,-1,51,-1,33
1,<environment.Job instance at 0x7fdae4a9cfa0>,20,15,[1 6],21,-1,74,-1,59
1,<environment.Job instance at 0x7fdae5c42230>,37,12,[ 4 10],38,-1,75,-1,63
1,<environment.Job instance at 0x7fdae5c42820>,36,28,[1 7],37,-1,91,-1,63
1,<environment.Job instance at 0x7fdae5c564b0>,46,28,[9 2],47,-1,91,-1,63
1,<environment.Job instance at 0x7fdae5c42690>,31,28,[2 8],32,-1,91,-1,63
1,<environment.Job instance at 0x7fdae4efd2d0>,58,15,[ 3 11],59,-1,82,-1,67
1,<environment.Job instance at 0x7fdae4f20640>,66,23,[7 4],67,-1,90,-1,67
1,<environment.Job instance at 0x7fdae4f207d0>,65,15,[ 2 11],66,-1,85,-1,70
1,<environment.Job instance at 0x7fdae4f20190>,64,15,[9 1],65,-1,86,-1,71
1,<environment.Job instance at 0x7fdae4f20550>,68,17,[5 5],69,-1,98,-1,81
1,<environment.Job instance at 0x7fdae4f20320>,70,15,[9 4],71,-1,98,-1,83
1,<environment.Job instance at 0x7fdae4a6bfa0>,82,14,[6 5],83,-1,97,-1,83
1,<environment.Job instance at 0x7fdae4a9f0a0>,84,15,[10  3],85,-1,100,-1,85
1,<environment.Job instance at 0x7fdae4a9f190>,85,20,[4 7],86,-1,106,-1,86
1,<environment.Job instance at 0x7fdae4a9f410>,86,21,[6 5],87,-1,108,-1,87
1,<environment.Job instance at 0x7fdae4a9f640>,87,13,[9 4],88,-1,102,-1,89
1,<environment.Job instance at 0x7fdae4a9f9b0>,89,17,[5 9],90,-1,107,-1,90
1,<environment.Job instance at 0x7fdae4a9f050>,90,15,[4 5],91,-1,106,-1,91
1,<environment.Job instance at 0x7fdae4b572d0>,96,25,[8 3],97,-1,129,-1,104
1,<environment.Job instance at 0x7fdae4b57820>,98,16,[ 5 10],99,-1,120,-1,104
1,<environment.Job instance at 0x7fdae4b42e10>,93,17,[8 5],94,-1,121,-1,104
1,<environment.Job instance at 0x7fdae4b57190>,99,18,[7 3],100,-1,122,-1,104
1,<environment.Job instance at 0x7fdae4b57230>,101,19,[10  1],102,-1,123,-1,104
1,<environment.Job instance at 0x7fdae4b58820>,16,13,[11  1],17,-1,40,-1,27
1,<environment.Job instance at 0x7fdae4a6bf50>,18,12,[ 5 12],19,-1,42,-1,30
1,<environment.Job instance at 0x7fdaee8772d0>,33,27,[9 3],34,-1,126,-1,99
1,<environment.Job instance at 0x7fdae4b2b1e0>,31,28,[2 8],32,-1,130,-1,102
1,<environment.Job instance at 0x7fdae5542780>,36,28,[1 7],37,-1,130,-1,102
1,<environment.Job instance at 0x7fdae5540500>,39,2,[ 4 11],40,-1,114,-1,112
1,<environment.Job instance at 0x7fdae4dfcdc0>,44,3,[11  1],45,-1,120,-1,117
1,<environment.Job instance at 0x7fdae47e5e60>,46,28,[9 2],47,-1,149,-1,121
1,<environment.Job instance at 0x7fdae56167d0>,57,3,[ 1 12],58,-1,144,-1,141
1,<environment.Job instance at 0x7fdae56169b0>,58,15,[ 3 11],59,-1,156,-1,141
1,<environment.Job instance at 0x7fdae495b780>,65,15,[ 2 11],66,-1,174,-1,159
1,<environment.Job instance at 0x7fdae55dc3c0>,66,23,[7 4],67,-1,185,-1,162
1,<environment.Job instance at 0x7fdae469a690>,80,16,[14  3],81,-1,223,-1,207
1,<environment.Job instance at 0x7fdae46a04b0>,91,27,[5 1],92,-1,259,-1,232
1,<environment.Job instance at 0x7fdae4b07d20>,96,25,[8 3],97,-1,276,-1,251
1,<environment.Job instance at 0x7fdae4f5ac30>,97,13,[13  1],98,-1,264,-1,251
1,<environment.Job instance at 0x7fdae565c0a0>,106,25,[ 5 10],107,-1,343,-1,318
1,<environment.Job instance at 0x7fdae5c4d780>,2,18,[5 9],3,-1,21,-1,3
1,<environment.Job instance at 0x7fdae5c2a370>,8,18,[1 9],9,-1,27,-1,9
1,<environment.Job instance at 0x7fdae5c2a050>,10,15,[3 9],11,-1,26,-1,11
1,<environment.Job instance at 0x7fdae5c232d0>,14,17,[9 5],15,-1,32,-1,15
1,<environment.Job instance at 0x7fdae5c24730>,15,16,[5 3],16,-1,32,-1,16
1,<environment.Job instance at 0x7fdae57b35f0>,18,14,[9 4],19,-1,33,-1,19
1,<environment.Job instance at 0x7fdae5c24cd0>,19,13,[3 6],20,-1,33,-1,20
1,<environment.Job instance at 0x7fdae5c4e7d0>,20,26,[6 3],21,-1,47,-1,21
1,<environment.Job instance at 0x7fdae5c4e870>,21,14,[4 6],22,-1,36,-1,22
1,<environment.Job instance at 0x7fdae5c4e9b0>,22,17,[ 2 11],23,-1,40,-1,23
1,<environment.Job instance at 0x7fdae57881e0>,27,17,[4 9],28,-1,45,-1,28
1,<environment.Job instance at 0x7fdae57f7a00>,31,17,[10  4],32,-1,49,-1,32
1,<environment.Job instance at 0x7fdae5059190>,34,14,[7 4],35,-1,49,-1,35
1,<environment.Job instance at 0x7fdae50359b0>,35,18,[10  3],36,-1,54,-1,36
1,<environment.Job instance at 0x7fdae4ca8960>,37,18,[3 6],38,-1,56,-1,38
1,<environment.Job instance at 0x7fdae4cb9960>,44,18,[4 7],45,-1,63,-1,45
1,<environment.Job instance at 0x7fdae4cb9cd0>,46,17,[5 5],47,-1,64,-1,47
1,<environment.Job instance at 0x7fdae4cb9af0>,47,13,[8 2],48,-1,61,-1,48
1,<environment.Job instance at 0x7fdae57db870>,52,17,[1 6],53,-1,70,-1,53
1,<environment.Job instance at 0x7fdae57db410>,53,16,[4 9],54,-1,70,-1,54
1,<environment.Job instance at 0x7fdae57d6500>,56,17,[11  2],57,-1,149,-1,132
1,<environment.Job instance at 0x7fdae57d6b40>,67,16,[ 5 10],68,-1,148,-1,132
1,<environment.Job instance at 0x7fdae57d6820>,66,14,[13  5],67,-1,146,-1,132
1,<environment.Job instance at 0x7fdae57d6d20>,70,13,[12  5],71,-1,146,-1,133
1,<environment.Job instance at 0x7fdae57f51e0>,72,16,[9 4],73,-1,150,-1,134
1,<environment.Job instance at 0x7fdae57d65a0>,59,18,[9 5],60,-1,152,-1,134
1,<environment.Job instance at 0x7fdae57d6c80>,69,15,[5 2],70,-1,149,-1,134
1,<environment.Job instance at 0x7fdae57f53c0>,77,14,[4 7],78,-1,148,-1,134
1,<environment.Job instance at 0x7fdae57f5460>,78,15,[ 3 13],79,-1,150,-1,135
1,<environment.Job instance at 0x7fdae57f55a0>,80,16,[5 1],81,-1,151,-1,135
1,<environment.Job instance at 0x7fdae57f5640>,81,16,[ 2 10],82,-1,151,-1,135
1,<environment.Job instance at 0x7fdae57f56e0>,82,17,[4 5],83,-1,152,-1,135
1,<environment.Job instance at 0x7fdae57f5780>,83,18,[ 1 10],84,-1,153,-1,135
1,<environment.Job instance at 0x7fdae57f5be0>,90,15,[ 4 10],91,-1,163,-1,148
1,<environment.Job instance at 0x7fdae57f5a00>,87,18,[10  5],88,-1,166,-1,148
1,<environment.Job instance at 0x7fdae57c51e0>,99,17,[9 4],100,-1,195,-1,178
1,<environment.Job instance at 0x7fdae57c5460>,103,15,[10  4],104,-1,193,-1,178
1,<environment.Job instance at 0x7fdae57c5640>,106,15,[ 5 10],107,-1,195,-1,180
1,<environment.Job instance at 0x7fdae57d6640>,60,28,[5 6],61,-1,208,-1,180
1,<environment.Job instance at 0x7fdae57c5780>,108,14,[8 3],109,-1,194,-1,180
1,<environment.Job instance at 0x7fdae469f2d0>,16,2,[13  5],17,-1,40,-1,38
1,<environment.Job instance at 0x7fdae469faf0>,20,26,[6 3],21,-1,83,-1,57
1,<environment.Job instance at 0x7fdae55dc230>,22,17,[ 2 11],23,-1,74,-1,57
1,<environment.Job instance at 0x7fdae4aab500>,25,23,[7 1],26,-1,83,-1,60
1,<environment.Job instance at 0x7fdae4df8c30>,33,12,[ 1 14],34,-1,90,-1,78
1,<environment.Job instance at 0x7fdae5540370>,36,13,[13  3],37,-1,105,-1,92
1,<environment.Job instance at 0x7fdae55405f0>,38,1,[ 3 14],39,-1,93,-1,92
1,<environment.Job instance at 0x7fdae4b07780>,51,14,[ 3 14],52,-1,159,-1,145
1,<environment.Job instance at 0x7fdae4b07aa0>,55,13,[ 1 12],56,-1,173,-1,160
1,<environment.Job instance at 0x7fdae4b542d0>,56,17,[11  2],57,-1,177,-1,160
1,<environment.Job instance at 0x7fdae4a6baa0>,60,28,[5 6],61,-1,207,-1,179
1,<environment.Job instance at 0x7fdae4a6bc30>,63,28,[ 1 11],64,-1,208,-1,180
1,<environment.Job instance at 0x7fdae4f20460>,65,23,[5 3],66,-1,206,-1,183
1,<environment.Job instance at 0x7fdae4f20d70>,66,14,[13  5],67,-1,197,-1,183
1,<environment.Job instance at 0x7fdae505c280>,70,13,[12  5],71,-1,212,-1,199
1,<environment.Job instance at 0x7fdae589eaa0>,78,15,[ 3 13],79,-1,245,-1,230
1,<environment.Job instance at 0x7fdae5baf5a0>,86,18,[ 3 13],87,-1,296,-1,278
1,<environment.Job instance at 0x7fdae5359a50>,97,2,[ 4 14],98,-1,316,-1,314
1,<environment.Job instance at 0x7fdae4818820>,104,2,[ 1 12],105,-1,333,-1,331
1,<environment.Job instance at 0x7fdae4ae41e0>,2,18,[9 4],3,-1,22,-1,4
1,<environment.Job instance at 0x7fdae565cd70>,3,18,[ 4 10],4,-1,23,-1,5
1,<environment.Job instance at 0x7fdae4ae4280>,7,15,[ 5 10],8,-1,24,-1,9
1,<environment.Job instance at 0x7fdae4f33b40>,9,2,[13  5],10,-1,12,-1,10
1,<environment.Job instance at 0x7fdae4ae4460>,8,17,[5 7],9,-1,28,-1,11
1,<environment.Job instance at 0x7fdae4f33190>,23,18,[ 5 10],24,-1,42,-1,24
1,<environment.Job instance at 0x7fdae4f334b0>,24,20,[9 5],25,-1,45,-1,25
1,<environment.Job instance at 0x7fdae4f33eb0>,25,17,[7 4],26,-1,51,-1,34
1,<environment.Job instance at 0x7fdae4f33fa0>,19,16,[2 8],20,-1,54,-1,38
1,<environment.Job instance at 0x7fdae4f330f0>,11,16,[ 4 10],12,-1,62,-1,46
1,<environment.Job instance at 0x7fdae5085c30>,40,13,[9 3],41,-1,59,-1,46
1,<environment.Job instance at 0x7fdae4f339b0>,16,18,[9 4],17,-1,65,-1,47
1,<environment.Job instance at 0x7fdae5085a50>,35,18,[14  2],36,-1,66,-1,48
1,<environment.Job instance at 0x7fdae50854b0>,33,17,[10  5],34,-1,65,-1,48
1,<environment.Job instance at 0x7fdae50852d0>,41,16,[2 7],42,-1,65,-1,49
1,<environment.Job instance at 0x7fdae5671690>,45,15,[9 1],46,-1,68,-1,53
1,<environment.Job instance at 0x7fdae5671af0>,47,25,[9 4],48,-1,78,-1,53
1,<environment.Job instance at 0x7fdae56715f0>,50,16,[2 8],51,-1,71,-1,55
1,<environment.Job instance at 0x7fdae56711e0>,52,17,[1 7],53,-1,73,-1,56
1,<environment.Job instance at 0x7fdae5671fa0>,53,17,[6 4],54,-1,73,-1,56
1,<environment.Job instance at 0x7fdae56710a0>,55,16,[1 6],56,-1,72,-1,56
1,<environment.Job instance at 0x7fdae4a14af0>,57,14,[12  5],58,-1,72,-1,58
1,<environment.Job instance at 0x7fdae4f33640>,26,18,[4 6],27,-1,77,-1,59
1,<environment.Job instance at 0x7fdae5671190>,56,16,[14  3],57,-1,75,-1,59
1,<environment.Job instance at 0x7fdae4a145f0>,58,14,[5 4],59,-1,73,-1,59
1,<environment.Job instance at 0x7fdae4a14eb0>,61,18,[9 3],62,-1,80,-1,62
1,<environment.Job instance at 0x7fdae4a14410>,63,12,[4 9],64,-1,76,-1,64
1,<environment.Job instance at 0x7fdae4a14140>,64,25,[7 4],65,-1,90,-1,65
1,<environment.Job instance at 0x7fdaee4da820>,72,18,[5 8],73,-1,108,-1,90
1,<environment.Job instance at 0x7fdaee4dab40>,80,16,[5 9],81,-1,115,-1,99
1,<environment.Job instance at 0x7fdaee4dad20>,81,15,[9 5],82,-1,114,-1,99
1,<environment.Job instance at 0x7fdae4b795f0>,90,18,[5 8],91,-1,140,-1,122
1,<environment.Job instance at 0x7fdae4a14690>,66,22,[ 4 10],67,-1,144,-1,122
1,<environment.Job instance at 0x7fdae4b79dc0>,91,17,[3 7],92,-1,139,-1,122
1,<environment.Job instance at 0x7fdae4e94c30>,103,16,[8 2],104,-1,244,-1,228
1,<environment.Job instance at 0x7fdae4f33c80>,0,25,[2 8],1,-1,26,-1,1
1,<environment.Job instance at 0x7fdae5085870>,4,3,[ 3 14],5,-1,8,-1,5
1,<environment.Job instance at 0x7fdae4a14cd0>,9,2,[13  5],10,-1,17,-1,15
1,<environment.Job instance at 0x7fdae57c0640>,18,1,[ 3 12],19,-1,53,-1,52
1,<environment.Job instance at 0x7fdae4efd460>,35,18,[14  2],36,-1,135,-1,117
1,<environment.Job instance at 0x7fdae4efb050>,47,25,[9 4],48,-1,205,-1,180
1,<environment.Job instance at 0x7fdae55dc3c0>,51,3,[ 4 12],52,-1,187,-1,184
1,<environment.Job instance at 0x7fdae565c550>,56,16,[14  3],57,-1,218,-1,202
1,<environment.Job instance at 0x7fdae565c9b0>,57,14,[12  5],58,-1,216,-1,202
1,<environment.Job instance at 0x7fdae57c5c80>,64,25,[7 4],65,-1,260,-1,235
1,<environment.Job instance at 0x7fdae5a6c8c0>,75,23,[8 2],76,-1,304,-1,281
1,<environment.Job instance at 0x7fdae59f31e0>,83,18,[ 2 11],84,-1,319,-1,301
1,<environment.Job instance at 0x7fdae5a5caa0>,85,3,[11  2],86,-1,315,-1,312
1,<environment.Job instance at 0x7fdae4e81f00>,92,23,[7 1],93,-1,369,-1,346
1,<environment.Job instance at 0x7fdae55a4410>,95,3,[13  2],96,-1,364,-1,361
1,<environment.Job instance at 0x7fdae55a4140>,98,1,[13  4],99,-1,376,-1,375
1,<environment.Job instance at 0x7fdae4b97230>,102,13,[14  4],103,-1,393,-1,380
1,<environment.Job instance at 0x7fdae4481820>,0,15,[9 1],1,-1,17,-1,2
1,<environment.Job instance at 0x7fdae4481960>,2,13,[6 5],3,-1,16,-1,3
1,<environment.Job instance at 0x7fdae44812d0>,3,16,[ 4 10],4,-1,20,-1,4
1,<environment.Job instance at 0x7fdae4481410>,4,18,[1 8],5,-1,23,-1,5
1,<environment.Job instance at 0x7fdae44819b0>,5,13,[4 7],6,-1,19,-1,6
1,<environment.Job instance at 0x7fdae44815f0>,7,15,[6 1],8,-1,23,-1,8
1,<environment.Job instance at 0x7fdae44811e0>,8,18,[5 8],9,-1,27,-1,9
1,<environment.Job instance at 0x7fdae4481460>,9,1,[9 4],10,-1,11,-1,10
1,<environment.Job instance at 0x7fdae4481280>,10,20,[9 5],11,-1,31,-1,11
1,<environment.Job instance at 0x7fdae4481fa0>,14,15,[7 5],15,-1,30,-1,15
1,<environment.Job instance at 0x7fdae4470af0>,17,15,[ 1 10],18,-1,33,-1,18
1,<environment.Job instance at 0x7fdae4470e60>,19,2,[10  2],20,-1,22,-1,20
1,<environment.Job instance at 0x7fdae4470370>,20,1,[8 1],21,-1,22,-1,21
1,<environment.Job instance at 0x7fdae4470230>,21,18,[3 7],22,-1,40,-1,22
1,<environment.Job instance at 0x7fdae44703c0>,22,17,[1 9],23,-1,40,-1,23
1,<environment.Job instance at 0x7fdae44707d0>,23,14,[5 5],24,-1,38,-1,24
1,<environment.Job instance at 0x7fdae44702d0>,24,22,[9 5],25,-1,47,-1,25
1,<environment.Job instance at 0x7fdae44700a0>,25,3,[ 1 14],26,-1,29,-1,26
1,<environment.Job instance at 0x7fdae4470b40>,26,13,[3 7],27,-1,40,-1,27
1,<environment.Job instance at 0x7fdae4470140>,27,16,[5 8],28,-1,44,-1,28
1,<environment.Job instance at 0x7fdae4470780>,28,16,[1 6],29,-1,45,-1,29
1,<environment.Job instance at 0x7fdae4481910>,1,23,[ 3 13],2,-1,52,-1,29
1,<environment.Job instance at 0x7fdae44705a0>,34,14,[10  4],35,-1,51,-1,37
1,<environment.Job instance at 0x7fdae44e0f00>,38,12,[10  1],39,-1,51,-1,39
1,<environment.Job instance at 0x7fdae44e0370>,39,21,[1 7],40,-1,61,-1,40
1,<environment.Job instance at 0x7fdae44e0d70>,40,16,[9 2],41,-1,57,-1,41
1,<environment.Job instance at 0x7fdae44e0910>,46,12,[6 4],47,-1,59,-1,47
1,<environment.Job instance at 0x7fdae43d4460>,49,17,[9 2],50,-1,72,-1,55
1,<environment.Job instance at 0x7fdae44e06e0>,48,17,[1 6],49,-1,74,-1,57
1,<environment.Job instance at 0x7fdae44e0b90>,36,12,[9 4],37,-1,70,-1,58
1,<environment.Job instance at 0x7fdae43d4870>,55,16,[11  3],56,-1,75,-1,59
1,<environment.Job instance at 0x7fdae43d4500>,57,16,[3 5],58,-1,77,-1,61
1,<environment.Job instance at 0x7fdae43d4780>,60,13,[6 4],61,-1,74,-1,61
1,<environment.Job instance at 0x7fdae47f4190>,64,17,[8 3],65,-1,88,-1,71
1,<environment.Job instance at 0x7fdae43d4c80>,63,18,[ 2 10],64,-1,89,-1,71
1,<environment.Job instance at 0x7fdae458ba00>,69,16,[10  5],70,-1,89,-1,73
1,<environment.Job instance at 0x7fdae458b910>,68,15,[8 3],69,-1,92,-1,77
1,<environment.Job instance at 0x7fdae47f4b90>,67,17,[7 4],68,-1,94,-1,77
1,<environment.Job instance at 0x7fdae503faf0>,75,17,[ 2 10],76,-1,107,-1,90
1,<environment.Job instance at 0x7fdae4da0280>,80,18,[9 2],81,-1,121,-1,103
1,<environment.Job instance at 0x7fdae54a2d70>,89,18,[1 5],90,-1,121,-1,103
1,<environment.Job instance at 0x7fdae4fd1cd0>,87,14,[11  2],88,-1,119,-1,105
1,<environment.Job instance at 0x7fdae52196e0>,90,27,[7 4],91,-1,133,-1,106
1,<environment.Job instance at 0x7fdaee7a2dc0>,92,16,[10  2],93,-1,123,-1,107
1,<environment.Job instance at 0x7fdaee7a2960>,93,15,[4 8],94,-1,122,-1,107
1,<environment.Job instance at 0x7fdaee7a2b40>,97,18,[6 2],98,-1,125,-1,107
1,<environment.Job instance at 0x7fdaee7a2780>,98,14,[ 4 10],99,-1,121,-1,107
1,<environment.Job instance at 0x7fdaee7a2050>,94,12,[1 8],95,-1,119,-1,107
1,<environment.Job instance at 0x7fdaee7a2460>,95,2,[ 1 12],96,-1,109,-1,107
1,<environment.Job instance at 0x7fdaee7a2910>,96,13,[9 5],97,-1,120,-1,107
1,<environment.Job instance at 0x7fdaee7a2230>,100,25,[ 1 14],101,-1,132,-1,107
1,<environment.Job instance at 0x7fdaee7a20a0>,99,13,[7 5],100,-1,120,-1,107
1,<environment.Job instance at 0x7fdae484f320>,88,15,[ 3 14],89,-1,123,-1,108
1,<environment.Job instance at 0x7fdae44e09b0>,1,23,[ 3 13],2,-1,25,-1,2
1,<environment.Job instance at 0x7fdae4993c80>,25,3,[ 1 14],26,-1,68,-1,65
1,<environment.Job instance at 0x7fdae496b6e0>,30,13,[11  4],31,-1,97,-1,84
1,<environment.Job instance at 0x7fdae496bcd0>,31,12,[ 1 13],32,-1,96,-1,84
1,<environment.Job instance at 0x7fdae49802d0>,42,17,[ 2 14],43,-1,148,-1,131
1,<environment.Job instance at 0x7fdae5bf0190>,55,16,[11  3],56,-1,197,-1,181
1,<environment.Job instance at 0x7fdae51736e0>,66,1,[11  2],67,-1,204,-1,203
1,<environment.Job instance at 0x7fdae4adc5a0>,87,14,[11  2],88,-1,301,-1,287
1,<environment.Job instance at 0x7fdae503b410>,88,15,[ 3 14],89,-1,302,-1,287
1,<environment.Job instance at 0x7fdae5111e10>,90,27,[7 4],91,-1,315,-1,288
1,<environment.Job instance at 0x7fdae5111a50>,95,2,[ 1 12],96,-1,302,-1,300
1,<environment.Job instance at 0x7fdae490bfa0>,100,25,[ 1 14],101,-1,354,-1,329
1,<environment.Job instance at 0x7fdae4dd6be0>,103,1,[ 4 13],104,-1,343,-1,342
1,<environment.Job instance at 0x7fdae55e1e10>,105,3,[ 4 11],106,-1,359,-1,356
1,<environment.Job instance at 0x7fdae4a6b280>,1,13,[9 4],2,-1,16,-1,3
1,<environment.Job instance at 0x7fdae4a6bb90>,3,13,[3 7],4,-1,17,-1,4
1,<environment.Job instance at 0x7fdae4a6b2d0>,4,15,[6 4],5,-1,20,-1,5
1,<environment.Job instance at 0x7fdae4d4f960>,7,16,[7 2],8,-1,24,-1,8
1,<environment.Job instance at 0x7fdae4a6baa0>,2,16,[1 7],3,-1,28,-1,12
1,<environment.Job instance at 0x7fdae4a6ba00>,12,14,[9 3],13,-1,31,-1,17
1,<environment.Job instance at 0x7fdae4d4f730>,16,16,[4 9],17,-1,33,-1,17
1,<environment.Job instance at 0x7fdae4d4fd70>,19,14,[3 8],20,-1,34,-1,20
1,<environment.Job instance at 0x7fdae4d4f640>,21,18,[5 9],22,-1,40,-1,22
1,<environment.Job instance at 0x7fdae51fadc0>,25,17,[10  3],26,-1,43,-1,26
1,<environment.Job instance at 0x7fdae51faeb0>,27,16,[8 4],28,-1,44,-1,28
1,<environment.Job instance at 0x7fdae51fa730>,28,14,[6 3],29,-1,43,-1,29
1,<environment.Job instance at 0x7fdae51faaf0>,30,17,[8 4],31,-1,48,-1,31
1,<environment.Job instance at 0x7fdae51fa0f0>,31,14,[ 5 10],32,-1,46,-1,32
1,<environment.Job instance at 0x7fdae51fac80>,32,19,[8 3],33,-1,52,-1,33
1,<environment.Job instance at 0x7fdae51fa5a0>,34,17,[8 5],35,-1,52,-1,35
1,<environment.Job instance at 0x7fdae51fa460>,36,23,[5 5],37,-1,60,-1,37
1,<environment.Job instance at 0x7fdae51fa3c0>,38,14,[9 5],39,-1,53,-1,39
1,<environment.Job instance at 0x7fdae55543c0>,39,25,[7 3],40,-1,65,-1,40
1,<environment.Job instance at 0x7fdae5554370>,41,13,[5 2],42,-1,58,-1,45
1,<environment.Job instance at 0x7fdae5554c30>,43,17,[6 4],44,-1,62,-1,45
1,<environment.Job instance at 0x7fdae5554eb0>,45,3,[ 3 10],46,-1,49,-1,46
1,<environment.Job instance at 0x7fdae5554aa0>,46,13,[10  5],47,-1,60,-1,47
1,<environment.Job instance at 0x7fdae55540a0>,47,14,[2 6],48,-1,62,-1,48
1,<environment.Job instance at 0x7fdae5554140>,48,12,[5 1],49,-1,61,-1,49
1,<environment.Job instance at 0x7fdae5554690>,49,3,[7 1],50,-1,53,-1,50
1,<environment.Job instance at 0x7fdae5554550>,50,2,[8 5],51,-1,53,-1,51
1,<environment.Job instance at 0x7fdae5554640>,51,3,[ 3 11],52,-1,55,-1,52
1,<environment.Job instance at 0x7fdae55540f0>,44,17,[4 7],45,-1,69,-1,52
1,<environment.Job instance at 0x7fdae5554500>,52,14,[10  1],53,-1,69,-1,55
1,<environment.Job instance at 0x7fdae5554320>,55,14,[5 7],56,-1,70,-1,56
1,<environment.Job instance at 0x7fdae5554870>,54,15,[8 1],55,-1,71,-1,56
1,<environment.Job instance at 0x7fdae5554cd0>,57,15,[3 9],58,-1,74,-1,59
1,<environment.Job instance at 0x7fdae5392550>,58,15,[ 4 10],59,-1,74,-1,59
1,<environment.Job instance at 0x7fdae48aab40>,60,18,[5 4],61,-1,81,-1,63
1,<environment.Job instance at 0x7fdae48aac80>,62,19,[6 2],63,-1,82,-1,63
1,<environment.Job instance at 0x7fdae48aaaa0>,68,18,[ 4 10],69,-1,88,-1,70
1,<environment.Job instance at 0x7fdae48aa230>,73,16,[3 8],74,-1,90,-1,74
1,<environment.Job instance at 0x7fdae4c518c0>,74,16,[9 2],75,-1,91,-1,75
1,<environment.Job instance at 0x7fdae4c51d20>,76,18,[3 6],77,-1,95,-1,77
1,<environment.Job instance at 0x7fdae4c51a00>,77,18,[5 5],78,-1,96,-1,78
1,<environment.Job instance at 0x7fdae4c51a50>,84,15,[3 5],85,-1,100,-1,85
1,<environment.Job instance at 0x7fdae4c51050>,85,18,[5 8],86,-1,104,-1,86
1,<environment.Job instance at 0x7fdae4c51960>,86,18,[3 9],87,-1,105,-1,87
1,<environment.Job instance at 0x7fdae596b640>,89,23,[4 9],90,-1,113,-1,90
1,<environment.Job instance at 0x7fdae596ba50>,91,16,[6 5],92,-1,108,-1,92
1,<environment.Job instance at 0x7fdae596be10>,94,22,[5 8],95,-1,117,-1,95
1,<environment.Job instance at 0x7fdae596b550>,95,16,[6 5],96,-1,112,-1,96
1,<environment.Job instance at 0x7fdae48aaf50>,8,3,[11  1],9,-1,12,-1,9
1,<environment.Job instance at 0x7fdae5c15e10>,36,23,[5 5],37,-1,140,-1,117
1,<environment.Job instance at 0x7fdae57bcaf0>,39,25,[7 3],40,-1,157,-1,132
1,<environment.Job instance at 0x7fdae44e7af0>,40,1,[12  5],41,-1,133,-1,132
1,<environment.Job instance at 0x7fdae4ec3960>,51,3,[ 3 11],52,-1,175,-1,172
1,<environment.Job instance at 0x7fdaee5e8f50>,65,3,[14  4],66,-1,235,-1,232
1,<environment.Job instance at 0x7fdae57c4c30>,66,17,[ 1 13],67,-1,249,-1,232
1,<environment.Job instance at 0x7fdae52934b0>,67,18,[ 3 12],68,-1,250,-1,232
1,<environment.Job instance at 0x7fdae4e5c960>,71,2,[11  4],72,-1,235,-1,233
1,<environment.Job instance at 0x7fdae4963fa0>,78,22,[ 1 13],79,-1,285,-1,263
1,<environment.Job instance at 0x7fdae49099b0>,88,2,[11  2],89,-1,310,-1,308
1,<environment.Job instance at 0x7fdae4909820>,89,23,[4 9],90,-1,332,-1,309
1,<environment.Job instance at 0x7fdae498f320>,92,13,[14  2],93,-1,322,-1,309
1,<environment.Job instance at 0x7fdae4450a50>,4,17,[3 7],5,-1,22,-1,5
1,<environment.Job instance at 0x7fdae44500a0>,6,14,[7 5],7,-1,21,-1,7
1,<environment.Job instance at 0x7fdae44502d0>,9,18,[2 9],10,-1,28,-1,10
1,<environment.Job instance at 0x7fdae49e8af0>,10,18,[5 5],11,-1,29,-1,11
1,<environment.Job instance at 0x7fdae49e8410>,11,14,[ 1 10],12,-1,26,-1,12
1,<environment.Job instance at 0x7fdae49e87d0>,13,18,[5 2],14,-1,32,-1,14
1,<environment.Job instance at 0x7fdae49e8730>,14,16,[7 5],15,-1,31,-1,15
1,<environment.Job instance at 0x7fdae4aef550>,23,17,[14  2],24,-1,41,-1,24
1,<environment.Job instance at 0x7fdae4aef4b0>,21,13,[9 1],22,-1,38,-1,25
1,<environment.Job instance at 0x7fdae4aeffa0>,25,20,[10  3],26,-1,47,-1,27
1,<environment.Job instance at 0x7fdae4aef9b0>,24,15,[10  2],25,-1,44,-1,29
1,<environment.Job instance at 0x7fdae4aefc80>,32,18,[9 2],33,-1,51,-1,33
1,<environment.Job instance at 0x7fdae55eca00>,34,14,[5 9],35,-1,49,-1,35
1,<environment.Job instance at 0x7fdae55ec6e0>,37,23,[6 1],38,-1,61,-1,38
1,<environment.Job instance at 0x7fdae55ec1e0>,41,14,[1 5],42,-1,56,-1,42
1,<environment.Job instance at 0x7fdae55ecc80>,42,17,[5 1],43,-1,60,-1,43
1,<environment.Job instance at 0x7fdae55ef1e0>,46,18,[ 2 10],47,-1,65,-1,47
1,<environment.Job instance at 0x7fdae55efb40>,47,17,[5 5],48,-1,65,-1,48
1,<environment.Job instance at 0x7fdae55ef230>,48,14,[9 5],49,-1,63,-1,49
1,<environment.Job instance at 0x7fdae55ef4b0>,49,14,[8 5],50,-1,65,-1,51
1,<environment.Job instance at 0x7fdae55ef410>,50,25,[9 4],51,-1,76,-1,51
1,<environment.Job instance at 0x7fdae55effa0>,52,17,[1 5],53,-1,70,-1,53
1,<environment.Job instance at 0x7fdae55efa50>,54,28,[ 5 10],55,-1,83,-1,55
1,<environment.Job instance at 0x7fdae55efc30>,56,13,[5 9],57,-1,70,-1,57
1,<environment.Job instance at 0x7fdae55ef780>,57,27,[2 9],58,-1,85,-1,58
1,<environment.Job instance at 0x7fdae55efcd0>,58,26,[4 9],59,-1,85,-1,59
1,<environment.Job instance at 0x7fdae55ef690>,60,18,[5 4],61,-1,79,-1,61
1,<environment.Job instance at 0x7fdae55ef050>,61,14,[8 4],62,-1,76,-1,62
1,<environment.Job instance at 0x7fdae5bef500>,68,19,[2 7],69,-1,88,-1,69
1,<environment.Job instance at 0x7fdae5bef8c0>,72,22,[5 4],73,-1,95,-1,73
1,<environment.Job instance at 0x7fdae5bef3c0>,79,13,[4 8],80,-1,93,-1,80
1,<environment.Job instance at 0x7fdae5bef410>,74,13,[5 8],75,-1,94,-1,81
1,<environment.Job instance at 0x7fdae551d7d0>,80,17,[10  1],81,-1,101,-1,84
1,<environment.Job instance at 0x7fdae5bef7d0>,78,17,[7 5],79,-1,101,-1,84
1,<environment.Job instance at 0x7fdae551daa0>,81,16,[2 5],82,-1,100,-1,84
1,<environment.Job instance at 0x7fdae551dfa0>,87,26,[10  5],88,-1,114,-1,88
1,<environment.Job instance at 0x7fdae551de10>,85,15,[5 4],86,-1,104,-1,89
1,<environment.Job instance at 0x7fdae551d5a0>,89,16,[5 6],90,-1,106,-1,90
1,<environment.Job instance at 0x7fdae551df50>,90,18,[4 5],91,-1,110,-1,92
1,<environment.Job instance at 0x7fdae551d780>,91,18,[4 9],92,-1,111,-1,93
1,<environment.Job instance at 0x7fdae551dd20>,83,16,[1 5],84,-1,115,-1,99
1,<environment.Job instance at 0x7fdae551deb0>,93,13,[9 3],94,-1,112,-1,99
1,<environment.Job instance at 0x7fdae48c9c30>,98,12,[1 9],99,-1,111,-1,99
1,<environment.Job instance at 0x7fdae48c9780>,94,19,[2 5],95,-1,119,-1,100
1,<environment.Job instance at 0x7fdae584cf50>,103,23,[1 7],104,-1,127,-1,104
1,<environment.Job instance at 0x7fdae54dfe60>,104,22,[1 8],105,-1,128,-1,106
1,<environment.Job instance at 0x7fdae54df140>,105,18,[ 2 10],106,-1,127,-1,109
1,<environment.Job instance at 0x7fdae49e84b0>,0,2,[ 4 14],1,-1,3,-1,1
1,<environment.Job instance at 0x7fdae5bf0410>,23,17,[14  2],24,-1,83,-1,66
1,<environment.Job instance at 0x7fdae4963aa0>,36,2,[ 5 12],37,-1,96,-1,94
1,<environment.Job instance at 0x7fdae49630f0>,37,23,[6 1],38,-1,120,-1,97
1,<environment.Job instance at 0x7fdae52934b0>,50,25,[9 4],51,-1,167,-1,142
1,<environment.Job instance at 0x7fdae58a0140>,54,28,[ 5 10],55,-1,187,-1,159
1,<environment.Job instance at 0x7fdaee79de60>,58,26,[4 9],59,-1,199,-1,173
1,<environment.Job instance at 0x7fdae4945fa0>,57,27,[2 9],58,-1,200,-1,173
1,<environment.Job instance at 0x7fdae44e7af0>,66,16,[ 5 12],67,-1,200,-1,184
1,<environment.Job instance at 0x7fdae596bfa0>,86,17,[ 2 14],87,-1,271,-1,254
1,<environment.Job instance at 0x7fdae596b2d0>,87,26,[10  5],88,-1,282,-1,256
1,<environment.Job instance at 0x7fdae4ddee60>,103,23,[1 7],104,-1,333,-1,310
1,<environment.Job instance at 0x7fdae58dda50>,108,13,[14  3],109,-1,330,-1,317
1,<environment.Job instance at 0x7fdae47f7640>,0,16,[4 8],1,-1,17,-1,1
1,<environment.Job instance at 0x7fdae47f7960>,2,26,[1 5],3,-1,29,-1,3
1,<environment.Job instance at 0x7fdae47f7a50>,3,17,[ 4 10],4,-1,21,-1,4
1,<environment.Job instance at 0x7fdae47f78c0>,5,15,[8 3],6,-1,23,-1,8
1,<environment.Job instance at 0x7fdae47f70a0>,7,12,[9 2],8,-1,20,-1,8
1,<environment.Job instance at 0x7fdae47f73c0>,10,13,[10  5],11,-1,25,-1,12
1,<environment.Job instance at 0x7fdae47f7c30>,12,22,[5 3],13,-1,35,-1,13
1,<environment.Job instance at 0x7fdae47f7730>,11,12,[8 2],12,-1,25,-1,13
1,<environment.Job instance at 0x7fdae498c640>,21,16,[4 9],22,-1,38,-1,22
1,<environment.Job instance at 0x7fdae498c5a0>,22,15,[1 6],23,-1,39,-1,24
1,<environment.Job instance at 0x7fdae498c960>,26,18,[7 1],27,-1,45,-1,27
1,<environment.Job instance at 0x7fdae498caf0>,27,3,[7 5],28,-1,31,-1,28
1,<environment.Job instance at 0x7fdae498c460>,31,23,[9 4],32,-1,55,-1,32
1,<environment.Job instance at 0x7fdae563d4b0>,32,13,[1 9],33,-1,46,-1,33
1,<environment.Job instance at 0x7fdae563de10>,34,14,[2 7],35,-1,51,-1,37
1,<environment.Job instance at 0x7fdae498c410>,23,26,[1 8],24,-1,65,-1,39
1,<environment.Job instance at 0x7fdae4f6ecd0>,38,16,[5 1],39,-1,57,-1,41
1,<environment.Job instance at 0x7fdae4f6ec80>,41,14,[3 5],42,-1,56,-1,42
1,<environment.Job instance at 0x7fdae4f6e320>,36,16,[9 3],37,-1,68,-1,52
1,<environment.Job instance at 0x7fdaee872370>,50,18,[3 6],51,-1,70,-1,52
1,<environment.Job instance at 0x7fdaee299500>,53,13,[6 4],54,-1,69,-1,56
1,<environment.Job instance at 0x7fdae498c7d0>,29,15,[ 1 14],30,-1,71,-1,56
1,<environment.Job instance at 0x7fdaee299c30>,52,16,[1 9],53,-1,72,-1,56
1,<environment.Job instance at 0x7fdaee299870>,57,13,[7 1],58,-1,72,-1,59
1,<environment.Job instance at 0x7fdaee299b40>,56,16,[2 7],57,-1,75,-1,59
1,<environment.Job instance at 0x7fdaee299aa0>,58,1,[8 3],59,-1,61,-1,60
1,<environment.Job instance at 0x7fdae4f6ea00>,40,17,[4 7],41,-1,77,-1,60
1,<environment.Job instance at 0x7fdaee299410>,60,14,[1 9],61,-1,75,-1,61
1,<environment.Job instance at 0x7fdae4573c80>,64,17,[10  5],65,-1,83,-1,66
1,<environment.Job instance at 0x7fdae5ac7af0>,67,16,[11  5],68,-1,84,-1,68
1,<environment.Job instance at 0x7fdae4d85b90>,75,17,[ 5 10],76,-1,98,-1,81
1,<environment.Job instance at 0x7fdae58146e0>,70,14,[3 5],71,-1,95,-1,81
1,<environment.Job instance at 0x7fdae5085fa0>,76,12,[5 6],77,-1,93,-1,81
1,<environment.Job instance at 0x7fdae5827690>,82,16,[5 3],83,-1,109,-1,93
1,<environment.Job instance at 0x7fdae49b1cd0>,83,16,[9 5],84,-1,109,-1,93
1,<environment.Job instance at 0x7fdae5575870>,84,16,[8 5],85,-1,109,-1,93
1,<environment.Job instance at 0x7fdae4c4f640>,87,14,[ 5 10],88,-1,111,-1,97
1,<environment.Job instance at 0x7fdae4aa6320>,89,16,[6 2],90,-1,113,-1,97
1,<environment.Job instance at 0x7fdae53c50a0>,80,15,[6 2],81,-1,112,-1,97
1,<environment.Job instance at 0x7fdae4be5140>,92,16,[9 3],93,-1,113,-1,97
1,<environment.Job instance at 0x7fdae58450f0>,65,15,[1 6],66,-1,112,-1,97
1,<environment.Job instance at 0x7fdae4c025f0>,94,16,[7 3],95,-1,113,-1,97
1,<environment.Job instance at 0x7fdae4db1870>,93,14,[1 6],94,-1,112,-1,98
1,<environment.Job instance at 0x7fdae4f6e9b0>,47,17,[4 6],48,-1,116,-1,99
1,<environment.Job instance at 0x7fdae54c9410>,98,13,[5 7],99,-1,112,-1,99
1,<environment.Job instance at 0x7fdae54c9230>,95,22,[5 2],96,-1,127,-1,105
1,<environment.Job instance at 0x7fdae5c35870>,102,14,[6 1],103,-1,119,-1,105
1,<environment.Job instance at 0x7fdae4d0e6e0>,105,18,[10  4],106,-1,124,-1,106
1,<environment.Job instance at 0x7fdae498c230>,2,26,[1 5],3,-1,29,-1,3
1,<environment.Job instance at 0x7fdae5befaa0>,17,24,[2 8],18,-1,66,-1,42
1,<environment.Job instance at 0x7fdae4dfaaa0>,19,13,[14  2],20,-1,55,-1,42
1,<environment.Job instance at 0x7fdae4e1fe10>,23,26,[1 8],24,-1,82,-1,56
1,<environment.Job instance at 0x7fdae5abb320>,29,15,[ 1 14],30,-1,87,-1,72
1,<environment.Job instance at 0x7fdae5abbb40>,31,23,[9 4],32,-1,98,-1,75
1,<environment.Job instance at 0x7fdae53b9780>,67,16,[11  5],68,-1,223,-1,207
1,<environment.Job instance at 0x7fdae5cc4d70>,71,3,[13  1],72,-1,221,-1,218
1,<environment.Job instance at 0x7fdae51d4f00>,85,1,[ 3 12],86,-1,275,-1,274
1,<environment.Job instance at 0x7fdae46ea820>,88,3,[ 5 12],89,-1,283,-1,280
1,<environment.Job instance at 0x7fdae4f66a00>,96,1,[11  1],97,-1,311,-1,310
1,<environment.Job instance at 0x7fdae4df9870>,100,13,[11  3],101,-1,334,-1,321
1,<environment.Job instance at 0x7fdae56f7be0>,101,28,[7 5],102,-1,352,-1,324
1,<environment.Job instance at 0x7fdae5ca20f0>,103,2,[14  5],104,-1,326,-1,324
1,<environment.Job instance at 0x7fdae5ca2050>,104,26,[7 1],105,-1,351,-1,325
1,<environment.Job instance at 0x7fdae5a99b40>,1,18,[4 9],2,-1,20,-1,2
1,<environment.Job instance at 0x7fdae5a99640>,2,18,[3 6],3,-1,21,-1,3
1,<environment.Job instance at 0x7fdae4da5780>,5,16,[2 7],6,-1,22,-1,6
1,<environment.Job instance at 0x7fdae4da5a00>,8,18,[8 3],9,-1,28,-1,10
1,<environment.Job instance at 0x7fdae4da5370>,12,15,[ 2 10],13,-1,28,-1,13
1,<environment.Job instance at 0x7fdae4da5190>,13,18,[6 3],14,-1,32,-1,14
1,<environment.Job instance at 0x7fdae4da5be0>,14,17,[10  3],15,-1,32,-1,15
1,<environment.Job instance at 0x7fdae4da5e60>,17,18,[6 4],18,-1,36,-1,18
1,<environment.Job instance at 0x7fdae4dd7780>,28,27,[1 7],29,-1,79,-1,52
1,<environment.Job instance at 0x7fdae4dc1410>,40,17,[5 9],41,-1,70,-1,53
1,<environment.Job instance at 0x7fdae4dc1500>,41,17,[9 4],42,-1,70,-1,53
1,<environment.Job instance at 0x7fdae4dc4e60>,44,14,[9 5],45,-1,67,-1,53
1,<environment.Job instance at 0x7fdae4dc48c0>,47,18,[ 5 10],48,-1,90,-1,72
1,<environment.Job instance at 0x7fdae4dc4f00>,52,12,[10  2],53,-1,84,-1,72
1,<environment.Job instance at 0x7fdae4dc1e60>,37,17,[13  5],38,-1,89,-1,72
1,<environment.Job instance at 0x7fdae4dc4690>,54,18,[ 2 10],55,-1,90,-1,72
1,<environment.Job instance at 0x7fdae4daf6e0>,55,14,[8 4],56,-1,86,-1,72
1,<environment.Job instance at 0x7fdae4da52d0>,15,18,[ 2 11],16,-1,90,-1,72
1,<environment.Job instance at 0x7fdae4dc4f50>,46,16,[3 8],47,-1,93,-1,77
1,<environment.Job instance at 0x7fdae4dafeb0>,57,18,[5 9],58,-1,97,-1,79
1,<environment.Job instance at 0x7fdae4dafd70>,60,17,[8 2],61,-1,96,-1,79
1,<environment.Job instance at 0x7fdae4daf7d0>,56,18,[ 2 10],57,-1,97,-1,79
1,<environment.Job instance at 0x7fdae4dd7230>,7,13,[13  4],8,-1,21,-1,8
1,<environment.Job instance at 0x7fdae4dac6e0>,11,3,[ 4 12],12,-1,24,-1,21
1,<environment.Job instance at 0x7fdae4dac5f0>,10,24,[10  5],11,-1,61,-1,37
1,<environment.Job instance at 0x7fdae5c0ca00>,15,18,[ 2 11],16,-1,55,-1,37
1,<environment.Job instance at 0x7fdaee35e910>,16,13,[11  3],17,-1,50,-1,37
1,<environment.Job instance at 0x7fdae48ab6e0>,18,27,[5 1],19,-1,66,-1,39
1,<environment.Job instance at 0x7fdae5224730>,28,27,[1 7],29,-1,101,-1,74
1,<environment.Job instance at 0x7fdae57f7c30>,29,16,[12  5],30,-1,90,-1,74
1,<environment.Job instance at 0x7fdae571f6e0>,36,1,[14  4],37,-1,83,-1,82
1,<environment.Job instance at 0x7fdae4b7fc80>,37,17,[13  5],38,-1,99,-1,82
1,<environment.Job instance at 0x7fdae44fa550>,68,25,[5 5],69,-1,247,-1,222
1,<environment.Job instance at 0x7fdae44fa730>,70,18,[14  5],71,-1,240,-1,222
1,<environment.Job instance at 0x7fdae436a1e0>,71,15,[ 1 12],72,-1,237,-1,222
1,<environment.Job instance at 0x7fdae5740370>,92,17,[ 3 14],93,-1,335,-1,318
1,<environment.Job instance at 0x7fdae5740410>,95,16,[ 4 12],96,-1,338,-1,322
1,<environment.Job instance at 0x7fdae57404b0>,98,18,[13  3],99,-1,351,-1,333
1,<environment.Job instance at 0x7fdaee5fd320>,99,1,[ 4 14],100,-1,334,-1,333
1,<environment.Job instance at 0x7fdae44fdeb0>,102,16,[14  1],103,-1,354,-1,338
1,<environment.Job instance at 0x7fdae4c59190>,105,1,[ 5 13],106,-1,340,-1,339
1,<environment.Job instance at 0x7fdae4589280>,4,1,[9 1],5,-1,6,-1,5
1,<environment.Job instance at 0x7fdae4589910>,5,16,[8 5],6,-1,22,-1,6
1,<environment.Job instance at 0x7fdae4589eb0>,6,13,[4 5],7,-1,20,-1,7
1,<environment.Job instance at 0x7fdae4589780>,9,18,[7 2],10,-1,28,-1,10
1,<environment.Job instance at 0x7fdae4d6f230>,13,12,[5 8],14,-1,28,-1,16
1,<environment.Job instance at 0x7fdae4d6fa00>,20,12,[10  4],21,-1,35,-1,23
1,<environment.Job instance at 0x7fdae44f1b90>,24,26,[10  2],25,-1,51,-1,25
1,<environment.Job instance at 0x7fdae44f1320>,26,16,[ 5 10],27,-1,43,-1,27
1,<environment.Job instance at 0x7fdae44f18c0>,27,12,[6 2],28,-1,40,-1,28
1,<environment.Job instance at 0x7fdae44f1be0>,29,2,[4 5],30,-1,32,-1,30
1,<environment.Job instance at 0x7fdae44f1640>,30,1,[7 1],31,-1,32,-1,31
1,<environment.Job instance at 0x7fdae44f1190>,32,20,[5 2],33,-1,53,-1,33
1,<environment.Job instance at 0x7fdae44f1cd0>,33,14,[1 8],34,-1,48,-1,34
1,<environment.Job instance at 0x7fdae44f13c0>,34,12,[3 9],35,-1,47,-1,35
1,<environment.Job instance at 0x7fdae44f1af0>,35,15,[5 1],36,-1,51,-1,36
1,<environment.Job instance at 0x7fdae43bf820>,43,15,[8 4],44,-1,59,-1,44
1,<environment.Job instance at 0x7fdae4d090a0>,46,20,[4 9],47,-1,67,-1,47
1,<environment.Job instance at 0x7fdae4d09780>,53,21,[5 7],54,-1,75,-1,54
1,<environment.Job instance at 0x7fdae48b9c30>,54,14,[10  4],55,-1,69,-1,55
1,<environment.Job instance at 0x7fdae48b9c80>,55,17,[4 9],56,-1,73,-1,56
1,<environment.Job instance at 0x7fdae48b9aa0>,57,13,[7 4],58,-1,71,-1,58
1,<environment.Job instance at 0x7fdae48b9fa0>,60,13,[10  1],61,-1,78,-1,65
1,<environment.Job instance at 0x7fdae4d6fd70>,22,18,[ 5 10],23,-1,83,-1,65
1,<environment.Job instance at 0x7fdae48b9b40>,65,13,[6 4],66,-1,80,-1,67
1,<environment.Job instance at 0x7fdae48b9dc0>,67,18,[4 7],68,-1,86,-1,68
1,<environment.Job instance at 0x7fdae48b9190>,70,26,[9 4],71,-1,98,-1,72
1,<environment.Job instance at 0x7fdae48b9960>,66,19,[9 4],67,-1,92,-1,73
1,<environment.Job instance at 0x7fdae4a0afa0>,73,18,[10  5],74,-1,92,-1,74
1,<environment.Job instance at 0x7fdae58fdfa0>,3,3,[ 5 11],4,-1,7,-1,4
1,<environment.Job instance at 0x7fdae48b9e60>,11,3,[ 3 11],12,-1,27,-1,24
1,<environment.Job instance at 0x7fdae54e1960>,18,18,[ 4 12],19,-1,49,-1,31
1,<environment.Job instance at 0x7fdaee5fd320>,24,26,[10  2],25,-1,83,-1,57
1,<environment.Job instance at 0x7fdae4b47c80>,37,15,[13  3],38,-1,94,-1,79
1,<environment.Job instance at 0x7fdae4dcd820>,51,2,[ 2 13],52,-1,109,-1,107
1,<environment.Job instance at 0x7fdae59677d0>,58,2,[12  1],59,-1,126,-1,124
1,<environment.Job instance at 0x7fdae5967e10>,59,27,[ 5 11],60,-1,151,-1,124
1,<environment.Job instance at 0x7fdae532daf0>,63,25,[9 3],64,-1,176,-1,151
1,<environment.Job instance at 0x7fdae5704a00>,68,17,[ 2 12],69,-1,182,-1,165
1,<environment.Job instance at 0x7fdae4b6d910>,70,26,[9 4],71,-1,196,-1,170
1,<environment.Job instance at 0x7fdae4ed4f50>,75,14,[13  2],76,-1,189,-1,175
1,<environment.Job instance at 0x7fdae5ca1d20>,78,24,[8 3],79,-1,203,-1,179
1,<environment.Job instance at 0x7fdae4dd76e0>,98,2,[ 4 12],99,-1,266,-1,264
1,<environment.Job instance at 0x7fdae5ab09b0>,103,26,[2 9],104,-1,318,-1,292
1,<environment.Job instance at 0x7fdae4be5960>,106,13,[12  4],107,-1,305,-1,292
1,<environment.Job instance at 0x7fdae43fc320>,3,18,[1 8],4,-1,22,-1,4
1,<environment.Job instance at 0x7fdae43fc7d0>,9,15,[8 4],10,-1,25,-1,10
1,<environment.Job instance at 0x7fdae47f6280>,15,13,[2 6],16,-1,29,-1,16
1,<environment.Job instance at 0x7fdae47e8820>,18,18,[5 6],19,-1,37,-1,19
1,<environment.Job instance at 0x7fdae4819be0>,22,18,[7 3],23,-1,41,-1,23
1,<environment.Job instance at 0x7fdae4819eb0>,27,16,[3 5],28,-1,47,-1,31
1,<environment.Job instance at 0x7fdae4819640>,29,23,[5 5],30,-1,55,-1,32
1,<environment.Job instance at 0x7fdae4819460>,32,12,[5 4],33,-1,46,-1,34
1,<environment.Job instance at 0x7fdae48198c0>,30,17,[8 3],31,-1,52,-1,35
1,<environment.Job instance at 0x7fdae4819820>,33,13,[10  3],34,-1,49,-1,36
1,<environment.Job instance at 0x7fdae4819aa0>,34,17,[5 6],35,-1,54,-1,37
1,<environment.Job instance at 0x7fdae4819e60>,25,16,[5 7],26,-1,59,-1,43
1,<environment.Job instance at 0x7fdae4a230f0>,42,17,[3 8],43,-1,63,-1,46
1,<environment.Job instance at 0x7fdae4a23be0>,46,13,[ 1 10],47,-1,60,-1,47
1,<environment.Job instance at 0x7fdae4bbcaa0>,47,14,[9 3],48,-1,62,-1,48
1,<environment.Job instance at 0x7fdae4de8140>,49,15,[8 4],50,-1,65,-1,50
1,<environment.Job instance at 0x7fdae518f0a0>,51,15,[3 9],52,-1,68,-1,53
1,<environment.Job instance at 0x7fdae518f960>,52,16,[6 3],53,-1,69,-1,53
1,<environment.Job instance at 0x7fdae4a230a0>,40,14,[6 1],41,-1,70,-1,56
1,<environment.Job instance at 0x7fdae43f2550>,55,19,[8 1],56,-1,77,-1,58
1,<environment.Job instance at 0x7fdae48195f0>,35,24,[7 5],36,-1,89,-1,65
1,<environment.Job instance at 0x7fdae541ceb0>,63,22,[5 4],64,-1,88,-1,66
1,<environment.Job instance at 0x7fdae53fcf50>,71,17,[6 5],72,-1,97,-1,80
1,<environment.Job instance at 0x7fdae53fc9b0>,73,18,[10  5],74,-1,99,-1,81
1,<environment.Job instance at 0x7fdae4b25640>,62,28,[8 2],63,-1,110,-1,82
1,<environment.Job instance at 0x7fdae529af00>,61,23,[7 5],62,-1,106,-1,83
1,<environment.Job instance at 0x7fdae53fc870>,76,16,[3 6],77,-1,100,-1,84
1,<environment.Job instance at 0x7fdae54040f0>,84,26,[7 4],85,-1,111,-1,85
1,<environment.Job instance at 0x7fdae545d410>,88,16,[1 8],89,-1,105,-1,89
1,<environment.Job instance at 0x7fdae54130a0>,94,17,[10  4],95,-1,112,-1,95
1,<environment.Job instance at 0x7fdae5404cd0>,83,18,[4 9],84,-1,125,-1,107
1,<environment.Job instance at 0x7fdae43f2b40>,1,17,[13  5],2,-1,19,-1,2
1,<environment.Job instance at 0x7fdae56a88c0>,29,23,[5 5],30,-1,96,-1,73
1,<environment.Job instance at 0x7fdae4c06e10>,37,3,[ 2 13],38,-1,107,-1,104
1,<environment.Job instance at 0x7fdae4c063c0>,35,24,[7 5],36,-1,137,-1,113
1,<environment.Job instance at 0x7fdae5100be0>,50,1,[13  2],51,-1,141,-1,140
1,<environment.Job instance at 0x7fdae48d08c0>,53,1,[ 2 13],54,-1,154,-1,153
1,<environment.Job instance at 0x7fdae4b3cfa0>,56,1,[ 4 11],57,-1,168,-1,167
1,<environment.Job instance at 0x7fdae4b3c500>,62,28,[8 2],63,-1,213,-1,185
1,<environment.Job instance at 0x7fdae5c85370>,61,23,[7 5],62,-1,208,-1,185
1,<environment.Job instance at 0x7fdae55b2e60>,84,26,[7 4],85,-1,252,-1,226
1,<environment.Job instance at 0x7fdae55b2eb0>,85,1,[12  3],86,-1,227,-1,226
1,<environment.Job instance at 0x7fdae4b3b640>,98,16,[14  5],99,-1,284,-1,268
1,<environment.Job instance at 0x7fdae4b3b050>,102,14,[ 2 12],103,-1,288,-1,274
1,<environment.Job instance at 0x7fdae4b3b230>,105,15,[ 2 12],106,-1,292,-1,277
1,<environment.Job instance at 0x7fdae5120be0>,0,17,[2 8],1,-1,18,-1,1
1,<environment.Job instance at 0x7fdae51205f0>,2,12,[10  3],3,-1,16,-1,4
1,<environment.Job instance at 0x7fdae4e78500>,4,16,[6 3],5,-1,21,-1,5
1,<environment.Job instance at 0x7fdae4e78aa0>,7,18,[7 1],8,-1,26,-1,8
1,<environment.Job instance at 0x7fdae4e78140>,8,16,[10  3],9,-1,25,-1,9
1,<environment.Job instance at 0x7fdae4e78a50>,9,15,[9 3],10,-1,25,-1,10
1,<environment.Job instance at 0x7fdae5120190>,12,22,[6 2],13,-1,35,-1,13
1,<environment.Job instance at 0x7fdae5100280>,13,16,[4 9],14,-1,30,-1,14
1,<environment.Job instance at 0x7fdae5100af0>,14,23,[6 5],15,-1,38,-1,15
1,<environment.Job instance at 0x7fdae5100820>,18,12,[ 3 10],19,-1,31,-1,19
1,<environment.Job instance at 0x7fdae5100dc0>,21,12,[1 7],22,-1,34,-1,22
1,<environment.Job instance at 0x7fdae5100e10>,22,17,[1 6],23,-1,40,-1,23
1,<environment.Job instance at 0x7fdae51000f0>,23,21,[7 4],24,-1,45,-1,24
1,<environment.Job instance at 0x7fdae5120c30>,3,13,[5 1],4,-1,38,-1,25
1,<environment.Job instance at 0x7fdae48a7a00>,30,26,[5 7],31,-1,57,-1,31
1,<environment.Job instance at 0x7fdae48a7eb0>,31,16,[ 2 10],32,-1,50,-1,34
1,<environment.Job instance at 0x7fdae48a7cd0>,33,15,[10  1],34,-1,49,-1,34
1,<environment.Job instance at 0x7fdae48a7f50>,34,20,[5 9],35,-1,58,-1,38
1,<environment.Job instance at 0x7fdae48a7820>,38,18,[5 6],39,-1,57,-1,39
1,<environment.Job instance at 0x7fdae48a7dc0>,39,27,[5 9],40,-1,67,-1,40
1,<environment.Job instance at 0x7fdae58189b0>,44,16,[5 6],45,-1,61,-1,45
1,<environment.Job instance at 0x7fdae4e7d230>,57,14,[8 3],58,-1,73,-1,59
1,<environment.Job instance at 0x7fdae4e7d4b0>,56,18,[3 5],57,-1,105,-1,87
1,<environment.Job instance at 0x7fdae5818b40>,50,20,[5 8],51,-1,200,-1,180
1,<environment.Job instance at 0x7fdae4e383c0>,85,23,[7 4],86,-1,203,-1,180
1,<environment.Job instance at 0x7fdae4e38780>,92,18,[9 5],93,-1,198,-1,180
1,<environment.Job instance at 0x7fdae48d4cd0>,14,23,[6 5],15,-1,55,-1,32
1,<environment.Job instance at 0x7fdae48d0690>,25,15,[ 5 11],26,-1,81,-1,66
1,<environment.Job instance at 0x7fdae51008c0>,30,26,[5 7],31,-1,98,-1,72
1,<environment.Job instance at 0x7fdae4e38320>,39,27,[5 9],40,-1,118,-1,91
1,<environment.Job instance at 0x7fdae4ee25a0>,43,28,[3 5],44,-1,134,-1,106
1,<environment.Job instance at 0x7fdae4f80e60>,42,26,[ 1 10],43,-1,158,-1,132
1,<environment.Job instance at 0x7fdae5736870>,59,14,[ 1 13],60,-1,160,-1,146
1,<environment.Job instance at 0x7fdae541c0f0>,62,16,[11  5],63,-1,163,-1,147
1,<environment.Job instance at 0x7fdae544ee60>,85,23,[7 4],86,-1,254,-1,231
1,<environment.Job instance at 0x7fdae4ac3a00>,86,23,[5 6],87,-1,254,-1,231
1,<environment.Job instance at 0x7fdae544e410>,88,25,[ 5 10],89,-1,258,-1,233
1,<environment.Job instance at 0x7fdae4df2f00>,91,12,[ 5 11],92,-1,245,-1,233
1,<environment.Job instance at 0x7fdae545d0a0>,97,26,[ 2 10],98,-1,290,-1,264
1,<environment.Job instance at 0x7fdae5408780>,103,17,[ 5 12],104,-1,297,-1,280
1,<environment.Job instance at 0x7fdae4547b40>,5,15,[8 2],6,-1,23,-1,8
1,<environment.Job instance at 0x7fdae4547780>,11,18,[6 1],12,-1,30,-1,12
1,<environment.Job instance at 0x7fdae45310a0>,13,14,[2 9],14,-1,28,-1,14
1,<environment.Job instance at 0x7fdae4531910>,19,2,[6 4],20,-1,22,-1,20
1,<environment.Job instance at 0x7fdae4531960>,20,25,[8 3],21,-1,46,-1,21
1,<environment.Job instance at 0x7fdae45318c0>,21,27,[8 1],22,-1,49,-1,22
1,<environment.Job instance at 0x7fdae45310f0>,16,12,[3 5],17,-1,34,-1,22
1,<environment.Job instance at 0x7fdae45319b0>,22,1,[7 5],23,-1,24,-1,23
1,<environment.Job instance at 0x7fdae4531eb0>,26,17,[3 8],27,-1,44,-1,27
1,<environment.Job instance at 0x7fdae4531fa0>,27,27,[2 6],28,-1,55,-1,28
1,<environment.Job instance at 0x7fdae45530f0>,29,18,[5 2],30,-1,48,-1,30
1,<environment.Job instance at 0x7fdae4553460>,32,13,[9 4],33,-1,46,-1,33
1,<environment.Job instance at 0x7fdae45536e0>,35,18,[5 5],36,-1,54,-1,36
1,<environment.Job instance at 0x7fdae4553910>,36,14,[10  1],37,-1,52,-1,38
1,<environment.Job instance at 0x7fdae45539b0>,38,14,[3 7],39,-1,53,-1,39
1,<environment.Job instance at 0x7fdae4553690>,37,26,[ 5 10],38,-1,66,-1,40
1,<environment.Job instance at 0x7fdae4553780>,40,17,[4 8],41,-1,58,-1,41
1,<environment.Job instance at 0x7fdae4553b40>,41,17,[3 6],42,-1,59,-1,42
1,<environment.Job instance at 0x7fdae4553be0>,42,17,[ 4 10],43,-1,60,-1,43
1,<environment.Job instance at 0x7fdae4542780>,51,18,[5 5],52,-1,70,-1,52
1,<environment.Job instance at 0x7fdae4542550>,52,28,[5 1],53,-1,81,-1,53
1,<environment.Job instance at 0x7fdae454dcd0>,59,13,[ 1 13],60,-1,73,-1,60
1,<environment.Job instance at 0x7fdae45429b0>,54,17,[6 1],55,-1,78,-1,61
1,<environment.Job instance at 0x7fdae454d550>,61,17,[ 4 10],62,-1,80,-1,63
1,<environment.Job instance at 0x7fdae454d8c0>,64,23,[2 9],65,-1,88,-1,65
1,<environment.Job instance at 0x7fdae454d0a0>,65,18,[5 3],66,-1,84,-1,66
1,<environment.Job instance at 0x7fdae454d190>,67,15,[5 1],68,-1,83,-1,68
1,<environment.Job instance at 0x7fdae48510f0>,70,12,[ 4 10],71,-1,83,-1,71
1,<environment.Job instance at 0x7fdae5bc2320>,71,17,[6 1],72,-1,89,-1,72
1,<environment.Job instance at 0x7fdae50d8be0>,72,16,[9 2],73,-1,89,-1,73
1,<environment.Job instance at 0x7fdae50d8c30>,73,15,[5 8],74,-1,89,-1,74
1,<environment.Job instance at 0x7fdae5292550>,78,26,[2 5],79,-1,105,-1,79
1,<environment.Job instance at 0x7fdae4826140>,79,28,[4 8],80,-1,108,-1,80
1,<environment.Job instance at 0x7fdae50b9870>,80,28,[1 5],81,-1,109,-1,81
1,<environment.Job instance at 0x7fdae50b9820>,83,13,[10  1],84,-1,99,-1,86
1,<environment.Job instance at 0x7fdae45595f0>,86,22,[7 4],87,-1,109,-1,87
1,<environment.Job instance at 0x7fdae45599b0>,87,28,[ 1 10],88,-1,116,-1,88
1,<environment.Job instance at 0x7fdae50adaf0>,88,18,[5 5],89,-1,107,-1,89
1,<environment.Job instance at 0x7fdae50d9820>,94,18,[ 2 10],95,-1,115,-1,97
1,<environment.Job instance at 0x7fdae4832eb0>,98,14,[9 3],99,-1,115,-1,101
1,<environment.Job instance at 0x7fdae5438140>,102,18,[7 2],103,-1,121,-1,103
1,<environment.Job instance at 0x7fdae54381e0>,104,16,[5 8],105,-1,121,-1,105
1,<environment.Job instance at 0x7fdae54385a0>,105,16,[2 7],106,-1,124,-1,108
1,<environment.Job instance at 0x7fdae4542be0>,56,17,[3 7],57,-1,126,-1,109
1,<environment.Job instance at 0x7fdae54380a0>,107,12,[10  4],108,-1,127,-1,115
1,<environment.Job instance at 0x7fdae50dd870>,7,2,[ 5 11],8,-1,10,-1,8
1,<environment.Job instance at 0x7fdae5572730>,8,12,[12  2],9,-1,21,-1,9
1,<environment.Job instance at 0x7fdae454d050>,10,2,[ 4 14],11,-1,13,-1,11
1,<environment.Job instance at 0x7fdae4547d70>,20,25,[8 3],21,-1,57,-1,32
1,<environment.Job instance at 0x7fdae5408780>,21,27,[8 1],22,-1,59,-1,32
1,<environment.Job instance at 0x7fdae5413280>,27,27,[2 6],28,-1,77,-1,50
1,<environment.Job instance at 0x7fdae544ee60>,37,26,[ 5 10],38,-1,98,-1,72
1,<environment.Job instance at 0x7fdaee876fa0>,39,1,[12  4],40,-1,73,-1,72
1,<environment.Job instance at 0x7fdae4e8c370>,44,1,[ 1 11],45,-1,104,-1,103
1,<environment.Job instance at 0x7fdae4e8c0f0>,45,1,[ 3 14],46,-1,104,-1,103
1,<environment.Job instance at 0x7fdae5851a00>,52,28,[5 1],53,-1,149,-1,121
1,<environment.Job instance at 0x7fdae4debdc0>,59,13,[ 1 13],60,-1,154,-1,141
1,<environment.Job instance at 0x7fdae44e4050>,66,3,[14  4],67,-1,161,-1,158
1,<environment.Job instance at 0x7fdae4d4ffa0>,64,23,[2 9],65,-1,198,-1,175
1,<environment.Job instance at 0x7fdae4e38730>,78,26,[2 5],79,-1,235,-1,209
1,<environment.Job instance at 0x7fdae4e78eb0>,80,28,[1 5],81,-1,240,-1,212
1,<environment.Job instance at 0x7fdae4e78690>,79,28,[4 8],80,-1,249,-1,221
1,<environment.Job instance at 0x7fdae5120500>,87,28,[ 1 10],88,-1,257,-1,229
1,<environment.Job instance at 0x7fdae53d8500>,3,15,[3 5],4,-1,19,-1,4
1,<environment.Job instance at 0x7fdae53d8050>,6,20,[10  4],7,-1,27,-1,7
1,<environment.Job instance at 0x7fdae4855370>,9,13,[3 6],10,-1,23,-1,10
1,<environment.Job instance at 0x7fdae4855fa0>,15,17,[5 8],16,-1,33,-1,16
1,<environment.Job instance at 0x7fdae466bcd0>,20,16,[8 2],21,-1,37,-1,21
1,<environment.Job instance at 0x7fdae466bdc0>,21,12,[9 4],22,-1,35,-1,23
1,<environment.Job instance at 0x7fdae466b8c0>,22,17,[5 5],23,-1,40,-1,23
1,<environment.Job instance at 0x7fdae4e6b320>,29,15,[10  5],30,-1,45,-1,30
1,<environment.Job instance at 0x7fdae4e6b460>,31,24,[2 6],32,-1,56,-1,32
1,<environment.Job instance at 0x7fdae4e6b640>,32,15,[4 9],33,-1,49,-1,34
1,<environment.Job instance at 0x7fdae4e6b1e0>,33,13,[7 3],34,-1,49,-1,36
1,<environment.Job instance at 0x7fdae4e6b6e0>,35,3,[1 5],36,-1,40,-1,37
1,<environment.Job instance at 0x7fdae5bef190>,36,15,[6 4],37,-1,52,-1,37
1,<environment.Job instance at 0x7fdae5bef0f0>,39,16,[ 1 10],40,-1,56,-1,40
1,<environment.Job instance at 0x7fdaee8e3af0>,43,21,[5 4],44,-1,65,-1,44
1,<environment.Job instance at 0x7fdaee8e3dc0>,44,17,[11  5],45,-1,62,-1,45
1,<environment.Job instance at 0x7fdaee8e3410>,46,12,[10  3],47,-1,62,-1,50
1,<environment.Job instance at 0x7fdaee8e3a50>,49,14,[5 9],50,-1,66,-1,52
1,<environment.Job instance at 0x7fdae4f6e140>,52,18,[10  3],53,-1,73,-1,55
1,<environment.Job instance at 0x7fdae4f6e870>,54,24,[5 8],55,-1,79,-1,55
1,<environment.Job instance at 0x7fdae5aa1910>,57,18,[3 8],58,-1,78,-1,60
1,<environment.Job instance at 0x7fdae5aa15a0>,63,17,[7 2],64,-1,81,-1,64
1,<environment.Job instance at 0x7fdae5aa1fa0>,64,18,[1 8],65,-1,83,-1,65
1,<environment.Job instance at 0x7fdae5345d70>,66,23,[9 5],67,-1,90,-1,67
1,<environment.Job instance at 0x7fdae5345dc0>,67,18,[1 8],68,-1,86,-1,68
1,<environment.Job instance at 0x7fdae5345820>,69,17,[6 3],70,-1,87,-1,70
1,<environment.Job instance at 0x7fdae53458c0>,72,18,[1 6],73,-1,91,-1,73
1,<environment.Job instance at 0x7fdae5345280>,73,17,[10  3],74,-1,93,-1,76
1,<environment.Job instance at 0x7fdae5ab8be0>,75,16,[7 4],76,-1,92,-1,76
1,<environment.Job instance at 0x7fdae4743a00>,82,17,[6 3],83,-1,100,-1,83
1,<environment.Job instance at 0x7fdae4743c30>,83,27,[5 6],84,-1,111,-1,84
1,<environment.Job instance at 0x7fdae454b190>,92,16,[7 1],93,-1,109,-1,93
1,<environment.Job instance at 0x7fdae53c8d20>,23,24,[9 2],24,-1,76,-1,52
1,<environment.Job instance at 0x7fdae5c59050>,31,24,[2 6],32,-1,90,-1,66
1,<environment.Job instance at 0x7fdae4e38320>,44,17,[11  5],45,-1,121,-1,104
1,<environment.Job instance at 0x7fdae4f80e60>,45,15,[ 2 12],46,-1,119,-1,104
1,<environment.Job instance at 0x7fdae5736870>,54,24,[5 8],55,-1,174,-1,150
1,<environment.Job instance at 0x7fdae541cbe0>,60,2,[14  3],61,-1,154,-1,152
1,<environment.Job instance at 0x7fdae541c0f0>,56,24,[10  2],57,-1,181,-1,157
1,<environment.Job instance at 0x7fdae4e8caa0>,66,23,[9 5],67,-1,198,-1,175
1,<environment.Job instance at 0x7fdae4832140>,79,1,[13  5],80,-1,226,-1,225
1,<environment.Job instance at 0x7fdae50b9af0>,83,27,[5 6],84,-1,268,-1,241
1,<environment.Job instance at 0x7fdae50dd640>,86,16,[ 3 11],87,-1,262,-1,246
1,<environment.Job instance at 0x7fdae454d910>,88,25,[11  1],89,-1,271,-1,246
1,<environment.Job instance at 0x7fdae4531870>,94,27,[3 8],95,-1,280,-1,253
1,<environment.Job instance at 0x7fdae454b870>,100,18,[12  3],101,-1,281,-1,263
1,<environment.Job instance at 0x7fdae444c3c0>,105,27,[4 6],106,-1,323,-1,296
1,<environment.Job instance at 0x7fdae4660280>,0,16,[10  3],1,-1,20,-1,4
1,<environment.Job instance at 0x7fdae558e410>,3,12,[9 4],4,-1,16,-1,4
1,<environment.Job instance at 0x7fdae46555a0>,12,17,[3 8],13,-1,30,-1,13
1,<environment.Job instance at 0x7fdae4655cd0>,13,14,[4 9],14,-1,28,-1,14
1,<environment.Job instance at 0x7fdae4655be0>,14,28,[4 7],15,-1,43,-1,15
1,<environment.Job instance at 0x7fdae4655eb0>,15,13,[ 3 10],16,-1,32,-1,19
1,<environment.Job instance at 0x7fdae432acd0>,19,18,[8 2],20,-1,38,-1,20
1,<environment.Job instance at 0x7fdae432a6e0>,20,24,[9 4],21,-1,45,-1,21
1,<environment.Job instance at 0x7fdae432a280>,21,17,[5 4],22,-1,39,-1,22
1,<environment.Job instance at 0x7fdae432ae10>,26,18,[10  1],27,-1,45,-1,27
1,<environment.Job instance at 0x7fdae463b730>,27,12,[3 7],28,-1,40,-1,28
1,<environment.Job instance at 0x7fdae463b4b0>,28,16,[7 1],29,-1,45,-1,29
1,<environment.Job instance at 0x7fdae463b320>,29,15,[ 4 10],30,-1,45,-1,30
1,<environment.Job instance at 0x7fdae463b410>,30,17,[3 8],31,-1,48,-1,31
1,<environment.Job instance at 0x7fdae432ac80>,18,14,[10  3],19,-1,45,-1,31
1,<environment.Job instance at 0x7fdae463b050>,33,17,[7 3],34,-1,53,-1,36
1,<environment.Job instance at 0x7fdae434b6e0>,37,18,[3 9],38,-1,56,-1,38
1,<environment.Job instance at 0x7fdae434b5f0>,38,12,[3 9],39,-1,51,-1,39
1,<environment.Job instance at 0x7fdae4697e60>,43,17,[10  3],44,-1,61,-1,44
1,<environment.Job instance at 0x7fdae4697550>,46,16,[2 9],47,-1,63,-1,47
1,<environment.Job instance at 0x7fdae5b81c30>,47,22,[10  4],48,-1,70,-1,48
1,<environment.Job instance at 0x7fdae469bfa0>,48,21,[7 1],49,-1,70,-1,49
1,<environment.Job instance at 0x7fdae5819d70>,52,21,[5 3],53,-1,74,-1,53
1,<environment.Job instance at 0x7fdae4fbfb90>,54,15,[4 8],55,-1,70,-1,55
1,<environment.Job instance at 0x7fdae5026a50>,59,13,[3 8],60,-1,73,-1,60
1,<environment.Job instance at 0x7fdae5026410>,64,2,[2 5],65,-1,68,-1,66
1,<environment.Job instance at 0x7fdae4fdc550>,66,21,[10  2],67,-1,88,-1,67
1,<environment.Job instance at 0x7fdaee725b90>,60,14,[12  5],61,-1,82,-1,68
1,<environment.Job instance at 0x7fdae4fdc0a0>,68,12,[1 5],69,-1,81,-1,69
1,<environment.Job instance at 0x7fdae4fdc690>,70,13,[1 5],71,-1,84,-1,71
1,<environment.Job instance at 0x7fdae4fdc370>,67,15,[5 1],68,-1,86,-1,71
1,<environment.Job instance at 0x7fdae56cfc30>,72,15,[3 8],73,-1,88,-1,73
1,<environment.Job instance at 0x7fdae56cf780>,74,16,[8 4],75,-1,92,-1,76
1,<environment.Job instance at 0x7fdae4c05280>,76,14,[ 2 10],77,-1,92,-1,78
1,<environment.Job instance at 0x7fdae4ca3be0>,80,25,[ 4 10],81,-1,108,-1,83
1,<environment.Job instance at 0x7fdae4ca3b40>,81,22,[9 1],82,-1,105,-1,83
1,<environment.Job instance at 0x7fdae4ca3e10>,84,14,[ 2 11],85,-1,100,-1,86
1,<environment.Job instance at 0x7fdae4ca3780>,85,18,[2 9],86,-1,104,-1,86
1,<environment.Job instance at 0x7fdae4ca3820>,86,18,[10  3],87,-1,105,-1,87
1,<environment.Job instance at 0x7fdae4ca3370>,87,19,[ 2 10],88,-1,107,-1,88
1,<environment.Job instance at 0x7fdae4ca3aa0>,82,14,[7 5],83,-1,104,-1,90
1,<environment.Job instance at 0x7fdae4ca3b90>,78,14,[6 4],79,-1,104,-1,90
1,<environment.Job instance at 0x7fdae4ca35a0>,90,17,[ 5 14],91,-1,108,-1,91
1,<environment.Job instance at 0x7fdae474e780>,93,15,[5 7],94,-1,109,-1,94
1,<environment.Job instance at 0x7fdae474ef50>,94,16,[2 8],95,-1,111,-1,95
1,<environment.Job instance at 0x7fdae451c050>,106,16,[12  5],107,-1,123,-1,107
1,<environment.Job instance at 0x7fdae4ad5fa0>,10,14,[11  5],11,-1,31,-1,17
1,<environment.Job instance at 0x7fdae4659dc0>,14,28,[4 7],15,-1,59,-1,31
1,<environment.Job instance at 0x7fdae451cc30>,20,24,[9 4],21,-1,79,-1,55
1,<environment.Job instance at 0x7fdae490eaa0>,23,2,[12  3],24,-1,57,-1,55
1,<environment.Job instance at 0x7fdae50d94b0>,31,16,[12  1],32,-1,107,-1,91
1,<environment.Job instance at 0x7fdaee62ab90>,58,3,[14  4],59,-1,194,-1,191
1,<environment.Job instance at 0x7fdaee2bfaa0>,60,14,[12  5],61,-1,207,-1,193
1,<environment.Job instance at 0x7fdae5aee320>,80,25,[ 4 10],81,-1,283,-1,258
1,<environment.Job instance at 0x7fdae498f230>,84,14,[ 2 11],85,-1,276,-1,262
1,<environment.Job instance at 0x7fdae498fe60>,90,17,[ 5 14],91,-1,305,-1,288
1,<environment.Job instance at 0x7fdae438e280>,106,16,[12  5],107,-1,370,-1,354
1,<environment.Job instance at 0x7fdae48480a0>,5,18,[7 4],6,-1,24,-1,6
1,<environment.Job instance at 0x7fdae5c0f870>,9,17,[4 6],10,-1,27,-1,10
1,<environment.Job instance at 0x7fdae4833d20>,15,17,[4 6],16,-1,33,-1,16
1,<environment.Job instance at 0x7fdae5671a00>,16,15,[10  5],17,-1,37,-1,22
1,<environment.Job instance at 0x7fdae5725410>,22,17,[ 1 10],23,-1,40,-1,23
1,<environment.Job instance at 0x7fdae46e34b0>,24,15,[7 5],25,-1,40,-1,25
1,<environment.Job instance at 0x7fdae5a22b90>,26,15,[5 5],27,-1,42,-1,27
1,<environment.Job instance at 0x7fdae574c910>,27,17,[9 4],28,-1,45,-1,28
1,<environment.Job instance at 0x7fdae46fba00>,30,18,[2 9],31,-1,49,-1,31
1,<environment.Job instance at 0x7fdae572c3c0>,32,16,[2 8],33,-1,49,-1,33
1,<environment.Job instance at 0x7fdae55075f0>,33,12,[3 6],34,-1,46,-1,34
1,<environment.Job instance at 0x7fdae5c6e8c0>,21,13,[ 3 11],22,-1,47,-1,34
1,<environment.Job instance at 0x7fdae5533500>,43,15,[9 4],44,-1,59,-1,44
1,<environment.Job instance at 0x7fdae46ec820>,36,13,[10  2],37,-1,61,-1,48
1,<environment.Job instance at 0x7fdae54ff280>,39,20,[7 2],40,-1,68,-1,48
1,<environment.Job instance at 0x7fdae5533f00>,48,22,[ 3 10],49,-1,71,-1,49
1,<environment.Job instance at 0x7fdae5533dc0>,50,13,[ 2 13],51,-1,64,-1,51
1,<environment.Job instance at 0x7fdae5533550>,52,17,[5 8],53,-1,70,-1,53
1,<environment.Job instance at 0x7fdae551c820>,51,14,[ 5 10],52,-1,68,-1,54
1,<environment.Job instance at 0x7fdae551c7d0>,54,19,[3 7],55,-1,75,-1,56
1,<environment.Job instance at 0x7fdae551c5f0>,55,12,[ 4 10],56,-1,68,-1,56
1,<environment.Job instance at 0x7fdae54ff460>,41,12,[6 3],42,-1,71,-1,59
1,<environment.Job instance at 0x7fdae4e720f0>,57,23,[3 5],58,-1,82,-1,59
1,<environment.Job instance at 0x7fdae4e72190>,59,16,[1 8],60,-1,76,-1,60
1,<environment.Job instance at 0x7fdae4e72c80>,69,23,[8 2],70,-1,102,-1,79
1,<environment.Job instance at 0x7fdae4e72500>,65,15,[4 9],66,-1,94,-1,79
1,<environment.Job instance at 0x7fdae4e72f00>,73,19,[3 9],74,-1,98,-1,79
1,<environment.Job instance at 0x7fdae4e72e10>,75,17,[9 1],76,-1,96,-1,79
1,<environment.Job instance at 0x7fdae4e729b0>,66,16,[6 2],67,-1,96,-1,80
1,<environment.Job instance at 0x7fdae4ea0320>,79,18,[5 3],80,-1,98,-1,80
1,<environment.Job instance at 0x7fdae4ea09b0>,81,20,[10  2],82,-1,103,-1,83
1,<environment.Job instance at 0x7fdae4ea0910>,83,15,[ 3 14],84,-1,100,-1,85
1,<environment.Job instance at 0x7fdae54ff190>,40,16,[1 9],41,-1,101,-1,85
1,<environment.Job instance at 0x7fdae4ea0280>,77,14,[5 6],78,-1,99,-1,85
1,<environment.Job instance at 0x7fdae4ea0b90>,85,15,[2 6],86,-1,101,-1,86
1,<environment.Job instance at 0x7fdae4ea0cd0>,87,18,[1 8],88,-1,106,-1,88
1,<environment.Job instance at 0x7fdae4e8e0a0>,90,18,[8 3],91,-1,109,-1,91
1,<environment.Job instance at 0x7fdae4e8e5f0>,95,15,[14  4],96,-1,116,-1,101
1,<environment.Job instance at 0x7fdae4e8e410>,94,12,[4 5],95,-1,113,-1,101
1,<environment.Job instance at 0x7fdae4e8e3c0>,93,17,[6 1],94,-1,119,-1,102
1,<environment.Job instance at 0x7fdae4e8e820>,99,27,[3 5],100,-1,129,-1,102
1,<environment.Job instance at 0x7fdae4e8e550>,97,20,[1 5],98,-1,124,-1,104
1,<environment.Job instance at 0x7fdae4e72dc0>,71,16,[1 7],72,-1,120,-1,104
1,<environment.Job instance at 0x7fdae4e8e8c0>,100,13,[4 7],101,-1,117,-1,104
1,<environment.Job instance at 0x7fdae4e8e1e0>,102,2,[12  2],103,-1,106,-1,104
1,<environment.Job instance at 0x7fdae4e8eb90>,103,13,[3 7],104,-1,117,-1,104
1,<environment.Job instance at 0x7fdae4e8ec30>,104,15,[7 4],105,-1,120,-1,105
1,<environment.Job instance at 0x7fdae4e8e9b0>,101,16,[5 5],102,-1,123,-1,107
1,<environment.Job instance at 0x7fdae4e8efa0>,107,17,[4 9],108,-1,126,-1,109
1,<environment.Job instance at 0x7fdae4e72820>,14,12,[ 4 13],15,-1,31,-1,19
1,<environment.Job instance at 0x7fdae4ea0fa0>,20,2,[ 2 12],21,-1,37,-1,35
1,<environment.Job instance at 0x7fdaee7a1550>,21,13,[ 3 11],22,-1,48,-1,35
1,<environment.Job instance at 0x7fdae498f4b0>,35,1,[14  5],36,-1,99,-1,98
1,<environment.Job instance at 0x7fdae498fa00>,37,2,[ 5 12],38,-1,100,-1,98
1,<environment.Job instance at 0x7fdae5aee320>,45,2,[ 2 12],46,-1,133,-1,131
1,<environment.Job instance at 0x7fdae5aee780>,50,13,[ 2 13],51,-1,162,-1,149
1,<environment.Job instance at 0x7fdae5aee370>,57,23,[3 5],58,-1,200,-1,177
1,<environment.Job instance at 0x7fdaee2bf280>,60,28,[2 6],61,-1,231,-1,203
1,<environment.Job instance at 0x7fdae4d712d0>,70,1,[13  1],71,-1,211,-1,210
1,<environment.Job instance at 0x7fdae4d71f50>,69,23,[8 2],70,-1,235,-1,212
1,<environment.Job instance at 0x7fdae558ea50>,83,15,[ 3 14],84,-1,271,-1,256
1,<environment.Job instance at 0x7fdae54085f0>,88,3,[13  1],89,-1,278,-1,275
1,<environment.Job instance at 0x7fdae4553320>,95,15,[14  4],96,-1,307,-1,292
1,<environment.Job instance at 0x7fdae43da910>,98,27,[6 3],99,-1,337,-1,310
1,<environment.Job instance at 0x7fdae451cc30>,99,27,[3 5],100,-1,350,-1,323
1,<environment.Job instance at 0x7fdae4f6cc80>,102,2,[12  2],103,-1,325,-1,323
1,<environment.Job instance at 0x7f11cfa906e0>,0,13,[9 3],1,-1,15,-1,2
1,<environment.Job instance at 0x7f11cfa908c0>,1,22,[11  3],2,-1,24,-1,2
1,<environment.Job instance at 0x7f11cfa90730>,2,22,[4 8],3,-1,25,-1,3
1,<environment.Job instance at 0x7f11c64a0fa0>,9,18,[11  5],10,-1,28,-1,10
1,<environment.Job instance at 0x7f11c64a30f0>,11,15,[4 8],12,-1,27,-1,12
1,<environment.Job instance at 0x7f11c64a3320>,12,26,[ 1 10],13,-1,39,-1,13
1,<environment.Job instance at 0x7f11c64a3230>,13,18,[ 4 10],14,-1,32,-1,14
1,<environment.Job instance at 0x7f11c64a3460>,15,18,[2 8],16,-1,34,-1,16
1,<environment.Job instance at 0x7f11c64a3640>,16,16,[3 5],17,-1,33,-1,17
1,<environment.Job instance at 0x7f11c64a3b90>,23,27,[1 6],24,-1,51,-1,24
1,<environment.Job instance at 0x7f11c64a3d20>,24,18,[2 6],25,-1,43,-1,25
1,<environment.Job instance at 0x7f11c64a60a0>,27,15,[8 4],28,-1,43,-1,28
1,<environment.Job instance at 0x7f11c64a61e0>,28,23,[10  4],29,-1,52,-1,29
1,<environment.Job instance at 0x7f11c64a6140>,29,12,[5 4],30,-1,42,-1,30
1,<environment.Job instance at 0x7f11c64a6320>,30,14,[5 2],31,-1,45,-1,31
1,<environment.Job instance at 0x7f11c64a63c0>,31,14,[2 5],32,-1,46,-1,32
1,<environment.Job instance at 0x7f11c64a6500>,33,14,[5 5],34,-1,48,-1,34
1,<environment.Job instance at 0x7f11c64a6550>,35,15,[9 5],36,-1,52,-1,37
1,<environment.Job instance at 0x7f11c64a6be0>,40,15,[10  3],41,-1,57,-1,42
1,<environment.Job instance at 0x7f11c64a6d20>,43,18,[5 5],44,-1,62,-1,44
1,<environment.Job instance at 0x7f11c64a80a0>,45,13,[6 5],46,-1,60,-1,47
1,<environment.Job instance at 0x7f11c64a8190>,46,17,[12  2],47,-1,64,-1,47
1,<environment.Job instance at 0x7f11c64a87d0>,54,13,[13  1],55,-1,70,-1,57
1,<environment.Job instance at 0x7f11c64a8370>,49,16,[2 5],50,-1,74,-1,58
1,<environment.Job instance at 0x7f11c64a8910>,56,17,[8 5],57,-1,75,-1,58
1,<environment.Job instance at 0x7f11c64a8320>,48,15,[10  1],49,-1,73,-1,58
1,<environment.Job instance at 0x7f11c64ab0a0>,62,22,[6 4],63,-1,91,-1,69
1,<environment.Job instance at 0x7f11c64a8cd0>,59,17,[1 6],60,-1,89,-1,72
1,<environment.Job instance at 0x7f11c64a8c30>,57,18,[2 8],58,-1,91,-1,73
1,<environment.Job instance at 0x7f11c64ab3c0>,67,27,[ 1 10],68,-1,100,-1,73
1,<environment.Job instance at 0x7f11c64ab1e0>,64,18,[2 9],65,-1,93,-1,75
1,<environment.Job instance at 0x7f11c64a8780>,53,17,[5 7],54,-1,92,-1,75
1,<environment.Job instance at 0x7f11c64ab500>,69,13,[ 3 12],70,-1,89,-1,76
1,<environment.Job instance at 0x7f11c64abc80>,76,19,[4 8],77,-1,96,-1,77
1,<environment.Job instance at 0x7f11c64ab190>,65,20,[2 6],66,-1,99,-1,79
1,<environment.Job instance at 0x7f11c64abd20>,78,12,[10  2],79,-1,91,-1,79
1,<environment.Job instance at 0x7f11c64abe60>,77,13,[8 5],78,-1,92,-1,79
1,<environment.Job instance at 0x7f11c64abaf0>,74,14,[5 1],75,-1,94,-1,80
1,<environment.Job instance at 0x7f11c64ae140>,79,13,[9 4],80,-1,94,-1,81
1,<environment.Job instance at 0x7f11c64ae230>,82,16,[ 4 10],83,-1,116,-1,100
1,<environment.Job instance at 0x7f11c64ae2d0>,84,18,[3 7],85,-1,120,-1,102
1,<environment.Job instance at 0x7f11c64ae460>,85,17,[3 9],86,-1,119,-1,102
1,<environment.Job instance at 0x7f11c64ae3c0>,83,20,[7 1],84,-1,124,-1,104
1,<environment.Job instance at 0x7f11c64a8500>,50,16,[12  2],51,-1,121,-1,105
1,<environment.Job instance at 0x7f11c64ae8c0>,92,20,[1 5],93,-1,126,-1,106
1,<environment.Job instance at 0x7f11c64abeb0>,75,14,[ 4 11],76,-1,120,-1,106
1,<environment.Job instance at 0x7f11c64aeaa0>,95,15,[5 7],96,-1,121,-1,106
1,<environment.Job instance at 0x7f11c64aed20>,99,18,[12  5],100,-1,124,-1,106
1,<environment.Job instance at 0x7f11cfad6140>,100,18,[2 7],101,-1,126,-1,108
1,<environment.Job instance at 0x7f11cfac6780>,101,18,[ 1 10],102,-1,127,-1,109
1,<environment.Job instance at 0x7f11c649a0a0>,102,16,[3 9],103,-1,125,-1,109
1,<environment.Job instance at 0x7f11c6497f00>,103,16,[1 6],104,-1,125,-1,109
1,<environment.Job instance at 0x7f11c64976e0>,104,15,[1 9],105,-1,124,-1,109
1,<environment.Job instance at 0x7f11c64d95a0>,107,17,[9 3],108,-1,131,-1,114
1,<environment.Job instance at 0x7f11c64d9640>,106,15,[11  1],107,-1,130,-1,115
1,<environment.Job instance at 0x7f11c64ae500>,86,18,[9 2],87,-1,133,-1,115
1,<environment.Job instance at 0x7f11c65bf7d0>,113,15,[6 1],114,-1,131,-1,116
1,<environment.Job instance at 0x7f11c66d1140>,115,16,[7 5],116,-1,133,-1,117
1,<environment.Job instance at 0x7f11c64a3730>,1,22,[11  3],2,-1,24,-1,2
1,<environment.Job instance at 0x7f11c64a8e60>,9,18,[11  5],10,-1,32,-1,14
1,<environment.Job instance at 0x7f11c64ab0f0>,12,26,[ 1 10],13,-1,82,-1,56
1,<environment.Job instance at 0x7f11c654af00>,23,27,[1 6],24,-1,87,-1,60
1,<environment.Job instance at 0x7f11c64a0870>,28,23,[10  4],29,-1,97,-1,74
1,<environment.Job instance at 0x7f11c64c8050>,34,24,[1 8],35,-1,117,-1,93
1,<environment.Job instance at 0x7f11c64c8cd0>,36,13,[ 3 14],37,-1,106,-1,93
1,<environment.Job instance at 0x7f11c6529d20>,46,17,[12  2],47,-1,134,-1,117
1,<environment.Job instance at 0x7f11c6550640>,50,16,[12  2],51,-1,146,-1,130
1,<environment.Job instance at 0x7f11c65506e0>,54,13,[13  1],55,-1,158,-1,145
1,<environment.Job instance at 0x7f11c65ab820>,60,3,[12  3],61,-1,169,-1,166
1,<environment.Job instance at 0x7f11c654fcd0>,67,27,[ 1 10],68,-1,216,-1,189
1,<environment.Job instance at 0x7f11c654fd70>,69,13,[ 3 12],70,-1,202,-1,189
1,<environment.Job instance at 0x7f11c654feb0>,75,14,[ 4 11],76,-1,215,-1,201
1,<environment.Job instance at 0x7f11c64f7e60>,97,2,[ 5 11],98,-1,294,-1,292
1,<environment.Job instance at 0x7f11c64ec6e0>,99,18,[12  5],100,-1,312,-1,294
1,<environment.Job instance at 0x7f11c648b500>,105,14,[14  5],106,-1,341,-1,327
1,<environment.Job instance at 0x7f11c6488410>,106,15,[11  1],107,-1,342,-1,327
1,<environment.Job instance at 0x7f11c6483500>,116,3,[ 1 12],117,-1,363,-1,360
1,<environment.Job instance at 0x7f11c6488eb0>,111,26,[ 5 10],112,-1,396,-1,370
1,<environment.Job instance at 0x7f11c5becd20>,10,15,[8 3],11,-1,26,-1,11
1,<environment.Job instance at 0x7f11c5bec9b0>,12,13,[ 5 10],13,-1,27,-1,14
1,<environment.Job instance at 0x7f11c5becdc0>,15,14,[ 2 10],16,-1,30,-1,16
1,<environment.Job instance at 0x7f11c5bec0a0>,17,20,[9 2],18,-1,38,-1,18
1,<environment.Job instance at 0x7f11c5bea140>,18,16,[11  2],19,-1,35,-1,19
1,<environment.Job instance at 0x7f11c5bea8c0>,19,18,[ 1 12],20,-1,38,-1,20
1,<environment.Job instance at 0x7f11c5bea4b0>,20,16,[2 8],21,-1,37,-1,21
1,<environment.Job instance at 0x7f11c5bea050>,21,13,[5 6],22,-1,35,-1,22
1,<environment.Job instance at 0x7f11c5bccfa0>,26,17,[1 7],27,-1,44,-1,27
1,<environment.Job instance at 0x7f11c5bef7d0>,31,15,[10  4],32,-1,47,-1,32
1,<environment.Job instance at 0x7f11c5bef730>,32,14,[1 8],33,-1,47,-1,33
1,<environment.Job instance at 0x7f11c5a4fc80>,34,14,[8 4],35,-1,49,-1,35
1,<environment.Job instance at 0x7f11c5ab9370>,38,14,[9 5],39,-1,53,-1,39
1,<environment.Job instance at 0x7f11c5b2a050>,41,15,[1 7],42,-1,57,-1,42
1,<environment.Job instance at 0x7f11c5be98c0>,43,15,[5 2],44,-1,59,-1,44
1,<environment.Job instance at 0x7f11c643aaa0>,48,19,[6 4],49,-1,68,-1,49
1,<environment.Job instance at 0x7f11c5a93050>,53,18,[6 5],54,-1,72,-1,54
1,<environment.Job instance at 0x7f11c5a96640>,55,16,[ 2 10],56,-1,72,-1,56
1,<environment.Job instance at 0x7f11c5aa3050>,57,21,[ 3 10],58,-1,79,-1,58
1,<environment.Job instance at 0x7f11c5aaffa0>,59,14,[2 6],60,-1,74,-1,60
1,<environment.Job instance at 0x7f11c5a3c9b0>,68,21,[9 4],69,-1,94,-1,73
1,<environment.Job instance at 0x7f11c5bc28c0>,13,16,[ 3 10],14,-1,90,-1,74
1,<environment.Job instance at 0x7f11c5a3ca50>,71,17,[10  2],72,-1,118,-1,101
1,<environment.Job instance at 0x7f11c5a38be0>,80,13,[10  5],81,-1,114,-1,101
1,<environment.Job instance at 0x7f11c5a3c550>,70,18,[10  3],71,-1,119,-1,101
1,<environment.Job instance at 0x7f11c5a383c0>,83,14,[7 5],84,-1,115,-1,101
1,<environment.Job instance at 0x7f11c5a38320>,85,14,[10  2],86,-1,115,-1,101
1,<environment.Job instance at 0x7f11c5a38140>,82,14,[2 7],83,-1,118,-1,104
1,<environment.Job instance at 0x7f11c5a3a050>,94,16,[7 2],95,-1,128,-1,112
1,<environment.Job instance at 0x7f11c5a3b910>,100,18,[4 5],101,-1,131,-1,113
1,<environment.Job instance at 0x7f11c5aafc80>,2,3,[ 4 12],3,-1,6,-1,3
1,<environment.Job instance at 0x7f11c5a3c910>,3,12,[ 4 11],4,-1,16,-1,4
1,<environment.Job instance at 0x7f11c5a3bc30>,8,23,[ 2 14],9,-1,32,-1,9
1,<environment.Job instance at 0x7f11cfc0abe0>,18,16,[11  2],19,-1,44,-1,28
1,<environment.Job instance at 0x7f11c5c75c30>,19,18,[ 1 12],20,-1,46,-1,28
1,<environment.Job instance at 0x7f11c5c9faa0>,23,15,[ 1 12],24,-1,57,-1,42
1,<environment.Job instance at 0x7f11c5ce16e0>,25,3,[ 4 13],26,-1,46,-1,43
1,<environment.Job instance at 0x7f11c5ce5f50>,27,1,[ 1 14],28,-1,46,-1,45
1,<environment.Job instance at 0x7f11c5c45e60>,40,3,[13  3],41,-1,97,-1,94
1,<environment.Job instance at 0x7f11c5c9c8c0>,45,13,[ 1 14],46,-1,113,-1,100
1,<environment.Job instance at 0x7f11c5c48eb0>,56,2,[11  5],57,-1,132,-1,130
1,<environment.Job instance at 0x7f11c5c5edc0>,58,3,[14  4],59,-1,135,-1,132
1,<environment.Job instance at 0x7f11c5c64f50>,78,12,[14  4],79,-1,208,-1,196
1,<environment.Job instance at 0x7f11c5c96dc0>,88,2,[13  1],89,-1,233,-1,231
1,<environment.Job instance at 0x7f11c5bf59b0>,91,3,[13  5],92,-1,243,-1,240
1,<environment.Job instance at 0x7f11c5bf5870>,92,2,[ 1 12],93,-1,242,-1,240
1,<environment.Job instance at 0x7f11c5df3eb0>,102,1,[ 4 13],103,-1,272,-1,271
1,<environment.Job instance at 0x7f11c5df3730>,103,14,[11  3],104,-1,285,-1,271
1,<environment.Job instance at 0x7f11c5a4f870>,4,16,[7 5],5,-1,23,-1,7
1,<environment.Job instance at 0x7f11c5a4f140>,6,16,[7 4],7,-1,23,-1,7
1,<environment.Job instance at 0x7f11c5a4f230>,8,18,[4 6],9,-1,30,-1,12
1,<environment.Job instance at 0x7f11c5a4ffa0>,12,26,[8 4],13,-1,39,-1,13
1,<environment.Job instance at 0x7f11c5a4f730>,14,14,[5 5],15,-1,29,-1,15
1,<environment.Job instance at 0x7f11c5a4feb0>,11,27,[4 7],12,-1,43,-1,16
1,<environment.Job instance at 0x7f11c5a4fd20>,18,18,[4 5],19,-1,39,-1,21
1,<environment.Job instance at 0x7f11cfc00d70>,27,13,[9 2],28,-1,41,-1,28
1,<environment.Job instance at 0x7f11cfc00410>,28,15,[3 6],29,-1,44,-1,29
1,<environment.Job instance at 0x7f11cfc008c0>,30,17,[2 6],31,-1,48,-1,31
1,<environment.Job instance at 0x7f11cfc00050>,31,15,[8 4],32,-1,47,-1,32
1,<environment.Job instance at 0x7f11cfc02820>,33,23,[10  1],34,-1,57,-1,34
1,<environment.Job instance at 0x7f11cfc02870>,35,1,[8 1],36,-1,37,-1,36
1,<environment.Job instance at 0x7f11cfc02190>,36,28,[6 5],37,-1,65,-1,37
1,<environment.Job instance at 0x7f11cfc02c30>,37,18,[5 9],38,-1,56,-1,38
1,<environment.Job instance at 0x7f11df3600a0>,20,25,[ 3 10],21,-1,63,-1,38
1,<environment.Job instance at 0x7f11c5b280a0>,44,15,[10  4],45,-1,61,-1,46
1,<environment.Job instance at 0x7f11c5b286e0>,45,18,[11  3],46,-1,64,-1,46
1,<environment.Job instance at 0x7f11c5b28be0>,49,28,[5 3],50,-1,79,-1,51
1,<environment.Job instance at 0x7f11cfc0aaa0>,52,18,[8 2],53,-1,71,-1,53
1,<environment.Job instance at 0x7f11cfc0a8c0>,55,17,[4 6],56,-1,73,-1,56
1,<environment.Job instance at 0x7f11cfc0a870>,57,14,[ 1 10],58,-1,72,-1,58
1,<environment.Job instance at 0x7f11cfab88c0>,62,25,[6 3],63,-1,91,-1,66
1,<environment.Job instance at 0x7f11cfab8c80>,68,17,[3 6],69,-1,86,-1,69
1,<environment.Job instance at 0x7f11cfab83c0>,69,15,[ 5 10],70,-1,87,-1,72
1,<environment.Job instance at 0x7f11cfc09f00>,71,14,[8 2],72,-1,88,-1,74
1,<environment.Job instance at 0x7f11cfc099b0>,74,15,[5 1],75,-1,93,-1,78
1,<environment.Job instance at 0x7f11cfc09960>,73,20,[2 6],74,-1,101,-1,81
1,<environment.Job instance at 0x7f11c5a4f190>,0,24,[ 1 10],1,-1,25,-1,1
1,<environment.Job instance at 0x7f11c5a4f910>,3,24,[7 4],4,-1,28,-1,4
1,<environment.Job instance at 0x7f11c5b28f50>,5,3,[12  3],6,-1,9,-1,6
1,<environment.Job instance at 0x7f11c5b28640>,11,27,[4 7],12,-1,49,-1,22
1,<environment.Job instance at 0x7f11c622e3c0>,12,26,[8 4],13,-1,48,-1,22
1,<environment.Job instance at 0x7f11c5d413c0>,15,16,[14  1],16,-1,38,-1,22
1,<environment.Job instance at 0x7f11cf606230>,20,25,[ 3 10],21,-1,68,-1,43
1,<environment.Job instance at 0x7f11c63325a0>,33,23,[10  1],34,-1,89,-1,66
1,<environment.Job instance at 0x7f11c6b74280>,36,28,[6 5],37,-1,95,-1,67
1,<environment.Job instance at 0x7f11c5dfb280>,41,15,[14  1],42,-1,95,-1,80
1,<environment.Job instance at 0x7f11c6c8eaf0>,45,18,[11  3],46,-1,102,-1,84
1,<environment.Job instance at 0x7f11c5be9cd0>,49,28,[5 3],50,-1,130,-1,102
1,<environment.Job instance at 0x7f11c6245c30>,62,25,[6 3],63,-1,163,-1,138
1,<environment.Job instance at 0x7f11c5d9b5f0>,79,18,[13  1],80,-1,211,-1,193
1,<environment.Job instance at 0x7f11c5d9b820>,82,3,[ 3 11],83,-1,198,-1,195
1,<environment.Job instance at 0x7f11c5ce5050>,90,24,[2 8],91,-1,254,-1,230
1,<environment.Job instance at 0x7f11c5d025f0>,91,24,[9 1],92,-1,254,-1,230
1,<environment.Job instance at 0x7f11c5ee1370>,93,24,[10  5],94,-1,257,-1,233
1,<environment.Job instance at 0x7f11c5ee1be0>,94,23,[10  2],95,-1,256,-1,233
1,<environment.Job instance at 0x7f11c5ee11e0>,95,15,[ 1 11],96,-1,248,-1,233
1,<environment.Job instance at 0x7f11c5e170a0>,107,15,[ 3 12],108,-1,294,-1,279
1,<environment.Job instance at 0x7f11c6871280>,0,27,[ 5 10],1,-1,28,-1,1
1,<environment.Job instance at 0x7f11c6871870>,1,17,[7 5],2,-1,19,-1,2
1,<environment.Job instance at 0x7f11c68712d0>,6,25,[ 5 10],7,-1,32,-1,7
1,<environment.Job instance at 0x7f11c6871fa0>,8,18,[1 5],9,-1,27,-1,9
1,<environment.Job instance at 0x7f11c6adf6e0>,15,13,[5 5],16,-1,29,-1,16
1,<environment.Job instance at 0x7f11c6909e10>,25,16,[10  4],26,-1,42,-1,26
1,<environment.Job instance at 0x7f11c69097d0>,30,18,[9 5],31,-1,60,-1,42
1,<environment.Job instance at 0x7f11c6909550>,39,17,[8 1],40,-1,59,-1,42
1,<environment.Job instance at 0x7f11c69096e0>,37,15,[2 9],38,-1,57,-1,42
1,<environment.Job instance at 0x7f11c6909500>,38,1,[2 6],39,-1,43,-1,42
1,<environment.Job instance at 0x7f11c61408c0>,41,17,[2 6],42,-1,66,-1,49
1,<environment.Job instance at 0x7f11c6140b40>,42,19,[8 2],43,-1,68,-1,49
1,<environment.Job instance at 0x7f11c61401e0>,44,17,[ 5 14],45,-1,66,-1,49
1,<environment.Job instance at 0x7f11c69095f0>,34,17,[7 2],35,-1,68,-1,51
1,<environment.Job instance at 0x7f11c6140be0>,48,14,[ 2 10],49,-1,65,-1,51
1,<environment.Job instance at 0x7f11c6140d70>,50,18,[3 5],51,-1,71,-1,53
1,<environment.Job instance at 0x7f11c6140870>,49,17,[9 1],50,-1,73,-1,56
1,<environment.Job instance at 0x7f11c6b21960>,58,14,[4 6],59,-1,75,-1,61
1,<environment.Job instance at 0x7f11c6b21cd0>,59,15,[10  2],60,-1,77,-1,62
1,<environment.Job instance at 0x7f11c6b21f50>,61,12,[5 5],62,-1,74,-1,62
1,<environment.Job instance at 0x7f11c6b219b0>,63,13,[4 9],64,-1,81,-1,68
1,<environment.Job instance at 0x7f11c6b218c0>,67,3,[10  2],68,-1,71,-1,68
1,<environment.Job instance at 0x7f11c6b21c80>,60,13,[5 6],61,-1,81,-1,68
1,<environment.Job instance at 0x7f11c6b21640>,70,16,[10  2],71,-1,88,-1,72
1,<environment.Job instance at 0x7f11c68e8910>,74,21,[7 2],75,-1,96,-1,75
1,<environment.Job instance at 0x7f11c68e8280>,78,16,[6 3],79,-1,100,-1,84
1,<environment.Job instance at 0x7f11c68e8d70>,71,13,[4 5],72,-1,97,-1,84
1,<environment.Job instance at 0x7f11c5f59c80>,89,27,[1 5],90,-1,141,-1,114
1,<environment.Job instance at 0x7f11c6909690>,36,12,[8 3],37,-1,132,-1,120
1,<environment.Job instance at 0x7f11c692c8c0>,95,14,[ 5 12],96,-1,134,-1,120
1,<environment.Job instance at 0x7f11c692c280>,97,19,[14  4],98,-1,139,-1,120
1,<environment.Job instance at 0x7f11c5f59be0>,88,15,[8 5],89,-1,135,-1,120
1,<environment.Job instance at 0x7f11c62dcd20>,99,14,[ 5 11],100,-1,134,-1,120
1,<environment.Job instance at 0x7f11c692caa0>,96,18,[4 6],97,-1,144,-1,126
1,<environment.Job instance at 0x7f11d6e74fa0>,98,17,[7 4],99,-1,143,-1,126
1,<environment.Job instance at 0x7f11c68e8140>,80,18,[4 7],81,-1,145,-1,127
1,<environment.Job instance at 0x7f11c68e8b90>,83,14,[2 7],84,-1,142,-1,128
1,<environment.Job instance at 0x7f11c65e8b40>,109,27,[9 3],110,-1,163,-1,136
1,<environment.Job instance at 0x7f11c65977d0>,102,18,[6 3],103,-1,154,-1,136
1,<environment.Job instance at 0x7f11cf64d0f0>,105,16,[6 3],106,-1,157,-1,141
1,<environment.Job instance at 0x7f11c67c1fa0>,114,17,[8 5],115,-1,163,-1,146
1,<environment.Job instance at 0x7f11c6adfc30>,0,27,[ 5 10],1,-1,28,-1,1
1,<environment.Job instance at 0x7f11c6b21a50>,6,25,[ 5 10],7,-1,40,-1,15
1,<environment.Job instance at 0x7f11c670d370>,22,17,[12  4],23,-1,61,-1,44
1,<environment.Job instance at 0x7f11c6871960>,35,2,[ 4 11],36,-1,63,-1,61
1,<environment.Job instance at 0x7f11c5ee2550>,43,2,[ 2 14],44,-1,94,-1,92
1,<environment.Job instance at 0x7f11c5de0280>,44,17,[ 5 14],45,-1,109,-1,92
1,<environment.Job instance at 0x7f11c6245eb0>,46,2,[11  3],47,-1,94,-1,92
1,<environment.Job instance at 0x7f11c5de0230>,47,2,[12  2],48,-1,94,-1,92
1,<environment.Job instance at 0x7f11c5eaf960>,52,2,[12  5],53,-1,126,-1,124
1,<environment.Job instance at 0x7f11c6c8e140>,54,1,[14  4],55,-1,125,-1,124
1,<environment.Job instance at 0x7f11c5e9fdc0>,73,1,[ 5 12],74,-1,195,-1,194
1,<environment.Job instance at 0x7f11c627d320>,82,14,[ 1 11],83,-1,233,-1,219
1,<environment.Job instance at 0x7f11c623fc30>,84,3,[14  4],85,-1,229,-1,226
1,<environment.Job instance at 0x7f11cfc09780>,86,2,[13  4],87,-1,230,-1,228
1,<environment.Job instance at 0x7f11c679e230>,89,27,[1 5],90,-1,269,-1,242
1,<environment.Job instance at 0x7f11c679e6e0>,95,14,[ 5 12],96,-1,260,-1,246
1,<environment.Job instance at 0x7f11c679e0a0>,97,19,[14  4],98,-1,268,-1,249
1,<environment.Job instance at 0x7f11c679e4b0>,99,14,[ 5 11],100,-1,263,-1,249
1,<environment.Job instance at 0x7f11c62ee910>,106,25,[3 8],107,-1,309,-1,284
1,<environment.Job instance at 0x7f11c632c410>,108,3,[ 5 14],109,-1,287,-1,284
1,<environment.Job instance at 0x7f11c632caf0>,109,27,[9 3],110,-1,324,-1,297
1,<environment.Job instance at 0x7f11c6f823c0>,112,24,[ 3 10],113,-1,328,-1,304
1,<environment.Job instance at 0x7f11c62f3cd0>,117,12,[ 2 12],118,-1,322,-1,310
1,<environment.Job instance at 0x7f11c62f3280>,118,27,[1 7],119,-1,339,-1,312
1,<environment.Job instance at 0x7f11c68fe500>,4,16,[10  3],5,-1,21,-1,5
1,<environment.Job instance at 0x7f11c68fe780>,7,13,[6 4],8,-1,21,-1,8
1,<environment.Job instance at 0x7f11c68f50f0>,8,14,[10  3],9,-1,23,-1,9
1,<environment.Job instance at 0x7f11c60c4f50>,10,19,[1 5],11,-1,30,-1,11
1,<environment.Job instance at 0x7f11c68f55a0>,11,18,[2 9],12,-1,30,-1,12
1,<environment.Job instance at 0x7f11c68f57d0>,12,18,[10  4],13,-1,31,-1,13
1,<environment.Job instance at 0x7f11c68d9190>,17,18,[5 1],18,-1,36,-1,18
1,<environment.Job instance at 0x7f11c68d9a00>,19,15,[9 5],20,-1,35,-1,20
1,<environment.Job instance at 0x7f11c68d95a0>,21,13,[5 3],22,-1,36,-1,23
1,<environment.Job instance at 0x7f11c68d9aa0>,23,18,[5 9],24,-1,42,-1,24
1,<environment.Job instance at 0x7f11c68936e0>,24,12,[6 4],25,-1,37,-1,25
1,<environment.Job instance at 0x7f11c60ed1e0>,25,21,[2 5],26,-1,47,-1,26
1,<environment.Job instance at 0x7f11c68ad6e0>,26,1,[7 2],27,-1,28,-1,27
1,<environment.Job instance at 0x7f11c68a09b0>,27,2,[2 6],28,-1,30,-1,28
1,<environment.Job instance at 0x7f11c68a0eb0>,28,14,[5 9],29,-1,43,-1,29
1,<environment.Job instance at 0x7f11c68a0e10>,29,19,[9 1],30,-1,49,-1,30
1,<environment.Job instance at 0x7f11c68a0a50>,30,12,[2 5],31,-1,43,-1,31
1,<environment.Job instance at 0x7f11c60e2910>,31,16,[6 5],32,-1,48,-1,32
1,<environment.Job instance at 0x7f11c68fe6e0>,22,15,[5 1],23,-1,48,-1,33
1,<environment.Job instance at 0x7f11c61a74b0>,39,13,[5 9],40,-1,53,-1,40
1,<environment.Job instance at 0x7f11c61a76e0>,41,18,[8 4],42,-1,60,-1,42
1,<environment.Job instance at 0x7f11c5ebf0a0>,44,17,[3 9],45,-1,62,-1,45
1,<environment.Job instance at 0x7f11c5ebf140>,45,13,[10  4],46,-1,65,-1,52
1,<environment.Job instance at 0x7f11c5ed45f0>,50,14,[6 4],51,-1,69,-1,55
1,<environment.Job instance at 0x7f11c5ed46e0>,51,18,[3 6],52,-1,74,-1,56
1,<environment.Job instance at 0x7f11c5ed4fa0>,55,25,[6 3],56,-1,81,-1,56
1,<environment.Job instance at 0x7f11c5ed45a0>,58,16,[8 5],59,-1,75,-1,59
1,<environment.Job instance at 0x7f11c6174dc0>,59,18,[7 5],60,-1,78,-1,60
1,<environment.Job instance at 0x7f11c6174f00>,61,14,[5 8],62,-1,76,-1,62
1,<environment.Job instance at 0x7f11c6182230>,62,16,[9 2],63,-1,79,-1,63
1,<environment.Job instance at 0x7f11c61821e0>,63,15,[6 3],64,-1,81,-1,66
1,<environment.Job instance at 0x7f11c5ebf0f0>,46,16,[5 5],47,-1,84,-1,68
1,<environment.Job instance at 0x7f11c6182460>,65,18,[7 5],66,-1,86,-1,68
1,<environment.Job instance at 0x7f11c6182780>,68,17,[10  3],69,-1,86,-1,69
1,<environment.Job instance at 0x7f11c6182870>,69,27,[ 5 10],70,-1,97,-1,70
1,<environment.Job instance at 0x7f11c6182960>,71,22,[ 1 10],72,-1,94,-1,72
1,<environment.Job instance at 0x7f11c61828c0>,72,18,[5 1],73,-1,97,-1,79
1,<environment.Job instance at 0x7f11c61830a0>,79,15,[ 1 10],80,-1,95,-1,80
1,<environment.Job instance at 0x7f11c6183190>,80,14,[3 6],81,-1,95,-1,81
1,<environment.Job instance at 0x7f11c6183460>,82,15,[1 6],83,-1,98,-1,83
1,<environment.Job instance at 0x7f11c61832d0>,84,12,[4 6],85,-1,97,-1,85
1,<environment.Job instance at 0x7f11c6183820>,85,17,[7 1],86,-1,103,-1,86
1,<environment.Job instance at 0x7f11c6183b40>,91,14,[10  4],92,-1,108,-1,94
1,<environment.Job instance at 0x7f11c6183960>,88,12,[ 5 12],89,-1,106,-1,94
1,<environment.Job instance at 0x7f11c6183d20>,92,18,[5 5],93,-1,112,-1,94
1,<environment.Job instance at 0x7f11c61838c0>,89,14,[10  1],90,-1,110,-1,96
1,<environment.Job instance at 0x7f11c6183dc0>,94,12,[8 4],95,-1,108,-1,96
1,<environment.Job instance at 0x7f11c6187280>,96,3,[8 1],97,-1,100,-1,97
1,<environment.Job instance at 0x7f11c6187230>,97,14,[6 2],98,-1,112,-1,98
1,<environment.Job instance at 0x7f11c61870f0>,98,21,[5 8],99,-1,120,-1,99
1,<environment.Job instance at 0x7f11c6187320>,99,17,[7 2],100,-1,117,-1,100
1,<environment.Job instance at 0x7f11c61874b0>,100,12,[8 1],101,-1,113,-1,101
1,<environment.Job instance at 0x7f11c61875a0>,104,12,[6 5],105,-1,121,-1,109
1,<environment.Job instance at 0x7f11c6183fa0>,103,27,[9 3],104,-1,141,-1,114
1,<environment.Job instance at 0x7f11c6187d20>,112,3,[9 1],113,-1,117,-1,114
1,<environment.Job instance at 0x7f11c6187870>,106,28,[1 7],107,-1,142,-1,114
1,<environment.Job instance at 0x7f11c61880f0>,116,28,[9 2],117,-1,145,-1,117
1,<environment.Job instance at 0x7f11c6183050>,15,2,[14  5],16,-1,36,-1,34
1,<environment.Job instance at 0x7f11c62ee0f0>,33,27,[1 8],34,-1,127,-1,100
1,<environment.Job instance at 0x7f11c5e18a50>,53,3,[ 3 14],54,-1,184,-1,181
1,<environment.Job instance at 0x7f11c5e32f00>,55,25,[6 3],56,-1,208,-1,183
1,<environment.Job instance at 0x7f11cf5e0a00>,60,2,[ 5 11],61,-1,200,-1,198
1,<environment.Job instance at 0x7f11c5dfbaf0>,69,27,[ 5 10],70,-1,279,-1,252
1,<environment.Job instance at 0x7f11c5ee24b0>,86,13,[11  1],87,-1,306,-1,293
1,<environment.Job instance at 0x7f11c5ee2500>,88,12,[ 5 12],89,-1,315,-1,303
1,<environment.Job instance at 0x7f11c5ee1a00>,101,28,[2 8],102,-1,410,-1,382
1,<environment.Job instance at 0x7f11c6647780>,103,27,[9 3],104,-1,409,-1,382
1,<environment.Job instance at 0x7f11c627c9b0>,106,28,[1 7],107,-1,412,-1,384
1,<environment.Job instance at 0x7f11c658dc30>,109,2,[ 4 11],110,-1,402,-1,400
1,<environment.Job instance at 0x7f11c68e8690>,114,3,[11  1],115,-1,421,-1,418
1,<environment.Job instance at 0x7f11c65e8280>,116,28,[9 2],117,-1,466,-1,438
1,<environment.Job instance at 0x7f11c60f12d0>,8,15,[ 3 11],9,-1,24,-1,9
1,<environment.Job instance at 0x7f11c60f17d0>,10,14,[6 4],11,-1,25,-1,11
1,<environment.Job instance at 0x7f11c5f18b40>,14,15,[9 1],15,-1,30,-1,15
1,<environment.Job instance at 0x7f11c5f189b0>,15,15,[ 2 11],16,-1,31,-1,16
1,<environment.Job instance at 0x7f11c5f185f0>,16,23,[7 4],17,-1,40,-1,17
1,<environment.Job instance at 0x7f11c5f18a50>,18,17,[5 5],19,-1,36,-1,19
1,<environment.Job instance at 0x7f11c5f18f00>,20,15,[9 4],21,-1,36,-1,21
1,<environment.Job instance at 0x7f11c5f18690>,23,20,[5 4],24,-1,44,-1,24
1,<environment.Job instance at 0x7f11c5f0c960>,35,20,[4 7],36,-1,56,-1,36
1,<environment.Job instance at 0x7f11c5f0c190>,32,14,[6 5],33,-1,51,-1,37
1,<environment.Job instance at 0x7f11c5f0c640>,37,13,[9 4],38,-1,51,-1,38
1,<environment.Job instance at 0x7f11c5f0c690>,39,17,[5 9],40,-1,58,-1,41
1,<environment.Job instance at 0x7f11c5f12aa0>,41,27,[5 1],42,-1,69,-1,42
1,<environment.Job instance at 0x7f11c5f12410>,42,21,[1 6],43,-1,64,-1,43
1,<environment.Job instance at 0x7f11c5f12c30>,43,17,[8 5],44,-1,61,-1,44
1,<environment.Job instance at 0x7f11c5f12a00>,48,16,[ 5 10],49,-1,65,-1,49
1,<environment.Job instance at 0x7f11c5f12d70>,49,18,[7 3],50,-1,68,-1,50
1,<environment.Job instance at 0x7f11c5f12280>,50,16,[9 2],51,-1,67,-1,51
1,<environment.Job instance at 0x7f11c68b20f0>,56,25,[ 5 10],57,-1,94,-1,69
1,<environment.Job instance at 0x7f11c5f126e0>,51,19,[10  1],52,-1,88,-1,69
1,<environment.Job instance at 0x7f11c5f0c0f0>,36,21,[6 5],37,-1,90,-1,69
1,<environment.Job instance at 0x7f11c68b2cd0>,63,16,[6 5],64,-1,85,-1,69
1,<environment.Job instance at 0x7f11c68b2050>,68,18,[1 9],69,-1,91,-1,73
1,<environment.Job instance at 0x7f11c5f12eb0>,47,13,[13  1],48,-1,87,-1,74
1,<environment.Job instance at 0x7f11c68b2c80>,54,3,[6 4],55,-1,85,-1,82
1,<environment.Job instance at 0x7f11c60c42d0>,75,16,[5 3],76,-1,98,-1,82
1,<environment.Job instance at 0x7f11c60c4550>,69,15,[6 3],70,-1,97,-1,82
1,<environment.Job instance at 0x7f11c60c48c0>,76,2,[13  5],77,-1,84,-1,82
1,<environment.Job instance at 0x7f11c6fe7eb0>,79,13,[3 6],80,-1,96,-1,83
1,<environment.Job instance at 0x7f11c6fe7a50>,78,14,[9 4],79,-1,104,-1,90
1,<environment.Job instance at 0x7f11c6fe7320>,80,26,[6 3],81,-1,119,-1,93
1,<environment.Job instance at 0x7f11c68b2550>,62,18,[5 9],63,-1,111,-1,93
1,<environment.Job instance at 0x7f11c60c4730>,74,17,[9 5],75,-1,110,-1,93
1,<environment.Job instance at 0x7f11c6fe74b0>,82,17,[ 2 11],83,-1,110,-1,93
1,<environment.Job instance at 0x7f11c6fe7f00>,85,23,[7 1],86,-1,116,-1,93
1,<environment.Job instance at 0x7f11c6fe75f0>,87,17,[4 9],88,-1,110,-1,93
1,<environment.Job instance at 0x7f11c5f18d20>,95,18,[10  3],96,-1,133,-1,115
1,<environment.Job instance at 0x7f11c5f335a0>,96,13,[13  3],97,-1,128,-1,115
1,<environment.Job instance at 0x7f11c5f0a500>,93,12,[ 1 14],94,-1,143,-1,131
1,<environment.Job instance at 0x7f11c60e1410>,104,18,[4 7],105,-1,150,-1,132
1,<environment.Job instance at 0x7f11c6feb640>,108,1,[8 4],109,-1,133,-1,132
1,<environment.Job instance at 0x7f11c68f4f00>,113,16,[4 9],114,-1,168,-1,152
1,<environment.Job instance at 0x7f11c68b2eb0>,7,3,[ 1 12],8,-1,11,-1,8
1,<environment.Job instance at 0x7f11c5f129b0>,8,15,[ 3 11],9,-1,24,-1,9
1,<environment.Job instance at 0x7f11c6fe7640>,15,15,[ 2 11],16,-1,31,-1,16
1,<environment.Job instance at 0x7f11c6a00640>,16,23,[7 4],17,-1,42,-1,19
1,<environment.Job instance at 0x7f11c61877d0>,30,16,[14  3],31,-1,72,-1,56
1,<environment.Job instance at 0x7f11c68fe230>,41,27,[5 1],42,-1,104,-1,77
1,<environment.Job instance at 0x7f11c6930410>,46,25,[8 3],47,-1,117,-1,92
1,<environment.Job instance at 0x7f11c668f870>,47,13,[13  1],48,-1,105,-1,92
1,<environment.Job instance at 0x7f11cf5cf1e0>,56,25,[ 5 10],57,-1,160,-1,135
1,<environment.Job instance at 0x7f11c6877d70>,76,2,[13  5],77,-1,204,-1,202
1,<environment.Job instance at 0x7f11c6647640>,80,26,[6 3],81,-1,238,-1,212
1,<environment.Job instance at 0x7f11c5cb6af0>,82,17,[ 2 11],83,-1,229,-1,212
1,<environment.Job instance at 0x7f11c5cb6550>,85,23,[7 1],86,-1,241,-1,218
1,<environment.Job instance at 0x7f11c6216f00>,93,12,[ 1 14],94,-1,254,-1,242
1,<environment.Job instance at 0x7f11c6521c80>,96,13,[13  3],97,-1,269,-1,256
1,<environment.Job instance at 0x7f11c6521af0>,98,1,[ 3 14],99,-1,261,-1,260
1,<environment.Job instance at 0x7f11c5eee320>,111,14,[ 3 14],112,-1,325,-1,311
1,<environment.Job instance at 0x7f11c68a06e0>,115,13,[ 1 12],116,-1,342,-1,329
1,<environment.Job instance at 0x7f11c68d2c80>,116,17,[11  2],117,-1,346,-1,329
1,<environment.Job instance at 0x7f11c5dfe3c0>,0,28,[5 6],1,-1,29,-1,1
1,<environment.Job instance at 0x7f11c60c75f0>,4,17,[6 5],5,-1,23,-1,6
1,<environment.Job instance at 0x7f11c69091e0>,5,23,[5 3],6,-1,29,-1,6
1,<environment.Job instance at 0x7f11c60c7eb0>,7,16,[ 5 10],8,-1,29,-1,13
1,<environment.Job instance at 0x7f11c60d2870>,16,15,[9 5],17,-1,35,-1,20
1,<environment.Job instance at 0x7f11c60d28c0>,12,16,[9 4],13,-1,46,-1,30
1,<environment.Job instance at 0x7f11c60e7dc0>,22,17,[4 5],23,-1,47,-1,30
1,<environment.Job instance at 0x7f11c6233500>,27,18,[10  5],28,-1,48,-1,30
1,<environment.Job instance at 0x7f11c62041e0>,30,15,[ 4 10],31,-1,46,-1,31
1,<environment.Job instance at 0x7f11c6233190>,33,15,[7 2],34,-1,57,-1,42
1,<environment.Job instance at 0x7f11c6f356e0>,39,17,[9 4],40,-1,59,-1,42
1,<environment.Job instance at 0x7f11c6bd3aa0>,41,18,[4 8],42,-1,60,-1,42
1,<environment.Job instance at 0x7f11c60e7370>,0,28,[5 6],1,-1,29,-1,1
1,<environment.Job instance at 0x7f11c6049e10>,3,28,[ 1 11],4,-1,32,-1,4
1,<environment.Job instance at 0x7f11c603c0a0>,5,23,[5 3],6,-1,29,-1,6
1,<environment.Job instance at 0x7f11c603c320>,6,14,[13  5],7,-1,21,-1,7
1,<environment.Job instance at 0x7f11c603ca50>,10,13,[12  5],11,-1,24,-1,11
1,<environment.Job instance at 0x7f11c60720a0>,18,15,[ 3 13],19,-1,39,-1,24
1,<environment.Job instance at 0x7f11c6072cd0>,26,18,[ 3 13],27,-1,74,-1,56
1,<environment.Job instance at 0x7f11c6521af0>,37,2,[ 4 14],38,-1,92,-1,90
1,<environment.Job instance at 0x7f11c5cb6f50>,44,2,[ 1 12],45,-1,108,-1,106
1,<environment.Job instance at 0x7f11c6647c80>,50,25,[2 8],51,-1,165,-1,140
1,<environment.Job instance at 0x7f11cf5cf1e0>,54,3,[ 3 14],55,-1,156,-1,153
1,<environment.Job instance at 0x7f11c679b320>,59,2,[13  5],60,-1,182,-1,180
1,<environment.Job instance at 0x7f11c6183c30>,68,1,[ 3 12],69,-1,221,-1,220
1,<environment.Job instance at 0x7f11c5eeba00>,85,18,[14  2],86,-1,323,-1,305
1,<environment.Job instance at 0x7f11c64c8eb0>,97,25,[9 4],98,-1,394,-1,369
1,<environment.Job instance at 0x7f11c6a88320>,101,3,[ 4 12],102,-1,376,-1,373
1,<environment.Job instance at 0x7f11c6ec30a0>,106,16,[14  3],107,-1,407,-1,391
1,<environment.Job instance at 0x7f11c60ce500>,107,14,[12  5],108,-1,405,-1,391
1,<environment.Job instance at 0x7f11c60c4b90>,114,25,[7 4],115,-1,443,-1,418
1,<environment.Job instance at 0x7f11cfab9640>,2,18,[5 8],3,-1,21,-1,3
1,<environment.Job instance at 0x7f11c5de1be0>,5,23,[8 2],6,-1,29,-1,6
1,<environment.Job instance at 0x7f11c5de1c80>,10,16,[5 9],11,-1,27,-1,11
1,<environment.Job instance at 0x7f11c5de1e60>,11,15,[9 5],12,-1,27,-1,12
1,<environment.Job instance at 0x7f11c5de19b0>,12,14,[9 1],13,-1,28,-1,14
1,<environment.Job instance at 0x7f11c5f18d70>,13,18,[ 2 11],14,-1,32,-1,14
1,<environment.Job instance at 0x7f11c5de11e0>,18,14,[8 1],19,-1,33,-1,19
1,<environment.Job instance at 0x7f11cf98d8c0>,19,16,[ 4 10],20,-1,37,-1,21
1,<environment.Job instance at 0x7f11cf98da50>,21,17,[3 7],22,-1,39,-1,22
1,<environment.Job instance at 0x7f11cf98d6e0>,22,23,[7 1],23,-1,46,-1,23
1,<environment.Job instance at 0x7f11cf98db90>,23,2,[2 8],24,-1,26,-1,24
1,<environment.Job instance at 0x7f11cf98dfa0>,24,14,[10  1],25,-1,39,-1,25
1,<environment.Job instance at 0x7f11cf98daa0>,25,3,[13  2],26,-1,29,-1,26
1,<environment.Job instance at 0x7f11c5de12d0>,20,18,[5 8],21,-1,45,-1,27
1,<environment.Job instance at 0x7f11cf98dd70>,30,15,[4 9],31,-1,46,-1,31
1,<environment.Job instance at 0x7f11cf98d140>,31,15,[7 5],32,-1,47,-1,32
1,<environment.Job instance at 0x7f11c67ef0a0>,36,17,[9 3],37,-1,57,-1,40
1,<environment.Job instance at 0x7f11c67ef0f0>,40,15,[9 1],41,-1,56,-1,41
1,<environment.Job instance at 0x7f11d6bfa960>,43,16,[ 4 10],44,-1,60,-1,44
1,<environment.Job instance at 0x7f11c5e2d7d0>,44,18,[1 8],45,-1,63,-1,45
1,<environment.Job instance at 0x7f11c5e2dc80>,45,13,[4 7],46,-1,59,-1,46
1,<environment.Job instance at 0x7f11c5e2db90>,48,18,[5 8],49,-1,67,-1,49
1,<environment.Job instance at 0x7f11c5e2d410>,50,20,[9 5],51,-1,71,-1,51
1,<environment.Job instance at 0x7f11c5e2df00>,54,15,[7 5],55,-1,70,-1,55
1,<environment.Job instance at 0x7f11c5e2dcd0>,57,15,[ 1 10],58,-1,73,-1,58
1,<environment.Job instance at 0x7f11c6912b40>,61,18,[3 7],62,-1,80,-1,62
1,<environment.Job instance at 0x7f11c69127d0>,62,17,[1 9],63,-1,80,-1,63
1,<environment.Job instance at 0x7f11c6912190>,63,14,[5 5],64,-1,78,-1,64
1,<environment.Job instance at 0x7f11c6912230>,64,22,[9 5],65,-1,87,-1,65
1,<environment.Job instance at 0x7f11c6912a00>,66,13,[3 7],67,-1,80,-1,67
1,<environment.Job instance at 0x7f11c6912140>,67,16,[5 8],68,-1,84,-1,68
1,<environment.Job instance at 0x7f11c69125f0>,68,16,[1 6],69,-1,85,-1,69
1,<environment.Job instance at 0x7f11c6912f50>,70,13,[11  4],71,-1,84,-1,71
1,<environment.Job instance at 0x7f11c6912c30>,73,15,[4 9],74,-1,89,-1,74
1,<environment.Job instance at 0x7f11c69128c0>,74,14,[10  4],75,-1,89,-1,75
1,<environment.Job instance at 0x7f11c6912280>,76,12,[9 4],77,-1,89,-1,77
1,<environment.Job instance at 0x7f11c5d1d6e0>,78,12,[10  1],79,-1,91,-1,79
1,<environment.Job instance at 0x7f11c5d1d870>,79,21,[1 7],80,-1,101,-1,80
1,<environment.Job instance at 0x7f11c5d1dd20>,80,16,[9 2],81,-1,97,-1,81
1,<environment.Job instance at 0x7f11c5d1dc80>,87,17,[8 2],88,-1,105,-1,88
1,<environment.Job instance at 0x7f11c5d1daa0>,88,17,[1 6],89,-1,106,-1,89
1,<environment.Job instance at 0x7f11c5e9ea00>,89,17,[9 2],90,-1,107,-1,90
1,<environment.Job instance at 0x7f11c5d44d20>,107,17,[7 4],108,-1,130,-1,113
1,<environment.Job instance at 0x7f11c5c07b40>,109,16,[10  5],110,-1,129,-1,113
1,<environment.Job instance at 0x7f11c5dee4b0>,111,16,[5 3],112,-1,129,-1,113
1,<environment.Job instance at 0x7f11c5ea4820>,104,17,[8 3],105,-1,133,-1,116
1,<environment.Job instance at 0x7f11c5e75eb0>,115,17,[ 2 10],116,-1,133,-1,116
1,<environment.Job instance at 0x7f11c60d2960>,5,23,[8 2],6,-1,31,-1,8
1,<environment.Job instance at 0x7f11c6912410>,13,18,[ 2 11],14,-1,34,-1,16
1,<environment.Job instance at 0x7f11c5ca56e0>,15,3,[11  2],16,-1,21,-1,18
1,<environment.Job instance at 0x7f11c5e327d0>,22,23,[7 1],23,-1,76,-1,53
1,<environment.Job instance at 0x7f11c62af320>,25,3,[13  2],26,-1,71,-1,68
1,<environment.Job instance at 0x7f11c5ef7050>,28,1,[13  4],29,-1,70,-1,69
1,<environment.Job instance at 0x7f11c60e1af0>,32,13,[14  4],33,-1,96,-1,83
1,<environment.Job instance at 0x7f11c6647a00>,41,23,[ 3 13],42,-1,142,-1,119
1,<environment.Job instance at 0x7f11c60cafa0>,65,3,[ 1 14],66,-1,218,-1,215
1,<environment.Job instance at 0x7f11c621c6e0>,70,13,[11  4],71,-1,257,-1,244
1,<environment.Job instance at 0x7f11c6049f50>,71,12,[ 1 13],72,-1,256,-1,244
1,<environment.Job instance at 0x7f11c6401cd0>,82,17,[ 2 14],83,-1,307,-1,290
1,<environment.Job instance at 0x7f11c60c4820>,95,16,[11  3],96,-1,355,-1,339
1,<environment.Job instance at 0x7f11c6e42d70>,106,1,[11  2],107,-1,363,-1,362
1,<environment.Job instance at 0x7f11c5879af0>,0,18,[9 2],1,-1,22,-1,4
1,<environment.Job instance at 0x7f11c5879190>,4,12,[7 4],5,-1,17,-1,5
1,<environment.Job instance at 0x7f11c58795f0>,7,14,[11  2],8,-1,22,-1,8
1,<environment.Job instance at 0x7f11c5879cd0>,9,18,[1 5],10,-1,28,-1,10
1,<environment.Job instance at 0x7f11c5879d20>,10,27,[7 4],11,-1,38,-1,11
1,<environment.Job instance at 0x7f11c58010a0>,12,16,[10  2],13,-1,29,-1,13
1,<environment.Job instance at 0x7f11c58010f0>,13,15,[4 8],14,-1,29,-1,14
1,<environment.Job instance at 0x7f11c5801be0>,15,2,[ 1 12],16,-1,18,-1,16
1,<environment.Job instance at 0x7f11c5801cd0>,16,13,[9 5],17,-1,30,-1,17
1,<environment.Job instance at 0x7f11c5801640>,17,18,[6 2],18,-1,36,-1,18
1,<environment.Job instance at 0x7f11c5801550>,18,14,[ 4 10],19,-1,33,-1,19
1,<environment.Job instance at 0x7f11c5879640>,3,14,[5 5],4,-1,33,-1,19
1,<environment.Job instance at 0x7f11c5801a50>,21,14,[9 5],22,-1,37,-1,23
1,<environment.Job instance at 0x7f11c5801f50>,24,19,[9 1],25,-1,44,-1,25
1,<environment.Job instance at 0x7f11c58014b0>,29,15,[8 5],30,-1,45,-1,30
1,<environment.Job instance at 0x7f11c58a3230>,31,13,[9 4],32,-1,45,-1,32
1,<environment.Job instance at 0x7f11c58a3640>,32,16,[1 7],33,-1,49,-1,33
1,<environment.Job instance at 0x7f11c58a34b0>,33,13,[3 7],34,-1,47,-1,34
1,<environment.Job instance at 0x7f11c58a3b40>,34,15,[6 4],35,-1,50,-1,35
1,<environment.Job instance at 0x7f11c58a3fa0>,42,14,[9 3],43,-1,57,-1,43
1,<environment.Job instance at 0x7f11c58821e0>,46,16,[4 9],47,-1,63,-1,47
1,<environment.Job instance at 0x7f11c5882640>,47,22,[6 1],48,-1,70,-1,48
1,<environment.Job instance at 0x7f11c58829b0>,48,15,[7 1],49,-1,64,-1,49
1,<environment.Job instance at 0x7f11c5882cd0>,49,14,[3 8],50,-1,64,-1,50
1,<environment.Job instance at 0x7f11c5882500>,50,12,[5 9],51,-1,63,-1,51
1,<environment.Job instance at 0x7f11c5882c80>,51,18,[5 9],52,-1,70,-1,52
1,<environment.Job instance at 0x7f11c581c5a0>,55,17,[10  3],56,-1,73,-1,56
1,<environment.Job instance at 0x7f11c581c730>,57,16,[8 4],58,-1,74,-1,58
1,<environment.Job instance at 0x7f11c581ccd0>,58,14,[6 3],59,-1,73,-1,59
1,<environment.Job instance at 0x7f11c581ca00>,60,17,[8 4],61,-1,78,-1,61
1,<environment.Job instance at 0x7f11c67e4550>,61,14,[ 5 10],62,-1,76,-1,62
1,<environment.Job instance at 0x7f11c659ed20>,62,19,[8 3],63,-1,82,-1,63
1,<environment.Job instance at 0x7f11c659ea00>,63,13,[8 3],64,-1,77,-1,64
1,<environment.Job instance at 0x7f11c659ea50>,64,17,[8 5],65,-1,82,-1,65
1,<environment.Job instance at 0x7f11c659e870>,66,23,[5 5],67,-1,90,-1,67
1,<environment.Job instance at 0x7f11c659e0a0>,68,14,[9 5],69,-1,83,-1,69
1,<environment.Job instance at 0x7f11c659e370>,69,25,[7 3],70,-1,95,-1,70
1,<environment.Job instance at 0x7f11c59c5460>,73,17,[6 4],74,-1,91,-1,74
1,<environment.Job instance at 0x7f11c67cfa50>,74,17,[4 7],75,-1,92,-1,75
1,<environment.Job instance at 0x7f11c5c84a50>,76,13,[10  5],77,-1,90,-1,77
1,<environment.Job instance at 0x7f11c66d6050>,82,14,[10  1],83,-1,97,-1,83
1,<environment.Job instance at 0x7f11c5796730>,84,15,[8 1],85,-1,100,-1,85
1,<environment.Job instance at 0x7f11c597eaf0>,85,14,[5 7],86,-1,100,-1,86
1,<environment.Job instance at 0x7f11c617eaf0>,87,15,[3 9],88,-1,103,-1,88
1,<environment.Job instance at 0x7f11c5863140>,88,15,[ 4 10],89,-1,104,-1,89
1,<environment.Job instance at 0x7f11c58638c0>,90,18,[5 4],91,-1,109,-1,91
1,<environment.Job instance at 0x7f11c5801190>,22,15,[7 3],23,-1,107,-1,92
1,<environment.Job instance at 0x7f11c58822d0>,7,14,[11  2],8,-1,22,-1,8
1,<environment.Job instance at 0x7f11c57b4e60>,8,15,[ 3 14],9,-1,24,-1,9
1,<environment.Job instance at 0x7f11c58c3820>,10,27,[7 4],11,-1,46,-1,19
1,<environment.Job instance at 0x7f11c58791e0>,15,2,[ 1 12],16,-1,23,-1,21
1,<environment.Job instance at 0x7f11c60c4b90>,20,25,[ 1 14],21,-1,73,-1,48
1,<environment.Job instance at 0x7f11c60c4f00>,23,1,[ 4 13],24,-1,61,-1,60
1,<environment.Job instance at 0x7f11c60c4370>,25,3,[ 4 11],26,-1,65,-1,62
1,<environment.Job instance at 0x7f11cf7ee190>,38,3,[11  1],39,-1,120,-1,117
1,<environment.Job instance at 0x7f11c648fa00>,66,23,[5 5],67,-1,247,-1,224
1,<environment.Job instance at 0x7f11c6484910>,69,25,[7 3],70,-1,264,-1,239
1,<environment.Job instance at 0x7f11c6484a00>,70,1,[12  5],71,-1,240,-1,239
1,<environment.Job instance at 0x7f11c6a67eb0>,81,3,[ 3 11],82,-1,282,-1,279
1,<environment.Job instance at 0x7f11c692d7d0>,95,3,[14  4],96,-1,339,-1,336
1,<environment.Job instance at 0x7f11c692d960>,96,17,[ 1 13],97,-1,353,-1,336
1,<environment.Job instance at 0x7f11c691a820>,97,18,[ 3 12],98,-1,354,-1,336
1,<environment.Job instance at 0x7f11c6f57b90>,101,2,[11  4],102,-1,342,-1,340
1,<environment.Job instance at 0x7f11c5b0d960>,108,22,[ 1 13],109,-1,393,-1,371
1,<environment.Job instance at 0x7f11c5f13c80>,118,2,[11  2],119,-1,417,-1,415
1,<environment.Job instance at 0x7f11c5c16e10>,5,16,[6 5],6,-1,22,-1,6
1,<environment.Job instance at 0x7f11c5c169b0>,6,12,[ 1 10],7,-1,20,-1,8
1,<environment.Job instance at 0x7f11c5c16c30>,7,18,[9 4],8,-1,26,-1,8
1,<environment.Job instance at 0x7f11c5c165f0>,8,15,[1 8],9,-1,24,-1,9
1,<environment.Job instance at 0x7f11c70740a0>,18,14,[7 2],19,-1,34,-1,20
1,<environment.Job instance at 0x7f11c7074a00>,19,18,[1 9],20,-1,38,-1,20
1,<environment.Job instance at 0x7f11c7074550>,23,14,[4 8],24,-1,38,-1,24
1,<environment.Job instance at 0x7f11c7074820>,24,17,[3 7],25,-1,42,-1,25
1,<environment.Job instance at 0x7f11c7074f00>,26,14,[7 5],27,-1,46,-1,32
1,<environment.Job instance at 0x7f11c7074690>,30,18,[5 5],31,-1,60,-1,42
1,<environment.Job instance at 0x7f11c6bfcaa0>,34,16,[7 5],35,-1,60,-1,44
1,<environment.Job instance at 0x7f11c6bfc500>,43,17,[14  2],44,-1,62,-1,45
1,<environment.Job instance at 0x7f11cf9cdfa0>,45,20,[10  3],46,-1,67,-1,47
1,<environment.Job instance at 0x7f11c6bfcb90>,46,12,[3 5],47,-1,59,-1,47
1,<environment.Job instance at 0x7f11cf9cde10>,44,15,[10  2],45,-1,68,-1,53
1,<environment.Job instance at 0x7f11c6bfce60>,41,13,[9 1],42,-1,66,-1,53
1,<environment.Job instance at 0x7f11cf9cde60>,52,18,[9 2],53,-1,72,-1,54
1,<environment.Job instance at 0x7f11cf9cd7d0>,55,14,[6 3],56,-1,70,-1,56
1,<environment.Job instance at 0x7f11c6b4f230>,54,14,[5 9],55,-1,72,-1,58
1,<environment.Job instance at 0x7f11c6b4f370>,57,23,[6 1],58,-1,85,-1,62
1,<environment.Job instance at 0x7f11c6b4f5f0>,65,12,[8 3],66,-1,78,-1,66
1,<environment.Job instance at 0x7f11c6b4f7d0>,66,18,[ 2 10],67,-1,85,-1,67
1,<environment.Job instance at 0x7f11c6b4fc30>,67,17,[5 5],68,-1,85,-1,68
1,<environment.Job instance at 0x7f11c6b4f500>,62,17,[5 1],63,-1,86,-1,69
1,<environment.Job instance at 0x7f11c6b4f8c0>,68,14,[9 5],69,-1,84,-1,70
1,<environment.Job instance at 0x7f11c6b4f1e0>,69,14,[8 5],70,-1,84,-1,70
1,<environment.Job instance at 0x7f11c6b4f870>,70,25,[9 4],71,-1,96,-1,71
1,<environment.Job instance at 0x7f11c6140370>,71,15,[7 3],72,-1,87,-1,72
1,<environment.Job instance at 0x7f11c6140780>,72,17,[1 5],73,-1,90,-1,73
1,<environment.Job instance at 0x7f11c6140050>,74,28,[ 5 10],75,-1,103,-1,75
1,<environment.Job instance at 0x7f11c6140960>,76,13,[5 9],77,-1,91,-1,78
1,<environment.Job instance at 0x7f11c61400f0>,78,26,[4 9],79,-1,105,-1,79
1,<environment.Job instance at 0x7f11c6140a00>,81,14,[8 4],82,-1,103,-1,89
1,<environment.Job instance at 0x7f11c6140730>,77,27,[2 9],78,-1,116,-1,89
1,<environment.Job instance at 0x7f11c6140a50>,80,18,[5 4],81,-1,115,-1,97
1,<environment.Job instance at 0x7f11c61408c0>,86,16,[ 5 12],87,-1,113,-1,97
1,<environment.Job instance at 0x7f11c6140c80>,88,19,[2 7],89,-1,117,-1,98
1,<environment.Job instance at 0x7f11c68ef0a0>,92,22,[5 4],93,-1,120,-1,98
1,<environment.Job instance at 0x7f11c68ef9b0>,90,12,[2 6],91,-1,110,-1,98
1,<environment.Job instance at 0x7f11c6140230>,84,16,[8 1],85,-1,115,-1,99
1,<environment.Job instance at 0x7f11c68efa50>,98,17,[7 5],99,-1,118,-1,101
1,<environment.Job instance at 0x7f11c68ef410>,99,13,[4 8],100,-1,114,-1,101
1,<environment.Job instance at 0x7f11c68efbe0>,100,17,[10  1],101,-1,119,-1,102
1,<environment.Job instance at 0x7f11c6c85a50>,101,16,[2 5],102,-1,118,-1,102
1,<environment.Job instance at 0x7f11c5a973c0>,103,16,[1 5],104,-1,122,-1,106
1,<environment.Job instance at 0x7f11c68efd20>,96,18,[1 5],97,-1,125,-1,107
1,<environment.Job instance at 0x7f11c69196e0>,102,15,[2 5],103,-1,122,-1,107
1,<environment.Job instance at 0x7f11c6f837d0>,107,26,[10  5],108,-1,134,-1,108
1,<environment.Job instance at 0x7f11c6f835f0>,106,17,[ 2 14],107,-1,127,-1,110
1,<environment.Job instance at 0x7f11c6f83d70>,111,18,[4 9],112,-1,130,-1,112
1,<environment.Job instance at 0x7f11c6f83e10>,113,13,[9 3],114,-1,130,-1,117
1,<environment.Job instance at 0x7f11c6f830f0>,110,18,[4 5],111,-1,136,-1,118
1,<environment.Job instance at 0x7f11c6f83230>,109,16,[5 6],110,-1,136,-1,120
1,<environment.Job instance at 0x7f11c6bfc820>,2,13,[14  2],3,-1,16,-1,3
1,<environment.Job instance at 0x7f11c5c16d70>,20,2,[ 4 14],21,-1,46,-1,44
1,<environment.Job instance at 0x7f11c69182d0>,43,17,[14  2],44,-1,157,-1,140
1,<environment.Job instance at 0x7f11c6e4d7d0>,56,2,[ 5 12],57,-1,164,-1,162
1,<environment.Job instance at 0x7f11cfbfc550>,57,23,[6 1],58,-1,188,-1,165
1,<environment.Job instance at 0x7f11c58e28c0>,70,25,[9 4],71,-1,243,-1,218
1,<environment.Job instance at 0x7f11c692dcd0>,74,28,[ 5 10],75,-1,263,-1,235
1,<environment.Job instance at 0x7f11c5efaa00>,77,27,[2 9],78,-1,263,-1,236
1,<environment.Job instance at 0x7f11c6a6da00>,78,26,[4 9],79,-1,262,-1,236
1,<environment.Job instance at 0x7f11c632a5a0>,86,16,[ 5 12],87,-1,285,-1,269
1,<environment.Job instance at 0x7f11c6493b40>,106,17,[ 2 14],107,-1,350,-1,333
1,<environment.Job instance at 0x7f11c6493a50>,107,26,[10  5],108,-1,361,-1,335
1,<environment.Job instance at 0x7f11c6fa2780>,4,22,[1 8],5,-1,27,-1,5
1,<environment.Job instance at 0x7f11c6fa2690>,5,18,[ 2 10],6,-1,24,-1,6
1,<environment.Job instance at 0x7f11c6fa26e0>,9,17,[9 1],10,-1,28,-1,11
1,<environment.Job instance at 0x7f11c6fa2050>,12,26,[1 5],13,-1,39,-1,13
1,<environment.Job instance at 0x7f11c5deeb40>,13,17,[ 4 10],14,-1,31,-1,14
1,<environment.Job instance at 0x7f11c5deebe0>,14,15,[5 3],15,-1,30,-1,15
1,<environment.Job instance at 0x7f11c5dee640>,15,15,[8 3],16,-1,31,-1,16
1,<environment.Job instance at 0x7f11c5dee780>,17,12,[9 2],18,-1,30,-1,18
1,<environment.Job instance at 0x7f11c5dee730>,20,13,[10  5],21,-1,34,-1,21
1,<environment.Job instance at 0x7f11c5d66460>,22,22,[5 3],23,-1,45,-1,23
1,<environment.Job instance at 0x7f11c5d66a00>,24,15,[4 7],25,-1,40,-1,25
1,<environment.Job instance at 0x7f11c5d665f0>,27,24,[2 8],28,-1,52,-1,28
1,<environment.Job instance at 0x7f11c5d664b0>,31,16,[4 9],32,-1,48,-1,32
1,<environment.Job instance at 0x7f11c5d66fa0>,33,26,[1 8],34,-1,60,-1,34
1,<environment.Job instance at 0x7f11c5d66320>,35,12,[5 2],36,-1,48,-1,36
1,<environment.Job instance at 0x7f11c6f285f0>,36,18,[7 1],37,-1,55,-1,37
1,<environment.Job instance at 0x7f11c6f28140>,41,23,[9 4],42,-1,65,-1,42
1,<environment.Job instance at 0x7f11c6f28dc0>,44,14,[2 7],45,-1,59,-1,45
1,<environment.Job instance at 0x7f11c6f28640>,46,16,[9 3],47,-1,63,-1,47
1,<environment.Job instance at 0x7f11c6f28050>,48,16,[5 1],49,-1,65,-1,49
1,<environment.Job instance at 0x7f11c6f28c30>,50,17,[4 7],51,-1,68,-1,51
1,<environment.Job instance at 0x7f11c5d3af50>,52,14,[6 3],53,-1,67,-1,53
1,<environment.Job instance at 0x7f11c5d3ae60>,53,12,[4 5],54,-1,66,-1,54
1,<environment.Job instance at 0x7f11c5d3a5f0>,57,17,[4 6],58,-1,75,-1,58
1,<environment.Job instance at 0x7f11c5d3a0a0>,60,18,[3 6],61,-1,79,-1,61
1,<environment.Job instance at 0x7f11c5d3a2d0>,62,16,[1 9],63,-1,79,-1,63
1,<environment.Job instance at 0x7f11c5d3a8c0>,64,12,[10  3],65,-1,77,-1,65
1,<environment.Job instance at 0x7f11c6f87eb0>,66,16,[2 7],67,-1,83,-1,67
1,<environment.Job instance at 0x7f11c6f871e0>,67,13,[7 1],68,-1,81,-1,68
1,<environment.Job instance at 0x7f11c6f87280>,69,12,[4 8],70,-1,82,-1,70
1,<environment.Job instance at 0x7f11c6f87a00>,70,14,[1 9],71,-1,85,-1,71
1,<environment.Job instance at 0x7f11c6f872d0>,72,12,[1 7],73,-1,85,-1,73
1,<environment.Job instance at 0x7f11c6f87b40>,74,17,[10  5],75,-1,92,-1,75
1,<environment.Job instance at 0x7f11c6f87320>,75,15,[1 6],76,-1,91,-1,76
1,<environment.Job instance at 0x7f11c6f874b0>,77,16,[11  5],78,-1,94,-1,78
1,<environment.Job instance at 0x7f11c6f87be0>,80,14,[3 5],81,-1,95,-1,81
1,<environment.Job instance at 0x7f11c6bd30a0>,84,12,[7 2],85,-1,97,-1,85
1,<environment.Job instance at 0x7f11c6bd3780>,85,17,[ 5 10],86,-1,103,-1,86
1,<environment.Job instance at 0x7f11c6bd33c0>,90,15,[6 2],91,-1,109,-1,94
1,<environment.Job instance at 0x7f11c6bd3c30>,91,2,[10  4],92,-1,96,-1,94
1,<environment.Job instance at 0x7f11c6bd3fa0>,92,16,[5 3],93,-1,110,-1,94
1,<environment.Job instance at 0x7f11c6bd37d0>,93,16,[9 5],94,-1,111,-1,95
1,<environment.Job instance at 0x7f11c6bd3d20>,94,16,[8 5],95,-1,111,-1,95
1,<environment.Job instance at 0x7f11c6f28d20>,39,15,[ 1 14],40,-1,110,-1,95
1,<environment.Job instance at 0x7f11c6940820>,10,16,[4 8],11,-1,111,-1,95
1,<environment.Job instance at 0x7f11c612f140>,97,14,[ 5 10],98,-1,112,-1,98
1,<environment.Job instance at 0x7f11c636b4b0>,99,16,[6 2],100,-1,116,-1,100
1,<environment.Job instance at 0x7f11c64c8e60>,102,16,[9 3],103,-1,120,-1,104
1,<environment.Job instance at 0x7f11cfb320a0>,104,16,[7 3],105,-1,121,-1,105
1,<environment.Job instance at 0x7f11cfb32f50>,105,22,[5 2],106,-1,128,-1,106
1,<environment.Job instance at 0x7f11c5abf550>,110,13,[11  3],111,-1,129,-1,116
1,<environment.Job instance at 0x7f11c70280a0>,115,18,[10  4],116,-1,137,-1,119
1,<environment.Job instance at 0x7f11c6f28e60>,3,23,[1 7],4,-1,27,-1,4
1,<environment.Job instance at 0x7f11c5d3a050>,8,13,[14  3],9,-1,22,-1,9
1,<environment.Job instance at 0x7f11c6f87050>,12,26,[1 5],13,-1,39,-1,13
1,<environment.Job instance at 0x7f11c6493b40>,27,24,[2 8],28,-1,94,-1,70
1,<environment.Job instance at 0x7f11c6493a50>,29,13,[14  2],30,-1,83,-1,70
1,<environment.Job instance at 0x7f11c64a8410>,33,26,[1 8],34,-1,116,-1,90
1,<environment.Job instance at 0x7f11c64a8dc0>,39,15,[ 1 14],40,-1,118,-1,103
1,<environment.Job instance at 0x7f11c5dc0190>,41,23,[9 4],42,-1,131,-1,108
1,<environment.Job instance at 0x7f11c6e4d370>,77,16,[11  5],78,-1,276,-1,260
1,<environment.Job instance at 0x7f11c67baaa0>,81,3,[13  1],82,-1,273,-1,270
1,<environment.Job instance at 0x7f11c69161e0>,95,1,[ 3 12],96,-1,316,-1,315
1,<environment.Job instance at 0x7f11c61eceb0>,98,3,[ 5 12],99,-1,334,-1,331
1,<environment.Job instance at 0x7f11c6b4f780>,106,1,[11  1],107,-1,365,-1,364
1,<environment.Job instance at 0x7f11c6bfc820>,110,13,[11  3],111,-1,382,-1,369
1,<environment.Job instance at 0x7f11c6bfc690>,111,28,[7 5],112,-1,406,-1,378
1,<environment.Job instance at 0x7f11c66a49b0>,113,2,[14  5],114,-1,380,-1,378
1,<environment.Job instance at 0x7f11c7074c80>,114,26,[7 1],115,-1,408,-1,382
1,<environment.Job instance at 0x7f11c693bd70>,1,18,[4 9],2,-1,20,-1,2
1,<environment.Job instance at 0x7f11c6a29e60>,2,18,[3 6],3,-1,21,-1,3
1,<environment.Job instance at 0x7f11c693b690>,8,18,[8 3],9,-1,28,-1,10
1,<environment.Job instance at 0x7f11c66aa9b0>,10,24,[10  5],11,-1,35,-1,11
1,<environment.Job instance at 0x7f11c66aa820>,12,15,[ 2 10],13,-1,28,-1,13
1,<environment.Job instance at 0x7f11c66aae60>,13,18,[6 3],14,-1,32,-1,14
1,<environment.Job instance at 0x7f11c66aaeb0>,14,17,[10  3],15,-1,32,-1,15
1,<environment.Job instance at 0x7f11c66aab40>,15,18,[ 2 11],16,-1,34,-1,16
1,<environment.Job instance at 0x7f11c66aa5a0>,16,13,[11  3],17,-1,30,-1,17
1,<environment.Job instance at 0x7f11c66aa640>,17,18,[6 4],18,-1,36,-1,18
1,<environment.Job instance at 0x7f11c66aa960>,18,27,[5 1],19,-1,46,-1,19
1,<environment.Job instance at 0x7f11c66aa780>,19,15,[9 3],20,-1,35,-1,20
1,<environment.Job instance at 0x7f11c6a29c80>,9,15,[6 5],10,-1,36,-1,21
1,<environment.Job instance at 0x7f11c68bfbe0>,28,27,[1 7],29,-1,56,-1,29
1,<environment.Job instance at 0x7f11c5be9910>,40,17,[5 9],41,-1,58,-1,41
1,<environment.Job instance at 0x7f11c5be9f00>,41,17,[9 4],42,-1,61,-1,44
1,<environment.Job instance at 0x7f11c5be9cd0>,44,14,[9 5],45,-1,60,-1,46
1,<environment.Job instance at 0x7f11c5be9550>,46,16,[3 8],47,-1,63,-1,47
1,<environment.Job instance at 0x7f11c5be9b40>,47,18,[ 5 10],48,-1,66,-1,48
1,<environment.Job instance at 0x7f11c5be9820>,48,15,[1 8],49,-1,64,-1,49
1,<environment.Job instance at 0x7f11c5be9af0>,52,12,[10  2],53,-1,65,-1,53
1,<environment.Job instance at 0x7f11c5be9960>,54,18,[ 2 10],55,-1,73,-1,55
1,<environment.Job instance at 0x7f11c5be9690>,55,14,[8 4],56,-1,70,-1,56
1,<environment.Job instance at 0x7f11c6fe86e0>,56,18,[ 2 10],57,-1,75,-1,57
1,<environment.Job instance at 0x7f11c6fe8320>,57,18,[5 9],58,-1,76,-1,58
1,<environment.Job instance at 0x7f11c6fe8e60>,60,17,[8 2],61,-1,78,-1,61
1,<environment.Job instance at 0x7f11c6fe84b0>,61,14,[4 9],62,-1,76,-1,62
1,<environment.Job instance at 0x7f11c62abeb0>,64,15,[2 5],65,-1,80,-1,65
1,<environment.Job instance at 0x7f11c6284050>,68,25,[5 5],69,-1,94,-1,69
1,<environment.Job instance at 0x7f11c631caa0>,75,14,[5 9],76,-1,98,-1,84
1,<environment.Job instance at 0x7f11c5b9dd70>,78,17,[2 7],79,-1,101,-1,84
1,<environment.Job instance at 0x7f11c6626550>,79,16,[8 5],80,-1,100,-1,84
1,<environment.Job instance at 0x7f11c6303460>,80,22,[4 6],81,-1,106,-1,84
1,<environment.Job instance at 0x7f11c6648370>,82,18,[5 6],83,-1,102,-1,84
1,<environment.Job instance at 0x7f11c5b8d820>,84,18,[10  2],85,-1,103,-1,85
1,<environment.Job instance at 0x7f11c6a04370>,85,17,[3 9],86,-1,103,-1,86
1,<environment.Job instance at 0x7f11cf6e9d70>,83,14,[4 8],84,-1,103,-1,89
1,<environment.Job instance at 0x7f11c5be9e60>,7,13,[13  4],8,-1,21,-1,8
1,<environment.Job instance at 0x7f11c631c3c0>,11,3,[ 4 12],12,-1,24,-1,21
1,<environment.Job instance at 0x7f11c6c2c730>,10,24,[10  5],11,-1,61,-1,37
1,<environment.Job instance at 0x7f11cf5cad70>,15,18,[ 2 11],16,-1,55,-1,37
1,<environment.Job instance at 0x7f11cf5ca910>,16,13,[11  3],17,-1,50,-1,37
1,<environment.Job instance at 0x7f11c68c8c30>,18,27,[5 1],19,-1,66,-1,39
1,<environment.Job instance at 0x7f11c6acb2d0>,28,27,[1 7],29,-1,101,-1,74
1,<environment.Job instance at 0x7f11c6acb230>,29,16,[12  5],30,-1,90,-1,74
1,<environment.Job instance at 0x7f11c5a412d0>,36,1,[14  4],37,-1,83,-1,82
1,<environment.Job instance at 0x7f11c5a418c0>,37,17,[13  5],38,-1,99,-1,82
1,<environment.Job instance at 0x7f11c5920500>,68,25,[5 5],69,-1,247,-1,222
1,<environment.Job instance at 0x7f11c5920d20>,70,18,[14  5],71,-1,240,-1,222
1,<environment.Job instance at 0x7f11c5920370>,71,15,[ 1 12],72,-1,237,-1,222
1,<environment.Job instance at 0x7f11c64df5f0>,92,17,[ 3 14],93,-1,335,-1,318
1,<environment.Job instance at 0x7f11c663f5f0>,95,16,[ 4 12],96,-1,338,-1,322
1,<environment.Job instance at 0x7f11c6625320>,98,18,[13  3],99,-1,351,-1,333
1,<environment.Job instance at 0x7f11c66483c0>,99,1,[ 4 14],100,-1,334,-1,333
1,<environment.Job instance at 0x7f11c64cb8c0>,102,16,[14  1],103,-1,354,-1,338
1,<environment.Job instance at 0x7f11c64cb870>,105,1,[ 5 13],106,-1,340,-1,339
1,<environment.Job instance at 0x7f11c664b460>,113,3,[ 5 11],114,-1,374,-1,371
1,<environment.Job instance at 0x7f11c5d26050>,8,18,[ 4 12],9,-1,27,-1,9
1,<environment.Job instance at 0x7f11c5d265a0>,10,12,[10  4],11,-1,23,-1,11
1,<environment.Job instance at 0x7f11c5d26140>,12,18,[ 5 10],13,-1,31,-1,13
1,<environment.Job instance at 0x7f11c5bbbe60>,16,16,[ 5 10],17,-1,33,-1,17
1,<environment.Job instance at 0x7f11c5bbb870>,19,2,[4 5],20,-1,22,-1,20
1,<environment.Job instance at 0x7f11c6bce910>,33,15,[8 4],34,-1,49,-1,34
1,<environment.Job instance at 0x7f11c6bcecd0>,36,20,[4 9],37,-1,62,-1,42
1,<environment.Job instance at 0x7f11c6bce500>,40,16,[6 2],41,-1,59,-1,43
1,<environment.Job instance at 0x7f11c6e988c0>,43,21,[5 7],44,-1,65,-1,44
1,<environment.Job instance at 0x7f11c6e98e10>,44,14,[10  4],45,-1,60,-1,46
1,<environment.Job instance at 0x7f11c6e982d0>,45,17,[4 9],46,-1,63,-1,46
1,<environment.Job instance at 0x7f11c6e98870>,47,13,[7 4],48,-1,61,-1,48
1,<environment.Job instance at 0x7f11c5bbb5a0>,27,15,[13  3],28,-1,66,-1,51
1,<environment.Job instance at 0x7f11c6e985a0>,51,16,[5 7],52,-1,68,-1,52
1,<environment.Job instance at 0x7f11c6e981e0>,52,19,[4 7],53,-1,72,-1,53
1,<environment.Job instance at 0x7f11c6e98a50>,56,19,[9 4],57,-1,76,-1,57
1,<environment.Job instance at 0x7f11c6e98640>,57,18,[4 7],58,-1,76,-1,58
1,<environment.Job instance at 0x7f11c64c23c0>,63,18,[10  5],64,-1,88,-1,70
1,<environment.Job instance at 0x7f11c6ec1640>,72,15,[ 3 10],73,-1,88,-1,73
1,<environment.Job instance at 0x7f11c6ec1820>,74,17,[9 5],75,-1,92,-1,75
1,<environment.Job instance at 0x7f11c64c21e0>,65,14,[13  2],66,-1,99,-1,85
1,<environment.Job instance at 0x7f11c6ec1780>,79,19,[2 9],80,-1,104,-1,85
1,<environment.Job instance at 0x7f11c6ec1c30>,80,22,[1 9],81,-1,107,-1,85
1,<environment.Job instance at 0x7f11c5eb6c80>,68,24,[8 3],69,-1,116,-1,92
1,<environment.Job instance at 0x7f11c64ee730>,85,14,[10  1],86,-1,106,-1,92
1,<environment.Job instance at 0x7f11c6ec1500>,77,12,[ 3 10],78,-1,104,-1,92
1,<environment.Job instance at 0x7f11c6e98dc0>,53,25,[9 3],54,-1,117,-1,92
1,<environment.Job instance at 0x7f11c64c2d70>,60,26,[9 4],61,-1,118,-1,92
1,<environment.Job instance at 0x7f11c64ee280>,87,17,[1 7],88,-1,109,-1,92
1,<environment.Job instance at 0x7f11c64ee820>,89,17,[8 4],90,-1,109,-1,92
1,<environment.Job instance at 0x7f11c64ee550>,91,16,[2 6],92,-1,110,-1,94
1,<environment.Job instance at 0x7f11c64ee320>,92,17,[8 1],93,-1,111,-1,94
1,<environment.Job instance at 0x7f11c5ef38c0>,93,26,[2 9],94,-1,120,-1,94
1,<environment.Job instance at 0x7f11c5ef3eb0>,94,13,[2 5],95,-1,108,-1,95
1,<environment.Job instance at 0x7f11c64ee690>,84,13,[10  5],85,-1,108,-1,95
1,<environment.Job instance at 0x7f11c5ef3d20>,95,17,[1 8],96,-1,114,-1,97
1,<environment.Job instance at 0x7f11c5ef3410>,102,18,[6 4],103,-1,124,-1,106
1,<environment.Job instance at 0x7f11c64c2fa0>,66,16,[5 2],67,-1,122,-1,106
1,<environment.Job instance at 0x7f11c5bbb050>,22,20,[5 2],23,-1,126,-1,106
1,<environment.Job instance at 0x7f11c5ef3af0>,103,18,[1 8],104,-1,124,-1,106
1,<environment.Job instance at 0x7f11c5ef3230>,96,13,[12  4],97,-1,121,-1,108
1,<environment.Job instance at 0x7f11c6f131e0>,109,15,[8 4],110,-1,125,-1,110
1,<environment.Job instance at 0x7f11cf65edc0>,114,16,[5 3],115,-1,132,-1,116
1,<environment.Job instance at 0x7f11c6282370>,118,18,[5 6],119,-1,137,-1,119
1,<environment.Job instance at 0x7f11c5d26550>,1,3,[ 3 11],2,-1,5,-1,2
1,<environment.Job instance at 0x7f11c6e98550>,8,18,[ 4 12],9,-1,27,-1,9
1,<environment.Job instance at 0x7f11c6ec1af0>,14,26,[10  2],15,-1,50,-1,24
1,<environment.Job instance at 0x7f11c5c43640>,27,15,[13  3],28,-1,54,-1,39
1,<environment.Job instance at 0x7f11c6dfea00>,41,2,[ 2 13],42,-1,72,-1,70
1,<environment.Job instance at 0x7f11c68a0500>,48,2,[12  1],49,-1,98,-1,96
1,<environment.Job instance at 0x7f11c5ecc0a0>,49,27,[ 5 11],50,-1,123,-1,96
1,<environment.Job instance at 0x7f11c630cf50>,53,25,[9 3],54,-1,136,-1,111
1,<environment.Job instance at 0x7f11c6bd84b0>,58,17,[ 2 12],59,-1,132,-1,115
1,<environment.Job instance at 0x7f11c6bd8870>,60,26,[9 4],61,-1,153,-1,127
1,<environment.Job instance at 0x7f11c67e8d70>,65,14,[13  2],66,-1,155,-1,141
1,<environment.Job instance at 0x7f11c66fa190>,68,24,[8 3],69,-1,182,-1,158
1,<environment.Job instance at 0x7f11c613b910>,88,2,[ 4 12],89,-1,230,-1,228
1,<environment.Job instance at 0x7f11c5bbf5f0>,93,26,[2 9],94,-1,285,-1,259
1,<environment.Job instance at 0x7f11cf5d9550>,96,13,[12  4],97,-1,272,-1,259
1,<environment.Job instance at 0x7f11c62d5c80>,101,17,[13  5],102,-1,292,-1,275
1,<environment.Job instance at 0x7f11c61eb7d0>,2,18,[7 3],3,-1,21,-1,3
1,<environment.Job instance at 0x7f11c61eba50>,5,16,[5 7],6,-1,22,-1,6
1,<environment.Job instance at 0x7f11c61ebe60>,7,16,[3 5],8,-1,24,-1,8
1,<environment.Job instance at 0x7f11c653d1e0>,9,23,[5 5],10,-1,33,-1,10
1,<environment.Job instance at 0x7f11c653da00>,10,17,[8 3],11,-1,28,-1,11
1,<environment.Job instance at 0x7f11c653daf0>,12,12,[5 4],13,-1,25,-1,13
1,<environment.Job instance at 0x7f11c653db90>,13,13,[10  3],14,-1,27,-1,14
1,<environment.Job instance at 0x7f11c653d190>,14,17,[5 6],15,-1,32,-1,15
1,<environment.Job instance at 0x7f11c653d370>,15,24,[7 5],16,-1,40,-1,16
1,<environment.Job instance at 0x7f11c653d9b0>,16,15,[1 5],17,-1,32,-1,17
1,<environment.Job instance at 0x7f11c653d2d0>,22,17,[3 8],23,-1,40,-1,23
1,<environment.Job instance at 0x7f11c6173cd0>,26,13,[ 1 10],27,-1,40,-1,27
1,<environment.Job instance at 0x7f11c61734b0>,27,14,[9 3],28,-1,42,-1,28
1,<environment.Job instance at 0x7f11c6173eb0>,29,15,[8 4],30,-1,45,-1,30
1,<environment.Job instance at 0x7f11c6173780>,31,15,[3 9],32,-1,47,-1,32
1,<environment.Job instance at 0x7f11c6173c80>,32,16,[6 3],33,-1,49,-1,33
1,<environment.Job instance at 0x7f11c6173e60>,35,19,[8 1],36,-1,55,-1,36
1,<environment.Job instance at 0x7f11c5bf3d70>,41,23,[7 5],42,-1,65,-1,42
1,<environment.Job instance at 0x7f11c5bf39b0>,42,28,[8 2],43,-1,71,-1,43
1,<environment.Job instance at 0x7f11c5bf3aa0>,43,22,[5 4],44,-1,66,-1,44
1,<environment.Job instance at 0x7f11c5bf3fa0>,45,17,[ 4 10],46,-1,63,-1,46
1,<environment.Job instance at 0x7f11c6f3e050>,51,17,[6 5],52,-1,69,-1,52
1,<environment.Job instance at 0x7f11c6f3e820>,53,18,[10  5],54,-1,72,-1,54
1,<environment.Job instance at 0x7f11c65e4820>,63,18,[4 9],64,-1,82,-1,64
1,<environment.Job instance at 0x7f11c65e4190>,64,26,[7 4],65,-1,91,-1,65
1,<environment.Job instance at 0x7f11c577c8c0>,68,16,[1 8],69,-1,85,-1,69
1,<environment.Job instance at 0x7f11c577c690>,69,12,[9 3],70,-1,84,-1,72
1,<environment.Job instance at 0x7f11c69a4190>,74,17,[10  4],75,-1,92,-1,75
1,<environment.Job instance at 0x7f11c69a4230>,76,2,[3 5],77,-1,79,-1,77
1,<environment.Job instance at 0x7f11c69a4320>,77,1,[5 1],78,-1,79,-1,78
1,<environment.Job instance at 0x7f11c69a47d0>,78,16,[14  5],79,-1,95,-1,79
1,<environment.Job instance at 0x7f11c69a4c80>,79,2,[6 3],80,-1,82,-1,80
1,<environment.Job instance at 0x7f11c69a4b90>,80,13,[8 3],81,-1,94,-1,81
1,<environment.Job instance at 0x7f11c69a4d70>,81,16,[8 1],82,-1,98,-1,82
1,<environment.Job instance at 0x7f11c6fbb370>,87,19,[4 7],88,-1,107,-1,88
1,<environment.Job instance at 0x7f11c6fbb1e0>,89,15,[6 1],90,-1,105,-1,90
1,<environment.Job instance at 0x7f11c6fbbdc0>,90,17,[2 8],91,-1,108,-1,91
1,<environment.Job instance at 0x7f11c6fbbd70>,92,12,[10  3],93,-1,105,-1,93
1,<environment.Job instance at 0x7f11c64ae3c0>,94,16,[6 3],95,-1,111,-1,95
1,<environment.Job instance at 0x7f11c6315f50>,97,18,[7 1],98,-1,117,-1,99
1,<environment.Job instance at 0x7f11c63151e0>,99,15,[9 3],100,-1,115,-1,100
1,<environment.Job instance at 0x7f11c6315370>,100,2,[3 9],101,-1,103,-1,101
1,<environment.Job instance at 0x7f11c6315dc0>,101,3,[1 7],102,-1,105,-1,102
1,<environment.Job instance at 0x7f11c6315a00>,102,22,[6 2],103,-1,125,-1,103
1,<environment.Job instance at 0x7f11c6315be0>,103,16,[4 9],104,-1,120,-1,104
1,<environment.Job instance at 0x7f11c6315cd0>,104,23,[6 5],105,-1,128,-1,105
1,<environment.Job instance at 0x7f11c63155a0>,105,1,[9 4],106,-1,107,-1,106
1,<environment.Job instance at 0x7f11c63155f0>,106,3,[ 4 10],107,-1,110,-1,107
1,<environment.Job instance at 0x7f11c6315e60>,108,12,[ 3 10],109,-1,121,-1,109
1,<environment.Job instance at 0x7f11c6a77b90>,110,2,[2 7],111,-1,113,-1,111
1,<environment.Job instance at 0x7f11c62b53c0>,111,12,[1 7],112,-1,124,-1,112
1,<environment.Job instance at 0x7f11c6ba8e10>,112,17,[1 6],113,-1,130,-1,113
1,<environment.Job instance at 0x7f11c5a64910>,113,21,[7 4],114,-1,135,-1,114
1,<environment.Job instance at 0x7f11c61e7d20>,98,16,[10  3],99,-1,131,-1,115
1,<environment.Job instance at 0x7f11c6d830a0>,9,23,[5 5],10,-1,39,-1,16
1,<environment.Job instance at 0x7f11c69a4e10>,15,24,[7 5],16,-1,64,-1,40
1,<environment.Job instance at 0x7f11c61eb280>,17,3,[ 2 13],18,-1,43,-1,40
1,<environment.Job instance at 0x7f11c6ae3910>,30,1,[13  2],31,-1,78,-1,77
1,<environment.Job instance at 0x7f11c62d5c80>,33,1,[ 2 13],34,-1,90,-1,89
1,<environment.Job instance at 0x7f11c6799320>,36,1,[ 4 11],37,-1,105,-1,104
1,<environment.Job instance at 0x7f11cf5d9730>,41,23,[7 5],42,-1,134,-1,111
1,<environment.Job instance at 0x7f11c5bc7050>,42,28,[8 2],43,-1,149,-1,121
1,<environment.Job instance at 0x7f11c5ebc370>,64,26,[7 4],65,-1,187,-1,161
1,<environment.Job instance at 0x7f11c630c320>,65,1,[12  3],66,-1,162,-1,161
1,<environment.Job instance at 0x7f11c60f1a00>,78,16,[14  5],79,-1,212,-1,196
1,<environment.Job instance at 0x7f11c6173a50>,82,14,[ 2 12],83,-1,216,-1,202
1,<environment.Job instance at 0x7f11c5ce1230>,85,15,[ 2 12],86,-1,228,-1,213
1,<environment.Job instance at 0x7f11c6768640>,104,23,[6 5],105,-1,311,-1,288
1,<environment.Job instance at 0x7f11c66b55f0>,115,15,[ 5 11],116,-1,338,-1,323
1,<environment.Job instance at 0x7f11c70a3b90>,0,26,[5 7],1,-1,27,-1,1
1,<environment.Job instance at 0x7f11c70a3eb0>,1,16,[ 2 10],2,-1,22,-1,6
1,<environment.Job instance at 0x7f11c70a3d20>,7,15,[1 7],8,-1,23,-1,8
1,<environment.Job instance at 0x7f11c5e8fe60>,8,18,[5 6],9,-1,27,-1,9
1,<environment.Job instance at 0x7f11c5e8f550>,9,27,[5 9],10,-1,37,-1,10
1,<environment.Job instance at 0x7f11c70a3dc0>,4,20,[5 9],5,-1,34,-1,14
1,<environment.Job instance at 0x7f11c5e8faf0>,11,12,[8 3],12,-1,26,-1,14
1,<environment.Job instance at 0x7f11c5e8f8c0>,15,16,[10  2],16,-1,133,-1,117
1,<environment.Job instance at 0x7f11c5e8fd20>,14,16,[5 6],15,-1,134,-1,118
1,<environment.Job instance at 0x7f11cf62a780>,17,12,[4 7],18,-1,131,-1,119
1,<environment.Job instance at 0x7f11cf62abe0>,19,12,[ 5 10],20,-1,131,-1,119
1,<environment.Job instance at 0x7f11cf62a2d0>,20,20,[5 8],21,-1,145,-1,125
1,<environment.Job instance at 0x7f11c709c8c0>,27,14,[8 3],28,-1,139,-1,125
1,<environment.Job instance at 0x7f11c709c960>,28,14,[7 5],29,-1,139,-1,125
1,<environment.Job instance at 0x7f11c5e7cf00>,32,16,[11  5],33,-1,141,-1,125
1,<environment.Job instance at 0x7f11c70a3aa0>,12,26,[ 1 10],13,-1,151,-1,125
1,<environment.Job instance at 0x7f11c5e7c320>,34,18,[3 8],35,-1,143,-1,125
1,<environment.Job instance at 0x7f11c709c6e0>,30,21,[5 2],31,-1,159,-1,138
1,<environment.Job instance at 0x7f11c5e7c690>,41,17,[2 9],42,-1,159,-1,142
1,<environment.Job instance at 0x7f11c6a22640>,46,12,[9 1],47,-1,154,-1,142
1,<environment.Job instance at 0x7f11c5e7c550>,38,13,[5 9],39,-1,155,-1,142
1,<environment.Job instance at 0x7f11c6a22f00>,48,14,[7 3],49,-1,156,-1,142
1,<environment.Job instance at 0x7f11c6a22be0>,50,12,[3 8],51,-1,154,-1,142
1,<environment.Job instance at 0x7f11cf986a00>,53,2,[4 7],54,-1,145,-1,143
1,<environment.Job instance at 0x7f11cf6045a0>,54,18,[6 3],55,-1,162,-1,144
1,<environment.Job instance at 0x7f11cf604e60>,55,23,[7 4],56,-1,167,-1,144
1,<environment.Job instance at 0x7f11cf604780>,56,23,[5 6],57,-1,168,-1,145
1,<environment.Job instance at 0x7f11cf6046e0>,57,16,[2 6],58,-1,163,-1,147
1,<environment.Job instance at 0x7f11cf604960>,58,25,[ 5 10],59,-1,172,-1,147
1,<environment.Job instance at 0x7f11cf604230>,59,15,[5 3],60,-1,162,-1,147
1,<environment.Job instance at 0x7f11cf604690>,60,17,[6 4],61,-1,164,-1,147
1,<environment.Job instance at 0x7f11cf604410>,62,18,[9 5],63,-1,165,-1,147
1,<environment.Job instance at 0x7f11cf604370>,63,17,[5 1],64,-1,164,-1,147
1,<environment.Job instance at 0x7f11cf6040a0>,65,15,[9 5],66,-1,162,-1,147
1,<environment.Job instance at 0x7f11c658fdc0>,68,14,[3 8],69,-1,161,-1,147
1,<environment.Job instance at 0x7f11cf625140>,71,16,[8 5],72,-1,163,-1,147
1,<environment.Job instance at 0x7f11c6b53910>,73,17,[ 5 12],74,-1,164,-1,147
1,<environment.Job instance at 0x7f11c6b53b90>,74,17,[5 7],75,-1,166,-1,149
1,<environment.Job instance at 0x7f11c6a553c0>,83,20,[5 2],84,-1,196,-1,176
1,<environment.Job instance at 0x7f11c709c820>,26,18,[3 5],27,-1,194,-1,176
1,<environment.Job instance at 0x7f11c586d230>,89,14,[8 5],90,-1,190,-1,176
1,<environment.Job instance at 0x7f11c70a3960>,3,15,[10  1],4,-1,191,-1,176
1,<environment.Job instance at 0x7f11c6229b90>,91,18,[6 1],92,-1,195,-1,177
1,<environment.Job instance at 0x7f11c70a9d70>,85,15,[8 2],86,-1,192,-1,177
1,<environment.Job instance at 0x7f11c6b3b5f0>,94,12,[9 4],95,-1,189,-1,177
1,<environment.Job instance at 0x7f11c597d730>,96,12,[3 5],97,-1,189,-1,177
1,<environment.Job instance at 0x7f11c61bef00>,98,12,[3 5],99,-1,189,-1,177
1,<environment.Job instance at 0x7f11c5982500>,100,25,[8 3],101,-1,202,-1,177
1,<environment.Job instance at 0x7f11c6b42a50>,101,27,[8 1],102,-1,204,-1,177
1,<environment.Job instance at 0x7f11c66816e0>,93,14,[2 9],94,-1,196,-1,182
1,<environment.Job instance at 0x7f11c6b52aa0>,106,17,[3 8],107,-1,201,-1,184
1,<environment.Job instance at 0x7f11c65790f0>,109,18,[5 2],110,-1,203,-1,185
1,<environment.Job instance at 0x7f11c65628c0>,116,14,[10  1],117,-1,200,-1,186
1,<environment.Job instance at 0x7f11c6562410>,117,26,[ 5 10],118,-1,212,-1,186
1,<environment.Job instance at 0x7f11c6562550>,118,14,[3 7],119,-1,200,-1,186
1,<environment.Job instance at 0x7f11cf604460>,67,26,[ 2 10],68,-1,212,-1,186
1,<environment.Job instance at 0x7f11c6562960>,0,26,[5 7],1,-1,27,-1,1
1,<environment.Job instance at 0x7f11c6566f50>,9,27,[5 9],10,-1,45,-1,18
1,<environment.Job instance at 0x7f11c59b2d70>,13,28,[3 5],14,-1,49,-1,21
1,<environment.Job instance at 0x7f11c6545460>,12,26,[ 1 10],13,-1,59,-1,33
1,<environment.Job instance at 0x7f11c69c5e60>,29,14,[ 1 13],30,-1,73,-1,59
1,<environment.Job instance at 0x7f11c5e8fbe0>,32,16,[11  5],33,-1,77,-1,61
1,<environment.Job instance at 0x7f11c6341c30>,55,23,[7 4],56,-1,164,-1,141
1,<environment.Job instance at 0x7f11c63419b0>,56,23,[5 6],57,-1,164,-1,141
1,<environment.Job instance at 0x7f11c5de6140>,61,12,[ 5 11],62,-1,178,-1,166
1,<environment.Job instance at 0x7f11c5de2a00>,58,25,[ 5 10],59,-1,206,-1,181
1,<environment.Job instance at 0x7f11c61ce280>,67,26,[ 2 10],68,-1,212,-1,186
1,<environment.Job instance at 0x7f11c61ecc30>,73,17,[ 5 12],74,-1,227,-1,210
1,<environment.Job instance at 0x7f11c61ca410>,87,2,[ 5 11],88,-1,250,-1,248
1,<environment.Job instance at 0x7f11c60f5c30>,88,12,[12  2],89,-1,260,-1,248
1,<environment.Job instance at 0x7f11c61ca460>,90,2,[ 4 14],91,-1,251,-1,249
1,<environment.Job instance at 0x7f11c5afbd20>,101,27,[8 1],102,-1,324,-1,297
1,<environment.Job instance at 0x7f11c5dbaf50>,100,25,[8 3],101,-1,322,-1,297
1,<environment.Job instance at 0x7f11c5f8a730>,107,27,[2 6],108,-1,329,-1,302
1,<environment.Job instance at 0x7f11c61c83c0>,117,26,[ 5 10],118,-1,357,-1,331
1,<environment.Job instance at 0x7f11c5fa1c30>,0,17,[4 8],1,-1,18,-1,1
1,<environment.Job instance at 0x7f11c5fa1910>,1,17,[3 6],2,-1,19,-1,2
1,<environment.Job instance at 0x7f11c5fa1370>,2,17,[ 4 10],3,-1,20,-1,3
1,<environment.Job instance at 0x7f11c5f815f0>,9,18,[5 5],10,-1,28,-1,10
1,<environment.Job instance at 0x7f11c5f81f00>,11,18,[5 5],12,-1,30,-1,12
1,<environment.Job instance at 0x7f11c5f81a50>,12,28,[5 1],13,-1,41,-1,13
1,<environment.Job instance at 0x7f11c5fa17d0>,16,17,[3 7],17,-1,34,-1,17
1,<environment.Job instance at 0x7f11c5f7caa0>,21,17,[ 4 10],22,-1,40,-1,23
1,<environment.Job instance at 0x7f11c5f7c460>,24,23,[2 9],25,-1,48,-1,25
1,<environment.Job instance at 0x7f11c5f7c320>,25,18,[5 3],26,-1,44,-1,26
1,<environment.Job instance at 0x7f11c5f76e60>,31,17,[6 1],32,-1,50,-1,33
1,<environment.Job instance at 0x7f11c5f76320>,33,15,[5 8],34,-1,49,-1,34
1,<environment.Job instance at 0x7f11c5f76780>,38,26,[2 5],39,-1,65,-1,39
1,<environment.Job instance at 0x7f11c5f905f0>,39,28,[4 8],40,-1,68,-1,40
1,<environment.Job instance at 0x7f11c5f90dc0>,40,28,[1 5],41,-1,75,-1,47
1,<environment.Job instance at 0x7f11c5f902d0>,43,13,[10  1],44,-1,60,-1,47
1,<environment.Job instance at 0x7f11c5b30eb0>,46,22,[7 4],47,-1,69,-1,47
1,<environment.Job instance at 0x7f11c5b30460>,48,18,[5 5],49,-1,68,-1,50
1,<environment.Job instance at 0x7f11c5b308c0>,54,18,[ 2 10],55,-1,73,-1,55
1,<environment.Job instance at 0x7f11c5b30f50>,58,14,[9 3],59,-1,77,-1,63
1,<environment.Job instance at 0x7f11c6c805a0>,64,16,[5 8],65,-1,81,-1,65
1,<environment.Job instance at 0x7f11c6c80aa0>,62,18,[7 2],63,-1,83,-1,65
1,<environment.Job instance at 0x7f11c6c80eb0>,65,16,[2 7],66,-1,82,-1,66
1,<environment.Job instance at 0x7f11c6c80190>,67,12,[10  4],68,-1,81,-1,69
1,<environment.Job instance at 0x7f11c6c80dc0>,69,16,[ 3 10],70,-1,86,-1,70
1,<environment.Job instance at 0x7f11c6c80640>,70,13,[8 2],71,-1,84,-1,71
1,<environment.Job instance at 0x7f11c6c80140>,73,15,[3 5],74,-1,90,-1,75
1,<environment.Job instance at 0x7f11c634d230>,75,13,[6 1],76,-1,89,-1,76
1,<environment.Job instance at 0x7f11c634d640>,76,20,[10  4],77,-1,97,-1,77
1,<environment.Job instance at 0x7f11c5b30550>,47,28,[ 1 10],48,-1,106,-1,78
1,<environment.Job instance at 0x7f11c634d4b0>,79,13,[3 6],80,-1,93,-1,80
1,<environment.Job instance at 0x7f11c634d1e0>,85,17,[5 8],86,-1,104,-1,87
1,<environment.Job instance at 0x7f11c63495f0>,90,16,[8 2],91,-1,109,-1,93
1,<environment.Job instance at 0x7f11c69e0280>,92,17,[5 5],93,-1,110,-1,93
1,<environment.Job instance at 0x7f11c69e08c0>,93,24,[9 2],94,-1,118,-1,94
1,<environment.Job instance at 0x7f11c69e01e0>,91,12,[9 4],92,-1,109,-1,97
1,<environment.Job instance at 0x7f11c5f873c0>,94,13,[6 5],95,-1,113,-1,100
1,<environment.Job instance at 0x7f11c5f87460>,99,15,[10  5],100,-1,115,-1,100
1,<environment.Job instance at 0x7f11c634d2d0>,86,1,[10  4],87,-1,107,-1,106
1,<environment.Job instance at 0x7f11c5afbb40>,103,13,[7 3],104,-1,130,-1,117
1,<environment.Job instance at 0x7f11c6950a00>,101,24,[2 6],102,-1,141,-1,117
1,<environment.Job instance at 0x7f11c6b46f00>,109,16,[ 1 10],110,-1,139,-1,123
1,<environment.Job instance at 0x7f11c5f76640>,30,12,[ 4 10],31,-1,137,-1,125
1,<environment.Job instance at 0x7f11c58f1b90>,114,17,[11  5],115,-1,142,-1,125
1,<environment.Job instance at 0x7f11c58e6190>,115,15,[ 2 12],116,-1,142,-1,127
1,<environment.Job instance at 0x7f11c58e61e0>,118,3,[10  4],119,-1,130,-1,127
1,<environment.Job instance at 0x7f11c69c3a00>,113,21,[5 4],114,-1,148,-1,127
1,<environment.Job instance at 0x7f11c58e6eb0>,116,12,[10  3],117,-1,139,-1,127
1,<environment.Job instance at 0x7f11c634d960>,4,1,[ 1 11],5,-1,6,-1,5
1,<environment.Job instance at 0x7f11c5f870f0>,5,1,[ 3 14],6,-1,7,-1,6
1,<environment.Job instance at 0x7f11c5f81910>,12,28,[5 1],13,-1,48,-1,20
1,<environment.Job instance at 0x7f11c5f7f7d0>,19,13,[ 1 13],20,-1,55,-1,42
1,<environment.Job instance at 0x7f11c5f76550>,24,23,[2 9],25,-1,70,-1,47
1,<environment.Job instance at 0x7f11c5f76dc0>,26,3,[14  4],27,-1,50,-1,47
1,<environment.Job instance at 0x7f11c5f90550>,38,26,[2 5],39,-1,123,-1,97
1,<environment.Job instance at 0x7f11c5b300a0>,40,28,[1 5],41,-1,128,-1,100
1,<environment.Job instance at 0x7f11c5f904b0>,39,28,[4 8],40,-1,138,-1,110
1,<environment.Job instance at 0x7f11c59b25f0>,47,28,[ 1 10],48,-1,146,-1,118
1,<environment.Job instance at 0x7f11c656d690>,93,24,[9 2],94,-1,281,-1,257
1,<environment.Job instance at 0x7f11c620e320>,101,24,[2 6],102,-1,298,-1,274
1,<environment.Job instance at 0x7f11c6955870>,114,17,[11  5],115,-1,345,-1,328
1,<environment.Job instance at 0x7f11c6955a50>,115,15,[ 2 12],116,-1,343,-1,328
1,<environment.Job instance at 0x7f11c6428fa0>,2,18,[10  3],3,-1,23,-1,5
1,<environment.Job instance at 0x7f11c640e1e0>,5,1,[1 5],6,-1,7,-1,6
1,<environment.Job instance at 0x7f11c640e0f0>,6,24,[10  2],7,-1,31,-1,7
1,<environment.Job instance at 0x7f11c640e230>,7,18,[3 8],8,-1,26,-1,8
1,<environment.Job instance at 0x7f11c640e2d0>,8,1,[2 6],9,-1,10,-1,9
1,<environment.Job instance at 0x7f11c6428d70>,4,24,[5 8],5,-1,33,-1,9
1,<environment.Job instance at 0x7f11c640e730>,13,17,[7 2],14,-1,31,-1,14
1,<environment.Job instance at 0x7f11c640e820>,14,18,[1 8],15,-1,33,-1,15
1,<environment.Job instance at 0x7f11c640e910>,16,23,[9 5],17,-1,40,-1,17
1,<environment.Job instance at 0x7f11c640ea50>,17,18,[1 8],18,-1,36,-1,18
1,<environment.Job instance at 0x7f11c640edc0>,22,18,[1 6],23,-1,41,-1,23
1,<environment.Job instance at 0x7f11c642d050>,23,17,[10  3],24,-1,41,-1,24
1,<environment.Job instance at 0x7f11c642d190>,25,16,[7 4],26,-1,42,-1,26
1,<environment.Job instance at 0x7f11c642d910>,32,17,[6 3],33,-1,50,-1,33
1,<environment.Job instance at 0x7f11c642db90>,33,27,[5 6],34,-1,61,-1,34
1,<environment.Job instance at 0x7f11c642de10>,36,16,[ 3 11],37,-1,53,-1,37
1,<environment.Job instance at 0x7f11c64179b0>,47,18,[4 5],48,-1,67,-1,49
1,<environment.Job instance at 0x7f11c6417820>,49,17,[7 5],50,-1,67,-1,50
1,<environment.Job instance at 0x7f11c6417c30>,51,15,[4 9],52,-1,70,-1,55
1,<environment.Job instance at 0x7f11c6417af0>,48,15,[5 4],49,-1,71,-1,56
1,<environment.Job instance at 0x7f11c6411050>,56,15,[8 5],57,-1,74,-1,59
1,<environment.Job instance at 0x7f11c63fa1e0>,59,17,[7 1],60,-1,77,-1,60
1,<environment.Job instance at 0x7f11c63fa140>,60,16,[10  3],61,-1,77,-1,61
1,<environment.Job instance at 0x7f11c6413fa0>,63,12,[9 4],64,-1,76,-1,64
1,<environment.Job instance at 0x7f11c6417e60>,53,18,[1 8],54,-1,83,-1,65
1,<environment.Job instance at 0x7f11c6417fa0>,55,27,[4 6],56,-1,102,-1,75
1,<environment.Job instance at 0x7f11c64133c0>,72,17,[3 8],73,-1,94,-1,77
1,<environment.Job instance at 0x7f11c64175a0>,44,27,[3 8],45,-1,104,-1,77
1,<environment.Job instance at 0x7f11c64136e0>,69,13,[4 9],70,-1,90,-1,77
1,<environment.Job instance at 0x7f11c6413230>,74,28,[4 7],75,-1,105,-1,77
1,<environment.Job instance at 0x7f11c64132d0>,73,14,[4 9],74,-1,91,-1,77
1,<environment.Job instance at 0x7f11c5e37cd0>,78,14,[10  3],79,-1,93,-1,79
1,<environment.Job instance at 0x7f11c5e474b0>,79,18,[8 2],80,-1,98,-1,80
1,<environment.Job instance at 0x7f11c62187d0>,58,12,[4 8],59,-1,96,-1,84
1,<environment.Job instance at 0x7f11c5726e10>,80,24,[9 4],81,-1,111,-1,87
1,<environment.Job instance at 0x7f11c65485a0>,86,18,[10  1],87,-1,107,-1,89
1,<environment.Job instance at 0x7f11c5726fa0>,81,17,[5 4],82,-1,106,-1,89
1,<environment.Job instance at 0x7f11c5cf48c0>,88,16,[7 1],89,-1,105,-1,89
1,<environment.Job instance at 0x7f11c56fa280>,85,12,[2 6],86,-1,102,-1,90
1,<environment.Job instance at 0x7f11c571dcd0>,89,15,[ 4 10],90,-1,105,-1,90
1,<environment.Job instance at 0x7f11c571d3c0>,90,17,[3 8],91,-1,108,-1,91
1,<environment.Job instance at 0x7f11c570d140>,93,17,[7 3],94,-1,111,-1,94
1,<environment.Job instance at 0x7f11c6b61d20>,84,14,[3 7],85,-1,114,-1,100
1,<environment.Job instance at 0x7f11c5e494b0>,97,18,[3 9],98,-1,118,-1,100
1,<environment.Job instance at 0x7f11c5e4aeb0>,103,17,[10  3],104,-1,121,-1,104
1,<environment.Job instance at 0x7f11c571d050>,91,16,[12  1],92,-1,122,-1,106
1,<environment.Job instance at 0x7f11c5e4aaf0>,106,16,[2 9],107,-1,123,-1,107
1,<environment.Job instance at 0x7f11c5e4a960>,107,22,[10  4],108,-1,130,-1,108
1,<environment.Job instance at 0x7f11c57240a0>,108,21,[7 1],109,-1,130,-1,109
1,<environment.Job instance at 0x7f11c640e500>,4,24,[5 8],5,-1,38,-1,14
1,<environment.Job instance at 0x7f11c64173c0>,10,2,[14  3],11,-1,16,-1,14
1,<environment.Job instance at 0x7f11c642d230>,6,24,[10  2],7,-1,45,-1,21
1,<environment.Job instance at 0x7f11c5e4adc0>,16,23,[9 5],17,-1,72,-1,49
1,<environment.Job instance at 0x7f11c69556e0>,29,1,[13  5],30,-1,70,-1,69
1,<environment.Job instance at 0x7f11c6579e60>,33,27,[5 6],34,-1,103,-1,76
1,<environment.Job instance at 0x7f11c620e320>,36,16,[ 3 11],37,-1,92,-1,76
1,<environment.Job instance at 0x7f11c6545eb0>,38,25,[11  1],39,-1,112,-1,87
1,<environment.Job instance at 0x7f11c656db90>,44,27,[3 8],45,-1,136,-1,109
1,<environment.Job instance at 0x7f11c57b7be0>,50,18,[12  3],51,-1,128,-1,110
1,<environment.Job instance at 0x7f11c5976d70>,55,27,[4 6],56,-1,165,-1,138
1,<environment.Job instance at 0x7f11c58f3820>,70,14,[11  5],71,-1,213,-1,199
1,<environment.Job instance at 0x7f11c58f3320>,74,28,[4 7],75,-1,243,-1,215
1,<environment.Job instance at 0x7f11c6566320>,80,24,[9 4],81,-1,266,-1,242
1,<environment.Job instance at 0x7f11c59b2d70>,83,2,[12  3],84,-1,244,-1,242
1,<environment.Job instance at 0x7f11c5b30af0>,91,16,[12  1],92,-1,304,-1,288
1,<environment.Job instance at 0x7f11c5f81f50>,118,3,[14  4],119,-1,389,-1,386
1,<environment.Job instance at 0x7f11c5d194b0>,6,21,[10  2],7,-1,34,-1,13
1,<environment.Job instance at 0x7f11c5d19af0>,14,16,[8 4],15,-1,31,-1,15
1,<environment.Job instance at 0x7f11c5e1b1e0>,16,14,[ 2 10],17,-1,31,-1,17
1,<environment.Job instance at 0x7f11c5e1b2d0>,18,14,[6 4],19,-1,33,-1,19
1,<environment.Job instance at 0x7f11c5e1b230>,19,3,[1 6],20,-1,23,-1,20
1,<environment.Job instance at 0x7f11c5e1b5f0>,20,25,[ 4 10],21,-1,46,-1,21
1,<environment.Job instance at 0x7f11c5e1bf00>,21,22,[9 1],22,-1,44,-1,22
1,<environment.Job instance at 0x7f11c5e1b9b0>,22,14,[7 5],23,-1,37,-1,23
1,<environment.Job instance at 0x7f11c5e1bfa0>,24,14,[ 2 11],25,-1,39,-1,25
1,<environment.Job instance at 0x7f11c5e1baa0>,25,18,[2 9],26,-1,44,-1,26
1,<environment.Job instance at 0x7f11c5e1b7d0>,26,18,[10  3],27,-1,45,-1,27
1,<environment.Job instance at 0x7f11c5d196e0>,12,15,[3 8],13,-1,42,-1,27
1,<environment.Job instance at 0x7f11c5e1baf0>,27,19,[ 2 10],28,-1,47,-1,28
1,<environment.Job instance at 0x7f11c5e1b820>,29,17,[1 5],30,-1,47,-1,30
1,<environment.Job instance at 0x7f11c700ac80>,34,16,[2 8],35,-1,51,-1,35
1,<environment.Job instance at 0x7f11c700a050>,37,17,[ 5 10],38,-1,55,-1,38
1,<environment.Job instance at 0x7f11c700ae60>,38,15,[2 6],39,-1,55,-1,40
1,<environment.Job instance at 0x7f11c700a2d0>,40,17,[6 1],41,-1,58,-1,41
1,<environment.Job instance at 0x7f11c700aa00>,41,14,[4 8],42,-1,56,-1,42
1,<environment.Job instance at 0x7f11c6d83820>,49,28,[4 8],50,-1,78,-1,50
1,<environment.Job instance at 0x7f11c6d83af0>,50,13,[1 8],51,-1,64,-1,51
1,<environment.Job instance at 0x7f11c6d832d0>,51,13,[8 2],52,-1,65,-1,52
1,<environment.Job instance at 0x7f11c6d83960>,55,18,[7 4],56,-1,74,-1,56
1,<environment.Job instance at 0x7f11c5ecfe10>,59,17,[4 6],60,-1,77,-1,60
1,<environment.Job instance at 0x7f11c5ecfb40>,61,15,[5 1],62,-1,77,-1,62
1,<environment.Job instance at 0x7f11c5ecf190>,65,17,[4 6],66,-1,83,-1,66
1,<environment.Job instance at 0x7f11c6dab050>,66,15,[10  5],67,-1,82,-1,67
1,<environment.Job instance at 0x7f11c6dab0a0>,77,17,[9 4],78,-1,95,-1,78
1,<environment.Job instance at 0x7f11c6dab960>,76,15,[5 5],77,-1,96,-1,81
1,<environment.Job instance at 0x7f11c6dabf50>,71,13,[ 3 11],72,-1,94,-1,81
1,<environment.Job instance at 0x7f11c6d83d20>,46,16,[12  5],47,-1,101,-1,85
1,<environment.Job instance at 0x7f11c6fa46e0>,80,18,[2 9],81,-1,103,-1,85
1,<environment.Job instance at 0x7f11c6fa4550>,82,16,[2 8],83,-1,101,-1,85
1,<environment.Job instance at 0x7f11c582d640>,84,14,[7 2],85,-1,99,-1,85
1,<environment.Job instance at 0x7f11c6fa45a0>,81,2,[10  3],82,-1,89,-1,87
1,<environment.Job instance at 0x7f11c582d3c0>,86,13,[10  2],87,-1,100,-1,87
1,<environment.Job instance at 0x7f11c582de10>,89,20,[7 2],90,-1,110,-1,90
1,<environment.Job instance at 0x7f11c582d5f0>,90,16,[1 9],91,-1,107,-1,91
1,<environment.Job instance at 0x7f11c700a230>,39,16,[5 5],40,-1,112,-1,96
1,<environment.Job instance at 0x7f11c60e3aa0>,98,22,[ 3 10],99,-1,121,-1,99
1,<environment.Job instance at 0x7f11c60e3c80>,99,12,[7 5],100,-1,112,-1,100
1,<environment.Job instance at 0x7f11c6428190>,101,14,[ 5 10],102,-1,117,-1,103
1,<environment.Job instance at 0x7f11c6adf4b0>,102,17,[5 8],103,-1,120,-1,103
1,<environment.Job instance at 0x7f11c582dfa0>,92,16,[5 3],93,-1,131,-1,115
1,<environment.Job instance at 0x7f11cf5cad20>,104,19,[3 7],105,-1,134,-1,115
1,<environment.Job instance at 0x7f11c60e3410>,93,15,[9 4],94,-1,131,-1,116
1,<environment.Job instance at 0x7f11c6ab27d0>,110,28,[2 6],111,-1,146,-1,118
1,<environment.Job instance at 0x7f11c60e3960>,100,13,[ 2 13],101,-1,132,-1,119
1,<environment.Job instance at 0x7f11c5ab93c0>,105,12,[ 4 10],106,-1,131,-1,119
1,<environment.Job instance at 0x7f11c57ea870>,115,15,[4 9],116,-1,134,-1,119
1,<environment.Job instance at 0x7f11c5d19230>,0,14,[12  5],1,-1,15,-1,1
1,<environment.Job instance at 0x7f11c602c280>,20,25,[ 4 10],21,-1,81,-1,56
1,<environment.Job instance at 0x7f11c5f81550>,24,14,[ 2 11],25,-1,70,-1,56
1,<environment.Job instance at 0x7f11c5f76730>,30,17,[ 5 14],31,-1,89,-1,72
1,<environment.Job instance at 0x7f11c67db960>,46,16,[12  5],47,-1,142,-1,126
1,<environment.Job instance at 0x7f11c69a7730>,49,28,[4 8],50,-1,162,-1,134
1,<environment.Job instance at 0x7f11c60e45f0>,64,12,[ 4 13],65,-1,182,-1,170
1,<environment.Job instance at 0x7f11c5976500>,70,2,[ 2 12],71,-1,192,-1,190
1,<environment.Job instance at 0x7f11c5976460>,71,13,[ 3 11],72,-1,203,-1,190
1,<environment.Job instance at 0x7f11c6545fa0>,85,1,[14  5],86,-1,256,-1,255
1,<environment.Job instance at 0x7f11c6545aa0>,87,2,[ 5 12],88,-1,268,-1,266
1,<environment.Job instance at 0x7f11c585d5a0>,95,2,[ 2 12],96,-1,302,-1,300
1,<environment.Job instance at 0x7f11c6428780>,100,13,[ 2 13],101,-1,327,-1,314
1,<environment.Job instance at 0x7f11c5e47c30>,107,23,[3 5],108,-1,367,-1,344
1,<environment.Job instance at 0x7f11c64138c0>,110,28,[2 6],111,-1,387,-1,359
1,<environment.Job instance at 0x7f11c68140a0>,1,16,[1 7],2,-1,18,-1,2
1,<environment.Job instance at 0x7f11c5a355f0>,3,19,[3 9],4,-1,23,-1,4
1,<environment.Job instance at 0x7f11c6814b40>,5,17,[9 1],6,-1,24,-1,7
1,<environment.Job instance at 0x7f11c63a58c0>,7,14,[5 6],8,-1,22,-1,8
1,<environment.Job instance at 0x7f11c63a5dc0>,9,18,[5 3],10,-1,28,-1,10
1,<environment.Job instance at 0x7f11c63a5be0>,11,20,[10  2],12,-1,32,-1,12
1,<environment.Job instance at 0x7f11c63a5230>,14,14,[ 3 10],15,-1,29,-1,15
1,<environment.Job instance at 0x7f11c625ce60>,17,18,[1 8],18,-1,36,-1,18
1,<environment.Job instance at 0x7f11c5b7d9b0>,20,18,[8 3],21,-1,39,-1,21
1,<environment.Job instance at 0x7f11c6833280>,24,12,[4 5],25,-1,37,-1,25
1,<environment.Job instance at 0x7f11c6833190>,28,27,[6 3],29,-1,56,-1,29
1,<environment.Job instance at 0x7f11c68335a0>,31,16,[5 5],32,-1,48,-1,32
1,<environment.Job instance at 0x7f11c60077d0>,34,15,[7 4],35,-1,50,-1,35
1,<environment.Job instance at 0x7f11c60073c0>,35,1,[9 5],36,-1,37,-1,36
1,<environment.Job instance at 0x7f11c56dfcd0>,37,17,[4 9],38,-1,55,-1,38
1,<environment.Job instance at 0x7f11c5ccc690>,69,15,[2 5],70,-1,200,-1,185
1,<environment.Job instance at 0x7f11c5ccc820>,72,2,[1 8],73,-1,189,-1,187
1,<environment.Job instance at 0x7f11c5978230>,76,22,[4 9],77,-1,209,-1,187
1,<environment.Job instance at 0x7f11c56dfbe0>,40,23,[5 8],41,-1,211,-1,188
1,<environment.Job instance at 0x7f11c5ccc3c0>,73,3,[9 3],74,-1,191,-1,188
1,<environment.Job instance at 0x7f11c5978140>,78,14,[5 6],79,-1,202,-1,188
1,<environment.Job instance at 0x7f11c5a1c0f0>,80,1,[2 9],81,-1,189,-1,188
1,<environment.Job instance at 0x7f11c5a1c460>,81,1,[7 3],82,-1,189,-1,188
1,<environment.Job instance at 0x7f11c5a1cc80>,79,2,[7 3],80,-1,190,-1,188
1,<environment.Job instance at 0x7f11c6f0f410>,83,1,[2 6],84,-1,189,-1,188
1,<environment.Job instance at 0x7f11c5a1c640>,82,18,[7 3],83,-1,206,-1,188
1,<environment.Job instance at 0x7f11c5978b40>,75,17,[8 3],76,-1,206,-1,189
1,<environment.Job instance at 0x7f11c6f0fb40>,84,3,[6 2],85,-1,192,-1,189
1,<environment.Job instance at 0x7f11c6f0f550>,85,14,[8 2],86,-1,203,-1,189
1,<environment.Job instance at 0x7f11c63fc7d0>,90,15,[8 2],91,-1,204,-1,189
1,<environment.Job instance at 0x7f11c6529640>,91,16,[4 9],92,-1,206,-1,190
1,<environment.Job instance at 0x7f11c65298c0>,92,15,[9 5],93,-1,205,-1,190
1,<environment.Job instance at 0x7f11c65295a0>,93,13,[3 7],94,-1,203,-1,190
1,<environment.Job instance at 0x7f11c5ad7910>,97,13,[10  3],98,-1,203,-1,190
1,<environment.Job instance at 0x7f11c6d15d70>,98,18,[10  5],99,-1,208,-1,190
1,<environment.Job instance at 0x7f11c5ad7c80>,96,16,[ 5 10],97,-1,206,-1,190
1,<environment.Job instance at 0x7f11c6d15eb0>,100,17,[6 4],101,-1,211,-1,194
1,<environment.Job instance at 0x7f11c6d15fa0>,103,13,[8 4],104,-1,207,-1,194
1,<environment.Job instance at 0x7f11c6d15460>,106,15,[7 3],107,-1,209,-1,194
1,<environment.Job instance at 0x7f11c6d15780>,107,3,[8 4],108,-1,197,-1,194
1,<environment.Job instance at 0x7f11c57594b0>,110,14,[13  1],111,-1,208,-1,194
1,<environment.Job instance at 0x7f11c6d15550>,101,23,[9 2],102,-1,219,-1,196
1,<environment.Job instance at 0x7f11c6d15870>,109,15,[ 5 10],110,-1,211,-1,196
1,<environment.Job instance at 0x7f11c5759690>,111,12,[7 5],112,-1,210,-1,198
1,<environment.Job instance at 0x7f11c5efa690>,117,12,[ 4 10],118,-1,210,-1,198
1,<environment.Job instance at 0x7f11c6833460>,29,27,[3 5],30,-1,225,-1,198
1,<environment.Job instance at 0x7f11c63a56e0>,0,1,[13  1],1,-1,2,-1,1
1,<environment.Job instance at 0x7f11c6f48640>,13,15,[ 3 14],14,-1,38,-1,23
1,<environment.Job instance at 0x7f11c6f48b90>,18,3,[13  1],19,-1,38,-1,35
1,<environment.Job instance at 0x7f11c67e1dc0>,25,15,[14  4],26,-1,59,-1,44
1,<environment.Job instance at 0x7f11c5976460>,29,27,[3 5],30,-1,84,-1,57
1,<environment.Job instance at 0x7f11c5976a50>,28,27,[6 3],29,-1,85,-1,58
1,<environment.Job instance at 0x7f11c5976b40>,32,2,[12  2],33,-1,60,-1,58
1,<environment.Job instance at 0x7f11c5b30960>,40,23,[5 8],41,-1,111,-1,88
1,<environment.Job instance at 0x7f11c5f76f00>,47,12,[ 2 14],48,-1,125,-1,113
1,<environment.Job instance at 0x7f11c70a0fa0>,68,28,[9 5],69,-1,234,-1,206
1,<environment.Job instance at 0x7f11c70a0f00>,70,1,[11  1],71,-1,207,-1,206
1,<environment.Job instance at 0x7f11c6562320>,87,1,[ 2 12],88,-1,244,-1,243
1,<environment.Job instance at 0x7f11c62e0fa0>,101,23,[9 2],102,-1,329,-1,306
1,<environment.Job instance at 0x7f11c62e0e10>,105,25,[ 2 11],106,-1,333,-1,308
1,<environment.Job instance at 0x7f11c62e0b90>,110,14,[13  1],111,-1,340,-1,326
1,<environment.Job instance at 0x7f11c62e0af0>,113,12,[12  5],114,-1,350,-1,338
1,<environment.Job instance at 0x7f11c59fcfa0>,0,18,[3 7],1,-1,19,-1,1
1,<environment.Job instance at 0x7f11c63266e0>,10,17,[10  2],11,-1,34,-1,17
1,<environment.Job instance at 0x7f11c66d3fa0>,17,16,[5 1],18,-1,34,-1,18
1,<environment.Job instance at 0x7f11c7074320>,20,20,[ 3 10],21,-1,45,-1,25
1,<environment.Job instance at 0x7f11c66d3690>,16,17,[5 8],17,-1,48,-1,31
1,<environment.Job instance at 0x7f11c5bd53c0>,36,14,[ 3 10],37,-1,51,-1,37
1,<environment.Job instance at 0x7f11c60ce1e0>,24,16,[9 5],25,-1,55,-1,39
1,<environment.Job instance at 0x7f11c7078050>,14,22,[7 4],15,-1,75,-1,53
1,<environment.Job instance at 0x7f11c693eaa0>,42,14,[ 2 11],43,-1,67,-1,53
1,<environment.Job instance at 0x7f11c66d3b40>,22,14,[11  5],23,-1,69,-1,55
1,<environment.Job instance at 0x7f11c7081460>,29,18,[1 9],30,-1,73,-1,55
1,<environment.Job instance at 0x7f11c692e6e0>,48,14,[7 1],49,-1,69,-1,55
1,<environment.Job instance at 0x7f11c692e0f0>,46,13,[9 1],47,-1,68,-1,55
1,<environment.Job instance at 0x7f11c692e5f0>,52,17,[9 3],53,-1,73,-1,56
1,<environment.Job instance at 0x7f11c693ec80>,44,16,[9 1],45,-1,107,-1,91
1,<environment.Job instance at 0x7f11c6bf9aa0>,9,13,[ 5 11],10,-1,137,-1,124
1,<environment.Job instance at 0x7f11c693ac30>,67,17,[10  4],68,-1,141,-1,124
1,<environment.Job instance at 0x7f11c694a4b0>,73,23,[5 6],74,-1,148,-1,125
1,<environment.Job instance at 0x7f11c694a460>,76,16,[10  2],77,-1,142,-1,126
1,<environment.Job instance at 0x7f11c694a820>,79,17,[10  1],80,-1,143,-1,126
1,<environment.Job instance at 0x7f11c694a690>,82,14,[9 2],83,-1,156,-1,142
1,<environment.Job instance at 0x7f11c694afa0>,88,15,[5 3],89,-1,157,-1,142
1,<environment.Job instance at 0x7f11c694ad70>,89,15,[4 9],90,-1,157,-1,142
1,<environment.Job instance at 0x7f11c694aaa0>,83,1,[14  1],84,-1,143,-1,142
1,<environment.Job instance at 0x7f11c6a663c0>,91,17,[9 4],92,-1,161,-1,144
1,<environment.Job instance at 0x7f11c6a665f0>,95,16,[3 7],96,-1,161,-1,145
1,<environment.Job instance at 0x7f11c6a66820>,97,18,[10  3],98,-1,163,-1,145
1,<environment.Job instance at 0x7f11c693acd0>,68,17,[9 3],69,-1,210,-1,193
1,<environment.Job instance at 0x7f11c6a66f50>,107,18,[3 6],108,-1,214,-1,196
1,<environment.Job instance at 0x7f11c6a8f190>,110,28,[8 5],111,-1,224,-1,196
1,<environment.Job instance at 0x7f11c6a8f690>,116,17,[9 4],117,-1,227,-1,210
1,<environment.Job instance at 0x7f11c60ce370>,2,22,[ 4 11],3,-1,25,-1,3
1,<environment.Job instance at 0x7f11c70815a0>,6,15,[13  2],7,-1,22,-1,7
1,<environment.Job instance at 0x7f11c68b7320>,9,13,[ 5 11],10,-1,23,-1,10
1,<environment.Job instance at 0x7f11c693a5a0>,13,3,[ 3 14],14,-1,22,-1,19
1,<environment.Job instance at 0x7f11c6a66280>,18,17,[14  2],19,-1,39,-1,22
1,<environment.Job instance at 0x7f11c6a8ffa0>,22,14,[11  5],23,-1,52,-1,38
1,<environment.Job instance at 0x7f11c62e0a00>,37,1,[12  4],38,-1,68,-1,67
1,<environment.Job instance at 0x7f11c62e0320>,42,14,[ 2 11],43,-1,101,-1,87
1,<environment.Job instance at 0x7f11c6a4c9b0>,45,13,[ 3 14],46,-1,102,-1,89
1,<environment.Job instance at 0x7f11cf61c460>,61,1,[12  1],62,-1,142,-1,141
1,<environment.Job instance at 0x7f11c70a0320>,63,3,[ 3 12],64,-1,145,-1,142
1,<environment.Job instance at 0x7f11c5d19280>,73,23,[5 6],74,-1,230,-1,207
1,<environment.Job instance at 0x7f11c5ecf500>,80,2,[13  2],81,-1,216,-1,214
1,<environment.Job instance at 0x7f11c5f81870>,83,1,[14  1],84,-1,220,-1,219
1,<environment.Job instance at 0x7f11c6566e60>,98,2,[ 4 11],99,-1,277,-1,275
1,<environment.Job instance at 0x7f11c5976d20>,100,12,[ 1 14],101,-1,293,-1,281
1,<environment.Job instance at 0x7f11c5976fa0>,102,2,[ 1 14],103,-1,290,-1,288
1,<environment.Job instance at 0x7f11c6e34b90>,104,24,[4 8],105,-1,319,-1,295
1,<environment.Job instance at 0x7f11c6e34af0>,106,23,[9 2],107,-1,327,-1,304
1,<environment.Job instance at 0x7f11c59ff4b0>,109,27,[ 5 10],110,-1,352,-1,325
1,<environment.Job instance at 0x7f11c59ffd20>,110,28,[8 5],111,-1,363,-1,335
1,<environment.Job instance at 0x7f11c6f48d70>,113,17,[ 5 12],114,-1,352,-1,335
1,<environment.Job instance at 0x7f11c6f483c0>,114,18,[ 4 13],115,-1,353,-1,335
1,<environment.Job instance at 0x7fb652d51af0>,2,22,[4 8],3,-1,25,-1,3
1,<environment.Job instance at 0x7fb652d54050>,9,18,[11  5],10,-1,28,-1,10
1,<environment.Job instance at 0x7fb652d54140>,11,15,[4 8],12,-1,27,-1,12
1,<environment.Job instance at 0x7fb652d54280>,13,18,[ 4 10],14,-1,32,-1,14
1,<environment.Job instance at 0x7fb652d51e60>,15,18,[2 8],16,-1,35,-1,17
1,<environment.Job instance at 0x7fb652d54f50>,24,18,[2 6],25,-1,44,-1,26
1,<environment.Job instance at 0x7fb652d570a0>,27,15,[8 4],28,-1,46,-1,31
1,<environment.Job instance at 0x7fb652d54d20>,23,27,[1 6],24,-1,59,-1,32
1,<environment.Job instance at 0x7fb652d57370>,30,14,[5 2],31,-1,46,-1,32
1,<environment.Job instance at 0x7fb652d545a0>,16,16,[3 5],17,-1,52,-1,36
1,<environment.Job instance at 0x7fb652d57640>,33,14,[5 5],34,-1,51,-1,37
1,<environment.Job instance at 0x7fb652d57780>,35,15,[9 5],36,-1,52,-1,37
1,<environment.Job instance at 0x7fb652d57c80>,40,15,[10  3],41,-1,59,-1,44
1,<environment.Job instance at 0x7fb652d571e0>,29,12,[5 4],30,-1,62,-1,50
1,<environment.Job instance at 0x7fb652d57f50>,43,18,[5 5],44,-1,68,-1,50
1,<environment.Job instance at 0x7fb652d59230>,46,17,[12  2],47,-1,67,-1,50
1,<environment.Job instance at 0x7fb652d593c0>,48,15,[10  1],49,-1,65,-1,50
1,<environment.Job instance at 0x7fb652d576e0>,34,24,[1 8],35,-1,74,-1,50
1,<environment.Job instance at 0x7fb652d59370>,49,16,[2 5],50,-1,66,-1,50
1,<environment.Job instance at 0x7fb652d599b0>,53,17,[5 7],54,-1,71,-1,54
1,<environment.Job instance at 0x7fb652d59be0>,56,17,[8 5],57,-1,75,-1,58
1,<environment.Job instance at 0x7fb652d57230>,28,23,[10  4],29,-1,82,-1,59
1,<environment.Job instance at 0x7fb652d59c80>,57,18,[2 8],58,-1,77,-1,59
1,<environment.Job instance at 0x7fb652d5c1e0>,62,22,[6 4],63,-1,85,-1,63
1,<environment.Job instance at 0x7fb652d5c190>,64,18,[2 9],65,-1,83,-1,65
1,<environment.Job instance at 0x7fb652d5c550>,65,20,[2 6],66,-1,86,-1,66
1,<environment.Job instance at 0x7fb652d59dc0>,59,17,[1 6],60,-1,101,-1,84
1,<environment.Job instance at 0x7fb652d57320>,36,13,[ 3 14],37,-1,97,-1,84
1,<environment.Job instance at 0x7fb652d600a0>,78,12,[10  2],79,-1,96,-1,84
1,<environment.Job instance at 0x7fb652d60230>,79,13,[9 4],80,-1,97,-1,84
1,<environment.Job instance at 0x7fb652d601e0>,80,14,[2 6],81,-1,98,-1,84
1,<environment.Job instance at 0x7fb652d600f0>,81,15,[5 9],82,-1,99,-1,84
1,<environment.Job instance at 0x7fb652d60320>,82,16,[ 4 10],83,-1,100,-1,84
1,<environment.Job instance at 0x7fb652d60460>,83,20,[7 1],84,-1,105,-1,85
1,<environment.Job instance at 0x7fb652d5cf00>,77,13,[8 5],78,-1,98,-1,85
1,<environment.Job instance at 0x7fb652d5cc80>,76,19,[4 8],77,-1,111,-1,92
1,<environment.Job instance at 0x7fb652d59640>,50,16,[12  2],51,-1,108,-1,92
1,<environment.Job instance at 0x7fb652d60550>,85,17,[3 9],86,-1,109,-1,92
1,<environment.Job instance at 0x7fb652d5c640>,67,27,[ 1 10],68,-1,119,-1,92
1,<environment.Job instance at 0x7fb652d604b0>,86,18,[9 2],87,-1,110,-1,92
1,<environment.Job instance at 0x7fb652d60640>,84,18,[3 7],85,-1,110,-1,92
1,<environment.Job instance at 0x7fb652d60d20>,92,20,[1 5],93,-1,113,-1,93
1,<environment.Job instance at 0x7fb652d9d960>,95,15,[5 7],96,-1,111,-1,96
1,<environment.Job instance at 0x7fb652d48cd0>,100,18,[2 7],101,-1,120,-1,102
1,<environment.Job instance at 0x7fb652d48870>,102,16,[3 9],103,-1,119,-1,103
1,<environment.Job instance at 0x7fb652d96190>,101,18,[ 1 10],102,-1,131,-1,113
1,<environment.Job instance at 0x7fb652d48550>,107,17,[9 3],108,-1,130,-1,113
1,<environment.Job instance at 0x7fb652d48780>,106,15,[11  1],107,-1,128,-1,113
1,<environment.Job instance at 0x7fb652df4b40>,111,26,[ 5 10],112,-1,140,-1,114
1,<environment.Job instance at 0x7fb652d48e60>,99,18,[12  5],100,-1,132,-1,114
1,<environment.Job instance at 0x7fb652e17050>,113,15,[6 1],114,-1,129,-1,114
1,<environment.Job instance at 0x7fb652d60820>,89,14,[5 3],90,-1,129,-1,115
1,<environment.Job instance at 0x7fb652e5f320>,115,16,[7 5],116,-1,132,-1,116
1,<environment.Job instance at 0x7fb652d48c80>,104,15,[1 9],105,-1,132,-1,117
1,<environment.Job instance at 0x7fb652ed7be0>,119,20,[2 6],120,-1,140,-1,120
1,<environment.Job instance at 0x7fb652d54640>,1,22,[11  3],2,-1,24,-1,2
1,<environment.Job instance at 0x7fb652d59050>,9,18,[11  5],10,-1,32,-1,14
1,<environment.Job instance at 0x7fb652d592d0>,12,26,[ 1 10],13,-1,82,-1,56
1,<environment.Job instance at 0x7fb652d74e60>,23,27,[1 6],24,-1,87,-1,60
1,<environment.Job instance at 0x7fb652d51d70>,28,23,[10  4],29,-1,97,-1,74
1,<environment.Job instance at 0x7fb652e016e0>,34,24,[1 8],35,-1,117,-1,93
1,<environment.Job instance at 0x7fb652e01e60>,36,13,[ 3 14],37,-1,106,-1,93
1,<environment.Job instance at 0x7fb652e5cd20>,46,17,[12  2],47,-1,134,-1,117
1,<environment.Job instance at 0x7fb652e5ca50>,50,16,[12  2],51,-1,146,-1,130
1,<environment.Job instance at 0x7fb652e00d70>,54,13,[13  1],55,-1,158,-1,145
1,<environment.Job instance at 0x7fb652dff730>,60,3,[12  3],61,-1,169,-1,166
1,<environment.Job instance at 0x7fb652d289b0>,67,27,[ 1 10],68,-1,216,-1,189
1,<environment.Job instance at 0x7fb652d8c550>,69,13,[ 3 12],70,-1,202,-1,189
1,<environment.Job instance at 0x7fb652d3f870>,75,14,[ 4 11],76,-1,215,-1,201
1,<environment.Job instance at 0x7fb652d340a0>,97,2,[ 5 11],98,-1,294,-1,292
1,<environment.Job instance at 0x7fb652d34460>,99,18,[12  5],100,-1,312,-1,294
1,<environment.Job instance at 0x7fb652d45550>,105,14,[14  5],106,-1,341,-1,327
1,<environment.Job instance at 0x7fb652d45cd0>,106,15,[11  1],107,-1,342,-1,327
1,<environment.Job instance at 0x7fb652d41730>,116,3,[ 1 12],117,-1,363,-1,360
1,<environment.Job instance at 0x7fb652d455f0>,111,26,[ 5 10],112,-1,396,-1,370
1,<environment.Job instance at 0x7fb652d60eb0>,122,3,[ 4 12],123,-1,377,-1,374
1,<environment.Job instance at 0x7fb652d60f50>,123,12,[ 4 11],124,-1,386,-1,374
1,<environment.Job instance at 0x7fb652cec280>,128,23,[ 2 14],129,-1,419,-1,396
1,<environment.Job instance at 0x7fb6527305a0>,0,15,[8 3],1,-1,18,-1,3
1,<environment.Job instance at 0x7fb65272baf0>,3,16,[ 3 10],4,-1,20,-1,4
1,<environment.Job instance at 0x7fb65272b320>,5,14,[ 2 10],6,-1,20,-1,6
1,<environment.Job instance at 0x7fb65272b780>,6,1,[9 3],7,-1,8,-1,7
1,<environment.Job instance at 0x7fb65272bb90>,7,20,[9 2],8,-1,28,-1,8
1,<environment.Job instance at 0x7fb6526efb90>,8,16,[11  2],9,-1,25,-1,9
1,<environment.Job instance at 0x7fb6526ef1e0>,9,18,[ 1 12],10,-1,28,-1,10
1,<environment.Job instance at 0x7fb6526ef960>,10,16,[2 8],11,-1,27,-1,11
1,<environment.Job instance at 0x7fb6526ef820>,11,13,[5 6],12,-1,25,-1,12
1,<environment.Job instance at 0x7fb65272abe0>,13,15,[ 1 12],14,-1,29,-1,14
1,<environment.Job instance at 0x7fb652729640>,16,17,[1 7],17,-1,34,-1,17
1,<environment.Job instance at 0x7fb65272ba00>,2,13,[ 5 10],3,-1,30,-1,17
1,<environment.Job instance at 0x7fb6527ba0f0>,21,15,[10  4],22,-1,38,-1,23
1,<environment.Job instance at 0x7fb6527ba550>,24,14,[8 4],25,-1,39,-1,25
1,<environment.Job instance at 0x7fb6527bad70>,28,14,[9 5],29,-1,43,-1,29
1,<environment.Job instance at 0x7fb6526e93c0>,22,14,[1 8],23,-1,44,-1,30
1,<environment.Job instance at 0x7fb6527be4b0>,31,15,[1 7],32,-1,47,-1,32
1,<environment.Job instance at 0x7fb6527be9b0>,38,19,[6 4],39,-1,58,-1,39
1,<environment.Job instance at 0x7fb6527c42d0>,39,14,[3 6],40,-1,54,-1,40
1,<environment.Job instance at 0x7fb6527c4500>,43,18,[6 5],44,-1,62,-1,44
1,<environment.Job instance at 0x7fb65293fd20>,45,16,[ 2 10],46,-1,62,-1,46
1,<environment.Job instance at 0x7fb6528d85f0>,47,21,[ 3 10],48,-1,69,-1,48
1,<environment.Job instance at 0x7fb65282dbe0>,49,14,[2 6],50,-1,64,-1,50
1,<environment.Job instance at 0x7fb6526f1370>,51,13,[8 5],52,-1,65,-1,52
1,<environment.Job instance at 0x7fb6526f4eb0>,52,14,[2 9],53,-1,67,-1,53
1,<environment.Job instance at 0x7fb6525e3e10>,58,21,[9 4],59,-1,80,-1,59
1,<environment.Job instance at 0x7fb6525e3c80>,59,12,[9 3],60,-1,73,-1,61
1,<environment.Job instance at 0x7fb6525ba870>,60,18,[10  3],61,-1,79,-1,61
1,<environment.Job instance at 0x7fb6525e3d70>,61,17,[10  2],62,-1,80,-1,63
1,<environment.Job instance at 0x7fb6523d2d70>,66,14,[5 5],67,-1,81,-1,67
1,<environment.Job instance at 0x7fb652c3ceb0>,70,13,[10  5],71,-1,84,-1,71
1,<environment.Job instance at 0x7fb652490e10>,71,14,[1 6],72,-1,86,-1,72
1,<environment.Job instance at 0x7fb6522e9780>,72,14,[2 7],73,-1,87,-1,73
1,<environment.Job instance at 0x7fb65235d6e0>,73,14,[7 5],74,-1,88,-1,74
1,<environment.Job instance at 0x7fb652358f50>,75,14,[10  2],76,-1,99,-1,85
1,<environment.Job instance at 0x7fb6522fdc80>,86,12,[ 3 10],87,-1,99,-1,87
1,<environment.Job instance at 0x7fb6522fd460>,87,3,[1 5],88,-1,91,-1,88
1,<environment.Job instance at 0x7fb6522fdb40>,88,1,[10  5],89,-1,90,-1,89
1,<environment.Job instance at 0x7fb6522fdaa0>,89,1,[ 2 10],90,-1,91,-1,90
1,<environment.Job instance at 0x7fb6522fdd20>,90,18,[4 5],91,-1,109,-1,91
1,<environment.Job instance at 0x7fb6522fde60>,91,18,[2 8],92,-1,110,-1,92
1,<environment.Job instance at 0x7fb6522fe460>,84,16,[7 2],85,-1,108,-1,92
1,<environment.Job instance at 0x7fb6522fd140>,94,16,[9 4],95,-1,113,-1,97
1,<environment.Job instance at 0x7fb652300280>,97,16,[9 2],98,-1,114,-1,98
1,<environment.Job instance at 0x7fb652300320>,98,15,[7 5],99,-1,114,-1,99
1,<environment.Job instance at 0x7fb652300050>,96,14,[10  1],97,-1,113,-1,99
1,<environment.Job instance at 0x7fb652300500>,102,20,[1 7],103,-1,123,-1,103
1,<environment.Job instance at 0x7fb652301370>,106,19,[2 7],107,-1,127,-1,108
1,<environment.Job instance at 0x7fb652301460>,108,18,[6 3],109,-1,127,-1,109
1,<environment.Job instance at 0x7fb65242e820>,118,18,[4 6],119,-1,140,-1,122
1,<environment.Job instance at 0x7fb6522fb7d0>,110,24,[ 1 10],111,-1,148,-1,124
1,<environment.Job instance at 0x7fb652364960>,121,27,[4 7],122,-1,151,-1,124
1,<environment.Job instance at 0x7fb652364410>,122,26,[8 4],123,-1,150,-1,124
1,<environment.Job instance at 0x7fb6522fba50>,114,16,[7 5],115,-1,140,-1,124
1,<environment.Job instance at 0x7fb6522fbb40>,113,24,[7 4],114,-1,155,-1,131
1,<environment.Job instance at 0x7fb652387960>,127,17,[5 2],128,-1,149,-1,132
1,<environment.Job instance at 0x7fb65239ff00>,8,16,[11  2],9,-1,32,-1,16
1,<environment.Job instance at 0x7fb677b270f0>,9,18,[ 1 12],10,-1,34,-1,16
1,<environment.Job instance at 0x7fb6522fd280>,13,15,[ 1 12],14,-1,32,-1,17
1,<environment.Job instance at 0x7fb652300960>,15,3,[ 4 13],16,-1,22,-1,19
1,<environment.Job instance at 0x7fb6522fb9b0>,17,1,[ 1 14],18,-1,21,-1,20
1,<environment.Job instance at 0x7fb652d59690>,30,3,[13  3],31,-1,70,-1,67
1,<environment.Job instance at 0x7fb65c387460>,35,13,[ 1 14],36,-1,85,-1,72
1,<environment.Job instance at 0x7fb652513550>,46,2,[11  5],47,-1,95,-1,93
1,<environment.Job instance at 0x7fb652966a00>,48,3,[14  4],49,-1,103,-1,100
1,<environment.Job instance at 0x7fb652561320>,68,12,[14  4],69,-1,176,-1,164
1,<environment.Job instance at 0x7fb652502d20>,78,2,[13  1],79,-1,207,-1,205
1,<environment.Job instance at 0x7fb65260d820>,81,3,[13  5],82,-1,211,-1,208
1,<environment.Job instance at 0x7fb6526320f0>,82,2,[ 1 12],83,-1,210,-1,208
1,<environment.Job instance at 0x7fb6524ac550>,92,1,[ 4 13],93,-1,244,-1,243
1,<environment.Job instance at 0x7fb6525faf50>,93,14,[11  3],94,-1,257,-1,243
1,<environment.Job instance at 0x7fb6524c4910>,110,24,[ 1 10],111,-1,340,-1,316
1,<environment.Job instance at 0x7fb652539780>,113,24,[7 4],114,-1,347,-1,323
1,<environment.Job instance at 0x7fb65262f3c0>,115,3,[12  3],116,-1,326,-1,323
1,<environment.Job instance at 0x7fb6524ca5a0>,121,27,[4 7],122,-1,366,-1,339
1,<environment.Job instance at 0x7fb6524d0870>,122,26,[8 4],123,-1,365,-1,339
1,<environment.Job instance at 0x7fb6524d6320>,125,16,[14  1],126,-1,355,-1,339
1,<environment.Job instance at 0x7fb652478aa0>,7,13,[9 2],8,-1,22,-1,9
1,<environment.Job instance at 0x7fb6524785a0>,10,17,[2 6],11,-1,28,-1,11
1,<environment.Job instance at 0x7fb6524786e0>,11,15,[8 4],12,-1,27,-1,12
1,<environment.Job instance at 0x7fb652476320>,16,28,[6 5],17,-1,45,-1,17
1,<environment.Job instance at 0x7fb652476fa0>,17,18,[5 9],18,-1,36,-1,18
1,<environment.Job instance at 0x7fb652476820>,24,15,[10  4],25,-1,40,-1,25
1,<environment.Job instance at 0x7fb65246ea50>,30,18,[6 1],31,-1,52,-1,34
1,<environment.Job instance at 0x7fb65246a8c0>,39,16,[9 4],40,-1,56,-1,40
1,<environment.Job instance at 0x7fb65247d2d0>,8,15,[3 6],9,-1,60,-1,45
1,<environment.Job instance at 0x7fb65246a230>,42,25,[6 3],43,-1,70,-1,45
1,<environment.Job instance at 0x7fb65246a280>,40,15,[8 2],41,-1,61,-1,46
1,<environment.Job instance at 0x7fb6524661e0>,48,17,[3 6],49,-1,66,-1,49
1,<environment.Job instance at 0x7fb652466e60>,49,15,[ 5 10],50,-1,65,-1,50
1,<environment.Job instance at 0x7fb65246a5a0>,44,17,[9 4],45,-1,69,-1,52
1,<environment.Job instance at 0x7fb652466280>,53,20,[2 6],54,-1,75,-1,55
1,<environment.Job instance at 0x7fb652478e10>,0,25,[ 3 10],1,-1,26,-1,1
1,<environment.Job instance at 0x7fb65c4aa050>,13,23,[10  1],14,-1,40,-1,17
1,<environment.Job instance at 0x7fb652430d20>,16,28,[6 5],17,-1,59,-1,31
1,<environment.Job instance at 0x7fb65257ad70>,21,15,[14  1],22,-1,46,-1,31
1,<environment.Job instance at 0x7fb6524ebaf0>,25,18,[11  3],26,-1,53,-1,35
1,<environment.Job instance at 0x7fb6524eb730>,29,28,[5 3],30,-1,70,-1,42
1,<environment.Job instance at 0x7fb65c4bad20>,42,25,[6 3],43,-1,109,-1,84
1,<environment.Job instance at 0x7fb65248dd20>,59,18,[13  1],60,-1,157,-1,139
1,<environment.Job instance at 0x7fb65248dfa0>,62,3,[ 3 11],63,-1,150,-1,147
1,<environment.Job instance at 0x7fb652358550>,70,24,[2 8],71,-1,201,-1,177
1,<environment.Job instance at 0x7fb652b98cd0>,71,24,[9 1],72,-1,201,-1,177
1,<environment.Job instance at 0x7fb652358960>,73,24,[10  5],74,-1,204,-1,180
1,<environment.Job instance at 0x7fb652355410>,74,23,[10  2],75,-1,203,-1,180
1,<environment.Job instance at 0x7fb6523555f0>,75,15,[ 1 11],76,-1,195,-1,180
1,<environment.Job instance at 0x7fb652b1b6e0>,87,15,[ 3 12],88,-1,241,-1,226
1,<environment.Job instance at 0x7fb6523f3870>,100,27,[ 5 10],101,-1,304,-1,277
1,<environment.Job instance at 0x7fb6523f5460>,106,25,[ 5 10],107,-1,332,-1,307
1,<environment.Job instance at 0x7fb652352d20>,122,17,[12  4],123,-1,351,-1,334
1,<environment.Job instance at 0x7fb652619140>,0,18,[9 5],1,-1,19,-1,1
1,<environment.Job instance at 0x7fb653862820>,9,17,[8 1],10,-1,27,-1,10
1,<environment.Job instance at 0x7fb653862550>,11,17,[2 6],12,-1,29,-1,12
1,<environment.Job instance at 0x7fb653862f50>,12,19,[8 2],13,-1,32,-1,13
1,<environment.Job instance at 0x7fb653862280>,18,14,[ 2 10],19,-1,34,-1,20
1,<environment.Job instance at 0x7fb653147550>,19,17,[9 1],20,-1,37,-1,20
1,<environment.Job instance at 0x7fb6538621e0>,20,18,[3 5],21,-1,39,-1,21
1,<environment.Job instance at 0x7fb65386bc30>,28,14,[4 6],29,-1,43,-1,29
1,<environment.Job instance at 0x7fb65386bd20>,29,15,[10  2],30,-1,45,-1,30
1,<environment.Job instance at 0x7fb65386b780>,30,13,[5 6],31,-1,45,-1,32
1,<environment.Job instance at 0x7fb65386b910>,32,12,[5 5],33,-1,45,-1,33
1,<environment.Job instance at 0x7fb65386bf50>,33,13,[4 9],34,-1,47,-1,34
1,<environment.Job instance at 0x7fb65386b2d0>,35,14,[7 4],36,-1,50,-1,36
1,<environment.Job instance at 0x7fb652b9c4b0>,40,16,[10  2],41,-1,58,-1,42
1,<environment.Job instance at 0x7fb6522b0690>,44,21,[7 2],45,-1,66,-1,45
1,<environment.Job instance at 0x7fb6522b0dc0>,45,12,[ 1 10],46,-1,58,-1,46
1,<environment.Job instance at 0x7fb652bbe1e0>,48,16,[6 3],49,-1,65,-1,49
1,<environment.Job instance at 0x7fb652bbe3c0>,49,14,[5 7],50,-1,64,-1,50
1,<environment.Job instance at 0x7fb652bbe230>,50,18,[4 7],51,-1,69,-1,51
1,<environment.Job instance at 0x7fb652bbe500>,52,14,[ 1 11],53,-1,67,-1,53
1,<environment.Job instance at 0x7fb652bbe6e0>,53,14,[2 7],54,-1,68,-1,54
1,<environment.Job instance at 0x7fb653879d70>,58,15,[8 5],59,-1,74,-1,59
1,<environment.Job instance at 0x7fb65247dc80>,59,27,[1 5],60,-1,87,-1,60
1,<environment.Job instance at 0x7fb652a2c050>,66,18,[4 6],67,-1,85,-1,67
1,<environment.Job instance at 0x7fb6531720a0>,68,17,[7 4],69,-1,86,-1,69
1,<environment.Job instance at 0x7fb6526c8550>,75,16,[6 3],76,-1,92,-1,76
1,<environment.Job instance at 0x7fb6526c8dc0>,76,25,[3 8],77,-1,102,-1,77
1,<environment.Job instance at 0x7fb65313f2d0>,82,24,[ 3 10],83,-1,140,-1,116
1,<environment.Job instance at 0x7fb6531648c0>,94,16,[10  3],95,-1,132,-1,116
1,<environment.Job instance at 0x7fb6526d4780>,93,12,[1 8],94,-1,128,-1,116
1,<environment.Job instance at 0x7fb652bbf780>,97,13,[6 4],98,-1,130,-1,117
1,<environment.Job instance at 0x7fb652bbfcd0>,98,14,[10  3],99,-1,131,-1,117
1,<environment.Job instance at 0x7fb652b9ca50>,41,13,[4 5],42,-1,130,-1,117
1,<environment.Job instance at 0x7fb652bbfc30>,100,19,[1 5],101,-1,136,-1,117
1,<environment.Job instance at 0x7fb652bbfd70>,101,18,[2 9],102,-1,135,-1,117
1,<environment.Job instance at 0x7fb6526d4aa0>,88,27,[1 7],89,-1,144,-1,117
1,<environment.Job instance at 0x7fb652bbf4b0>,102,18,[10  4],103,-1,135,-1,117
1,<environment.Job instance at 0x7fb652bbfaf0>,103,13,[6 5],104,-1,136,-1,123
1,<environment.Job instance at 0x7fb6526be1e0>,107,18,[5 1],108,-1,141,-1,123
1,<environment.Job instance at 0x7fb6526becd0>,113,18,[5 9],114,-1,180,-1,162
1,<environment.Job instance at 0x7fb6526bd550>,119,19,[9 1],120,-1,183,-1,164
1,<environment.Job instance at 0x7fb6526bdb40>,121,16,[6 5],122,-1,180,-1,164
1,<environment.Job instance at 0x7fb65313f370>,84,17,[8 5],85,-1,181,-1,164
1,<environment.Job instance at 0x7fb652b91af0>,5,2,[ 4 11],6,-1,8,-1,6
1,<environment.Job instance at 0x7fb6526c8370>,13,2,[ 2 14],14,-1,37,-1,35
1,<environment.Job instance at 0x7fb65298bb40>,14,17,[ 5 14],15,-1,52,-1,35
1,<environment.Job instance at 0x7fb652589280>,16,2,[11  3],17,-1,37,-1,35
1,<environment.Job instance at 0x7fb6526c0be0>,17,2,[12  2],18,-1,37,-1,35
1,<environment.Job instance at 0x7fb6526bd320>,22,2,[12  5],23,-1,41,-1,39
1,<environment.Job instance at 0x7fb6526dd460>,24,1,[14  4],25,-1,54,-1,53
1,<environment.Job instance at 0x7fb652369a50>,43,1,[ 5 12],44,-1,117,-1,116
1,<environment.Job instance at 0x7fb6523f5d20>,52,14,[ 1 11],53,-1,158,-1,144
1,<environment.Job instance at 0x7fb652383050>,54,3,[14  4],55,-1,149,-1,146
1,<environment.Job instance at 0x7fb652383af0>,56,2,[13  4],57,-1,162,-1,160
1,<environment.Job instance at 0x7fb6523f3500>,59,27,[1 5],60,-1,190,-1,163
1,<environment.Job instance at 0x7fb652acc280>,65,14,[ 5 12],66,-1,193,-1,179
1,<environment.Job instance at 0x7fb652b1b5f0>,67,19,[14  4],68,-1,199,-1,180
1,<environment.Job instance at 0x7fb652b1b230>,69,14,[ 5 11],70,-1,196,-1,182
1,<environment.Job instance at 0x7fb6523555f0>,76,25,[3 8],77,-1,239,-1,214
1,<environment.Job instance at 0x7fb6523558c0>,78,3,[ 5 14],79,-1,217,-1,214
1,<environment.Job instance at 0x7fb652355e60>,79,27,[9 3],80,-1,243,-1,216
1,<environment.Job instance at 0x7fb652358960>,82,24,[ 3 10],83,-1,245,-1,221
1,<environment.Job instance at 0x7fb6531eb6e0>,87,12,[ 2 12],88,-1,243,-1,231
1,<environment.Job instance at 0x7fb65323b460>,88,27,[1 7],89,-1,260,-1,233
1,<environment.Job instance at 0x7fb677b270f0>,105,2,[14  5],106,-1,298,-1,296
1,<environment.Job instance at 0x7fb6524eb410>,123,27,[1 8],124,-1,392,-1,365
1,<environment.Job instance at 0x7fb652deee10>,1,18,[8 4],2,-1,20,-1,2
1,<environment.Job instance at 0x7fb652dee780>,4,17,[3 9],5,-1,22,-1,5
1,<environment.Job instance at 0x7fb652deed70>,5,13,[10  4],6,-1,20,-1,7
1,<environment.Job instance at 0x7fb652bdda50>,7,22,[1 7],8,-1,30,-1,8
1,<environment.Job instance at 0x7fb652bddb90>,9,15,[7 1],10,-1,25,-1,10
1,<environment.Job instance at 0x7fb652bddd70>,10,14,[6 4],11,-1,25,-1,11
1,<environment.Job instance at 0x7fb652bddd20>,11,18,[3 6],12,-1,30,-1,12
1,<environment.Job instance at 0x7fb652bddaa0>,12,1,[9 3],13,-1,14,-1,13
1,<environment.Job instance at 0x7fb65388f730>,6,16,[5 5],7,-1,30,-1,14
1,<environment.Job instance at 0x7fb652bddb40>,15,25,[6 3],16,-1,41,-1,16
1,<environment.Job instance at 0x7fb652bdd140>,18,16,[8 5],19,-1,35,-1,19
1,<environment.Job instance at 0x7fb652bdd550>,19,18,[7 5],20,-1,38,-1,20
1,<environment.Job instance at 0x7fb653010af0>,22,16,[9 2],23,-1,40,-1,24
1,<environment.Job instance at 0x7fb6530107d0>,24,1,[5 7],25,-1,26,-1,25
1,<environment.Job instance at 0x7fb653010140>,25,18,[7 5],26,-1,44,-1,26
1,<environment.Job instance at 0x7fb652bdd050>,23,15,[6 3],24,-1,41,-1,26
1,<environment.Job instance at 0x7fb653010dc0>,28,17,[10  3],29,-1,47,-1,30
1,<environment.Job instance at 0x7fb653010320>,30,1,[6 3],31,-1,32,-1,31
1,<environment.Job instance at 0x7fb653010fa0>,31,22,[ 1 10],32,-1,54,-1,32
1,<environment.Job instance at 0x7fb6530106e0>,32,18,[5 1],33,-1,51,-1,33
1,<environment.Job instance at 0x7fb6530104b0>,33,2,[5 6],34,-1,36,-1,34
1,<environment.Job instance at 0x7fb653010050>,34,2,[2 5],35,-1,37,-1,35
1,<environment.Job instance at 0x7fb653010a50>,35,3,[6 5],36,-1,39,-1,36
1,<environment.Job instance at 0x7fb6530109b0>,36,3,[8 2],37,-1,40,-1,37
1,<environment.Job instance at 0x7fb653010a00>,37,13,[7 3],38,-1,51,-1,38
1,<environment.Job instance at 0x7fb653010460>,38,20,[6 2],39,-1,59,-1,39
1,<environment.Job instance at 0x7fb652e6e870>,39,15,[ 1 10],40,-1,55,-1,40
1,<environment.Job instance at 0x7fb652e6e0a0>,40,14,[3 6],41,-1,55,-1,41
1,<environment.Job instance at 0x7fb652e6e8c0>,41,1,[8 5],42,-1,43,-1,42
1,<environment.Job instance at 0x7fb652e6e370>,42,15,[1 6],43,-1,58,-1,43
1,<environment.Job instance at 0x7fb652e6e0f0>,43,2,[5 5],44,-1,46,-1,44
1,<environment.Job instance at 0x7fb652e6e5f0>,44,12,[4 6],45,-1,57,-1,45
1,<environment.Job instance at 0x7fb652e6ed70>,45,17,[7 1],46,-1,63,-1,46
1,<environment.Job instance at 0x7fb652e6e500>,46,13,[11  1],47,-1,60,-1,47
1,<environment.Job instance at 0x7fb653109410>,47,18,[1 7],48,-1,66,-1,48
1,<environment.Job instance at 0x7fb653109aa0>,48,12,[ 5 12],49,-1,61,-1,49
1,<environment.Job instance at 0x7fb653109be0>,49,14,[10  1],50,-1,64,-1,50
1,<environment.Job instance at 0x7fb6531090f0>,50,15,[1 6],51,-1,66,-1,51
1,<environment.Job instance at 0x7fb6531099b0>,51,14,[10  4],52,-1,66,-1,52
1,<environment.Job instance at 0x7fb653109a00>,52,18,[5 5],53,-1,71,-1,53
1,<environment.Job instance at 0x7fb653109870>,53,2,[10  5],54,-1,56,-1,54
1,<environment.Job instance at 0x7fb653109280>,54,12,[8 4],55,-1,67,-1,55
1,<environment.Job instance at 0x7fb653109dc0>,55,15,[7 4],56,-1,71,-1,56
1,<environment.Job instance at 0x7fb653109d20>,56,3,[8 1],57,-1,60,-1,57
1,<environment.Job instance at 0x7fb653109460>,57,14,[6 2],58,-1,72,-1,58
1,<environment.Job instance at 0x7fb653109910>,58,21,[5 8],59,-1,80,-1,59
1,<environment.Job instance at 0x7fb653109f00>,59,17,[7 2],60,-1,77,-1,60
1,<environment.Job instance at 0x7fb6531094b0>,60,12,[8 1],61,-1,73,-1,61
1,<environment.Job instance at 0x7fb653109e10>,61,28,[2 8],62,-1,90,-1,62
1,<environment.Job instance at 0x7fb653109640>,62,18,[5 1],63,-1,81,-1,63
1,<environment.Job instance at 0x7fb653109050>,63,27,[9 3],64,-1,91,-1,64
1,<environment.Job instance at 0x7fb652e79500>,64,12,[6 5],65,-1,77,-1,65
1,<environment.Job instance at 0x7fb652e79f50>,65,2,[4 7],66,-1,68,-1,66
1,<environment.Job instance at 0x7fb652e79820>,66,28,[1 7],67,-1,95,-1,67
1,<environment.Job instance at 0x7fb652e795a0>,67,12,[ 4 10],68,-1,80,-1,68
1,<environment.Job instance at 0x7fb652e79410>,68,1,[5 7],69,-1,70,-1,69
1,<environment.Job instance at 0x7fb652e79190>,69,2,[ 4 11],70,-1,72,-1,70
1,<environment.Job instance at 0x7fb652e79be0>,70,3,[4 8],71,-1,74,-1,71
1,<environment.Job instance at 0x7fb652e799b0>,71,1,[10  2],72,-1,73,-1,72
1,<environment.Job instance at 0x7fb652e79460>,72,3,[9 1],73,-1,76,-1,73
1,<environment.Job instance at 0x7fb652e79eb0>,73,2,[ 4 10],74,-1,76,-1,74
1,<environment.Job instance at 0x7fb652e79b40>,74,3,[11  1],75,-1,78,-1,75
1,<environment.Job instance at 0x7fb652e79640>,75,1,[8 2],76,-1,77,-1,76
1,<environment.Job instance at 0x7fb652e79370>,76,28,[9 2],77,-1,105,-1,77
1,<environment.Job instance at 0x7fb652e79730>,77,2,[8 4],78,-1,80,-1,78
1,<environment.Job instance at 0x7fb652e79960>,78,1,[6 3],79,-1,80,-1,79
1,<environment.Job instance at 0x7fb652e79c30>,79,17,[1 5],80,-1,97,-1,80
1,<environment.Job instance at 0x7fb652e79f00>,80,3,[9 5],81,-1,84,-1,81
1,<environment.Job instance at 0x7fb652e79d20>,81,13,[1 7],82,-1,95,-1,82
1,<environment.Job instance at 0x7fb652e796e0>,82,13,[4 8],83,-1,96,-1,83
1,<environment.Job instance at 0x7fb652e79870>,83,1,[6 2],84,-1,85,-1,84
1,<environment.Job instance at 0x7fb652e797d0>,84,2,[4 6],85,-1,87,-1,85
1,<environment.Job instance at 0x7fb652ac8190>,85,3,[8 5],86,-1,89,-1,86
1,<environment.Job instance at 0x7fb652ac8f00>,86,12,[7 1],87,-1,99,-1,87
1,<environment.Job instance at 0x7fb652ac8e60>,87,3,[ 1 12],88,-1,91,-1,88
1,<environment.Job instance at 0x7fb652ac8690>,88,15,[ 3 11],89,-1,104,-1,89
1,<environment.Job instance at 0x7fb652ac8050>,89,3,[5 1],90,-1,93,-1,90
1,<environment.Job instance at 0x7fb652ac8cd0>,90,14,[6 4],91,-1,105,-1,91
1,<environment.Job instance at 0x7fb652ac8f50>,91,1,[10  4],92,-1,93,-1,92
1,<environment.Job instance at 0x7fb652ac8b40>,92,3,[6 4],93,-1,96,-1,93
1,<environment.Job instance at 0x7fb652ac8b90>,93,3,[6 2],94,-1,97,-1,94
1,<environment.Job instance at 0x7fb652ac8a00>,94,15,[9 1],95,-1,110,-1,95
1,<environment.Job instance at 0x7fb652ac89b0>,95,15,[ 2 11],96,-1,111,-1,96
1,<environment.Job instance at 0x7fb653010d20>,29,27,[ 5 10],30,-1,123,-1,96
1,<environment.Job instance at 0x7fb653010960>,96,23,[7 4],97,-1,120,-1,97
1,<environment.Job instance at 0x7fb652de3aa0>,100,15,[9 4],101,-1,118,-1,103
1,<environment.Job instance at 0x7fb652de3410>,103,20,[5 4],104,-1,124,-1,104
1,<environment.Job instance at 0x7fb652e42050>,114,15,[10  3],115,-1,130,-1,115
1,<environment.Job instance at 0x7fb652e42cd0>,115,20,[4 7],116,-1,136,-1,116
1,<environment.Job instance at 0x7fb652e42780>,116,21,[6 5],117,-1,138,-1,117
1,<environment.Job instance at 0x7fb652e42d70>,117,13,[9 4],118,-1,131,-1,118
1,<environment.Job instance at 0x7fb652e42460>,119,17,[5 9],120,-1,137,-1,120
1,<environment.Job instance at 0x7fb652e9bfa0>,121,27,[5 1],122,-1,149,-1,122
1,<environment.Job instance at 0x7fb652e9b500>,122,21,[1 6],123,-1,144,-1,123
1,<environment.Job instance at 0x7fb652e9b2d0>,123,17,[8 5],124,-1,141,-1,124
1,<environment.Job instance at 0x7fb652e9b780>,125,16,[4 5],126,-1,142,-1,126
1,<environment.Job instance at 0x7fb653880780>,126,25,[8 3],127,-1,152,-1,127
1,<environment.Job instance at 0x7fb652e5ce60>,128,16,[ 5 10],129,-1,145,-1,129
1,<environment.Job instance at 0x7fb6524eb870>,13,3,[ 3 14],14,-1,37,-1,34
1,<environment.Job instance at 0x7fb652702280>,15,25,[6 3],16,-1,60,-1,35
1,<environment.Job instance at 0x7fb65239ff00>,20,2,[ 5 11],21,-1,52,-1,50
1,<environment.Job instance at 0x7fb6523dc0a0>,29,27,[ 5 10],30,-1,127,-1,100
1,<environment.Job instance at 0x7fb652acc280>,46,13,[11  1],47,-1,144,-1,131
1,<environment.Job instance at 0x7fb6523f3af0>,48,12,[ 5 12],49,-1,156,-1,144
1,<environment.Job instance at 0x7fb65248eaf0>,61,28,[2 8],62,-1,249,-1,221
1,<environment.Job instance at 0x7fb653884050>,63,27,[9 3],64,-1,250,-1,223
1,<environment.Job instance at 0x7fb6526b3cd0>,66,28,[1 7],67,-1,253,-1,225
1,<environment.Job instance at 0x7fb6526ae780>,69,2,[ 4 11],70,-1,239,-1,237
1,<environment.Job instance at 0x7fb6526be730>,74,3,[11  1],75,-1,245,-1,242
1,<environment.Job instance at 0x7fb6526bd190>,76,28,[9 2],77,-1,273,-1,245
1,<environment.Job instance at 0x7fb65386b960>,87,3,[ 1 12],88,-1,272,-1,269
1,<environment.Job instance at 0x7fb652b7a190>,88,15,[ 3 11],89,-1,284,-1,269
1,<environment.Job instance at 0x7fb652e48280>,95,15,[ 2 11],96,-1,304,-1,289
1,<environment.Job instance at 0x7fb652e481e0>,96,23,[7 4],97,-1,315,-1,292
1,<environment.Job instance at 0x7fb652e74fa0>,110,16,[14  3],111,-1,342,-1,326
1,<environment.Job instance at 0x7fb652e9ba50>,121,27,[5 1],122,-1,391,-1,364
1,<environment.Job instance at 0x7fb652dea910>,127,13,[13  1],128,-1,395,-1,382
1,<environment.Job instance at 0x7fb652deaa50>,126,25,[8 3],127,-1,408,-1,383
1,<environment.Job instance at 0x7fb651fe3640>,0,16,[9 2],1,-1,18,-1,2
1,<environment.Job instance at 0x7fb651fe3870>,1,19,[10  1],2,-1,21,-1,2
1,<environment.Job instance at 0x7fb65213a550>,6,25,[ 5 10],7,-1,32,-1,7
1,<environment.Job instance at 0x7fb651fd3d20>,12,18,[5 9],13,-1,31,-1,13
1,<environment.Job instance at 0x7fb651fb2280>,13,16,[6 5],14,-1,30,-1,14
1,<environment.Job instance at 0x7fb651fb2a00>,18,18,[1 9],19,-1,37,-1,19
1,<environment.Job instance at 0x7fb651fb2730>,20,15,[3 9],21,-1,36,-1,21
1,<environment.Job instance at 0x7fb651faea50>,24,17,[9 5],25,-1,42,-1,25
1,<environment.Job instance at 0x7fb651fae730>,25,16,[5 3],26,-1,42,-1,26
1,<environment.Job instance at 0x7fb6520840f0>,28,14,[9 4],29,-1,43,-1,29
1,<environment.Job instance at 0x7fb6520846e0>,29,13,[3 6],30,-1,43,-1,30
1,<environment.Job instance at 0x7fb6520841e0>,30,26,[6 3],31,-1,57,-1,31
1,<environment.Job instance at 0x7fb652084e10>,31,14,[4 6],32,-1,46,-1,32
1,<environment.Job instance at 0x7fb652084c80>,32,17,[ 2 11],33,-1,50,-1,33
1,<environment.Job instance at 0x7fb651faaa00>,35,23,[7 1],36,-1,59,-1,36
1,<environment.Job instance at 0x7fb651faac80>,37,17,[4 9],38,-1,55,-1,38
1,<environment.Job instance at 0x7fb652066780>,41,17,[10  4],42,-1,59,-1,42
1,<environment.Job instance at 0x7fb652066910>,42,14,[3 9],43,-1,57,-1,43
1,<environment.Job instance at 0x7fb652066050>,44,14,[7 4],45,-1,59,-1,45
1,<environment.Job instance at 0x7fb6520668c0>,45,18,[10  3],46,-1,64,-1,46
1,<environment.Job instance at 0x7fb652ecad70>,54,18,[4 7],55,-1,73,-1,55
1,<environment.Job instance at 0x7fb653343f50>,56,17,[5 5],57,-1,74,-1,57
1,<environment.Job instance at 0x7fb652fbc1e0>,62,17,[1 6],63,-1,80,-1,63
1,<environment.Job instance at 0x7fb652fbc730>,63,16,[4 9],64,-1,80,-1,64
1,<environment.Job instance at 0x7fb651fbde10>,68,15,[3 6],69,-1,85,-1,70
1,<environment.Job instance at 0x7fb651fbd820>,69,18,[9 5],70,-1,88,-1,70
1,<environment.Job instance at 0x7fb65213b960>,70,28,[5 6],71,-1,110,-1,82
1,<environment.Job instance at 0x7fb6533d42d0>,76,14,[13  5],77,-1,96,-1,82
1,<environment.Job instance at 0x7fb6533d46e0>,77,16,[ 5 10],78,-1,109,-1,93
1,<environment.Job instance at 0x7fb6526df1e0>,80,13,[12  5],81,-1,106,-1,93
1,<environment.Job instance at 0x7fb652f3daf0>,82,16,[9 4],83,-1,109,-1,93
1,<environment.Job instance at 0x7fb65336afa0>,75,23,[5 3],76,-1,116,-1,93
1,<environment.Job instance at 0x7fb653857870>,88,15,[ 3 13],89,-1,109,-1,94
1,<environment.Job instance at 0x7fb653857eb0>,91,16,[ 2 10],92,-1,110,-1,94
1,<environment.Job instance at 0x7fb653857320>,90,16,[5 1],91,-1,110,-1,94
1,<environment.Job instance at 0x7fb652fab640>,96,18,[ 3 13],97,-1,150,-1,132
1,<environment.Job instance at 0x7fb652fab6e0>,97,18,[10  5],98,-1,150,-1,132
1,<environment.Job instance at 0x7fb65370db90>,100,15,[ 4 10],101,-1,147,-1,132
1,<environment.Job instance at 0x7fb65370daf0>,99,1,[7 3],100,-1,133,-1,132
1,<environment.Job instance at 0x7fb653857050>,86,15,[9 5],87,-1,149,-1,134
1,<environment.Job instance at 0x7fb65336aa00>,73,28,[ 1 11],74,-1,162,-1,134
1,<environment.Job instance at 0x7fb653435140>,108,14,[1 7],109,-1,148,-1,134
1,<environment.Job instance at 0x7fb653435820>,111,18,[4 8],112,-1,152,-1,134
1,<environment.Job instance at 0x7fb653435870>,113,15,[10  4],114,-1,150,-1,135
1,<environment.Job instance at 0x7fb6538b5870>,122,18,[9 4],123,-1,184,-1,166
1,<environment.Job instance at 0x7fb6538b5320>,116,15,[ 5 10],117,-1,181,-1,166
1,<environment.Job instance at 0x7fb6538b50f0>,123,18,[ 4 10],124,-1,184,-1,166
1,<environment.Job instance at 0x7fb651fae7d0>,6,25,[ 5 10],7,-1,33,-1,8
1,<environment.Job instance at 0x7fb653504a50>,26,2,[13  5],27,-1,46,-1,44
1,<environment.Job instance at 0x7fb653388820>,30,26,[6 3],31,-1,99,-1,73
1,<environment.Job instance at 0x7fb6533739b0>,32,17,[ 2 11],33,-1,90,-1,73
1,<environment.Job instance at 0x7fb652e9ba50>,35,23,[7 1],36,-1,102,-1,79
1,<environment.Job instance at 0x7fb652e481e0>,43,12,[ 1 14],44,-1,116,-1,104
1,<environment.Job instance at 0x7fb652e48a00>,46,13,[13  3],47,-1,131,-1,118
1,<environment.Job instance at 0x7fb6531a4500>,48,1,[ 3 14],49,-1,122,-1,121
1,<environment.Job instance at 0x7fb6526b38c0>,61,14,[ 3 14],62,-1,184,-1,170
1,<environment.Job instance at 0x7fb6523f3910>,65,13,[ 1 12],66,-1,201,-1,188
1,<environment.Job instance at 0x7fb6523f34b0>,66,17,[11  2],67,-1,205,-1,188
1,<environment.Job instance at 0x7fb652accd70>,70,28,[5 6],71,-1,238,-1,210
1,<environment.Job instance at 0x7fb65c4aceb0>,73,28,[ 1 11],74,-1,238,-1,210
1,<environment.Job instance at 0x7fb652702280>,75,23,[5 3],76,-1,236,-1,213
1,<environment.Job instance at 0x7fb65248d6e0>,76,14,[13  5],77,-1,227,-1,213
1,<environment.Job instance at 0x7fb652de3190>,80,13,[12  5],81,-1,229,-1,216
1,<environment.Job instance at 0x7fb653173320>,88,15,[ 3 13],89,-1,260,-1,245
1,<environment.Job instance at 0x7fb653833910>,96,18,[ 3 13],97,-1,306,-1,288
1,<environment.Job instance at 0x7fb653833230>,107,2,[ 4 14],108,-1,324,-1,322
1,<environment.Job instance at 0x7fb6537186e0>,114,2,[ 1 12],115,-1,355,-1,353
1,<environment.Job instance at 0x7fb653718050>,120,25,[2 8],121,-1,407,-1,382
1,<environment.Job instance at 0x7fb653314c80>,124,3,[ 3 14],125,-1,398,-1,395
1,<environment.Job instance at 0x7fb65213b500>,1,16,[ 4 10],2,-1,19,-1,3
1,<environment.Job instance at 0x7fb65277c320>,4,15,[ 2 10],5,-1,21,-1,6
1,<environment.Job instance at 0x7fb65277c820>,6,18,[9 4],7,-1,25,-1,7
1,<environment.Job instance at 0x7fb652959af0>,9,16,[2 8],10,-1,26,-1,10
1,<environment.Job instance at 0x7fb652ddeeb0>,11,13,[2 8],12,-1,25,-1,12
1,<environment.Job instance at 0x7fb653065640>,12,18,[5 1],13,-1,31,-1,13
1,<environment.Job instance at 0x7fb652deb870>,13,18,[ 5 10],14,-1,32,-1,14
1,<environment.Job instance at 0x7fb652deb500>,14,20,[9 5],15,-1,35,-1,15
1,<environment.Job instance at 0x7fb652debc30>,15,17,[7 4],16,-1,33,-1,16
1,<environment.Job instance at 0x7fb652deba50>,16,18,[4 6],17,-1,35,-1,17
1,<environment.Job instance at 0x7fb652defdc0>,17,14,[5 5],18,-1,32,-1,18
1,<environment.Job instance at 0x7fb6531024b0>,19,12,[5 7],20,-1,32,-1,20
1,<environment.Job instance at 0x7fb65277ce60>,5,16,[4 6],6,-1,38,-1,22
1,<environment.Job instance at 0x7fb6524e64b0>,23,17,[10  5],24,-1,42,-1,25
1,<environment.Job instance at 0x7fb6524e6870>,24,17,[3 6],25,-1,42,-1,25
1,<environment.Job instance at 0x7fb653117140>,31,16,[2 7],32,-1,48,-1,32
1,<environment.Job instance at 0x7fb6524fd500>,32,15,[3 8],33,-1,48,-1,33
1,<environment.Job instance at 0x7fb6522484b0>,37,25,[9 4],38,-1,63,-1,38
1,<environment.Job instance at 0x7fb65309c2d0>,35,15,[9 1],36,-1,53,-1,38
1,<environment.Job instance at 0x7fb65311f2d0>,40,16,[2 8],41,-1,57,-1,41
1,<environment.Job instance at 0x7fb65311f410>,42,17,[1 7],43,-1,60,-1,43
1,<environment.Job instance at 0x7fb652237e60>,43,17,[6 4],44,-1,61,-1,44
1,<environment.Job instance at 0x7fb652237d70>,45,16,[1 6],46,-1,62,-1,46
1,<environment.Job instance at 0x7fb652239aa0>,51,18,[9 3],52,-1,73,-1,55
1,<environment.Job instance at 0x7fb65222f730>,55,3,[1 6],56,-1,59,-1,56
1,<environment.Job instance at 0x7fb65222f500>,56,22,[ 4 10],57,-1,79,-1,57
1,<environment.Job instance at 0x7fb65222f3c0>,58,16,[2 7],59,-1,75,-1,59
1,<environment.Job instance at 0x7fb652234370>,59,16,[ 3 10],60,-1,76,-1,60
1,<environment.Job instance at 0x7fb6522344b0>,61,13,[ 3 10],62,-1,75,-1,62
1,<environment.Job instance at 0x7fb652234640>,62,18,[5 8],63,-1,81,-1,63
1,<environment.Job instance at 0x7fb65222f7d0>,54,25,[7 4],55,-1,88,-1,63
1,<environment.Job instance at 0x7fb6522347d0>,65,23,[8 2],66,-1,90,-1,67
1,<environment.Job instance at 0x7fb652234b40>,70,16,[5 9],71,-1,87,-1,71
1,<environment.Job instance at 0x7fb652234f50>,71,15,[9 5],72,-1,87,-1,72
1,<environment.Job instance at 0x7fb6522536e0>,78,14,[8 1],79,-1,93,-1,79
1,<environment.Job instance at 0x7fb652253820>,79,16,[ 4 10],80,-1,96,-1,80
1,<environment.Job instance at 0x7fb652253280>,80,18,[5 8],81,-1,99,-1,81
1,<environment.Job instance at 0x7fb652253910>,81,17,[3 7],82,-1,99,-1,82
1,<environment.Job instance at 0x7fb6522539b0>,82,23,[7 1],83,-1,106,-1,83
1,<environment.Job instance at 0x7fb652253af0>,84,14,[10  1],85,-1,99,-1,85
1,<environment.Job instance at 0x7fb65223a460>,91,15,[7 5],92,-1,109,-1,94
1,<environment.Job instance at 0x7fb65223a1e0>,90,15,[4 9],91,-1,109,-1,94
1,<environment.Job instance at 0x7fb65223a7d0>,96,17,[9 3],97,-1,114,-1,97
1,<environment.Job instance at 0x7fb652234a50>,66,16,[6 1],67,-1,116,-1,100
1,<environment.Job instance at 0x7fb65223ac30>,100,15,[9 1],101,-1,119,-1,104
1,<environment.Job instance at 0x7fb65223ac80>,103,16,[ 4 10],104,-1,121,-1,105
1,<environment.Job instance at 0x7fb65223a5a0>,93,16,[8 2],94,-1,125,-1,109
1,<environment.Job instance at 0x7fb65223afa0>,104,18,[1 8],105,-1,127,-1,109
1,<environment.Job instance at 0x7fb652264280>,108,18,[5 8],109,-1,127,-1,109
1,<environment.Job instance at 0x7fb6522396e0>,47,14,[12  5],48,-1,123,-1,109
1,<environment.Job instance at 0x7fb6522641e0>,107,15,[6 1],108,-1,124,-1,109
1,<environment.Job instance at 0x7fb6522640f0>,110,20,[9 5],111,-1,131,-1,111
1,<environment.Job instance at 0x7fb652264910>,114,15,[7 5],115,-1,133,-1,118
1,<environment.Job instance at 0x7fb65223aaa0>,101,23,[ 3 13],102,-1,145,-1,122
1,<environment.Job instance at 0x7fb65352e0f0>,121,18,[3 7],122,-1,140,-1,122
1,<environment.Job instance at 0x7fb65352e280>,122,17,[1 9],123,-1,140,-1,123
1,<environment.Job instance at 0x7fb65352e4b0>,125,3,[ 1 14],126,-1,132,-1,129
1,<environment.Job instance at 0x7fb652264c30>,117,15,[ 1 10],118,-1,145,-1,130
1,<environment.Job instance at 0x7fb652239a00>,8,1,[ 3 12],9,-1,10,-1,9
1,<environment.Job instance at 0x7fb652264320>,25,18,[14  2],26,-1,86,-1,68
1,<environment.Job instance at 0x7fb653718cd0>,37,25,[9 4],38,-1,153,-1,128
1,<environment.Job instance at 0x7fb6537183c0>,41,3,[ 4 12],42,-1,133,-1,130
1,<environment.Job instance at 0x7fb653833820>,46,16,[14  3],47,-1,162,-1,146
1,<environment.Job instance at 0x7fb653833780>,47,14,[12  5],48,-1,160,-1,146
1,<environment.Job instance at 0x7fb653833c30>,54,25,[7 4],55,-1,205,-1,180
1,<environment.Job instance at 0x7fb652de37d0>,65,23,[8 2],66,-1,252,-1,229
1,<environment.Job instance at 0x7fb65248d140>,73,18,[ 2 11],74,-1,263,-1,245
1,<environment.Job instance at 0x7fb652acc640>,75,3,[11  2],76,-1,257,-1,254
1,<environment.Job instance at 0x7fb6523f35a0>,82,23,[7 1],83,-1,312,-1,289
1,<environment.Job instance at 0x7fb6523f3500>,85,3,[13  2],86,-1,307,-1,304
1,<environment.Job instance at 0x7fb6526ae640>,88,1,[13  4],89,-1,319,-1,318
1,<environment.Job instance at 0x7fb6526b5c30>,92,13,[14  4],93,-1,336,-1,323
1,<environment.Job instance at 0x7fb652e48370>,101,23,[ 3 13],102,-1,379,-1,356
1,<environment.Job instance at 0x7fb652fab7d0>,125,3,[ 1 14],126,-1,472,-1,469
1,<environment.Job instance at 0x7fb653314690>,4,14,[10  4],5,-1,21,-1,7
1,<environment.Job instance at 0x7fb652502b40>,8,12,[10  1],9,-1,21,-1,9
1,<environment.Job instance at 0x7fb652502af0>,9,21,[1 7],10,-1,31,-1,10
1,<environment.Job instance at 0x7fb652502960>,10,16,[9 2],11,-1,27,-1,11
1,<environment.Job instance at 0x7fb652b51190>,16,12,[6 4],17,-1,29,-1,17
1,<environment.Job instance at 0x7fb652b51b40>,17,17,[8 2],18,-1,35,-1,18
1,<environment.Job instance at 0x7fb652b51320>,18,17,[1 6],19,-1,36,-1,19
1,<environment.Job instance at 0x7fb652b51550>,19,17,[9 2],20,-1,37,-1,20
1,<environment.Job instance at 0x7fb652b519b0>,22,15,[2 9],23,-1,38,-1,23
1,<environment.Job instance at 0x7fb652839af0>,33,18,[ 2 10],34,-1,52,-1,34
1,<environment.Job instance at 0x7fb652839370>,34,17,[8 3],35,-1,52,-1,35
1,<environment.Job instance at 0x7fb6528395a0>,37,17,[7 4],38,-1,55,-1,38
1,<environment.Job instance at 0x7fb652839050>,38,15,[8 3],39,-1,54,-1,39
1,<environment.Job instance at 0x7fb652839b40>,39,16,[10  5],40,-1,56,-1,40
1,<environment.Job instance at 0x7fb652864870>,41,16,[5 3],42,-1,58,-1,42
1,<environment.Job instance at 0x7fb652864780>,45,17,[ 2 10],46,-1,67,-1,50
1,<environment.Job instance at 0x7fb652864cd0>,50,18,[9 2],51,-1,69,-1,51
1,<environment.Job instance at 0x7fb6521d3690>,110,17,[8 4],111,-1,374,-1,357
1,<environment.Job instance at 0x7fb65286d0a0>,70,25,[ 1 14],71,-1,382,-1,357
1,<environment.Job instance at 0x7fb652b350a0>,101,18,[5 9],102,-1,375,-1,357
1,<environment.Job instance at 0x7fb652529af0>,114,17,[8 5],115,-1,380,-1,363
1,<environment.Job instance at 0x7fb652529370>,116,23,[5 5],117,-1,386,-1,363
1,<environment.Job instance at 0x7fb652529be0>,112,19,[8 3],113,-1,383,-1,364
1,<environment.Job instance at 0x7fb6525292d0>,118,14,[9 5],119,-1,378,-1,364
1,<environment.Job instance at 0x7fb652529a50>,119,25,[7 3],120,-1,389,-1,364
1,<environment.Job instance at 0x7fb652966cd0>,60,27,[7 4],61,-1,391,-1,364
1,<environment.Job instance at 0x7fb652550370>,124,17,[4 7],125,-1,381,-1,364
1,<environment.Job instance at 0x7fb6528935a0>,126,13,[10  5],127,-1,380,-1,367
1,<environment.Job instance at 0x7fb6525298c0>,113,13,[8 3],114,-1,380,-1,367
1,<environment.Job instance at 0x7fb652529d70>,123,17,[6 4],124,-1,384,-1,367
1,<environment.Job instance at 0x7fb652966fa0>,57,14,[11  2],58,-1,381,-1,367
1,<environment.Job instance at 0x7fb652502780>,0,13,[11  4],1,-1,14,-1,1
1,<environment.Job instance at 0x7fb652b511e0>,1,12,[ 1 13],2,-1,14,-1,2
1,<environment.Job instance at 0x7fb65286d4b0>,12,17,[ 2 14],13,-1,37,-1,20
1,<environment.Job instance at 0x7fb65c3e65f0>,25,16,[11  3],26,-1,81,-1,65
1,<environment.Job instance at 0x7fb6525110a0>,36,1,[11  2],37,-1,89,-1,88
1,<environment.Job instance at 0x7fb652e9b280>,57,14,[11  2],58,-1,175,-1,161
1,<environment.Job instance at 0x7fb652e9baa0>,58,15,[ 3 14],59,-1,176,-1,161
1,<environment.Job instance at 0x7fb652e9b5f0>,60,27,[7 4],61,-1,194,-1,167
1,<environment.Job instance at 0x7fb6526b3cd0>,65,2,[ 1 12],66,-1,182,-1,180
1,<environment.Job instance at 0x7fb6523f3a00>,70,25,[ 1 14],71,-1,232,-1,207
1,<environment.Job instance at 0x7fb65c4bad20>,73,1,[ 4 13],74,-1,222,-1,221
1,<environment.Job instance at 0x7fb652accaa0>,75,3,[ 4 11],76,-1,235,-1,232
1,<environment.Job instance at 0x7fb6531730f0>,88,3,[11  1],89,-1,283,-1,280
1,<environment.Job instance at 0x7fb652db4fa0>,116,23,[5 5],117,-1,410,-1,387
1,<environment.Job instance at 0x7fb6533145a0>,119,25,[7 3],120,-1,427,-1,402
1,<environment.Job instance at 0x7fb652264af0>,120,1,[12  5],121,-1,403,-1,402
1,<environment.Job instance at 0x7fb651fa65f0>,4,15,[8 1],5,-1,20,-1,5
1,<environment.Job instance at 0x7fb6523141e0>,8,15,[ 4 10],9,-1,24,-1,9
1,<environment.Job instance at 0x7fb652314230>,10,18,[5 4],11,-1,29,-1,11
1,<environment.Job instance at 0x7fb6520cb460>,18,18,[ 4 10],19,-1,37,-1,19
1,<environment.Job instance at 0x7fb6520cb640>,19,13,[7 2],20,-1,34,-1,21
1,<environment.Job instance at 0x7fb6520cbd20>,23,16,[3 8],24,-1,40,-1,24
1,<environment.Job instance at 0x7fb6520cb190>,24,16,[9 2],25,-1,41,-1,25
1,<environment.Job instance at 0x7fb6520cb820>,26,18,[3 6],27,-1,45,-1,27
1,<environment.Job instance at 0x7fb6520cbdc0>,27,18,[5 5],28,-1,46,-1,28
1,<environment.Job instance at 0x7fb6520986e0>,33,18,[4 5],34,-1,52,-1,34
1,<environment.Job instance at 0x7fb652098500>,34,15,[3 5],35,-1,50,-1,35
1,<environment.Job instance at 0x7fb6520989b0>,35,18,[5 8],36,-1,54,-1,36
1,<environment.Job instance at 0x7fb6520980f0>,36,18,[3 9],37,-1,55,-1,37
1,<environment.Job instance at 0x7fb652315be0>,39,23,[4 9],40,-1,63,-1,40
1,<environment.Job instance at 0x7fb6523158c0>,41,16,[6 5],42,-1,58,-1,42
1,<environment.Job instance at 0x7fb6520cb1e0>,17,18,[ 3 12],18,-1,78,-1,60
1,<environment.Job instance at 0x7fb652315690>,44,22,[5 8],45,-1,82,-1,60
1,<environment.Job instance at 0x7fb65208ed70>,49,3,[4 5],50,-1,63,-1,60
1,<environment.Job instance at 0x7fb652315f00>,45,16,[6 5],46,-1,76,-1,60
1,<environment.Job instance at 0x7fb652327320>,58,14,[7 2],59,-1,74,-1,60
1,<environment.Job instance at 0x7fb652327230>,59,18,[1 9],60,-1,78,-1,60
1,<environment.Job instance at 0x7fb652327b90>,57,3,[4 5],58,-1,63,-1,60
1,<environment.Job instance at 0x7fb652327e10>,60,2,[ 4 14],61,-1,63,-1,61
1,<environment.Job instance at 0x7fb6523277d0>,61,14,[6 1],62,-1,76,-1,62
1,<environment.Job instance at 0x7fb6523275f0>,63,14,[4 8],64,-1,78,-1,64
1,<environment.Job instance at 0x7fb6523278c0>,64,17,[3 7],65,-1,82,-1,65
1,<environment.Job instance at 0x7fb6520931e0>,66,14,[7 5],67,-1,84,-1,70
1,<environment.Job instance at 0x7fb652e3b280>,69,18,[2 9],70,-1,88,-1,70
1,<environment.Job instance at 0x7fb652e3be10>,70,18,[5 5],71,-1,89,-1,71
1,<environment.Job instance at 0x7fb652e3bb40>,71,14,[ 1 10],72,-1,88,-1,74
1,<environment.Job instance at 0x7fb652e3b5a0>,74,16,[7 5],75,-1,91,-1,75
1,<environment.Job instance at 0x7fb652e3bc80>,73,18,[5 2],74,-1,94,-1,76
1,<environment.Job instance at 0x7fb6520deaa0>,85,20,[10  3],86,-1,106,-1,86
1,<environment.Job instance at 0x7fb6520de5f0>,84,15,[10  2],85,-1,108,-1,93
1,<environment.Job instance at 0x7fb652122960>,92,18,[9 2],93,-1,113,-1,95
1,<environment.Job instance at 0x7fb65235a870>,102,17,[5 1],103,-1,120,-1,103
1,<environment.Job instance at 0x7fb652c8b0f0>,106,18,[ 2 10],107,-1,129,-1,111
1,<environment.Job instance at 0x7fb6527db4b0>,105,12,[8 3],106,-1,123,-1,111
1,<environment.Job instance at 0x7fb653005c30>,108,14,[9 5],109,-1,131,-1,117
1,<environment.Job instance at 0x7fb6527db460>,109,14,[8 5],110,-1,137,-1,123
1,<environment.Job instance at 0x7fb6527dbaa0>,110,25,[9 4],111,-1,148,-1,123
1,<environment.Job instance at 0x7fb6520cb7d0>,1,3,[ 3 11],2,-1,5,-1,2
1,<environment.Job instance at 0x7fb652e3b050>,15,3,[14  4],16,-1,25,-1,22
1,<environment.Job instance at 0x7fb6521d3640>,16,17,[ 1 13],17,-1,39,-1,22
1,<environment.Job instance at 0x7fb65342b2d0>,17,18,[ 3 12],18,-1,40,-1,22
1,<environment.Job instance at 0x7fb65c3952d0>,21,2,[11  4],22,-1,38,-1,36
1,<environment.Job instance at 0x7fb6537189b0>,28,22,[ 1 13],29,-1,90,-1,68
1,<environment.Job instance at 0x7fb65353d960>,38,2,[11  2],39,-1,110,-1,108
1,<environment.Job instance at 0x7fb6520e6af0>,39,23,[4 9],40,-1,132,-1,109
1,<environment.Job instance at 0x7fb652febd70>,42,13,[14  2],43,-1,124,-1,111
1,<environment.Job instance at 0x7fb6532a8dc0>,60,2,[ 4 14],61,-1,176,-1,174
1,<environment.Job instance at 0x7fb65bf113c0>,83,17,[14  2],84,-1,293,-1,276
1,<environment.Job instance at 0x7fb6530c1aa0>,96,2,[ 5 12],97,-1,306,-1,304
1,<environment.Job instance at 0x7fb652bbeb90>,97,23,[6 1],98,-1,339,-1,316
1,<environment.Job instance at 0x7fb652da8690>,110,25,[9 4],111,-1,379,-1,354
1,<environment.Job instance at 0x7fb652e772d0>,114,28,[ 5 10],115,-1,399,-1,371
1,<environment.Job instance at 0x7fb652b09fa0>,118,26,[4 9],119,-1,411,-1,385
1,<environment.Job instance at 0x7fb652c77aa0>,117,27,[2 9],118,-1,412,-1,385
1,<environment.Job instance at 0x7fb6526cf4b0>,126,16,[ 5 12],127,-1,417,-1,401
1,<environment.Job instance at 0x7fb652fd4be0>,2,22,[5 4],3,-1,25,-1,3
1,<environment.Job instance at 0x7fb652fd42d0>,6,18,[1 5],7,-1,25,-1,7
1,<environment.Job instance at 0x7fb652fd4780>,8,17,[7 5],9,-1,26,-1,9
1,<environment.Job instance at 0x7fb653833960>,10,17,[10  1],11,-1,28,-1,11
1,<environment.Job instance at 0x7fb653833b90>,11,16,[2 5],12,-1,28,-1,12
1,<environment.Job instance at 0x7fb653833be0>,13,16,[1 5],14,-1,30,-1,14
1,<environment.Job instance at 0x7fb653833460>,15,15,[5 4],16,-1,31,-1,16
1,<environment.Job instance at 0x7fb6538d75f0>,17,26,[10  5],18,-1,44,-1,18
1,<environment.Job instance at 0x7fb6538d7a00>,19,16,[5 6],20,-1,36,-1,20
1,<environment.Job instance at 0x7fb6538d79b0>,20,18,[4 5],21,-1,39,-1,21
1,<environment.Job instance at 0x7fb6538d7870>,21,18,[4 9],22,-1,40,-1,22
1,<environment.Job instance at 0x7fb6538d7960>,23,13,[9 3],24,-1,38,-1,25
1,<environment.Job instance at 0x7fb6538d7d20>,24,19,[2 5],25,-1,44,-1,25
1,<environment.Job instance at 0x7fb6538d7f00>,25,14,[ 3 10],26,-1,41,-1,27
1,<environment.Job instance at 0x7fb6538d7730>,28,12,[1 9],29,-1,41,-1,29
1,<environment.Job instance at 0x7fb6538d71e0>,26,14,[5 4],27,-1,44,-1,30
1,<environment.Job instance at 0x7fb6534addc0>,33,23,[1 7],34,-1,57,-1,34
1,<environment.Job instance at 0x7fb6534ada00>,35,18,[ 2 10],36,-1,57,-1,39
1,<environment.Job instance at 0x7fb6534ad460>,39,17,[9 1],40,-1,57,-1,40
1,<environment.Job instance at 0x7fb6534ad320>,40,16,[4 8],41,-1,57,-1,41
1,<environment.Job instance at 0x7fb6534adf00>,42,26,[1 5],43,-1,69,-1,43
1,<environment.Job instance at 0x7fb6534adaf0>,43,17,[ 4 10],44,-1,61,-1,44
1,<environment.Job instance at 0x7fb65382f640>,50,13,[10  5],51,-1,64,-1,51
1,<environment.Job instance at 0x7fb65382f410>,57,24,[2 8],58,-1,98,-1,74
1,<environment.Job instance at 0x7fb652202640>,16,17,[ 2 14],17,-1,60,-1,43
1,<environment.Job instance at 0x7fb65353f460>,17,26,[10  5],18,-1,79,-1,53
1,<environment.Job instance at 0x7fb652bbeb90>,33,23,[1 7],34,-1,138,-1,115
1,<environment.Job instance at 0x7fb651fe3370>,38,13,[14  3],39,-1,128,-1,115
1,<environment.Job instance at 0x7fb6533f3730>,42,26,[1 5],43,-1,151,-1,125
1,<environment.Job instance at 0x7fb6532ff4b0>,57,24,[2 8],58,-1,207,-1,183
1,<environment.Job instance at 0x7fb652542a50>,59,13,[14  2],60,-1,196,-1,183
1,<environment.Job instance at 0x7fb652db2690>,63,26,[1 8],64,-1,231,-1,205
1,<environment.Job instance at 0x7fb65c2335f0>,69,15,[ 1 14],70,-1,233,-1,218
1,<environment.Job instance at 0x7fb652455190>,71,23,[9 4],72,-1,246,-1,223
1,<environment.Job instance at 0x7fb653295e60>,107,16,[11  5],108,-1,385,-1,369
1,<environment.Job instance at 0x7fb6536cd6e0>,111,3,[13  1],112,-1,384,-1,381
1,<environment.Job instance at 0x7fb652b2b320>,125,1,[ 3 12],126,-1,435,-1,434
1,<environment.Job instance at 0x7fb652b2bc80>,128,3,[ 5 12],129,-1,439,-1,436
1,<environment.Job instance at 0x7fb653331640>,2,16,[9 3],3,-1,20,-1,4
1,<environment.Job instance at 0x7fb652e68780>,4,16,[7 3],5,-1,21,-1,5
1,<environment.Job instance at 0x7fb652e689b0>,5,22,[5 2],6,-1,28,-1,6
1,<environment.Job instance at 0x7fb652e68a00>,8,13,[5 7],9,-1,22,-1,9
1,<environment.Job instance at 0x7fb653762640>,11,28,[7 5],12,-1,40,-1,12
1,<environment.Job instance at 0x7fb653762cd0>,14,26,[7 1],15,-1,41,-1,15
1,<environment.Job instance at 0x7fb653111050>,15,18,[10  4],16,-1,34,-1,16
1,<environment.Job instance at 0x7fb653111410>,18,1,[5 1],19,-1,20,-1,19
1,<environment.Job instance at 0x7fb6531115f0>,21,18,[4 9],22,-1,40,-1,22
1,<environment.Job instance at 0x7fb6531117d0>,22,18,[3 6],23,-1,41,-1,23
1,<environment.Job instance at 0x7fb653111a00>,25,16,[2 7],26,-1,42,-1,26
1,<environment.Job instance at 0x7fb653111c80>,28,18,[8 3],29,-1,47,-1,29
1,<environment.Job instance at 0x7fb6537480f0>,35,18,[ 2 11],36,-1,55,-1,37
1,<environment.Job instance at 0x7fb653111e10>,30,24,[10  5],31,-1,61,-1,37
1,<environment.Job instance at 0x7fb653748550>,37,18,[6 4],38,-1,56,-1,38
1,<environment.Job instance at 0x7fb6537481e0>,33,18,[6 3],34,-1,56,-1,38
1,<environment.Job instance at 0x7fb653748050>,32,15,[ 2 10],33,-1,53,-1,38
1,<environment.Job instance at 0x7fb653748370>,36,13,[11  3],37,-1,51,-1,38
1,<environment.Job instance at 0x7fb6537483c0>,38,27,[5 1],39,-1,66,-1,39
1,<environment.Job instance at 0x7fb6537485f0>,39,15,[9 3],40,-1,59,-1,44
1,<environment.Job instance at 0x7fb653748d20>,48,27,[1 7],49,-1,79,-1,52
1,<environment.Job instance at 0x7fb653748d70>,46,15,[4 7],47,-1,67,-1,52
1,<environment.Job instance at 0x7fb65377a5a0>,57,17,[13  5],58,-1,75,-1,58
1,<environment.Job instance at 0x7fb65377a7d0>,55,13,[3 7],56,-1,73,-1,60
1,<environment.Job instance at 0x7fb65377ac80>,60,17,[5 9],61,-1,78,-1,61
1,<environment.Job instance at 0x7fb65377ad20>,61,17,[9 4],62,-1,79,-1,62
1,<environment.Job instance at 0x7fb6537570f0>,64,14,[9 5],65,-1,80,-1,66
1,<environment.Job instance at 0x7fb653757190>,66,16,[3 8],67,-1,83,-1,67
1,<environment.Job instance at 0x7fb653757410>,67,18,[ 5 10],68,-1,86,-1,68
1,<environment.Job instance at 0x7fb653757320>,68,15,[1 8],69,-1,85,-1,70
1,<environment.Job instance at 0x7fb6537574b0>,70,13,[7 3],71,-1,86,-1,73
1,<environment.Job instance at 0x7fb6537575f0>,72,12,[10  2],73,-1,86,-1,74
1,<environment.Job instance at 0x7fb653120690>,74,18,[ 2 10],75,-1,93,-1,75
1,<environment.Job instance at 0x7fb653748c80>,49,16,[12  5],50,-1,93,-1,77
1,<environment.Job instance at 0x7fb652591c30>,77,18,[5 9],78,-1,96,-1,78
1,<environment.Job instance at 0x7fb65276eeb0>,76,18,[ 2 10],77,-1,99,-1,81
1,<environment.Job instance at 0x7fb65c4b6050>,80,17,[8 2],81,-1,99,-1,82
1,<environment.Job instance at 0x7fb652591960>,81,14,[4 9],82,-1,99,-1,85
1,<environment.Job instance at 0x7fb651f9c1e0>,85,13,[2 7],86,-1,102,-1,89
1,<environment.Job instance at 0x7fb652787320>,90,18,[14  5],91,-1,112,-1,94
1,<environment.Job instance at 0x7fb6527878c0>,95,14,[5 9],96,-1,110,-1,96
1,<environment.Job instance at 0x7fb65315abe0>,96,15,[2 7],97,-1,112,-1,97
1,<environment.Job instance at 0x7fb651f6f820>,94,14,[7 4],95,-1,112,-1,98
1,<environment.Job instance at 0x7fb652787eb0>,88,25,[5 5],89,-1,124,-1,99
1,<environment.Job instance at 0x7fb653158c80>,98,17,[2 7],99,-1,116,-1,99
1,<environment.Job instance at 0x7fb652865be0>,99,16,[8 5],100,-1,116,-1,100
1,<environment.Job instance at 0x7fb65217a9b0>,97,16,[3 5],98,-1,120,-1,104
1,<environment.Job instance at 0x7fb6527dde60>,100,22,[4 6],101,-1,127,-1,105
1,<environment.Job instance at 0x7fb652878690>,104,18,[10  2],105,-1,124,-1,106
1,<environment.Job instance at 0x7fb652878f50>,105,17,[3 9],106,-1,129,-1,112
1,<environment.Job instance at 0x7fb6527dda00>,102,18,[5 6],103,-1,144,-1,126
1,<environment.Job instance at 0x7fb6527cc140>,122,16,[14  1],123,-1,146,-1,130
1,<environment.Job instance at 0x7fb6527ccaa0>,123,14,[9 2],124,-1,144,-1,130
1,<environment.Job instance at 0x7fb6527cc780>,115,16,[ 4 12],116,-1,146,-1,130
1,<environment.Job instance at 0x7fb653748c30>,6,1,[11  1],7,-1,8,-1,7
1,<environment.Job instance at 0x7fb65388f5a0>,10,13,[11  3],11,-1,27,-1,14
1,<environment.Job instance at 0x7fb65377a2d0>,13,2,[14  5],14,-1,20,-1,18
1,<environment.Job instance at 0x7fb65377a780>,11,28,[7 5],12,-1,47,-1,19
1,<environment.Job instance at 0x7fb6527b9f50>,14,26,[7 1],15,-1,45,-1,19
1,<environment.Job instance at 0x7fb652e6a690>,27,13,[13  4],28,-1,59,-1,46
1,<environment.Job instance at 0x7fb653723e10>,30,24,[10  5],31,-1,86,-1,62
1,<environment.Job instance at 0x7fb65246ac80>,31,3,[ 4 12],32,-1,65,-1,62
1,<environment.Job instance at 0x7fb653267500>,35,18,[ 2 11],36,-1,96,-1,78
1,<environment.Job instance at 0x7fb653423230>,36,13,[11  3],37,-1,91,-1,78
1,<environment.Job instance at 0x7fb652da7d70>,38,27,[5 1],39,-1,123,-1,96
1,<environment.Job instance at 0x7fb6520e6d70>,48,27,[1 7],49,-1,143,-1,116
1,<environment.Job instance at 0x7fb6520e6fa0>,49,16,[12  5],50,-1,132,-1,116
1,<environment.Job instance at 0x7fb6523a1460>,56,1,[14  4],57,-1,122,-1,121
1,<environment.Job instance at 0x7fb652ac7410>,57,17,[13  5],58,-1,138,-1,121
1,<environment.Job instance at 0x7fb652fd4460>,88,25,[5 5],89,-1,311,-1,286
1,<environment.Job instance at 0x7fb652fd4550>,90,18,[14  5],91,-1,304,-1,286
1,<environment.Job instance at 0x7fb652fd4e10>,91,15,[ 1 12],92,-1,301,-1,286
1,<environment.Job instance at 0x7fb6533ced20>,112,17,[ 3 14],113,-1,400,-1,383
1,<environment.Job instance at 0x7fb652b51a50>,115,16,[ 4 12],116,-1,403,-1,387
1,<environment.Job instance at 0x7fb653402690>,118,18,[13  3],119,-1,416,-1,398
1,<environment.Job instance at 0x7fb653402460>,119,1,[ 4 14],120,-1,399,-1,398
1,<environment.Job instance at 0x7fb652456140>,122,16,[14  1],123,-1,417,-1,401
1,<environment.Job instance at 0x7fb653289be0>,125,1,[ 5 13],126,-1,405,-1,404
1,<environment.Job instance at 0x7fb65213a0a0>,1,22,[2 9],2,-1,24,-1,2
1,<environment.Job instance at 0x7fb65213aa50>,5,16,[8 5],6,-1,22,-1,6
1,<environment.Job instance at 0x7fb65213ae60>,9,18,[7 2],10,-1,28,-1,10
1,<environment.Job instance at 0x7fb652c93d20>,14,1,[2 5],15,-1,16,-1,15
1,<environment.Job instance at 0x7fb652da7730>,17,13,[5 5],18,-1,31,-1,18
1,<environment.Job instance at 0x7fb653527cd0>,18,18,[ 4 12],19,-1,37,-1,19
1,<environment.Job instance at 0x7fb65226a050>,20,12,[10  4],21,-1,33,-1,21
1,<environment.Job instance at 0x7fb65223ef00>,22,18,[ 5 10],23,-1,41,-1,23
1,<environment.Job instance at 0x7fb6524248c0>,32,20,[5 2],33,-1,54,-1,34
1,<environment.Job instance at 0x7fb651f84190>,43,15,[8 4],44,-1,60,-1,45
1,<environment.Job instance at 0x7fb652091af0>,53,21,[5 7],54,-1,76,-1,55
1,<environment.Job instance at 0x7fb652424c80>,26,16,[ 5 10],27,-1,71,-1,55
1,<environment.Job instance at 0x7fb651f6d6e0>,54,14,[10  4],55,-1,69,-1,55
1,<environment.Job instance at 0x7fb65270f370>,33,14,[1 8],34,-1,73,-1,59
1,<environment.Job instance at 0x7fb651f6d550>,55,17,[4 9],56,-1,76,-1,59
1,<environment.Job instance at 0x7fb652d4c690>,63,25,[9 3],64,-1,95,-1,70
1,<environment.Job instance at 0x7fb652d4ccd0>,62,19,[4 7],63,-1,89,-1,70
1,<environment.Job instance at 0x7fb652ea1960>,66,19,[9 4],67,-1,89,-1,70
1,<environment.Job instance at 0x7fb651f6d5f0>,61,16,[5 7],62,-1,86,-1,70
1,<environment.Job instance at 0x7fb652ea1c30>,67,18,[4 7],68,-1,88,-1,70
1,<environment.Job instance at 0x7fb651f6dc80>,59,27,[ 5 11],60,-1,97,-1,70
1,<environment.Job instance at 0x7fb651f84550>,46,20,[4 9],47,-1,90,-1,70
1,<environment.Job instance at 0x7fb652ea1140>,65,13,[6 4],66,-1,84,-1,71
1,<environment.Job instance at 0x7fb651f6dfa0>,60,13,[10  1],61,-1,85,-1,72
1,<environment.Job instance at 0x7fb6537081e0>,73,18,[10  5],74,-1,92,-1,74
1,<environment.Job instance at 0x7fb653708f50>,68,17,[ 2 12],69,-1,94,-1,77
1,<environment.Job instance at 0x7fb653708b90>,71,14,[2 7],72,-1,91,-1,77
1,<environment.Job instance at 0x7fb652b33af0>,78,24,[8 3],79,-1,103,-1,79
1,<environment.Job instance at 0x7fb652b339b0>,76,16,[5 2],77,-1,96,-1,80
1,<environment.Job instance at 0x7fb652b33e10>,82,15,[ 3 10],83,-1,98,-1,83
1,<environment.Job instance at 0x7fb652a84960>,84,17,[9 5],85,-1,102,-1,85
1,<environment.Job instance at 0x7fb652b335a0>,79,14,[3 5],80,-1,100,-1,86
1,<environment.Job instance at 0x7fb652a84fa0>,87,12,[ 3 10],88,-1,102,-1,90
1,<environment.Job instance at 0x7fb652a84aa0>,89,19,[2 9],90,-1,109,-1,90
1,<environment.Job instance at 0x7fb652a84f00>,90,22,[1 9],91,-1,116,-1,94
1,<environment.Job instance at 0x7fb6527cb230>,94,13,[10  5],95,-1,109,-1,96
1,<environment.Job instance at 0x7fb653220eb0>,97,17,[1 7],98,-1,115,-1,98
1,<environment.Job instance at 0x7fb653295190>,99,17,[8 4],100,-1,117,-1,100
1,<environment.Job instance at 0x7fb65228a690>,101,16,[2 6],102,-1,118,-1,102
1,<environment.Job instance at 0x7fb653295a50>,102,17,[8 1],103,-1,120,-1,103
1,<environment.Job instance at 0x7fb653295be0>,103,26,[2 9],104,-1,130,-1,104
1,<environment.Job instance at 0x7fb65238bf00>,105,17,[1 8],106,-1,123,-1,106
1,<environment.Job instance at 0x7fb6527cba50>,95,14,[10  1],96,-1,123,-1,109
1,<environment.Job instance at 0x7fb65310cbe0>,112,18,[6 4],113,-1,131,-1,113
1,<environment.Job instance at 0x7fb6530205a0>,113,18,[1 8],114,-1,132,-1,114
1,<environment.Job instance at 0x7fb6522b9c30>,108,14,[1 6],109,-1,129,-1,115
1,<environment.Job instance at 0x7fb65213ca50>,119,15,[8 4],120,-1,135,-1,120
1,<environment.Job instance at 0x7fb6521b6d20>,121,12,[5 1],122,-1,135,-1,123
1,<environment.Job instance at 0x7fb6538b3370>,124,16,[5 3],125,-1,142,-1,126
1,<environment.Job instance at 0x7fb652730eb0>,126,1,[6 3],127,-1,128,-1,127
1,<environment.Job instance at 0x7fb653987aa0>,125,13,[2 6],126,-1,140,-1,127
1,<environment.Job instance at 0x7fb652730550>,128,18,[5 6],129,-1,147,-1,129
1,<environment.Job instance at 0x7fb65270f230>,3,3,[ 5 11],4,-1,7,-1,4
1,<environment.Job instance at 0x7fb653708910>,11,3,[ 3 11],12,-1,27,-1,24
1,<environment.Job instance at 0x7fb65213a2d0>,18,18,[ 4 12],19,-1,49,-1,31
1,<environment.Job instance at 0x7fb6779c8910>,24,26,[10  2],25,-1,83,-1,57
1,<environment.Job instance at 0x7fb652df48c0>,37,15,[13  3],38,-1,94,-1,79
1,<environment.Job instance at 0x7fb6537f4550>,51,2,[ 2 13],52,-1,109,-1,107
1,<environment.Job instance at 0x7fb6538bceb0>,58,2,[12  1],59,-1,126,-1,124
1,<environment.Job instance at 0x7fb6534b79b0>,59,27,[ 5 11],60,-1,151,-1,124
1,<environment.Job instance at 0x7fb653366820>,63,25,[9 3],64,-1,176,-1,151
1,<environment.Job instance at 0x7fb6527a05f0>,68,17,[ 2 12],69,-1,182,-1,165
1,<environment.Job instance at 0x7fb65218bbe0>,70,26,[9 4],71,-1,196,-1,170
1,<environment.Job instance at 0x7fb652dde500>,75,14,[13  2],76,-1,189,-1,175
1,<environment.Job instance at 0x7fb653536b90>,78,24,[8 3],79,-1,203,-1,179
1,<environment.Job instance at 0x7fb653948910>,98,2,[ 4 12],99,-1,266,-1,264
1,<environment.Job instance at 0x7fb6524af190>,103,26,[2 9],104,-1,318,-1,292
1,<environment.Job instance at 0x7fb6526ae730>,106,13,[12  4],107,-1,305,-1,292
1,<environment.Job instance at 0x7fb653423dc0>,111,17,[13  5],112,-1,325,-1,308
1,<environment.Job instance at 0x7fb652e7c8c0>,2,18,[7 3],3,-1,21,-1,3
1,<environment.Job instance at 0x7fb652e7c5f0>,5,16,[5 7],6,-1,22,-1,6
1,<environment.Job instance at 0x7fb652e7c9b0>,7,16,[3 5],8,-1,24,-1,8
1,<environment.Job instance at 0x7fb652e7c1e0>,9,23,[5 5],10,-1,33,-1,10
1,<environment.Job instance at 0x7fb652e7cc80>,10,17,[8 3],11,-1,29,-1,12
1,<environment.Job instance at 0x7fb652e7c460>,12,12,[5 4],13,-1,25,-1,13
1,<environment.Job instance at 0x7fb652e7cfa0>,13,13,[10  3],14,-1,27,-1,14
1,<environment.Job instance at 0x7fb65268a140>,14,17,[5 6],15,-1,32,-1,15
1,<environment.Job instance at 0x7fb65268a7d0>,15,24,[7 5],16,-1,40,-1,16
1,<environment.Job instance at 0x7fb65268a9b0>,16,15,[1 5],17,-1,32,-1,17
1,<environment.Job instance at 0x7fb65268ae60>,20,14,[6 1],21,-1,35,-1,21
1,<environment.Job instance at 0x7fb65268a500>,22,17,[3 8],23,-1,40,-1,23
1,<environment.Job instance at 0x7fb65268a370>,24,3,[9 3],25,-1,28,-1,25
1,<environment.Job instance at 0x7fb652bbe280>,11,12,[7 5],12,-1,37,-1,25
1,<environment.Job instance at 0x7fb65268ad70>,26,13,[ 1 10],27,-1,40,-1,27
1,<environment.Job instance at 0x7fb65268a910>,27,14,[9 3],28,-1,44,-1,30
1,<environment.Job instance at 0x7fb65268ac80>,29,15,[8 4],30,-1,45,-1,30
1,<environment.Job instance at 0x7fb65c4b44b0>,32,16,[6 3],33,-1,49,-1,33
1,<environment.Job instance at 0x7fb65c4b4500>,35,19,[8 1],36,-1,55,-1,36
1,<environment.Job instance at 0x7fb6522ad5f0>,41,23,[7 5],42,-1,65,-1,42
1,<environment.Job instance at 0x7fb6522ad7d0>,42,28,[8 2],43,-1,71,-1,43
1,<environment.Job instance at 0x7fb653873690>,43,22,[5 4],44,-1,66,-1,44
1,<environment.Job instance at 0x7fb653873500>,45,17,[ 4 10],46,-1,63,-1,46
1,<environment.Job instance at 0x7fb65271a730>,50,16,[1 5],51,-1,67,-1,51
1,<environment.Job instance at 0x7fb65271afa0>,51,17,[6 5],52,-1,69,-1,52
1,<environment.Job instance at 0x7fb65271a4b0>,53,18,[10  5],54,-1,72,-1,54
1,<environment.Job instance at 0x7fb65271a690>,56,16,[3 6],57,-1,73,-1,57
1,<environment.Job instance at 0x7fb65271a550>,63,18,[4 9],64,-1,82,-1,64
1,<environment.Job instance at 0x7fb6525e0af0>,64,26,[7 4],65,-1,91,-1,65
1,<environment.Job instance at 0x7fb653120460>,68,16,[1 8],69,-1,85,-1,69
1,<environment.Job instance at 0x7fb653120140>,69,12,[9 3],70,-1,84,-1,72
1,<environment.Job instance at 0x7fb653120b40>,71,13,[5 5],72,-1,87,-1,74
1,<environment.Job instance at 0x7fb652412910>,74,17,[10  4],75,-1,92,-1,75
1,<environment.Job instance at 0x7fb652c872d0>,87,19,[4 7],88,-1,108,-1,89
1,<environment.Job instance at 0x7fb652c87c30>,90,17,[2 8],91,-1,110,-1,93
1,<environment.Job instance at 0x7fb652c873c0>,94,16,[6 3],95,-1,111,-1,95
1,<environment.Job instance at 0x7fb652c87410>,96,12,[1 9],97,-1,109,-1,97
1,<environment.Job instance at 0x7fb6538f9d20>,97,18,[7 1],98,-1,116,-1,98
1,<environment.Job instance at 0x7fb65299b960>,98,16,[10  3],99,-1,115,-1,99
1,<environment.Job instance at 0x7fb652925370>,99,15,[9 3],100,-1,115,-1,100
1,<environment.Job instance at 0x7fb652c87a50>,102,22,[6 2],103,-1,125,-1,103
1,<environment.Job instance at 0x7fb65398b0a0>,103,16,[4 9],104,-1,120,-1,104
1,<environment.Job instance at 0x7fb65398b5a0>,104,23,[6 5],105,-1,128,-1,105
1,<environment.Job instance at 0x7fb6533fcbe0>,115,15,[ 5 11],116,-1,140,-1,125
1,<environment.Job instance at 0x7fb6533fc190>,120,26,[5 7],121,-1,153,-1,127
1,<environment.Job instance at 0x7fb6533955a0>,123,15,[10  1],124,-1,142,-1,127
1,<environment.Job instance at 0x7fb6533fc960>,118,1,[5 1],119,-1,128,-1,127
1,<environment.Job instance at 0x7fb653395410>,124,20,[5 9],125,-1,147,-1,127
1,<environment.Job instance at 0x7fb653445320>,85,15,[ 2 12],86,-1,143,-1,128
1,<environment.Job instance at 0x7fb6533fcb90>,121,16,[ 2 10],122,-1,145,-1,129
1,<environment.Job instance at 0x7fb65271a370>,9,23,[5 5],10,-1,39,-1,16
1,<environment.Job instance at 0x7fb6534450f0>,15,24,[7 5],16,-1,64,-1,40
1,<environment.Job instance at 0x7fb65299be10>,17,3,[ 2 13],18,-1,43,-1,40
1,<environment.Job instance at 0x7fb652e7caa0>,30,1,[13  2],31,-1,78,-1,77
1,<environment.Job instance at 0x7fb653423b90>,33,1,[ 2 13],34,-1,90,-1,89
1,<environment.Job instance at 0x7fb65238b370>,36,1,[ 4 11],37,-1,105,-1,104
1,<environment.Job instance at 0x7fb6538aeaa0>,41,23,[7 5],42,-1,134,-1,111
1,<environment.Job instance at 0x7fb6538aee60>,42,28,[8 2],43,-1,149,-1,121
1,<environment.Job instance at 0x7fb6537f4550>,64,26,[7 4],65,-1,187,-1,161
1,<environment.Job instance at 0x7fb6534b7500>,65,1,[12  3],66,-1,162,-1,161
1,<environment.Job instance at 0x7fb65331b5f0>,78,16,[14  5],79,-1,212,-1,196
1,<environment.Job instance at 0x7fb653357820>,82,14,[ 2 12],83,-1,216,-1,202
1,<environment.Job instance at 0x7fb653987aa0>,85,15,[ 2 12],86,-1,228,-1,213
1,<environment.Job instance at 0x7fb652cecd20>,104,23,[6 5],105,-1,311,-1,288
1,<environment.Job instance at 0x7fb652730f50>,115,15,[ 5 11],116,-1,338,-1,323
1,<environment.Job instance at 0x7fb65359e780>,120,26,[5 7],121,-1,361,-1,335
1,<environment.Job instance at 0x7fb652036b40>,4,16,[5 6],5,-1,22,-1,6
1,<environment.Job instance at 0x7fb653373230>,5,16,[10  2],6,-1,22,-1,6
1,<environment.Job instance at 0x7fb65205d0f0>,10,20,[5 8],11,-1,31,-1,11
1,<environment.Job instance at 0x7fb65205d7d0>,16,18,[3 5],17,-1,36,-1,18
1,<environment.Job instance at 0x7fb65205d550>,18,14,[7 5],19,-1,33,-1,19
1,<environment.Job instance at 0x7fb65205da00>,20,21,[5 2],21,-1,42,-1,21
1,<environment.Job instance at 0x7fb65205d8c0>,17,14,[8 3],18,-1,35,-1,21
1,<environment.Job instance at 0x7fb65205dd20>,24,18,[3 8],25,-1,43,-1,25
1,<environment.Job instance at 0x7fb6520494b0>,31,17,[2 9],32,-1,56,-1,39
1,<environment.Job instance at 0x7fb65203b5a0>,46,23,[5 6],47,-1,71,-1,48
1,<environment.Job instance at 0x7fb652049d70>,38,14,[7 3],39,-1,62,-1,48
1,<environment.Job instance at 0x7fb65203b730>,48,25,[ 5 10],49,-1,74,-1,49
1,<environment.Job instance at 0x7fb65203b5f0>,47,16,[2 6],48,-1,66,-1,50
1,<environment.Job instance at 0x7fb65203b9b0>,50,17,[6 4],51,-1,68,-1,51
1,<environment.Job instance at 0x7fb65203baa0>,52,18,[9 5],53,-1,71,-1,53
1,<environment.Job instance at 0x7fb65205dbe0>,26,14,[3 9],27,-1,70,-1,56
1,<environment.Job instance at 0x7fb65203be60>,55,15,[9 5],56,-1,72,-1,57
1,<environment.Job instance at 0x7fb65203ba00>,51,12,[ 5 11],52,-1,72,-1,60
1,<environment.Job instance at 0x7fb65203bf50>,57,26,[ 2 10],58,-1,86,-1,60
1,<environment.Job instance at 0x7fb6520312d0>,61,16,[8 5],62,-1,84,-1,68
1,<environment.Job instance at 0x7fb6520314b0>,64,17,[5 7],65,-1,85,-1,68
1,<environment.Job instance at 0x7fb65230cd70>,91,27,[8 1],92,-1,337,-1,310
1,<environment.Job instance at 0x7fb652037320>,119,18,[5 5],120,-1,333,-1,315
1,<environment.Job instance at 0x7fb652037aa0>,120,16,[5 4],121,-1,331,-1,315
1,<environment.Job instance at 0x7fb652037e10>,121,18,[5 5],122,-1,334,-1,316
1,<environment.Job instance at 0x7fb652037c30>,122,28,[5 1],123,-1,344,-1,316
1,<environment.Job instance at 0x7fb652037780>,126,17,[3 7],127,-1,334,-1,317
1,<environment.Job instance at 0x7fb65205db40>,22,16,[11  5],23,-1,345,-1,329
1,<environment.Job instance at 0x7fb652030dc0>,115,1,[ 3 14],116,-1,331,-1,330
1,<environment.Job instance at 0x7fb65215c500>,107,26,[ 5 10],108,-1,356,-1,330
1,<environment.Job instance at 0x7fb65205de60>,2,26,[ 1 10],3,-1,29,-1,3
1,<environment.Job instance at 0x7fb6520496e0>,3,28,[3 5],4,-1,32,-1,4
1,<environment.Job instance at 0x7fb6520389b0>,19,14,[ 1 13],20,-1,37,-1,23
1,<environment.Job instance at 0x7fb65231dd20>,22,16,[11  5],23,-1,51,-1,35
1,<environment.Job instance at 0x7fb65359e780>,45,23,[7 4],46,-1,139,-1,116
1,<environment.Job instance at 0x7fb652730730>,46,23,[5 6],47,-1,139,-1,116
1,<environment.Job instance at 0x7fb6522b95f0>,51,12,[ 5 11],52,-1,143,-1,131
1,<environment.Job instance at 0x7fb652730640>,48,25,[ 5 10],49,-1,174,-1,149
1,<environment.Job instance at 0x7fb65bf064b0>,57,26,[ 2 10],58,-1,176,-1,150
1,<environment.Job instance at 0x7fb65223e910>,63,17,[ 5 12],64,-1,170,-1,153
1,<environment.Job instance at 0x7fb65c53b5a0>,77,2,[ 5 11],78,-1,210,-1,208
1,<environment.Job instance at 0x7fb65c3956e0>,78,12,[12  2],79,-1,220,-1,208
1,<environment.Job instance at 0x7fb6527ee0a0>,80,2,[ 4 14],81,-1,211,-1,209
1,<environment.Job instance at 0x7fb6535276e0>,90,25,[8 3],91,-1,286,-1,261
1,<environment.Job instance at 0x7fb653527aa0>,91,27,[8 1],92,-1,288,-1,261
1,<environment.Job instance at 0x7fb6534b7d20>,97,27,[2 6],98,-1,293,-1,266
1,<environment.Job instance at 0x7fb65205a870>,107,26,[ 5 10],108,-1,318,-1,292
1,<environment.Job instance at 0x7fb6531595a0>,109,1,[12  4],110,-1,293,-1,292
1,<environment.Job instance at 0x7fb6524afaf0>,114,1,[ 1 11],115,-1,324,-1,323
1,<environment.Job instance at 0x7fb65238b550>,115,1,[ 3 14],116,-1,324,-1,323
1,<environment.Job instance at 0x7fb653423910>,122,28,[5 1],123,-1,373,-1,345
1,<environment.Job instance at 0x7fb652a0a050>,1,17,[ 4 10],2,-1,19,-1,2
1,<environment.Job instance at 0x7fb653808320>,11,17,[6 1],12,-1,30,-1,13
1,<environment.Job instance at 0x7fb652a0a9b0>,13,15,[5 8],14,-1,29,-1,14
1,<environment.Job instance at 0x7fb6526b5870>,14,2,[6 1],15,-1,17,-1,15
1,<environment.Job instance at 0x7fb652351500>,12,16,[9 2],13,-1,31,-1,15
1,<environment.Job instance at 0x7fb6527f41e0>,18,26,[2 5],19,-1,45,-1,19
1,<environment.Job instance at 0x7fb65295c730>,26,22,[7 4],27,-1,63,-1,41
1,<environment.Job instance at 0x7fb653137370>,19,28,[4 8],20,-1,70,-1,42
1,<environment.Job instance at 0x7fb652c18be0>,38,14,[9 3],39,-1,56,-1,42
1,<environment.Job instance at 0x7fb6520cb2d0>,27,28,[ 1 10],28,-1,70,-1,42
1,<environment.Job instance at 0x7fb65295c370>,28,18,[5 5],29,-1,66,-1,48
1,<environment.Job instance at 0x7fb6520cbeb0>,23,13,[10  1],24,-1,61,-1,48
1,<environment.Job instance at 0x7fb653159370>,44,16,[5 8],45,-1,65,-1,49
1,<environment.Job instance at 0x7fb652314be0>,49,16,[ 3 10],50,-1,66,-1,50
1,<environment.Job instance at 0x7fb65299b780>,48,12,[3 8],49,-1,73,-1,61
1,<environment.Job instance at 0x7fb6537f4730>,54,13,[6 5],55,-1,74,-1,61
1,<environment.Job instance at 0x7fb6537f48c0>,55,13,[6 1],56,-1,74,-1,61
1,<environment.Job instance at 0x7fb6537f4690>,53,15,[3 5],54,-1,76,-1,61
1,<environment.Job instance at 0x7fb6525988c0>,47,12,[10  4],48,-1,73,-1,61
1,<environment.Job instance at 0x7fb6520f2640>,59,13,[3 6],60,-1,74,-1,61
1,<environment.Job instance at 0x7fb6520f2230>,56,20,[10  4],57,-1,87,-1,67
1,<environment.Job instance at 0x7fb6530b8190>,65,17,[5 8],66,-1,87,-1,70
1,<environment.Job instance at 0x7fb652903640>,70,16,[8 2],71,-1,88,-1,72
1,<environment.Job instance at 0x7fb6525b2230>,72,17,[5 5],73,-1,91,-1,74
1,<environment.Job instance at 0x7fb6525b2500>,73,24,[9 2],74,-1,99,-1,75
1,<environment.Job instance at 0x7fb6526aef00>,79,15,[10  5],80,-1,95,-1,80
1,<environment.Job instance at 0x7fb652f90f50>,71,12,[9 4],72,-1,93,-1,81
1,<environment.Job instance at 0x7fb652846cd0>,82,15,[4 9],83,-1,99,-1,84
1,<environment.Job instance at 0x7fb65217a690>,89,16,[ 1 10],90,-1,119,-1,103
1,<environment.Job instance at 0x7fb653159780>,45,16,[2 7],46,-1,119,-1,103
1,<environment.Job instance at 0x7fb65206e5f0>,93,21,[5 4],94,-1,124,-1,103
1,<environment.Job instance at 0x7fb65206ef00>,94,17,[11  5],95,-1,166,-1,149
1,<environment.Job instance at 0x7fb652071910>,104,24,[5 8],105,-1,173,-1,149
1,<environment.Job instance at 0x7fb652071d20>,107,18,[3 8],108,-1,169,-1,151
1,<environment.Job instance at 0x7fb6520804b0>,113,17,[7 2],114,-1,173,-1,156
1,<environment.Job instance at 0x7fb652161230>,102,18,[10  3],103,-1,175,-1,157
1,<environment.Job instance at 0x7fb652080c80>,114,18,[1 8],115,-1,176,-1,158
1,<environment.Job instance at 0x7fb652080820>,117,18,[1 8],118,-1,178,-1,160
1,<environment.Job instance at 0x7fb652080320>,112,13,[3 6],113,-1,173,-1,160
1,<environment.Job instance at 0x7fb652080640>,119,17,[6 3],120,-1,177,-1,160
1,<environment.Job instance at 0x7fb6520805f0>,116,23,[9 5],117,-1,183,-1,160
1,<environment.Job instance at 0x7fb652c25410>,122,18,[1 6],123,-1,178,-1,160
1,<environment.Job instance at 0x7fb65212e280>,125,16,[7 4],126,-1,176,-1,160
1,<environment.Job instance at 0x7fb6526af910>,123,17,[10  3],124,-1,177,-1,160
1,<environment.Job instance at 0x7fb65212e190>,126,13,[4 6],127,-1,173,-1,160
1,<environment.Job instance at 0x7fb6530b8aa0>,6,3,[14  4],7,-1,10,-1,7
1,<environment.Job instance at 0x7fb652e4eaa0>,4,23,[2 9],5,-1,42,-1,19
1,<environment.Job instance at 0x7fb65203b870>,18,26,[2 5],19,-1,75,-1,49
1,<environment.Job instance at 0x7fb65203bcd0>,20,28,[1 5],21,-1,77,-1,49
1,<environment.Job instance at 0x7fb652a84190>,27,28,[ 1 10],28,-1,91,-1,63
1,<environment.Job instance at 0x7fb65203b2d0>,19,28,[4 8],20,-1,91,-1,63
1,<environment.Job instance at 0x7fb652806460>,73,24,[9 2],74,-1,237,-1,213
1,<environment.Job instance at 0x7fb6523b5d20>,81,24,[2 6],82,-1,258,-1,234
1,<environment.Job instance at 0x7fb652151320>,94,17,[11  5],95,-1,286,-1,269
1,<environment.Job instance at 0x7fb6521cc690>,95,15,[ 2 12],96,-1,284,-1,269
1,<environment.Job instance at 0x7fb6523ab190>,104,24,[5 8],105,-1,338,-1,314
1,<environment.Job instance at 0x7fb65207b5a0>,110,2,[14  3],111,-1,319,-1,317
1,<environment.Job instance at 0x7fb652c42280>,106,24,[10  2],107,-1,351,-1,327
1,<environment.Job instance at 0x7fb6523591e0>,116,23,[9 5],117,-1,368,-1,345
1,<environment.Job instance at 0x7fb6520b06e0>,3,27,[5 6],4,-1,31,-1,4
1,<environment.Job instance at 0x7fb652585050>,17,18,[4 5],18,-1,37,-1,19
1,<environment.Job instance at 0x7fb652585e60>,19,17,[7 5],20,-1,37,-1,20
1,<environment.Job instance at 0x7fb652585fa0>,18,15,[5 4],19,-1,36,-1,21
1,<environment.Job instance at 0x7fb652585730>,25,27,[4 6],26,-1,118,-1,91
1,<environment.Job instance at 0x7fb652e98410>,3,27,[5 6],4,-1,31,-1,4
1,<environment.Job instance at 0x7fb652142140>,6,16,[ 3 11],7,-1,23,-1,7
1,<environment.Job instance at 0x7fb6533d4460>,8,25,[11  1],9,-1,34,-1,9
1,<environment.Job instance at 0x7fb6536eb1e0>,20,18,[12  3],21,-1,39,-1,21
1,<environment.Job instance at 0x7fb6536d2320>,14,27,[3 8],15,-1,62,-1,35
1,<environment.Job instance at 0x7fb653481870>,25,27,[4 6],26,-1,75,-1,48
1,<environment.Job instance at 0x7fb653340e60>,40,14,[11  5],41,-1,111,-1,97
1,<environment.Job instance at 0x7fb652591a50>,44,28,[4 7],45,-1,154,-1,126
1,<environment.Job instance at 0x7fb65bed5230>,50,24,[9 4],51,-1,172,-1,148
1,<environment.Job instance at 0x7fb6536af500>,53,2,[12  3],54,-1,150,-1,148
1,<environment.Job instance at 0x7fb653441190>,61,16,[12  1],62,-1,199,-1,183
1,<environment.Job instance at 0x7fb6535a3b90>,88,3,[14  4],89,-1,285,-1,282
1,<environment.Job instance at 0x7fb65200ceb0>,90,14,[12  5],91,-1,299,-1,285
1,<environment.Job instance at 0x7fb6522fda50>,110,25,[ 4 10],111,-1,378,-1,353
1,<environment.Job instance at 0x7fb6534716e0>,114,14,[ 2 11],115,-1,369,-1,355
1,<environment.Job instance at 0x7fb6523a1e10>,120,17,[ 5 14],121,-1,400,-1,383
1,<environment.Job instance at 0x7fb652d60e10>,1,14,[4 8],2,-1,16,-1,2
1,<environment.Job instance at 0x7fb652848c30>,15,18,[7 4],16,-1,37,-1,19
1,<environment.Job instance at 0x7fb652403910>,19,17,[4 6],20,-1,37,-1,20
1,<environment.Job instance at 0x7fb653042e10>,25,17,[4 6],26,-1,43,-1,26
1,<environment.Job instance at 0x7fb65210c320>,26,15,[10  5],27,-1,47,-1,32
1,<environment.Job instance at 0x7fb6522e8c80>,32,17,[ 1 10],33,-1,50,-1,33
1,<environment.Job instance at 0x7fb6534aa370>,34,15,[7 5],35,-1,50,-1,35
1,<environment.Job instance at 0x7fb652564640>,35,15,[7 1],36,-1,51,-1,36
1,<environment.Job instance at 0x7fb652e4eb90>,36,15,[5 5],37,-1,52,-1,37
1,<environment.Job instance at 0x7fb652e4e4b0>,37,17,[9 4],38,-1,55,-1,38
1,<environment.Job instance at 0x7fb652e4e460>,40,18,[2 9],41,-1,59,-1,41
1,<environment.Job instance at 0x7fb652e4ec80>,42,16,[2 8],43,-1,59,-1,43
1,<environment.Job instance at 0x7fb6522ce2d0>,44,14,[7 2],45,-1,59,-1,45
1,<environment.Job instance at 0x7fb6520f21e0>,46,13,[10  2],47,-1,60,-1,47
1,<environment.Job instance at 0x7fb652080190>,49,20,[7 2],50,-1,70,-1,50
1,<environment.Job instance at 0x7fb6520f2d20>,50,16,[1 9],51,-1,67,-1,51
1,<environment.Job instance at 0x7fb652608cd0>,51,12,[6 3],52,-1,64,-1,52
1,<environment.Job instance at 0x7fb6526088c0>,52,16,[5 3],53,-1,69,-1,53
1,<environment.Job instance at 0x7fb653654820>,53,15,[9 4],54,-1,69,-1,54
1,<environment.Job instance at 0x7fb6523ab410>,31,13,[ 3 11],32,-1,72,-1,59
1,<environment.Job instance at 0x7fb6522c7eb0>,60,13,[ 2 13],61,-1,75,-1,62
1,<environment.Job instance at 0x7fb6522c7320>,62,17,[5 8],63,-1,88,-1,71
1,<environment.Job instance at 0x7fb6522c70f0>,61,14,[ 5 10],62,-1,87,-1,73
1,<environment.Job instance at 0x7fb6522c7140>,63,14,[5 7],64,-1,87,-1,73
1,<environment.Job instance at 0x7fb6522c7780>,58,22,[ 3 10],59,-1,95,-1,73
1,<environment.Job instance at 0x7fb6522c7050>,64,19,[3 7],65,-1,95,-1,76
1,<environment.Job instance at 0x7fb6522c72d0>,68,16,[1 9],69,-1,92,-1,76
1,<environment.Job instance at 0x7fb6522c7820>,70,28,[2 6],71,-1,104,-1,76
1,<environment.Job instance at 0x7fb6522c7cd0>,66,1,[6 5],67,-1,77,-1,76
1,<environment.Job instance at 0x7fb652e91e10>,75,15,[4 9],76,-1,92,-1,77
1,<environment.Job instance at 0x7fb6534f01e0>,76,16,[6 2],77,-1,96,-1,80
1,<environment.Job instance at 0x7fb6522c76e0>,69,16,[1 8],70,-1,97,-1,81
1,<environment.Job instance at 0x7fb6525ea690>,83,19,[3 9],84,-1,109,-1,90
1,<environment.Job instance at 0x7fb6522c70a0>,67,23,[3 5],68,-1,113,-1,90
1,<environment.Job instance at 0x7fb6525ea3c0>,85,17,[9 1],86,-1,108,-1,91
1,<environment.Job instance at 0x7fb6525ea910>,89,18,[5 3],90,-1,109,-1,91
1,<environment.Job instance at 0x7fb652c42690>,91,20,[10  2],92,-1,112,-1,92
1,<environment.Job instance at 0x7fb6525eaa50>,79,23,[8 2],80,-1,117,-1,94
1,<environment.Job instance at 0x7fb652c42190>,94,14,[ 3 10],95,-1,110,-1,96
1,<environment.Job instance at 0x7fb6525ea500>,86,12,[3 9],87,-1,111,-1,99
1,<environment.Job instance at 0x7fb652c42050>,93,15,[ 3 14],94,-1,117,-1,102
1,<environment.Job instance at 0x7fb652c42f00>,95,15,[2 6],96,-1,117,-1,102
1,<environment.Job instance at 0x7fb652c424b0>,97,18,[1 8],98,-1,120,-1,102
1,<environment.Job instance at 0x7fb6525eac80>,80,1,[13  1],81,-1,113,-1,112
1,<environment.Job instance at 0x7fb652159820>,108,27,[6 3],109,-1,139,-1,112
1,<environment.Job instance at 0x7fb6521591e0>,109,27,[3 5],110,-1,139,-1,112
1,<environment.Job instance at 0x7fb652c42dc0>,100,18,[8 3],101,-1,130,-1,112
1,<environment.Job instance at 0x7fb6521590a0>,107,20,[1 5],108,-1,132,-1,112
1,<environment.Job instance at 0x7fb6526f1d20>,6,16,[12  5],7,-1,23,-1,7
1,<environment.Job instance at 0x7fb65223eaf0>,9,28,[4 8],10,-1,44,-1,16
1,<environment.Job instance at 0x7fb65215ab40>,24,12,[ 4 13],25,-1,48,-1,36
1,<environment.Job instance at 0x7fb651f9ad20>,30,2,[ 2 12],31,-1,46,-1,44
1,<environment.Job instance at 0x7fb6522fd960>,31,13,[ 3 11],32,-1,57,-1,44
1,<environment.Job instance at 0x7fb652e01d20>,45,1,[14  5],46,-1,120,-1,119
1,<environment.Job instance at 0x7fb65363bcd0>,47,2,[ 5 12],48,-1,132,-1,130
1,<environment.Job instance at 0x7fb652da8d70>,55,2,[ 2 12],56,-1,160,-1,158
1,<environment.Job instance at 0x7fb653441f00>,60,13,[ 2 13],61,-1,179,-1,166
1,<environment.Job instance at 0x7fb653845d70>,67,23,[3 5],68,-1,224,-1,201
1,<environment.Job instance at 0x7fb651fb0320>,70,28,[2 6],71,-1,254,-1,226
1,<environment.Job instance at 0x7fb65c3d2050>,80,1,[13  1],81,-1,248,-1,247
1,<environment.Job instance at 0x7fb65c3d2e60>,79,23,[8 2],80,-1,272,-1,249
1,<environment.Job instance at 0x7fb652033d70>,93,15,[ 3 14],94,-1,304,-1,289
1,<environment.Job instance at 0x7fb652151c80>,98,3,[13  1],99,-1,318,-1,315
1,<environment.Job instance at 0x7fb652151230>,105,15,[14  4],106,-1,349,-1,334
1,<environment.Job instance at 0x7fb6521510a0>,108,27,[6 3],109,-1,378,-1,351
1,<environment.Job instance at 0x7fb652151be0>,109,27,[3 5],110,-1,378,-1,351
1,<environment.Job instance at 0x7fb6526af780>,112,2,[12  2],113,-1,353,-1,351
1,<environment.Job instance at 0x7fb6526af5f0>,120,23,[5 8],121,-1,408,-1,385
1,<environment.Job instance at 0x7fb6526af2d0>,127,12,[ 2 14],128,-1,424,-1,412
1,<environment.Job instance at 0x7fb65218f820>,1,14,[9 3],2,-1,17,-1,3
1,<environment.Job instance at 0x7fb65217c140>,6,13,[ 5 10],7,-1,20,-1,7
1,<environment.Job instance at 0x7fb65217cf50>,2,14,[ 3 10],3,-1,22,-1,8
1,<environment.Job instance at 0x7fb6521a1500>,12,16,[1 7],13,-1,29,-1,13
1,<environment.Job instance at 0x7fb6521a1280>,14,18,[2 5],15,-1,34,-1,16
1,<environment.Job instance at 0x7fb6521a1c80>,17,15,[10  1],18,-1,33,-1,18
1,<environment.Job instance at 0x7fb65219b460>,18,28,[9 5],19,-1,47,-1,19
1,<environment.Job instance at 0x7fb6521a1f00>,15,18,[2 9],16,-1,37,-1,19
1,<environment.Job instance at 0x7fb652fc84b0>,25,17,[8 3],26,-1,43,-1,26
1,<environment.Job instance at 0x7fb652fc8e10>,26,22,[4 9],27,-1,49,-1,27
1,<environment.Job instance at 0x7fb6524eee60>,32,18,[7 3],33,-1,51,-1,33
1,<environment.Job instance at 0x7fb652c9e7d0>,40,15,[8 2],41,-1,56,-1,41
1,<environment.Job instance at 0x7fb651fba1e0>,41,16,[4 9],42,-1,58,-1,42
1,<environment.Job instance at 0x7fb651fba2d0>,42,15,[9 5],43,-1,58,-1,43
1,<environment.Job instance at 0x7fb651fba140>,43,13,[3 7],44,-1,57,-1,44
1,<environment.Job instance at 0x7fb65218f280>,46,16,[ 5 10],47,-1,63,-1,47
1,<environment.Job instance at 0x7fb65218faf0>,47,13,[10  3],48,-1,63,-1,50
1,<environment.Job instance at 0x7fb652ca20a0>,50,17,[6 4],51,-1,68,-1,51
1,<environment.Job instance at 0x7fb652c94e60>,51,23,[9 2],52,-1,75,-1,52
1,<environment.Job instance at 0x7fb65218fbe0>,48,18,[10  5],49,-1,70,-1,52
1,<environment.Job instance at 0x7fb652c94140>,53,13,[8 4],54,-1,69,-1,56
1,<environment.Job instance at 0x7fb652c94320>,56,15,[7 3],57,-1,72,-1,57
1,<environment.Job instance at 0x7fb652514d20>,59,15,[ 5 10],60,-1,75,-1,60
1,<environment.Job instance at 0x7fb6521a15f0>,67,12,[ 4 10],68,-1,80,-1,68
1,<environment.Job instance at 0x7fb652c6b1e0>,69,17,[11  5],70,-1,87,-1,70
1,<environment.Job instance at 0x7fb652c6bf00>,70,18,[3 7],71,-1,89,-1,71
1,<environment.Job instance at 0x7fb652c68d70>,77,14,[4 9],78,-1,94,-1,80
1,<environment.Job instance at 0x7fb652c895a0>,80,17,[10  2],81,-1,98,-1,81
1,<environment.Job instance at 0x7fb652c6b550>,72,22,[ 4 11],73,-1,106,-1,84
1,<environment.Job instance at 0x7fb652c89500>,82,18,[1 5],83,-1,105,-1,87
1,<environment.Job instance at 0x7fb652c89460>,86,17,[5 8],87,-1,106,-1,89
1,<environment.Job instance at 0x7fb652fd6cd0>,90,20,[ 3 10],91,-1,111,-1,91
1,<environment.Job instance at 0x7fb652c94780>,55,25,[ 2 11],56,-1,118,-1,93
1,<environment.Job instance at 0x7fb652c865a0>,92,14,[11  5],93,-1,109,-1,95
1,<environment.Job instance at 0x7fb652c86320>,94,16,[9 5],95,-1,114,-1,98
1,<environment.Job instance at 0x7fb652c89af0>,84,22,[7 4],85,-1,122,-1,100
1,<environment.Job instance at 0x7fb652e30410>,99,18,[1 9],100,-1,119,-1,101
1,<environment.Job instance at 0x7fb652221320>,112,14,[ 2 11],113,-1,130,-1,116
1,<environment.Job instance at 0x7fb652c89f50>,87,16,[5 1],88,-1,132,-1,116
1,<environment.Job instance at 0x7fb652221280>,114,16,[9 1],115,-1,132,-1,116
1,<environment.Job instance at 0x7fb652aa7870>,18,28,[9 5],19,-1,78,-1,50
1,<environment.Job instance at 0x7fb652aa7aa0>,20,1,[11  1],21,-1,51,-1,50
1,<environment.Job instance at 0x7fb652aacc80>,37,1,[ 2 12],38,-1,77,-1,76
1,<environment.Job instance at 0x7fb652ae2050>,51,23,[9 2],52,-1,161,-1,138
1,<environment.Job instance at 0x7fb6538dc230>,55,25,[ 2 11],56,-1,169,-1,144
1,<environment.Job instance at 0x7fb6536eec30>,60,14,[13  1],61,-1,182,-1,168
1,<environment.Job instance at 0x7fb6536ee500>,63,12,[12  5],64,-1,183,-1,171
1,<environment.Job instance at 0x7fb6536ce960>,69,17,[11  5],70,-1,215,-1,198
1,<environment.Job instance at 0x7fb65383f9b0>,72,22,[ 4 11],73,-1,225,-1,203
1,<environment.Job instance at 0x7fb6536f7550>,76,15,[13  2],77,-1,236,-1,221
1,<environment.Job instance at 0x7fb6536fa8c0>,79,13,[ 5 11],80,-1,238,-1,225
1,<environment.Job instance at 0x7fb6534c1eb0>,83,3,[ 3 14],84,-1,242,-1,239
1,<environment.Job instance at 0x7fb6538a75f0>,88,17,[14  2],89,-1,261,-1,244
1,<environment.Job instance at 0x7fb6538430f0>,92,14,[11  5],93,-1,274,-1,260
1,<environment.Job instance at 0x7fb652c44d70>,107,1,[12  4],108,-1,292,-1,291
1,<environment.Job instance at 0x7fb652c469b0>,112,14,[ 2 11],113,-1,327,-1,313
1,<environment.Job instance at 0x7fb65382b320>,115,13,[ 3 14],116,-1,336,-1,323
1,<environment.Job instance at 0x7fb6526e57d0>,7,17,[10  4],8,-1,25,-1,8
1,<environment.Job instance at 0x7fb6526e5820>,8,17,[9 3],9,-1,26,-1,9
1,<environment.Job instance at 0x7fb65270e7d0>,9,18,[2 7],10,-1,28,-1,10
1,<environment.Job instance at 0x7fb65270e6e0>,10,16,[ 1 10],11,-1,28,-1,12
1,<environment.Job instance at 0x7fb65270e140>,13,23,[5 6],14,-1,37,-1,14
1,<environment.Job instance at 0x7fb65270e370>,16,16,[10  2],17,-1,33,-1,17
1,<environment.Job instance at 0x7fb6526e5730>,11,13,[4 5],12,-1,30,-1,17
1,<environment.Job instance at 0x7fb65270eb90>,19,17,[10  1],20,-1,38,-1,21
1,<environment.Job instance at 0x7fb65270ed20>,22,14,[9 2],23,-1,42,-1,28
1,<environment.Job instance at 0x7fb652ff5500>,27,14,[10  2],28,-1,42,-1,28
1,<environment.Job instance at 0x7fb652ff5640>,29,15,[4 9],30,-1,45,-1,30
1,<environment.Job instance at 0x7fb652ff5cd0>,31,17,[9 4],32,-1,49,-1,32
1,<environment.Job instance at 0x7fb6521fd1e0>,35,16,[3 7],36,-1,52,-1,36
1,<environment.Job instance at 0x7fb6521fd460>,36,13,[9 1],37,-1,52,-1,39
1,<environment.Job instance at 0x7fb6521fddc0>,37,18,[10  3],38,-1,57,-1,39
1,<environment.Job instance at 0x7fb6521fdb90>,44,24,[4 8],45,-1,69,-1,45
1,<environment.Job instance at 0x7fb652fd1d20>,46,23,[9 2],47,-1,70,-1,47
1,<environment.Job instance at 0x7fb652fd12d0>,47,18,[3 6],48,-1,66,-1,48
1,<environment.Job instance at 0x7fb652fd19b0>,48,14,[10  1],49,-1,64,-1,50
1,<environment.Job instance at 0x7fb652fd1500>,50,28,[8 5],51,-1,79,-1,51
1,<environment.Job instance at 0x7fb652fd1e60>,51,16,[6 2],52,-1,68,-1,52
1,<environment.Job instance at 0x7fb652fd1690>,52,2,[8 5],53,-1,55,-1,53
1,<environment.Job instance at 0x7fb652fd1a00>,53,17,[ 5 12],54,-1,71,-1,54
1,<environment.Job instance at 0x7fb652fd1410>,54,18,[ 4 13],55,-1,73,-1,55
1,<environment.Job instance at 0x7fb652fd1be0>,55,14,[ 2 10],56,-1,70,-1,56
1,<environment.Job instance at 0x7fb652fd1b40>,56,17,[9 4],57,-1,74,-1,57
1,<environment.Job instance at 0x7fb652fd17d0>,57,2,[2 5],58,-1,60,-1,58
1,<environment.Job instance at 0x7fb652fd1370>,58,14,[ 1 10],59,-1,73,-1,59
1,<environment.Job instance at 0x7fb652fd16e0>,59,2,[3 7],60,-1,62,-1,60
1,<environment.Job instance at 0x7fb652fd10f0>,60,13,[ 4 10],61,-1,74,-1,61
1,<environment.Job instance at 0x7fb652fd18c0>,61,16,[4 7],62,-1,78,-1,62
1,<environment.Job instance at 0x7fb652fd1460>,62,17,[10  4],63,-1,80,-1,63
1,<environment.Job instance at 0x7fb65271da00>,63,13,[ 4 10],64,-1,77,-1,64
1,<environment.Job instance at 0x7fb652fd11e0>,49,27,[ 5 10],50,-1,92,-1,65
1,<environment.Job instance at 0x7fb65271df50>,68,18,[4 7],69,-1,87,-1,69
1,<environment.Job instance at 0x7fb65271d0a0>,70,21,[9 2],71,-1,95,-1,74
1,<environment.Job instance at 0x7fb65271d2d0>,74,15,[3 5],75,-1,90,-1,75
1,<environment.Job instance at 0x7fb65271ddc0>,73,18,[ 4 10],74,-1,93,-1,75
1,<environment.Job instance at 0x7fb65271dfa0>,76,26,[3 5],77,-1,103,-1,77
1,<environment.Job instance at 0x7fb652ff2370>,77,24,[9 4],78,-1,102,-1,78
1,<environment.Job instance at 0x7fb652ff23c0>,80,15,[1 8],81,-1,96,-1,81
1,<environment.Job instance at 0x7fb652ff2320>,84,17,[3 5],85,-1,102,-1,85
1,<environment.Job instance at 0x7fb652ff28c0>,85,18,[ 3 10],86,-1,104,-1,86
1,<environment.Job instance at 0x7fb652ff2be0>,88,1,[12  1],89,-1,90,-1,89
1,<environment.Job instance at 0x7fb652c8a280>,91,2,[2 5],92,-1,94,-1,92
1,<environment.Job instance at 0x7fb652c8a190>,92,13,[9 5],93,-1,106,-1,93
1,<environment.Job instance at 0x7fb652c8aa00>,93,12,[ 3 10],94,-1,106,-1,94
1,<environment.Job instance at 0x7fb652c8a910>,94,1,[7 2],95,-1,96,-1,95
1,<environment.Job instance at 0x7fb652c8ac80>,95,1,[6 4],96,-1,97,-1,96
1,<environment.Job instance at 0x7fb652c8a500>,97,17,[8 4],98,-1,115,-1,98
1,<environment.Job instance at 0x7fb652c8adc0>,99,14,[1 5],100,-1,114,-1,100
1,<environment.Job instance at 0x7fb652c8a8c0>,101,16,[1 8],102,-1,118,-1,102
1,<environment.Job instance at 0x7fb652c8ab90>,103,24,[5 1],104,-1,128,-1,104
1,<environment.Job instance at 0x7fb652770d20>,105,22,[5 4],106,-1,128,-1,106
1,<environment.Job instance at 0x7fb652770eb0>,106,28,[8 5],107,-1,135,-1,107
1,<environment.Job instance at 0x7fb65c4b3eb0>,110,18,[5 8],111,-1,129,-1,111
1,<environment.Job instance at 0x7fb652b0c780>,114,25,[9 4],115,-1,140,-1,115
1,<environment.Job instance at 0x7fb652c949b0>,119,14,[8 1],120,-1,135,-1,121
1,<environment.Job instance at 0x7fb652c65280>,124,12,[4 9],125,-1,137,-1,125
1,<environment.Job instance at 0x7fb652c68b40>,127,13,[2 7],128,-1,141,-1,128
1,<environment.Job instance at 0x7fb652ff5eb0>,1,1,[12  1],2,-1,3,-1,2
1,<environment.Job instance at 0x7fb65271d6e0>,3,3,[ 3 12],4,-1,7,-1,4
1,<environment.Job instance at 0x7fb653410050>,13,23,[5 6],14,-1,48,-1,25
1,<environment.Job instance at 0x7fb65c395b40>,20,2,[13  2],21,-1,40,-1,38
1,<environment.Job instance at 0x7fb65249dfa0>,23,1,[14  1],24,-1,43,-1,42
1,<environment.Job instance at 0x7fb6531ceeb0>,38,2,[ 4 11],39,-1,106,-1,104
1,<environment.Job instance at 0x7fb652878af0>,40,12,[ 1 14],41,-1,118,-1,106
1,<environment.Job instance at 0x7fb65c2415a0>,42,2,[ 1 14],43,-1,121,-1,119
1,<environment.Job instance at 0x7fb6534adb90>,44,24,[4 8],45,-1,145,-1,121
1,<environment.Job instance at 0x7fb6534ad870>,46,23,[9 2],47,-1,156,-1,133
1,<environment.Job instance at 0x7fb65313fdc0>,49,27,[ 5 10],50,-1,180,-1,153
1,<environment.Job instance at 0x7fb65313f640>,50,28,[8 5],51,-1,192,-1,164
1,<environment.Job instance at 0x7fb652107af0>,53,17,[ 5 12],54,-1,181,-1,164
1,<environment.Job instance at 0x7fb65c4a9320>,54,18,[ 4 13],55,-1,182,-1,164
1,<environment.Job instance at 0x7fb6520b93c0>,76,26,[3 5],77,-1,294,-1,268
1,<environment.Job instance at 0x7fb6520b9910>,77,24,[9 4],78,-1,292,-1,268
1,<environment.Job instance at 0x7fb6520a8af0>,88,1,[12  1],89,-1,299,-1,298
1,<environment.Job instance at 0x7fb652104140>,103,24,[5 1],104,-1,360,-1,336
1,<environment.Job instance at 0x7fb652d32730>,106,28,[8 5],107,-1,367,-1,339
1,<environment.Job instance at 0x7fb65382f8c0>,114,25,[9 4],115,-1,395,-1,370
1,<environment.Job instance at 0x7fb651fb28c0>,116,18,[11  2],117,-1,388,-1,370
1,<environment.Job instance at 0x7fb6536e0fa0>,118,15,[ 1 14],119,-1,385,-1,370
1,<environment.Job instance at 0x7fb651f72e10>,123,2,[ 2 13],124,-1,387,-1,385
1,<environment.Job instance at 0x7fb652fecc80>,5,27,[4 6],6,-1,33,-1,6
1,<environment.Job instance at 0x7fb652fec910>,7,17,[2 8],8,-1,26,-1,9
1,<environment.Job instance at 0x7fb652fecd70>,8,18,[5 5],9,-1,27,-1,9
1,<environment.Job instance at 0x7fb6521631e0>,11,18,[8 2],12,-1,31,-1,13
1,<environment.Job instance at 0x7fb652163550>,13,15,[4 8],14,-1,29,-1,14
1,<environment.Job instance at 0x7fb652c96690>,17,17,[2 5],18,-1,35,-1,18
1,<environment.Job instance at 0x7fb652c960a0>,19,17,[9 4],20,-1,37,-1,20
1,<environment.Job instance at 0x7fb652c96aa0>,20,15,[10  4],21,-1,36,-1,21
1,<environment.Job instance at 0x7fb652c96780>,22,14,[1 8],23,-1,37,-1,23
1,<environment.Job instance at 0x7fb652c89320>,23,17,[7 4],24,-1,41,-1,24
1,<environment.Job instance at 0x7fb652163a50>,12,16,[ 1 10],13,-1,40,-1,24
1,<environment.Job instance at 0x7fb652c89870>,31,23,[5 2],32,-1,56,-1,33
1,<environment.Job instance at 0x7fb652c89280>,33,28,[10  4],34,-1,62,-1,34
1,<environment.Job instance at 0x7fb652c865a0>,37,17,[9 5],38,-1,55,-1,38
1,<environment.Job instance at 0x7fb652c86e10>,38,18,[ 4 13],39,-1,57,-1,39
1,<environment.Job instance at 0x7fb652c86f50>,39,14,[ 1 10],40,-1,54,-1,40
1,<environment.Job instance at 0x7fb6521a1870>,43,15,[5 6],44,-1,59,-1,44
1,<environment.Job instance at 0x7fb6521a1f00>,44,16,[10  5],45,-1,61,-1,45
1,<environment.Job instance at 0x7fb6521a12d0>,46,18,[10  3],47,-1,65,-1,47
1,<environment.Job instance at 0x7fb6521a16e0>,50,14,[5 6],51,-1,65,-1,51
1,<environment.Job instance at 0x7fb6521a1730>,51,19,[10  5],52,-1,71,-1,52
1,<environment.Job instance at 0x7fb6534b20f0>,56,15,[5 8],57,-1,72,-1,57
1,<environment.Job instance at 0x7fb651fc1be0>,57,13,[ 1 10],58,-1,71,-1,58
1,<environment.Job instance at 0x7fb651fc1230>,59,17,[2 5],60,-1,77,-1,60
1,<environment.Job instance at 0x7fb651fc1410>,60,13,[ 2 10],61,-1,74,-1,61
1,<environment.Job instance at 0x7fb651fc1690>,61,18,[4 5],62,-1,80,-1,62
1,<environment.Job instance at 0x7fb65210c230>,66,18,[3 7],67,-1,85,-1,67
1,<environment.Job instance at 0x7fb65210caf0>,68,12,[2 6],69,-1,81,-1,69
1,<environment.Job instance at 0x7fb65210c3c0>,69,18,[6 5],70,-1,88,-1,70
1,<environment.Job instance at 0x7fb65210c2d0>,70,15,[5 5],71,-1,86,-1,71
1,<environment.Job instance at 0x7fb65210c370>,72,14,[4 6],73,-1,87,-1,73
1,<environment.Job instance at 0x7fb65210cb90>,74,24,[5 9],75,-1,99,-1,75
1,<environment.Job instance at 0x7fb65210cc30>,75,18,[1 6],76,-1,94,-1,76
1,<environment.Job instance at 0x7fb65210c050>,76,28,[9 5],77,-1,105,-1,77
1,<environment.Job instance at 0x7fb65210c870>,77,13,[1 7],78,-1,91,-1,78
1,<environment.Job instance at 0x7fb65210c140>,79,17,[5 2],80,-1,97,-1,80
1,<environment.Job instance at 0x7fb65210c8c0>,81,18,[9 3],82,-1,100,-1,82
1,<environment.Job instance at 0x7fb6523db6e0>,82,17,[4 8],83,-1,100,-1,83
1,<environment.Job instance at 0x7fb6523dbf00>,83,18,[8 3],84,-1,102,-1,84
1,<environment.Job instance at 0x7fb6523db500>,85,15,[2 7],86,-1,101,-1,86
1,<environment.Job instance at 0x7fb65228adc0>,91,14,[1 7],92,-1,106,-1,92
1,<environment.Job instance at 0x7fb65228ad70>,93,18,[2 6],94,-1,112,-1,94
1,<environment.Job instance at 0x7fb65228af00>,94,13,[1 6],95,-1,108,-1,95
1,<environment.Job instance at 0x7fb6521385a0>,97,18,[3 8],98,-1,116,-1,98
1,<environment.Job instance at 0x7fb6521540f0>,99,15,[10  3],100,-1,115,-1,100
1,<environment.Job instance at 0x7fb652fe6e60>,101,17,[9 5],102,-1,119,-1,102
1,<environment.Job instance at 0x7fb652fe6190>,102,19,[1 5],103,-1,122,-1,103
1,<environment.Job instance at 0x7fb6521509b0>,105,16,[ 4 10],106,-1,122,-1,106
1,<environment.Job instance at 0x7fb6524ee6e0>,108,16,[8 1],109,-1,125,-1,109
1,<environment.Job instance at 0x7fb6524ee8c0>,109,14,[9 3],110,-1,124,-1,110
1,<environment.Job instance at 0x7fb653805be0>,111,14,[7 4],112,-1,126,-1,112
1,<environment.Job instance at 0x7fb6524eea50>,112,12,[2 8],113,-1,125,-1,113
1,<environment.Job instance at 0x7fb651fafd70>,113,23,[5 6],114,-1,137,-1,114
1,<environment.Job instance at 0x7fb651faf2d0>,114,15,[5 2],115,-1,130,-1,115
1,<environment.Job instance at 0x7fb6535beeb0>,118,28,[3 8],119,-1,147,-1,119
1,<environment.Job instance at 0x7fb652f43140>,119,16,[ 5 10],120,-1,136,-1,120
1,<environment.Job instance at 0x7fb65310b5a0>,120,13,[2 9],121,-1,134,-1,121
1,<environment.Job instance at 0x7fb652f43780>,123,23,[5 7],124,-1,147,-1,124
1,<environment.Job instance at 0x7fb65363ba50>,124,28,[8 5],125,-1,153,-1,125
1,<environment.Job instance at 0x7fb652314d70>,126,23,[3 7],127,-1,150,-1,127
1,<environment.Job instance at 0x7fb6538b1b90>,127,24,[2 9],128,-1,152,-1,128
1,<environment.Job instance at 0x7fb6538b1550>,128,17,[8 1],129,-1,146,-1,129
1,<environment.Job instance at 0x7fb6521a1e10>,5,27,[4 6],6,-1,33,-1,6
1,<environment.Job instance at 0x7fb652fe60a0>,9,24,[9 1],10,-1,54,-1,30
1,<environment.Job instance at 0x7fb652fec640>,18,1,[ 2 12],19,-1,31,-1,30
1,<environment.Job instance at 0x7fb652104140>,26,13,[11  2],27,-1,72,-1,59
1,<environment.Job instance at 0x7fb653497b90>,31,23,[5 2],32,-1,98,-1,75
1,<environment.Job instance at 0x7fb6534979b0>,32,17,[ 5 14],33,-1,92,-1,75
1,<environment.Job instance at 0x7fb6534975a0>,33,28,[10  4],34,-1,103,-1,75
1,<environment.Job instance at 0x7fb652edb780>,38,18,[ 4 13],39,-1,96,-1,78
1,<environment.Job instance at 0x7fb6529a4a50>,74,24,[5 9],75,-1,236,-1,212
1,<environment.Job instance at 0x7fb65c395b90>,76,28,[9 5],77,-1,257,-1,229
1,<environment.Job instance at 0x7fb652699eb0>,106,14,[14  5],107,-1,351,-1,337
1,<environment.Job instance at 0x7fb6520ddeb0>,113,23,[5 6],114,-1,405,-1,382
1,<environment.Job instance at 0x7fb652acab40>,118,28,[3 8],119,-1,433,-1,405
1,<environment.Job instance at 0x7fb65223a320>,123,23,[5 7],124,-1,444,-1,421
1,<environment.Job instance at 0x7fb65223a410>,124,28,[8 5],125,-1,461,-1,433
1,<environment.Job instance at 0x7fb65223ac80>,126,23,[3 7],127,-1,457,-1,434
1,<environment.Job instance at 0x7fb65223aa50>,127,24,[2 9],128,-1,458,-1,434
1,<environment.Job instance at 0x7f3878b6a6e0>,0,13,[9 3],1,-1,15,-1,2
1,<environment.Job instance at 0x7f3878b6a8c0>,1,22,[11  3],2,-1,24,-1,2
1,<environment.Job instance at 0x7f3878b6a730>,2,22,[4 8],3,-1,25,-1,3
1,<environment.Job instance at 0x7f386f57afa0>,9,18,[11  5],10,-1,28,-1,10
1,<environment.Job instance at 0x7f386f57d0f0>,11,15,[4 8],12,-1,27,-1,12
1,<environment.Job instance at 0x7f386f57d320>,12,26,[ 1 10],13,-1,39,-1,13
1,<environment.Job instance at 0x7f386f57d230>,13,18,[ 4 10],14,-1,32,-1,14
1,<environment.Job instance at 0x7f386f57d460>,15,18,[2 8],16,-1,34,-1,16
1,<environment.Job instance at 0x7f386f57d640>,16,16,[3 5],17,-1,33,-1,17
1,<environment.Job instance at 0x7f386f57d870>,19,14,[3 5],20,-1,34,-1,20
1,<environment.Job instance at 0x7f386f57db90>,23,27,[1 6],24,-1,51,-1,24
1,<environment.Job instance at 0x7f386f57dc30>,24,18,[2 6],25,-1,43,-1,25
1,<environment.Job instance at 0x7f386f57dd70>,27,15,[8 4],28,-1,43,-1,28
1,<environment.Job instance at 0x7f386f580140>,28,23,[10  4],29,-1,52,-1,29
1,<environment.Job instance at 0x7f386f580280>,30,14,[5 2],31,-1,45,-1,31
1,<environment.Job instance at 0x7f386f580410>,31,14,[2 5],32,-1,46,-1,32
1,<environment.Job instance at 0x7f386f580190>,32,3,[5 1],33,-1,36,-1,33
1,<environment.Job instance at 0x7f386f580500>,33,14,[5 5],34,-1,48,-1,34
1,<environment.Job instance at 0x7f386f5805a0>,34,24,[1 8],35,-1,59,-1,35
1,<environment.Job instance at 0x7f386f580640>,35,15,[9 5],36,-1,51,-1,36
1,<environment.Job instance at 0x7f386f580b40>,40,15,[10  3],41,-1,59,-1,44
1,<environment.Job instance at 0x7f386f580cd0>,43,18,[5 5],44,-1,62,-1,44
1,<environment.Job instance at 0x7f386f582230>,48,15,[10  1],49,-1,65,-1,50
1,<environment.Job instance at 0x7f386f5827d0>,53,17,[5 7],54,-1,71,-1,54
1,<environment.Job instance at 0x7f386f582a00>,56,17,[8 5],57,-1,74,-1,57
1,<environment.Job instance at 0x7f386f5840a0>,62,22,[6 4],63,-1,85,-1,63
1,<environment.Job instance at 0x7f386f584190>,64,18,[2 9],65,-1,83,-1,65
1,<environment.Job instance at 0x7f386f584410>,65,20,[2 6],66,-1,86,-1,66
1,<environment.Job instance at 0x7f386f589280>,83,20,[7 1],84,-1,163,-1,143
1,<environment.Job instance at 0x7f386f584f50>,79,13,[9 4],80,-1,156,-1,143
1,<environment.Job instance at 0x7f386f584e60>,76,19,[4 8],77,-1,162,-1,143
1,<environment.Job instance at 0x7f386f5893c0>,85,17,[3 9],86,-1,167,-1,150
1,<environment.Job instance at 0x7f386f589140>,81,15,[5 9],82,-1,165,-1,150
1,<environment.Job instance at 0x7f386f5899b0>,92,20,[1 5],93,-1,170,-1,150
1,<environment.Job instance at 0x7f386f589460>,86,18,[9 2],87,-1,168,-1,150
1,<environment.Job instance at 0x7f386f589aa0>,95,15,[5 7],96,-1,166,-1,151
1,<environment.Job instance at 0x7f386f589640>,89,14,[5 3],90,-1,169,-1,155
1,<environment.Job instance at 0x7f386f589e60>,100,18,[2 7],101,-1,173,-1,155
1,<environment.Job instance at 0x7f386f589e10>,102,16,[3 9],103,-1,171,-1,155
1,<environment.Job instance at 0x7f386f589dc0>,99,18,[12  5],100,-1,173,-1,155
1,<environment.Job instance at 0x7f386f58a0a0>,103,16,[1 6],104,-1,171,-1,155
1,<environment.Job instance at 0x7f386f6471e0>,111,26,[ 5 10],112,-1,231,-1,205
1,<environment.Job instance at 0x7f386f69f460>,125,21,[4 5],126,-1,226,-1,205
1,<environment.Job instance at 0x7f386f7ada00>,127,22,[4 5],128,-1,228,-1,206
1,<environment.Job instance at 0x7f386f687230>,130,15,[8 3],131,-1,222,-1,207
1,<environment.Job instance at 0x7f386f57d730>,1,22,[11  3],2,-1,24,-1,2
1,<environment.Job instance at 0x7f386f582eb0>,9,18,[11  5],10,-1,32,-1,14
1,<environment.Job instance at 0x7f386f584140>,12,26,[ 1 10],13,-1,82,-1,56
1,<environment.Job instance at 0x7f386f5a2960>,23,27,[1 6],24,-1,87,-1,60
1,<environment.Job instance at 0x7f386f6a1230>,28,23,[10  4],29,-1,97,-1,74
1,<environment.Job instance at 0x7f386f62a640>,34,24,[1 8],35,-1,117,-1,93
1,<environment.Job instance at 0x7f386f629cd0>,36,13,[ 3 14],37,-1,106,-1,93
1,<environment.Job instance at 0x7f386f628690>,46,17,[12  2],47,-1,134,-1,117
1,<environment.Job instance at 0x7f386f5db780>,50,16,[12  2],51,-1,146,-1,130
1,<environment.Job instance at 0x7f386f5b5410>,54,13,[13  1],55,-1,158,-1,145
1,<environment.Job instance at 0x7f386f5bfd20>,60,3,[12  3],61,-1,169,-1,166
1,<environment.Job instance at 0x7f386f5574b0>,67,27,[ 1 10],68,-1,216,-1,189
1,<environment.Job instance at 0x7f386f568370>,69,13,[ 3 12],70,-1,202,-1,189
1,<environment.Job instance at 0x7f386f5d3e10>,75,14,[ 4 11],76,-1,215,-1,201
1,<environment.Job instance at 0x7f386f56a5f0>,97,2,[ 5 11],98,-1,294,-1,292
1,<environment.Job instance at 0x7f386f56a9b0>,99,18,[12  5],100,-1,312,-1,294
1,<environment.Job instance at 0x7f386f56a960>,105,14,[14  5],106,-1,341,-1,327
1,<environment.Job instance at 0x7f386f58a550>,106,15,[11  1],107,-1,342,-1,327
1,<environment.Job instance at 0x7f386f58acd0>,116,3,[ 1 12],117,-1,363,-1,360
1,<environment.Job instance at 0x7f386f58a910>,111,26,[ 5 10],112,-1,396,-1,370
1,<environment.Job instance at 0x7f386f517050>,122,3,[ 4 12],123,-1,377,-1,374
1,<environment.Job instance at 0x7f386f517140>,123,12,[ 4 11],124,-1,386,-1,374
1,<environment.Job instance at 0x7f386f517460>,128,23,[ 2 14],129,-1,419,-1,396
1,<environment.Job instance at 0x7f386f517b40>,138,16,[11  2],139,-1,447,-1,431
1,<environment.Job instance at 0x7f386ef8c2d0>,0,16,[2 8],1,-1,18,-1,2
1,<environment.Job instance at 0x7f386ef53d70>,3,15,[ 1 12],4,-1,19,-1,4
1,<environment.Job instance at 0x7f386f51fc30>,1,13,[5 6],2,-1,17,-1,4
1,<environment.Job instance at 0x7f386ef11b40>,6,17,[1 7],7,-1,24,-1,7
1,<environment.Job instance at 0x7f386efdd230>,11,15,[10  4],12,-1,27,-1,12
1,<environment.Job instance at 0x7f386efddb90>,14,14,[8 4],15,-1,29,-1,15
1,<environment.Job instance at 0x7f386efddbe0>,18,14,[9 5],19,-1,33,-1,19
1,<environment.Job instance at 0x7f386efe6410>,21,15,[1 7],22,-1,37,-1,22
1,<environment.Job instance at 0x7f386efeb230>,28,19,[6 4],29,-1,48,-1,29
1,<environment.Job instance at 0x7f386efeb780>,31,2,[5 5],32,-1,34,-1,32
1,<environment.Job instance at 0x7f386efeb410>,33,18,[6 5],34,-1,52,-1,34
1,<environment.Job instance at 0x7f386efeb4b0>,34,19,[6 1],35,-1,54,-1,35
1,<environment.Job instance at 0x7f386efeb640>,35,16,[ 2 10],36,-1,52,-1,36
1,<environment.Job instance at 0x7f386efeb9b0>,37,21,[ 3 10],38,-1,59,-1,38
1,<environment.Job instance at 0x7f386efebb40>,39,14,[2 6],40,-1,54,-1,40
1,<environment.Job instance at 0x7f386f047a50>,41,13,[8 5],42,-1,55,-1,42
1,<environment.Job instance at 0x7f386efff190>,48,21,[9 4],49,-1,70,-1,49
1,<environment.Job instance at 0x7f386ef229b0>,49,12,[9 3],50,-1,62,-1,50
1,<environment.Job instance at 0x7f386ef227d0>,50,18,[10  3],51,-1,69,-1,51
1,<environment.Job instance at 0x7f386f191b90>,51,17,[10  2],52,-1,69,-1,52
1,<environment.Job instance at 0x7f386edf2460>,54,12,[3 8],55,-1,67,-1,55
1,<environment.Job instance at 0x7f3878bb02d0>,56,14,[5 5],57,-1,71,-1,57
1,<environment.Job instance at 0x7f3878ce5410>,60,13,[10  5],61,-1,75,-1,62
1,<environment.Job instance at 0x7f386ebfc460>,62,14,[2 7],63,-1,77,-1,63
1,<environment.Job instance at 0x7f386ebfc320>,63,14,[7 5],64,-1,78,-1,64
1,<environment.Job instance at 0x7f386f467f00>,65,14,[10  2],66,-1,80,-1,66
1,<environment.Job instance at 0x7f386eb85d20>,74,16,[7 2],75,-1,91,-1,75
1,<environment.Job instance at 0x7f386eb2b640>,80,18,[4 5],81,-1,99,-1,81
1,<environment.Job instance at 0x7f386eb2b8c0>,81,18,[2 8],82,-1,100,-1,82
1,<environment.Job instance at 0x7f386eb2b780>,83,14,[11  3],84,-1,102,-1,88
1,<environment.Job instance at 0x7f386ec570f0>,84,16,[9 4],85,-1,105,-1,89
1,<environment.Job instance at 0x7f386ee1bc80>,61,14,[1 6],62,-1,103,-1,89
1,<environment.Job instance at 0x7f386eb29e10>,88,15,[7 5],89,-1,105,-1,90
1,<environment.Job instance at 0x7f386eb29960>,89,13,[6 3],90,-1,103,-1,90
1,<environment.Job instance at 0x7f386eb293c0>,92,20,[1 7],93,-1,113,-1,93
1,<environment.Job instance at 0x7f386eb29640>,90,13,[7 4],91,-1,110,-1,97
1,<environment.Job instance at 0x7f386eb2a550>,96,19,[2 7],97,-1,116,-1,97
1,<environment.Job instance at 0x7f386eb2a410>,98,18,[6 3],99,-1,119,-1,101
1,<environment.Job instance at 0x7f386eb2a730>,104,16,[7 5],105,-1,122,-1,106
1,<environment.Job instance at 0x7f386eb284b0>,106,16,[7 4],107,-1,123,-1,107
1,<environment.Job instance at 0x7f386eb28f00>,108,18,[4 6],109,-1,128,-1,110
1,<environment.Job instance at 0x7f386eb28e60>,111,27,[4 7],112,-1,141,-1,114
1,<environment.Job instance at 0x7f386ebb0eb0>,114,14,[5 5],115,-1,129,-1,115
1,<environment.Job instance at 0x7f386ec5a3c0>,115,16,[14  1],116,-1,192,-1,176
1,<environment.Job instance at 0x7f386eeb7320>,130,17,[2 6],131,-1,199,-1,182
1,<environment.Job instance at 0x7f386edffc30>,131,15,[8 4],132,-1,197,-1,182
1,<environment.Job instance at 0x7f3878cd2960>,133,23,[10  1],134,-1,205,-1,182
1,<environment.Job instance at 0x7f386ec50a00>,136,28,[6 5],137,-1,210,-1,182
1,<environment.Job instance at 0x7f386ed9b320>,137,18,[5 9],138,-1,202,-1,184
1,<environment.Job instance at 0x7f386ec59f00>,128,15,[3 6],129,-1,199,-1,184
1,<environment.Job instance at 0x7f386eb0eb90>,103,24,[7 4],104,-1,208,-1,184
1,<environment.Job instance at 0x7f386efe6320>,3,15,[ 1 12],4,-1,19,-1,4
1,<environment.Job instance at 0x7f386eb98a00>,5,3,[ 4 13],6,-1,9,-1,6
1,<environment.Job instance at 0x7f386edf6730>,7,1,[ 1 14],8,-1,9,-1,8
1,<environment.Job instance at 0x7f386ed97a00>,20,3,[13  3],21,-1,39,-1,36
1,<environment.Job instance at 0x7f386f517690>,25,13,[ 1 14],26,-1,66,-1,53
1,<environment.Job instance at 0x7f386f58aaf0>,36,2,[11  5],37,-1,70,-1,68
1,<environment.Job instance at 0x7f386f58acd0>,38,3,[14  4],39,-1,76,-1,73
1,<environment.Job instance at 0x7f386ed3e410>,58,12,[14  4],59,-1,144,-1,132
1,<environment.Job instance at 0x7f386ed3c320>,68,2,[13  1],69,-1,177,-1,175
1,<environment.Job instance at 0x7f386ee63b90>,71,3,[13  5],72,-1,179,-1,176
1,<environment.Job instance at 0x7f386ee63b40>,72,2,[ 1 12],73,-1,178,-1,176
1,<environment.Job instance at 0x7f386ee68be0>,82,1,[ 4 13],83,-1,197,-1,196
1,<environment.Job instance at 0x7f386ed15280>,83,14,[11  3],84,-1,210,-1,196
1,<environment.Job instance at 0x7f386ecd6b40>,100,24,[ 1 10],101,-1,299,-1,275
1,<environment.Job instance at 0x7f386ed3ac80>,103,24,[7 4],104,-1,303,-1,279
1,<environment.Job instance at 0x7f386ece5140>,105,3,[12  3],106,-1,282,-1,279
1,<environment.Job instance at 0x7f386ecdbb40>,111,27,[4 7],112,-1,338,-1,311
1,<environment.Job instance at 0x7f386ed281e0>,112,26,[8 4],113,-1,337,-1,311
1,<environment.Job instance at 0x7f386ed28690>,115,16,[14  1],116,-1,330,-1,314
1,<environment.Job instance at 0x7f386ed63140>,120,25,[ 3 10],121,-1,358,-1,333
1,<environment.Job instance at 0x7f386eced370>,133,23,[10  1],134,-1,401,-1,378
1,<environment.Job instance at 0x7f386ece1910>,136,28,[6 5],137,-1,407,-1,379
1,<environment.Job instance at 0x7f386eca1190>,4,15,[10  4],5,-1,21,-1,6
1,<environment.Job instance at 0x7f386eca1d20>,5,18,[11  3],6,-1,24,-1,6
1,<environment.Job instance at 0x7f386ec9e6e0>,12,18,[8 2],13,-1,34,-1,16
1,<environment.Job instance at 0x7f386ec9eb40>,17,14,[ 1 10],18,-1,32,-1,18
1,<environment.Job instance at 0x7f386ec965a0>,19,16,[9 4],20,-1,36,-1,20
1,<environment.Job instance at 0x7f386ec96370>,20,15,[8 2],21,-1,36,-1,21
1,<environment.Job instance at 0x7f386ec96780>,22,25,[6 3],23,-1,48,-1,23
1,<environment.Job instance at 0x7f386ec96d70>,24,17,[9 4],25,-1,42,-1,25
1,<environment.Job instance at 0x7f386ec925a0>,27,13,[1 9],28,-1,41,-1,28
1,<environment.Job instance at 0x7f386ec928c0>,28,17,[3 6],29,-1,46,-1,29
1,<environment.Job instance at 0x7f386ec92640>,29,15,[ 5 10],30,-1,45,-1,30
1,<environment.Job instance at 0x7f386ec92e10>,33,20,[2 6],34,-1,54,-1,34
1,<environment.Job instance at 0x7f386ec92f00>,34,15,[5 1],35,-1,50,-1,35
1,<environment.Job instance at 0x7f386ec9eeb0>,15,17,[4 6],16,-1,57,-1,40
1,<environment.Job instance at 0x7f386ed0dcd0>,46,15,[2 7],47,-1,62,-1,47
1,<environment.Job instance at 0x7f386ed0bcd0>,48,15,[7 5],49,-1,64,-1,49
1,<environment.Job instance at 0x7f386ed0bc80>,49,15,[ 3 10],50,-1,65,-1,50
1,<environment.Job instance at 0x7f386ed0bf50>,50,24,[2 8],51,-1,75,-1,51
1,<environment.Job instance at 0x7f386ed0b460>,54,23,[10  2],55,-1,94,-1,71
1,<environment.Job instance at 0x7f386ed0b500>,56,16,[ 5 10],57,-1,87,-1,71
1,<environment.Job instance at 0x7f386ed070f0>,64,14,[1 5],65,-1,85,-1,71
1,<environment.Job instance at 0x7f386ed07370>,62,13,[1 6],63,-1,84,-1,71
1,<environment.Job instance at 0x7f386ed07500>,67,15,[ 3 12],68,-1,86,-1,71
1,<environment.Job instance at 0x7f386ed070a0>,65,12,[ 4 10],66,-1,83,-1,71
1,<environment.Job instance at 0x7f386ed07d70>,70,14,[8 3],71,-1,90,-1,76
1,<environment.Job instance at 0x7f386ec9e690>,1,15,[14  1],2,-1,17,-1,2
1,<environment.Job instance at 0x7f386ec9e230>,5,18,[11  3],6,-1,24,-1,6
1,<environment.Job instance at 0x7f386ed0d3c0>,9,28,[5 3],10,-1,38,-1,10
1,<environment.Job instance at 0x7f386eb20f50>,22,25,[6 3],23,-1,73,-1,48
1,<environment.Job instance at 0x7f386f28f4b0>,39,18,[13  1],40,-1,118,-1,100
1,<environment.Job instance at 0x7f386fa7b640>,42,3,[ 3 11],43,-1,105,-1,102
1,<environment.Job instance at 0x7f386eb2b0f0>,50,24,[2 8],51,-1,169,-1,145
1,<environment.Job instance at 0x7f386eb2b690>,51,24,[9 1],52,-1,169,-1,145
1,<environment.Job instance at 0x7f386f2d2780>,53,24,[10  5],54,-1,170,-1,146
1,<environment.Job instance at 0x7f386f2d2690>,54,23,[10  2],55,-1,169,-1,146
1,<environment.Job instance at 0x7f386f2d2050>,55,15,[ 1 11],56,-1,161,-1,146
1,<environment.Job instance at 0x7f386eb88dc0>,67,15,[ 3 12],68,-1,194,-1,179
1,<environment.Job instance at 0x7f386f28ec30>,80,27,[ 5 10],81,-1,280,-1,253
1,<environment.Job instance at 0x7f386eba4f00>,86,25,[ 5 10],87,-1,299,-1,274
1,<environment.Job instance at 0x7f386fae0370>,102,17,[12  4],103,-1,323,-1,306
1,<environment.Job instance at 0x7f386ec5c820>,115,2,[ 4 11],116,-1,343,-1,341
1,<environment.Job instance at 0x7f386ec5ef00>,123,2,[ 2 14],124,-1,374,-1,372
1,<environment.Job instance at 0x7f386ec5e320>,124,17,[ 5 14],125,-1,389,-1,372
1,<environment.Job instance at 0x7f386ec1e0f0>,126,2,[11  3],127,-1,374,-1,372
1,<environment.Job instance at 0x7f386ec5a9b0>,127,2,[12  2],128,-1,374,-1,372
1,<environment.Job instance at 0x7f386ec40e60>,132,2,[12  5],133,-1,391,-1,389
1,<environment.Job instance at 0x7f386ec7d9b0>,134,1,[14  4],135,-1,391,-1,390
1,<environment.Job instance at 0x7f386ef936e0>,3,13,[4 9],4,-1,17,-1,4
1,<environment.Job instance at 0x7f386efc0870>,5,14,[7 4],6,-1,20,-1,6
1,<environment.Job instance at 0x7f3870091e60>,10,16,[10  2],11,-1,27,-1,11
1,<environment.Job instance at 0x7f386f289370>,14,21,[7 2],15,-1,36,-1,15
1,<environment.Job instance at 0x7f386f289550>,15,12,[ 1 10],16,-1,29,-1,17
1,<environment.Job instance at 0x7f386f289780>,18,16,[6 3],19,-1,35,-1,19
1,<environment.Job instance at 0x7f386f289820>,19,14,[5 7],20,-1,34,-1,20
1,<environment.Job instance at 0x7f386f289a50>,20,18,[4 7],21,-1,39,-1,21
1,<environment.Job instance at 0x7f386f289b40>,22,14,[ 1 11],23,-1,37,-1,23
1,<environment.Job instance at 0x7f386f289d20>,23,14,[2 7],24,-1,38,-1,24
1,<environment.Job instance at 0x7f386f96a1e0>,28,15,[8 5],29,-1,44,-1,29
1,<environment.Job instance at 0x7f386f96a370>,29,27,[1 5],30,-1,57,-1,30
1,<environment.Job instance at 0x7f386f96aaf0>,36,18,[4 6],37,-1,55,-1,37
1,<environment.Job instance at 0x7f386f96aeb0>,42,18,[6 3],43,-1,61,-1,43
1,<environment.Job instance at 0x7f386f9a23c0>,45,16,[6 3],46,-1,63,-1,47
1,<environment.Job instance at 0x7f386f9a2780>,49,27,[9 3],50,-1,77,-1,50
1,<environment.Job instance at 0x7f386f9a2870>,50,15,[7 5],51,-1,66,-1,51
1,<environment.Job instance at 0x7f386f9a2960>,52,24,[ 3 10],53,-1,77,-1,53
1,<environment.Job instance at 0x7f386f9a28c0>,54,17,[8 5],55,-1,72,-1,55
1,<environment.Job instance at 0x7f386f9a2f00>,57,12,[ 2 12],58,-1,70,-1,58
1,<environment.Job instance at 0x7f386f9a2cd0>,58,27,[1 7],59,-1,86,-1,59
1,<environment.Job instance at 0x7f386f99c140>,60,19,[6 3],61,-1,80,-1,61
1,<environment.Job instance at 0x7f386f99c280>,61,13,[5 5],62,-1,75,-1,62
1,<environment.Job instance at 0x7f386f99c3c0>,63,12,[1 8],64,-1,76,-1,64
1,<environment.Job instance at 0x7f386f99c5a0>,64,16,[10  3],65,-1,81,-1,65
1,<environment.Job instance at 0x7f386f99c910>,68,14,[10  3],69,-1,83,-1,69
1,<environment.Job instance at 0x7f386f99c730>,70,19,[1 5],71,-1,90,-1,71
1,<environment.Job instance at 0x7f386eca1410>,71,18,[2 9],72,-1,90,-1,72
1,<environment.Job instance at 0x7f38700b9280>,72,18,[10  4],73,-1,91,-1,73
1,<environment.Job instance at 0x7f386f1c7d70>,77,18,[5 1],78,-1,97,-1,79
1,<environment.Job instance at 0x7f386f2759b0>,79,15,[9 5],80,-1,95,-1,80
1,<environment.Job instance at 0x7f386ec59690>,82,15,[5 1],83,-1,98,-1,83
1,<environment.Job instance at 0x7f38700a2780>,83,18,[5 9],84,-1,102,-1,84
1,<environment.Job instance at 0x7f38700a2280>,88,14,[5 9],89,-1,107,-1,93
1,<environment.Job instance at 0x7f38700a2dc0>,89,19,[9 1],90,-1,112,-1,93
1,<environment.Job instance at 0x7f38700a2af0>,90,12,[2 5],91,-1,105,-1,93
1,<environment.Job instance at 0x7f386fc2b910>,91,16,[6 5],92,-1,109,-1,93
1,<environment.Job instance at 0x7f386f1b90a0>,93,27,[1 8],94,-1,121,-1,94
1,<environment.Job instance at 0x7f386f9c7dc0>,96,14,[3 9],97,-1,111,-1,97
1,<environment.Job instance at 0x7f386ef027d0>,101,18,[8 4],102,-1,120,-1,102
1,<environment.Job instance at 0x7f386f27a5f0>,76,3,[2 7],77,-1,108,-1,105
1,<environment.Job instance at 0x7f386ef02e10>,104,17,[3 9],105,-1,122,-1,105
1,<environment.Job instance at 0x7f386f9a2190>,46,25,[3 8],47,-1,130,-1,105
1,<environment.Job instance at 0x7f386f198e60>,105,13,[10  4],106,-1,121,-1,108
1,<environment.Job instance at 0x7f386f1984b0>,107,22,[1 7],108,-1,134,-1,112
1,<environment.Job instance at 0x7f386eeef370>,111,18,[3 6],112,-1,130,-1,112
1,<environment.Job instance at 0x7f386f96ac80>,39,14,[ 5 11],40,-1,126,-1,112
1,<environment.Job instance at 0x7f386eeefaa0>,109,15,[7 1],110,-1,127,-1,112
1,<environment.Job instance at 0x7f386eeef050>,110,14,[6 4],111,-1,126,-1,112
1,<environment.Job instance at 0x7f386eeef230>,115,25,[6 3],116,-1,141,-1,116
1,<environment.Job instance at 0x7f386eeefeb0>,118,16,[8 5],119,-1,135,-1,119
1,<environment.Job instance at 0x7f386eef15a0>,119,18,[7 5],120,-1,138,-1,120
1,<environment.Job instance at 0x7f386eef18c0>,121,14,[5 8],122,-1,136,-1,122
1,<environment.Job instance at 0x7f386eef1a00>,122,16,[9 2],123,-1,140,-1,124
1,<environment.Job instance at 0x7f386eef1dc0>,125,18,[7 5],126,-1,144,-1,126
1,<environment.Job instance at 0x7f386eee4b90>,128,17,[10  3],129,-1,147,-1,130
1,<environment.Job instance at 0x7f386eee47d0>,129,27,[ 5 10],130,-1,159,-1,132
1,<environment.Job instance at 0x7f386eee49b0>,131,22,[ 1 10],132,-1,156,-1,134
1,<environment.Job instance at 0x7f386f3f0460>,99,13,[5 9],100,-1,152,-1,139
1,<environment.Job instance at 0x7f386ef01aa0>,138,20,[6 2],139,-1,159,-1,139
1,<environment.Job instance at 0x7f38700a22d0>,13,1,[ 5 12],14,-1,18,-1,17
1,<environment.Job instance at 0x7f386ec57820>,22,14,[ 1 11],23,-1,62,-1,48
1,<environment.Job instance at 0x7f386eb67be0>,24,3,[14  4],25,-1,59,-1,56
1,<environment.Job instance at 0x7f386eb623c0>,26,2,[13  4],27,-1,64,-1,62
1,<environment.Job instance at 0x7f386f2ed870>,29,27,[1 5],30,-1,94,-1,67
1,<environment.Job instance at 0x7f386fae0870>,35,14,[ 5 12],36,-1,99,-1,85
1,<environment.Job instance at 0x7f386f769320>,37,19,[14  4],38,-1,104,-1,85
1,<environment.Job instance at 0x7f386edf6b90>,39,14,[ 5 11],40,-1,102,-1,88
1,<environment.Job instance at 0x7f386ec04e60>,46,25,[3 8],47,-1,135,-1,110
1,<environment.Job instance at 0x7f386f28ebe0>,48,3,[ 5 14],49,-1,113,-1,110
1,<environment.Job instance at 0x7f386f28e1e0>,49,27,[9 3],50,-1,139,-1,112
1,<environment.Job instance at 0x7f386f35e870>,52,24,[ 3 10],53,-1,148,-1,124
1,<environment.Job instance at 0x7f386eb2b0f0>,57,12,[ 2 12],58,-1,139,-1,127
1,<environment.Job instance at 0x7f386eb2bc80>,58,27,[1 7],59,-1,156,-1,129
1,<environment.Job instance at 0x7f386ed5a460>,75,2,[14  5],76,-1,194,-1,192
1,<environment.Job instance at 0x7f386f3541e0>,93,27,[1 8],94,-1,279,-1,252
1,<environment.Job instance at 0x7f386f3008c0>,113,3,[ 3 14],114,-1,341,-1,338
1,<environment.Job instance at 0x7f386f45d370>,115,25,[6 3],116,-1,378,-1,353
1,<environment.Job instance at 0x7f386fa35460>,120,2,[ 5 11],121,-1,359,-1,357
1,<environment.Job instance at 0x7f386ee91050>,129,27,[ 5 10],130,-1,434,-1,407
1,<environment.Job instance at 0x7f386f2eedc0>,5,17,[7 1],6,-1,23,-1,6
1,<environment.Job instance at 0x7f386f2ee0a0>,7,18,[1 7],8,-1,26,-1,8
1,<environment.Job instance at 0x7f386f2ee5f0>,9,14,[10  1],10,-1,25,-1,11
1,<environment.Job instance at 0x7f386f2eef50>,11,14,[10  4],12,-1,26,-1,12
1,<environment.Job instance at 0x7f386f2eecd0>,12,18,[5 5],13,-1,31,-1,13
1,<environment.Job instance at 0x7f386f2ee730>,15,15,[7 4],16,-1,31,-1,16
1,<environment.Job instance at 0x7f386f629910>,18,21,[5 8],19,-1,40,-1,19
1,<environment.Job instance at 0x7f386f629d70>,19,17,[7 2],20,-1,37,-1,20
1,<environment.Job instance at 0x7f386f629b90>,21,28,[2 8],22,-1,50,-1,22
1,<environment.Job instance at 0x7f386f629b40>,22,18,[5 1],23,-1,41,-1,23
1,<environment.Job instance at 0x7f386f6298c0>,23,27,[9 3],24,-1,51,-1,24
1,<environment.Job instance at 0x7f386f629f00>,26,28,[1 7],27,-1,58,-1,30
1,<environment.Job instance at 0x7f386f2ee460>,10,15,[1 6],11,-1,46,-1,31
1,<environment.Job instance at 0x7f386fa64910>,39,17,[1 5],40,-1,58,-1,41
1,<environment.Job instance at 0x7f386f2092d0>,48,15,[ 3 11],49,-1,64,-1,49
1,<environment.Job instance at 0x7f386f209550>,50,14,[6 4],51,-1,65,-1,51
1,<environment.Job instance at 0x7f386f893460>,54,15,[9 1],55,-1,70,-1,55
1,<environment.Job instance at 0x7f386f209aa0>,42,13,[4 8],43,-1,74,-1,61
1,<environment.Job instance at 0x7f386f893780>,60,15,[9 4],61,-1,86,-1,71
1,<environment.Job instance at 0x7f386f893730>,58,17,[5 5],59,-1,89,-1,72
1,<environment.Job instance at 0x7f386f893050>,59,14,[3 7],60,-1,86,-1,72
1,<environment.Job instance at 0x7f386f893af0>,63,20,[5 4],64,-1,92,-1,72
1,<environment.Job instance at 0x7f386f9c2e10>,72,14,[6 5],73,-1,87,-1,73
1,<environment.Job instance at 0x7f386f9c26e0>,74,15,[10  3],75,-1,93,-1,78
1,<environment.Job instance at 0x7f386f9c2c30>,70,16,[14  3],71,-1,104,-1,88
1,<environment.Job instance at 0x7f386f893cd0>,56,23,[7 4],57,-1,112,-1,89
1,<environment.Job instance at 0x7f386f9c2960>,77,13,[9 4],78,-1,102,-1,89
1,<environment.Job instance at 0x7f386f9c2f50>,75,20,[4 7],76,-1,110,-1,90
1,<environment.Job instance at 0x7f386f9c20f0>,76,21,[6 5],77,-1,111,-1,90
1,<environment.Job instance at 0x7f386f9c27d0>,81,27,[5 1],82,-1,117,-1,90
1,<environment.Job instance at 0x7f386f9c21e0>,80,15,[4 5],81,-1,105,-1,90
1,<environment.Job instance at 0x7f386f9c2550>,83,17,[8 5],84,-1,107,-1,90
1,<environment.Job instance at 0x7f386f8da1e0>,85,16,[4 5],86,-1,106,-1,90
1,<environment.Job instance at 0x7f386f8da640>,86,25,[8 3],87,-1,115,-1,90
1,<environment.Job instance at 0x7f386f8da500>,87,13,[13  1],88,-1,103,-1,90
1,<environment.Job instance at 0x7f386f9c24b0>,82,21,[1 6],83,-1,111,-1,90
1,<environment.Job instance at 0x7f386f8dacd0>,89,18,[7 3],90,-1,108,-1,90
1,<environment.Job instance at 0x7f386f8da230>,88,16,[ 5 10],89,-1,106,-1,90
1,<environment.Job instance at 0x7f386f8da280>,90,16,[9 2],91,-1,108,-1,92
1,<environment.Job instance at 0x7f386f8da410>,91,19,[10  1],92,-1,113,-1,94
1,<environment.Job instance at 0x7f386f9c2d70>,79,17,[5 9],80,-1,122,-1,105
1,<environment.Job instance at 0x7f386f06db90>,102,18,[5 9],103,-1,123,-1,105
1,<environment.Job instance at 0x7f386f956af0>,108,18,[1 9],109,-1,127,-1,109
1,<environment.Job instance at 0x7f386f360190>,109,15,[6 3],110,-1,125,-1,110
1,<environment.Job instance at 0x7f3870096730>,96,25,[ 5 10],97,-1,136,-1,111
1,<environment.Job instance at 0x7f386f6a44b0>,95,13,[2 6],96,-1,124,-1,111
1,<environment.Job instance at 0x7f38700ddf50>,110,15,[3 9],111,-1,126,-1,111
1,<environment.Job instance at 0x7f386f3c5be0>,114,17,[9 5],115,-1,132,-1,115
1,<environment.Job instance at 0x7f386ed5a2d0>,103,16,[6 5],104,-1,133,-1,117
1,<environment.Job instance at 0x7f386f0e6d20>,115,16,[5 3],116,-1,134,-1,118
1,<environment.Job instance at 0x7f386ee34eb0>,118,14,[9 4],119,-1,134,-1,120
1,<environment.Job instance at 0x7f386faaad20>,120,26,[6 3],121,-1,147,-1,121
1,<environment.Job instance at 0x7f386f16f730>,125,23,[7 1],126,-1,149,-1,126
1,<environment.Job instance at 0x7f38786f1f50>,122,17,[ 2 11],123,-1,145,-1,128
1,<environment.Job instance at 0x7f386f02fa00>,127,17,[4 9],128,-1,145,-1,128
1,<environment.Job instance at 0x7f386f358b40>,131,17,[10  4],132,-1,149,-1,132
1,<environment.Job instance at 0x7f386fb54eb0>,132,14,[3 9],133,-1,147,-1,133
1,<environment.Job instance at 0x7f386ee34230>,119,13,[3 6],120,-1,146,-1,133
1,<environment.Job instance at 0x7f386fb549b0>,134,14,[7 4],135,-1,150,-1,136
1,<environment.Job instance at 0x7f3870080410>,137,18,[3 6],138,-1,156,-1,138
1,<environment.Job instance at 0x7f386fa648c0>,6,13,[11  1],7,-1,20,-1,7
1,<environment.Job instance at 0x7f386fa64820>,8,12,[ 5 12],9,-1,21,-1,9
1,<environment.Job instance at 0x7f386f9564b0>,21,28,[2 8],22,-1,82,-1,54
1,<environment.Job instance at 0x7f386f358280>,26,28,[1 7],27,-1,110,-1,82
1,<environment.Job instance at 0x7f386f0fdaa0>,23,27,[9 3],24,-1,110,-1,83
1,<environment.Job instance at 0x7f386f4ee3c0>,29,2,[ 4 11],30,-1,85,-1,83
1,<environment.Job instance at 0x7f386ee91aa0>,34,3,[11  1],35,-1,100,-1,97
1,<environment.Job instance at 0x7f386ee910a0>,36,28,[9 2],37,-1,127,-1,99
1,<environment.Job instance at 0x7f386eda1d20>,47,3,[ 1 12],48,-1,118,-1,115
1,<environment.Job instance at 0x7f386f3818c0>,48,15,[ 3 11],49,-1,130,-1,115
1,<environment.Job instance at 0x7f386f0e6140>,55,15,[ 2 11],56,-1,148,-1,133
1,<environment.Job instance at 0x7f386ec9e780>,56,23,[7 4],57,-1,157,-1,134
1,<environment.Job instance at 0x7f386ec04e60>,70,16,[14  3],71,-1,186,-1,170
1,<environment.Job instance at 0x7f386f2edc30>,81,27,[5 1],82,-1,219,-1,192
1,<environment.Job instance at 0x7f386ec40e60>,87,13,[13  1],88,-1,221,-1,208
1,<environment.Job instance at 0x7f386ef02870>,86,25,[8 3],87,-1,247,-1,222
1,<environment.Job instance at 0x7f386f96acd0>,96,25,[ 5 10],97,-1,292,-1,267
1,<environment.Job instance at 0x7f386f0f83c0>,116,2,[13  5],117,-1,328,-1,326
1,<environment.Job instance at 0x7f386fa0c4b0>,120,26,[6 3],121,-1,378,-1,352
1,<environment.Job instance at 0x7f386fa0ca50>,122,17,[ 2 11],123,-1,369,-1,352
1,<environment.Job instance at 0x7f386f09b230>,125,23,[7 1],126,-1,379,-1,356
1,<environment.Job instance at 0x7f386ede2500>,133,12,[ 1 14],134,-1,394,-1,382
1,<environment.Job instance at 0x7f386ed155f0>,136,13,[13  3],137,-1,412,-1,399
1,<environment.Job instance at 0x7f386fa88690>,138,1,[ 3 14],139,-1,409,-1,408
1,<environment.Job instance at 0x7f386ea641e0>,4,18,[4 7],5,-1,23,-1,5
1,<environment.Job instance at 0x7f386ee0c550>,6,17,[5 5],7,-1,24,-1,7
1,<environment.Job instance at 0x7f38701b4af0>,12,17,[1 6],13,-1,30,-1,13
1,<environment.Job instance at 0x7f38701b4aa0>,13,16,[4 9],14,-1,30,-1,14
1,<environment.Job instance at 0x7f38701b4d20>,15,13,[ 1 12],16,-1,29,-1,16
1,<environment.Job instance at 0x7f386eaa69b0>,19,18,[9 5],20,-1,39,-1,21
1,<environment.Job instance at 0x7f386edff500>,24,17,[6 5],25,-1,42,-1,25
1,<environment.Job instance at 0x7f386ea48f50>,25,23,[5 3],26,-1,49,-1,26
1,<environment.Job instance at 0x7f386ea05af0>,20,28,[5 6],21,-1,54,-1,26
1,<environment.Job instance at 0x7f386e87cbe0>,32,16,[9 4],33,-1,54,-1,38
1,<environment.Job instance at 0x7f386e87e5a0>,41,16,[ 2 10],42,-1,82,-1,66
1,<environment.Job instance at 0x7f386e974460>,48,3,[7 1],49,-1,74,-1,71
1,<environment.Job instance at 0x7f386e9746e0>,47,18,[10  5],48,-1,89,-1,71
1,<environment.Job instance at 0x7f386e87e9b0>,38,15,[ 3 13],39,-1,87,-1,72
1,<environment.Job instance at 0x7f386ea6af50>,43,18,[ 1 10],44,-1,90,-1,72
1,<environment.Job instance at 0x7f386e974690>,50,15,[ 4 10],51,-1,87,-1,72
1,<environment.Job instance at 0x7f386e974050>,51,1,[9 5],52,-1,73,-1,72
1,<environment.Job instance at 0x7f386e87e6e0>,36,15,[9 5],37,-1,87,-1,72
1,<environment.Job instance at 0x7f386ea44c80>,58,14,[1 7],59,-1,86,-1,72
1,<environment.Job instance at 0x7f386ea44e60>,59,17,[9 4],60,-1,89,-1,72
1,<environment.Job instance at 0x7f386e9f90a0>,60,1,[5 4],61,-1,73,-1,72
1,<environment.Job instance at 0x7f386e9f9c80>,61,18,[4 8],62,-1,94,-1,76
1,<environment.Job instance at 0x7f386e9f90f0>,63,15,[10  4],64,-1,91,-1,76
1,<environment.Job instance at 0x7f38786f22d0>,103,17,[10  5],104,-1,2169,-1,2152
1,<environment.Job instance at 0x7f386ea49960>,111,16,[2 7],112,-1,2172,-1,2156
1,<environment.Job instance at 0x7f386e97e050>,112,15,[3 8],113,-1,2171,-1,2156
1,<environment.Job instance at 0x7f386ea491e0>,109,1,[5 6],110,-1,2158,-1,2157
1,<environment.Job instance at 0x7f386e97e140>,115,15,[9 1],116,-1,2173,-1,2158
1,<environment.Job instance at 0x7f386f28bd70>,117,25,[9 4],118,-1,2183,-1,2158
1,<environment.Job instance at 0x7f386fdcc2d0>,105,18,[14  2],106,-1,2176,-1,2158
1,<environment.Job instance at 0x7f386e979370>,120,16,[2 8],121,-1,2178,-1,2162
1,<environment.Job instance at 0x7f386ea49690>,110,13,[9 3],111,-1,2175,-1,2162
1,<environment.Job instance at 0x7f386ebf6af0>,125,16,[1 6],126,-1,2178,-1,2162
1,<environment.Job instance at 0x7f386e979e10>,122,17,[1 7],123,-1,2179,-1,2162
1,<environment.Job instance at 0x7f386ebf6910>,127,14,[12  5],128,-1,2176,-1,2162
1,<environment.Job instance at 0x7f386e979230>,123,17,[6 4],124,-1,2179,-1,2162
1,<environment.Job instance at 0x7f386ebf6140>,126,16,[14  3],127,-1,2180,-1,2164
1,<environment.Job instance at 0x7f386e8c80f0>,11,14,[ 3 14],12,-1,32,-1,18
1,<environment.Job instance at 0x7f386fde1730>,15,13,[ 1 12],16,-1,35,-1,22
1,<environment.Job instance at 0x7f386fde1a00>,16,17,[11  2],17,-1,39,-1,22
1,<environment.Job instance at 0x7f386fbac370>,20,28,[5 6],21,-1,66,-1,38
1,<environment.Job instance at 0x7f386fbac050>,23,28,[ 1 11],24,-1,68,-1,40
1,<environment.Job instance at 0x7f386fa0c3c0>,25,23,[5 3],26,-1,66,-1,43
1,<environment.Job instance at 0x7f386fa0c6e0>,26,14,[13  5],27,-1,57,-1,43
1,<environment.Job instance at 0x7f386f0f88c0>,30,13,[12  5],31,-1,69,-1,56
1,<environment.Job instance at 0x7f386ee2d820>,38,15,[ 3 13],39,-1,97,-1,82
1,<environment.Job instance at 0x7f386eda1d20>,46,18,[ 3 13],47,-1,146,-1,128
1,<environment.Job instance at 0x7f386f02f3c0>,57,2,[ 4 14],58,-1,161,-1,159
1,<environment.Job instance at 0x7f38700dd3c0>,64,2,[ 1 12],65,-1,179,-1,177
1,<environment.Job instance at 0x7f386f209640>,70,25,[2 8],71,-1,250,-1,225
1,<environment.Job instance at 0x7f386f2ee4b0>,74,3,[ 3 14],75,-1,238,-1,235
1,<environment.Job instance at 0x7f386f06d0f0>,79,2,[13  5],80,-1,258,-1,256
1,<environment.Job instance at 0x7f386f0911e0>,88,1,[ 3 12],89,-1,302,-1,301
1,<environment.Job instance at 0x7f386f0913c0>,105,18,[14  2],106,-1,393,-1,375
1,<environment.Job instance at 0x7f386f709410>,117,25,[9 4],118,-1,459,-1,434
1,<environment.Job instance at 0x7f386f7090f0>,121,3,[ 4 12],122,-1,441,-1,438
1,<environment.Job instance at 0x7f386ed15500>,126,16,[14  3],127,-1,471,-1,455
1,<environment.Job instance at 0x7f386ed151e0>,127,14,[12  5],128,-1,469,-1,455
1,<environment.Job instance at 0x7f386ed15640>,134,25,[7 4],135,-1,514,-1,489
1,<environment.Job instance at 0x7f386ef71550>,2,18,[5 8],3,-1,21,-1,3
1,<environment.Job instance at 0x7f386ef71c30>,10,16,[5 9],11,-1,27,-1,11
1,<environment.Job instance at 0x7f386ef71cd0>,11,15,[9 5],12,-1,27,-1,12
1,<environment.Job instance at 0x7f386fa0c280>,13,18,[ 2 11],14,-1,34,-1,16
1,<environment.Job instance at 0x7f386ef6a370>,18,14,[8 1],19,-1,33,-1,19
1,<environment.Job instance at 0x7f386ef6a4b0>,19,16,[ 4 10],20,-1,36,-1,20
1,<environment.Job instance at 0x7f386ef6a3c0>,20,18,[5 8],21,-1,39,-1,21
1,<environment.Job instance at 0x7f386ef6a5a0>,21,17,[3 7],22,-1,39,-1,22
1,<environment.Job instance at 0x7f386ef6a640>,22,23,[7 1],23,-1,46,-1,23
1,<environment.Job instance at 0x7f386ef6a780>,24,14,[10  1],25,-1,44,-1,30
1,<environment.Job instance at 0x7f386ef6adc0>,30,15,[4 9],31,-1,46,-1,31
1,<environment.Job instance at 0x7f386ef6ac30>,31,15,[7 5],32,-1,47,-1,32
1,<environment.Job instance at 0x7f386f3540a0>,33,16,[8 2],34,-1,50,-1,34
1,<environment.Job instance at 0x7f386f354320>,36,17,[9 3],37,-1,54,-1,37
1,<environment.Job instance at 0x7f386f354820>,40,15,[9 1],41,-1,56,-1,41
1,<environment.Job instance at 0x7f386f354a00>,43,16,[ 4 10],44,-1,60,-1,44
1,<environment.Job instance at 0x7f386f354910>,41,23,[ 3 13],42,-1,80,-1,57
1,<environment.Job instance at 0x7f386f354a50>,44,18,[1 8],45,-1,75,-1,57
1,<environment.Job instance at 0x7f386f354e10>,50,20,[9 5],51,-1,77,-1,57
1,<environment.Job instance at 0x7f386f354f00>,48,18,[5 8],49,-1,75,-1,57
1,<environment.Job instance at 0x7f386f362280>,54,15,[7 5],55,-1,73,-1,58
1,<environment.Job instance at 0x7f386f362d20>,61,18,[3 7],62,-1,82,-1,64
1,<environment.Job instance at 0x7f386f362a00>,57,15,[ 1 10],58,-1,79,-1,64
1,<environment.Job instance at 0x7f386f3629b0>,63,14,[5 5],64,-1,79,-1,65
1,<environment.Job instance at 0x7f386f362aa0>,64,22,[9 5],65,-1,87,-1,65
1,<environment.Job instance at 0x7f386f34f230>,67,16,[5 8],68,-1,84,-1,68
1,<environment.Job instance at 0x7f386f34f6e0>,73,15,[4 9],74,-1,90,-1,75
1,<environment.Job instance at 0x7f386f34f140>,68,16,[1 6],69,-1,93,-1,77
1,<environment.Job instance at 0x7f386f362e10>,62,17,[1 9],63,-1,106,-1,89
1,<environment.Job instance at 0x7f386f34fcd0>,80,16,[9 2],81,-1,105,-1,89
1,<environment.Job instance at 0x7f386f34fe10>,82,17,[ 2 14],83,-1,121,-1,104
1,<environment.Job instance at 0x7f386f34f730>,74,14,[10  4],75,-1,118,-1,104
1,<environment.Job instance at 0x7f386f34e6e0>,89,17,[9 2],90,-1,121,-1,104
1,<environment.Job instance at 0x7f386f34e230>,87,17,[8 2],88,-1,121,-1,104
1,<environment.Job instance at 0x7f386f34ea50>,95,16,[11  3],96,-1,120,-1,104
1,<environment.Job instance at 0x7f386f34fb40>,79,21,[1 7],80,-1,128,-1,107
1,<environment.Job instance at 0x7f386f34eb90>,97,16,[3 5],98,-1,124,-1,108
1,<environment.Job instance at 0x7f386f34ed20>,103,18,[ 2 10],104,-1,126,-1,108
1,<environment.Job instance at 0x7f386f34f410>,70,13,[11  4],71,-1,121,-1,108
1,<environment.Job instance at 0x7f386fdc7e10>,104,17,[8 3],105,-1,125,-1,108
1,<environment.Job instance at 0x7f386ef855a0>,107,17,[7 4],108,-1,126,-1,109
1,<environment.Job instance at 0x7f386f55e910>,108,15,[8 3],109,-1,124,-1,109
1,<environment.Job instance at 0x7f386f60fa50>,109,16,[10  5],110,-1,126,-1,110
1,<environment.Job instance at 0x7f386f607aa0>,115,17,[ 2 10],116,-1,142,-1,125
1,<environment.Job instance at 0x7f386e9dae60>,118,19,[7 1],119,-1,147,-1,128
1,<environment.Job instance at 0x7f38700c6640>,120,18,[9 2],121,-1,146,-1,128
1,<environment.Job instance at 0x7f386f5e3230>,123,14,[5 5],124,-1,142,-1,128
1,<environment.Job instance at 0x7f386f552b40>,124,12,[7 4],125,-1,142,-1,130
1,<environment.Job instance at 0x7f386f5593c0>,127,14,[11  2],128,-1,144,-1,130
1,<environment.Job instance at 0x7f386f576e10>,129,18,[1 5],130,-1,148,-1,130
1,<environment.Job instance at 0x7f386ff53550>,130,27,[7 4],131,-1,158,-1,131
1,<environment.Job instance at 0x7f386f354410>,5,23,[8 2],6,-1,31,-1,8
1,<environment.Job instance at 0x7f386fbae1e0>,13,18,[ 2 11],14,-1,34,-1,16
1,<environment.Job instance at 0x7f386f34e5f0>,15,3,[11  2],16,-1,21,-1,18
1,<environment.Job instance at 0x7f386f559b40>,22,23,[7 1],23,-1,76,-1,53
1,<environment.Job instance at 0x7f386f573690>,25,3,[13  2],26,-1,71,-1,68
1,<environment.Job instance at 0x7f386f619b90>,28,1,[13  4],29,-1,70,-1,69
1,<environment.Job instance at 0x7f386ef71690>,32,13,[14  4],33,-1,96,-1,83
1,<environment.Job instance at 0x7f386ed15550>,41,23,[ 3 13],42,-1,142,-1,119
1,<environment.Job instance at 0x7f386f091320>,65,3,[ 1 14],66,-1,218,-1,215
1,<environment.Job instance at 0x7f386f091280>,70,13,[11  4],71,-1,257,-1,244
1,<environment.Job instance at 0x7f386f091690>,71,12,[ 1 13],72,-1,256,-1,244
1,<environment.Job instance at 0x7f386f06d870>,82,17,[ 2 14],83,-1,307,-1,290
1,<environment.Job instance at 0x7f386f209cd0>,95,16,[11  3],96,-1,355,-1,339
1,<environment.Job instance at 0x7f386f4ee6e0>,106,1,[11  2],107,-1,363,-1,362
1,<environment.Job instance at 0x7f386f0f8fa0>,127,14,[11  2],128,-1,446,-1,432
1,<environment.Job instance at 0x7f386f0f8f50>,128,15,[ 3 14],129,-1,447,-1,432
1,<environment.Job instance at 0x7f386f0f83c0>,130,27,[7 4],131,-1,470,-1,443
1,<environment.Job instance at 0x7f386fa0c6e0>,135,2,[ 1 12],136,-1,465,-1,463
1,<environment.Job instance at 0x7f386f96fe60>,1,14,[9 5],2,-1,17,-1,3
1,<environment.Job instance at 0x7f386ed15e10>,2,15,[7 3],3,-1,18,-1,3
1,<environment.Job instance at 0x7f386f96feb0>,9,15,[8 5],10,-1,27,-1,12
1,<environment.Job instance at 0x7f386f5d2fa0>,11,13,[9 4],12,-1,25,-1,12
1,<environment.Job instance at 0x7f386f5d27d0>,12,16,[1 7],13,-1,30,-1,14
1,<environment.Job instance at 0x7f386f5d2a50>,14,15,[6 4],15,-1,30,-1,15
1,<environment.Job instance at 0x7f386f5d22d0>,17,16,[7 2],18,-1,34,-1,18
1,<environment.Job instance at 0x7f386fb21d70>,26,16,[4 9],27,-1,48,-1,32
1,<environment.Job instance at 0x7f386f56a320>,29,14,[3 8],30,-1,46,-1,32
1,<environment.Job instance at 0x7f386f5d2e10>,22,14,[9 3],23,-1,46,-1,32
1,<environment.Job instance at 0x7f386f56a960>,31,18,[5 9],32,-1,50,-1,32
1,<environment.Job instance at 0x7f386f56a140>,35,17,[10  3],36,-1,53,-1,36
1,<environment.Job instance at 0x7f386f56ab40>,37,16,[8 4],38,-1,54,-1,38
1,<environment.Job instance at 0x7f386f96fcd0>,4,19,[9 1],5,-1,60,-1,41
1,<environment.Job instance at 0x7f386f56aa00>,38,14,[6 3],39,-1,55,-1,41
1,<environment.Job instance at 0x7f386f380190>,41,14,[ 5 10],42,-1,56,-1,42
1,<environment.Job instance at 0x7f386f380af0>,42,19,[8 3],43,-1,62,-1,43
1,<environment.Job instance at 0x7f386f56adc0>,27,22,[6 1],28,-1,65,-1,43
1,<environment.Job instance at 0x7f386f3808c0>,43,13,[8 3],44,-1,57,-1,44
1,<environment.Job instance at 0x7f386f380960>,44,17,[8 5],45,-1,62,-1,45
1,<environment.Job instance at 0x7f386fb76dc0>,53,17,[6 4],54,-1,71,-1,54
1,<environment.Job instance at 0x7f386f835d70>,49,25,[7 3],50,-1,79,-1,54
1,<environment.Job instance at 0x7f386fb76550>,54,17,[4 7],55,-1,80,-1,63
1,<environment.Job instance at 0x7f386fb760a0>,62,14,[10  1],63,-1,78,-1,64
1,<environment.Job instance at 0x7f386f62ac80>,64,15,[8 1],65,-1,81,-1,66
1,<environment.Job instance at 0x7f386fb76cd0>,56,13,[10  5],57,-1,80,-1,67
1,<environment.Job instance at 0x7f386f62a5f0>,65,14,[5 7],66,-1,82,-1,68
1,<environment.Job instance at 0x7f386f62a2d0>,67,15,[3 9],68,-1,84,-1,69
1,<environment.Job instance at 0x7f3870073c30>,70,18,[5 4],71,-1,92,-1,74
1,<environment.Job instance at 0x7f386f5409b0>,72,19,[6 2],73,-1,93,-1,74
1,<environment.Job instance at 0x7f386faf4870>,77,18,[ 3 12],78,-1,96,-1,78
1,<environment.Job instance at 0x7f386faf43c0>,78,18,[ 4 10],79,-1,101,-1,83
1,<environment.Job instance at 0x7f386faf4960>,76,17,[ 1 13],77,-1,168,-1,151
1,<environment.Job instance at 0x7f386fb925a0>,86,18,[3 6],87,-1,175,-1,157
1,<environment.Job instance at 0x7f386f637a00>,68,15,[ 4 10],69,-1,173,-1,158
1,<environment.Job instance at 0x7f386fb92320>,88,22,[ 1 13],89,-1,181,-1,159
1,<environment.Job instance at 0x7f386fb3d730>,96,18,[3 9],97,-1,196,-1,178
1,<environment.Job instance at 0x7f386fb3d320>,99,23,[4 9],100,-1,201,-1,178
1,<environment.Job instance at 0x7f386fb3d140>,93,18,[4 5],94,-1,198,-1,180
1,<environment.Job instance at 0x7f386fb72b90>,102,13,[14  2],103,-1,193,-1,180
1,<environment.Job instance at 0x7f386fb3d6e0>,95,18,[5 8],96,-1,198,-1,180
1,<environment.Job instance at 0x7f386f835af0>,48,14,[9 5],49,-1,195,-1,181
1,<environment.Job instance at 0x7f386fb33690>,106,12,[ 1 10],107,-1,193,-1,181
1,<environment.Job instance at 0x7f38786d7550>,104,22,[5 8],105,-1,205,-1,183
1,<environment.Job instance at 0x7f386f7c9e10>,84,16,[9 2],85,-1,200,-1,184
1,<environment.Job instance at 0x7f386fb72780>,101,16,[6 5],102,-1,200,-1,184
1,<environment.Job instance at 0x7f386fb03960>,110,15,[5 1],111,-1,208,-1,193
1,<environment.Job instance at 0x7f386fb33960>,108,15,[1 8],109,-1,220,-1,205
1,<environment.Job instance at 0x7f386fc589b0>,119,18,[1 9],120,-1,224,-1,206
1,<environment.Job instance at 0x7f386fc583c0>,124,17,[3 7],125,-1,223,-1,206
1,<environment.Job instance at 0x7f386fc58c80>,123,14,[4 8],124,-1,220,-1,206
1,<environment.Job instance at 0x7f386fc587d0>,129,18,[2 9],130,-1,225,-1,207
1,<environment.Job instance at 0x7f386fc58910>,130,18,[5 5],131,-1,225,-1,207
1,<environment.Job instance at 0x7f386fc58370>,126,14,[7 5],127,-1,221,-1,207
1,<environment.Job instance at 0x7f38786d7230>,105,16,[6 5],106,-1,223,-1,207
1,<environment.Job instance at 0x7f386fc58fa0>,133,18,[5 2],134,-1,225,-1,207
1,<environment.Job instance at 0x7f386fbe01e0>,136,12,[8 3],137,-1,220,-1,208
1,<environment.Job instance at 0x7f386fc58a00>,131,14,[ 1 10],132,-1,222,-1,208
1,<environment.Job instance at 0x7f386f96f0a0>,3,1,[ 4 13],4,-1,2194,-1,2193
1,<environment.Job instance at 0x7f386f5d2c80>,0,25,[ 1 14],1,-1,26,-1,1
1,<environment.Job instance at 0x7f386fb21a00>,3,1,[ 4 13],4,-1,5,-1,4
1,<environment.Job instance at 0x7f386f56ac80>,5,3,[ 4 11],6,-1,9,-1,6
1,<environment.Job instance at 0x7f386fbe0be0>,18,3,[11  1],19,-1,40,-1,37
1,<environment.Job instance at 0x7f386f091a00>,46,23,[5 5],47,-1,165,-1,142
1,<environment.Job instance at 0x7f386f091780>,49,25,[7 3],50,-1,182,-1,157
1,<environment.Job instance at 0x7f386f091460>,50,1,[12  5],51,-1,158,-1,157
1,<environment.Job instance at 0x7f386f931690>,61,3,[ 3 11],62,-1,197,-1,194
1,<environment.Job instance at 0x7f386ed159b0>,75,3,[14  4],76,-1,248,-1,245
1,<environment.Job instance at 0x7f386ef71eb0>,76,17,[ 1 13],77,-1,262,-1,245
1,<environment.Job instance at 0x7f386ef71960>,77,18,[ 3 12],78,-1,263,-1,245
1,<environment.Job instance at 0x7f386f5de5f0>,81,2,[11  4],82,-1,257,-1,255
1,<environment.Job instance at 0x7f386f559b40>,88,22,[ 1 13],89,-1,309,-1,287
1,<environment.Job instance at 0x7f386f362be0>,98,2,[11  2],99,-1,328,-1,326
1,<environment.Job instance at 0x7f386ea64b40>,99,23,[4 9],100,-1,350,-1,327
1,<environment.Job instance at 0x7f386f354280>,102,13,[14  2],103,-1,340,-1,327
1,<environment.Job instance at 0x7f386faf6fa0>,120,2,[ 4 14],121,-1,401,-1,399
1,<environment.Job instance at 0x7f386f8a1b90>,1,13,[9 1],2,-1,18,-1,5
1,<environment.Job instance at 0x7f386f8a11e0>,5,20,[10  3],6,-1,26,-1,6
1,<environment.Job instance at 0x7f386f8a1500>,6,12,[3 5],7,-1,19,-1,7
1,<environment.Job instance at 0x7f386ec82190>,12,18,[9 2],13,-1,32,-1,14
1,<environment.Job instance at 0x7f386ec82960>,14,14,[5 9],15,-1,29,-1,15
1,<environment.Job instance at 0x7f386ec823c0>,15,14,[6 3],16,-1,30,-1,16
1,<environment.Job instance at 0x7f386ec824b0>,17,23,[6 1],18,-1,41,-1,18
1,<environment.Job instance at 0x7f386f8a1050>,3,17,[14  2],4,-1,39,-1,22
1,<environment.Job instance at 0x7f386ec82d20>,21,14,[1 5],22,-1,37,-1,23
1,<environment.Job instance at 0x7f386f8a1fa0>,4,15,[10  2],5,-1,42,-1,27
1,<environment.Job instance at 0x7f386f820b90>,25,12,[8 3],26,-1,40,-1,28
1,<environment.Job instance at 0x7f386f820820>,27,17,[5 5],28,-1,48,-1,31
1,<environment.Job instance at 0x7f386f820280>,29,14,[8 5],30,-1,57,-1,43
1,<environment.Job instance at 0x7f386f8205f0>,28,14,[9 5],29,-1,67,-1,53
1,<environment.Job instance at 0x7f386f820730>,34,28,[ 5 10],35,-1,81,-1,53
1,<environment.Job instance at 0x7f386f820af0>,31,15,[7 3],32,-1,70,-1,55
1,<environment.Job instance at 0x7f386f8208c0>,37,27,[2 9],38,-1,83,-1,56
1,<environment.Job instance at 0x7f386f820a00>,30,25,[9 4],31,-1,81,-1,56
1,<environment.Job instance at 0x7f386f8204b0>,38,26,[4 9],39,-1,82,-1,56
1,<environment.Job instance at 0x7f386f8203c0>,32,17,[1 5],33,-1,73,-1,56
1,<environment.Job instance at 0x7f386f820c80>,44,16,[8 1],45,-1,73,-1,57
1,<environment.Job instance at 0x7f386f9f3f50>,46,16,[ 5 12],47,-1,73,-1,57
1,<environment.Job instance at 0x7f386f9f3320>,48,19,[2 7],49,-1,81,-1,62
1,<environment.Job instance at 0x7f386f820640>,41,14,[8 4],42,-1,76,-1,62
1,<environment.Job instance at 0x7f386f9f3b90>,51,2,[6 2],52,-1,65,-1,63
1,<environment.Job instance at 0x7f386f9f3f00>,55,13,[5 5],56,-1,78,-1,65
1,<environment.Job instance at 0x7f386f9f3500>,52,22,[5 4],53,-1,87,-1,65
1,<environment.Job instance at 0x7f386f9f3c80>,56,18,[1 5],57,-1,83,-1,65
1,<environment.Job instance at 0x7f386f9f31e0>,58,17,[7 5],59,-1,83,-1,66
1,<environment.Job instance at 0x7f386f9f3d20>,59,13,[4 8],60,-1,79,-1,66
1,<environment.Job instance at 0x7f386f64cbe0>,60,17,[10  1],61,-1,83,-1,66
1,<environment.Job instance at 0x7f386f64cc30>,61,16,[2 5],62,-1,82,-1,66
1,<environment.Job instance at 0x7f386f64c230>,63,16,[1 5],64,-1,83,-1,67
1,<environment.Job instance at 0x7f386f64c820>,65,15,[5 4],66,-1,82,-1,67
1,<environment.Job instance at 0x7f386f64ce10>,66,17,[ 2 14],67,-1,84,-1,67
1,<environment.Job instance at 0x7f386f64c460>,67,26,[10  5],68,-1,94,-1,68
1,<environment.Job instance at 0x7f386f64c320>,62,15,[2 5],63,-1,83,-1,68
1,<environment.Job instance at 0x7f386f876a00>,71,18,[4 9],72,-1,111,-1,93
1,<environment.Job instance at 0x7f386f8767d0>,70,18,[4 5],71,-1,116,-1,98
1,<environment.Job instance at 0x7f386f876640>,74,19,[2 5],75,-1,118,-1,99
1,<environment.Job instance at 0x7f386f8763c0>,76,14,[5 4],77,-1,113,-1,99
1,<environment.Job instance at 0x7f386f876fa0>,75,14,[ 3 10],76,-1,113,-1,99
1,<environment.Job instance at 0x7f386f876190>,83,23,[1 7],84,-1,128,-1,105
1,<environment.Job instance at 0x7f386f876050>,84,22,[1 8],85,-1,127,-1,105
1,<environment.Job instance at 0x7f386f8202d0>,40,18,[5 4],41,-1,129,-1,111
1,<environment.Job instance at 0x7f386f028370>,90,16,[4 8],91,-1,132,-1,116
1,<environment.Job instance at 0x7f386f028cd0>,89,17,[9 1],90,-1,142,-1,125
1,<environment.Job instance at 0x7f386f876500>,85,18,[ 2 10],86,-1,144,-1,126
1,<environment.Job instance at 0x7f386f820910>,26,18,[ 2 10],27,-1,145,-1,127
1,<environment.Job instance at 0x7f386f0283c0>,93,17,[ 4 10],94,-1,150,-1,133
1,<environment.Job instance at 0x7f386f028280>,95,15,[8 3],96,-1,148,-1,133
1,<environment.Job instance at 0x7f386f028aa0>,100,13,[10  5],101,-1,146,-1,133
1,<environment.Job instance at 0x7f386f028780>,88,13,[14  3],89,-1,148,-1,135
1,<environment.Job instance at 0x7f386f028b90>,102,22,[5 3],103,-1,157,-1,135
1,<environment.Job instance at 0x7f386f0288c0>,101,12,[8 2],102,-1,147,-1,135
1,<environment.Job instance at 0x7f386f811a00>,107,24,[2 8],108,-1,167,-1,143
1,<environment.Job instance at 0x7f386f811e10>,110,12,[ 5 10],111,-1,155,-1,143
1,<environment.Job instance at 0x7f386f8116e0>,109,13,[14  2],110,-1,158,-1,145
1,<environment.Job instance at 0x7f386f0281e0>,104,15,[4 7],105,-1,160,-1,145
1,<environment.Job instance at 0x7f386f811460>,111,16,[4 9],112,-1,161,-1,145
1,<environment.Job instance at 0x7f386f1b9d20>,116,18,[7 1],117,-1,163,-1,145
1,<environment.Job instance at 0x7f386f792a00>,121,23,[9 4],122,-1,168,-1,145
1,<environment.Job instance at 0x7f3878787aa0>,119,15,[ 1 14],120,-1,160,-1,145
1,<environment.Job instance at 0x7f3878ce4d70>,122,13,[1 9],123,-1,159,-1,146
1,<environment.Job instance at 0x7f386f811780>,113,26,[1 8],114,-1,172,-1,146
1,<environment.Job instance at 0x7f386fb88d70>,126,16,[9 3],127,-1,163,-1,147
1,<environment.Job instance at 0x7f386f021c30>,130,17,[4 7],131,-1,164,-1,147
1,<environment.Job instance at 0x7f386f0287d0>,94,15,[5 3],95,-1,162,-1,147
1,<environment.Job instance at 0x7f386e99d780>,124,14,[2 7],125,-1,161,-1,147
1,<environment.Job instance at 0x7f386f811b90>,112,15,[1 6],113,-1,171,-1,156
1,<environment.Job instance at 0x7f386efe6a50>,133,12,[4 5],134,-1,168,-1,156
1,<environment.Job instance at 0x7f386ea477d0>,137,17,[4 6],138,-1,173,-1,156
1,<environment.Job instance at 0x7f386ec40550>,3,17,[14  2],4,-1,21,-1,4
1,<environment.Job instance at 0x7f3878dfc8c0>,16,2,[ 5 12],17,-1,37,-1,35
1,<environment.Job instance at 0x7f386f509b90>,17,23,[6 1],18,-1,60,-1,37
1,<environment.Job instance at 0x7f3878740e10>,30,25,[9 4],31,-1,104,-1,79
1,<environment.Job instance at 0x7f386ed6b960>,34,28,[ 5 10],35,-1,124,-1,96
1,<environment.Job instance at 0x7f386f5b7050>,37,27,[2 9],38,-1,124,-1,97
1,<environment.Job instance at 0x7f386f5b7d70>,38,26,[4 9],39,-1,123,-1,97
1,<environment.Job instance at 0x7f387005ca00>,46,16,[ 5 12],47,-1,131,-1,115
1,<environment.Job instance at 0x7f386e99cb90>,66,17,[ 2 14],67,-1,199,-1,182
1,<environment.Job instance at 0x7f386f6a2dc0>,67,26,[10  5],68,-1,210,-1,184
1,<environment.Job instance at 0x7f386f16e460>,83,23,[1 7],84,-1,259,-1,236
1,<environment.Job instance at 0x7f386f16ef50>,88,13,[14  3],89,-1,251,-1,238
1,<environment.Job instance at 0x7f386f16eb40>,92,26,[1 5],93,-1,281,-1,255
1,<environment.Job instance at 0x7f386f91b280>,107,24,[2 8],108,-1,351,-1,327
1,<environment.Job instance at 0x7f386f7eee60>,109,13,[14  2],110,-1,340,-1,327
1,<environment.Job instance at 0x7f386f640fa0>,113,26,[1 8],114,-1,377,-1,351
1,<environment.Job instance at 0x7f386f4ca370>,119,15,[ 1 14],120,-1,378,-1,363
1,<environment.Job instance at 0x7f386fb4faa0>,121,23,[9 4],122,-1,392,-1,369
1,<environment.Job instance at 0x7f386ebb8a50>,0,18,[3 6],1,-1,19,-1,1
1,<environment.Job instance at 0x7f386f506aa0>,2,16,[1 9],3,-1,19,-1,3
1,<environment.Job instance at 0x7f386f506280>,4,12,[10  3],5,-1,19,-1,7
1,<environment.Job instance at 0x7f386f506960>,6,16,[2 7],7,-1,23,-1,7
1,<environment.Job instance at 0x7f3878c0af50>,10,14,[1 9],11,-1,25,-1,11
1,<environment.Job instance at 0x7f386f3c2e60>,14,17,[10  5],15,-1,32,-1,15
1,<environment.Job instance at 0x7f386f3c2f50>,15,15,[1 6],16,-1,31,-1,16
1,<environment.Job instance at 0x7f386f3c2d70>,17,16,[11  5],18,-1,34,-1,18
1,<environment.Job instance at 0x7f38701acfa0>,25,17,[ 5 10],26,-1,46,-1,29
1,<environment.Job instance at 0x7f3878718190>,32,16,[5 3],33,-1,49,-1,33
1,<environment.Job instance at 0x7f3878718550>,33,16,[9 5],34,-1,67,-1,51
1,<environment.Job instance at 0x7f3878718410>,34,16,[8 5],35,-1,69,-1,53
1,<environment.Job instance at 0x7f3878718a00>,39,16,[6 2],40,-1,69,-1,53
1,<environment.Job instance at 0x7f38787189b0>,37,14,[ 5 10],38,-1,67,-1,53
1,<environment.Job instance at 0x7f3878718500>,42,16,[9 3],43,-1,69,-1,53
1,<environment.Job instance at 0x7f3878718230>,44,16,[7 3],45,-1,70,-1,54
1,<environment.Job instance at 0x7f3878718fa0>,41,12,[2 5],42,-1,66,-1,54
1,<environment.Job instance at 0x7f3878718f00>,45,22,[5 2],46,-1,77,-1,55
1,<environment.Job instance at 0x7f386e86fb40>,50,13,[11  3],51,-1,68,-1,55
1,<environment.Job instance at 0x7f38701acaf0>,26,12,[5 6],27,-1,67,-1,55
1,<environment.Job instance at 0x7f386e86f550>,51,28,[7 5],52,-1,83,-1,55
1,<environment.Job instance at 0x7f386e86fc80>,52,14,[6 1],53,-1,69,-1,55
1,<environment.Job instance at 0x7f386e86f910>,54,26,[7 1],55,-1,81,-1,55
1,<environment.Job instance at 0x7f386e86fc30>,55,18,[10  4],56,-1,74,-1,56
1,<environment.Job instance at 0x7f386e86f280>,48,13,[5 7],49,-1,71,-1,58
1,<environment.Job instance at 0x7f386eb9fd20>,62,18,[3 6],63,-1,161,-1,143
1,<environment.Job instance at 0x7f386eb9f1e0>,61,18,[4 9],62,-1,161,-1,143
1,<environment.Job instance at 0x7f386eb9f4b0>,65,16,[2 7],66,-1,159,-1,143
1,<environment.Job instance at 0x7f386eb9ffa0>,68,18,[8 3],69,-1,161,-1,143
1,<environment.Job instance at 0x7f386eb9f820>,67,13,[13  4],68,-1,157,-1,144
1,<environment.Job instance at 0x7f386fb21550>,73,18,[6 3],74,-1,162,-1,144
1,<environment.Job instance at 0x7f386eb9f230>,72,15,[ 2 10],73,-1,159,-1,144
1,<environment.Job instance at 0x7f386fb21e10>,74,17,[10  3],75,-1,161,-1,144
1,<environment.Job instance at 0x7f386fb216e0>,76,13,[11  3],77,-1,157,-1,144
1,<environment.Job instance at 0x7f386fb21af0>,77,18,[6 4],78,-1,162,-1,144
1,<environment.Job instance at 0x7f386fb21fa0>,75,18,[ 2 11],76,-1,162,-1,144
1,<environment.Job instance at 0x7f386fb21eb0>,78,27,[5 1],79,-1,171,-1,144
1,<environment.Job instance at 0x7f386fb219b0>,79,15,[9 3],80,-1,161,-1,146
1,<environment.Job instance at 0x7f386eb9f460>,69,15,[6 5],70,-1,161,-1,146
1,<environment.Job instance at 0x7f386fa3f6e0>,86,15,[4 7],87,-1,161,-1,146
1,<environment.Job instance at 0x7f386fb21be0>,83,12,[4 8],84,-1,158,-1,146
1,<environment.Job instance at 0x7f386fa3f0f0>,88,27,[1 7],89,-1,173,-1,146
1,<environment.Job instance at 0x7f386fa3ffa0>,89,16,[12  5],90,-1,162,-1,146
1,<environment.Job instance at 0x7f386eb2a2d0>,97,17,[13  5],98,-1,164,-1,147
1,<environment.Job instance at 0x7f386eb2aaf0>,95,13,[3 7],96,-1,160,-1,147
1,<environment.Job instance at 0x7f386eb2ad70>,100,17,[5 9],101,-1,165,-1,148
1,<environment.Job instance at 0x7f386eb2a0a0>,101,17,[9 4],102,-1,165,-1,148
1,<environment.Job instance at 0x7f386f9b0050>,104,14,[9 5],105,-1,162,-1,148
1,<environment.Job instance at 0x7f386f9b0910>,105,14,[6 1],106,-1,162,-1,148
1,<environment.Job instance at 0x7f386f9b0be0>,106,16,[3 8],107,-1,165,-1,149
1,<environment.Job instance at 0x7f386f9b0870>,107,18,[ 5 10],108,-1,169,-1,151
1,<environment.Job instance at 0x7f386f9b0eb0>,108,15,[1 8],109,-1,166,-1,151
1,<environment.Job instance at 0x7f386eb2aa50>,99,13,[4 5],100,-1,164,-1,151
1,<environment.Job instance at 0x7f386f9b04b0>,110,13,[7 3],111,-1,164,-1,151
1,<environment.Job instance at 0x7f386f9b0190>,114,18,[ 2 10],115,-1,170,-1,152
1,<environment.Job instance at 0x7f386eb9f960>,70,24,[10  5],71,-1,176,-1,152
1,<environment.Job instance at 0x7f386f9b05a0>,115,14,[8 4],116,-1,166,-1,152
1,<environment.Job instance at 0x7f386f9b0e60>,117,18,[5 9],118,-1,171,-1,153
1,<environment.Job instance at 0x7f3870008050>,120,17,[8 2],121,-1,170,-1,153
1,<environment.Job instance at 0x7f3870008dc0>,121,14,[4 9],122,-1,168,-1,154
1,<environment.Job instance at 0x7f38700085f0>,122,16,[6 2],123,-1,170,-1,154
1,<environment.Job instance at 0x7f3870008230>,125,13,[2 7],126,-1,168,-1,155
1,<environment.Job instance at 0x7f386f2ff500>,128,25,[5 5],129,-1,182,-1,157
1,<environment.Job instance at 0x7f386e8bd870>,130,18,[14  5],131,-1,175,-1,157
1,<environment.Job instance at 0x7f386e8bdaf0>,131,15,[ 1 12],132,-1,172,-1,157
1,<environment.Job instance at 0x7f386f6dac80>,124,15,[2 5],125,-1,172,-1,157
1,<environment.Job instance at 0x7f386e8bdfa0>,132,13,[3 7],133,-1,170,-1,157
1,<environment.Job instance at 0x7f386e8bde60>,134,14,[7 4],135,-1,171,-1,157
1,<environment.Job instance at 0x7f386e8bd1e0>,135,14,[5 9],136,-1,171,-1,157
1,<environment.Job instance at 0x7f386e8bda50>,136,15,[2 7],137,-1,172,-1,157
1,<environment.Job instance at 0x7f386e8bda00>,137,16,[3 5],138,-1,174,-1,158
1,<environment.Job instance at 0x7f386f9b0cd0>,116,18,[ 2 10],117,-1,176,-1,158
1,<environment.Job instance at 0x7f386e8bd9b0>,138,17,[2 7],139,-1,175,-1,158
1,<environment.Job instance at 0x7f386f4a9730>,17,16,[11  5],18,-1,64,-1,48
1,<environment.Job instance at 0x7f386f4ad4b0>,21,3,[13  1],22,-1,68,-1,65
1,<environment.Job instance at 0x7f38786a4910>,35,1,[ 3 12],36,-1,115,-1,114
1,<environment.Job instance at 0x7f386f1a6e10>,38,3,[ 5 12],39,-1,122,-1,119
1,<environment.Job instance at 0x7f386ef06a50>,46,1,[11  1],47,-1,161,-1,160
1,<environment.Job instance at 0x7f386f37d4b0>,50,13,[11  3],51,-1,186,-1,173
1,<environment.Job instance at 0x7f386f27acd0>,51,28,[7 5],52,-1,202,-1,174
1,<environment.Job instance at 0x7f386f784be0>,53,2,[14  5],54,-1,176,-1,174
1,<environment.Job instance at 0x7f386f879be0>,54,26,[7 1],55,-1,202,-1,176
1,<environment.Job instance at 0x7f3878727be0>,67,13,[13  4],68,-1,229,-1,216
1,<environment.Job instance at 0x7f386f509b90>,71,3,[ 4 12],72,-1,244,-1,241
1,<environment.Job instance at 0x7f3878dfc8c0>,70,24,[10  5],71,-1,283,-1,259
1,<environment.Job instance at 0x7f386ff93f50>,75,18,[ 2 11],76,-1,277,-1,259
1,<environment.Job instance at 0x7f387874b7d0>,76,13,[11  3],77,-1,272,-1,259
1,<environment.Job instance at 0x7f386fc01870>,78,27,[5 1],79,-1,303,-1,276
1,<environment.Job instance at 0x7f386ef23dc0>,88,27,[1 7],89,-1,325,-1,298
1,<environment.Job instance at 0x7f386fa31190>,89,16,[12  5],90,-1,314,-1,298
1,<environment.Job instance at 0x7f386fdd4370>,96,1,[14  4],97,-1,317,-1,316
1,<environment.Job instance at 0x7f386fdd47d0>,97,17,[13  5],98,-1,333,-1,316
1,<environment.Job instance at 0x7f386fed7b90>,128,25,[5 5],129,-1,487,-1,462
1,<environment.Job instance at 0x7f386fed75f0>,130,18,[14  5],131,-1,480,-1,462
1,<environment.Job instance at 0x7f386f9c6050>,131,15,[ 1 12],132,-1,477,-1,462
1,<environment.Job instance at 0x7f386ed8d4b0>,0,22,[4 6],1,-1,23,-1,1
1,<environment.Job instance at 0x7f387015acd0>,2,18,[5 6],3,-1,21,-1,3
1,<environment.Job instance at 0x7f3870182af0>,4,18,[10  2],5,-1,24,-1,6
1,<environment.Job instance at 0x7f386f4255a0>,6,1,[6 4],7,-1,8,-1,7
1,<environment.Job instance at 0x7f3870182aa0>,5,17,[3 9],6,-1,25,-1,8
1,<environment.Job instance at 0x7f387015a640>,8,12,[10  5],9,-1,25,-1,13
1,<environment.Job instance at 0x7f386ea07640>,13,2,[8 3],14,-1,16,-1,14
1,<environment.Job instance at 0x7f386ea07370>,12,17,[ 3 14],13,-1,31,-1,14
1,<environment.Job instance at 0x7f386ea07eb0>,23,14,[9 2],24,-1,39,-1,25
1,<environment.Job instance at 0x7f386f989460>,29,15,[4 9],30,-1,45,-1,30
1,<environment.Job instance at 0x7f386f9895f0>,30,15,[1 6],31,-1,46,-1,31
1,<environment.Job instance at 0x7f386f989370>,31,22,[2 9],32,-1,54,-1,32
1,<environment.Job instance at 0x7f386f989a00>,35,16,[8 5],36,-1,52,-1,36
1,<environment.Job instance at 0x7f386f989eb0>,39,18,[7 2],40,-1,58,-1,40
1,<environment.Job instance at 0x7f386ea07e10>,24,15,[3 7],25,-1,59,-1,44
1,<environment.Job instance at 0x7f386f9a51e0>,56,16,[ 5 10],57,-1,86,-1,70
1,<environment.Job instance at 0x7f386f9a5280>,57,12,[6 2],58,-1,82,-1,70
1,<environment.Job instance at 0x7f386f9a6960>,48,18,[ 4 12],49,-1,88,-1,70
1,<environment.Job instance at 0x7f386f9a6b40>,51,12,[4 5],52,-1,82,-1,70
1,<environment.Job instance at 0x7f386f9a5190>,60,1,[7 1],61,-1,71,-1,70
1,<environment.Job instance at 0x7f386f9a5550>,63,14,[1 8],64,-1,86,-1,72
1,<environment.Job instance at 0x7f386f9a54b0>,62,20,[5 2],63,-1,94,-1,74
1,<environment.Job instance at 0x7f386f9a6cd0>,52,18,[ 5 10],53,-1,92,-1,74
1,<environment.Job instance at 0x7f386f9a55f0>,64,12,[3 9],65,-1,86,-1,74
1,<environment.Job instance at 0x7f386f9a5d70>,73,15,[8 4],74,-1,89,-1,74
1,<environment.Job instance at 0x7f386f4397d0>,75,13,[5 1],76,-1,89,-1,76
1,<environment.Job instance at 0x7f386f9a57d0>,67,15,[13  3],68,-1,107,-1,92
1,<environment.Job instance at 0x7f386f439820>,76,20,[4 9],77,-1,112,-1,92
1,<environment.Job instance at 0x7f386f42ba00>,81,2,[ 2 13],82,-1,94,-1,92
1,<environment.Job instance at 0x7f386f42b5f0>,80,16,[6 2],81,-1,108,-1,92
1,<environment.Job instance at 0x7f386f42b2d0>,83,21,[5 7],84,-1,113,-1,92
1,<environment.Job instance at 0x7f386f42b910>,84,14,[10  4],85,-1,106,-1,92
1,<environment.Job instance at 0x7f386f42bbe0>,85,17,[4 9],86,-1,109,-1,92
1,<environment.Job instance at 0x7f386e9ffcd0>,87,13,[7 4],88,-1,105,-1,92
1,<environment.Job instance at 0x7f386ea07960>,18,18,[13  3],19,-1,110,-1,92
1,<environment.Job instance at 0x7f386ef60b40>,90,13,[10  1],91,-1,105,-1,92
1,<environment.Job instance at 0x7f386e916b90>,93,25,[9 3],94,-1,141,-1,116
1,<environment.Job instance at 0x7f387015baf0>,89,27,[ 5 11],90,-1,148,-1,121
1,<environment.Job instance at 0x7f386f391f50>,92,19,[4 7],93,-1,141,-1,122
1,<environment.Job instance at 0x7f386e94bc80>,96,19,[9 4],97,-1,142,-1,123
1,<environment.Job instance at 0x7f386f9a6e60>,54,26,[10  2],55,-1,150,-1,124
1,<environment.Job instance at 0x7f386f98e410>,101,14,[2 7],102,-1,138,-1,124
1,<environment.Job instance at 0x7f386f5cc230>,103,18,[10  5],104,-1,144,-1,126
1,<environment.Job instance at 0x7f386f5cc2d0>,104,1,[7 2],105,-1,133,-1,132
1,<environment.Job instance at 0x7f386f98e550>,100,26,[9 4],101,-1,159,-1,133
1,<environment.Job instance at 0x7f386f914cd0>,108,24,[8 3],109,-1,157,-1,133
1,<environment.Job instance at 0x7f386f926190>,95,13,[6 4],96,-1,147,-1,134
1,<environment.Job instance at 0x7f386f9149b0>,113,2,[1 5],114,-1,136,-1,134
1,<environment.Job instance at 0x7f386f9145f0>,112,15,[ 3 10],113,-1,149,-1,134
1,<environment.Job instance at 0x7f386f914e10>,114,17,[9 5],115,-1,151,-1,134
1,<environment.Job instance at 0x7f386f914eb0>,115,14,[2 9],116,-1,149,-1,135
1,<environment.Job instance at 0x7f386f9147d0>,117,12,[ 3 10],118,-1,150,-1,138
1,<environment.Job instance at 0x7f386f9143c0>,109,14,[3 5],110,-1,152,-1,138
1,<environment.Job instance at 0x7f386f905eb0>,119,19,[2 9],120,-1,159,-1,140
1,<environment.Job instance at 0x7f386f9051e0>,120,22,[1 9],121,-1,163,-1,141
1,<environment.Job instance at 0x7f386f9215a0>,124,13,[10  5],125,-1,154,-1,141
1,<environment.Job instance at 0x7f386f9216e0>,125,14,[10  1],126,-1,157,-1,143
1,<environment.Job instance at 0x7f386f921820>,128,2,[ 4 12],129,-1,145,-1,143
1,<environment.Job instance at 0x7f386f5cc8c0>,105,14,[13  2],106,-1,158,-1,144
1,<environment.Job instance at 0x7f386f921b40>,127,17,[1 7],128,-1,162,-1,145
1,<environment.Job instance at 0x7f386f5c3b90>,131,16,[2 6],132,-1,167,-1,151
1,<environment.Job instance at 0x7f386f910c80>,136,13,[12  4],137,-1,164,-1,151
1,<environment.Job instance at 0x7f386f910fa0>,137,3,[4 9],138,-1,154,-1,151
1,<environment.Job instance at 0x7f386f8ffb40>,133,26,[2 9],134,-1,177,-1,151
1,<environment.Job instance at 0x7f386f910e60>,138,14,[1 6],139,-1,166,-1,152
1,<environment.Job instance at 0x7f386f9211e0>,12,17,[ 3 14],13,-1,40,-1,23
1,<environment.Job instance at 0x7f386f8ffc30>,15,16,[ 4 12],16,-1,42,-1,26
1,<environment.Job instance at 0x7f3870185370>,18,18,[13  3],19,-1,57,-1,39
1,<environment.Job instance at 0x7f386f9a1b40>,19,1,[ 4 14],20,-1,40,-1,39
1,<environment.Job instance at 0x7f386eedd550>,22,16,[14  1],23,-1,59,-1,43
1,<environment.Job instance at 0x7f386eb9fa50>,25,1,[ 5 13],26,-1,45,-1,44
1,<environment.Job instance at 0x7f3878718460>,33,3,[ 5 11],34,-1,78,-1,75
1,<environment.Job instance at 0x7f386f48de60>,41,3,[ 3 11],42,-1,98,-1,95
1,<environment.Job instance at 0x7f3878727be0>,48,18,[ 4 12],49,-1,126,-1,108
1,<environment.Job instance at 0x7f386ed6bdc0>,54,26,[10  2],55,-1,162,-1,136
1,<environment.Job instance at 0x7f38786a4820>,67,15,[13  3],68,-1,179,-1,164
1,<environment.Job instance at 0x7f3878787cd0>,81,2,[ 2 13],82,-1,192,-1,190
1,<environment.Job instance at 0x7f386f4ca140>,88,2,[12  1],89,-1,210,-1,208
1,<environment.Job instance at 0x7f386fb4faa0>,89,27,[ 5 11],90,-1,235,-1,208
1,<environment.Job instance at 0x7f386f6ee730>,93,25,[9 3],94,-1,259,-1,234
1,<environment.Job instance at 0x7f386fe606e0>,98,17,[ 2 12],99,-1,264,-1,247
1,<environment.Job instance at 0x7f3878a92cd0>,100,26,[9 4],101,-1,277,-1,251
1,<environment.Job instance at 0x7f38787192d0>,105,14,[13  2],106,-1,279,-1,265
1,<environment.Job instance at 0x7f38787194b0>,108,24,[8 3],109,-1,305,-1,281
1,<environment.Job instance at 0x7f3878725f50>,128,2,[ 4 12],129,-1,371,-1,369
1,<environment.Job instance at 0x7f386e8a3370>,133,26,[2 9],134,-1,417,-1,391
1,<environment.Job instance at 0x7f386ebb6460>,136,13,[12  4],137,-1,404,-1,391
1,<environment.Job instance at 0x7f386f5662d0>,3,18,[1 8],4,-1,23,-1,5
1,<environment.Job instance at 0x7f386e8dec80>,9,15,[8 4],10,-1,25,-1,10
1,<environment.Job instance at 0x7f386e8de730>,15,13,[2 6],16,-1,29,-1,16
1,<environment.Job instance at 0x7f386f4a0640>,18,18,[5 6],19,-1,37,-1,19
1,<environment.Job instance at 0x7f386fe5df00>,22,18,[7 3],23,-1,41,-1,23
1,<environment.Job instance at 0x7f386fc1f5a0>,25,16,[5 7],26,-1,42,-1,26
1,<environment.Job instance at 0x7f386f073870>,26,12,[4 6],27,-1,39,-1,27
1,<environment.Job instance at 0x7f3878ce51e0>,27,16,[3 5],28,-1,44,-1,28
1,<environment.Job instance at 0x7f386ec5e140>,29,23,[5 5],30,-1,53,-1,30
1,<environment.Job instance at 0x7f386ec5ef50>,30,17,[8 3],31,-1,48,-1,31
1,<environment.Job instance at 0x7f386fed7dc0>,4,13,[2 8],5,-1,50,-1,37
1,<environment.Job instance at 0x7f386f5d51e0>,35,24,[7 5],36,-1,78,-1,54
1,<environment.Job instance at 0x7f386fa93eb0>,47,14,[9 3],48,-1,69,-1,55
1,<environment.Job instance at 0x7f386f6af820>,42,17,[3 8],43,-1,72,-1,55
1,<environment.Job instance at 0x7f386fa93690>,49,15,[8 4],50,-1,70,-1,55
1,<environment.Job instance at 0x7f386fa936e0>,46,13,[ 1 10],47,-1,68,-1,55
1,<environment.Job instance at 0x7f386ec5e460>,33,13,[10  3],34,-1,69,-1,56
1,<environment.Job instance at 0x7f386fa93c30>,52,16,[6 3],53,-1,72,-1,56
1,<environment.Job instance at 0x7f386fa93f50>,51,15,[3 9],52,-1,71,-1,56
1,<environment.Job instance at 0x7f386f09bdc0>,62,28,[8 2],63,-1,94,-1,66
1,<environment.Job instance at 0x7f386f09b460>,63,22,[5 4],64,-1,88,-1,66
1,<environment.Job instance at 0x7f3870076870>,65,17,[ 4 10],66,-1,84,-1,67
1,<environment.Job instance at 0x7f386fa931e0>,55,19,[8 1],56,-1,91,-1,72
1,<environment.Job instance at 0x7f386e869e10>,73,18,[10  5],74,-1,94,-1,76
1,<environment.Job instance at 0x7f386faaa4b0>,76,16,[3 6],77,-1,93,-1,77
1,<environment.Job instance at 0x7f386eb9a6e0>,83,18,[4 9],84,-1,103,-1,85
1,<environment.Job instance at 0x7f386eb9abe0>,84,26,[7 4],85,-1,115,-1,89
1,<environment.Job instance at 0x7f386f1ad5a0>,88,16,[1 8],89,-1,106,-1,90
1,<environment.Job instance at 0x7f386f4505a0>,71,17,[6 5],72,-1,108,-1,91
1,<environment.Job instance at 0x7f386f289140>,94,17,[10  4],95,-1,116,-1,99
1,<environment.Job instance at 0x7f386e886640>,61,23,[7 5],62,-1,125,-1,102
1,<environment.Job instance at 0x7f386e878870>,98,16,[14  5],99,-1,118,-1,102
1,<environment.Job instance at 0x7f386f41fc30>,102,14,[ 2 12],103,-1,117,-1,103
1,<environment.Job instance at 0x7f386f681f00>,101,16,[8 1],102,-1,122,-1,106
1,<environment.Job instance at 0x7f386f5f59b0>,105,15,[ 2 12],106,-1,123,-1,108
1,<environment.Job instance at 0x7f386f625690>,107,19,[4 7],108,-1,127,-1,108
1,<environment.Job instance at 0x7f386f145550>,110,17,[2 8],111,-1,131,-1,114
1,<environment.Job instance at 0x7f3878b943c0>,112,12,[10  3],113,-1,128,-1,116
1,<environment.Job instance at 0x7f386fdccc30>,114,16,[6 3],115,-1,132,-1,116
1,<environment.Job instance at 0x7f38700799b0>,117,18,[7 1],118,-1,136,-1,118
1,<environment.Job instance at 0x7f386f96b7d0>,89,12,[9 3],90,-1,130,-1,118
1,<environment.Job instance at 0x7f386f94adc0>,115,1,[5 7],116,-1,119,-1,118
1,<environment.Job instance at 0x7f386e9ab5a0>,118,16,[10  3],119,-1,135,-1,119
1,<environment.Job instance at 0x7f386e9ab640>,119,15,[9 3],120,-1,135,-1,120
1,<environment.Job instance at 0x7f386f019320>,122,22,[6 2],123,-1,146,-1,124
1,<environment.Job instance at 0x7f386ff49d70>,124,23,[6 5],125,-1,148,-1,125
1,<environment.Job instance at 0x7f386f3cbb90>,123,16,[4 9],124,-1,145,-1,129
1,<environment.Job instance at 0x7f386f4a0870>,1,17,[13  5],2,-1,19,-1,2
1,<environment.Job instance at 0x7f386f8ff0a0>,29,23,[5 5],30,-1,96,-1,73
1,<environment.Job instance at 0x7f3870114550>,37,3,[ 2 13],38,-1,107,-1,104
1,<environment.Job instance at 0x7f386f566640>,35,24,[7 5],36,-1,137,-1,113
1,<environment.Job instance at 0x7f386f7f58c0>,50,1,[13  2],51,-1,141,-1,140
1,<environment.Job instance at 0x7f38701aca00>,53,1,[ 2 13],54,-1,154,-1,153
1,<environment.Job instance at 0x7f386f552c80>,56,1,[ 4 11],57,-1,168,-1,167
1,<environment.Job instance at 0x7f386f36ef00>,62,28,[8 2],63,-1,213,-1,185
1,<environment.Job instance at 0x7f386f36e730>,61,23,[7 5],62,-1,208,-1,185
1,<environment.Job instance at 0x7f386f5d1280>,84,26,[7 4],85,-1,252,-1,226
1,<environment.Job instance at 0x7f386f5d1b40>,85,1,[12  3],86,-1,227,-1,226
1,<environment.Job instance at 0x7f386e951a50>,98,16,[14  5],99,-1,284,-1,268
1,<environment.Job instance at 0x7f386f09ba00>,102,14,[ 2 12],103,-1,288,-1,274
1,<environment.Job instance at 0x7f386e8eb190>,105,15,[ 2 12],106,-1,292,-1,277
1,<environment.Job instance at 0x7f386f75fe60>,124,23,[6 5],125,-1,378,-1,355
1,<environment.Job instance at 0x7f386efa2780>,135,15,[ 5 11],136,-1,390,-1,375
1,<environment.Job instance at 0x7f386ee68e10>,0,26,[5 7],1,-1,27,-1,1
1,<environment.Job instance at 0x7f386ee686e0>,1,16,[ 2 10],2,-1,21,-1,5
1,<environment.Job instance at 0x7f386ee68500>,7,15,[1 7],8,-1,23,-1,8
1,<environment.Job instance at 0x7f386ee689b0>,4,20,[5 9],5,-1,137,-1,117
1,<environment.Job instance at 0x7f3878a926e0>,11,12,[8 3],12,-1,191,-1,179
1,<environment.Job instance at 0x7f386ee685f0>,3,15,[10  1],4,-1,202,-1,187
1,<environment.Job instance at 0x7f386ee684b0>,10,1,[8 1],11,-1,191,-1,190
1,<environment.Job instance at 0x7f386ee681e0>,9,27,[5 9],10,-1,221,-1,194
1,<environment.Job instance at 0x7f3878a92b90>,13,28,[3 5],14,-1,230,-1,202
1,<environment.Job instance at 0x7f3878a92460>,20,20,[5 8],21,-1,224,-1,204
1,<environment.Job instance at 0x7f3878a92910>,12,26,[ 1 10],13,-1,253,-1,227
1,<environment.Job instance at 0x7f386fbfbe60>,26,18,[3 5],27,-1,245,-1,227
1,<environment.Job instance at 0x7f386fbfb410>,32,16,[11  5],33,-1,245,-1,229
1,<environment.Job instance at 0x7f3878a92f50>,15,16,[10  2],16,-1,247,-1,231
1,<environment.Job instance at 0x7f386fbfb230>,31,12,[7 5],32,-1,243,-1,231
1,<environment.Job instance at 0x7f386fbfb370>,30,21,[5 2],31,-1,253,-1,232
1,<environment.Job instance at 0x7f386fed90a0>,35,2,[ 5 10],36,-1,234,-1,232
1,<environment.Job instance at 0x7f386fed9640>,34,18,[3 8],35,-1,250,-1,232
1,<environment.Job instance at 0x7f386fed97d0>,38,13,[5 9],39,-1,247,-1,234
1,<environment.Job instance at 0x7f386fed96e0>,36,14,[3 9],37,-1,248,-1,234
1,<environment.Job instance at 0x7f386fed9320>,41,17,[2 9],42,-1,251,-1,234
1,<environment.Job instance at 0x7f386fed9050>,46,12,[9 1],47,-1,246,-1,234
1,<environment.Job instance at 0x7f386fed94b0>,48,14,[7 3],49,-1,248,-1,234
1,<environment.Job instance at 0x7f386fed9550>,50,12,[3 8],51,-1,246,-1,234
1,<environment.Job instance at 0x7f386fed9eb0>,40,14,[5 5],41,-1,248,-1,234
1,<environment.Job instance at 0x7f386f7e1140>,55,23,[7 4],56,-1,257,-1,234
1,<environment.Job instance at 0x7f386f7e1b40>,54,18,[6 3],55,-1,252,-1,234
1,<environment.Job instance at 0x7f386f7e1280>,57,16,[2 6],58,-1,250,-1,234
1,<environment.Job instance at 0x7f386f7e1550>,58,25,[ 5 10],59,-1,259,-1,234
1,<environment.Job instance at 0x7f386f7e1d70>,56,23,[5 6],57,-1,257,-1,234
1,<environment.Job instance at 0x7f386f7e1af0>,59,15,[5 3],60,-1,249,-1,234
1,<environment.Job instance at 0x7f386f7e1a50>,61,12,[ 5 11],62,-1,247,-1,235
1,<environment.Job instance at 0x7f386f7e1370>,62,18,[9 5],63,-1,253,-1,235
1,<environment.Job instance at 0x7f386f7e1870>,60,17,[6 4],61,-1,252,-1,235
1,<environment.Job instance at 0x7f386f7e1820>,65,15,[9 5],66,-1,250,-1,235
1,<environment.Job instance at 0x7f386f7e17d0>,67,26,[ 2 10],68,-1,261,-1,235
1,<environment.Job instance at 0x7f386f7e1690>,68,14,[3 8],69,-1,249,-1,235
1,<environment.Job instance at 0x7f386f7e1c80>,63,17,[5 1],64,-1,252,-1,235
1,<environment.Job instance at 0x7f386f842370>,71,16,[8 5],72,-1,251,-1,235
1,<environment.Job instance at 0x7f386f7e1e10>,69,3,[2 9],70,-1,238,-1,235
1,<environment.Job instance at 0x7f386f6a4eb0>,73,17,[ 5 12],74,-1,252,-1,235
1,<environment.Job instance at 0x7f386f6a4690>,74,17,[5 7],75,-1,255,-1,238
1,<environment.Job instance at 0x7f386f6a4e10>,75,12,[5 1],76,-1,250,-1,238
1,<environment.Job instance at 0x7f386f6a4cd0>,78,15,[6 1],79,-1,254,-1,239
1,<environment.Job instance at 0x7f3878b05af0>,80,12,[6 1],81,-1,251,-1,239
1,<environment.Job instance at 0x7f386f842550>,70,13,[6 5],71,-1,252,-1,239
1,<environment.Job instance at 0x7f3878b69690>,85,15,[8 2],86,-1,256,-1,241
1,<environment.Job instance at 0x7f386ea6a2d0>,88,12,[12  2],89,-1,253,-1,241
1,<environment.Job instance at 0x7f386ea6a640>,89,14,[8 5],90,-1,255,-1,241
1,<environment.Job instance at 0x7f386fbfb7d0>,28,14,[7 5],29,-1,255,-1,241
1,<environment.Job instance at 0x7f386ea6a8c0>,91,18,[6 1],92,-1,259,-1,241
1,<environment.Job instance at 0x7f386ea6ad20>,93,14,[2 9],94,-1,256,-1,242
1,<environment.Job instance at 0x7f386ea6a910>,96,12,[3 5],97,-1,255,-1,243
1,<environment.Job instance at 0x7f386ea6a500>,98,12,[3 5],99,-1,258,-1,246
1,<environment.Job instance at 0x7f3878b69d70>,84,12,[ 4 10],85,-1,260,-1,248
1,<environment.Job instance at 0x7f3878e06cd0>,100,25,[8 3],101,-1,277,-1,252
1,<environment.Job instance at 0x7f386ea6a320>,94,12,[9 4],95,-1,264,-1,252
1,<environment.Job instance at 0x7f386e78efa0>,101,27,[8 1],102,-1,280,-1,253
1,<environment.Job instance at 0x7f386e84a190>,107,27,[2 6],108,-1,280,-1,253
1,<environment.Job instance at 0x7f386f4c4a00>,109,18,[5 2],110,-1,271,-1,253
1,<environment.Job instance at 0x7f386f685690>,112,13,[9 4],113,-1,266,-1,253
1,<environment.Job instance at 0x7f386e84aaf0>,106,17,[3 8],107,-1,271,-1,254
1,<environment.Job instance at 0x7f386ed52eb0>,115,18,[5 5],116,-1,273,-1,255
1,<environment.Job instance at 0x7f386f9330f0>,117,26,[ 5 10],118,-1,281,-1,255
1,<environment.Job instance at 0x7f386f4945a0>,118,14,[3 7],119,-1,269,-1,255
1,<environment.Job instance at 0x7f386f27abe0>,120,17,[4 8],121,-1,273,-1,256
1,<environment.Job instance at 0x7f386f49ef50>,121,17,[3 6],122,-1,273,-1,256
1,<environment.Job instance at 0x7f386f49eaa0>,122,17,[ 4 10],123,-1,273,-1,256
1,<environment.Job instance at 0x7f386fec9370>,129,18,[5 5],130,-1,275,-1,257
1,<environment.Job instance at 0x7f386fec9dc0>,128,3,[6 2],129,-1,261,-1,258
1,<environment.Job instance at 0x7f386fec9500>,131,18,[5 5],132,-1,286,-1,268
1,<environment.Job instance at 0x7f386fec95f0>,130,16,[5 4],131,-1,288,-1,272
1,<environment.Job instance at 0x7f3870119dc0>,0,26,[5 7],1,-1,27,-1,1
1,<environment.Job instance at 0x7f386e951be0>,9,27,[5 9],10,-1,45,-1,18
1,<environment.Job instance at 0x7f386e951eb0>,13,28,[3 5],14,-1,49,-1,21
1,<environment.Job instance at 0x7f386e9515f0>,12,26,[ 1 10],13,-1,59,-1,33
1,<environment.Job instance at 0x7f386f552c80>,29,14,[ 1 13],30,-1,73,-1,59
1,<environment.Job instance at 0x7f3878cda3c0>,32,16,[11  5],33,-1,77,-1,61
1,<environment.Job instance at 0x7f386fa93fa0>,55,23,[7 4],56,-1,164,-1,141
1,<environment.Job instance at 0x7f386fa93b40>,56,23,[5 6],57,-1,164,-1,141
1,<environment.Job instance at 0x7f386ed11320>,61,12,[ 5 11],62,-1,178,-1,166
1,<environment.Job instance at 0x7f386fa93190>,58,25,[ 5 10],59,-1,206,-1,181
1,<environment.Job instance at 0x7f386eac06e0>,67,26,[ 2 10],68,-1,212,-1,186
1,<environment.Job instance at 0x7f386fee5dc0>,73,17,[ 5 12],74,-1,227,-1,210
1,<environment.Job instance at 0x7f386e877230>,87,2,[ 5 11],88,-1,250,-1,248
1,<environment.Job instance at 0x7f386e877640>,88,12,[12  2],89,-1,260,-1,248
1,<environment.Job instance at 0x7f386f7ad4b0>,90,2,[ 4 14],91,-1,251,-1,249
1,<environment.Job instance at 0x7f38787364b0>,101,27,[8 1],102,-1,324,-1,297
1,<environment.Job instance at 0x7f3878736b40>,100,25,[8 3],101,-1,322,-1,297
1,<environment.Job instance at 0x7f3878736a00>,107,27,[2 6],108,-1,329,-1,302
1,<environment.Job instance at 0x7f386f41f3c0>,117,26,[ 5 10],118,-1,357,-1,331
1,<environment.Job instance at 0x7f386f41fa00>,119,1,[12  4],120,-1,332,-1,331
1,<environment.Job instance at 0x7f386f640be0>,124,1,[ 1 11],125,-1,362,-1,361
1,<environment.Job instance at 0x7f386f6408c0>,125,1,[ 3 14],126,-1,362,-1,361
1,<environment.Job instance at 0x7f386f361230>,132,28,[5 1],133,-1,408,-1,380
1,<environment.Job instance at 0x7f38786ff0f0>,1,17,[ 4 10],2,-1,19,-1,2
1,<environment.Job instance at 0x7f386f060460>,4,23,[2 9],5,-1,29,-1,6
1,<environment.Job instance at 0x7f386f6af5a0>,5,18,[5 3],6,-1,24,-1,6
1,<environment.Job instance at 0x7f386f0608c0>,10,12,[ 4 10],11,-1,23,-1,11
1,<environment.Job instance at 0x7f386f0609b0>,11,17,[6 1],12,-1,29,-1,12
1,<environment.Job instance at 0x7f386f060a50>,12,16,[9 2],13,-1,29,-1,13
1,<environment.Job instance at 0x7f386f060aa0>,13,15,[5 8],14,-1,29,-1,14
1,<environment.Job instance at 0x7f386f060e60>,18,26,[2 5],19,-1,45,-1,19
1,<environment.Job instance at 0x7f386f056140>,19,28,[4 8],20,-1,48,-1,20
1,<environment.Job instance at 0x7f386f056050>,20,28,[1 5],21,-1,49,-1,21
1,<environment.Job instance at 0x7f386f0563c0>,23,13,[10  1],24,-1,40,-1,27
1,<environment.Job instance at 0x7f386f056780>,26,22,[7 4],27,-1,49,-1,27
1,<environment.Job instance at 0x7f386f056640>,28,18,[5 5],29,-1,47,-1,29
1,<environment.Job instance at 0x7f386f056960>,29,15,[3 6],30,-1,46,-1,31
1,<environment.Job instance at 0x7f386f056d20>,34,18,[ 2 10],35,-1,57,-1,39
1,<environment.Job instance at 0x7f386f088140>,38,14,[9 3],39,-1,53,-1,39
1,<environment.Job instance at 0x7f386f0884b0>,42,18,[7 2],43,-1,61,-1,43
1,<environment.Job instance at 0x7f386f050050>,56,20,[10  4],57,-1,82,-1,62
1,<environment.Job instance at 0x7f386f0885a0>,44,16,[5 8],45,-1,80,-1,64
1,<environment.Job instance at 0x7f386f0889b0>,48,12,[3 8],49,-1,76,-1,64
1,<environment.Job instance at 0x7f386f050e10>,65,17,[5 8],66,-1,83,-1,66
1,<environment.Job instance at 0x7f386f077140>,70,16,[8 2],71,-1,87,-1,71
1,<environment.Job instance at 0x7f386f077050>,68,12,[6 2],69,-1,84,-1,72
1,<environment.Job instance at 0x7f386f088c30>,49,16,[ 3 10],50,-1,88,-1,72
1,<environment.Job instance at 0x7f386f0775a0>,72,17,[5 5],73,-1,90,-1,73
1,<environment.Job instance at 0x7f386f077640>,73,24,[9 2],74,-1,98,-1,74
1,<environment.Job instance at 0x7f386f0776e0>,74,13,[6 5],75,-1,88,-1,75
1,<environment.Job instance at 0x7f386f077780>,75,3,[ 4 10],76,-1,81,-1,78
1,<environment.Job instance at 0x7f386f077d20>,81,24,[2 6],82,-1,107,-1,83
1,<environment.Job instance at 0x7f386f077e10>,82,15,[4 9],83,-1,99,-1,84
1,<environment.Job instance at 0x7f386f084370>,86,15,[6 4],87,-1,102,-1,87
1,<environment.Job instance at 0x7f386f084690>,89,16,[ 1 10],90,-1,106,-1,90
1,<environment.Job instance at 0x7f386f077aa0>,79,15,[10  5],80,-1,107,-1,92
1,<environment.Job instance at 0x7f386f077460>,71,12,[9 4],72,-1,104,-1,92
1,<environment.Job instance at 0x7f386f084500>,91,13,[3 5],92,-1,107,-1,94
1,<environment.Job instance at 0x7f386f050230>,54,13,[6 5],55,-1,107,-1,94
1,<environment.Job instance at 0x7f386f084b90>,94,17,[11  5],95,-1,112,-1,95
1,<environment.Job instance at 0x7f386f084aa0>,95,15,[ 2 12],96,-1,111,-1,96
1,<environment.Job instance at 0x7f386f084c80>,96,12,[10  3],97,-1,109,-1,97
1,<environment.Job instance at 0x7f386f084870>,93,21,[5 4],94,-1,119,-1,98
1,<environment.Job instance at 0x7f386f41f320>,99,14,[5 9],100,-1,116,-1,102
1,<environment.Job instance at 0x7f386f04f5f0>,101,12,[4 6],102,-1,115,-1,103
1,<environment.Job instance at 0x7f386f04f4b0>,102,18,[10  3],103,-1,121,-1,103
1,<environment.Job instance at 0x7f386f04f410>,104,24,[5 8],105,-1,130,-1,106
1,<environment.Job instance at 0x7f386eb844b0>,107,18,[3 8],108,-1,126,-1,108
1,<environment.Job instance at 0x7f386f04f230>,106,24,[10  2],107,-1,133,-1,109
1,<environment.Job instance at 0x7f386f055c30>,116,23,[9 5],117,-1,141,-1,118
1,<environment.Job instance at 0x7f386f072050>,119,17,[6 3],120,-1,137,-1,120
1,<environment.Job instance at 0x7f386f072410>,123,17,[10  3],124,-1,141,-1,124
1,<environment.Job instance at 0x7f386f077b90>,80,12,[9 2],81,-1,138,-1,126
1,<environment.Job instance at 0x7f386f0723c0>,125,16,[7 4],126,-1,142,-1,126
1,<environment.Job instance at 0x7f386f072640>,126,13,[4 6],127,-1,141,-1,128
1,<environment.Job instance at 0x7f386f0880a0>,6,3,[14  4],7,-1,10,-1,7
1,<environment.Job instance at 0x7f386f088d70>,4,23,[2 9],5,-1,42,-1,19
1,<environment.Job instance at 0x7f386f057d20>,18,26,[2 5],19,-1,75,-1,49
1,<environment.Job instance at 0x7f386f04f0a0>,20,28,[1 5],21,-1,77,-1,49
1,<environment.Job instance at 0x7f386f072cd0>,27,28,[ 1 10],28,-1,91,-1,63
1,<environment.Job instance at 0x7f386eb84eb0>,19,28,[4 8],20,-1,91,-1,63
1,<environment.Job instance at 0x7f386f7ad3c0>,73,24,[9 2],74,-1,237,-1,213
1,<environment.Job instance at 0x7f386f3cbe10>,81,24,[2 6],82,-1,258,-1,234
1,<environment.Job instance at 0x7f3878a97870>,94,17,[11  5],95,-1,286,-1,269
1,<environment.Job instance at 0x7f3878a97460>,95,15,[ 2 12],96,-1,284,-1,269
1,<environment.Job instance at 0x7f386f625e10>,104,24,[5 8],105,-1,338,-1,314
1,<environment.Job instance at 0x7f387872cf50>,110,2,[14  3],111,-1,319,-1,317
1,<environment.Job instance at 0x7f386faaafa0>,106,24,[10  2],107,-1,351,-1,327
1,<environment.Job instance at 0x7f386f77ecd0>,116,23,[9 5],117,-1,368,-1,345
1,<environment.Job instance at 0x7f386f36e5a0>,129,1,[13  5],130,-1,398,-1,397
1,<environment.Job instance at 0x7f3870076a00>,133,27,[5 6],134,-1,435,-1,408
1,<environment.Job instance at 0x7f386e9790a0>,136,16,[ 3 11],137,-1,424,-1,408
1,<environment.Job instance at 0x7f386f7926e0>,138,25,[11  1],139,-1,434,-1,409
1,<environment.Job instance at 0x7f386f5f6280>,1,12,[10  1],2,-1,15,-1,3
1,<environment.Job instance at 0x7f386f5f6e60>,2,16,[7 1],3,-1,19,-1,3
1,<environment.Job instance at 0x7f386f5f6a00>,7,18,[4 5],8,-1,27,-1,9
1,<environment.Job instance at 0x7f386f5f6fa0>,9,17,[7 5],10,-1,27,-1,10
1,<environment.Job instance at 0x7f386f5f6eb0>,8,15,[5 4],9,-1,25,-1,10
1,<environment.Job instance at 0x7f386ec564b0>,13,18,[1 8],14,-1,33,-1,15
1,<environment.Job instance at 0x7f386ec56410>,15,27,[4 6],16,-1,43,-1,16
1,<environment.Job instance at 0x7f386ec567d0>,16,15,[8 5],17,-1,32,-1,17
1,<environment.Job instance at 0x7f386ec56a50>,18,12,[4 8],19,-1,36,-1,24
1,<environment.Job instance at 0x7f386fa14370>,23,12,[9 4],24,-1,38,-1,26
1,<environment.Job instance at 0x7f386f5815f0>,32,17,[3 8],33,-1,50,-1,33
1,<environment.Job instance at 0x7f386fcc9dc0>,30,14,[11  5],31,-1,48,-1,34
1,<environment.Job instance at 0x7f386ea0e2d0>,26,15,[5 2],27,-1,49,-1,34
1,<environment.Job instance at 0x7f387007f690>,34,28,[4 7],35,-1,63,-1,35
1,<environment.Job instance at 0x7f38700dafa0>,35,13,[ 3 10],36,-1,60,-1,47
1,<environment.Job instance at 0x7f386eec3fa0>,40,24,[9 4],41,-1,71,-1,47
1,<environment.Job instance at 0x7f386e91d5f0>,20,16,[10  3],21,-1,63,-1,47
1,<environment.Job instance at 0x7f387009d5a0>,41,17,[5 4],42,-1,64,-1,47
1,<environment.Job instance at 0x7f386ee606e0>,44,14,[3 7],45,-1,62,-1,48
1,<environment.Job instance at 0x7f386f7d42d0>,46,18,[10  1],47,-1,66,-1,48
1,<environment.Job instance at 0x7f386f792b90>,47,12,[3 7],48,-1,60,-1,48
1,<environment.Job instance at 0x7f386eec3820>,39,18,[8 2],40,-1,78,-1,60
1,<environment.Job instance at 0x7f386f0ec280>,49,15,[ 4 10],50,-1,75,-1,60
1,<environment.Job instance at 0x7f386e88a550>,53,17,[7 3],54,-1,77,-1,60
1,<environment.Job instance at 0x7f386ef5d5a0>,50,17,[3 8],51,-1,77,-1,60
1,<environment.Job instance at 0x7f386e88a0a0>,54,13,[7 1],55,-1,73,-1,60
1,<environment.Job instance at 0x7f386e88a370>,57,18,[3 9],58,-1,78,-1,60
1,<environment.Job instance at 0x7f387872c410>,58,12,[3 9],59,-1,72,-1,60
1,<environment.Job instance at 0x7f386eec3370>,38,14,[10  3],39,-1,78,-1,64
1,<environment.Job instance at 0x7f386fcaf410>,60,1,[6 3],61,-1,65,-1,64
1,<environment.Job instance at 0x7f386f0f43c0>,63,17,[10  3],64,-1,89,-1,72
1,<environment.Job instance at 0x7f386f0ecb90>,51,16,[12  1],52,-1,88,-1,72
1,<environment.Job instance at 0x7f3870104960>,66,16,[2 9],67,-1,90,-1,74
1,<environment.Job instance at 0x7f38701046e0>,67,22,[10  4],68,-1,96,-1,74
1,<environment.Job instance at 0x7f38701040f0>,68,21,[7 1],69,-1,95,-1,74
1,<environment.Job instance at 0x7f386e9f80f0>,72,21,[5 3],73,-1,95,-1,74
1,<environment.Job instance at 0x7f386e8648c0>,65,2,[9 3],66,-1,76,-1,74
1,<environment.Job instance at 0x7f386e9f82d0>,73,2,[9 1],74,-1,76,-1,74
1,<environment.Job instance at 0x7f386e8b7140>,74,15,[4 8],75,-1,90,-1,75
1,<environment.Job instance at 0x7f386e8b75f0>,75,3,[4 5],76,-1,79,-1,76
1,<environment.Job instance at 0x7f386e8b7190>,79,13,[3 8],80,-1,93,-1,80
1,<environment.Job instance at 0x7f386f655f00>,82,13,[2 6],83,-1,102,-1,89
1,<environment.Job instance at 0x7f386e864140>,64,15,[6 3],65,-1,104,-1,89
1,<environment.Job instance at 0x7f386ef71230>,86,21,[10  2],87,-1,111,-1,90
1,<environment.Job instance at 0x7f386fcd33c0>,80,14,[12  5],81,-1,111,-1,97
1,<environment.Job instance at 0x7f386fc420a0>,92,15,[3 8],93,-1,112,-1,97
1,<environment.Job instance at 0x7f386f14f8c0>,96,14,[ 2 10],97,-1,114,-1,100
1,<environment.Job instance at 0x7f386e82dc30>,97,14,[7 4],98,-1,115,-1,101
1,<environment.Job instance at 0x7f386f14f690>,94,16,[8 4],95,-1,117,-1,101
1,<environment.Job instance at 0x7f386fa3d370>,90,13,[1 5],91,-1,114,-1,101
1,<environment.Job instance at 0x7f386e82d500>,100,25,[ 4 10],101,-1,129,-1,104
1,<environment.Job instance at 0x7f386e82dd20>,98,14,[6 4],99,-1,118,-1,104
1,<environment.Job instance at 0x7f386ee78b40>,83,17,[6 4],84,-1,122,-1,105
1,<environment.Job instance at 0x7f386f175c30>,101,22,[9 1],102,-1,134,-1,112
1,<environment.Job instance at 0x7f386eb84780>,105,18,[2 9],106,-1,130,-1,112
1,<environment.Job instance at 0x7f386fec9870>,117,17,[ 5 10],118,-1,160,-1,143
1,<environment.Job instance at 0x7f386fec95f0>,119,16,[5 5],120,-1,159,-1,143
1,<environment.Job instance at 0x7f386f9c5be0>,129,28,[4 8],130,-1,182,-1,154
1,<environment.Job instance at 0x7f386ff461e0>,135,18,[7 4],136,-1,189,-1,171
1,<environment.Job instance at 0x7f386fc5e230>,4,27,[3 8],5,-1,44,-1,17
1,<environment.Job instance at 0x7f386f316e60>,10,18,[12  3],11,-1,35,-1,17
1,<environment.Job instance at 0x7f386f316500>,15,27,[4 6],16,-1,71,-1,44
1,<environment.Job instance at 0x7f386f0600a0>,30,14,[11  5],31,-1,108,-1,94
1,<environment.Job instance at 0x7f386ff42320>,34,28,[4 7],35,-1,148,-1,120
1,<environment.Job instance at 0x7f386f077d70>,40,24,[9 4],41,-1,169,-1,145
1,<environment.Job instance at 0x7f386f050eb0>,43,2,[12  3],44,-1,147,-1,145
1,<environment.Job instance at 0x7f386f088d70>,51,16,[12  1],52,-1,202,-1,186
1,<environment.Job instance at 0x7f3878718be0>,78,3,[14  4],79,-1,289,-1,286
1,<environment.Job instance at 0x7f386f552c80>,80,14,[12  5],81,-1,302,-1,288
1,<environment.Job instance at 0x7f386ea0ed20>,100,25,[ 4 10],101,-1,378,-1,353
1,<environment.Job instance at 0x7f386fb9cf50>,104,14,[ 2 11],105,-1,371,-1,357
1,<environment.Job instance at 0x7f386f5b18c0>,110,17,[ 5 14],111,-1,400,-1,383
1,<environment.Job instance at 0x7f386fe64460>,126,16,[12  5],127,-1,465,-1,449
1,<environment.Job instance at 0x7f38787240a0>,129,28,[4 8],130,-1,492,-1,464
1,<environment.Job instance at 0x7f386f6a0f50>,6,15,[10  5],7,-1,27,-1,12
1,<environment.Job instance at 0x7f386f6a0a00>,12,17,[ 1 10],13,-1,30,-1,13
1,<environment.Job instance at 0x7f386f6a0fa0>,14,15,[7 5],15,-1,30,-1,15
1,<environment.Job instance at 0x7f386f6a07d0>,16,15,[5 5],17,-1,32,-1,17
1,<environment.Job instance at 0x7f386f6a0780>,17,17,[9 4],18,-1,35,-1,18
1,<environment.Job instance at 0x7f386f6a0690>,20,18,[2 9],21,-1,39,-1,21
1,<environment.Job instance at 0x7f386f54a6e0>,22,16,[2 8],23,-1,39,-1,23
1,<environment.Job instance at 0x7f386f54ae60>,23,12,[3 6],24,-1,36,-1,24
1,<environment.Job instance at 0x7f386f54af00>,24,14,[7 2],25,-1,39,-1,25
1,<environment.Job instance at 0x7f386f6a0c30>,11,13,[ 3 11],12,-1,38,-1,25
1,<environment.Job instance at 0x7f386f54a9b0>,26,13,[10  2],27,-1,41,-1,28
1,<environment.Job instance at 0x7f386f54a460>,29,20,[7 2],30,-1,51,-1,31
1,<environment.Job instance at 0x7f386f54a500>,30,16,[1 9],31,-1,48,-1,32
1,<environment.Job instance at 0x7f386ff46780>,33,15,[9 4],34,-1,49,-1,34
1,<environment.Job instance at 0x7f386f0eaeb0>,37,12,[ 2 10],38,-1,51,-1,39
1,<environment.Job instance at 0x7f386f0f30a0>,39,12,[7 5],40,-1,52,-1,40
1,<environment.Job instance at 0x7f386f0f3870>,40,13,[ 2 13],41,-1,54,-1,41
1,<environment.Job instance at 0x7f386f0f31e0>,41,14,[ 5 10],42,-1,56,-1,42
1,<environment.Job instance at 0x7f386fd62690>,42,17,[5 8],43,-1,60,-1,43
1,<environment.Job instance at 0x7f3878a6a550>,38,22,[ 3 10],39,-1,65,-1,43
1,<environment.Job instance at 0x7f386f0f34b0>,43,14,[5 7],44,-1,58,-1,44
1,<environment.Job instance at 0x7f386fd62b40>,44,19,[3 7],45,-1,64,-1,45
1,<environment.Job instance at 0x7f386eefb190>,47,23,[3 5],48,-1,71,-1,48
1,<environment.Job instance at 0x7f386eefb050>,48,16,[1 9],49,-1,65,-1,49
1,<environment.Job instance at 0x7f386eefb9b0>,49,16,[1 8],50,-1,66,-1,50
1,<environment.Job instance at 0x7f386e9fb730>,55,15,[4 9],56,-1,72,-1,57
1,<environment.Job instance at 0x7f386f20d3c0>,56,16,[6 2],57,-1,74,-1,58
1,<environment.Job instance at 0x7f386f6bc280>,59,23,[8 2],60,-1,85,-1,62
1,<environment.Job instance at 0x7f3878739820>,63,19,[3 9],64,-1,83,-1,64
1,<environment.Job instance at 0x7f386f1fc370>,65,17,[9 1],66,-1,84,-1,67
1,<environment.Job instance at 0x7f386ea6a910>,67,14,[5 6],68,-1,82,-1,68
1,<environment.Job instance at 0x7f386f5b17d0>,69,18,[5 3],70,-1,88,-1,70
1,<environment.Job instance at 0x7f386f5b1aa0>,71,20,[10  2],72,-1,92,-1,72
1,<environment.Job instance at 0x7f386f5b1cd0>,74,14,[ 3 10],75,-1,89,-1,75
1,<environment.Job instance at 0x7f3878718280>,88,27,[6 3],89,-1,122,-1,95
1,<environment.Job instance at 0x7f386f3b6f00>,80,18,[8 3],81,-1,113,-1,95
1,<environment.Job instance at 0x7f386ece93c0>,66,12,[3 9],67,-1,107,-1,95
1,<environment.Job instance at 0x7f386f56a910>,99,13,[10  2],100,-1,140,-1,127
1,<environment.Job instance at 0x7f386f56a4b0>,100,23,[5 8],101,-1,150,-1,127
1,<environment.Job instance at 0x7f386f56a0f0>,102,17,[ 5 10],103,-1,144,-1,127
1,<environment.Job instance at 0x7f3878718460>,91,16,[5 5],92,-1,144,-1,128
1,<environment.Job instance at 0x7f386fca4dc0>,104,18,[3 5],105,-1,146,-1,128
1,<environment.Job instance at 0x7f38787180f0>,4,12,[ 4 13],5,-1,17,-1,5
1,<environment.Job instance at 0x7f386ec28b90>,10,2,[ 2 12],11,-1,13,-1,11
1,<environment.Job instance at 0x7f386f6a0a50>,11,13,[ 3 11],12,-1,25,-1,12
1,<environment.Job instance at 0x7f386efe66e0>,25,1,[14  5],26,-1,60,-1,59
1,<environment.Job instance at 0x7f386efe6690>,27,2,[ 5 12],28,-1,73,-1,71
1,<environment.Job instance at 0x7f386efe6460>,35,2,[ 2 12],36,-1,107,-1,105
1,<environment.Job instance at 0x7f386ef600a0>,40,13,[ 2 13],41,-1,131,-1,118
1,<environment.Job instance at 0x7f386f94ae60>,47,23,[3 5],48,-1,170,-1,147
1,<environment.Job instance at 0x7f386f7f0050>,50,28,[2 6],51,-1,187,-1,159
1,<environment.Job instance at 0x7f386e87c500>,59,23,[8 2],60,-1,204,-1,181
1,<environment.Job instance at 0x7f386ea4c4b0>,60,1,[13  1],61,-1,182,-1,181
1,<environment.Job instance at 0x7f386f0191e0>,73,15,[ 3 14],74,-1,240,-1,225
1,<environment.Job instance at 0x7f386fc58230>,78,3,[13  1],79,-1,247,-1,244
1,<environment.Job instance at 0x7f386fd23d70>,85,15,[14  4],86,-1,277,-1,262
1,<environment.Job instance at 0x7f386fd237d0>,88,27,[6 3],89,-1,306,-1,279
1,<environment.Job instance at 0x7f386ee60af0>,89,27,[3 5],90,-1,306,-1,279
1,<environment.Job instance at 0x7f386f5afe10>,92,2,[12  2],93,-1,281,-1,279
1,<environment.Job instance at 0x7f386f358d20>,100,23,[5 8],101,-1,340,-1,317
1,<environment.Job instance at 0x7f386ea50320>,107,12,[ 2 14],108,-1,354,-1,342
1,<environment.Job instance at 0x7f386f291820>,128,28,[9 5],129,-1,457,-1,429
1,<environment.Job instance at 0x7f386ef82d70>,130,1,[11  1],131,-1,430,-1,429
1,<environment.Job instance at 0x7f386fc6cf50>,2,18,[7 3],3,-1,21,-1,3
1,<environment.Job instance at 0x7f386ed48be0>,11,16,[4 9],12,-1,28,-1,12
1,<environment.Job instance at 0x7f386eb8c820>,12,15,[9 5],13,-1,28,-1,13
1,<environment.Job instance at 0x7f386eb8c0f0>,13,13,[3 7],14,-1,27,-1,14
1,<environment.Job instance at 0x7f386ed5d1e0>,16,16,[ 5 10],17,-1,33,-1,17
1,<environment.Job instance at 0x7f386e94b500>,17,13,[10  3],18,-1,31,-1,18
1,<environment.Job instance at 0x7f386e94b2d0>,18,18,[10  5],19,-1,37,-1,19
1,<environment.Job instance at 0x7f386e94bb40>,20,17,[6 4],21,-1,38,-1,21
1,<environment.Job instance at 0x7f386ef71eb0>,21,23,[9 2],22,-1,45,-1,22
1,<environment.Job instance at 0x7f386ef714b0>,23,13,[8 4],24,-1,37,-1,24
1,<environment.Job instance at 0x7f386f5e06e0>,29,15,[ 5 10],30,-1,46,-1,31
1,<environment.Job instance at 0x7f386f418640>,30,14,[13  1],31,-1,45,-1,31
1,<environment.Job instance at 0x7f386fa3d550>,33,12,[12  5],34,-1,46,-1,34
1,<environment.Job instance at 0x7f386fa3d0a0>,34,14,[5 5],35,-1,49,-1,35
1,<environment.Job instance at 0x7f386f525be0>,36,12,[5 9],37,-1,50,-1,38
1,<environment.Job instance at 0x7f386f5250f0>,39,17,[11  5],40,-1,57,-1,40
1,<environment.Job instance at 0x7f386f0e4190>,40,18,[3 7],41,-1,59,-1,41
1,<environment.Job instance at 0x7f386fca9b40>,42,22,[ 4 11],43,-1,65,-1,43
1,<environment.Job instance at 0x7f386fca9cd0>,43,13,[8 4],44,-1,57,-1,44
1,<environment.Job instance at 0x7f386f525dc0>,37,12,[ 4 10],38,-1,56,-1,44
1,<environment.Job instance at 0x7f386ff468c0>,50,17,[10  2],51,-1,68,-1,51
1,<environment.Job instance at 0x7f386ff46c30>,52,18,[1 5],53,-1,71,-1,53
1,<environment.Job instance at 0x7f386f237d70>,54,22,[7 4],55,-1,77,-1,55
1,<environment.Job instance at 0x7f386e8af500>,56,17,[5 8],57,-1,74,-1,57
1,<environment.Job instance at 0x7f386f237e60>,57,16,[5 1],58,-1,75,-1,59
1,<environment.Job instance at 0x7f386ec04690>,60,20,[ 3 10],61,-1,81,-1,61
1,<environment.Job instance at 0x7f386f237fa0>,62,14,[11  5],63,-1,77,-1,63
1,<environment.Job instance at 0x7f386f1b83c0>,64,16,[9 5],65,-1,81,-1,65
1,<environment.Job instance at 0x7f3878724fa0>,67,15,[4 6],68,-1,83,-1,68
1,<environment.Job instance at 0x7f38787245a0>,69,18,[1 9],70,-1,88,-1,70
1,<environment.Job instance at 0x7f386e8af190>,58,17,[14  2],59,-1,89,-1,72
1,<environment.Job instance at 0x7f3878724960>,76,14,[ 3 10],77,-1,93,-1,79
1,<environment.Job instance at 0x7f386f05cc30>,79,14,[5 4],80,-1,95,-1,81
1,<environment.Job instance at 0x7f386f6916e0>,84,16,[9 1],85,-1,101,-1,85
1,<environment.Job instance at 0x7f386f691eb0>,86,13,[9 1],87,-1,114,-1,101
1,<environment.Job instance at 0x7f386f691320>,99,19,[2 5],100,-1,120,-1,101
1,<environment.Job instance at 0x7f386f691820>,98,3,[8 5],99,-1,104,-1,101
1,<environment.Job instance at 0x7f3878724820>,78,17,[3 8],79,-1,123,-1,106
1,<environment.Job instance at 0x7f386f5849b0>,49,13,[ 5 11],50,-1,121,-1,108
1,<environment.Job instance at 0x7f386fa5b870>,107,17,[10  4],108,-1,128,-1,111
1,<environment.Job instance at 0x7f386fa5b1e0>,109,18,[2 7],110,-1,135,-1,117
1,<environment.Job instance at 0x7f386fa5bb90>,110,16,[ 1 10],111,-1,137,-1,121
1,<environment.Job instance at 0x7f386fa5b2d0>,116,16,[10  2],117,-1,137,-1,121
1,<environment.Job instance at 0x7f386fa5b820>,113,23,[5 6],114,-1,144,-1,121
1,<environment.Job instance at 0x7f386e8ba280>,122,14,[9 2],123,-1,148,-1,134
1,<environment.Job instance at 0x7f386f3c60f0>,127,14,[10  2],128,-1,150,-1,136
1,<environment.Job instance at 0x7f386ed5da00>,7,1,[ 2 12],8,-1,9,-1,8
1,<environment.Job instance at 0x7f386fa5b230>,21,23,[9 2],22,-1,75,-1,52
1,<environment.Job instance at 0x7f386e8ba3c0>,25,25,[ 2 11],26,-1,86,-1,61
1,<environment.Job instance at 0x7f386f9c7af0>,30,14,[13  1],31,-1,87,-1,73
1,<environment.Job instance at 0x7f386f9c75a0>,33,12,[12  5],34,-1,98,-1,86
1,<environment.Job instance at 0x7f386ff46960>,39,17,[11  5],40,-1,123,-1,106
1,<environment.Job instance at 0x7f3878aa7550>,42,22,[ 4 11],43,-1,140,-1,118
1,<environment.Job instance at 0x7f386ea325a0>,46,15,[13  2],47,-1,139,-1,124
1,<environment.Job instance at 0x7f386ea321e0>,49,13,[ 5 11],50,-1,146,-1,133
1,<environment.Job instance at 0x7f386f358190>,53,3,[ 3 14],54,-1,150,-1,147
1,<environment.Job instance at 0x7f386f358dc0>,58,17,[14  2],59,-1,182,-1,165
1,<environment.Job instance at 0x7f386f5afe10>,62,14,[11  5],63,-1,183,-1,169
1,<environment.Job instance at 0x7f386f7f09b0>,77,1,[12  4],78,-1,222,-1,221
1,<environment.Job instance at 0x7f386ebb1780>,82,14,[ 2 11],83,-1,252,-1,238
1,<environment.Job instance at 0x7f386f7f05a0>,85,13,[ 3 14],86,-1,264,-1,251
1,<environment.Job instance at 0x7f386f088eb0>,101,1,[12  1],102,-1,293,-1,292
1,<environment.Job instance at 0x7f386f088780>,103,3,[ 3 12],104,-1,296,-1,293
1,<environment.Job instance at 0x7f386f542a00>,113,23,[5 6],114,-1,366,-1,343
1,<environment.Job instance at 0x7f386ea0e460>,120,2,[13  2],121,-1,363,-1,361
1,<environment.Job instance at 0x7f386eb56c30>,123,1,[14  1],124,-1,367,-1,366
1,<environment.Job instance at 0x7f386eb56140>,138,2,[ 4 11],139,-1,433,-1,431
1,<environment.Job instance at 0x7f386f800640>,1,16,[1 7],2,-1,19,-1,3
1,<environment.Job instance at 0x7f386f651d70>,7,18,[3 6],8,-1,34,-1,16
1,<environment.Job instance at 0x7f386f6518c0>,10,28,[8 5],11,-1,44,-1,16
1,<environment.Job instance at 0x7f386f651690>,8,14,[10  1],9,-1,30,-1,16
1,<environment.Job instance at 0x7f386f651550>,11,16,[6 2],12,-1,32,-1,16
1,<environment.Job instance at 0x7f386f63b640>,13,17,[ 5 12],14,-1,33,-1,16
1,<environment.Job instance at 0x7f386f651820>,9,27,[ 5 10],10,-1,44,-1,17
1,<environment.Job instance at 0x7f386f63ba50>,15,14,[ 2 10],16,-1,31,-1,17
1,<environment.Job instance at 0x7f386f6515a0>,6,23,[9 2],7,-1,45,-1,22
1,<environment.Job instance at 0x7f386f624b90>,21,16,[4 7],22,-1,42,-1,26
1,<environment.Job instance at 0x7f386f624550>,20,13,[ 4 10],21,-1,40,-1,27
1,<environment.Job instance at 0x7f386fbd39b0>,27,12,[6 5],28,-1,40,-1,28
1,<environment.Job instance at 0x7f386f63b910>,14,18,[ 4 13],15,-1,46,-1,28
1,<environment.Job instance at 0x7f386f631050>,29,15,[7 2],30,-1,49,-1,34
1,<environment.Job instance at 0x7f386fbdb190>,28,18,[4 7],29,-1,54,-1,36
1,<environment.Job instance at 0x7f386f631aa0>,33,18,[ 4 10],34,-1,56,-1,38
1,<environment.Job instance at 0x7f386f624230>,23,13,[ 4 10],24,-1,51,-1,38
1,<environment.Job instance at 0x7f386f8a8b90>,36,26,[3 5],37,-1,64,-1,38
1,<environment.Job instance at 0x7f386e9d1140>,37,24,[9 4],38,-1,63,-1,39
1,<environment.Job instance at 0x7f386f624370>,22,17,[10  4],23,-1,58,-1,41
1,<environment.Job instance at 0x7f386f1b50f0>,40,15,[1 8],41,-1,56,-1,41
1,<environment.Job instance at 0x7f386f861500>,41,14,[6 4],42,-1,57,-1,43
1,<environment.Job instance at 0x7f386f631690>,30,21,[9 2],31,-1,64,-1,43
1,<environment.Job instance at 0x7f386eb4c8c0>,45,18,[ 3 10],46,-1,64,-1,46
1,<environment.Job instance at 0x7f386ff3c500>,44,17,[3 5],45,-1,65,-1,48
1,<environment.Job instance at 0x7f386eb2aa50>,53,12,[ 3 10],54,-1,67,-1,55
1,<environment.Job instance at 0x7f386efe3820>,57,17,[8 4],58,-1,79,-1,62
1,<environment.Job instance at 0x7f386efe3140>,59,14,[1 5],60,-1,76,-1,62
1,<environment.Job instance at 0x7f386efe81e0>,63,24,[5 1],64,-1,88,-1,64
1,<environment.Job instance at 0x7f386efe8640>,65,22,[5 4],66,-1,88,-1,66
1,<environment.Job instance at 0x7f386efe8e60>,66,28,[8 5],67,-1,95,-1,67
1,<environment.Job instance at 0x7f386eb493c0>,76,18,[11  2],77,-1,95,-1,77
1,<environment.Job instance at 0x7f386eff2be0>,70,18,[5 8],71,-1,98,-1,80
1,<environment.Job instance at 0x7f386eb49a50>,79,14,[8 1],80,-1,94,-1,80
1,<environment.Job instance at 0x7f386eb495a0>,80,14,[9 4],81,-1,95,-1,81
1,<environment.Job instance at 0x7f386eff8820>,81,17,[6 2],82,-1,99,-1,82
1,<environment.Job instance at 0x7f386eff8c80>,84,12,[4 9],85,-1,100,-1,88
1,<environment.Job instance at 0x7f386eff8280>,87,13,[2 7],88,-1,101,-1,88
1,<environment.Job instance at 0x7f386f850d70>,89,15,[10  5],90,-1,105,-1,90
1,<environment.Job instance at 0x7f386f8b8410>,95,27,[4 6],96,-1,123,-1,96
1,<environment.Job instance at 0x7f386f800fa0>,97,17,[2 8],98,-1,115,-1,98
1,<environment.Job instance at 0x7f386efd7230>,98,18,[5 5],99,-1,117,-1,99
1,<environment.Job instance at 0x7f386f3b79b0>,103,15,[4 8],104,-1,119,-1,104
1,<environment.Job instance at 0x7f386eff2730>,74,25,[9 4],75,-1,133,-1,108
1,<environment.Job instance at 0x7f386ee9ef00>,105,14,[5 5],106,-1,122,-1,108
1,<environment.Job instance at 0x7f386f8d5780>,109,17,[9 4],110,-1,127,-1,110
1,<environment.Job instance at 0x7f386f8d5e10>,110,15,[10  4],111,-1,126,-1,111
1,<environment.Job instance at 0x7f386f8d57d0>,112,14,[1 8],113,-1,127,-1,113
1,<environment.Job instance at 0x7f386fbece10>,4,24,[4 8],5,-1,137,-1,113
1,<environment.Job instance at 0x7f386e9c2b40>,113,17,[7 4],114,-1,131,-1,114
1,<environment.Job instance at 0x7f386e9a9d70>,123,28,[10  4],124,-1,185,-1,157
1,<environment.Job instance at 0x7f386f631320>,136,18,[10  3],137,-1,189,-1,171
1,<environment.Job instance at 0x7f386f8dd0a0>,99,24,[9 1],100,-1,1271,-1,1247
1,<environment.Job instance at 0x7f386efe39b0>,0,12,[ 1 14],1,-1,13,-1,1
1,<environment.Job instance at 0x7f386eff20f0>,2,2,[ 1 14],3,-1,5,-1,3
1,<environment.Job instance at 0x7f386efe8320>,4,24,[4 8],5,-1,29,-1,5
1,<environment.Job instance at 0x7f386eb4c5a0>,6,23,[9 2],7,-1,41,-1,18
1,<environment.Job instance at 0x7f386eff8190>,9,27,[ 5 10],10,-1,45,-1,18
1,<environment.Job instance at 0x7f386e9c2690>,10,28,[8 5],11,-1,46,-1,18
1,<environment.Job instance at 0x7f386eeda320>,13,17,[ 5 12],14,-1,35,-1,18
1,<environment.Job instance at 0x7f386f514550>,14,18,[ 4 13],15,-1,36,-1,18
1,<environment.Job instance at 0x7f386e9d7fa0>,36,26,[3 5],37,-1,128,-1,102
1,<environment.Job instance at 0x7f386e9d7780>,37,24,[9 4],38,-1,139,-1,115
1,<environment.Job instance at 0x7f386ea01a00>,48,1,[12  1],49,-1,137,-1,136
1,<environment.Job instance at 0x7f386e7e4140>,63,24,[5 1],64,-1,202,-1,178
1,<environment.Job instance at 0x7f386e7e4b90>,66,28,[8 5],67,-1,209,-1,181
1,<environment.Job instance at 0x7f386e7dfaf0>,76,18,[11  2],77,-1,226,-1,208
1,<environment.Job instance at 0x7f386e7d12d0>,78,15,[ 1 14],79,-1,225,-1,210
1,<environment.Job instance at 0x7f386e7df140>,74,25,[9 4],75,-1,237,-1,212
1,<environment.Job instance at 0x7f386f545320>,83,2,[ 2 13],84,-1,228,-1,226
1,<environment.Job instance at 0x7f386f0b0cd0>,95,27,[4 6],96,-1,285,-1,258
1,<environment.Job instance at 0x7f386f5198c0>,99,24,[9 1],100,-1,300,-1,276
1,<environment.Job instance at 0x7f386f518af0>,108,1,[ 2 12],109,-1,296,-1,295
1,<environment.Job instance at 0x7f386feb6050>,116,13,[11  2],117,-1,343,-1,330
1,<environment.Job instance at 0x7f386e802050>,121,23,[5 2],122,-1,370,-1,347
1,<environment.Job instance at 0x7f386f0c8370>,122,17,[ 5 14],123,-1,364,-1,347
1,<environment.Job instance at 0x7f386ff48870>,123,28,[10  4],124,-1,375,-1,347
1,<environment.Job instance at 0x7f386ec57af0>,128,18,[ 4 13],129,-1,375,-1,357
1,<environment.Job instance at 0x7f386efef0a0>,1,19,[10  5],2,-1,21,-1,2
1,<environment.Job instance at 0x7f386efef3c0>,7,13,[ 1 10],8,-1,21,-1,8
1,<environment.Job instance at 0x7f386efefc80>,9,17,[2 5],10,-1,27,-1,10
1,<environment.Job instance at 0x7f386f8ddf00>,10,13,[ 2 10],11,-1,25,-1,12
1,<environment.Job instance at 0x7f386f8dd690>,12,13,[5 5],13,-1,26,-1,13
1,<environment.Job instance at 0x7f386f8dd960>,13,12,[5 2],14,-1,26,-1,14
1,<environment.Job instance at 0x7f386f8dd910>,16,18,[3 7],17,-1,35,-1,17
1,<environment.Job instance at 0x7f386f8ddf50>,18,12,[2 6],19,-1,31,-1,19
1,<environment.Job instance at 0x7f386f8dddc0>,19,18,[6 5],20,-1,38,-1,20
1,<environment.Job instance at 0x7f386efef370>,11,18,[4 5],12,-1,38,-1,20
1,<environment.Job instance at 0x7f386f8dd4b0>,22,14,[4 6],23,-1,37,-1,23
1,<environment.Job instance at 0x7f386f8ddc80>,24,24,[5 9],25,-1,49,-1,25
1,<environment.Job instance at 0x7f386f8dd230>,25,18,[1 6],26,-1,44,-1,26
1,<environment.Job instance at 0x7f386efd7eb0>,26,28,[9 5],27,-1,55,-1,27
1,<environment.Job instance at 0x7f386efd77d0>,29,17,[5 2],30,-1,47,-1,30
1,<environment.Job instance at 0x7f386efd7f50>,31,18,[9 3],32,-1,50,-1,32
1,<environment.Job instance at 0x7f386efd7c80>,32,17,[4 8],33,-1,50,-1,33
1,<environment.Job instance at 0x7f386efd75a0>,33,18,[8 3],34,-1,52,-1,34
1,<environment.Job instance at 0x7f386e9a96e0>,41,14,[1 7],42,-1,56,-1,42
1,<environment.Job instance at 0x7f386e9a9140>,43,18,[2 6],44,-1,62,-1,44
1,<environment.Job instance at 0x7f386f864d70>,44,13,[1 6],45,-1,58,-1,45
1,<environment.Job instance at 0x7f386eb1b230>,47,18,[3 8],48,-1,66,-1,48
1,<environment.Job instance at 0x7f386eb1b320>,48,13,[5 2],49,-1,63,-1,50
1,<environment.Job instance at 0x7f386eb1bcd0>,52,19,[1 5],53,-1,72,-1,53
1,<environment.Job instance at 0x7f386eb1beb0>,49,15,[10  3],50,-1,70,-1,55
1,<environment.Job instance at 0x7f386eb1bdc0>,51,17,[9 5],52,-1,78,-1,61
1,<environment.Job instance at 0x7f386eb2a370>,55,16,[ 4 10],56,-1,79,-1,63
1,<environment.Job instance at 0x7f386eb2ae10>,58,16,[8 1],59,-1,81,-1,65
1,<environment.Job instance at 0x7f386eb2a500>,59,14,[9 3],60,-1,79,-1,65
1,<environment.Job instance at 0x7f386eb2a460>,63,23,[5 6],64,-1,88,-1,65
1,<environment.Job instance at 0x7f386eb2a8c0>,62,12,[2 8],63,-1,77,-1,65
1,<environment.Job instance at 0x7f386eb2af50>,65,14,[1 5],66,-1,80,-1,66
1,<environment.Job instance at 0x7f386eb2a5a0>,61,14,[7 4],62,-1,91,-1,77
1,<environment.Job instance at 0x7f386eb2da00>,68,28,[3 8],69,-1,108,-1,80
1,<environment.Job instance at 0x7f386eb2df50>,69,16,[ 5 10],70,-1,97,-1,81
1,<environment.Job instance at 0x7f386eb2d9b0>,73,23,[5 7],74,-1,106,-1,83
1,<environment.Job instance at 0x7f386eb2ddc0>,74,28,[8 5],75,-1,112,-1,84
1,<environment.Job instance at 0x7f386eb2dc30>,76,23,[3 7],77,-1,109,-1,86
1,<environment.Job instance at 0x7f386eb2a2d0>,56,14,[14  5],57,-1,100,-1,86
1,<environment.Job instance at 0x7f386eb2d960>,77,24,[2 9],78,-1,110,-1,86
1,<environment.Job instance at 0x7f386eb2de10>,79,22,[5 3],80,-1,108,-1,86
1,<environment.Job instance at 0x7f386eb2d190>,80,15,[7 4],81,-1,101,-1,86
1,<environment.Job instance at 0x7f386f862550>,88,17,[1 8],89,-1,106,-1,89
1,<environment.Job instance at 0x7f386f8620a0>,91,16,[5 8],92,-1,108,-1,92
1,<environment.Job instance at 0x7f386eb2d5a0>,84,20,[1 9],85,-1,122,-1,102
1,<environment.Job instance at 0x7f386eb2acd0>,57,12,[1 7],58,-1,114,-1,102
1,<environment.Job instance at 0x7f386f85c6e0>,97,17,[ 3 10],98,-1,119,-1,102
1,<environment.Job instance at 0x7f386f85c320>,101,14,[1 6],102,-1,116,-1,102
1,<environment.Job instance at 0x7f386f85c730>,102,16,[1 9],103,-1,119,-1,103
1,<environment.Job instance at 0x7f386f631eb0>,111,27,[7 5],112,-1,154,-1,127
1,<environment.Job instance at 0x7f386f631e10>,105,16,[ 4 13],106,-1,143,-1,127
1,<environment.Job instance at 0x7f386f631730>,106,26,[8 4],107,-1,153,-1,127
1,<environment.Job instance at 0x7f386eea20f0>,112,17,[ 2 10],113,-1,144,-1,127
1,<environment.Job instance at 0x7f386f85c460>,96,24,[10  1],97,-1,154,-1,130
1,<environment.Job instance at 0x7f386efecd20>,117,15,[11  5],118,-1,145,-1,130
1,<environment.Job instance at 0x7f386efec410>,118,13,[5 1],119,-1,143,-1,130
1,<environment.Job instance at 0x7f386f1620a0>,24,24,[5 9],25,-1,102,-1,78
1,<environment.Job instance at 0x7f386fef05f0>,26,28,[9 5],27,-1,106,-1,78
1,<environment.Job instance at 0x7f386fa1bfa0>,56,14,[14  5],57,-1,203,-1,189
1,<environment.Job instance at 0x7f386fa114b0>,63,23,[5 6],64,-1,263,-1,240
1,<environment.Job instance at 0x7f386ed03d70>,68,28,[3 8],69,-1,282,-1,254
1,<environment.Job instance at 0x7f386f7fd140>,73,23,[5 7],74,-1,293,-1,270
1,<environment.Job instance at 0x7f386f7fd8c0>,74,28,[8 5],75,-1,298,-1,270
1,<environment.Job instance at 0x7f386f25d5f0>,76,23,[3 7],77,-1,294,-1,271
1,<environment.Job instance at 0x7f386f25d820>,77,24,[2 9],78,-1,296,-1,272
1,<environment.Job instance at 0x7f386fc50690>,82,23,[13  5],83,-1,308,-1,285
1,<environment.Job instance at 0x7f386fc50aa0>,83,12,[ 4 13],84,-1,297,-1,285
1,<environment.Job instance at 0x7f386fc507d0>,87,20,[ 5 12],88,-1,320,-1,300
1,<environment.Job instance at 0x7f38786a43c0>,93,26,[6 4],94,-1,333,-1,307
1,<environment.Job instance at 0x7f386ff65280>,96,24,[10  1],97,-1,354,-1,330
1,<environment.Job instance at 0x7f386ff65cd0>,103,17,[11  1],104,-1,356,-1,339
1,<environment.Job instance at 0x7f386fc43410>,105,16,[ 4 13],106,-1,355,-1,339
1,<environment.Job instance at 0x7f386f260500>,106,26,[8 4],107,-1,372,-1,346
1,<environment.Job instance at 0x7f386ec885f0>,108,18,[12  4],109,-1,364,-1,346
1,<environment.Job instance at 0x7f386ec88320>,111,27,[7 5],112,-1,390,-1,363
1,<environment.Job instance at 0x7f386ef54460>,117,15,[11  5],118,-1,392,-1,377
1,<environment.Job instance at 0x7f386f9d6460>,121,3,[12  3],122,-1,393,-1,390
1,<environment.Job instance at 0x7f386f9d6af0>,122,3,[14  3],123,-1,393,-1,390
1,<environment.Job instance at 0x7f386f257cd0>,126,25,[6 1],127,-1,422,-1,397
1,<environment.Job instance at 0x7f386ef07960>,131,18,[ 3 12],132,-1,425,-1,407
1,<environment.Job instance at 0x7f386eede550>,136,26,[8 5],137,-1,465,-1,439
1,<environment.Job instance at 0x7f386eb1b190>,0,27,[7 2],1,-1,28,-1,1
1,<environment.Job instance at 0x7f386f800960>,21,17,[4 8],22,-1,40,-1,23
1,<environment.Job instance at 0x7f386eb1bf00>,14,13,[2 9],15,-1,43,-1,30
1,<environment.Job instance at 0x7f386f800cd0>,22,17,[9 5],23,-1,47,-1,30
1,<environment.Job instance at 0x7f386f8000a0>,28,21,[5 3],29,-1,51,-1,30
1,<environment.Job instance at 0x7f386f3c38c0>,42,17,[7 2],43,-1,66,-1,49
1,<environment.Job instance at 0x7f386f3c37d0>,33,24,[10  4],34,-1,73,-1,49
1,<environment.Job instance at 0x7f386eb1b870>,8,12,[12  3],9,-1,61,-1,49
1,<environment.Job instance at 0x7f386ebe28c0>,44,13,[2 8],45,-1,62,-1,49
1,<environment.Job instance at 0x7f386ebe2730>,45,17,[6 3],46,-1,66,-1,49
1,<environment.Job instance at 0x7f386e9d3fa0>,47,14,[9 4],48,-1,64,-1,50
1,<environment.Job instance at 0x7f386e9d3730>,48,18,[8 3],49,-1,68,-1,50
1,<environment.Job instance at 0x7f386e9d3d70>,49,16,[ 4 10],50,-1,66,-1,50
1,<environment.Job instance at 0x7f386e9d3690>,52,18,[3 8],53,-1,73,-1,55
1,<environment.Job instance at 0x7f386e9d3e10>,46,12,[ 4 10],47,-1,68,-1,56
1,<environment.Job instance at 0x7f386ea06fa0>,58,12,[ 2 12],59,-1,71,-1,59
1,<environment.Job instance at 0x7f386ea06640>,66,19,[4 6],67,-1,91,-1,72
1,<environment.Job instance at 0x7f38700ccaf0>,69,21,[ 5 10],70,-1,106,-1,85
1,<environment.Job instance at 0x7f386e9d3f00>,55,25,[8 3],56,-1,113,-1,88
1,<environment.Job instance at 0x7f386ff3caf0>,73,21,[5 5],74,-1,109,-1,88
1,<environment.Job instance at 0x7f38700cc9b0>,71,18,[1 9],72,-1,106,-1,88
1,<environment.Job instance at 0x7f386ff3c370>,77,16,[6 5],78,-1,106,-1,90
1,<environment.Job instance at 0x7f386ff3c820>,78,12,[9 5],79,-1,102,-1,90
1,<environment.Job instance at 0x7f386ff3c500>,80,18,[9 1],81,-1,108,-1,90
1,<environment.Job instance at 0x7f386ff3c960>,79,12,[ 5 10],80,-1,102,-1,90
1,<environment.Job instance at 0x7f386efe3e60>,83,27,[4 6],84,-1,117,-1,90
1,<environment.Job instance at 0x7f386efe3780>,81,12,[7 5],82,-1,103,-1,91
1,<environment.Job instance at 0x7f386f3c33c0>,43,14,[7 2],44,-1,105,-1,91
1,<environment.Job instance at 0x7f386efe3370>,85,17,[10  2],86,-1,108,-1,91
1,<environment.Job instance at 0x7f386efe3f00>,88,14,[5 1],89,-1,105,-1,91
1,<environment.Job instance at 0x7f386eff87d0>,96,16,[4 8],97,-1,118,-1,102
1,<environment.Job instance at 0x7f386ea0d230>,97,28,[8 2],98,-1,130,-1,102
1,<environment.Job instance at 0x7f386ea0d640>,98,22,[5 8],99,-1,124,-1,102
1,<environment.Job instance at 0x7f386fd4b820>,99,15,[8 3],100,-1,117,-1,102
1,<environment.Job instance at 0x7f386e7f86e0>,100,18,[7 4],101,-1,120,-1,102
1,<environment.Job instance at 0x7f386f2d1280>,101,28,[ 3 10],102,-1,130,-1,102
1,<environment.Job instance at 0x7f3870058230>,105,18,[5 9],106,-1,124,-1,106
1,<environment.Job instance at 0x7f38700586e0>,107,18,[7 1],108,-1,128,-1,110
1,<environment.Job instance at 0x7f386f62c4b0>,112,14,[10  1],113,-1,127,-1,113
1,<environment.Job instance at 0x7f3870058320>,109,17,[6 3],110,-1,131,-1,114
1,<environment.Job instance at 0x7f386fe60870>,93,13,[8 5],94,-1,131,-1,118
1,<environment.Job instance at 0x7f386efe3b90>,86,16,[ 5 10],87,-1,135,-1,119
1,<environment.Job instance at 0x7f386fe8ca50>,118,14,[6 1],119,-1,133,-1,119
1,<environment.Job instance at 0x7f386e82e5a0>,116,16,[3 5],117,-1,137,-1,121
1,<environment.Job instance at 0x7f386f3c3c30>,41,21,[2 7],42,-1,142,-1,121
1,<environment.Job instance at 0x7f3870125500>,121,12,[11  3],122,-1,134,-1,122
1,<environment.Job instance at 0x7f387001a050>,124,17,[7 5],125,-1,142,-1,125
1,<environment.Job instance at 0x7f386e9025a0>,111,15,[14  2],112,-1,142,-1,127
1,<environment.Job instance at 0x7f386fbc6dc0>,0,27,[7 2],1,-1,28,-1,1
1,<environment.Job instance at 0x7f386fbc6410>,1,26,[ 5 11],2,-1,28,-1,2
1,<environment.Job instance at 0x7f386f3c3e10>,5,15,[ 5 13],6,-1,21,-1,6
1,<environment.Job instance at 0x7f386f3c35f0>,8,12,[12  3],9,-1,21,-1,9
1,<environment.Job instance at 0x7f386efa3500>,15,12,[14  1],16,-1,32,-1,20
1,<environment.Job instance at 0x7f386fe8c640>,17,16,[ 2 12],18,-1,37,-1,21
1,<environment.Job instance at 0x7f3870058c30>,19,2,[ 1 11],20,-1,24,-1,22
1,<environment.Job instance at 0x7f386ec88320>,33,24,[10  4],34,-1,73,-1,49
1,<environment.Job instance at 0x7f386fc43c30>,37,2,[ 3 11],38,-1,52,-1,50
1,<environment.Job instance at 0x7f386fa11e60>,55,25,[8 3],56,-1,143,-1,118
1,<environment.Job instance at 0x7f386fa1b640>,58,12,[ 2 12],59,-1,130,-1,118
1,<environment.Job instance at 0x7f386ff3cb40>,83,27,[4 6],84,-1,235,-1,208
1,<environment.Job instance at 0x7f386f1620a0>,90,3,[ 1 14],91,-1,213,-1,210
1,<environment.Job instance at 0x7f386fee5c80>,94,1,[ 2 11],95,-1,224,-1,223
1,<environment.Job instance at 0x7f386effb230>,97,28,[8 2],98,-1,266,-1,238
1,<environment.Job instance at 0x7f3870010d70>,101,28,[ 3 10],102,-1,293,-1,265
1,<environment.Job instance at 0x7f387007df50>,111,15,[14  2],112,-1,303,-1,288
1,<environment.Job instance at 0x7f386fc1c690>,121,12,[11  3],122,-1,335,-1,323
1,<environment.Job instance at 0x7f386f99cd70>,129,28,[3 6],130,-1,390,-1,362
1,<environment.Job instance at 0x7f386fc3c960>,130,26,[6 1],131,-1,388,-1,362
1,<environment.Job instance at 0x7f386fc3ceb0>,131,2,[ 4 13],132,-1,364,-1,362
1,<environment.Job instance at 0x7f50c592caf0>,2,22,[4 8],3,-1,25,-1,3
1,<environment.Job instance at 0x7f50c592f050>,9,18,[11  5],10,-1,29,-1,11
1,<environment.Job instance at 0x7f50c592f140>,11,15,[4 8],12,-1,27,-1,12
1,<environment.Job instance at 0x7f50c592f320>,13,18,[ 4 10],14,-1,32,-1,14
1,<environment.Job instance at 0x7f50c592f460>,15,18,[2 8],16,-1,34,-1,16
1,<environment.Job instance at 0x7f50c592f5a0>,16,16,[3 5],17,-1,33,-1,17
1,<environment.Job instance at 0x7f50c592fa50>,23,27,[1 6],24,-1,51,-1,24
1,<environment.Job instance at 0x7f50c592fcd0>,24,18,[2 6],25,-1,43,-1,25
1,<environment.Job instance at 0x7f50c592f960>,25,12,[ 5 10],26,-1,38,-1,26
1,<environment.Job instance at 0x7f50c592ff00>,27,15,[8 4],28,-1,43,-1,28
1,<environment.Job instance at 0x7f50c59320a0>,28,23,[10  4],29,-1,52,-1,29
1,<environment.Job instance at 0x7f50c59321e0>,30,14,[5 2],31,-1,45,-1,31
1,<environment.Job instance at 0x7f50c5932320>,31,14,[2 5],32,-1,46,-1,32
1,<environment.Job instance at 0x7f50c59325f0>,34,24,[1 8],35,-1,59,-1,35
1,<environment.Job instance at 0x7f50c5932780>,35,15,[9 5],36,-1,51,-1,36
1,<environment.Job instance at 0x7f50c5932be0>,40,15,[10  3],41,-1,56,-1,41
1,<environment.Job instance at 0x7f50c5932c30>,43,18,[5 5],44,-1,62,-1,44
1,<environment.Job instance at 0x7f50c59340f0>,48,15,[10  1],49,-1,65,-1,50
1,<environment.Job instance at 0x7f50c5936550>,67,27,[ 1 10],68,-1,175,-1,148
1,<environment.Job instance at 0x7f50c5934a50>,56,17,[8 5],57,-1,165,-1,148
1,<environment.Job instance at 0x7f50c592f6e0>,1,22,[11  3],2,-1,24,-1,2
1,<environment.Job instance at 0x7f50c5934af0>,9,18,[11  5],10,-1,32,-1,14
1,<environment.Job instance at 0x7f50c5923f00>,12,26,[ 1 10],13,-1,82,-1,56
1,<environment.Job instance at 0x7f50c5a49dc0>,23,27,[1 6],24,-1,87,-1,60
1,<environment.Job instance at 0x7f50c59dc870>,28,23,[10  4],29,-1,97,-1,74
1,<environment.Job instance at 0x7f50c5a3a320>,34,24,[1 8],35,-1,117,-1,93
1,<environment.Job instance at 0x7f50c5967550>,36,13,[ 3 14],37,-1,106,-1,93
1,<environment.Job instance at 0x7f50c59140f0>,46,17,[12  2],47,-1,134,-1,117
1,<environment.Job instance at 0x7f50c59200f0>,50,16,[12  2],51,-1,146,-1,130
1,<environment.Job instance at 0x7f50c592cd70>,54,13,[13  1],55,-1,158,-1,145
1,<environment.Job instance at 0x7f50c591cc30>,60,3,[12  3],61,-1,169,-1,166
1,<environment.Job instance at 0x7f50c58c5550>,67,27,[ 1 10],68,-1,216,-1,189
1,<environment.Job instance at 0x7f50c58c5730>,69,13,[ 3 12],70,-1,202,-1,189
1,<environment.Job instance at 0x7f50c58c5a00>,75,14,[ 4 11],76,-1,215,-1,201
1,<environment.Job instance at 0x7f50c58c7a50>,97,2,[ 5 11],98,-1,294,-1,292
1,<environment.Job instance at 0x7f50c58c7b90>,99,18,[12  5],100,-1,312,-1,294
1,<environment.Job instance at 0x7f50c58c77d0>,105,14,[14  5],106,-1,341,-1,327
1,<environment.Job instance at 0x7f50c58cb0a0>,106,15,[11  1],107,-1,342,-1,327
1,<environment.Job instance at 0x7f50c58cb9b0>,116,3,[ 1 12],117,-1,363,-1,360
1,<environment.Job instance at 0x7f50c58cb5f0>,111,26,[ 5 10],112,-1,396,-1,370
1,<environment.Job instance at 0x7f50c58cbcd0>,122,3,[ 4 12],123,-1,377,-1,374
1,<environment.Job instance at 0x7f50c58cbe10>,123,12,[ 4 11],124,-1,386,-1,374
1,<environment.Job instance at 0x7f50c58cd0a0>,128,23,[ 2 14],129,-1,419,-1,396
1,<environment.Job instance at 0x7f50c58cd820>,138,16,[11  2],139,-1,447,-1,431
1,<environment.Job instance at 0x7f50c58cd8c0>,139,18,[ 1 12],140,-1,449,-1,431
1,<environment.Job instance at 0x7f50c58cdb40>,143,15,[ 1 12],144,-1,466,-1,451
1,<environment.Job instance at 0x7f50c58cdf00>,145,3,[ 4 13],146,-1,455,-1,452
1,<environment.Job instance at 0x7f50c58cdfa0>,147,1,[ 1 14],148,-1,455,-1,454
1,<environment.Job instance at 0x7f50c52c4d20>,1,15,[10  4],2,-1,18,-1,3
1,<environment.Job instance at 0x7f50c5397230>,4,14,[8 4],5,-1,19,-1,5
1,<environment.Job instance at 0x7f50c5397af0>,8,14,[9 5],9,-1,23,-1,9
1,<environment.Job instance at 0x7f50c5397b90>,11,15,[1 7],12,-1,27,-1,12
1,<environment.Job instance at 0x7f50c539b0a0>,13,15,[5 2],14,-1,29,-1,14
1,<environment.Job instance at 0x7f50c55446e0>,2,14,[1 8],3,-1,30,-1,16
1,<environment.Job instance at 0x7f50c53a0460>,23,18,[6 5],24,-1,42,-1,24
1,<environment.Job instance at 0x7f50c53a0280>,24,19,[6 1],25,-1,44,-1,25
1,<environment.Job instance at 0x7f50c53a0500>,25,16,[ 2 10],26,-1,43,-1,27
1,<environment.Job instance at 0x7f50c5499960>,27,21,[ 3 10],28,-1,49,-1,28
1,<environment.Job instance at 0x7f50c553a550>,32,14,[2 9],33,-1,47,-1,33
1,<environment.Job instance at 0x7f50c5539b90>,38,21,[9 4],39,-1,60,-1,39
1,<environment.Job instance at 0x7f50c53ea1e0>,39,12,[9 3],40,-1,53,-1,41
1,<environment.Job instance at 0x7f50c53ea460>,40,18,[10  3],41,-1,59,-1,41
1,<environment.Job instance at 0x7f50c53ea7d0>,41,17,[10  2],42,-1,62,-1,45
1,<environment.Job instance at 0x7f50c53ea370>,46,14,[5 5],47,-1,61,-1,47
1,<environment.Job instance at 0x7f50c53ea500>,44,12,[3 8],45,-1,60,-1,48
1,<environment.Job instance at 0x7f50c4faf2d0>,50,13,[10  5],51,-1,65,-1,52
1,<environment.Job instance at 0x7f50c52ce050>,53,14,[7 5],54,-1,68,-1,54
1,<environment.Job instance at 0x7f50c52d4910>,55,14,[10  2],56,-1,78,-1,64
1,<environment.Job instance at 0x7f50c4ed1910>,64,16,[7 2],65,-1,83,-1,67
1,<environment.Job instance at 0x7f50c50670f0>,66,12,[ 3 10],67,-1,80,-1,68
1,<environment.Job instance at 0x7f50c506b7d0>,70,18,[4 5],71,-1,89,-1,71
1,<environment.Job instance at 0x7f50c4edc7d0>,71,18,[2 8],72,-1,92,-1,74
1,<environment.Job instance at 0x7f50c4edcb90>,74,16,[9 4],75,-1,91,-1,75
1,<environment.Job instance at 0x7f50c4edc8c0>,73,14,[11  3],74,-1,89,-1,75
1,<environment.Job instance at 0x7f50c4edc640>,76,14,[10  1],77,-1,99,-1,85
1,<environment.Job instance at 0x7f50c4ede780>,86,19,[2 7],87,-1,106,-1,87
1,<environment.Job instance at 0x7f50c4ec55f0>,88,18,[6 3],89,-1,107,-1,89
1,<environment.Job instance at 0x7f50c4f640f0>,90,24,[ 1 10],91,-1,115,-1,91
1,<environment.Job instance at 0x7f50c4ec21e0>,93,24,[7 4],94,-1,118,-1,94
1,<environment.Job instance at 0x7f50c4ec2cd0>,94,16,[7 5],95,-1,111,-1,95
1,<environment.Job instance at 0x7f50c4ed9960>,96,16,[7 4],97,-1,113,-1,97
1,<environment.Job instance at 0x7f50c5560a50>,48,12,[14  4],49,-1,113,-1,101
1,<environment.Job instance at 0x7f50c4ed9c30>,98,18,[4 6],99,-1,119,-1,101
1,<environment.Job instance at 0x7f50c4ed91e0>,102,26,[8 4],103,-1,129,-1,103
1,<environment.Job instance at 0x7f50c500e780>,103,12,[9 1],104,-1,118,-1,106
1,<environment.Job instance at 0x7f50c50029b0>,107,17,[5 2],108,-1,125,-1,108
1,<environment.Job instance at 0x7f50c4f59aa0>,108,18,[4 5],109,-1,128,-1,110
1,<environment.Job instance at 0x7f50c4ed9730>,101,27,[4 7],102,-1,137,-1,110
1,<environment.Job instance at 0x7f50c4f59fa0>,110,25,[ 3 10],111,-1,139,-1,114
1,<environment.Job instance at 0x7f50c4edc1e0>,77,16,[9 2],78,-1,131,-1,115
1,<environment.Job instance at 0x7f50c500ec80>,105,16,[14  1],106,-1,135,-1,119
1,<environment.Job instance at 0x7f50cef46640>,114,12,[7 2],115,-1,132,-1,120
1,<environment.Job instance at 0x7f50c4edb910>,120,17,[2 6],121,-1,138,-1,121
1,<environment.Job instance at 0x7f50c4edbb90>,121,15,[8 4],122,-1,137,-1,122
1,<environment.Job instance at 0x7f50c4edb780>,123,23,[10  1],124,-1,147,-1,124
1,<environment.Job instance at 0x7f50c4edf320>,126,28,[6 5],127,-1,155,-1,127
1,<environment.Job instance at 0x7f50c4ee18c0>,127,18,[5 9],128,-1,146,-1,128
1,<environment.Job instance at 0x7f50c500bbe0>,134,15,[10  4],135,-1,150,-1,135
1,<environment.Job instance at 0x7f50c51a8dc0>,138,13,[8 5],139,-1,154,-1,141
1,<environment.Job instance at 0x7f50c5142550>,142,18,[8 2],143,-1,161,-1,143
1,<environment.Job instance at 0x7f50c5142870>,145,17,[4 6],146,-1,163,-1,146
1,<environment.Job instance at 0x7f50c4fb90a0>,139,28,[5 3],140,-1,176,-1,148
1,<environment.Job instance at 0x7f50c4ed6690>,147,14,[ 1 10],148,-1,163,-1,149
1,<environment.Job instance at 0x7f50c4f59050>,10,3,[13  3],11,-1,21,-1,18
1,<environment.Job instance at 0x7f50c4edb190>,15,13,[ 1 14],16,-1,34,-1,21
1,<environment.Job instance at 0x7f50c58cd9b0>,26,2,[11  5],27,-1,43,-1,41
1,<environment.Job instance at 0x7f50c58cd730>,28,3,[14  4],29,-1,46,-1,43
1,<environment.Job instance at 0x7f50c58cba00>,48,12,[14  4],49,-1,113,-1,101
1,<environment.Job instance at 0x7f50c58c7d20>,58,2,[13  1],59,-1,146,-1,144
1,<environment.Job instance at 0x7f50c58c79b0>,61,3,[13  5],62,-1,149,-1,146
1,<environment.Job instance at 0x7f50c58c78c0>,62,2,[ 1 12],63,-1,148,-1,146
1,<environment.Job instance at 0x7f50c58c7280>,72,1,[ 4 13],73,-1,174,-1,173
1,<environment.Job instance at 0x7f50c51cd550>,73,14,[11  3],74,-1,187,-1,173
1,<environment.Job instance at 0x7f50c52d6550>,90,24,[ 1 10],91,-1,285,-1,261
1,<environment.Job instance at 0x7f50c52d4c30>,93,24,[7 4],94,-1,285,-1,261
1,<environment.Job instance at 0x7f50c512db40>,95,3,[12  3],96,-1,264,-1,261
1,<environment.Job instance at 0x7f50c52105f0>,101,27,[4 7],102,-1,309,-1,282
1,<environment.Job instance at 0x7f50c521caf0>,102,26,[8 4],103,-1,308,-1,282
1,<environment.Job instance at 0x7f50c513fd70>,105,16,[14  1],106,-1,300,-1,284
1,<environment.Job instance at 0x7f50c50c1190>,110,25,[ 3 10],111,-1,340,-1,315
1,<environment.Job instance at 0x7f50c5113eb0>,123,23,[10  1],124,-1,386,-1,363
1,<environment.Job instance at 0x7f50c508d3c0>,126,28,[6 5],127,-1,391,-1,363
1,<environment.Job instance at 0x7f50c5087460>,131,15,[14  1],132,-1,383,-1,368
1,<environment.Job instance at 0x7f50c50edbe0>,135,18,[11  3],136,-1,401,-1,383
1,<environment.Job instance at 0x7f50c50ed730>,139,28,[5 3],140,-1,416,-1,388
1,<environment.Job instance at 0x7f50c4f171e0>,0,15,[8 2],1,-1,18,-1,3
1,<environment.Job instance at 0x7f50c4f17fa0>,2,25,[6 3],3,-1,28,-1,3
1,<environment.Job instance at 0x7f50c4fca4b0>,4,17,[9 4],5,-1,23,-1,6
1,<environment.Job instance at 0x7f50c4fca140>,7,13,[1 9],8,-1,21,-1,8
1,<environment.Job instance at 0x7f50c4fcaa50>,8,17,[3 6],9,-1,26,-1,9
1,<environment.Job instance at 0x7f50c4fca190>,9,15,[ 5 10],10,-1,25,-1,10
1,<environment.Job instance at 0x7f50c4fcaa00>,10,1,[ 1 10],11,-1,12,-1,11
1,<environment.Job instance at 0x7f50c4fcaaa0>,11,14,[8 2],12,-1,26,-1,12
1,<environment.Job instance at 0x7f50c4fca6e0>,12,1,[5 9],13,-1,14,-1,13
1,<environment.Job instance at 0x7f50c4fca9b0>,13,20,[2 6],14,-1,34,-1,14
1,<environment.Job instance at 0x7f50c4fca500>,14,15,[5 1],15,-1,30,-1,15
1,<environment.Job instance at 0x7f50c502e190>,24,12,[5 9],25,-1,37,-1,25
1,<environment.Job instance at 0x7f50c502ed70>,26,15,[2 7],27,-1,42,-1,27
1,<environment.Job instance at 0x7f50c502e6e0>,28,15,[7 5],29,-1,44,-1,29
1,<environment.Job instance at 0x7f50c502ebe0>,29,15,[ 3 10],30,-1,45,-1,30
1,<environment.Job instance at 0x7f50c502e820>,30,24,[2 8],31,-1,55,-1,31
1,<environment.Job instance at 0x7f50c502eaa0>,31,24,[9 1],32,-1,56,-1,32
1,<environment.Job instance at 0x7f50c502ee60>,34,23,[10  2],35,-1,63,-1,40
1,<environment.Job instance at 0x7f50c5010be0>,40,15,[7 1],41,-1,56,-1,41
1,<environment.Job instance at 0x7f50c5010fa0>,41,17,[10  3],42,-1,59,-1,42
1,<environment.Job instance at 0x7f50c5010820>,44,14,[1 5],45,-1,60,-1,46
1,<environment.Job instance at 0x7f50c5010cd0>,49,16,[5 4],50,-1,66,-1,50
1,<environment.Job instance at 0x7f50c5010c30>,50,14,[8 3],51,-1,65,-1,51
1,<environment.Job instance at 0x7f50c500c460>,54,18,[3 6],55,-1,73,-1,55
1,<environment.Job instance at 0x7f50c500c3c0>,56,16,[9 2],57,-1,73,-1,57
1,<environment.Job instance at 0x7f50c500c5a0>,57,16,[9 4],58,-1,74,-1,58
1,<environment.Job instance at 0x7f50c500c820>,61,17,[7 5],62,-1,79,-1,62
1,<environment.Job instance at 0x7f50c500caa0>,64,15,[4 6],65,-1,80,-1,65
1,<environment.Job instance at 0x7f50c500f1e0>,66,25,[ 5 10],67,-1,92,-1,67
1,<environment.Job instance at 0x7f50c500f2d0>,68,18,[1 5],69,-1,87,-1,69
1,<environment.Job instance at 0x7f50c50031e0>,80,14,[7 5],81,-1,96,-1,82
1,<environment.Job instance at 0x7f50c5003be0>,82,17,[12  4],83,-1,100,-1,83
1,<environment.Job instance at 0x7f50c5003500>,85,16,[10  4],86,-1,102,-1,86
1,<environment.Job instance at 0x7f50c5003af0>,90,18,[9 5],91,-1,110,-1,92
1,<environment.Job instance at 0x7f50c5010410>,47,15,[ 3 12],48,-1,116,-1,101
1,<environment.Job instance at 0x7f50c5009af0>,96,12,[8 3],97,-1,115,-1,103
1,<environment.Job instance at 0x7f50c502e370>,36,16,[ 5 10],37,-1,119,-1,103
1,<environment.Job instance at 0x7f50c5009a00>,97,15,[2 9],98,-1,118,-1,103
1,<environment.Job instance at 0x7f50c5009d70>,99,17,[8 1],100,-1,120,-1,103
1,<environment.Job instance at 0x7f50c5009cd0>,100,2,[10  2],101,-1,105,-1,103
1,<environment.Job instance at 0x7f50c4ec5c80>,101,17,[2 6],102,-1,120,-1,103
1,<environment.Job instance at 0x7f50c4ec5960>,102,19,[8 2],103,-1,122,-1,103
1,<environment.Job instance at 0x7f50c5002cd0>,103,2,[ 2 14],104,-1,106,-1,104
1,<environment.Job instance at 0x7f50c5002b90>,104,17,[ 5 14],105,-1,122,-1,105
1,<environment.Job instance at 0x7f50c50025a0>,105,3,[2 5],106,-1,109,-1,106
1,<environment.Job instance at 0x7f50c5002230>,108,14,[ 2 10],109,-1,123,-1,109
1,<environment.Job instance at 0x7f50c5002a50>,109,17,[9 1],110,-1,127,-1,110
1,<environment.Job instance at 0x7f50c50028c0>,110,18,[3 5],111,-1,129,-1,111
1,<environment.Job instance at 0x7f50c4f2ce10>,119,15,[10  2],120,-1,145,-1,130
1,<environment.Job instance at 0x7f50c56b55a0>,120,13,[5 6],121,-1,143,-1,130
1,<environment.Job instance at 0x7f50c5686050>,122,12,[5 5],123,-1,142,-1,130
1,<environment.Job instance at 0x7f50c5686190>,123,13,[4 9],124,-1,143,-1,130
1,<environment.Job instance at 0x7f50c50096e0>,94,17,[7 2],95,-1,147,-1,130
1,<environment.Job instance at 0x7f50c558ba00>,124,2,[2 5],125,-1,132,-1,130
1,<environment.Job instance at 0x7f50c5686c30>,126,1,[3 8],127,-1,131,-1,130
1,<environment.Job instance at 0x7f50c5b4cf00>,127,3,[10  2],128,-1,133,-1,130
1,<environment.Job instance at 0x7f50c5b4cf50>,128,1,[2 8],129,-1,131,-1,130
1,<environment.Job instance at 0x7f50c5b1b6e0>,129,1,[ 3 10],130,-1,131,-1,130
1,<environment.Job instance at 0x7f50c56a4410>,130,16,[10  2],131,-1,147,-1,131
1,<environment.Job instance at 0x7f50c56a4320>,131,13,[4 5],132,-1,145,-1,132
1,<environment.Job instance at 0x7f50c56a3460>,134,21,[7 2],135,-1,156,-1,135
1,<environment.Job instance at 0x7f50c56a3370>,135,12,[ 1 10],136,-1,148,-1,136
1,<environment.Job instance at 0x7f50c5b36fa0>,138,16,[6 3],139,-1,155,-1,139
1,<environment.Job instance at 0x7f50c5b36820>,140,18,[4 7],141,-1,167,-1,149
1,<environment.Job instance at 0x7f50c5dc5640>,141,14,[1 5],142,-1,163,-1,149
1,<environment.Job instance at 0x7f50c5dc5b40>,142,14,[ 1 11],143,-1,163,-1,149
1,<environment.Job instance at 0x7f50c5dc5b90>,143,14,[2 7],144,-1,163,-1,149
1,<environment.Job instance at 0x7f50c51a8780>,148,15,[8 5],149,-1,169,-1,154
1,<environment.Job instance at 0x7f50c502ef50>,2,25,[6 3],3,-1,30,-1,5
1,<environment.Job instance at 0x7f50c5002a00>,19,18,[13  1],20,-1,48,-1,30
1,<environment.Job instance at 0x7f50c56a37d0>,22,3,[ 3 11],23,-1,34,-1,31
1,<environment.Job instance at 0x7f50c51a85f0>,30,24,[2 8],31,-1,84,-1,60
1,<environment.Job instance at 0x7f50c4f61640>,31,24,[9 1],32,-1,97,-1,73
1,<environment.Job instance at 0x7f50c4f17780>,33,24,[10  5],34,-1,97,-1,73
1,<environment.Job instance at 0x7f50c51cd550>,34,23,[10  2],35,-1,96,-1,73
1,<environment.Job instance at 0x7f50c4edc820>,35,15,[ 1 11],36,-1,88,-1,73
1,<environment.Job instance at 0x7f50c56891e0>,47,15,[ 3 12],48,-1,117,-1,102
1,<environment.Job instance at 0x7f50c5ffdc80>,60,27,[ 5 10],61,-1,197,-1,170
1,<environment.Job instance at 0x7f50c4edea00>,66,25,[ 5 10],67,-1,216,-1,191
1,<environment.Job instance at 0x7f50c4f59050>,82,17,[12  4],83,-1,239,-1,222
1,<environment.Job instance at 0x7f50c4f64870>,95,2,[ 4 11],96,-1,259,-1,257
1,<environment.Job instance at 0x7f50c4edf280>,103,2,[ 2 14],104,-1,291,-1,289
1,<environment.Job instance at 0x7f50c4f2a640>,104,17,[ 5 14],105,-1,306,-1,289
1,<environment.Job instance at 0x7f50c4ee12d0>,106,2,[11  3],107,-1,291,-1,289
1,<environment.Job instance at 0x7f50c4ee1be0>,107,2,[12  2],108,-1,291,-1,289
1,<environment.Job instance at 0x7f50c4fd1230>,112,2,[12  5],113,-1,305,-1,303
1,<environment.Job instance at 0x7f50c4fd1dc0>,114,1,[14  4],115,-1,309,-1,308
1,<environment.Job instance at 0x7f50c5009870>,133,1,[ 5 12],134,-1,378,-1,377
1,<environment.Job instance at 0x7f50c500ec30>,142,14,[ 1 11],143,-1,420,-1,406
1,<environment.Job instance at 0x7f50c500ec80>,144,3,[14  4],145,-1,412,-1,409
1,<environment.Job instance at 0x7f50c500e4b0>,146,2,[13  4],147,-1,422,-1,420
1,<environment.Job instance at 0x7f50c5d4dbe0>,9,14,[ 5 11],10,-1,25,-1,11
1,<environment.Job instance at 0x7f50c5610640>,12,18,[6 3],13,-1,31,-1,13
1,<environment.Job instance at 0x7f50c5610c80>,16,25,[3 8],17,-1,42,-1,17
1,<environment.Job instance at 0x7f50c5610fa0>,19,27,[9 3],20,-1,47,-1,20
1,<environment.Job instance at 0x7f50c5d76140>,20,15,[7 5],21,-1,36,-1,21
1,<environment.Job instance at 0x7f50c5d761e0>,22,24,[ 3 10],23,-1,47,-1,23
1,<environment.Job instance at 0x7f50c5d76230>,24,17,[8 5],25,-1,42,-1,25
1,<environment.Job instance at 0x7f50c5d768c0>,28,27,[1 7],29,-1,56,-1,29
1,<environment.Job instance at 0x7f50c5d76f00>,38,14,[10  3],39,-1,61,-1,47
1,<environment.Job instance at 0x7f50c5d822d0>,41,18,[2 9],42,-1,66,-1,48
1,<environment.Job instance at 0x7f50c5d821e0>,42,18,[10  4],43,-1,66,-1,48
1,<environment.Job instance at 0x7f50c5d82410>,43,13,[6 5],44,-1,61,-1,48
1,<environment.Job instance at 0x7f50c5d827d0>,47,18,[5 1],48,-1,99,-1,81
1,<environment.Job instance at 0x7f50c5d82c30>,53,18,[5 9],54,-1,99,-1,81
1,<environment.Job instance at 0x7f50c5d76f50>,37,13,[6 4],38,-1,94,-1,81
1,<environment.Job instance at 0x7f50c5d82dc0>,52,15,[5 1],53,-1,96,-1,81
1,<environment.Job instance at 0x7f50c5d82cd0>,49,15,[9 5],50,-1,96,-1,81
1,<environment.Job instance at 0x7f50c5d82f50>,54,12,[6 4],55,-1,93,-1,81
1,<environment.Job instance at 0x7f50c5d4f1e0>,58,14,[5 9],59,-1,95,-1,81
1,<environment.Job instance at 0x7f50c5d4f410>,59,19,[9 1],60,-1,100,-1,81
1,<environment.Job instance at 0x7f50c5d4f370>,60,12,[2 5],61,-1,94,-1,82
1,<environment.Job instance at 0x7f50c5d4f550>,61,16,[6 5],62,-1,98,-1,82
1,<environment.Job instance at 0x7f50c5d4f690>,63,27,[1 8],64,-1,109,-1,82
1,<environment.Job instance at 0x7f50c5d4f7d0>,65,12,[2 9],66,-1,94,-1,82
1,<environment.Job instance at 0x7f50c5d76d70>,34,16,[10  3],35,-1,98,-1,82
1,<environment.Job instance at 0x7f50c5d4f0a0>,56,1,[7 2],57,-1,83,-1,82
1,<environment.Job instance at 0x7f50c5d4f8c0>,68,3,[5 9],69,-1,85,-1,82
1,<environment.Job instance at 0x7f50c5d4fb90>,69,13,[5 9],70,-1,95,-1,82
1,<environment.Job instance at 0x7f50c5d4fc80>,70,3,[1 7],71,-1,85,-1,82
1,<environment.Job instance at 0x7f50c5d4fbe0>,71,18,[8 4],72,-1,102,-1,84
1,<environment.Job instance at 0x7f50c5d4ffa0>,75,13,[10  4],76,-1,98,-1,85
1,<environment.Job instance at 0x7f50c5d4ff50>,76,16,[5 5],77,-1,101,-1,85
1,<environment.Job instance at 0x7f50c5d4ff00>,77,22,[1 7],78,-1,107,-1,85
1,<environment.Job instance at 0x7f50c5d530f0>,79,15,[7 1],80,-1,100,-1,85
1,<environment.Job instance at 0x7f50c5d53230>,80,14,[6 4],81,-1,99,-1,85
1,<environment.Job instance at 0x7f50c576dcd0>,81,18,[3 6],82,-1,103,-1,85
1,<environment.Job instance at 0x7f50c4fe0cd0>,84,14,[7 1],85,-1,101,-1,87
1,<environment.Job instance at 0x7f50c4ff6500>,85,25,[6 3],86,-1,112,-1,87
1,<environment.Job instance at 0x7f50c5d39320>,88,16,[8 5],89,-1,105,-1,89
1,<environment.Job instance at 0x7f50c5d39730>,89,18,[7 5],90,-1,108,-1,90
1,<environment.Job instance at 0x7f50c5d4f870>,66,14,[3 9],67,-1,105,-1,91
1,<environment.Job instance at 0x7f50c4fc7a00>,91,14,[5 8],92,-1,107,-1,93
1,<environment.Job instance at 0x7f50c5360c30>,93,15,[6 3],94,-1,109,-1,94
1,<environment.Job instance at 0x7f50c5d395f0>,92,16,[9 2],93,-1,110,-1,94
1,<environment.Job instance at 0x7f50c5360780>,95,18,[7 5],96,-1,117,-1,99
1,<environment.Job instance at 0x7f50c4fe5370>,101,22,[ 1 10],102,-1,132,-1,110
1,<environment.Job instance at 0x7f50c5360d70>,98,17,[10  3],99,-1,127,-1,110
1,<environment.Job instance at 0x7f50c4fe57d0>,104,2,[2 5],105,-1,112,-1,110
1,<environment.Job instance at 0x7f50c52bc370>,108,20,[6 2],109,-1,130,-1,110
1,<environment.Job instance at 0x7f50c5771c30>,109,15,[ 1 10],110,-1,125,-1,110
1,<environment.Job instance at 0x7f50c52bdb90>,110,14,[3 6],111,-1,125,-1,111
1,<environment.Job instance at 0x7f50c52bce60>,107,13,[7 3],108,-1,125,-1,112
1,<environment.Job instance at 0x7f50c52b0370>,120,15,[1 6],121,-1,158,-1,143
1,<environment.Job instance at 0x7f50c52b02d0>,122,18,[5 5],123,-1,161,-1,143
1,<environment.Job instance at 0x7f50c52b0550>,119,14,[10  1],120,-1,160,-1,146
1,<environment.Job instance at 0x7f50c52b04b0>,121,14,[10  4],122,-1,161,-1,147
1,<environment.Job instance at 0x7f50c5d4fb40>,5,14,[ 5 12],6,-1,20,-1,6
1,<environment.Job instance at 0x7f50c5d4f9b0>,7,19,[14  4],8,-1,27,-1,8
1,<environment.Job instance at 0x7f50c52a3c80>,9,14,[ 5 11],10,-1,24,-1,10
1,<environment.Job instance at 0x7f50c5605780>,16,25,[3 8],17,-1,53,-1,28
1,<environment.Job instance at 0x7f50c5009190>,18,3,[ 5 14],19,-1,31,-1,28
1,<environment.Job instance at 0x7f50c5009690>,19,27,[9 3],20,-1,55,-1,28
1,<environment.Job instance at 0x7f50c5009c30>,22,24,[ 3 10],23,-1,57,-1,33
1,<environment.Job instance at 0x7f50c4fd13c0>,27,12,[ 2 12],28,-1,48,-1,36
1,<environment.Job instance at 0x7f50c4fd1550>,28,27,[1 7],29,-1,65,-1,38
1,<environment.Job instance at 0x7f50c5011eb0>,45,2,[14  5],46,-1,107,-1,105
1,<environment.Job instance at 0x7f50c5b41960>,63,27,[1 8],64,-1,198,-1,171
1,<environment.Job instance at 0x7f50c5003550>,83,3,[ 3 14],84,-1,250,-1,247
1,<environment.Job instance at 0x7f50c5003b90>,85,25,[6 3],86,-1,276,-1,251
1,<environment.Job instance at 0x7f50c500c6e0>,90,2,[ 5 11],91,-1,264,-1,262
1,<environment.Job instance at 0x7f50c4fca870>,99,27,[ 5 10],100,-1,344,-1,317
1,<environment.Job instance at 0x7f50c50d6140>,116,13,[11  1],117,-1,382,-1,369
1,<environment.Job instance at 0x7f50c50d6e10>,118,12,[ 5 12],119,-1,391,-1,379
1,<environment.Job instance at 0x7f50c4fd85a0>,131,28,[2 8],132,-1,486,-1,458
1,<environment.Job instance at 0x7f50c4fd2af0>,133,27,[9 3],134,-1,503,-1,476
1,<environment.Job instance at 0x7f50c5c7b640>,136,28,[1 7],137,-1,504,-1,476
1,<environment.Job instance at 0x7f50cee44780>,139,2,[ 4 11],140,-1,478,-1,476
1,<environment.Job instance at 0x7f50c5fb69b0>,144,3,[11  1],145,-1,493,-1,490
1,<environment.Job instance at 0x7f50c5fddcd0>,146,28,[9 2],147,-1,521,-1,493
1,<environment.Job instance at 0x7f50c5fafbe0>,8,15,[ 3 11],9,-1,24,-1,9
1,<environment.Job instance at 0x7f50c5fafcd0>,10,14,[6 4],11,-1,25,-1,11
1,<environment.Job instance at 0x7f50c5faf050>,14,15,[9 1],15,-1,31,-1,16
1,<environment.Job instance at 0x7f50c5faf870>,16,23,[7 4],17,-1,40,-1,17
1,<environment.Job instance at 0x7f50c5faf280>,18,17,[5 5],19,-1,36,-1,19
1,<environment.Job instance at 0x7f50c5fafd70>,19,14,[3 7],20,-1,34,-1,20
1,<environment.Job instance at 0x7f50c5faf780>,20,15,[9 4],21,-1,36,-1,21
1,<environment.Job instance at 0x7f50c5fafc30>,22,13,[1 5],23,-1,36,-1,23
1,<environment.Job instance at 0x7f50c5faff50>,23,20,[5 4],24,-1,44,-1,24
1,<environment.Job instance at 0x7f50c5faf2d0>,15,15,[ 2 11],16,-1,43,-1,28
1,<environment.Job instance at 0x7f50c5d10690>,34,15,[10  3],35,-1,51,-1,36
1,<environment.Job instance at 0x7f50c5d10550>,36,21,[6 5],37,-1,58,-1,37
1,<environment.Job instance at 0x7f50c5d103c0>,37,13,[9 4],38,-1,51,-1,38
1,<environment.Job instance at 0x7f50c5d10370>,39,17,[5 9],40,-1,57,-1,40
1,<environment.Job instance at 0x7f50c5d10960>,40,15,[4 5],41,-1,56,-1,41
1,<environment.Job instance at 0x7f50c5d109b0>,41,27,[5 1],42,-1,69,-1,42
1,<environment.Job instance at 0x7f50c5d101e0>,42,21,[1 6],43,-1,64,-1,43
1,<environment.Job instance at 0x7f50c5d10500>,43,17,[8 5],44,-1,61,-1,44
1,<environment.Job instance at 0x7f50c5d102d0>,45,16,[4 5],46,-1,62,-1,46
1,<environment.Job instance at 0x7f50c5d10460>,46,25,[8 3],47,-1,72,-1,47
1,<environment.Job instance at 0x7f50c5d105f0>,48,16,[ 5 10],49,-1,65,-1,49
1,<environment.Job instance at 0x7f50c5d100a0>,49,18,[7 3],50,-1,68,-1,50
1,<environment.Job instance at 0x7f50c5d100f0>,50,16,[9 2],51,-1,67,-1,51
1,<environment.Job instance at 0x7f50c5aa54b0>,51,19,[10  1],52,-1,71,-1,52
1,<environment.Job instance at 0x7f50c5aa5be0>,53,12,[4 6],54,-1,66,-1,54
1,<environment.Job instance at 0x7f50c5aa55a0>,55,13,[2 6],56,-1,69,-1,56
1,<environment.Job instance at 0x7f50c5aa53c0>,56,25,[ 5 10],57,-1,82,-1,57
1,<environment.Job instance at 0x7f50c5aa52d0>,62,18,[5 9],63,-1,81,-1,63
1,<environment.Job instance at 0x7f50c5aa5730>,63,16,[6 5],64,-1,80,-1,64
1,<environment.Job instance at 0x7f50c56ab8c0>,67,17,[5 2],68,-1,85,-1,68
1,<environment.Job instance at 0x7f50c56ab280>,68,18,[1 9],69,-1,87,-1,69
1,<environment.Job instance at 0x7f50c56ab460>,69,15,[6 3],70,-1,85,-1,70
1,<environment.Job instance at 0x7f50c56aba00>,70,15,[3 9],71,-1,86,-1,71
1,<environment.Job instance at 0x7f50c56abd70>,73,12,[6 2],74,-1,86,-1,74
1,<environment.Job instance at 0x7f50c5d10870>,35,20,[4 7],36,-1,94,-1,74
1,<environment.Job instance at 0x7f50c56ab050>,74,17,[9 5],75,-1,93,-1,76
1,<environment.Job instance at 0x7f50c56ab0a0>,78,14,[9 4],79,-1,93,-1,79
1,<environment.Job instance at 0x7f50c5cd2820>,79,13,[3 6],80,-1,93,-1,80
1,<environment.Job instance at 0x7f50c5cd22d0>,80,26,[6 3],81,-1,107,-1,81
1,<environment.Job instance at 0x7f50c5cd2dc0>,81,14,[4 6],82,-1,96,-1,82
1,<environment.Job instance at 0x7f50c56ab370>,75,16,[5 3],76,-1,101,-1,85
1,<environment.Job instance at 0x7f50c5cd2410>,87,17,[4 9],88,-1,105,-1,88
1,<environment.Job instance at 0x7f50c5cd2780>,91,17,[10  4],92,-1,110,-1,93
1,<environment.Job instance at 0x7f50c5b93c30>,95,18,[10  3],96,-1,114,-1,96
1,<environment.Job instance at 0x7f50c5fff2d0>,113,16,[4 9],114,-1,174,-1,158
1,<environment.Job instance at 0x7f50c59590a0>,119,18,[9 5],120,-1,194,-1,176
1,<environment.Job instance at 0x7f50c5fff1e0>,116,17,[11  2],117,-1,193,-1,176
1,<environment.Job instance at 0x7f50c5309370>,123,28,[ 1 11],124,-1,361,-1,333
1,<environment.Job instance at 0x7f50c5c87fa0>,127,16,[ 5 10],128,-1,351,-1,335
1,<environment.Job instance at 0x7f50c5bca050>,126,14,[13  5],127,-1,349,-1,335
1,<environment.Job instance at 0x7f50c5599960>,130,13,[12  5],131,-1,348,-1,335
1,<environment.Job instance at 0x7f50c5599d70>,132,16,[9 4],133,-1,354,-1,338
1,<environment.Job instance at 0x7f50c5b86870>,136,15,[9 5],137,-1,354,-1,339
1,<environment.Job instance at 0x7f50c5b86280>,137,14,[4 7],138,-1,355,-1,341
1,<environment.Job instance at 0x7f50c5531500>,142,17,[4 5],143,-1,374,-1,357
1,<environment.Job instance at 0x7f50c55315a0>,143,18,[ 1 10],144,-1,375,-1,357
1,<environment.Job instance at 0x7f50c547b500>,147,18,[10  5],148,-1,375,-1,357
1,<environment.Job instance at 0x7f50c5aa5e10>,7,3,[ 1 12],8,-1,11,-1,8
1,<environment.Job instance at 0x7f50c5aa5500>,8,15,[ 3 11],9,-1,24,-1,9
1,<environment.Job instance at 0x7f50c5cd28c0>,15,15,[ 2 11],16,-1,31,-1,16
1,<environment.Job instance at 0x7f50c547bdc0>,16,23,[7 4],17,-1,42,-1,19
1,<environment.Job instance at 0x7f50c5fb6910>,30,16,[14  3],31,-1,72,-1,56
1,<environment.Job instance at 0x7f50c57755a0>,41,27,[5 1],42,-1,104,-1,77
1,<environment.Job instance at 0x7f50c5d4d2d0>,46,25,[8 3],47,-1,117,-1,92
1,<environment.Job instance at 0x7f50c5d4d1e0>,47,13,[13  1],48,-1,105,-1,92
1,<environment.Job instance at 0x7f50cf0874b0>,56,25,[ 5 10],57,-1,160,-1,135
1,<environment.Job instance at 0x7f50c56170a0>,76,2,[13  5],77,-1,204,-1,202
1,<environment.Job instance at 0x7f50c528caa0>,80,26,[6 3],81,-1,238,-1,212
1,<environment.Job instance at 0x7f50c528c230>,82,17,[ 2 11],83,-1,229,-1,212
1,<environment.Job instance at 0x7f50c52a3eb0>,85,23,[7 1],86,-1,241,-1,218
1,<environment.Job instance at 0x7f50c5d76410>,93,12,[ 1 14],94,-1,254,-1,242
1,<environment.Job instance at 0x7f50c5c3f280>,96,13,[13  3],97,-1,269,-1,256
1,<environment.Job instance at 0x7f50c5c3f050>,98,1,[ 3 14],99,-1,261,-1,260
1,<environment.Job instance at 0x7f50c5c367d0>,111,14,[ 3 14],112,-1,325,-1,311
1,<environment.Job instance at 0x7f50c5c36b90>,115,13,[ 1 12],116,-1,342,-1,329
1,<environment.Job instance at 0x7f50ceaec050>,116,17,[11  2],117,-1,346,-1,329
1,<environment.Job instance at 0x7f50cee49af0>,120,28,[5 6],121,-1,373,-1,345
1,<environment.Job instance at 0x7f50c6562140>,123,28,[ 1 11],124,-1,375,-1,347
1,<environment.Job instance at 0x7f50c505f230>,125,23,[5 3],126,-1,375,-1,352
1,<environment.Job instance at 0x7f50c505fbe0>,126,14,[13  5],127,-1,366,-1,352
1,<environment.Job instance at 0x7f50c65726e0>,130,13,[12  5],131,-1,379,-1,366
1,<environment.Job instance at 0x7f50ceb29fa0>,138,15,[ 3 13],139,-1,416,-1,401
1,<environment.Job instance at 0x7f50c64b3c80>,146,18,[ 3 13],147,-1,450,-1,432
1,<environment.Job instance at 0x7f50c52d2780>,0,15,[ 4 10],1,-1,16,-1,1
1,<environment.Job instance at 0x7f50c51dd820>,9,17,[9 4],10,-1,27,-1,10
1,<environment.Job instance at 0x7f50c51ddd70>,11,18,[4 8],12,-1,30,-1,12
1,<environment.Job instance at 0x7f50c51dd460>,13,15,[10  4],14,-1,30,-1,15
1,<environment.Job instance at 0x7f50c51dd4b0>,16,15,[ 5 10],17,-1,32,-1,17
1,<environment.Job instance at 0x7f50c4e76e60>,18,14,[8 3],19,-1,33,-1,19
1,<environment.Job instance at 0x7f50c51dd960>,19,14,[9 5],20,-1,34,-1,20
1,<environment.Job instance at 0x7f50c4daf5a0>,22,18,[9 4],23,-1,41,-1,23
1,<environment.Job instance at 0x7f50c6288be0>,23,18,[ 4 10],24,-1,43,-1,25
1,<environment.Job instance at 0x7f50c4f48a50>,25,1,[10  1],26,-1,28,-1,27
1,<environment.Job instance at 0x7f50c4c04c80>,27,15,[ 5 10],28,-1,43,-1,28
1,<environment.Job instance at 0x7f50c4c04e10>,28,17,[5 7],29,-1,46,-1,29
1,<environment.Job instance at 0x7f50c63100a0>,31,16,[ 4 10],32,-1,48,-1,32
1,<environment.Job instance at 0x7f50c4d52820>,34,15,[ 2 10],35,-1,50,-1,35
1,<environment.Job instance at 0x7f50c4d52780>,35,16,[4 6],36,-1,52,-1,36
1,<environment.Job instance at 0x7f50c4d525f0>,36,18,[9 4],37,-1,55,-1,37
1,<environment.Job instance at 0x7f50c4c7e820>,39,16,[2 8],40,-1,56,-1,40
1,<environment.Job instance at 0x7f50c4c7eeb0>,42,18,[5 1],43,-1,61,-1,43
1,<environment.Job instance at 0x7f50c4c7eaf0>,43,18,[ 5 10],44,-1,62,-1,44
1,<environment.Job instance at 0x7f50c4d318c0>,44,20,[9 5],45,-1,65,-1,45
1,<environment.Job instance at 0x7f50c4dfe410>,45,17,[7 4],46,-1,63,-1,46
1,<environment.Job instance at 0x7f50c4dfebe0>,46,18,[4 6],47,-1,65,-1,47
1,<environment.Job instance at 0x7f50c4dfe640>,47,14,[5 5],48,-1,62,-1,48
1,<environment.Job instance at 0x7f50c4dfb190>,53,17,[10  5],54,-1,71,-1,54
1,<environment.Job instance at 0x7f50c4dfbfa0>,54,17,[3 6],55,-1,72,-1,55
1,<environment.Job instance at 0x7f50c521b2d0>,57,16,[1 5],58,-1,74,-1,58
1,<environment.Job instance at 0x7f50c4e1b2d0>,60,13,[9 3],61,-1,74,-1,61
1,<environment.Job instance at 0x7f50c4e1b410>,61,16,[2 7],62,-1,78,-1,62
1,<environment.Job instance at 0x7f50c4e1b9b0>,62,15,[3 8],63,-1,78,-1,63
1,<environment.Job instance at 0x7f50c4e1b690>,63,13,[6 5],64,-1,77,-1,64
1,<environment.Job instance at 0x7f50c4c2ddc0>,64,13,[5 4],65,-1,78,-1,65
1,<environment.Job instance at 0x7f50ceac84b0>,26,12,[6 3],27,-1,77,-1,65
1,<environment.Job instance at 0x7f50c4c2d9b0>,67,25,[9 4],68,-1,94,-1,69
1,<environment.Job instance at 0x7f50c4e1b730>,65,15,[9 1],66,-1,86,-1,71
1,<environment.Job instance at 0x7f50c4c2d0f0>,72,17,[1 7],73,-1,90,-1,73
1,<environment.Job instance at 0x7f50c4dac9b0>,73,17,[6 4],74,-1,91,-1,74
1,<environment.Job instance at 0x7f50c4dac960>,75,16,[1 6],76,-1,92,-1,76
1,<environment.Job instance at 0x7f50c4c2d320>,70,16,[2 8],71,-1,106,-1,90
1,<environment.Job instance at 0x7f50c62e8230>,86,22,[ 4 10],87,-1,119,-1,97
1,<environment.Job instance at 0x7f50c529f2d0>,92,18,[5 8],93,-1,115,-1,97
1,<environment.Job instance at 0x7f50c4c7e7d0>,7,2,[ 4 14],8,-1,10,-1,8
1,<environment.Job instance at 0x7f50c52dbfa0>,14,2,[ 1 12],15,-1,23,-1,21
1,<environment.Job instance at 0x7f50c5666280>,20,25,[2 8],21,-1,77,-1,52
1,<environment.Job instance at 0x7f50c52d2b90>,24,3,[ 3 14],25,-1,65,-1,62
1,<environment.Job instance at 0x7f50c4fca280>,29,2,[13  5],30,-1,85,-1,83
1,<environment.Job instance at 0x7f50c5e61e60>,38,1,[ 3 12],39,-1,126,-1,125
1,<environment.Job instance at 0x7f50c550a690>,55,18,[14  2],56,-1,219,-1,201
1,<environment.Job instance at 0x7f50c606faa0>,67,25,[9 4],68,-1,290,-1,265
1,<environment.Job instance at 0x7f50c606f3c0>,71,3,[ 4 12],72,-1,272,-1,269
1,<environment.Job instance at 0x7f50c606ff00>,76,16,[14  3],77,-1,303,-1,287
1,<environment.Job instance at 0x7f50c59dcb40>,77,14,[12  5],78,-1,301,-1,287
1,<environment.Job instance at 0x7f50c59dc780>,84,25,[7 4],85,-1,337,-1,312
1,<environment.Job instance at 0x7f50ceb29e60>,95,23,[8 2],96,-1,382,-1,359
1,<environment.Job instance at 0x7f50c5d71550>,103,18,[ 2 11],104,-1,399,-1,381
1,<environment.Job instance at 0x7f50c5d71d70>,105,3,[11  2],106,-1,393,-1,390
1,<environment.Job instance at 0x7f50c5d71fa0>,112,23,[7 1],113,-1,448,-1,425
1,<environment.Job instance at 0x7f50c5d712d0>,115,3,[13  2],116,-1,443,-1,440
1,<environment.Job instance at 0x7f50c5d71780>,118,1,[13  4],119,-1,455,-1,454
1,<environment.Job instance at 0x7f50c640a7d0>,122,13,[14  4],123,-1,472,-1,459
1,<environment.Job instance at 0x7f50c5ba8280>,131,23,[ 3 13],132,-1,515,-1,492
1,<environment.Job instance at 0x7f50c5fd9870>,1,18,[3 7],2,-1,20,-1,2
1,<environment.Job instance at 0x7f50c5f51b90>,2,17,[1 9],3,-1,20,-1,3
1,<environment.Job instance at 0x7f50c5f51be0>,4,22,[9 5],5,-1,27,-1,5
1,<environment.Job instance at 0x7f50c5f51f50>,7,16,[5 8],8,-1,24,-1,8
1,<environment.Job instance at 0x7f50c5f51e10>,8,16,[1 6],9,-1,25,-1,9
1,<environment.Job instance at 0x7f50c5f35320>,13,15,[4 9],14,-1,30,-1,15
1,<environment.Job instance at 0x7f50c5f35410>,15,12,[ 3 10],16,-1,28,-1,16
1,<environment.Job instance at 0x7f50c5f35550>,16,12,[9 4],17,-1,29,-1,17
1,<environment.Job instance at 0x7f50c5f35690>,18,12,[10  1],19,-1,31,-1,19
1,<environment.Job instance at 0x7f50c5f357d0>,19,21,[1 7],20,-1,41,-1,20
1,<environment.Job instance at 0x7f50c5f35820>,20,16,[9 2],21,-1,37,-1,21
1,<environment.Job instance at 0x7f50c5f35eb0>,27,17,[8 2],28,-1,45,-1,28
1,<environment.Job instance at 0x7f50c5f35e10>,28,17,[1 6],29,-1,46,-1,29
1,<environment.Job instance at 0x7f50c5f370a0>,29,17,[9 2],30,-1,47,-1,30
1,<environment.Job instance at 0x7f50c5f37320>,32,15,[2 9],33,-1,48,-1,33
1,<environment.Job instance at 0x7f50c5f376e0>,35,16,[11  3],36,-1,52,-1,36
1,<environment.Job instance at 0x7f50c5f375a0>,37,16,[3 5],38,-1,54,-1,38
1,<environment.Job instance at 0x7f50c5f51fa0>,14,14,[10  4],15,-1,54,-1,40
1,<environment.Job instance at 0x7f50c5f37e10>,43,18,[ 2 10],44,-1,63,-1,45
1,<environment.Job instance at 0x7f50c5f303c0>,47,17,[7 4],48,-1,65,-1,48
1,<environment.Job instance at 0x7f50c5f30230>,48,15,[8 3],49,-1,64,-1,49
1,<environment.Job instance at 0x7f50c5f30410>,49,16,[10  5],50,-1,66,-1,50
1,<environment.Job instance at 0x7f50c5f30640>,51,16,[5 3],52,-1,68,-1,52
1,<environment.Job instance at 0x7f50c5f30af0>,55,17,[ 2 10],56,-1,73,-1,56
1,<environment.Job instance at 0x7f50c5f30e10>,58,19,[7 1],59,-1,78,-1,59
1,<environment.Job instance at 0x7f50c5f30e60>,60,18,[9 2],61,-1,79,-1,61
1,<environment.Job instance at 0x7f50c53b09b0>,70,27,[7 4],71,-1,106,-1,79
1,<environment.Job instance at 0x7f50c53b0b40>,72,16,[10  2],73,-1,96,-1,80
1,<environment.Job instance at 0x7f50c5f37eb0>,44,17,[8 3],45,-1,98,-1,81
1,<environment.Job instance at 0x7f50c53b0910>,68,15,[ 3 14],69,-1,96,-1,81
1,<environment.Job instance at 0x7f50c53b0f50>,76,13,[9 5],77,-1,94,-1,81
1,<environment.Job instance at 0x7f50c5f37a50>,5,3,[ 1 14],6,-1,9,-1,6
1,<environment.Job instance at 0x7f50c5f300a0>,10,13,[11  4],11,-1,31,-1,18
1,<environment.Job instance at 0x7f50c5f30a00>,11,12,[ 1 13],12,-1,30,-1,18
1,<environment.Job instance at 0x7f50c5cfb730>,22,17,[ 2 14],23,-1,77,-1,60
1,<environment.Job instance at 0x7f50c5ba8aa0>,35,16,[11  3],36,-1,124,-1,108
1,<environment.Job instance at 0x7f50c5ba85a0>,46,1,[11  2],47,-1,131,-1,130
1,<environment.Job instance at 0x7f50c5d71190>,67,14,[11  2],68,-1,225,-1,211
1,<environment.Job instance at 0x7f50c5d71dc0>,68,15,[ 3 14],69,-1,226,-1,211
1,<environment.Job instance at 0x7f50ceb29e60>,70,27,[7 4],71,-1,241,-1,214
1,<environment.Job instance at 0x7f50c59dc5f0>,75,2,[ 1 12],76,-1,228,-1,226
1,<environment.Job instance at 0x7f50c59dc870>,80,25,[ 1 14],81,-1,278,-1,253
1,<environment.Job instance at 0x7f50c59dc500>,83,1,[ 4 13],84,-1,268,-1,267
1,<environment.Job instance at 0x7f50c59dc190>,85,3,[ 4 11],86,-1,281,-1,278
1,<environment.Job instance at 0x7f50c606faa0>,98,3,[11  1],99,-1,329,-1,326
1,<environment.Job instance at 0x7f50c54f5140>,126,23,[5 5],127,-1,469,-1,446
1,<environment.Job instance at 0x7f50c54f57d0>,129,25,[7 3],130,-1,490,-1,465
1,<environment.Job instance at 0x7f50c52c0f00>,130,1,[12  5],131,-1,466,-1,465
1,<environment.Job instance at 0x7f50c4d33fa0>,141,3,[ 3 11],142,-1,506,-1,503
1,<environment.Job instance at 0x7f50c53b3b40>,0,18,[5 4],1,-1,19,-1,1
1,<environment.Job instance at 0x7f50c59fea00>,8,18,[ 4 10],9,-1,27,-1,9
1,<environment.Job instance at 0x7f50c59fed20>,10,14,[2 6],11,-1,25,-1,11
1,<environment.Job instance at 0x7f50c5bda1e0>,13,16,[3 8],14,-1,30,-1,14
1,<environment.Job instance at 0x7f50c5bda460>,14,16,[9 2],15,-1,31,-1,15
1,<environment.Job instance at 0x7f50c5bdad70>,16,18,[3 6],17,-1,35,-1,17
1,<environment.Job instance at 0x7f50c5bda0a0>,17,18,[5 5],18,-1,36,-1,18
1,<environment.Job instance at 0x7f50c5dc8550>,23,18,[4 5],24,-1,43,-1,25
1,<environment.Job instance at 0x7f50c5dc8fa0>,25,18,[5 8],26,-1,44,-1,26
1,<environment.Job instance at 0x7f50c5dc8a50>,26,18,[3 9],27,-1,45,-1,27
1,<environment.Job instance at 0x7f50c5dc8410>,29,23,[4 9],30,-1,53,-1,30
1,<environment.Job instance at 0x7f50c5e4b6e0>,31,16,[6 5],32,-1,48,-1,32
1,<environment.Job instance at 0x7f50c5e4b3c0>,34,22,[5 8],35,-1,57,-1,35
1,<environment.Job instance at 0x7f50c5e4b960>,35,16,[6 5],36,-1,53,-1,37
1,<environment.Job instance at 0x7f50c5e4bdc0>,37,18,[9 4],38,-1,58,-1,40
1,<environment.Job instance at 0x7f50c5e4b550>,36,12,[ 1 10],37,-1,66,-1,54
1,<environment.Job instance at 0x7f50c5bf30a0>,53,14,[4 8],54,-1,70,-1,56
1,<environment.Job instance at 0x7f50c5beb870>,54,17,[3 7],55,-1,74,-1,57
1,<environment.Job instance at 0x7f50c5beb5f0>,59,18,[2 9],60,-1,79,-1,61
1,<environment.Job instance at 0x7f50c5bda280>,18,22,[ 1 13],19,-1,83,-1,61
1,<environment.Job instance at 0x7f50c5bebc80>,60,18,[5 5],61,-1,80,-1,62
1,<environment.Job instance at 0x7f50c5bebf00>,61,14,[ 1 10],62,-1,86,-1,72
1,<environment.Job instance at 0x7f50c5bec870>,66,12,[8 3],67,-1,88,-1,76
1,<environment.Job instance at 0x7f50c5bf3910>,49,18,[1 9],50,-1,97,-1,79
1,<environment.Job instance at 0x7f50c5beb3c0>,64,16,[7 5],65,-1,95,-1,79
1,<environment.Job instance at 0x7f50c5bebd70>,63,18,[5 2],64,-1,97,-1,79
1,<environment.Job instance at 0x7f50c5bf3aa0>,48,14,[7 2],49,-1,95,-1,81
1,<environment.Job instance at 0x7f50c5dd65f0>,75,20,[10  3],76,-1,103,-1,83
1,<environment.Job instance at 0x7f50c5becf50>,68,3,[6 3],69,-1,86,-1,83
1,<environment.Job instance at 0x7f50c5bec320>,73,17,[14  2],74,-1,100,-1,83
1,<environment.Job instance at 0x7f50c5bece10>,71,13,[9 1],72,-1,96,-1,83
1,<environment.Job instance at 0x7f50c56dcc80>,82,18,[9 2],83,-1,101,-1,83
1,<environment.Job instance at 0x7f50c5bec5a0>,74,15,[10  2],75,-1,99,-1,84
1,<environment.Job instance at 0x7f50c59b1140>,84,14,[5 9],85,-1,100,-1,86
1,<environment.Job instance at 0x7f50c5ef65f0>,87,23,[6 1],88,-1,111,-1,88
1,<environment.Job instance at 0x7f50c5ea6a00>,91,14,[1 5],92,-1,106,-1,92
1,<environment.Job instance at 0x7f50c5ea89b0>,92,17,[5 1],93,-1,110,-1,93
1,<environment.Job instance at 0x7f50c62fea50>,96,18,[ 2 10],97,-1,117,-1,99
1,<environment.Job instance at 0x7f50c62fee10>,95,12,[8 3],96,-1,111,-1,99
1,<environment.Job instance at 0x7f50c59b1820>,85,14,[6 3],86,-1,113,-1,99
1,<environment.Job instance at 0x7f50ceaa3820>,100,25,[9 4],101,-1,126,-1,101
1,<environment.Job instance at 0x7f50c50ae7d0>,99,14,[8 5],100,-1,118,-1,104
1,<environment.Job instance at 0x7f50cf067190>,107,27,[2 9],108,-1,135,-1,108
1,<environment.Job instance at 0x7f50c50ae140>,98,14,[9 5],99,-1,133,-1,119
1,<environment.Job instance at 0x7f50cf067f00>,104,28,[ 5 10],105,-1,148,-1,120
1,<environment.Job instance at 0x7f50c520e1e0>,108,26,[4 9],109,-1,148,-1,122
1,<environment.Job instance at 0x7f50c5984370>,114,16,[8 1],115,-1,138,-1,122
1,<environment.Job instance at 0x7f50c5984dc0>,116,16,[ 5 12],117,-1,138,-1,122
1,<environment.Job instance at 0x7f50c520e370>,110,18,[5 4],111,-1,140,-1,122
1,<environment.Job instance at 0x7f50c59848c0>,118,19,[2 7],119,-1,142,-1,123
1,<environment.Job instance at 0x7f50c640d2d0>,122,22,[5 4],123,-1,145,-1,123
1,<environment.Job instance at 0x7f50c5984280>,111,14,[8 4],112,-1,140,-1,126
1,<environment.Job instance at 0x7f50c5f44d20>,97,17,[5 5],98,-1,147,-1,130
1,<environment.Job instance at 0x7f50cee19870>,126,18,[1 5],127,-1,148,-1,130
1,<environment.Job instance at 0x7f50cee19410>,128,17,[7 5],129,-1,148,-1,131
1,<environment.Job instance at 0x7f50c51b59b0>,124,13,[5 8],125,-1,145,-1,132
1,<environment.Job instance at 0x7f50cee19690>,129,13,[4 8],130,-1,145,-1,132
1,<environment.Job instance at 0x7f50cee19dc0>,131,16,[2 5],132,-1,149,-1,133
1,<environment.Job instance at 0x7f50c58d03c0>,136,17,[ 2 14],137,-1,157,-1,140
1,<environment.Job instance at 0x7f50c58d00f0>,137,26,[10  5],138,-1,167,-1,141
1,<environment.Job instance at 0x7f50c58d07d0>,135,15,[5 4],136,-1,158,-1,143
1,<environment.Job instance at 0x7f50c504ba00>,140,18,[4 5],141,-1,162,-1,144
1,<environment.Job instance at 0x7f50c504b820>,141,18,[4 9],142,-1,163,-1,145
1,<environment.Job instance at 0x7f50c504b5a0>,143,13,[9 3],144,-1,158,-1,145
1,<environment.Job instance at 0x7f50c504bf50>,144,19,[2 5],145,-1,164,-1,145
1,<environment.Job instance at 0x7f50c504b910>,145,14,[ 3 10],146,-1,160,-1,146
1,<environment.Job instance at 0x7f50c504b370>,146,14,[5 4],147,-1,161,-1,147
1,<environment.Job instance at 0x7f50c58d0550>,139,16,[5 6],140,-1,163,-1,147
1,<environment.Job instance at 0x7f50c5e4b460>,5,3,[14  4],6,-1,9,-1,6
1,<environment.Job instance at 0x7f50c53b3a50>,6,17,[ 1 13],7,-1,24,-1,7
1,<environment.Job instance at 0x7f50c5e4bd70>,7,18,[ 3 12],8,-1,26,-1,8
1,<environment.Job instance at 0x7f50c5bf3730>,11,2,[11  4],12,-1,14,-1,12
1,<environment.Job instance at 0x7f50c5ea84b0>,18,22,[ 1 13],19,-1,47,-1,25
1,<environment.Job instance at 0x7f50c509e6e0>,28,2,[11  2],29,-1,67,-1,65
1,<environment.Job instance at 0x7f50c644e730>,29,23,[4 9],30,-1,88,-1,65
1,<environment.Job instance at 0x7f50c4e1b1e0>,32,13,[14  2],33,-1,79,-1,66
1,<environment.Job instance at 0x7f50c5cd2e10>,50,2,[ 4 14],51,-1,137,-1,135
1,<environment.Job instance at 0x7f50ceb29e10>,73,17,[14  2],74,-1,237,-1,220
1,<environment.Job instance at 0x7f50c5ba81e0>,86,2,[ 5 12],87,-1,247,-1,245
1,<environment.Job instance at 0x7f50c5ba82d0>,87,23,[6 1],88,-1,279,-1,256
1,<environment.Job instance at 0x7f50c5cfb550>,100,25,[9 4],101,-1,329,-1,304
1,<environment.Job instance at 0x7f50c5f30a00>,104,28,[ 5 10],105,-1,349,-1,321
1,<environment.Job instance at 0x7f50c5f302d0>,107,27,[2 9],108,-1,349,-1,322
1,<environment.Job instance at 0x7f50c5f306e0>,108,26,[4 9],109,-1,348,-1,322
1,<environment.Job instance at 0x7f50c5f51c30>,116,16,[ 5 12],117,-1,368,-1,352
1,<environment.Job instance at 0x7f50c5d027d0>,136,17,[ 2 14],137,-1,426,-1,409
1,<environment.Job instance at 0x7f50c60d60f0>,137,26,[10  5],138,-1,467,-1,441
1,<environment.Job instance at 0x7f50c53c8cd0>,3,23,[1 7],4,-1,27,-1,4
1,<environment.Job instance at 0x7f50c53c80a0>,5,18,[ 2 10],6,-1,24,-1,6
1,<environment.Job instance at 0x7f50c53c8dc0>,9,17,[9 1],10,-1,28,-1,11
1,<environment.Job instance at 0x7f50c53c8f50>,12,26,[1 5],13,-1,39,-1,13
1,<environment.Job instance at 0x7f50c63467d0>,13,17,[ 4 10],14,-1,31,-1,14
1,<environment.Job instance at 0x7f50c6346a50>,14,15,[5 3],15,-1,30,-1,15
1,<environment.Job instance at 0x7f50c6346550>,15,15,[8 3],16,-1,31,-1,16
1,<environment.Job instance at 0x7f50c6346aa0>,17,12,[9 2],18,-1,30,-1,18
1,<environment.Job instance at 0x7f50c63468c0>,20,13,[10  5],21,-1,34,-1,21
1,<environment.Job instance at 0x7f50c6346370>,22,22,[5 3],23,-1,45,-1,23
1,<environment.Job instance at 0x7f50c6346820>,24,15,[4 7],25,-1,40,-1,25
1,<environment.Job instance at 0x7f50c6346a00>,27,24,[2 8],28,-1,52,-1,28
1,<environment.Job instance at 0x7f50c56f79b0>,31,16,[4 9],32,-1,48,-1,32
1,<environment.Job instance at 0x7f50c56f7690>,32,15,[1 6],33,-1,48,-1,33
1,<environment.Job instance at 0x7f50c56f7cd0>,33,26,[1 8],34,-1,60,-1,34
1,<environment.Job instance at 0x7f50c56f7eb0>,35,12,[5 2],36,-1,48,-1,36
1,<environment.Job instance at 0x7f50c56f74b0>,36,18,[7 1],37,-1,55,-1,37
1,<environment.Job instance at 0x7f50c56f7140>,41,23,[9 4],42,-1,65,-1,42
1,<environment.Job instance at 0x7f50c4bdd190>,50,17,[4 7],51,-1,68,-1,51
1,<environment.Job instance at 0x7f50c56f70f0>,46,16,[9 3],47,-1,72,-1,56
1,<environment.Job instance at 0x7f50c4bddaa0>,53,12,[4 5],54,-1,68,-1,56
1,<environment.Job instance at 0x7f50c53c8fa0>,10,16,[4 8],11,-1,73,-1,57
1,<environment.Job instance at 0x7f50c5a3cbe0>,57,17,[4 6],58,-1,75,-1,58
1,<environment.Job instance at 0x7f50c5a3c050>,60,18,[3 6],61,-1,81,-1,63
1,<environment.Job instance at 0x7f50c5ccfaa0>,62,16,[1 9],63,-1,84,-1,68
1,<environment.Job instance at 0x7f50c56f7d20>,39,15,[ 1 14],40,-1,86,-1,71
1,<environment.Job instance at 0x7f50c501dd20>,66,16,[2 7],67,-1,87,-1,71
1,<environment.Job instance at 0x7f50c5b60cd0>,69,12,[4 8],70,-1,84,-1,72
1,<environment.Job instance at 0x7f50c5d7ba50>,70,14,[1 9],71,-1,86,-1,72
1,<environment.Job instance at 0x7f50c5d765a0>,74,17,[10  5],75,-1,96,-1,79
1,<environment.Job instance at 0x7f50c56f73c0>,44,14,[2 7],45,-1,93,-1,79
1,<environment.Job instance at 0x7f50c5ac4a50>,64,12,[10  3],65,-1,91,-1,79
1,<environment.Job instance at 0x7f50c56f7870>,45,2,[1 9],46,-1,82,-1,80
1,<environment.Job instance at 0x7f50ceb75320>,75,15,[1 6],76,-1,95,-1,80
1,<environment.Job instance at 0x7f50ceb75eb0>,77,16,[11  5],78,-1,101,-1,85
1,<environment.Job instance at 0x7f50c6232f50>,90,15,[6 2],91,-1,111,-1,96
1,<environment.Job instance at 0x7f50c4edf730>,92,16,[5 3],93,-1,113,-1,97
1,<environment.Job instance at 0x7f50c6305b40>,93,16,[9 5],94,-1,114,-1,98
1,<environment.Job instance at 0x7f50c6395820>,94,16,[8 5],95,-1,114,-1,98
1,<environment.Job instance at 0x7f50c4edf5a0>,85,17,[ 5 10],86,-1,118,-1,101
1,<environment.Job instance at 0x7f50c62e0be0>,97,14,[ 5 10],98,-1,115,-1,101
1,<environment.Job instance at 0x7f50c602ed20>,99,16,[6 2],100,-1,117,-1,101
1,<environment.Job instance at 0x7f50c578e190>,102,16,[9 3],103,-1,120,-1,104
1,<environment.Job instance at 0x7f50c578e820>,103,14,[1 6],104,-1,118,-1,104
1,<environment.Job instance at 0x7f50c5f37eb0>,104,16,[7 3],105,-1,121,-1,105
1,<environment.Job instance at 0x7f50c5c80c80>,84,12,[7 2],85,-1,119,-1,107
1,<environment.Job instance at 0x7f50c5f37960>,105,22,[5 2],106,-1,131,-1,109
1,<environment.Job instance at 0x7f50c578ee60>,101,12,[2 5],102,-1,121,-1,109
1,<environment.Job instance at 0x7f50c4cbf500>,108,13,[5 7],109,-1,122,-1,109
1,<environment.Job instance at 0x7f50c55fe9b0>,110,13,[11  3],111,-1,125,-1,112
1,<environment.Job instance at 0x7f50c64cd6e0>,111,28,[7 5],112,-1,143,-1,115
1,<environment.Job instance at 0x7f50c4f13c30>,115,18,[10  4],116,-1,134,-1,116
1,<environment.Job instance at 0x7f50c55fed70>,114,26,[7 1],115,-1,152,-1,126
1,<environment.Job instance at 0x7f50c5b1b5f0>,121,18,[4 9],122,-1,144,-1,126
1,<environment.Job instance at 0x7f50c5601fa0>,117,15,[7 2],118,-1,141,-1,126
1,<environment.Job instance at 0x7f50c5aa0190>,125,16,[2 7],126,-1,144,-1,128
1,<environment.Job instance at 0x7f50c51b8690>,128,18,[8 3],129,-1,149,-1,131
1,<environment.Job instance at 0x7f50c53e3cd0>,130,24,[10  5],131,-1,160,-1,136
1,<environment.Job instance at 0x7f50c556ef00>,127,13,[13  4],128,-1,150,-1,137
1,<environment.Job instance at 0x7f50c63c9050>,132,15,[ 2 10],133,-1,152,-1,137
1,<environment.Job instance at 0x7f50c53e6be0>,134,17,[10  3],135,-1,154,-1,137
1,<environment.Job instance at 0x7f50c56010f0>,122,18,[3 6],123,-1,155,-1,137
1,<environment.Job instance at 0x7f50c53cc3c0>,133,18,[6 3],134,-1,155,-1,137
1,<environment.Job instance at 0x7f50c53e67d0>,135,18,[ 2 11],136,-1,156,-1,138
1,<environment.Job instance at 0x7f50c59751e0>,138,27,[5 1],139,-1,166,-1,139
1,<environment.Job instance at 0x7f50c5ab9af0>,139,15,[9 3],140,-1,155,-1,140
1,<environment.Job instance at 0x7f50c5c7adc0>,137,18,[6 4],138,-1,158,-1,140
1,<environment.Job instance at 0x7f50c597cc30>,143,12,[4 8],144,-1,159,-1,147
1,<environment.Job instance at 0x7f50c598ddc0>,148,27,[1 7],149,-1,176,-1,149
1,<environment.Job instance at 0x7f50c56c3b90>,3,23,[1 7],4,-1,27,-1,4
1,<environment.Job instance at 0x7f50ceb750f0>,8,13,[14  3],9,-1,22,-1,9
1,<environment.Job instance at 0x7f50c5c1b1e0>,12,26,[1 5],13,-1,39,-1,13
1,<environment.Job instance at 0x7f50c53c8e60>,27,24,[2 8],28,-1,94,-1,70
1,<environment.Job instance at 0x7f50c53c8a50>,29,13,[14  2],30,-1,83,-1,70
1,<environment.Job instance at 0x7f50c5f37a50>,33,26,[1 8],34,-1,116,-1,90
1,<environment.Job instance at 0x7f50c5f30eb0>,39,15,[ 1 14],40,-1,118,-1,103
1,<environment.Job instance at 0x7f50c5f30a50>,41,23,[9 4],42,-1,131,-1,108
1,<environment.Job instance at 0x7f50c4bd2690>,77,16,[11  5],78,-1,276,-1,260
1,<environment.Job instance at 0x7f50c4bcceb0>,81,3,[13  1],82,-1,273,-1,270
1,<environment.Job instance at 0x7f50c53c30a0>,95,1,[ 3 12],96,-1,316,-1,315
1,<environment.Job instance at 0x7f50c59bf640>,98,3,[ 5 12],99,-1,334,-1,331
1,<environment.Job instance at 0x7f50c5a3caf0>,106,1,[11  1],107,-1,365,-1,364
1,<environment.Job instance at 0x7f50c5a3cc30>,110,13,[11  3],111,-1,382,-1,369
1,<environment.Job instance at 0x7f50c5a3ce10>,111,28,[7 5],112,-1,406,-1,378
1,<environment.Job instance at 0x7f50c4bd0c80>,113,2,[14  5],114,-1,380,-1,378
1,<environment.Job instance at 0x7f50c4bd0b90>,114,26,[7 1],115,-1,408,-1,382
1,<environment.Job instance at 0x7f50c4bd0870>,127,13,[13  4],128,-1,432,-1,419
1,<environment.Job instance at 0x7f50c4bd00a0>,131,3,[ 4 12],132,-1,440,-1,437
1,<environment.Job instance at 0x7f50c4bd00f0>,130,24,[10  5],131,-1,474,-1,450
1,<environment.Job instance at 0x7f50c5a302d0>,135,18,[ 2 11],136,-1,472,-1,454
1,<environment.Job instance at 0x7f50c5a30320>,136,13,[11  3],137,-1,467,-1,454
1,<environment.Job instance at 0x7f50c5a30cd0>,138,27,[5 1],139,-1,496,-1,469
1,<environment.Job instance at 0x7f50c5a30370>,148,27,[1 7],149,-1,534,-1,507
1,<environment.Job instance at 0x7f50c5c40b90>,10,17,[5 9],11,-1,28,-1,11
1,<environment.Job instance at 0x7f50c5c40c80>,11,17,[9 4],12,-1,32,-1,15
1,<environment.Job instance at 0x7f50c5c40eb0>,14,14,[9 5],15,-1,30,-1,16
1,<environment.Job instance at 0x7f50c53e2230>,16,16,[3 8],17,-1,33,-1,17
1,<environment.Job instance at 0x7f50c53e2190>,17,18,[ 5 10],18,-1,36,-1,18
1,<environment.Job instance at 0x7f50c53e2820>,24,18,[ 2 10],25,-1,43,-1,25
1,<environment.Job instance at 0x7f50c53e28c0>,25,14,[8 4],26,-1,40,-1,26
1,<environment.Job instance at 0x7f50c53e26e0>,26,18,[ 2 10],27,-1,45,-1,27
1,<environment.Job instance at 0x7f50c53e2a50>,27,18,[5 9],28,-1,46,-1,28
1,<environment.Job instance at 0x7f50c53e2d20>,30,17,[8 2],31,-1,48,-1,31
1,<environment.Job instance at 0x7f50c53e2960>,31,14,[4 9],32,-1,46,-1,32
1,<environment.Job instance at 0x7f50c53d7500>,38,25,[5 5],39,-1,65,-1,40
1,<environment.Job instance at 0x7f50c53d7230>,36,3,[1 8],37,-1,56,-1,53
1,<environment.Job instance at 0x7f50c53d7d20>,48,17,[2 7],49,-1,70,-1,53
1,<environment.Job instance at 0x7f50c53d7dc0>,49,16,[8 5],50,-1,69,-1,53
1,<environment.Job instance at 0x7f50c53d7eb0>,50,22,[4 6],51,-1,75,-1,53
1,<environment.Job instance at 0x7f50c53d7be0>,46,15,[2 7],47,-1,68,-1,53
1,<environment.Job instance at 0x7f50c53ea280>,52,18,[5 6],53,-1,74,-1,56
1,<environment.Job instance at 0x7f50c53ea910>,62,17,[ 3 14],63,-1,132,-1,115
1,<environment.Job instance at 0x7f50c596a5a0>,135,17,[4 9],136,-1,405,-1,388
1,<environment.Job instance at 0x7f50c4ceacd0>,6,1,[14  4],7,-1,8,-1,7
1,<environment.Job instance at 0x7f50c4c11140>,7,17,[13  5],8,-1,25,-1,8
1,<environment.Job instance at 0x7f50c60ab0a0>,38,25,[5 5],39,-1,152,-1,127
1,<environment.Job instance at 0x7f50c5c492d0>,40,18,[14  5],41,-1,145,-1,127
1,<environment.Job instance at 0x7f50c597e780>,41,15,[ 1 12],42,-1,142,-1,127
1,<environment.Job instance at 0x7f50c5a30a00>,62,17,[ 3 14],63,-1,245,-1,228
1,<environment.Job instance at 0x7f50c4bd05a0>,65,16,[ 4 12],66,-1,248,-1,232
1,<environment.Job instance at 0x7f50c4bd09b0>,68,18,[13  3],69,-1,260,-1,242
1,<environment.Job instance at 0x7f50c4bd0690>,69,1,[ 4 14],70,-1,243,-1,242
1,<environment.Job instance at 0x7f50c4bd0b40>,72,16,[14  1],73,-1,263,-1,247
1,<environment.Job instance at 0x7f50c4bd0190>,75,1,[ 5 13],76,-1,261,-1,260
1,<environment.Job instance at 0x7f50c5a3ce10>,83,3,[ 5 11],84,-1,294,-1,291
1,<environment.Job instance at 0x7f50c5a3c410>,91,3,[ 3 11],92,-1,299,-1,296
1,<environment.Job instance at 0x7f50c4bccf50>,98,18,[ 4 12],99,-1,334,-1,316
1,<environment.Job instance at 0x7f50c4bcc230>,104,26,[10  2],105,-1,370,-1,344
1,<environment.Job instance at 0x7f50c4bd2d20>,117,15,[13  3],118,-1,391,-1,376
1,<environment.Job instance at 0x7f50c5bda0f0>,131,2,[ 2 13],132,-1,417,-1,415
1,<environment.Job instance at 0x7f50cee192d0>,138,2,[12  1],139,-1,433,-1,431
1,<environment.Job instance at 0x7f50c52c00a0>,139,27,[ 5 11],140,-1,458,-1,431
1,<environment.Job instance at 0x7f50ceb29d70>,143,25,[9 3],144,-1,485,-1,460
1,<environment.Job instance at 0x7f50c644cd70>,148,17,[ 2 12],149,-1,491,-1,474
1,<environment.Job instance at 0x7f50c5a19050>,0,26,[9 4],1,-1,27,-1,1
1,<environment.Job instance at 0x7f50cea993c0>,3,18,[10  5],4,-1,22,-1,4
1,<environment.Job instance at 0x7f50c5304190>,14,17,[9 5],15,-1,32,-1,15
1,<environment.Job instance at 0x7f50c5304960>,15,14,[2 9],16,-1,30,-1,16
1,<environment.Job instance at 0x7f50c5304320>,20,22,[1 9],21,-1,46,-1,24
1,<environment.Job instance at 0x7f50c53048c0>,23,1,[5 6],24,-1,26,-1,25
1,<environment.Job instance at 0x7f50c5304730>,25,14,[10  1],26,-1,40,-1,26
1,<environment.Job instance at 0x7f50c5304fa0>,24,13,[10  5],25,-1,39,-1,26
1,<environment.Job instance at 0x7f50c5304be0>,27,17,[1 7],28,-1,49,-1,32
1,<environment.Job instance at 0x7f50c4c6f4b0>,31,16,[2 6],32,-1,48,-1,32
1,<environment.Job instance at 0x7f50c4c6feb0>,32,17,[8 1],33,-1,50,-1,33
1,<environment.Job instance at 0x7f50c4c6f0f0>,33,26,[2 9],34,-1,60,-1,34
1,<environment.Job instance at 0x7f50c4c6f3c0>,35,17,[1 8],36,-1,53,-1,36
1,<environment.Job instance at 0x7f50c4c6f5f0>,38,14,[1 6],39,-1,53,-1,39
1,<environment.Job instance at 0x7f50c4c6f730>,29,17,[8 4],30,-1,72,-1,55
1,<environment.Job instance at 0x7f50c5d52fa0>,58,18,[5 6],59,-1,97,-1,79
1,<environment.Job instance at 0x7f50c5304910>,19,19,[2 9],20,-1,102,-1,83
1,<environment.Job instance at 0x7f50c5d52730>,62,18,[7 3],63,-1,101,-1,83
1,<environment.Job instance at 0x7f50c529bf00>,43,18,[1 8],44,-1,101,-1,83
1,<environment.Job instance at 0x7f50c5df1fa0>,65,16,[5 7],66,-1,99,-1,83
1,<environment.Job instance at 0x7f50c529b780>,51,12,[5 1],52,-1,95,-1,83
1,<environment.Job instance at 0x7f50c5df1690>,69,23,[5 5],70,-1,116,-1,93
1,<environment.Job instance at 0x7f50c5df1370>,70,17,[8 3],71,-1,112,-1,95
1,<environment.Job instance at 0x7f50c5df1c80>,73,13,[10  3],74,-1,108,-1,95
1,<environment.Job instance at 0x7f50c5df1820>,74,17,[5 6],75,-1,112,-1,95
1,<environment.Job instance at 0x7f50c5df1cd0>,75,24,[7 5],76,-1,119,-1,95
1,<environment.Job instance at 0x7f50c6182410>,103,22,[5 4],104,-1,234,-1,212
1,<environment.Job instance at 0x7f50c6182690>,105,17,[ 4 10],106,-1,233,-1,216
1,<environment.Job instance at 0x7f50c6182b90>,113,18,[10  5],114,-1,247,-1,229
1,<environment.Job instance at 0x7f50c5f5e8c0>,92,16,[6 3],93,-1,248,-1,232
1,<environment.Job instance at 0x7f50c5f5ee60>,102,28,[8 2],103,-1,263,-1,235
1,<environment.Job instance at 0x7f50c4d50730>,123,18,[4 9],124,-1,253,-1,235
1,<environment.Job instance at 0x7f50c60d69b0>,129,12,[9 3],130,-1,249,-1,237
1,<environment.Job instance at 0x7f50c61824b0>,111,17,[6 5],112,-1,254,-1,237
1,<environment.Job instance at 0x7f50c58f4780>,124,26,[7 4],125,-1,263,-1,237
1,<environment.Job instance at 0x7f50c5f5e460>,95,19,[8 1],96,-1,256,-1,237
1,<environment.Job instance at 0x7f50c60d6230>,128,16,[1 8],129,-1,253,-1,237
1,<environment.Job instance at 0x7f50c60d67d0>,131,13,[5 5],132,-1,251,-1,238
1,<environment.Job instance at 0x7f50c549e410>,142,14,[ 2 12],143,-1,252,-1,238
1,<environment.Job instance at 0x7f50c5f44e10>,141,16,[8 1],142,-1,255,-1,239
1,<environment.Job instance at 0x7f50cea56780>,134,17,[10  4],135,-1,256,-1,239
1,<environment.Job instance at 0x7f50c6182f00>,147,19,[4 7],148,-1,261,-1,242
1,<environment.Job instance at 0x7f50c5f5e0f0>,101,23,[7 5],102,-1,265,-1,242
1,<environment.Job instance at 0x7f50cefc1370>,0,26,[9 4],1,-1,27,-1,1
1,<environment.Job instance at 0x7f50c529b960>,5,14,[13  2],6,-1,20,-1,6
1,<environment.Job instance at 0x7f50c5d52640>,8,24,[8 3],9,-1,48,-1,24
1,<environment.Job instance at 0x7f50c4d30a00>,28,2,[ 4 12],29,-1,51,-1,49
1,<environment.Job instance at 0x7f50c5217690>,33,26,[2 9],34,-1,107,-1,81
1,<environment.Job instance at 0x7f50c5217af0>,36,13,[12  4],37,-1,101,-1,88
1,<environment.Job instance at 0x7f50c50ae6e0>,41,17,[13  5],42,-1,122,-1,105
1,<environment.Job instance at 0x7f50c4bcceb0>,69,23,[5 5],70,-1,235,-1,212
1,<environment.Job instance at 0x7f50c4bcca50>,75,24,[7 5],76,-1,248,-1,224
1,<environment.Job instance at 0x7f50c53c30a0>,77,3,[ 2 13],78,-1,227,-1,224
1,<environment.Job instance at 0x7f50c5a3c780>,90,1,[13  2],91,-1,268,-1,267
1,<environment.Job instance at 0x7f50c4bd0280>,93,1,[ 2 13],94,-1,282,-1,281
1,<environment.Job instance at 0x7f50c4bd0c80>,96,1,[ 4 11],97,-1,288,-1,287
1,<environment.Job instance at 0x7f50c4bd0050>,101,23,[7 5],102,-1,328,-1,305
1,<environment.Job instance at 0x7f50c4bd0e60>,102,28,[8 2],103,-1,333,-1,305
1,<environment.Job instance at 0x7f50c5c49640>,124,26,[7 4],125,-1,377,-1,351
1,<environment.Job instance at 0x7f50c5c40870>,125,1,[12  3],126,-1,352,-1,351
1,<environment.Job instance at 0x7f50c5c55dc0>,138,16,[14  5],139,-1,403,-1,387
1,<environment.Job instance at 0x7f50c5c39140>,142,14,[ 2 12],143,-1,406,-1,392
1,<environment.Job instance at 0x7f50c5c55640>,145,15,[ 2 12],146,-1,420,-1,405
1,<environment.Job instance at 0x7f50c5307c30>,0,17,[2 8],1,-1,20,-1,3
1,<environment.Job instance at 0x7f50c4cd65f0>,3,13,[5 1],4,-1,17,-1,4
1,<environment.Job instance at 0x7f50c4cd6050>,2,12,[10  3],3,-1,16,-1,4
1,<environment.Job instance at 0x7f50c4cd6aa0>,7,18,[7 1],8,-1,26,-1,8
1,<environment.Job instance at 0x7f50c4cd64b0>,8,16,[10  3],9,-1,26,-1,10
1,<environment.Job instance at 0x7f50c4cd6280>,9,15,[9 3],10,-1,25,-1,10
1,<environment.Job instance at 0x7f50c4cd6730>,12,22,[6 2],13,-1,35,-1,13
1,<environment.Job instance at 0x7f50c4cd6190>,13,16,[4 9],14,-1,30,-1,14
1,<environment.Job instance at 0x7f50c4cd65a0>,14,23,[6 5],15,-1,38,-1,15
1,<environment.Job instance at 0x7f50c4cb7a50>,22,17,[1 6],23,-1,40,-1,23
1,<environment.Job instance at 0x7f50c4cb78c0>,23,21,[7 4],24,-1,45,-1,24
1,<environment.Job instance at 0x7f50c4cb75a0>,25,15,[ 5 11],26,-1,41,-1,26
1,<environment.Job instance at 0x7f50c50e15f0>,30,26,[5 7],31,-1,57,-1,31
1,<environment.Job instance at 0x7f50c628a050>,31,16,[ 2 10],32,-1,48,-1,32
1,<environment.Job instance at 0x7f50c628abe0>,33,15,[10  1],34,-1,50,-1,35
1,<environment.Job instance at 0x7f50c628a550>,35,3,[6 1],36,-1,39,-1,36
1,<environment.Job instance at 0x7f50c628aaf0>,36,1,[7 3],37,-1,38,-1,37
1,<environment.Job instance at 0x7f50c628aa00>,37,15,[1 7],38,-1,53,-1,38
1,<environment.Job instance at 0x7f50c628a460>,38,18,[5 6],39,-1,57,-1,39
1,<environment.Job instance at 0x7f50c628aaa0>,39,27,[5 9],40,-1,67,-1,40
1,<environment.Job instance at 0x7f50c628a1e0>,40,1,[8 1],41,-1,42,-1,41
1,<environment.Job instance at 0x7f50c628ad20>,41,12,[8 3],42,-1,54,-1,42
1,<environment.Job instance at 0x7f50c628a5f0>,42,26,[ 1 10],43,-1,69,-1,43
1,<environment.Job instance at 0x7f50c628a280>,43,28,[3 5],44,-1,72,-1,44
1,<environment.Job instance at 0x7f50c628a7d0>,44,16,[5 6],45,-1,61,-1,45
1,<environment.Job instance at 0x7f50c628a230>,45,16,[10  2],46,-1,62,-1,46
1,<environment.Job instance at 0x7f50c628a640>,46,2,[5 6],47,-1,49,-1,47
1,<environment.Job instance at 0x7f50c628a0a0>,47,12,[4 7],48,-1,60,-1,48
1,<environment.Job instance at 0x7f50c628a960>,48,1,[9 2],49,-1,50,-1,49
1,<environment.Job instance at 0x7f50c4c8e780>,49,12,[ 5 10],50,-1,62,-1,50
1,<environment.Job instance at 0x7f50c4c8efa0>,50,20,[5 8],51,-1,71,-1,51
1,<environment.Job instance at 0x7f50c4c8e190>,51,2,[10  5],52,-1,54,-1,52
1,<environment.Job instance at 0x7f50c628aeb0>,34,20,[5 9],35,-1,72,-1,52
1,<environment.Job instance at 0x7f50c4c8e370>,56,18,[3 5],57,-1,75,-1,57
1,<environment.Job instance at 0x7f50c4c8b5f0>,58,14,[7 5],59,-1,73,-1,59
1,<environment.Job instance at 0x7f50c4c8b730>,60,21,[5 2],61,-1,82,-1,61
1,<environment.Job instance at 0x7f50c5173500>,64,18,[3 8],65,-1,85,-1,67
1,<environment.Job instance at 0x7f50c4cdbf50>,71,17,[2 9],72,-1,89,-1,72
1,<environment.Job instance at 0x7f50c4cdb910>,74,3,[6 1],75,-1,78,-1,75
1,<environment.Job instance at 0x7f50c4cdb050>,76,12,[9 1],77,-1,89,-1,77
1,<environment.Job instance at 0x7f50c5173230>,78,14,[7 3],79,-1,93,-1,79
1,<environment.Job instance at 0x7f50ceae65f0>,80,12,[3 8],81,-1,93,-1,81
1,<environment.Job instance at 0x7f50cf085910>,84,18,[6 3],85,-1,103,-1,85
1,<environment.Job instance at 0x7f50c6000640>,85,23,[7 4],86,-1,109,-1,86
1,<environment.Job instance at 0x7f50c5b89820>,86,23,[5 6],87,-1,110,-1,87
1,<environment.Job instance at 0x7f50c5b89cd0>,87,16,[2 6],88,-1,104,-1,88
1,<environment.Job instance at 0x7f50c5173370>,66,14,[3 9],67,-1,111,-1,97
1,<environment.Job instance at 0x7f50c4dc4d20>,93,17,[5 1],94,-1,114,-1,97
1,<environment.Job instance at 0x7f50c6100be0>,97,26,[ 2 10],98,-1,124,-1,98
1,<environment.Job instance at 0x7f50c4dc4640>,95,15,[9 5],96,-1,114,-1,99
1,<environment.Job instance at 0x7f50c4e27640>,101,16,[8 5],102,-1,122,-1,106
1,<environment.Job instance at 0x7f50c4e27a00>,104,17,[5 7],105,-1,123,-1,106
1,<environment.Job instance at 0x7f50c4e27af0>,103,17,[ 5 12],104,-1,124,-1,107
1,<environment.Job instance at 0x7f50c4edb5f0>,92,18,[9 5],93,-1,126,-1,108
1,<environment.Job instance at 0x7f50c618d190>,98,14,[3 8],99,-1,127,-1,113
1,<environment.Job instance at 0x7f50c5b89a00>,88,25,[ 5 10],89,-1,140,-1,115
1,<environment.Job instance at 0x7f50c60575f0>,113,20,[5 2],114,-1,143,-1,123
1,<environment.Job instance at 0x7f50c64c7af0>,118,12,[12  2],119,-1,135,-1,123
1,<environment.Job instance at 0x7f50c64c7820>,119,14,[8 5],120,-1,155,-1,141
1,<environment.Job instance at 0x7f50c6085230>,124,12,[9 4],125,-1,154,-1,142
1,<environment.Job instance at 0x7f50c6085320>,121,18,[6 1],122,-1,161,-1,143
1,<environment.Job instance at 0x7f50c53941e0>,126,12,[3 5],127,-1,155,-1,143
1,<environment.Job instance at 0x7f50c4fda140>,130,25,[8 3],131,-1,168,-1,143
1,<environment.Job instance at 0x7f50c55b9b40>,131,27,[8 1],132,-1,170,-1,143
1,<environment.Job instance at 0x7f50c5394370>,127,3,[1 7],128,-1,146,-1,143
1,<environment.Job instance at 0x7f50c4d2fcd0>,136,17,[3 8],137,-1,161,-1,144
1,<environment.Job instance at 0x7f50c4d2f5a0>,137,27,[2 6],138,-1,171,-1,144
1,<environment.Job instance at 0x7f50c54520a0>,139,18,[5 2],140,-1,163,-1,145
1,<environment.Job instance at 0x7f50c5bddd70>,142,13,[9 4],143,-1,160,-1,147
1,<environment.Job instance at 0x7f50c4d2f7d0>,138,1,[10  4],139,-1,148,-1,147
1,<environment.Job instance at 0x7f50c58380a0>,144,2,[10  3],145,-1,149,-1,147
1,<environment.Job instance at 0x7f50c5198190>,145,18,[5 5],146,-1,168,-1,150
1,<environment.Job instance at 0x7f50c62d5af0>,146,14,[10  1],147,-1,164,-1,150
1,<environment.Job instance at 0x7f50c51e6eb0>,147,26,[ 5 10],148,-1,176,-1,150
1,<environment.Job instance at 0x7f50c504b4b0>,148,14,[3 7],149,-1,164,-1,150
1,<environment.Job instance at 0x7f50c6085be0>,14,23,[6 5],15,-1,55,-1,32
1,<environment.Job instance at 0x7f50cece0f50>,25,15,[ 5 11],26,-1,81,-1,66
1,<environment.Job instance at 0x7f50c4bc8dc0>,30,26,[5 7],31,-1,98,-1,72
1,<environment.Job instance at 0x7f50c56d4c80>,39,27,[5 9],40,-1,118,-1,91
1,<environment.Job instance at 0x7f50c543a050>,43,28,[3 5],44,-1,134,-1,106
1,<environment.Job instance at 0x7f50c6118af0>,42,26,[ 1 10],43,-1,158,-1,132
1,<environment.Job instance at 0x7f50c558d9b0>,59,14,[ 1 13],60,-1,160,-1,146
1,<environment.Job instance at 0x7f50c51e7eb0>,62,16,[11  5],63,-1,163,-1,147
1,<environment.Job instance at 0x7f50cf095f50>,85,23,[7 4],86,-1,254,-1,231
1,<environment.Job instance at 0x7f50c5f5e3c0>,86,23,[5 6],87,-1,254,-1,231
1,<environment.Job instance at 0x7f50c4f646e0>,88,25,[ 5 10],89,-1,258,-1,233
1,<environment.Job instance at 0x7f50ceb6ef50>,91,12,[ 5 11],92,-1,245,-1,233
1,<environment.Job instance at 0x7f50c4cbf780>,97,26,[ 2 10],98,-1,290,-1,264
1,<environment.Job instance at 0x7f50c5cb6eb0>,103,17,[ 5 12],104,-1,297,-1,280
1,<environment.Job instance at 0x7f50c506e9b0>,117,2,[ 5 11],118,-1,336,-1,334
1,<environment.Job instance at 0x7f50c62afc80>,118,12,[12  2],119,-1,346,-1,334
1,<environment.Job instance at 0x7f50cea5c780>,120,2,[ 4 14],121,-1,337,-1,335
1,<environment.Job instance at 0x7f50c4ff65f0>,131,27,[8 1],132,-1,410,-1,383
1,<environment.Job instance at 0x7f50c4ff6c80>,130,25,[8 3],131,-1,408,-1,383
1,<environment.Job instance at 0x7f50c5d489b0>,137,27,[2 6],138,-1,414,-1,387
1,<environment.Job instance at 0x7f50c62882d0>,147,26,[ 5 10],148,-1,435,-1,409
1,<environment.Job instance at 0x7f50c52bd870>,0,17,[4 8],1,-1,18,-1,1
1,<environment.Job instance at 0x7f50c52bd370>,1,17,[3 6],2,-1,19,-1,2
1,<environment.Job instance at 0x7f50c52bddc0>,2,17,[ 4 10],3,-1,21,-1,4
1,<environment.Job instance at 0x7f50c52bdfa0>,9,18,[5 5],10,-1,28,-1,10
1,<environment.Job instance at 0x7f50c52bd0a0>,11,18,[5 5],12,-1,30,-1,12
1,<environment.Job instance at 0x7f50c52bd5f0>,12,28,[5 1],13,-1,41,-1,13
1,<environment.Job instance at 0x7f50c58e55a0>,16,17,[3 7],17,-1,34,-1,17
1,<environment.Job instance at 0x7f50ceaa4640>,21,17,[ 4 10],22,-1,39,-1,22
1,<environment.Job instance at 0x7f50ceaa4f00>,24,23,[2 9],25,-1,48,-1,25
1,<environment.Job instance at 0x7f50ceaa4e10>,25,18,[5 3],26,-1,44,-1,26
1,<environment.Job instance at 0x7f50ceaa4370>,31,17,[6 1],32,-1,49,-1,32
1,<environment.Job instance at 0x7f50c4fe24b0>,32,16,[9 2],33,-1,49,-1,33
1,<environment.Job instance at 0x7f50c4fe2780>,33,15,[5 8],34,-1,49,-1,34
1,<environment.Job instance at 0x7f50ceaa4460>,30,12,[ 4 10],31,-1,49,-1,37
1,<environment.Job instance at 0x7f50c4fe26e0>,38,26,[2 5],39,-1,65,-1,39
1,<environment.Job instance at 0x7f50c4fe2550>,39,28,[4 8],40,-1,68,-1,40
1,<environment.Job instance at 0x7f50c4fe2960>,43,13,[10  1],44,-1,60,-1,47
1,<environment.Job instance at 0x7f50c5458730>,46,22,[7 4],47,-1,69,-1,47
1,<environment.Job instance at 0x7f50c5458870>,48,18,[5 5],49,-1,67,-1,49
1,<environment.Job instance at 0x7f50c5035370>,58,14,[9 3],59,-1,73,-1,59
1,<environment.Job instance at 0x7f50c623bc30>,54,18,[ 2 10],55,-1,78,-1,60
1,<environment.Job instance at 0x7f50c5305a00>,65,16,[2 7],66,-1,82,-1,66
1,<environment.Job instance at 0x7f50c59e9be0>,67,12,[10  4],68,-1,80,-1,68
1,<environment.Job instance at 0x7f50c4eb6730>,68,12,[3 8],69,-1,82,-1,70
1,<environment.Job instance at 0x7f50c5a11eb0>,70,13,[8 2],71,-1,84,-1,71
1,<environment.Job instance at 0x7f50c56d60f0>,72,13,[1 7],73,-1,86,-1,73
1,<environment.Job instance at 0x7f50c5e83730>,73,15,[3 5],74,-1,89,-1,74
1,<environment.Job instance at 0x7f50c5e83780>,74,13,[6 5],75,-1,88,-1,75
1,<environment.Job instance at 0x7f50c504b0f0>,76,20,[10  4],77,-1,97,-1,77
1,<environment.Job instance at 0x7f50c64505a0>,77,2,[10  1],78,-1,80,-1,78
1,<environment.Job instance at 0x7f50c6359fa0>,78,1,[2 8],79,-1,80,-1,79
1,<environment.Job instance at 0x7f50c5f92820>,79,13,[3 6],80,-1,93,-1,80
1,<environment.Job instance at 0x7f50c5d6ac30>,69,16,[ 3 10],70,-1,97,-1,81
1,<environment.Job instance at 0x7f50c623b140>,55,2,[8 2],56,-1,85,-1,83
1,<environment.Job instance at 0x7f50c524aaf0>,85,17,[5 8],86,-1,103,-1,86
1,<environment.Job instance at 0x7f50c5a29960>,90,16,[8 2],91,-1,108,-1,92
1,<environment.Job instance at 0x7f50c581ffa0>,92,17,[5 5],93,-1,110,-1,93
1,<environment.Job instance at 0x7f50c51d8500>,101,24,[2 6],102,-1,145,-1,121
1,<environment.Job instance at 0x7f50c51d8aa0>,99,15,[10  5],100,-1,136,-1,121
1,<environment.Job instance at 0x7f50c600cf00>,114,17,[11  5],115,-1,138,-1,121
1,<environment.Job instance at 0x7f50c5bed230>,124,24,[5 8],125,-1,252,-1,228
1,<environment.Job instance at 0x7f50c5de7c80>,136,23,[9 5],137,-1,252,-1,229
1,<environment.Job instance at 0x7f50c56b05a0>,137,18,[1 8],138,-1,247,-1,229
1,<environment.Job instance at 0x7f50c605ddc0>,142,18,[1 6],143,-1,248,-1,230
1,<environment.Job instance at 0x7f50c5309910>,143,17,[10  3],144,-1,262,-1,245
1,<environment.Job instance at 0x7f50c4fe2690>,40,28,[1 5],41,-1,292,-1,264
1,<environment.Job instance at 0x7f50c524a3c0>,4,1,[ 1 11],5,-1,6,-1,5
1,<environment.Job instance at 0x7f50ceaa4d70>,5,1,[ 3 14],6,-1,7,-1,6
1,<environment.Job instance at 0x7f50c56b0780>,12,28,[5 1],13,-1,48,-1,20
1,<environment.Job instance at 0x7f50c5d48550>,19,13,[ 1 13],20,-1,55,-1,42
1,<environment.Job instance at 0x7f50c5d93d70>,24,23,[2 9],25,-1,70,-1,47
1,<environment.Job instance at 0x7f50cea5ca50>,26,3,[14  4],27,-1,50,-1,47
1,<environment.Job instance at 0x7f50c53d2fa0>,38,26,[2 5],39,-1,123,-1,97
1,<environment.Job instance at 0x7f50c53d2910>,40,28,[1 5],41,-1,128,-1,100
1,<environment.Job instance at 0x7f50c53d29b0>,39,28,[4 8],40,-1,138,-1,110
1,<environment.Job instance at 0x7f50c4bc88c0>,47,28,[ 1 10],48,-1,146,-1,118
1,<environment.Job instance at 0x7f50c62afaf0>,93,24,[9 2],94,-1,281,-1,257
1,<environment.Job instance at 0x7f50c5f03640>,101,24,[2 6],102,-1,298,-1,274
1,<environment.Job instance at 0x7f50c53976e0>,114,17,[11  5],115,-1,345,-1,328
1,<environment.Job instance at 0x7f50c53970f0>,115,15,[ 2 12],116,-1,343,-1,328
1,<environment.Job instance at 0x7f50c4d57e60>,124,24,[5 8],125,-1,398,-1,374
1,<environment.Job instance at 0x7f50c4ac4280>,130,2,[14  3],131,-1,378,-1,376
1,<environment.Job instance at 0x7f50c4cfa5f0>,126,24,[10  2],127,-1,403,-1,379
1,<environment.Job instance at 0x7f50c5632140>,136,23,[9 5],137,-1,420,-1,397
1,<environment.Job instance at 0x7f50c64c0d20>,3,27,[5 6],4,-1,31,-1,4
1,<environment.Job instance at 0x7f50c6118780>,3,27,[5 6],4,-1,31,-1,4
1,<environment.Job instance at 0x7f50c6118e10>,6,16,[ 3 11],7,-1,23,-1,7
1,<environment.Job instance at 0x7f50c4d510a0>,8,25,[11  1],9,-1,34,-1,9
1,<environment.Job instance at 0x7f50c4cbf6e0>,20,18,[12  3],21,-1,39,-1,21
1,<environment.Job instance at 0x7f50c5397d70>,14,27,[3 8],15,-1,62,-1,35
1,<environment.Job instance at 0x7f50c4cbf780>,25,27,[4 6],26,-1,75,-1,48
1,<environment.Job instance at 0x7f50c4c72050>,40,14,[11  5],41,-1,111,-1,97
1,<environment.Job instance at 0x7f50c57a6050>,44,28,[4 7],45,-1,154,-1,126
1,<environment.Job instance at 0x7f50c4bc8690>,50,24,[9 4],51,-1,172,-1,148
1,<environment.Job instance at 0x7f50c4bc8140>,53,2,[12  3],54,-1,150,-1,148
1,<environment.Job instance at 0x7f50cee4d8c0>,61,16,[12  1],62,-1,199,-1,183
1,<environment.Job instance at 0x7f50c4d67e10>,88,3,[14  4],89,-1,285,-1,282
1,<environment.Job instance at 0x7f50c4d674b0>,90,14,[12  5],91,-1,299,-1,285
1,<environment.Job instance at 0x7f50c5590960>,110,25,[ 4 10],111,-1,378,-1,353
1,<environment.Job instance at 0x7f50c5b8dd20>,114,14,[ 2 11],115,-1,369,-1,355
1,<environment.Job instance at 0x7f50c4cb0780>,120,17,[ 5 14],121,-1,400,-1,383
1,<environment.Job instance at 0x7f50c5815aa0>,136,16,[12  5],137,-1,462,-1,446
1,<environment.Job instance at 0x7f50c4d2f3c0>,139,28,[4 8],140,-1,477,-1,449
1,<environment.Job instance at 0x7f50c4bd0eb0>,6,15,[10  5],7,-1,27,-1,12
1,<environment.Job instance at 0x7f50c59cbc80>,12,17,[ 1 10],13,-1,30,-1,13
1,<environment.Job instance at 0x7f50c59cb730>,14,15,[7 5],15,-1,30,-1,15
1,<environment.Job instance at 0x7f50c59cb2d0>,15,15,[7 1],16,-1,31,-1,16
1,<environment.Job instance at 0x7f50c59cbb90>,16,15,[5 5],17,-1,32,-1,17
1,<environment.Job instance at 0x7f50c59cbf00>,17,17,[9 4],18,-1,35,-1,18
1,<environment.Job instance at 0x7f50c4e39230>,20,18,[2 9],21,-1,39,-1,21
1,<environment.Job instance at 0x7f50c592fcd0>,22,16,[2 8],23,-1,39,-1,23
1,<environment.Job instance at 0x7f50c59025a0>,24,14,[7 2],25,-1,39,-1,25
1,<environment.Job instance at 0x7f50c4f03aa0>,26,13,[10  2],27,-1,40,-1,27
1,<environment.Job instance at 0x7f50c5fef370>,29,20,[7 2],30,-1,50,-1,30
1,<environment.Job instance at 0x7f50c6020870>,30,16,[1 9],31,-1,47,-1,31
1,<environment.Job instance at 0x7f50c6020f50>,31,12,[6 3],32,-1,44,-1,32
1,<environment.Job instance at 0x7f50c6020960>,32,16,[5 3],33,-1,49,-1,33
1,<environment.Job instance at 0x7f50c6020be0>,33,15,[9 4],34,-1,49,-1,34
1,<environment.Job instance at 0x7f50c6005c80>,37,12,[ 2 10],38,-1,50,-1,38
1,<environment.Job instance at 0x7f50c60059b0>,38,22,[ 3 10],39,-1,61,-1,39
1,<environment.Job instance at 0x7f50c6005c30>,41,14,[ 5 10],42,-1,56,-1,42
1,<environment.Job instance at 0x7f50c57cbf00>,42,17,[5 8],43,-1,60,-1,43
1,<environment.Job instance at 0x7f50c57cb870>,43,14,[5 7],44,-1,58,-1,44
1,<environment.Job instance at 0x7f50c57cb960>,44,19,[3 7],45,-1,64,-1,45
1,<environment.Job instance at 0x7f50c57cb5a0>,45,12,[ 4 10],46,-1,58,-1,46
1,<environment.Job instance at 0x7f50c57cb280>,47,23,[3 5],48,-1,71,-1,48
1,<environment.Job instance at 0x7f50c6009a50>,48,16,[1 9],49,-1,65,-1,49
1,<environment.Job instance at 0x7f50c6009050>,49,16,[1 8],50,-1,66,-1,50
1,<environment.Job instance at 0x7f50c4c34b90>,55,15,[4 9],56,-1,71,-1,56
1,<environment.Job instance at 0x7f50c59de1e0>,59,23,[8 2],60,-1,83,-1,60
1,<environment.Job instance at 0x7f50c59de4b0>,61,16,[1 7],62,-1,78,-1,62
1,<environment.Job instance at 0x7f50c5f0c7d0>,63,19,[3 9],64,-1,83,-1,64
1,<environment.Job instance at 0x7f50c5f0cf00>,65,17,[9 1],66,-1,84,-1,67
1,<environment.Job instance at 0x7f50c5f0ccd0>,67,14,[5 6],68,-1,82,-1,68
1,<environment.Job instance at 0x7f50c57de690>,68,12,[7 2],69,-1,81,-1,69
1,<environment.Job instance at 0x7f50c57dec30>,69,18,[5 3],70,-1,88,-1,70
1,<environment.Job instance at 0x7f50c57de730>,71,20,[10  2],72,-1,92,-1,72
1,<environment.Job instance at 0x7f50c4c2d5f0>,74,14,[ 3 10],75,-1,92,-1,78
1,<environment.Job instance at 0x7f50c57e5b40>,4,12,[ 4 13],5,-1,17,-1,5
1,<environment.Job instance at 0x7f50c50adb90>,10,2,[ 2 12],11,-1,13,-1,11
1,<environment.Job instance at 0x7f50c50ad3c0>,11,13,[ 3 11],12,-1,25,-1,12
1,<environment.Job instance at 0x7f50c5e94460>,25,1,[14  5],26,-1,60,-1,59
1,<environment.Job instance at 0x7f50c5e942d0>,27,2,[ 5 12],28,-1,73,-1,71
1,<environment.Job instance at 0x7f50c5e5df00>,35,2,[ 2 12],36,-1,107,-1,105
1,<environment.Job instance at 0x7f50c5e465a0>,40,13,[ 2 13],41,-1,131,-1,118
1,<environment.Job instance at 0x7f50c5e60870>,47,23,[3 5],48,-1,170,-1,147
1,<environment.Job instance at 0x7f50c50b4eb0>,50,28,[2 6],51,-1,187,-1,159
1,<environment.Job instance at 0x7f50c5e70be0>,59,23,[8 2],60,-1,204,-1,181
1,<environment.Job instance at 0x7f50c5e70cd0>,60,1,[13  1],61,-1,182,-1,181
1,<environment.Job instance at 0x7f50c5d58be0>,73,15,[ 3 14],74,-1,240,-1,225
1,<environment.Job instance at 0x7f50c50b3dc0>,78,3,[13  1],79,-1,247,-1,244
1,<environment.Job instance at 0x7f50c5d27af0>,85,15,[14  4],86,-1,277,-1,262
1,<environment.Job instance at 0x7f50c5d47960>,88,27,[6 3],89,-1,306,-1,279
1,<environment.Job instance at 0x7f50c5d47a50>,89,27,[3 5],90,-1,306,-1,279
1,<environment.Job instance at 0x7f50c59904b0>,92,2,[12  2],93,-1,281,-1,279
1,<environment.Job instance at 0x7f50c50397d0>,100,23,[5 8],101,-1,340,-1,317
1,<environment.Job instance at 0x7f50c50a5e10>,107,12,[ 2 14],108,-1,354,-1,342
1,<environment.Job instance at 0x7f50c59c3f00>,128,28,[9 5],129,-1,457,-1,429
1,<environment.Job instance at 0x7f50c5762a50>,130,1,[11  1],131,-1,430,-1,429
1,<environment.Job instance at 0x7f50c5090cd0>,147,1,[ 2 12],148,-1,469,-1,468
1,<environment.Job instance at 0x7f50c52b57d0>,1,16,[4 9],2,-1,18,-1,2
1,<environment.Job instance at 0x7f50c52b5190>,2,15,[9 5],3,-1,18,-1,3
1,<environment.Job instance at 0x7f50c52b59b0>,6,16,[ 5 10],7,-1,23,-1,7
1,<environment.Job instance at 0x7f50c52b55a0>,7,13,[10  3],8,-1,22,-1,9
1,<environment.Job instance at 0x7f50c52b5e10>,8,18,[10  5],9,-1,27,-1,9
1,<environment.Job instance at 0x7f50c52b5d70>,10,17,[6 4],11,-1,28,-1,11
1,<environment.Job instance at 0x7f50c4daba50>,19,15,[ 5 10],20,-1,35,-1,20
1,<environment.Job instance at 0x7f50c60f58c0>,27,12,[ 4 10],28,-1,40,-1,28
1,<environment.Job instance at 0x7f50c52b5140>,16,15,[7 3],17,-1,43,-1,28
1,<environment.Job instance at 0x7f50c60f5910>,29,17,[11  5],30,-1,47,-1,30
1,<environment.Job instance at 0x7f50c60f55f0>,30,18,[3 7],31,-1,49,-1,31
1,<environment.Job instance at 0x7f50c60f5b40>,33,13,[8 4],34,-1,51,-1,38
1,<environment.Job instance at 0x7f50c5957d20>,38,15,[5 4],39,-1,54,-1,39
1,<environment.Job instance at 0x7f50c4c0f820>,44,22,[7 4],45,-1,67,-1,45
1,<environment.Job instance at 0x7f50c5a297d0>,54,16,[9 5],55,-1,278,-1,262
1,<environment.Job instance at 0x7f50c6504d20>,48,17,[14  2],49,-1,289,-1,272
1,<environment.Job instance at 0x7f50c53ea820>,68,17,[3 8],69,-1,422,-1,405
1,<environment.Job instance at 0x7f50c639e2d0>,99,18,[2 7],100,-1,424,-1,406
1,<environment.Job instance at 0x7f50c590fa50>,97,17,[10  4],98,-1,423,-1,406
1,<environment.Job instance at 0x7f50c6504d70>,50,20,[ 3 10],51,-1,426,-1,406
1,<environment.Job instance at 0x7f50c592f140>,106,16,[10  2],107,-1,422,-1,406
1,<environment.Job instance at 0x7f50c592faf0>,109,17,[10  1],110,-1,429,-1,412
1,<environment.Job instance at 0x7f50c5902cd0>,101,13,[4 5],102,-1,427,-1,414
1,<environment.Job instance at 0x7f50c590f820>,98,17,[9 3],99,-1,432,-1,415
1,<environment.Job instance at 0x7f50c4e0f280>,121,17,[9 4],122,-1,452,-1,435
1,<environment.Job instance at 0x7f50c4e0fc30>,117,14,[10  2],118,-1,475,-1,461
1,<environment.Job instance at 0x7f50c4e16370>,127,18,[10  3],128,-1,479,-1,461
1,<environment.Job instance at 0x7f50c4e16e60>,134,24,[4 8],135,-1,487,-1,463
1,<environment.Job instance at 0x7f50c578caf0>,136,23,[9 2],137,-1,514,-1,491
1,<environment.Job instance at 0x7f50c578cb90>,139,27,[ 5 10],140,-1,518,-1,491
1,<environment.Job instance at 0x7f50c578c960>,140,28,[8 5],141,-1,519,-1,491
1,<environment.Job instance at 0x7f50c553eaf0>,11,23,[9 2],12,-1,56,-1,33
1,<environment.Job instance at 0x7f50c4fe8640>,15,25,[ 2 11],16,-1,71,-1,46
1,<environment.Job instance at 0x7f50c4fe8b40>,20,14,[13  1],21,-1,65,-1,51
1,<environment.Job instance at 0x7f50c580f2d0>,23,12,[12  5],24,-1,78,-1,66
1,<environment.Job instance at 0x7f50c4bf9cd0>,29,17,[11  5],30,-1,101,-1,84
1,<environment.Job instance at 0x7f50c4ca6140>,32,22,[ 4 11],33,-1,114,-1,92
1,<environment.Job instance at 0x7f50c529b050>,36,15,[13  2],37,-1,117,-1,102
1,<environment.Job instance at 0x7f50c4fc9910>,39,13,[ 5 11],40,-1,122,-1,109
1,<environment.Job instance at 0x7f50c4cad960>,43,3,[ 3 14],44,-1,127,-1,124
1,<environment.Job instance at 0x7f50c4be9f00>,48,17,[14  2],49,-1,150,-1,133
1,<environment.Job instance at 0x7f50c4fe54b0>,52,14,[11  5],53,-1,164,-1,150
1,<environment.Job instance at 0x7f50c5e204b0>,67,1,[12  4],68,-1,194,-1,193
1,<environment.Job instance at 0x7f50c6123c30>,72,14,[ 2 11],73,-1,224,-1,210
1,<environment.Job instance at 0x7f50c60d9a50>,75,13,[ 3 14],76,-1,236,-1,223
1,<environment.Job instance at 0x7f50c4c92b40>,91,1,[12  1],92,-1,265,-1,264
1,<environment.Job instance at 0x7f50c4cb5190>,93,3,[ 3 12],94,-1,268,-1,265
1,<environment.Job instance at 0x7f50c4bd7960>,103,23,[5 6],104,-1,338,-1,315
1,<environment.Job instance at 0x7f50c58ad4b0>,110,2,[13  2],111,-1,335,-1,333
1,<environment.Job instance at 0x7f50c61079b0>,113,1,[14  1],114,-1,339,-1,338
1,<environment.Job instance at 0x7f50c60eb780>,128,2,[ 4 11],129,-1,405,-1,403
1,<environment.Job instance at 0x7f50c60ebd70>,130,12,[ 1 14],131,-1,415,-1,403
1,<environment.Job instance at 0x7f50c60ebdc0>,132,2,[ 1 14],133,-1,418,-1,416
1,<environment.Job instance at 0x7f50c60ebf00>,134,24,[4 8],135,-1,445,-1,421
1,<environment.Job instance at 0x7f50c60eb140>,136,23,[9 2],137,-1,455,-1,432
1,<environment.Job instance at 0x7f50c4cd3730>,139,27,[ 5 10],140,-1,478,-1,451
1,<environment.Job instance at 0x7f50c4cd3640>,140,28,[8 5],141,-1,491,-1,463
1,<environment.Job instance at 0x7f50cead9af0>,143,17,[ 5 12],144,-1,480,-1,463
1,<environment.Job instance at 0x7f50c5810640>,144,18,[ 4 13],145,-1,481,-1,463
1,<environment.Job instance at 0x7f50cf096cd0>,1,16,[4 7],2,-1,18,-1,2
1,<environment.Job instance at 0x7f50c590f9b0>,2,17,[10  4],3,-1,21,-1,4
1,<environment.Job instance at 0x7f50c5a51b90>,8,18,[4 7],9,-1,27,-1,9
1,<environment.Job instance at 0x7f50c5e8dd70>,9,15,[7 2],10,-1,25,-1,10
1,<environment.Job instance at 0x7f50c5e8dd20>,10,21,[9 2],11,-1,32,-1,11
1,<environment.Job instance at 0x7f50c5fef820>,13,18,[ 4 10],14,-1,32,-1,14
1,<environment.Job instance at 0x7f50c5fef550>,14,15,[3 5],15,-1,30,-1,15
1,<environment.Job instance at 0x7f50cf0961e0>,3,13,[ 4 10],4,-1,28,-1,15
1,<environment.Job instance at 0x7f50c5fef190>,16,26,[3 5],17,-1,43,-1,17
1,<environment.Job instance at 0x7f50c6420c80>,24,17,[3 5],25,-1,42,-1,25
1,<environment.Job instance at 0x7f50c4d2fa00>,25,18,[ 3 10],26,-1,44,-1,26
1,<environment.Job instance at 0x7f50c5eefdc0>,33,12,[ 3 10],34,-1,46,-1,34
1,<environment.Job instance at 0x7f50c4e7a280>,37,17,[8 4],38,-1,55,-1,38
1,<environment.Job instance at 0x7f50c4bd01e0>,41,16,[1 8],42,-1,58,-1,42
1,<environment.Job instance at 0x7f50c60d1e60>,43,24,[5 1],44,-1,68,-1,44
1,<environment.Job instance at 0x7f50c601a960>,45,22,[5 4],46,-1,68,-1,46
1,<environment.Job instance at 0x7f50c4f03320>,46,28,[8 5],47,-1,75,-1,47
1,<environment.Job instance at 0x7f50c60e15a0>,50,18,[5 8],51,-1,69,-1,51
1,<environment.Job instance at 0x7f50c60af780>,54,25,[9 4],55,-1,80,-1,55
1,<environment.Job instance at 0x7f50c58835a0>,56,18,[11  2],57,-1,75,-1,57
1,<environment.Job instance at 0x7f50cecef460>,69,15,[10  5],70,-1,89,-1,74
1,<environment.Job instance at 0x7f50c626f050>,75,27,[4 6],76,-1,103,-1,76
1,<environment.Job instance at 0x7f50c6005d70>,77,17,[2 8],78,-1,95,-1,78
1,<environment.Job instance at 0x7f50c6005f00>,78,18,[5 5],79,-1,97,-1,79
1,<environment.Job instance at 0x7f50c6005c80>,81,18,[8 2],82,-1,100,-1,82
1,<environment.Job instance at 0x7f50c4db0820>,63,2,[ 2 13],64,-1,85,-1,83
1,<environment.Job instance at 0x7f50c6005fa0>,83,15,[4 8],84,-1,102,-1,87
1,<environment.Job instance at 0x7f50c60052d0>,82,16,[ 1 10],83,-1,103,-1,87
1,<environment.Job instance at 0x7f50c4db0cd0>,61,17,[6 2],62,-1,105,-1,88
1,<environment.Job instance at 0x7f50c5867fa0>,60,14,[9 4],61,-1,102,-1,88
1,<environment.Job instance at 0x7f50c60233c0>,87,17,[2 5],88,-1,105,-1,88
1,<environment.Job instance at 0x7f50c60237d0>,89,17,[9 4],90,-1,107,-1,90
1,<environment.Job instance at 0x7f50c6023780>,90,15,[10  4],91,-1,106,-1,91
1,<environment.Job instance at 0x7f50c6023af0>,91,16,[5 1],92,-1,109,-1,93
1,<environment.Job instance at 0x7f50c60235f0>,93,17,[7 4],94,-1,113,-1,96
1,<environment.Job instance at 0x7f50c6023e60>,92,14,[1 8],93,-1,110,-1,96
1,<environment.Job instance at 0x7f50c4c34b40>,96,13,[11  2],97,-1,113,-1,100
1,<environment.Job instance at 0x7f50c4c34be0>,101,23,[5 2],102,-1,125,-1,102
1,<environment.Job instance at 0x7f50c4cd3f00>,107,17,[9 5],108,-1,125,-1,108
1,<environment.Job instance at 0x7f50c4cd3960>,116,18,[10  3],117,-1,146,-1,128
1,<environment.Job instance at 0x7f50c5904e60>,126,15,[5 8],127,-1,156,-1,141
1,<environment.Job instance at 0x7f50c5904b90>,121,19,[10  5],122,-1,160,-1,141
1,<environment.Job instance at 0x7f50c63ccaf0>,131,18,[4 5],132,-1,172,-1,154
1,<environment.Job instance at 0x7f50c57d88c0>,146,28,[9 5],147,-1,266,-1,238
1,<environment.Job instance at 0x7f50c60232d0>,16,26,[3 5],17,-1,69,-1,43
1,<environment.Job instance at 0x7f50c6023d70>,17,24,[9 4],18,-1,82,-1,58
1,<environment.Job instance at 0x7f50c5eef730>,28,1,[12  1],29,-1,87,-1,86
1,<environment.Job instance at 0x7f50c4cd35a0>,43,24,[5 1],44,-1,152,-1,128
1,<environment.Job instance at 0x7f50c5618820>,46,28,[8 5],47,-1,157,-1,129
1,<environment.Job instance at 0x7f50c527dc80>,54,25,[9 4],55,-1,173,-1,148
1,<environment.Job instance at 0x7f50c4c2d140>,56,18,[11  2],57,-1,166,-1,148
1,<environment.Job instance at 0x7f50c58880a0>,58,15,[ 1 14],59,-1,163,-1,148
1,<environment.Job instance at 0x7f50c4c92190>,63,2,[ 2 13],64,-1,164,-1,162
1,<environment.Job instance at 0x7f50c4ca6f50>,75,27,[4 6],76,-1,232,-1,205
1,<environment.Job instance at 0x7f50c541b370>,79,24,[9 1],80,-1,242,-1,218
1,<environment.Job instance at 0x7f50c54b6f00>,88,1,[ 2 12],89,-1,240,-1,239
1,<environment.Job instance at 0x7f50c593bdc0>,96,13,[11  2],97,-1,297,-1,284
1,<environment.Job instance at 0x7f50c593bb90>,101,23,[5 2],102,-1,323,-1,300
1,<environment.Job instance at 0x7f50c593b0f0>,102,17,[ 5 14],103,-1,317,-1,300
1,<environment.Job instance at 0x7f50c593b780>,103,28,[10  4],104,-1,328,-1,300
1,<environment.Job instance at 0x7f50c59b6140>,108,18,[ 4 13],109,-1,320,-1,302
1,<environment.Job instance at 0x7f50c54be820>,144,24,[5 9],145,-1,476,-1,452
1,<environment.Job instance at 0x7f50c54be870>,146,28,[9 5],147,-1,480,-1,452
1,<environment.Job instance at 0x7f50c5703730>,1,18,[9 3],2,-1,20,-1,2
1,<environment.Job instance at 0x7f50c5703780>,2,17,[4 8],3,-1,20,-1,3
1,<environment.Job instance at 0x7f50c5713e60>,3,18,[8 3],4,-1,22,-1,4
1,<environment.Job instance at 0x7f50c573e0a0>,13,18,[2 6],14,-1,32,-1,14
1,<environment.Job instance at 0x7f50c573e6e0>,14,13,[1 6],15,-1,28,-1,15
1,<environment.Job instance at 0x7f50c5714280>,17,18,[3 8],18,-1,36,-1,18
1,<environment.Job instance at 0x7f50c5736230>,19,15,[10  3],20,-1,35,-1,20
1,<environment.Job instance at 0x7f50c5736f00>,21,17,[9 5],22,-1,39,-1,22
1,<environment.Job instance at 0x7f50c5736fa0>,22,19,[1 5],23,-1,42,-1,23
1,<environment.Job instance at 0x7f50c5c66cd0>,25,16,[ 4 10],26,-1,42,-1,26
1,<environment.Job instance at 0x7f50c4f5baa0>,28,16,[8 1],29,-1,45,-1,29
1,<environment.Job instance at 0x7f50c4f5baf0>,29,14,[9 3],30,-1,44,-1,30
1,<environment.Job instance at 0x7f50c4f5b8c0>,30,12,[3 6],31,-1,44,-1,32
1,<environment.Job instance at 0x7f50c4f5bb40>,32,12,[2 8],33,-1,45,-1,33
1,<environment.Job instance at 0x7f50c4f5b320>,33,23,[5 6],34,-1,57,-1,34
1,<environment.Job instance at 0x7f50c4f5b050>,34,15,[5 2],35,-1,50,-1,35
1,<environment.Job instance at 0x7f50c573ed20>,35,14,[1 5],36,-1,50,-1,36
1,<environment.Job instance at 0x7f50c56d8c30>,37,12,[6 5],38,-1,50,-1,38
1,<environment.Job instance at 0x7f50c4f40050>,38,28,[3 8],39,-1,67,-1,39
1,<environment.Job instance at 0x7f50c4f400a0>,39,16,[ 5 10],40,-1,56,-1,40
1,<environment.Job instance at 0x7f50c5c60e60>,41,2,[8 4],42,-1,44,-1,42
1,<environment.Job instance at 0x7f50c57300a0>,42,2,[10  2],43,-1,45,-1,43
1,<environment.Job instance at 0x7f50c57305a0>,43,23,[5 7],44,-1,67,-1,44
1,<environment.Job instance at 0x7f50c5730460>,44,28,[8 5],45,-1,73,-1,45
1,<environment.Job instance at 0x7f50c5c8b410>,46,23,[3 7],47,-1,70,-1,47
1,<environment.Job instance at 0x7f50c5c5dcd0>,47,24,[2 9],48,-1,72,-1,48
1,<environment.Job instance at 0x7f50c5c5d0f0>,48,17,[8 1],49,-1,66,-1,49
1,<environment.Job instance at 0x7f50c5c5fc80>,49,22,[5 3],50,-1,72,-1,50
1,<environment.Job instance at 0x7f50c4ca0be0>,50,15,[7 4],51,-1,66,-1,51
1,<environment.Job instance at 0x7f50c5c921e0>,53,12,[ 4 13],54,-1,66,-1,54
1,<environment.Job instance at 0x7f50c5c92b40>,54,20,[1 9],55,-1,79,-1,59
1,<environment.Job instance at 0x7f50c5c7b5a0>,57,20,[ 5 12],58,-1,79,-1,59
1,<environment.Job instance at 0x7f50c5c7b320>,61,16,[5 8],62,-1,78,-1,62
1,<environment.Job instance at 0x7f50c5c7e5a0>,64,13,[8 2],65,-1,78,-1,65
1,<environment.Job instance at 0x7f50c5c4de60>,65,12,[9 1],66,-1,78,-1,66
1,<environment.Job instance at 0x7f50c5c4d050>,67,17,[ 3 10],68,-1,85,-1,68
1,<environment.Job instance at 0x7f50c5714960>,63,26,[6 4],64,-1,97,-1,71
1,<environment.Job instance at 0x7f50c5c4ec80>,89,15,[3 9],90,-1,151,-1,136
1,<environment.Job instance at 0x7f50c5c83dc0>,81,27,[7 5],82,-1,494,-1,467
1,<environment.Job instance at 0x7f50c5c5baf0>,106,26,[8 5],107,-1,493,-1,467
1,<environment.Job instance at 0x7f50c4f750f0>,135,3,[5 7],136,-1,470,-1,467
1,<environment.Job instance at 0x7f50c4f75280>,137,15,[1 9],138,-1,482,-1,467
1,<environment.Job instance at 0x7f50c4f562d0>,111,26,[ 5 11],112,-1,496,-1,470
1,<environment.Job instance at 0x7f50c4f75230>,138,21,[5 3],139,-1,491,-1,470
1,<environment.Job instance at 0x7f50c4f63be0>,139,2,[6 5],140,-1,472,-1,470
1,<environment.Job instance at 0x7f50c4f63690>,141,3,[2 7],142,-1,474,-1,471
1,<environment.Job instance at 0x7f50c4f75780>,136,13,[5 1],137,-1,484,-1,471
1,<environment.Job instance at 0x7f50c4f63c80>,143,24,[10  4],144,-1,497,-1,473
1,<environment.Job instance at 0x7f50c5c4db90>,66,24,[10  1],67,-1,497,-1,473
1,<environment.Job instance at 0x7f50c4f63460>,145,2,[6 3],146,-1,476,-1,474
1,<environment.Job instance at 0x7f50c4f63d20>,144,3,[10  3],145,-1,478,-1,475
1,<environment.Job instance at 0x7f50c5c83410>,78,18,[12  4],79,-1,493,-1,475
1,<environment.Job instance at 0x7f50c5bd6640>,26,14,[14  5],27,-1,79,-1,65
1,<environment.Job instance at 0x7f50c5bd2a50>,33,23,[5 6],34,-1,134,-1,111
1,<environment.Job instance at 0x7f50c5bd2eb0>,38,28,[3 8],39,-1,153,-1,125
1,<environment.Job instance at 0x7f50c5bb4870>,44,28,[8 5],45,-1,174,-1,146
1,<environment.Job instance at 0x7f50c5bd5b40>,43,23,[5 7],44,-1,171,-1,148
1,<environment.Job instance at 0x7f50c5bb4910>,47,24,[2 9],48,-1,172,-1,148
1,<environment.Job instance at 0x7f50c5bb4780>,46,23,[3 7],47,-1,171,-1,148
1,<environment.Job instance at 0x7f50c5bd7280>,52,23,[13  5],53,-1,171,-1,148
1,<environment.Job instance at 0x7f50c5bd72d0>,53,12,[ 4 13],54,-1,160,-1,148
1,<environment.Job instance at 0x7f50c5bd70a0>,57,20,[ 5 12],58,-1,184,-1,164
1,<environment.Job instance at 0x7f50c4c736e0>,63,26,[6 4],64,-1,205,-1,179
1,<environment.Job instance at 0x7f50c4bcdb90>,66,24,[10  1],67,-1,216,-1,192
1,<environment.Job instance at 0x7f50c65056e0>,73,17,[11  1],74,-1,212,-1,195
1,<environment.Job instance at 0x7f50c6505690>,75,16,[ 4 13],76,-1,223,-1,207
1,<environment.Job instance at 0x7f50c6505640>,76,26,[8 4],77,-1,233,-1,207
1,<environment.Job instance at 0x7f50c5bb2fa0>,78,18,[12  4],79,-1,225,-1,207
1,<environment.Job instance at 0x7f50c6517780>,81,27,[7 5],82,-1,252,-1,225
1,<environment.Job instance at 0x7f50c4c7bd70>,87,15,[11  5],88,-1,253,-1,238
1,<environment.Job instance at 0x7f50c6522320>,91,3,[12  3],92,-1,254,-1,251
1,<environment.Job instance at 0x7f50c6522370>,92,3,[14  3],93,-1,254,-1,251
1,<environment.Job instance at 0x7f50c5f66c30>,96,25,[6 1],97,-1,283,-1,258
1,<environment.Job instance at 0x7f50c4c489b0>,101,18,[ 3 12],102,-1,286,-1,268
1,<environment.Job instance at 0x7f50c5b24690>,106,26,[8 5],107,-1,326,-1,300
1,<environment.Job instance at 0x7f50c5aa6320>,110,27,[7 2],111,-1,339,-1,312
1,<environment.Job instance at 0x7f50c5aa6d70>,111,26,[ 5 11],112,-1,338,-1,312
1,<environment.Job instance at 0x7f50c5aae690>,115,15,[ 5 13],116,-1,328,-1,313
1,<environment.Job instance at 0x7f50c4c6d910>,118,12,[12  3],119,-1,339,-1,327
1,<environment.Job instance at 0x7f50c5f8c0f0>,125,12,[14  1],126,-1,355,-1,343
1,<environment.Job instance at 0x7f50c5f8c370>,127,16,[ 2 12],128,-1,359,-1,343
1,<environment.Job instance at 0x7f50c561d230>,129,2,[ 1 11],130,-1,358,-1,356
1,<environment.Job instance at 0x7f50c5abcbe0>,143,24,[10  4],144,-1,409,-1,385
1,<environment.Job instance at 0x7f50c5abbdc0>,147,2,[ 3 11],148,-1,390,-1,388
1,<environment.Job instance at 0x7f50c4df5b40>,2,17,[7 2],3,-1,20,-1,3
1,<environment.Job instance at 0x7f50c4df5f50>,5,17,[6 3],6,-1,23,-1,6
1,<environment.Job instance at 0x7f50c4df5730>,6,12,[ 4 10],7,-1,19,-1,7
1,<environment.Job instance at 0x7f50c4df5af0>,7,14,[9 4],8,-1,22,-1,8
1,<environment.Job instance at 0x7f50c4df5a00>,8,18,[8 3],9,-1,27,-1,9
1,<environment.Job instance at 0x7f50c4df5690>,9,16,[ 4 10],10,-1,26,-1,10
1,<environment.Job instance at 0x7f50c573a2d0>,12,18,[3 8],13,-1,31,-1,13
1,<environment.Job instance at 0x7f50c573a910>,15,25,[8 3],16,-1,41,-1,16
1,<environment.Job instance at 0x7f50c573ad70>,17,13,[ 5 10],18,-1,31,-1,18
1,<environment.Job instance at 0x7f50c573e410>,26,19,[4 6],27,-1,46,-1,27
1,<environment.Job instance at 0x7f50c5730f50>,27,17,[6 2],28,-1,45,-1,28
1,<environment.Job instance at 0x7f50c57303c0>,29,21,[ 5 10],30,-1,51,-1,30
1,<environment.Job instance at 0x7f50c5736050>,31,18,[1 9],32,-1,50,-1,32
1,<environment.Job instance at 0x7f50c579b3c0>,33,21,[5 5],34,-1,55,-1,34
1,<environment.Job instance at 0x7f50c579b9b0>,38,12,[9 5],39,-1,51,-1,39
1,<environment.Job instance at 0x7f50c579baa0>,40,18,[9 1],41,-1,59,-1,41
1,<environment.Job instance at 0x7f50c579b4b0>,41,12,[7 5],42,-1,54,-1,42
1,<environment.Job instance at 0x7f50c579b5a0>,43,27,[4 6],44,-1,71,-1,44
1,<environment.Job instance at 0x7f50c579b280>,44,14,[3 5],45,-1,59,-1,45
1,<environment.Job instance at 0x7f50c579be60>,45,17,[10  2],46,-1,63,-1,46
1,<environment.Job instance at 0x7f50c579b320>,46,16,[ 5 10],47,-1,63,-1,47
1,<environment.Job instance at 0x7f50c579b190>,48,14,[5 1],49,-1,64,-1,50
1,<environment.Job instance at 0x7f50c57bfe60>,50,3,[ 1 14],51,-1,54,-1,51
1,<environment.Job instance at 0x7f50c579b230>,49,12,[6 2],50,-1,64,-1,52
1,<environment.Job instance at 0x7f50c57bfdc0>,54,1,[ 2 11],55,-1,56,-1,55
1,<environment.Job instance at 0x7f50c57bf910>,55,13,[6 4],56,-1,69,-1,56
1,<environment.Job instance at 0x7f50c57bf2d0>,56,16,[4 8],57,-1,73,-1,57
1,<environment.Job instance at 0x7f50c57bf730>,57,28,[8 2],58,-1,86,-1,58
1,<environment.Job instance at 0x7f50c57bf0f0>,58,22,[5 8],59,-1,81,-1,59
1,<environment.Job instance at 0x7f50c57bff00>,59,15,[8 3],60,-1,76,-1,61
1,<environment.Job instance at 0x7f50c57bfc80>,60,18,[7 4],61,-1,79,-1,61
1,<environment.Job instance at 0x7f50c57bfb90>,61,28,[ 3 10],62,-1,91,-1,63
1,<environment.Job instance at 0x7f50c6443fa0>,65,18,[5 9],66,-1,84,-1,66
1,<environment.Job instance at 0x7f50c6443050>,67,18,[7 1],68,-1,88,-1,70
1,<environment.Job instance at 0x7f50c6443230>,69,17,[6 3],70,-1,87,-1,70
1,<environment.Job instance at 0x7f50c6443e60>,72,14,[10  1],73,-1,96,-1,82
1,<environment.Job instance at 0x7f50c562f870>,84,17,[7 5],85,-1,102,-1,85
1,<environment.Job instance at 0x7f50c562fe60>,86,21,[8 5],87,-1,108,-1,87
1,<environment.Job instance at 0x7f50c562f9b0>,90,26,[6 1],91,-1,117,-1,91
1,<environment.Job instance at 0x7f50c562f0a0>,88,12,[10  2],89,-1,105,-1,93
1,<environment.Job instance at 0x7f50c5445fa0>,99,24,[9 1],100,-1,128,-1,104
1,<environment.Job instance at 0x7f50c5445f50>,95,12,[8 2],96,-1,117,-1,105
1,<environment.Job instance at 0x7f50c6443f00>,77,14,[5 1],78,-1,125,-1,111
1,<environment.Job instance at 0x7f50c4b33140>,111,17,[10  4],112,-1,332,-1,315
1,<environment.Job instance at 0x7f50c56c0910>,140,15,[3 9],141,-1,330,-1,315
1,<environment.Job instance at 0x7f50c4b342d0>,147,28,[4 9],148,-1,343,-1,315
1,<environment.Job instance at 0x7f50c4b34e10>,148,17,[5 5],149,-1,332,-1,315
1,<environment.Job instance at 0x7f50c56f8c30>,15,25,[8 3],16,-1,73,-1,48
1,<environment.Job instance at 0x7f50c570a9b0>,18,12,[ 2 12],19,-1,63,-1,51
1,<environment.Job instance at 0x7f50c63361e0>,43,27,[4 6],44,-1,145,-1,118
1,<environment.Job instance at 0x7f50ceb41dc0>,50,3,[ 1 14],51,-1,152,-1,149
1,<environment.Job instance at 0x7f50c4db5550>,54,1,[ 2 11],55,-1,168,-1,167
1,<environment.Job instance at 0x7f50c4d22370>,57,28,[8 2],58,-1,205,-1,177
1,<environment.Job instance at 0x7f50cf0678c0>,61,28,[ 3 10],62,-1,218,-1,190
1,<environment.Job instance at 0x7f50c6046320>,71,15,[14  2],72,-1,230,-1,215
1,<environment.Job instance at 0x7f50c64dcf50>,81,12,[11  3],82,-1,260,-1,248
1,<environment.Job instance at 0x7f50c5def1e0>,89,28,[3 6],90,-1,297,-1,269
1,<environment.Job instance at 0x7f50c5def870>,90,26,[6 1],91,-1,295,-1,269
1,<environment.Job instance at 0x7f50c4c48a50>,91,2,[ 4 13],92,-1,271,-1,269
1,<environment.Job instance at 0x7f50c5b244b0>,99,24,[9 1],100,-1,326,-1,302
1,<environment.Job instance at 0x7f50c5b24b90>,103,25,[3 7],104,-1,329,-1,304
1,<environment.Job instance at 0x7f50c4bf8f50>,104,13,[ 2 13],105,-1,317,-1,304
1,<environment.Job instance at 0x7f50c4b02e10>,106,20,[12  4],107,-1,324,-1,304
1,<environment.Job instance at 0x7f50c4d53eb0>,110,15,[13  3],111,-1,331,-1,316
1,<environment.Job instance at 0x7f50c5843140>,115,26,[7 2],116,-1,372,-1,346
1,<environment.Job instance at 0x7f50c64572d0>,118,15,[13  1],119,-1,361,-1,346
1,<environment.Job instance at 0x7f50c5142aa0>,119,25,[9 3],120,-1,384,-1,359
1,<environment.Job instance at 0x7f50c5ce8820>,132,28,[9 5],133,-1,438,-1,410
1,<environment.Job instance at 0x7f50c51c69b0>,147,28,[4 9],148,-1,498,-1,470
1,<environment.Job instance at 0x7f50c56cfd20>,0,16,[7 5],1,-1,17,-1,1
1,<environment.Job instance at 0x7f50cea47820>,3,17,[3 7],4,-1,21,-1,4
1,<environment.Job instance at 0x7f50cea47910>,5,18,[ 5 11],6,-1,26,-1,8
1,<environment.Job instance at 0x7f50cea47be0>,9,17,[10  4],10,-1,27,-1,10
1,<environment.Job instance at 0x7f50cea47410>,13,17,[ 5 13],14,-1,31,-1,14
1,<environment.Job instance at 0x7f50c5ebb2d0>,23,18,[2 9],24,-1,43,-1,25
1,<environment.Job instance at 0x7f50c5035d20>,25,13,[8 2],26,-1,39,-1,26
1,<environment.Job instance at 0x7f50c5035cd0>,27,17,[7 5],28,-1,45,-1,28
1,<environment.Job instance at 0x7f50c50351e0>,28,24,[10  5],29,-1,53,-1,29
1,<environment.Job instance at 0x7f50c5035960>,29,15,[3 5],30,-1,45,-1,30
1,<environment.Job instance at 0x7f50c5035780>,33,19,[5 5],34,-1,53,-1,34
1,<environment.Job instance at 0x7f50c5035140>,34,16,[1 7],35,-1,51,-1,35
1,<environment.Job instance at 0x7f50c50354b0>,36,14,[2 9],37,-1,51,-1,37
1,<environment.Job instance at 0x7f50c4b84c30>,38,15,[4 7],39,-1,54,-1,39
1,<environment.Job instance at 0x7f50c4b84960>,40,17,[9 5],41,-1,58,-1,41
1,<environment.Job instance at 0x7f50c4b84870>,41,14,[5 4],42,-1,56,-1,42
1,<environment.Job instance at 0x7f50c4b84370>,42,12,[1 5],43,-1,55,-1,43
1,<environment.Job instance at 0x7f50c5d78af0>,43,20,[1 7],44,-1,64,-1,44
1,<environment.Job instance at 0x7f50c5d78550>,44,14,[9 2],45,-1,59,-1,45
1,<environment.Job instance at 0x7f50c5d787d0>,47,15,[3 7],48,-1,63,-1,48
1,<environment.Job instance at 0x7f50c5d785f0>,51,16,[9 2],52,-1,68,-1,52
1,<environment.Job instance at 0x7f50c5d780a0>,52,14,[2 8],53,-1,67,-1,53
1,<environment.Job instance at 0x7f50c5d78870>,55,16,[7 4],56,-1,72,-1,56
1,<environment.Job instance at 0x7f50c5ebb1e0>,24,24,[ 3 10],25,-1,84,-1,60
1,<environment.Job instance at 0x7f50c53080a0>,68,26,[5 7],69,-1,101,-1,75
1,<environment.Job instance at 0x7f50c5308050>,69,28,[ 4 10],70,-1,103,-1,75
1,<environment.Job instance at 0x7f50c5308320>,73,13,[9 5],74,-1,90,-1,77
1,<environment.Job instance at 0x7f50c5c270f0>,74,16,[14  4],75,-1,93,-1,77
1,<environment.Job instance at 0x7f50c5c27d70>,75,23,[ 3 10],76,-1,100,-1,77
1,<environment.Job instance at 0x7f50c5c27550>,76,17,[9 2],77,-1,94,-1,77
1,<environment.Job instance at 0x7f50c5d781e0>,49,26,[10  1],50,-1,103,-1,77
1,<environment.Job instance at 0x7f50c5c27500>,77,12,[6 5],78,-1,90,-1,78
1,<environment.Job instance at 0x7f50c5c27be0>,80,18,[5 7],81,-1,99,-1,81
1,<environment.Job instance at 0x7f50c50ef5a0>,82,14,[5 8],83,-1,97,-1,83
1,<environment.Job instance at 0x7f50c5e4bbe0>,84,12,[ 2 10],85,-1,97,-1,85
1,<environment.Job instance at 0x7f50c5e4be60>,87,18,[10  1],88,-1,108,-1,90
1,<environment.Job instance at 0x7f50c5e4b280>,88,14,[9 1],89,-1,104,-1,90
1,<environment.Job instance at 0x7f50c5e4bc30>,89,17,[2 7],90,-1,110,-1,93
1,<environment.Job instance at 0x7f50c5e4b780>,90,23,[7 1],91,-1,116,-1,93
1,<environment.Job instance at 0x7f50c5e4b640>,91,17,[1 7],92,-1,110,-1,93
1,<environment.Job instance at 0x7f50cea471e0>,15,15,[3 5],16,-1,111,-1,96
1,<environment.Job instance at 0x7f50c4ca0140>,95,21,[5 2],96,-1,117,-1,96
1,<environment.Job instance at 0x7f50c56ea320>,97,13,[6 5],98,-1,112,-1,99
1,<environment.Job instance at 0x7f50cea5c280>,103,18,[5 9],104,-1,129,-1,111
1,<environment.Job instance at 0x7f50cea5c410>,98,14,[3 9],99,-1,125,-1,111
1,<environment.Job instance at 0x7f50cea5cf50>,105,14,[ 2 10],106,-1,125,-1,111
1,<environment.Job instance at 0x7f50cea5c820>,107,18,[3 5],108,-1,129,-1,111
1,<environment.Job instance at 0x7f50cea5cb90>,106,12,[5 5],107,-1,125,-1,113
1,<environment.Job instance at 0x7f50c52bcdc0>,112,18,[10  5],113,-1,131,-1,113
1,<environment.Job instance at 0x7f50c4b0c410>,108,27,[1 8],109,-1,140,-1,113
1,<environment.Job instance at 0x7f50c5ccef00>,113,17,[5 5],114,-1,131,-1,114
1,<environment.Job instance at 0x7f50c5f38500>,115,13,[5 5],116,-1,133,-1,120
1,<environment.Job instance at 0x7f50c4e721e0>,118,18,[2 5],119,-1,138,-1,120
1,<environment.Job instance at 0x7f50c4b23870>,116,13,[4 6],117,-1,133,-1,120
1,<environment.Job instance at 0x7f50c6193e10>,121,17,[1 5],122,-1,146,-1,129
1,<environment.Job instance at 0x7f50c5b6ebe0>,122,2,[13  4],123,-1,131,-1,129
1,<environment.Job instance at 0x7f50c5ce23c0>,124,14,[12  1],125,-1,143,-1,129
1,<environment.Job instance at 0x7f50cea5cc30>,101,13,[ 1 12],102,-1,142,-1,129
1,<environment.Job instance at 0x7f50c5ce2f50>,123,14,[5 2],124,-1,143,-1,129
1,<environment.Job instance at 0x7f50c50971e0>,127,15,[10  3],128,-1,144,-1,129
1,<environment.Job instance at 0x7f50c5beb0a0>,129,16,[9 2],130,-1,146,-1,130
1,<environment.Job instance at 0x7f50c640e4b0>,128,3,[ 3 14],129,-1,134,-1,131
1,<environment.Job instance at 0x7f50c6325aa0>,131,14,[ 2 10],132,-1,146,-1,132
1,<environment.Job instance at 0x7f50c6325410>,132,21,[2 7],133,-1,154,-1,133
1,<environment.Job instance at 0x7f50c6325550>,133,14,[5 6],134,-1,149,-1,135
1,<environment.Job instance at 0x7f50c6325a00>,134,17,[9 4],135,-1,152,-1,135
1,<environment.Job instance at 0x7f50c5308f50>,63,15,[7 1],64,-1,159,-1,144
1,<environment.Job instance at 0x7f50c582d820>,138,13,[5 6],139,-1,159,-1,146
1,<environment.Job instance at 0x7f50c582d410>,139,14,[10  4],140,-1,160,-1,146
1,<environment.Job instance at 0x7f50c59b6eb0>,140,16,[5 4],141,-1,162,-1,146
1,<environment.Job instance at 0x7f50c5fb29b0>,147,14,[3 9],148,-1,162,-1,148
1,<environment.Job instance at 0x7f50c62978c0>,148,15,[8 3],149,-1,165,-1,150
1,<environment.Job instance at 0x7f50c5d78a50>,57,16,[13  3],58,-1,2217,-1,2201
1,<environment.Job instance at 0x7f50cea47c30>,5,18,[ 5 11],6,-1,24,-1,6
1,<environment.Job instance at 0x7f50c5308cd0>,11,26,[3 8],12,-1,45,-1,19
1,<environment.Job instance at 0x7f50c5c27960>,13,17,[ 5 13],14,-1,36,-1,19
1,<environment.Job instance at 0x7f50c5ce2320>,19,2,[ 1 14],20,-1,25,-1,23
1,<environment.Job instance at 0x7f50c5d765a0>,24,24,[ 3 10],25,-1,58,-1,34
1,<environment.Job instance at 0x7f50c56cfb90>,28,24,[10  5],29,-1,71,-1,47
1,<environment.Job instance at 0x7f50c4c48280>,45,3,[ 4 13],46,-1,123,-1,120
1,<environment.Job instance at 0x7f50c4c48230>,46,28,[2 6],47,-1,148,-1,120
1,<environment.Job instance at 0x7f50c4c489b0>,49,26,[10  1],50,-1,154,-1,128
1,<environment.Job instance at 0x7f50c5ab56e0>,57,16,[13  3],58,-1,172,-1,156
1,<environment.Job instance at 0x7f50c4b2df00>,68,26,[5 7],69,-1,231,-1,205
1,<environment.Job instance at 0x7f50c5f2c230>,69,28,[ 4 10],70,-1,233,-1,205
1,<environment.Job instance at 0x7f50c4db52d0>,72,2,[ 4 11],73,-1,209,-1,207
1,<environment.Job instance at 0x7f50c4d31b40>,74,16,[14  4],75,-1,225,-1,209
1,<environment.Job instance at 0x7f50c4d31190>,75,23,[ 3 10],76,-1,235,-1,212
1,<environment.Job instance at 0x7f50c63c9370>,90,23,[7 1],91,-1,301,-1,278
1,<environment.Job instance at 0x7f50c5b440f0>,101,13,[ 1 12],102,-1,325,-1,312
1,<environment.Job instance at 0x7f50c4d8e140>,108,27,[1 8],109,-1,368,-1,341
1,<environment.Job instance at 0x7f50c5a29320>,109,3,[ 5 12],110,-1,344,-1,341
1,<environment.Job instance at 0x7f50c5a29eb0>,110,2,[ 5 14],111,-1,343,-1,341
1,<environment.Job instance at 0x7f50c4b20d20>,122,2,[13  4],123,-1,399,-1,397
1,<environment.Job instance at 0x7f50c4b20fa0>,124,14,[12  1],125,-1,414,-1,400
1,<environment.Job instance at 0x7f50c611b190>,128,3,[ 3 14],129,-1,409,-1,406
1,<environment.Job instance at 0x7f50c4c35280>,130,3,[13  3],131,-1,417,-1,414
1,<environment.Job instance at 0x7f50c5b23690>,135,2,[13  4],136,-1,434,-1,432
1,<environment.Job instance at 0x7f50c5b232d0>,136,24,[7 1],137,-1,472,-1,448
1,<environment.Job instance at 0x7fbd484406e0>,0,13,[9 3],1,-1,15,-1,2
1,<environment.Job instance at 0x7fbd484408c0>,1,22,[11  3],2,-1,24,-1,2
1,<environment.Job instance at 0x7fbd48440730>,2,22,[4 8],3,-1,25,-1,3
1,<environment.Job instance at 0x7fbd3ee50fa0>,9,18,[11  5],10,-1,28,-1,10
1,<environment.Job instance at 0x7fbd3ee530f0>,11,15,[4 8],12,-1,27,-1,12
1,<environment.Job instance at 0x7fbd3ee53320>,12,26,[ 1 10],13,-1,39,-1,13
1,<environment.Job instance at 0x7fbd3ee53230>,13,18,[ 4 10],14,-1,32,-1,14
1,<environment.Job instance at 0x7fbd3ee53460>,15,18,[2 8],16,-1,34,-1,16
1,<environment.Job instance at 0x7fbd3ee53640>,16,16,[3 5],17,-1,33,-1,17
1,<environment.Job instance at 0x7fbd3ee53b90>,23,27,[1 6],24,-1,51,-1,24
1,<environment.Job instance at 0x7fbd3ee53d20>,24,18,[2 6],25,-1,43,-1,25
1,<environment.Job instance at 0x7fbd3ee53d70>,25,12,[ 5 10],26,-1,38,-1,26
1,<environment.Job instance at 0x7fbd3ee53fa0>,27,15,[8 4],28,-1,43,-1,28
1,<environment.Job instance at 0x7fbd3ee56140>,28,23,[10  4],29,-1,52,-1,29
1,<environment.Job instance at 0x7fbd3ee56410>,31,14,[2 5],32,-1,46,-1,32
1,<environment.Job instance at 0x7fbd3ee56460>,33,14,[5 5],34,-1,48,-1,34
1,<environment.Job instance at 0x7fbd3ee56730>,34,24,[1 8],35,-1,59,-1,35
1,<environment.Job instance at 0x7fbd3ee56690>,35,15,[9 5],36,-1,51,-1,36
1,<environment.Job instance at 0x7fbd3ee56c80>,40,15,[10  3],41,-1,59,-1,44
1,<environment.Job instance at 0x7fbd3ee56e60>,43,18,[5 5],44,-1,63,-1,45
1,<environment.Job instance at 0x7fbd3ee58140>,48,15,[10  1],49,-1,66,-1,51
1,<environment.Job instance at 0x7fbd3ee58550>,50,16,[12  2],51,-1,67,-1,51
1,<environment.Job instance at 0x7fbd3ee589b0>,53,17,[5 7],54,-1,71,-1,54
1,<environment.Job instance at 0x7fbd3ee58be0>,56,17,[8 5],57,-1,75,-1,58
1,<environment.Job instance at 0x7fbd3ee58af0>,58,14,[2 7],59,-1,73,-1,59
1,<environment.Job instance at 0x7fbd3ee58e60>,59,17,[1 6],60,-1,77,-1,60
1,<environment.Job instance at 0x7fbd3ee5c140>,62,22,[6 4],63,-1,85,-1,63
1,<environment.Job instance at 0x7fbd3ee5c190>,64,18,[2 9],65,-1,83,-1,65
1,<environment.Job instance at 0x7fbd3ee5c4b0>,65,20,[2 6],66,-1,86,-1,66
1,<environment.Job instance at 0x7fbd3ee5c5a0>,67,27,[ 1 10],68,-1,95,-1,68
1,<environment.Job instance at 0x7fbd3ee58c80>,57,18,[2 8],58,-1,88,-1,70
1,<environment.Job instance at 0x7fbd3ee5e320>,81,15,[5 9],82,-1,97,-1,82
1,<environment.Job instance at 0x7fbd3ee5e5a0>,82,16,[ 4 10],83,-1,99,-1,83
1,<environment.Job instance at 0x7fbd3ee5e460>,83,20,[7 1],84,-1,106,-1,86
1,<environment.Job instance at 0x7fbd3ee5e6e0>,85,17,[3 9],86,-1,103,-1,86
1,<environment.Job instance at 0x7fbd3ee5e870>,86,18,[9 2],87,-1,108,-1,90
1,<environment.Job instance at 0x7fbd3ee5eaf0>,89,14,[5 3],90,-1,118,-1,104
1,<environment.Job instance at 0x7fbd3ee612d0>,99,18,[12  5],100,-1,290,-1,272
1,<environment.Job instance at 0x7fbd3ee53730>,1,22,[11  3],2,-1,24,-1,2
1,<environment.Job instance at 0x7fbd3ee58690>,9,18,[11  5],10,-1,32,-1,14
1,<environment.Job instance at 0x7fbd3ee5c0a0>,12,26,[ 1 10],13,-1,82,-1,56
1,<environment.Job instance at 0x7fbd3ef73a00>,23,27,[1 6],24,-1,87,-1,60
1,<environment.Job instance at 0x7fbd3ef000a0>,28,23,[10  4],29,-1,97,-1,74
1,<environment.Job instance at 0x7fbd3eeff7d0>,34,24,[1 8],35,-1,117,-1,93
1,<environment.Job instance at 0x7fbd3eefea50>,36,13,[ 3 14],37,-1,106,-1,93
1,<environment.Job instance at 0x7fbd3eea9410>,46,17,[12  2],47,-1,134,-1,117
1,<environment.Job instance at 0x7fbd3ee508c0>,50,16,[12  2],51,-1,146,-1,130
1,<environment.Job instance at 0x7fbd3ee442d0>,54,13,[13  1],55,-1,158,-1,145
1,<environment.Job instance at 0x7fbd3ee40820>,60,3,[12  3],61,-1,169,-1,166
1,<environment.Job instance at 0x7fbd3ee616e0>,67,27,[ 1 10],68,-1,216,-1,189
1,<environment.Job instance at 0x7fbd3ee61870>,69,13,[ 3 12],70,-1,202,-1,189
1,<environment.Job instance at 0x7fbd3ee61b40>,75,14,[ 4 11],76,-1,215,-1,201
1,<environment.Job instance at 0x7fbd3ededb90>,97,2,[ 5 11],98,-1,294,-1,292
1,<environment.Job instance at 0x7fbd3ededcd0>,99,18,[12  5],100,-1,312,-1,294
1,<environment.Job instance at 0x7fbd3edef230>,105,14,[14  5],106,-1,341,-1,327
1,<environment.Job instance at 0x7fbd3edef050>,106,15,[11  1],107,-1,342,-1,327
1,<environment.Job instance at 0x7fbd3edefaf0>,116,3,[ 1 12],117,-1,363,-1,360
1,<environment.Job instance at 0x7fbd3edef730>,111,26,[ 5 10],112,-1,396,-1,370
1,<environment.Job instance at 0x7fbd3edeff50>,122,3,[ 4 12],123,-1,377,-1,374
1,<environment.Job instance at 0x7fbd3edefe10>,123,12,[ 4 11],124,-1,386,-1,374
1,<environment.Job instance at 0x7fbd3edf2280>,128,23,[ 2 14],129,-1,419,-1,396
1,<environment.Job instance at 0x7fbd3edf2960>,138,16,[11  2],139,-1,447,-1,431
1,<environment.Job instance at 0x7fbd3edf2a00>,139,18,[ 1 12],140,-1,449,-1,431
1,<environment.Job instance at 0x7fbd3edf2c80>,143,15,[ 1 12],144,-1,466,-1,451
1,<environment.Job instance at 0x7fbd3edf2f50>,145,3,[ 4 13],146,-1,455,-1,452
1,<environment.Job instance at 0x7fbd3edf2fa0>,147,1,[ 1 14],148,-1,455,-1,454
1,<environment.Job instance at 0x7fbd3e82e9b0>,8,19,[6 4],9,-1,28,-1,9
1,<environment.Job instance at 0x7fbd3e830370>,13,18,[6 5],14,-1,32,-1,14
1,<environment.Job instance at 0x7fbd3e8303c0>,15,16,[ 2 10],16,-1,32,-1,16
1,<environment.Job instance at 0x7fbd3e829780>,17,21,[ 3 10],18,-1,39,-1,18
1,<environment.Job instance at 0x7fbd3e82db40>,21,13,[8 5],22,-1,36,-1,23
1,<environment.Job instance at 0x7fbd3e8bb370>,28,21,[9 4],29,-1,50,-1,29
1,<environment.Job instance at 0x7fbd3e82dc80>,22,14,[2 9],23,-1,43,-1,29
1,<environment.Job instance at 0x7fbd3e8bb3c0>,30,18,[10  3],31,-1,50,-1,32
1,<environment.Job instance at 0x7fbd3e8bbb40>,31,17,[10  2],32,-1,49,-1,32
1,<environment.Job instance at 0x7fbd3e8c0820>,36,14,[5 5],37,-1,55,-1,41
1,<environment.Job instance at 0x7fbd3e8c0910>,40,13,[10  5],41,-1,55,-1,42
1,<environment.Job instance at 0x7fbd3e8c5500>,43,14,[7 5],44,-1,58,-1,44
1,<environment.Job instance at 0x7fbd3e8c5190>,45,14,[10  2],46,-1,60,-1,46
1,<environment.Job instance at 0x7fbd3e8c0e10>,42,14,[2 7],43,-1,69,-1,55
1,<environment.Job instance at 0x7fbd3e4716e0>,54,16,[7 2],55,-1,78,-1,62
1,<environment.Job instance at 0x7fbd3e3eb1e0>,64,16,[9 4],65,-1,81,-1,65
1,<environment.Job instance at 0x7fbd3e8730f0>,66,14,[10  1],67,-1,82,-1,68
1,<environment.Job instance at 0x7fbd3e431e60>,63,14,[11  3],64,-1,82,-1,68
1,<environment.Job instance at 0x7fbd3e403be0>,67,16,[9 2],68,-1,88,-1,72
1,<environment.Job instance at 0x7fbd3e403b40>,69,13,[6 3],70,-1,85,-1,72
1,<environment.Job instance at 0x7fbd3e403780>,68,15,[7 5],69,-1,88,-1,73
1,<environment.Job instance at 0x7fbd3e4030a0>,72,20,[1 7],73,-1,93,-1,73
1,<environment.Job instance at 0x7fbd3e3fdb40>,76,19,[2 7],77,-1,96,-1,77
1,<environment.Job instance at 0x7fbd3e3ffdc0>,78,18,[6 3],79,-1,99,-1,81
1,<environment.Job instance at 0x7fbd3e3ff460>,80,24,[ 1 10],81,-1,105,-1,81
1,<environment.Job instance at 0x7fbd3e3ff8c0>,83,24,[7 4],84,-1,109,-1,85
1,<environment.Job instance at 0x7fbd3e402820>,86,16,[7 4],87,-1,106,-1,90
1,<environment.Job instance at 0x7fbd3e4022d0>,88,18,[4 6],89,-1,108,-1,90
1,<environment.Job instance at 0x7fbd484e0e60>,91,27,[4 7],92,-1,119,-1,92
1,<environment.Job instance at 0x7fbd3e402dc0>,92,26,[8 4],93,-1,119,-1,93
1,<environment.Job instance at 0x7fbd3e3ff230>,84,16,[7 5],85,-1,110,-1,94
1,<environment.Job instance at 0x7fbd3e8c09b0>,38,12,[14  4],39,-1,109,-1,97
1,<environment.Job instance at 0x7fbd3e530a50>,97,17,[5 2],98,-1,115,-1,98
1,<environment.Job instance at 0x7fbd3e611230>,61,18,[2 8],62,-1,117,-1,99
1,<environment.Job instance at 0x7fbd3e530c30>,98,18,[4 5],99,-1,117,-1,99
1,<environment.Job instance at 0x7fbd3e400f00>,100,25,[ 3 10],101,-1,126,-1,101
1,<environment.Job instance at 0x7fbd3e400960>,104,12,[7 2],105,-1,120,-1,108
1,<environment.Job instance at 0x7fbd3e590e60>,108,15,[3 6],109,-1,124,-1,109
1,<environment.Job instance at 0x7fbd3e4006e0>,105,2,[1 5],106,-1,112,-1,110
1,<environment.Job instance at 0x7fbd3e488aa0>,95,16,[14  1],96,-1,127,-1,111
1,<environment.Job instance at 0x7fbd3e400af0>,110,17,[2 6],111,-1,128,-1,111
1,<environment.Job instance at 0x7fbd3e400b90>,111,15,[8 4],112,-1,127,-1,112
1,<environment.Job instance at 0x7fbd3e474140>,113,23,[10  1],114,-1,137,-1,114
1,<environment.Job instance at 0x7fbd3e534910>,116,28,[6 5],117,-1,145,-1,117
1,<environment.Job instance at 0x7fbd3e401be0>,117,18,[5 9],118,-1,136,-1,118
1,<environment.Job instance at 0x7fbd3e3ea960>,124,15,[10  4],125,-1,140,-1,125
1,<environment.Job instance at 0x7fbd3e529eb0>,125,18,[11  3],126,-1,144,-1,126
1,<environment.Job instance at 0x7fbd3e531320>,128,13,[8 5],129,-1,143,-1,130
1,<environment.Job instance at 0x7fbd3e531640>,129,28,[5 3],130,-1,158,-1,130
1,<environment.Job instance at 0x7fbd3e531280>,130,18,[6 1],131,-1,151,-1,133
1,<environment.Job instance at 0x7fbd3e532be0>,135,17,[4 6],136,-1,153,-1,136
1,<environment.Job instance at 0x7fbd3e5326e0>,137,14,[ 1 10],138,-1,152,-1,138
1,<environment.Job instance at 0x7fbd485b9dc0>,139,16,[9 4],140,-1,156,-1,140
1,<environment.Job instance at 0x7fbd3e66b8c0>,142,25,[6 3],143,-1,168,-1,143
1,<environment.Job instance at 0x7fbd3e531410>,132,18,[8 2],133,-1,161,-1,143
1,<environment.Job instance at 0x7fbd3e66ba00>,144,17,[9 4],145,-1,162,-1,145
1,<environment.Job instance at 0x7fbd3e3e7730>,147,13,[1 9],148,-1,162,-1,149
1,<environment.Job instance at 0x7fbd3e3e78c0>,149,15,[ 5 10],150,-1,165,-1,150
1,<environment.Job instance at 0x7fbd3e3f9c30>,151,14,[8 2],152,-1,166,-1,152
1,<environment.Job instance at 0x7fbd3e3e7dc0>,148,17,[3 6],149,-1,171,-1,154
1,<environment.Job instance at 0x7fbd3e830500>,0,3,[13  3],1,-1,4,-1,1
1,<environment.Job instance at 0x7fbd3e82de60>,5,13,[ 1 14],6,-1,19,-1,6
1,<environment.Job instance at 0x7fbd3e3f9870>,16,2,[11  5],17,-1,19,-1,17
1,<environment.Job instance at 0x7fbd3e400e60>,18,3,[14  4],19,-1,24,-1,21
1,<environment.Job instance at 0x7fbd3edf28c0>,38,12,[14  4],39,-1,93,-1,81
1,<environment.Job instance at 0x7fbd3edf2500>,48,2,[13  1],49,-1,129,-1,127
1,<environment.Job instance at 0x7fbd3edf2050>,51,3,[13  5],52,-1,132,-1,129
1,<environment.Job instance at 0x7fbd3edefd70>,52,2,[ 1 12],53,-1,131,-1,129
1,<environment.Job instance at 0x7fbd3edef730>,62,1,[ 4 13],63,-1,152,-1,151
1,<environment.Job instance at 0x7fbd3edef5f0>,63,14,[11  3],64,-1,165,-1,151
1,<environment.Job instance at 0x7fbd3eded690>,80,24,[ 1 10],81,-1,239,-1,215
1,<environment.Job instance at 0x7fbd3eded460>,83,24,[7 4],84,-1,253,-1,229
1,<environment.Job instance at 0x7fbd3eded230>,85,3,[12  3],86,-1,232,-1,229
1,<environment.Job instance at 0x7fbd3e5924b0>,91,27,[4 7],92,-1,278,-1,251
1,<environment.Job instance at 0x7fbd3e5fcfa0>,92,26,[8 4],93,-1,277,-1,251
1,<environment.Job instance at 0x7fbd3e601c30>,95,16,[14  1],96,-1,269,-1,253
1,<environment.Job instance at 0x7fbd3e5ed0f0>,100,25,[ 3 10],101,-1,310,-1,285
1,<environment.Job instance at 0x7fbd3e7e6780>,113,23,[10  1],114,-1,350,-1,327
1,<environment.Job instance at 0x7fbd3e73a550>,116,28,[6 5],117,-1,355,-1,327
1,<environment.Job instance at 0x7fbd3e658c30>,121,15,[14  1],122,-1,347,-1,332
1,<environment.Job instance at 0x7fbd3e637050>,125,18,[11  3],126,-1,365,-1,347
1,<environment.Job instance at 0x7fbd3e5e58c0>,129,28,[5 3],130,-1,390,-1,362
1,<environment.Job instance at 0x7fbd3e604410>,142,25,[6 3],143,-1,440,-1,415
1,<environment.Job instance at 0x7fbd3e532e60>,6,15,[2 7],7,-1,22,-1,7
1,<environment.Job instance at 0x7fbd3e5323c0>,8,15,[7 5],9,-1,24,-1,9
1,<environment.Job instance at 0x7fbd3e5324b0>,9,15,[ 3 10],10,-1,25,-1,10
1,<environment.Job instance at 0x7fbd3e532fa0>,10,24,[2 8],11,-1,35,-1,11
1,<environment.Job instance at 0x7fbd3e5325f0>,11,24,[9 1],12,-1,36,-1,12
1,<environment.Job instance at 0x7fbd3e5321e0>,13,24,[10  5],14,-1,38,-1,14
1,<environment.Job instance at 0x7fbd3e532730>,16,16,[ 5 10],17,-1,33,-1,17
1,<environment.Job instance at 0x7fbd3e590460>,21,17,[10  3],22,-1,40,-1,23
1,<environment.Job instance at 0x7fbd3e590eb0>,26,1,[2 6],27,-1,28,-1,27
1,<environment.Job instance at 0x7fbd3e5909b0>,27,15,[ 3 12],28,-1,43,-1,28
1,<environment.Job instance at 0x7fbd3e5900f0>,28,2,[5 7],29,-1,31,-1,29
1,<environment.Job instance at 0x7fbd3e5905f0>,29,16,[5 4],30,-1,46,-1,30
1,<environment.Job instance at 0x7fbd3e590320>,30,14,[8 3],31,-1,45,-1,31
1,<environment.Job instance at 0x7fbd3e590280>,31,2,[6 3],32,-1,34,-1,32
1,<environment.Job instance at 0x7fbd3e590780>,32,12,[8 1],33,-1,45,-1,33
1,<environment.Job instance at 0x7fbd3e5312d0>,34,18,[3 6],35,-1,53,-1,35
1,<environment.Job instance at 0x7fbd3e531a50>,36,16,[9 2],37,-1,53,-1,37
1,<environment.Job instance at 0x7fbd3e531050>,37,16,[9 4],38,-1,54,-1,38
1,<environment.Job instance at 0x7fbd3e531780>,41,17,[7 5],42,-1,59,-1,42
1,<environment.Job instance at 0x7fbd3e793640>,46,25,[ 5 10],47,-1,72,-1,47
1,<environment.Job instance at 0x7fbd3e531b90>,42,12,[3 8],43,-1,68,-1,56
1,<environment.Job instance at 0x7fbd3e625780>,60,14,[7 5],61,-1,76,-1,62
1,<environment.Job instance at 0x7fbd3e751f50>,65,16,[10  4],66,-1,83,-1,67
1,<environment.Job instance at 0x7fbd3e751b90>,67,12,[5 8],68,-1,80,-1,68
1,<environment.Job instance at 0x7fbd3e751460>,68,14,[7 5],69,-1,84,-1,70
1,<environment.Job instance at 0x7fbd3e751190>,70,18,[9 5],71,-1,89,-1,71
1,<environment.Job instance at 0x7fbd3e8a2af0>,79,17,[8 1],80,-1,103,-1,86
1,<environment.Job instance at 0x7fbd3e8a2fa0>,76,12,[8 3],77,-1,98,-1,86
1,<environment.Job instance at 0x7fbd3e8a2dc0>,81,17,[2 6],82,-1,104,-1,87
1,<environment.Job instance at 0x7fbd3e8a2c80>,82,19,[8 2],83,-1,106,-1,87
1,<environment.Job instance at 0x7fbd3e531910>,40,27,[ 5 10],41,-1,114,-1,87
1,<environment.Job instance at 0x7fbd3e574230>,88,14,[ 2 10],89,-1,103,-1,89
1,<environment.Job instance at 0x7fbd3e8a2a00>,77,15,[2 9],78,-1,106,-1,91
1,<environment.Job instance at 0x7fbd3e574730>,84,17,[ 5 14],85,-1,108,-1,91
1,<environment.Job instance at 0x7fbd3e5742d0>,89,17,[9 1],90,-1,109,-1,92
1,<environment.Job instance at 0x7fbd3e574f00>,90,18,[3 5],91,-1,116,-1,98
1,<environment.Job instance at 0x7fbd3e4a3140>,98,14,[4 6],99,-1,113,-1,99
1,<environment.Job instance at 0x7fbd3e529190>,99,15,[10  2],100,-1,115,-1,100
1,<environment.Job instance at 0x7fbd3e529f50>,100,13,[5 6],101,-1,114,-1,101
1,<environment.Job instance at 0x7fbd3e529c80>,103,13,[4 9],104,-1,117,-1,104
1,<environment.Job instance at 0x7fbd3e457f50>,110,16,[10  2],111,-1,127,-1,111
1,<environment.Job instance at 0x7fbd3e438fa0>,111,13,[4 5],112,-1,125,-1,112
1,<environment.Job instance at 0x7fbd3e457be0>,114,21,[7 2],115,-1,138,-1,117
1,<environment.Job instance at 0x7fbd3e751820>,74,17,[7 2],75,-1,136,-1,119
1,<environment.Job instance at 0x7fbd3e6fc820>,115,12,[ 1 10],116,-1,133,-1,121
1,<environment.Job instance at 0x7fbd3ebaee10>,121,14,[1 5],122,-1,136,-1,122
1,<environment.Job instance at 0x7fbd3f33a640>,122,14,[ 1 11],123,-1,138,-1,124
1,<environment.Job instance at 0x7fbd485bad20>,118,16,[6 3],119,-1,141,-1,125
1,<environment.Job instance at 0x7fbd3f359f50>,123,14,[2 7],124,-1,144,-1,130
1,<environment.Job instance at 0x7fbd3ec3ce10>,129,27,[1 5],130,-1,157,-1,130
1,<environment.Job instance at 0x7fbd3e40af00>,135,14,[ 5 12],136,-1,150,-1,136
1,<environment.Job instance at 0x7fbd3e592a00>,136,18,[4 6],137,-1,156,-1,138
1,<environment.Job instance at 0x7fbd3e40a500>,137,19,[14  4],138,-1,157,-1,138
1,<environment.Job instance at 0x7fbd3e527fa0>,105,14,[7 4],106,-1,154,-1,140
1,<environment.Job instance at 0x7fbd3e592d70>,138,17,[7 4],139,-1,158,-1,141
1,<environment.Job instance at 0x7fbd3ec368c0>,140,12,[8 5],141,-1,153,-1,141
1,<environment.Job instance at 0x7fbd3e4f5910>,142,18,[6 3],143,-1,164,-1,146
1,<environment.Job instance at 0x7fbd3efcf3c0>,120,18,[4 7],121,-1,168,-1,150
1,<environment.Job instance at 0x7fbd3ebb2eb0>,149,27,[9 3],150,-1,177,-1,150
1,<environment.Job instance at 0x7fbd3ec39be0>,154,17,[8 5],155,-1,176,-1,159
1,<environment.Job instance at 0x7fbd3ec2a190>,146,25,[3 8],147,-1,184,-1,159
1,<environment.Job instance at 0x7fbd3ebd8a50>,150,15,[7 5],151,-1,174,-1,159
1,<environment.Job instance at 0x7fbd3ec74cd0>,158,27,[1 7],159,-1,186,-1,159
1,<environment.Job instance at 0x7fbd3e531dc0>,2,3,[ 3 11],3,-1,6,-1,3
1,<environment.Job instance at 0x7fbd3e751500>,10,24,[2 8],11,-1,42,-1,18
1,<environment.Job instance at 0x7fbd3e8a22d0>,11,24,[9 1],12,-1,42,-1,18
1,<environment.Job instance at 0x7fbd3e5741e0>,13,24,[10  5],14,-1,43,-1,19
1,<environment.Job instance at 0x7fbd3e5740a0>,14,23,[10  2],15,-1,42,-1,19
1,<environment.Job instance at 0x7fbd3e527c80>,15,15,[ 1 11],16,-1,34,-1,19
1,<environment.Job instance at 0x7fbd3e558c80>,27,15,[ 3 12],28,-1,65,-1,50
1,<environment.Job instance at 0x7fbd485b9f00>,40,27,[ 5 10],41,-1,134,-1,107
1,<environment.Job instance at 0x7fbd3e4020f0>,46,25,[ 5 10],47,-1,153,-1,128
1,<environment.Job instance at 0x7fbd3e3e79b0>,62,17,[12  4],63,-1,186,-1,169
1,<environment.Job instance at 0x7fbd3e48c3c0>,75,2,[ 4 11],76,-1,205,-1,203
1,<environment.Job instance at 0x7fbd3e4530f0>,83,2,[ 2 14],84,-1,236,-1,234
1,<environment.Job instance at 0x7fbd3e551780>,84,17,[ 5 14],85,-1,251,-1,234
1,<environment.Job instance at 0x7fbd3e43aaf0>,86,2,[11  3],87,-1,236,-1,234
1,<environment.Job instance at 0x7fbd3e43ab40>,87,2,[12  2],88,-1,236,-1,234
1,<environment.Job instance at 0x7fbd3e462c30>,92,2,[12  5],93,-1,257,-1,255
1,<environment.Job instance at 0x7fbd3e530550>,94,1,[14  4],95,-1,256,-1,255
1,<environment.Job instance at 0x7fbd3e586e60>,113,1,[ 5 12],114,-1,325,-1,324
1,<environment.Job instance at 0x7fbd3e583be0>,122,14,[ 1 11],123,-1,367,-1,353
1,<environment.Job instance at 0x7fbd3e583e60>,124,3,[14  4],125,-1,359,-1,356
1,<environment.Job instance at 0x7fbd3e583c30>,126,2,[13  4],127,-1,369,-1,367
1,<environment.Job instance at 0x7fbd3e583500>,129,27,[1 5],130,-1,399,-1,372
1,<environment.Job instance at 0x7fbd3e583280>,135,14,[ 5 12],136,-1,401,-1,387
1,<environment.Job instance at 0x7fbd3e57d1e0>,137,19,[14  4],138,-1,408,-1,389
1,<environment.Job instance at 0x7fbd3e57d690>,139,14,[ 5 11],140,-1,404,-1,390
1,<environment.Job instance at 0x7fbd3e57d640>,146,25,[3 8],147,-1,449,-1,424
1,<environment.Job instance at 0x7fbd3e57d500>,148,3,[ 5 14],149,-1,427,-1,424
1,<environment.Job instance at 0x7fbd3e57d780>,149,27,[9 3],150,-1,453,-1,426
1,<environment.Job instance at 0x7fbd3e57a4b0>,152,24,[ 3 10],153,-1,454,-1,430
1,<environment.Job instance at 0x7fbd3e57a140>,157,12,[ 2 12],158,-1,453,-1,441
1,<environment.Job instance at 0x7fbd3e57a0f0>,158,27,[1 7],159,-1,470,-1,443
1,<environment.Job instance at 0x7fbd3e5d5690>,0,19,[6 3],1,-1,20,-1,1
1,<environment.Job instance at 0x7fbd3f989140>,4,16,[10  3],5,-1,24,-1,8
1,<environment.Job instance at 0x7fbd3f9890a0>,8,14,[10  3],9,-1,23,-1,9
1,<environment.Job instance at 0x7fbd3f98a870>,9,1,[10  3],10,-1,11,-1,10
1,<environment.Job instance at 0x7fbd3f98a820>,10,19,[1 5],11,-1,30,-1,11
1,<environment.Job instance at 0x7fbd3f98a500>,11,18,[2 9],12,-1,30,-1,12
1,<environment.Job instance at 0x7fbd3f98adc0>,12,18,[10  4],13,-1,31,-1,13
1,<environment.Job instance at 0x7fbd3f98acd0>,13,13,[6 5],14,-1,27,-1,14
1,<environment.Job instance at 0x7fbd3f98ab90>,17,18,[5 1],18,-1,36,-1,18
1,<environment.Job instance at 0x7fbd3f98aeb0>,19,15,[9 5],20,-1,35,-1,20
1,<environment.Job instance at 0x7fbd3f98a320>,21,13,[5 3],22,-1,35,-1,22
1,<environment.Job instance at 0x7fbd3f98a6e0>,22,15,[5 1],23,-1,38,-1,23
1,<environment.Job instance at 0x7fbd3f98a640>,23,18,[5 9],24,-1,42,-1,24
1,<environment.Job instance at 0x7fbd3f98a5f0>,24,12,[6 4],25,-1,37,-1,25
1,<environment.Job instance at 0x7fbd3f98a0f0>,25,21,[2 5],26,-1,47,-1,26
1,<environment.Job instance at 0x7fbd3f96c320>,28,14,[5 9],29,-1,43,-1,29
1,<environment.Job instance at 0x7fbd3f96c0a0>,29,19,[9 1],30,-1,49,-1,30
1,<environment.Job instance at 0x7fbd3f96cc30>,30,12,[2 5],31,-1,43,-1,31
1,<environment.Job instance at 0x7fbd3f989280>,7,13,[6 4],8,-1,44,-1,31
1,<environment.Job instance at 0x7fbd3f96ce60>,31,16,[6 5],32,-1,48,-1,32
1,<environment.Job instance at 0x7fbd3f963cd0>,39,13,[5 9],40,-1,53,-1,40
1,<environment.Job instance at 0x7fbd3f963dc0>,41,18,[8 4],42,-1,60,-1,42
1,<environment.Job instance at 0x7fbd3f963fa0>,44,17,[3 9],45,-1,62,-1,45
1,<environment.Job instance at 0x7fbd3ed6c730>,45,13,[10  4],46,-1,60,-1,47
1,<environment.Job instance at 0x7fbd3ed6c690>,47,22,[1 7],48,-1,70,-1,48
1,<environment.Job instance at 0x7fbd3f24c820>,49,15,[7 1],50,-1,65,-1,50
1,<environment.Job instance at 0x7fbd3f24cb90>,50,14,[6 4],51,-1,65,-1,51
1,<environment.Job instance at 0x7fbd3f24ce60>,51,18,[3 6],52,-1,70,-1,52
1,<environment.Job instance at 0x7fbd3e3b62d0>,52,1,[9 3],53,-1,54,-1,53
1,<environment.Job instance at 0x7fbd3e3b6460>,54,14,[7 1],55,-1,69,-1,55
1,<environment.Job instance at 0x7fbd3e3b65a0>,55,25,[6 3],56,-1,81,-1,56
1,<environment.Job instance at 0x7fbd3e3b64b0>,56,2,[5 1],57,-1,59,-1,57
1,<environment.Job instance at 0x7fbd3e3b6780>,58,16,[8 5],59,-1,75,-1,59
1,<environment.Job instance at 0x7fbd3e3b6960>,59,18,[7 5],60,-1,78,-1,60
1,<environment.Job instance at 0x7fbd3e3b6a00>,61,14,[5 8],62,-1,76,-1,62
1,<environment.Job instance at 0x7fbd3e3b6be0>,62,16,[9 2],63,-1,79,-1,63
1,<environment.Job instance at 0x7fbd3e3b6af0>,63,15,[6 3],64,-1,79,-1,64
1,<environment.Job instance at 0x7fbd3f963f00>,46,16,[5 5],47,-1,80,-1,64
1,<environment.Job instance at 0x7fbd3e7ecb90>,65,18,[7 5],66,-1,84,-1,66
1,<environment.Job instance at 0x7fbd3f295140>,68,17,[10  3],69,-1,87,-1,70
1,<environment.Job instance at 0x7fbd3f295b90>,70,1,[6 3],71,-1,72,-1,71
1,<environment.Job instance at 0x7fbd3f295e10>,71,22,[ 1 10],72,-1,94,-1,72
1,<environment.Job instance at 0x7fbd3f2955f0>,72,18,[5 1],73,-1,91,-1,73
1,<environment.Job instance at 0x7fbd3f295370>,73,2,[5 6],74,-1,76,-1,74
1,<environment.Job instance at 0x7fbd3e5581e0>,69,27,[ 5 10],70,-1,102,-1,75
1,<environment.Job instance at 0x7fbd3e7cfa00>,78,20,[6 2],79,-1,99,-1,79
1,<environment.Job instance at 0x7fbd3f295730>,79,15,[ 1 10],80,-1,96,-1,81
1,<environment.Job instance at 0x7fbd3f2ed820>,82,15,[1 6],83,-1,98,-1,83
1,<environment.Job instance at 0x7fbd3ecc9f00>,85,17,[7 1],86,-1,103,-1,86
1,<environment.Job instance at 0x7fbd3e884d70>,87,18,[1 7],88,-1,106,-1,88
1,<environment.Job instance at 0x7fbd3eb53410>,89,14,[10  1],90,-1,106,-1,92
1,<environment.Job instance at 0x7fbd3e879af0>,92,18,[5 5],93,-1,111,-1,93
1,<environment.Job instance at 0x7fbd3eb481e0>,95,15,[7 4],96,-1,111,-1,96
1,<environment.Job instance at 0x7fbd3eb48140>,98,21,[5 8],99,-1,120,-1,99
1,<environment.Job instance at 0x7fbd3eb48280>,99,17,[7 2],100,-1,117,-1,100
1,<environment.Job instance at 0x7fbd3eb48aa0>,100,12,[8 1],101,-1,113,-1,101
1,<environment.Job instance at 0x7fbd3eb48fa0>,101,28,[2 8],102,-1,130,-1,102
1,<environment.Job instance at 0x7fbd3eb48320>,102,18,[5 1],103,-1,121,-1,103
1,<environment.Job instance at 0x7fbd3eb485a0>,103,27,[9 3],104,-1,131,-1,104
1,<environment.Job instance at 0x7fbd3e8839b0>,106,28,[1 7],107,-1,135,-1,107
1,<environment.Job instance at 0x7fbd3eb2de10>,107,12,[ 4 10],108,-1,120,-1,108
1,<environment.Job instance at 0x7fbd3eb56500>,116,28,[9 2],117,-1,145,-1,117
1,<environment.Job instance at 0x7fbd3eb56050>,119,17,[1 5],120,-1,137,-1,120
1,<environment.Job instance at 0x7fbd3eb560f0>,121,13,[1 7],122,-1,135,-1,122
1,<environment.Job instance at 0x7fbd3eb56af0>,122,13,[4 8],123,-1,136,-1,123
1,<environment.Job instance at 0x7fbd3eb5f140>,126,12,[7 1],127,-1,139,-1,127
1,<environment.Job instance at 0x7fbd3eb51f00>,128,15,[ 3 11],129,-1,144,-1,129
1,<environment.Job instance at 0x7fbd3eb51730>,130,14,[6 4],131,-1,145,-1,131
1,<environment.Job instance at 0x7fbd3eb51050>,131,1,[10  4],132,-1,133,-1,132
1,<environment.Job instance at 0x7fbd3eb51870>,134,15,[9 1],135,-1,150,-1,135
1,<environment.Job instance at 0x7fbd3f28b4b0>,135,15,[ 2 11],136,-1,151,-1,136
1,<environment.Job instance at 0x7fbd3f28b190>,136,23,[7 4],137,-1,160,-1,137
1,<environment.Job instance at 0x7fbd3f28b730>,138,17,[5 5],139,-1,156,-1,139
1,<environment.Job instance at 0x7fbd3f28b280>,139,14,[3 7],140,-1,154,-1,140
1,<environment.Job instance at 0x7fbd3f28b140>,140,15,[9 4],141,-1,156,-1,141
1,<environment.Job instance at 0x7fbd3e7b6960>,143,20,[5 4],144,-1,164,-1,144
1,<environment.Job instance at 0x7fbd3e7c7af0>,154,15,[10  3],155,-1,170,-1,155
1,<environment.Job instance at 0x7fbd3e7c7500>,155,20,[4 7],156,-1,176,-1,156
1,<environment.Job instance at 0x7fbd3e3af8c0>,156,21,[6 5],157,-1,178,-1,157
1,<environment.Job instance at 0x7fbd3eb48460>,15,2,[14  5],16,-1,36,-1,34
1,<environment.Job instance at 0x7fbd3f989960>,33,27,[1 8],34,-1,127,-1,100
1,<environment.Job instance at 0x7fbd3e583dc0>,53,3,[ 3 14],54,-1,184,-1,181
1,<environment.Job instance at 0x7fbd3e583320>,55,25,[6 3],56,-1,208,-1,183
1,<environment.Job instance at 0x7fbd3e583e60>,60,2,[ 5 11],61,-1,200,-1,198
1,<environment.Job instance at 0x7fbd3e586e60>,69,27,[ 5 10],70,-1,279,-1,252
1,<environment.Job instance at 0x7fbd3e530230>,86,13,[11  1],87,-1,306,-1,293
1,<environment.Job instance at 0x7fbd3e462c30>,88,12,[ 5 12],89,-1,315,-1,303
1,<environment.Job instance at 0x7fbd3e52c320>,101,28,[2 8],102,-1,410,-1,382
1,<environment.Job instance at 0x7fbd3e48c1e0>,103,27,[9 3],104,-1,409,-1,382
1,<environment.Job instance at 0x7fbd3e48c3c0>,106,28,[1 7],107,-1,412,-1,384
1,<environment.Job instance at 0x7fbd3e509fa0>,109,2,[ 4 11],110,-1,402,-1,400
1,<environment.Job instance at 0x7fbd3e556320>,114,3,[11  1],115,-1,421,-1,418
1,<environment.Job instance at 0x7fbd3e3e7b40>,116,28,[9 2],117,-1,466,-1,438
1,<environment.Job instance at 0x7fbd3e3ff6e0>,127,3,[ 1 12],128,-1,451,-1,448
1,<environment.Job instance at 0x7fbd3e3ff640>,128,15,[ 3 11],129,-1,463,-1,448
1,<environment.Job instance at 0x7fbd3e3f9a00>,135,15,[ 2 11],136,-1,481,-1,466
1,<environment.Job instance at 0x7fbd3e3f9d20>,136,23,[7 4],137,-1,491,-1,468
1,<environment.Job instance at 0x7fbd3ec3c140>,150,16,[14  3],151,-1,516,-1,500
1,<environment.Job instance at 0x7fbd3ec3a780>,1,27,[5 1],2,-1,29,-1,2
1,<environment.Job instance at 0x7fbd3ec3a5a0>,2,21,[1 6],3,-1,24,-1,3
1,<environment.Job instance at 0x7fbd3ec3ac30>,3,17,[8 5],4,-1,21,-1,4
1,<environment.Job instance at 0x7fbd3ec3a730>,6,25,[8 3],7,-1,32,-1,7
1,<environment.Job instance at 0x7fbd3ec3ab40>,8,16,[ 5 10],9,-1,25,-1,9
1,<environment.Job instance at 0x7fbd3ec3a690>,9,18,[7 3],10,-1,28,-1,10
1,<environment.Job instance at 0x7fbd3ec3a910>,10,16,[9 2],11,-1,28,-1,12
1,<environment.Job instance at 0x7fbd485a9870>,11,19,[10  1],12,-1,31,-1,12
1,<environment.Job instance at 0x7fbd3f5090a0>,22,18,[5 9],23,-1,42,-1,24
1,<environment.Job instance at 0x7fbd3f509d70>,27,17,[5 2],28,-1,45,-1,28
1,<environment.Job instance at 0x7fbd3eb8ddc0>,28,18,[1 9],29,-1,47,-1,29
1,<environment.Job instance at 0x7fbd3eb8d550>,29,15,[6 3],30,-1,45,-1,30
1,<environment.Job instance at 0x7fbd3eb8dcd0>,30,15,[3 9],31,-1,46,-1,31
1,<environment.Job instance at 0x7fbd3eb8d780>,33,12,[6 2],34,-1,46,-1,34
1,<environment.Job instance at 0x7fbd3eb8d410>,34,17,[9 5],35,-1,52,-1,35
1,<environment.Job instance at 0x7fbd3eb8daa0>,35,16,[5 3],36,-1,52,-1,36
1,<environment.Job instance at 0x7fbd3eb8dc80>,38,14,[9 4],39,-1,53,-1,39
1,<environment.Job instance at 0x7fbd3eb8d640>,40,26,[6 3],41,-1,67,-1,41
1,<environment.Job instance at 0x7fbd3f468e60>,42,17,[ 2 11],43,-1,60,-1,43
1,<environment.Job instance at 0x7fbd3f4684b0>,45,23,[7 1],46,-1,69,-1,46
1,<environment.Job instance at 0x7fbd3eba8780>,47,17,[4 9],48,-1,65,-1,48
1,<environment.Job instance at 0x7fbd3f509370>,23,16,[6 5],24,-1,67,-1,51
1,<environment.Job instance at 0x7fbd3eba8550>,51,17,[10  4],52,-1,70,-1,53
1,<environment.Job instance at 0x7fbd3ef02640>,55,18,[10  3],56,-1,74,-1,56
1,<environment.Job instance at 0x7fbd3ec28730>,57,18,[3 6],58,-1,76,-1,58
1,<environment.Job instance at 0x7fbd3ec28b90>,64,18,[4 7],65,-1,83,-1,65
1,<environment.Job instance at 0x7fbd3ee84b40>,79,18,[9 5],80,-1,128,-1,110
1,<environment.Job instance at 0x7fbd3ee84190>,80,28,[5 6],81,-1,138,-1,110
1,<environment.Job instance at 0x7fbd3ee40780>,84,17,[6 5],85,-1,127,-1,110
1,<environment.Job instance at 0x7fbd3f4bbbe0>,119,17,[9 4],120,-1,381,-1,364
1,<environment.Job instance at 0x7fbd3f09cd70>,132,18,[9 4],133,-1,388,-1,370
1,<environment.Job instance at 0x7fbd3f8ed370>,130,25,[2 8],131,-1,455,-1,430
1,<environment.Job instance at 0x7fbd3f4b68c0>,149,16,[2 8],150,-1,446,-1,430
1,<environment.Job instance at 0x7fbd3f4b6e60>,146,18,[9 4],147,-1,448,-1,430
1,<environment.Job instance at 0x7fbd3f2f7370>,154,20,[9 5],155,-1,482,-1,462
1,<environment.Job instance at 0x7fbd3f509050>,1,27,[5 1],2,-1,29,-1,2
1,<environment.Job instance at 0x7fbd3f468b90>,6,25,[8 3],7,-1,33,-1,8
1,<environment.Job instance at 0x7fbd3f4686e0>,7,13,[13  1],8,-1,21,-1,8
1,<environment.Job instance at 0x7fbd3ef5fcd0>,16,25,[ 5 10],17,-1,71,-1,46
1,<environment.Job instance at 0x7fbd3ef99c80>,36,2,[13  5],37,-1,102,-1,100
1,<environment.Job instance at 0x7fbd3ef52690>,40,26,[6 3],41,-1,144,-1,118
1,<environment.Job instance at 0x7fbd3eb92cd0>,42,17,[ 2 11],43,-1,135,-1,118
1,<environment.Job instance at 0x7fbd3ef39f00>,45,23,[7 1],46,-1,156,-1,133
1,<environment.Job instance at 0x7fbd3e7931e0>,53,12,[ 1 14],54,-1,162,-1,150
1,<environment.Job instance at 0x7fbd3e40a9b0>,56,13,[13  3],57,-1,177,-1,164
1,<environment.Job instance at 0x7fbd3e474b40>,58,1,[ 3 14],59,-1,178,-1,177
1,<environment.Job instance at 0x7fbd3e548d20>,71,14,[ 3 14],72,-1,242,-1,228
1,<environment.Job instance at 0x7fbd3e586e10>,75,13,[ 1 12],76,-1,253,-1,240
1,<environment.Job instance at 0x7fbd3e586050>,76,17,[11  2],77,-1,257,-1,240
1,<environment.Job instance at 0x7fbd3e5860a0>,80,28,[5 6],81,-1,287,-1,259
1,<environment.Job instance at 0x7fbd3e586190>,83,28,[ 1 11],84,-1,289,-1,261
1,<environment.Job instance at 0x7fbd3e586320>,85,23,[5 3],86,-1,288,-1,265
1,<environment.Job instance at 0x7fbd3e583640>,86,14,[13  5],87,-1,279,-1,265
1,<environment.Job instance at 0x7fbd3e583500>,90,13,[12  5],91,-1,291,-1,278
1,<environment.Job instance at 0x7fbd3e57a4b0>,98,15,[ 3 13],99,-1,328,-1,313
1,<environment.Job instance at 0x7fbd3eb60a50>,106,18,[ 3 13],107,-1,364,-1,346
1,<environment.Job instance at 0x7fbd3e879f50>,117,2,[ 4 14],118,-1,396,-1,394
1,<environment.Job instance at 0x7fbd3f963f50>,124,2,[ 1 12],125,-1,413,-1,411
1,<environment.Job instance at 0x7fbd3f989820>,130,25,[2 8],131,-1,469,-1,444
1,<environment.Job instance at 0x7fbd3ef5d140>,134,3,[ 3 14],135,-1,461,-1,458
1,<environment.Job instance at 0x7fbd3eeb1050>,139,2,[13  5],140,-1,487,-1,485
1,<environment.Job instance at 0x7fbd3f385dc0>,148,1,[ 3 12],149,-1,527,-1,526
1,<environment.Job instance at 0x7fbd3f963780>,3,17,[10  5],4,-1,21,-1,4
1,<environment.Job instance at 0x7fbd3f963c30>,4,17,[3 6],5,-1,22,-1,5
1,<environment.Job instance at 0x7fbd3f205320>,11,16,[2 7],12,-1,28,-1,12
1,<environment.Job instance at 0x7fbd3f9acc30>,13,13,[6 5],14,-1,27,-1,14
1,<environment.Job instance at 0x7fbd3f9ac050>,15,15,[9 1],16,-1,31,-1,16
1,<environment.Job instance at 0x7fbd3f9ac280>,17,25,[9 4],18,-1,43,-1,18
1,<environment.Job instance at 0x7fbd3ef9a870>,20,16,[2 8],21,-1,37,-1,21
1,<environment.Job instance at 0x7fbd3f4d2780>,22,17,[1 7],23,-1,40,-1,23
1,<environment.Job instance at 0x7fbd3e4d4a00>,27,14,[12  5],28,-1,43,-1,29
1,<environment.Job instance at 0x7fbd3e182820>,28,14,[5 4],29,-1,43,-1,29
1,<environment.Job instance at 0x7fbd3f359550>,26,16,[14  3],27,-1,46,-1,30
1,<environment.Job instance at 0x7fbd3f4d8fa0>,31,18,[9 3],32,-1,50,-1,32
1,<environment.Job instance at 0x7fbd3e402140>,33,12,[4 9],34,-1,46,-1,34
1,<environment.Job instance at 0x7fbd3e067050>,34,25,[7 4],35,-1,60,-1,35
1,<environment.Job instance at 0x7fbd3e067820>,36,22,[ 4 10],37,-1,59,-1,37
1,<environment.Job instance at 0x7fbd3f5f95a0>,38,16,[2 7],39,-1,55,-1,39
1,<environment.Job instance at 0x7fbd3f5f9460>,39,16,[ 3 10],40,-1,58,-1,42
1,<environment.Job instance at 0x7fbd3f5f99b0>,42,18,[5 8],43,-1,61,-1,43
1,<environment.Job instance at 0x7fbd3e0d6550>,45,23,[8 2],46,-1,69,-1,46
1,<environment.Job instance at 0x7fbd3eb56500>,50,16,[5 9],51,-1,67,-1,51
1,<environment.Job instance at 0x7fbd3eb568c0>,51,15,[9 5],52,-1,67,-1,52
1,<environment.Job instance at 0x7fbd3f621140>,53,18,[ 2 11],54,-1,77,-1,59
1,<environment.Job instance at 0x7fbd3e528cd0>,58,14,[8 1],59,-1,74,-1,60
1,<environment.Job instance at 0x7fbd3e378c30>,57,12,[5 4],58,-1,77,-1,65
1,<environment.Job instance at 0x7fbd3f624d20>,61,17,[3 7],62,-1,85,-1,68
1,<environment.Job instance at 0x7fbd3f624dc0>,60,18,[5 8],61,-1,89,-1,71
1,<environment.Job instance at 0x7fbd3f6247d0>,59,16,[ 4 10],60,-1,87,-1,71
1,<environment.Job instance at 0x7fbd3f4dd320>,64,14,[10  1],65,-1,85,-1,71
1,<environment.Job instance at 0x7fbd3e207320>,69,13,[ 2 10],70,-1,84,-1,71
1,<environment.Job instance at 0x7fbd3f4dd870>,62,23,[7 1],63,-1,95,-1,72
1,<environment.Job instance at 0x7fbd3e207140>,70,15,[4 9],71,-1,87,-1,72
1,<environment.Job instance at 0x7fbd3ef399b0>,81,23,[ 3 13],82,-1,114,-1,91
1,<environment.Job instance at 0x7fbd3e20eb90>,80,15,[9 1],81,-1,106,-1,91
1,<environment.Job instance at 0x7fbd3f44cd20>,76,17,[9 3],77,-1,108,-1,91
1,<environment.Job instance at 0x7fbd3e20ea00>,83,16,[ 4 10],84,-1,107,-1,91
1,<environment.Job instance at 0x7fbd3ef7beb0>,84,18,[1 8],85,-1,110,-1,92
1,<environment.Job instance at 0x7fbd3eed1550>,79,15,[5 6],80,-1,118,-1,103
1,<environment.Job instance at 0x7fbd3e2c0af0>,88,18,[5 8],89,-1,123,-1,105
1,<environment.Job instance at 0x7fbd3e20d820>,90,20,[9 5],91,-1,125,-1,105
1,<environment.Job instance at 0x7fbd3e2711e0>,94,15,[7 5],95,-1,120,-1,105
1,<environment.Job instance at 0x7fbd3ef94690>,85,13,[4 7],86,-1,119,-1,106
1,<environment.Job instance at 0x7fbd3f035d70>,97,15,[ 1 10],98,-1,121,-1,106
1,<environment.Job instance at 0x7fbd3e06bf00>,101,18,[3 7],102,-1,127,-1,109
1,<environment.Job instance at 0x7fbd3e06b050>,102,17,[1 9],103,-1,126,-1,109
1,<environment.Job instance at 0x7fbd3eb2d5f0>,103,14,[5 5],104,-1,123,-1,109
1,<environment.Job instance at 0x7fbd3f380050>,104,22,[9 5],105,-1,131,-1,109
1,<environment.Job instance at 0x7fbd3e1d17d0>,106,13,[3 7],107,-1,122,-1,109
1,<environment.Job instance at 0x7fbd3e20c820>,107,16,[5 8],108,-1,125,-1,109
1,<environment.Job instance at 0x7fbd3e592fa0>,108,16,[1 6],109,-1,125,-1,109
1,<environment.Job instance at 0x7fbd3ec9f690>,110,13,[11  4],111,-1,125,-1,112
1,<environment.Job instance at 0x7fbd3f4ed870>,113,15,[4 9],114,-1,130,-1,115
1,<environment.Job instance at 0x7fbd3e256820>,114,14,[10  4],115,-1,129,-1,115
1,<environment.Job instance at 0x7fbd3e256e60>,116,12,[9 4],117,-1,129,-1,117
1,<environment.Job instance at 0x7fbd3f7f94b0>,117,2,[3 7],118,-1,120,-1,118
1,<environment.Job instance at 0x7fbd3f7f9aa0>,118,12,[10  1],119,-1,131,-1,119
1,<environment.Job instance at 0x7fbd3e5091e0>,119,21,[1 7],120,-1,141,-1,120
1,<environment.Job instance at 0x7fbd3f956550>,120,16,[9 2],121,-1,137,-1,121
1,<environment.Job instance at 0x7fbd3eed5fa0>,127,17,[8 2],128,-1,145,-1,128
1,<environment.Job instance at 0x7fbd3eed5f50>,128,17,[1 6],129,-1,146,-1,129
1,<environment.Job instance at 0x7fbd3eff95f0>,135,16,[11  3],136,-1,168,-1,152
1,<environment.Job instance at 0x7fbd3eed54b0>,129,17,[9 2],130,-1,206,-1,189
1,<environment.Job instance at 0x7fbd3f260f50>,149,16,[10  5],150,-1,205,-1,189
1,<environment.Job instance at 0x7fbd3ef75e10>,158,19,[7 1],159,-1,210,-1,191
1,<environment.Job instance at 0x7fbd3f260af0>,144,17,[8 3],145,-1,208,-1,191
1,<environment.Job instance at 0x7fbd3ef75410>,155,17,[ 2 10],156,-1,208,-1,191
1,<environment.Job instance at 0x7fbd3ed77960>,5,18,[14  2],6,-1,24,-1,6
1,<environment.Job instance at 0x7fbd3ec9fb40>,17,25,[9 4],18,-1,64,-1,39
1,<environment.Job instance at 0x7fbd3e2ad6e0>,21,3,[ 4 12],22,-1,44,-1,41
1,<environment.Job instance at 0x7fbd3f260500>,26,16,[14  3],27,-1,73,-1,57
1,<environment.Job instance at 0x7fbd3f2608c0>,27,14,[12  5],28,-1,71,-1,57
1,<environment.Job instance at 0x7fbd3f3850a0>,34,25,[7 4],35,-1,111,-1,86
1,<environment.Job instance at 0x7fbd3e883320>,45,23,[8 2],46,-1,145,-1,122
1,<environment.Job instance at 0x7fbd3e3a8960>,53,18,[ 2 11],54,-1,166,-1,148
1,<environment.Job instance at 0x7fbd3e5094b0>,55,3,[11  2],56,-1,156,-1,153
1,<environment.Job instance at 0x7fbd3e4742d0>,62,23,[7 1],63,-1,212,-1,189
1,<environment.Job instance at 0x7fbd3ef478c0>,65,3,[13  2],66,-1,206,-1,203
1,<environment.Job instance at 0x7fbd3ef39730>,68,1,[13  4],69,-1,208,-1,207
1,<environment.Job instance at 0x7fbd3ef99550>,72,13,[14  4],73,-1,235,-1,222
1,<environment.Job instance at 0x7fbd3ec28910>,81,23,[ 3 13],82,-1,279,-1,256
1,<environment.Job instance at 0x7fbd3f0fa9b0>,105,3,[ 1 14],106,-1,357,-1,354
1,<environment.Job instance at 0x7fbd3f09f9b0>,110,13,[11  4],111,-1,391,-1,378
1,<environment.Job instance at 0x7fbd3f09fdc0>,111,12,[ 1 13],112,-1,390,-1,378
1,<environment.Job instance at 0x7fbd3f09f230>,122,17,[ 2 14],123,-1,439,-1,422
1,<environment.Job instance at 0x7fbd3f0d3460>,135,16,[11  3],136,-1,489,-1,473
1,<environment.Job instance at 0x7fbd3f5359b0>,146,1,[11  2],147,-1,496,-1,495
1,<environment.Job instance at 0x7fbd3f083820>,0,18,[9 2],1,-1,22,-1,4
1,<environment.Job instance at 0x7fbd3e8ef370>,4,12,[7 4],5,-1,17,-1,5
1,<environment.Job instance at 0x7fbd3e8ef5a0>,7,14,[11  2],8,-1,22,-1,8
1,<environment.Job instance at 0x7fbd3e8ef2d0>,3,14,[5 5],4,-1,22,-1,8
1,<environment.Job instance at 0x7fbd3e8ef730>,10,27,[7 4],11,-1,38,-1,11
1,<environment.Job instance at 0x7fbd3e8ef6e0>,12,16,[10  2],13,-1,30,-1,14
1,<environment.Job instance at 0x7fbd3e8efc30>,16,13,[9 5],17,-1,30,-1,17
1,<environment.Job instance at 0x7fbd3e8ef820>,13,15,[4 8],14,-1,32,-1,17
1,<environment.Job instance at 0x7fbd3e8efd70>,18,14,[ 4 10],19,-1,34,-1,20
1,<environment.Job instance at 0x7fbd3e8efd20>,19,13,[7 5],20,-1,33,-1,20
1,<environment.Job instance at 0x7fbd3e8effa0>,21,14,[9 5],22,-1,37,-1,23
1,<environment.Job instance at 0x7fbd3e8f21e0>,24,19,[9 1],25,-1,44,-1,25
1,<environment.Job instance at 0x7fbd3e8f27d0>,29,15,[8 5],30,-1,45,-1,30
1,<environment.Job instance at 0x7fbd3e8f2460>,31,13,[9 4],32,-1,45,-1,32
1,<environment.Job instance at 0x7fbd3e8f2a00>,32,16,[1 7],33,-1,49,-1,33
1,<environment.Job instance at 0x7fbd3e8f2910>,33,13,[3 7],34,-1,47,-1,34
1,<environment.Job instance at 0x7fbd3e8f2be0>,34,15,[6 4],35,-1,50,-1,35
1,<environment.Job instance at 0x7fbd3e8f2af0>,37,16,[7 2],38,-1,54,-1,38
1,<environment.Job instance at 0x7fbd3e914500>,42,14,[9 3],43,-1,57,-1,43
1,<environment.Job instance at 0x7fbd3e9146e0>,46,16,[4 9],47,-1,63,-1,47
1,<environment.Job instance at 0x7fbd3e914a50>,47,22,[6 1],48,-1,70,-1,48
1,<environment.Job instance at 0x7fbd3e9149b0>,48,15,[7 1],49,-1,64,-1,49
1,<environment.Job instance at 0x7fbd3e914b40>,49,14,[3 8],50,-1,64,-1,50
1,<environment.Job instance at 0x7fbd3e914c80>,51,18,[5 9],52,-1,70,-1,52
1,<environment.Job instance at 0x7fbd3e8eff00>,22,15,[7 3],23,-1,68,-1,53
1,<environment.Job instance at 0x7fbd3e8ea140>,55,17,[10  3],56,-1,75,-1,58
1,<environment.Job instance at 0x7fbd3e8ea4b0>,58,14,[6 3],59,-1,73,-1,59
1,<environment.Job instance at 0x7fbd3e8ea5a0>,60,17,[8 4],61,-1,78,-1,61
1,<environment.Job instance at 0x7fbd3e8ea780>,61,14,[ 5 10],62,-1,76,-1,62
1,<environment.Job instance at 0x7fbd3e8ea640>,62,19,[8 3],63,-1,82,-1,63
1,<environment.Job instance at 0x7fbd3e8ea820>,63,13,[8 3],64,-1,77,-1,64
1,<environment.Job instance at 0x7fbd3e8ea8c0>,64,17,[8 5],65,-1,82,-1,65
1,<environment.Job instance at 0x7fbd3e8eaa00>,66,23,[5 5],67,-1,90,-1,67
1,<environment.Job instance at 0x7fbd3e8ea0f0>,57,16,[8 4],58,-1,83,-1,67
1,<environment.Job instance at 0x7fbd3e8eaaa0>,68,14,[9 5],69,-1,84,-1,70
1,<environment.Job instance at 0x7fbd3e8ead70>,69,25,[7 3],70,-1,96,-1,71
1,<environment.Job instance at 0x7fbd3e909230>,74,17,[4 7],75,-1,94,-1,77
1,<environment.Job instance at 0x7fbd3e9095f0>,77,14,[2 6],78,-1,92,-1,78
1,<environment.Job instance at 0x7fbd3e909b40>,82,14,[10  1],83,-1,97,-1,83
1,<environment.Job instance at 0x7fbd3e909af0>,84,15,[8 1],85,-1,100,-1,85
1,<environment.Job instance at 0x7fbd3e909e10>,85,14,[5 7],86,-1,100,-1,86
1,<environment.Job instance at 0x7fbd3e909f00>,87,15,[3 9],88,-1,103,-1,88
1,<environment.Job instance at 0x7fbd3e9180a0>,88,15,[ 4 10],89,-1,104,-1,89
1,<environment.Job instance at 0x7fbd3e9181e0>,90,18,[5 4],91,-1,109,-1,91
1,<environment.Job instance at 0x7fbd3e909050>,76,13,[10  5],77,-1,104,-1,91
1,<environment.Job instance at 0x7fbd3eb03eb0>,113,18,[4 5],114,-1,134,-1,116
1,<environment.Job instance at 0x7fbd3e3b8910>,115,18,[5 8],116,-1,135,-1,117
1,<environment.Job instance at 0x7fbd3eb6f7d0>,116,18,[3 9],117,-1,135,-1,117
1,<environment.Job instance at 0x7fbd3f473be0>,119,23,[4 9],120,-1,177,-1,154
1,<environment.Job instance at 0x7fbd3efaa280>,125,16,[6 5],126,-1,175,-1,159
1,<environment.Job instance at 0x7fbd3eb9f7d0>,127,18,[9 4],128,-1,177,-1,159
1,<environment.Job instance at 0x7fbd3eb017d0>,122,13,[14  2],123,-1,172,-1,159
1,<environment.Job instance at 0x7fbd3e8ea0a0>,7,14,[11  2],8,-1,22,-1,8
1,<environment.Job instance at 0x7fbd3e8ea3c0>,8,15,[ 3 14],9,-1,24,-1,9
1,<environment.Job instance at 0x7fbd3e909a00>,10,27,[7 4],11,-1,46,-1,19
1,<environment.Job instance at 0x7fbd3ec6ca00>,15,2,[ 1 12],16,-1,23,-1,21
1,<environment.Job instance at 0x7fbd3eb83910>,20,25,[ 1 14],21,-1,73,-1,48
1,<environment.Job instance at 0x7fbd3eb9c280>,23,1,[ 4 13],24,-1,61,-1,60
1,<environment.Job instance at 0x7fbd3eea20f0>,25,3,[ 4 11],26,-1,65,-1,62
1,<environment.Job instance at 0x7fbd3e39cd20>,38,3,[11  1],39,-1,120,-1,117
1,<environment.Job instance at 0x7fbd3f0d3230>,66,23,[5 5],67,-1,247,-1,224
1,<environment.Job instance at 0x7fbd3f0d3a50>,69,25,[7 3],70,-1,264,-1,239
1,<environment.Job instance at 0x7fbd3f0d3780>,70,1,[12  5],71,-1,240,-1,239
1,<environment.Job instance at 0x7fbd3f09fdc0>,81,3,[ 3 11],82,-1,282,-1,279
1,<environment.Job instance at 0x7fbd3f0fa870>,95,3,[14  4],96,-1,339,-1,336
1,<environment.Job instance at 0x7fbd3f0fac30>,96,17,[ 1 13],97,-1,353,-1,336
1,<environment.Job instance at 0x7fbd3f0fa780>,97,18,[ 3 12],98,-1,354,-1,336
1,<environment.Job instance at 0x7fbd3efcce10>,101,2,[11  4],102,-1,342,-1,340
1,<environment.Job instance at 0x7fbd3f9ad500>,108,22,[ 1 13],109,-1,393,-1,371
1,<environment.Job instance at 0x7fbd3ef5b730>,118,2,[11  2],119,-1,417,-1,415
1,<environment.Job instance at 0x7fbd3f0ce0f0>,119,23,[4 9],120,-1,450,-1,427
1,<environment.Job instance at 0x7fbd3ef52960>,122,13,[14  2],123,-1,440,-1,427
1,<environment.Job instance at 0x7fbd3eb560f0>,140,2,[ 4 14],141,-1,493,-1,491
1,<environment.Job instance at 0x7fbd3f7d8a00>,4,15,[10  2],5,-1,21,-1,6
1,<environment.Job instance at 0x7fbd3f535c80>,5,20,[10  3],6,-1,26,-1,6
1,<environment.Job instance at 0x7fbd3f5ce320>,12,18,[9 2],13,-1,33,-1,15
1,<environment.Job instance at 0x7fbd3ea18c30>,15,14,[6 3],16,-1,30,-1,16
1,<environment.Job instance at 0x7fbd3ea180a0>,17,23,[6 1],18,-1,41,-1,18
1,<environment.Job instance at 0x7fbd3ea189b0>,14,14,[5 9],15,-1,35,-1,21
1,<environment.Job instance at 0x7fbd3f7e5eb0>,26,18,[ 2 10],27,-1,45,-1,27
1,<environment.Job instance at 0x7fbd3f7e5370>,27,17,[5 5],28,-1,45,-1,28
1,<environment.Job instance at 0x7fbd3f7e5320>,28,14,[9 5],29,-1,43,-1,29
1,<environment.Job instance at 0x7fbd3f7e5fa0>,30,25,[9 4],31,-1,56,-1,31
1,<environment.Job instance at 0x7fbd3f7e5500>,31,15,[7 3],32,-1,47,-1,32
1,<environment.Job instance at 0x7fbd3f7e5780>,32,17,[1 5],33,-1,50,-1,33
1,<environment.Job instance at 0x7fbd3f7e5960>,34,28,[ 5 10],35,-1,63,-1,35
1,<environment.Job instance at 0x7fbd484e5460>,37,27,[2 9],38,-1,65,-1,38
1,<environment.Job instance at 0x7fbd484e5280>,38,26,[4 9],39,-1,65,-1,39
1,<environment.Job instance at 0x7fbd484e56e0>,40,18,[5 4],41,-1,59,-1,41
1,<environment.Job instance at 0x7fbd484e5910>,41,14,[8 4],42,-1,56,-1,42
1,<environment.Job instance at 0x7fbd48221140>,44,16,[8 1],45,-1,61,-1,45
1,<environment.Job instance at 0x7fbd3e8e77d0>,46,16,[ 5 12],47,-1,63,-1,47
1,<environment.Job instance at 0x7fbd47fda230>,48,19,[2 7],49,-1,68,-1,49
1,<environment.Job instance at 0x7fbd47fda550>,52,22,[5 4],53,-1,75,-1,53
1,<environment.Job instance at 0x7fbd3f88b9b0>,54,13,[5 8],55,-1,68,-1,55
1,<environment.Job instance at 0x7fbd3f893500>,25,12,[8 3],26,-1,67,-1,55
1,<environment.Job instance at 0x7fbd3f88bfa0>,56,18,[1 5],57,-1,75,-1,57
1,<environment.Job instance at 0x7fbd3f88ba00>,58,17,[7 5],59,-1,76,-1,59
1,<environment.Job instance at 0x7fbd3f88bd20>,59,13,[4 8],60,-1,73,-1,60
1,<environment.Job instance at 0x7fbd485b3820>,60,17,[10  1],61,-1,83,-1,66
1,<environment.Job instance at 0x7fbd3f955690>,67,26,[10  5],68,-1,94,-1,68
1,<environment.Job instance at 0x7fbd3f27c730>,69,16,[5 6],70,-1,86,-1,70
1,<environment.Job instance at 0x7fbd3e78baa0>,65,15,[5 4],66,-1,86,-1,71
1,<environment.Job instance at 0x7fbd3e5eda50>,70,18,[4 5],71,-1,90,-1,72
1,<environment.Job instance at 0x7fbd3e9db370>,73,13,[9 3],74,-1,87,-1,74
1,<environment.Job instance at 0x7fbd3f793b90>,71,18,[4 9],72,-1,93,-1,75
1,<environment.Job instance at 0x7fbd3e9dbdc0>,75,14,[ 3 10],76,-1,90,-1,76
1,<environment.Job instance at 0x7fbd3e3afbe0>,76,14,[5 4],77,-1,93,-1,79
1,<environment.Job instance at 0x7fbd3e474550>,84,22,[1 8],85,-1,107,-1,85
1,<environment.Job instance at 0x7fbd3f4bb730>,83,23,[1 7],84,-1,109,-1,86
1,<environment.Job instance at 0x7fbd3e474c80>,85,18,[ 2 10],86,-1,104,-1,86
1,<environment.Job instance at 0x7fbd3e474780>,89,17,[9 1],90,-1,109,-1,92
1,<environment.Job instance at 0x7fbd3e4740a0>,92,26,[1 5],93,-1,119,-1,93
1,<environment.Job instance at 0x7fbd3e4747d0>,90,16,[4 8],91,-1,110,-1,94
1,<environment.Job instance at 0x7fbd3e474370>,93,17,[ 4 10],94,-1,111,-1,94
1,<environment.Job instance at 0x7fbd3e474cd0>,88,13,[14  3],89,-1,120,-1,107
1,<environment.Job instance at 0x7fbd3f6c9d70>,100,13,[10  5],101,-1,120,-1,107
1,<environment.Job instance at 0x7fbd3f6c95f0>,102,22,[5 3],103,-1,129,-1,107
1,<environment.Job instance at 0x7fbd3f6c9410>,97,12,[9 2],98,-1,120,-1,108
1,<environment.Job instance at 0x7fbd3f9b1640>,104,15,[4 7],105,-1,124,-1,109
1,<environment.Job instance at 0x7fbd3f6cd5a0>,107,24,[2 8],108,-1,134,-1,110
1,<environment.Job instance at 0x7fbd3f2fac80>,109,13,[14  2],110,-1,136,-1,123
1,<environment.Job instance at 0x7fbd3f2fa230>,111,16,[4 9],112,-1,139,-1,123
1,<environment.Job instance at 0x7fbd3e803dc0>,112,15,[1 6],113,-1,139,-1,124
1,<environment.Job instance at 0x7fbd3e803230>,114,13,[1 9],115,-1,137,-1,124
1,<environment.Job instance at 0x7fbd3ed93cd0>,121,23,[9 4],122,-1,147,-1,124
1,<environment.Job instance at 0x7fbd3ed93a50>,116,18,[7 1],117,-1,142,-1,124
1,<environment.Job instance at 0x7fbd3ed935f0>,115,12,[5 2],116,-1,139,-1,127
1,<environment.Job instance at 0x7fbd3ed93fa0>,123,3,[9 4],124,-1,132,-1,129
1,<environment.Job instance at 0x7fbd3ed93690>,124,14,[2 7],125,-1,144,-1,130
1,<environment.Job instance at 0x7fbd3e803960>,113,26,[1 8],114,-1,156,-1,130
1,<environment.Job instance at 0x7fbd3ed934b0>,126,16,[9 3],127,-1,146,-1,130
1,<environment.Job instance at 0x7fbd3ec3cbe0>,130,17,[4 7],131,-1,148,-1,131
1,<environment.Job instance at 0x7fbd3ec3c6e0>,131,14,[3 5],132,-1,146,-1,132
1,<environment.Job instance at 0x7fbd3e6046e0>,137,17,[4 6],138,-1,158,-1,141
1,<environment.Job instance at 0x7fbd3e604f00>,140,18,[3 6],141,-1,159,-1,141
1,<environment.Job instance at 0x7fbd3e7914b0>,142,16,[1 9],143,-1,159,-1,143
1,<environment.Job instance at 0x7fbd3e791fa0>,144,12,[10  3],145,-1,165,-1,153
1,<environment.Job instance at 0x7fbd3e7911e0>,146,16,[2 7],147,-1,174,-1,158
1,<environment.Job instance at 0x7fbd3ed932d0>,128,16,[5 1],129,-1,174,-1,158
1,<environment.Job instance at 0x7fbd485b3640>,62,15,[2 5],63,-1,174,-1,159
1,<environment.Job instance at 0x7fbd3eca50a0>,149,12,[4 8],150,-1,171,-1,159
1,<environment.Job instance at 0x7fbd3eca5a50>,150,14,[1 9],151,-1,173,-1,159
1,<environment.Job instance at 0x7fbd3f893d20>,3,17,[14  2],4,-1,21,-1,4
1,<environment.Job instance at 0x7fbd3f4bb820>,16,2,[ 5 12],17,-1,37,-1,35
1,<environment.Job instance at 0x7fbd3f2faa50>,17,23,[6 1],18,-1,60,-1,37
1,<environment.Job instance at 0x7fbd3f6a61e0>,30,25,[9 4],31,-1,104,-1,79
1,<environment.Job instance at 0x7fbd3f7d8b90>,34,28,[ 5 10],35,-1,124,-1,96
1,<environment.Job instance at 0x7fbd3f385910>,37,27,[2 9],38,-1,124,-1,97
1,<environment.Job instance at 0x7fbd3f385c80>,38,26,[4 9],39,-1,123,-1,97
1,<environment.Job instance at 0x7fbd3e7c9b40>,46,16,[ 5 12],47,-1,131,-1,115
1,<environment.Job instance at 0x7fbd3f83d8c0>,66,17,[ 2 14],67,-1,199,-1,182
1,<environment.Job instance at 0x7fbd3ec28460>,67,26,[10  5],68,-1,210,-1,184
1,<environment.Job instance at 0x7fbd3f0faf00>,83,23,[1 7],84,-1,259,-1,236
1,<environment.Job instance at 0x7fbd3f0fa9b0>,88,13,[14  3],89,-1,251,-1,238
1,<environment.Job instance at 0x7fbd3f09ff50>,92,26,[1 5],93,-1,281,-1,255
1,<environment.Job instance at 0x7fbd3f0d3820>,107,24,[2 8],108,-1,351,-1,327
1,<environment.Job instance at 0x7fbd3f0d3d20>,109,13,[14  2],110,-1,340,-1,327
1,<environment.Job instance at 0x7fbd3f0d3230>,113,26,[1 8],114,-1,377,-1,351
1,<environment.Job instance at 0x7fbd3e8ef780>,119,15,[ 1 14],120,-1,378,-1,363
1,<environment.Job instance at 0x7fbd3e39cc30>,121,23,[9 4],122,-1,392,-1,369
1,<environment.Job instance at 0x7fbd3e58ee60>,157,16,[11  5],158,-1,529,-1,513
1,<environment.Job instance at 0x7fbd3f08f960>,5,17,[ 5 10],6,-1,23,-1,6
1,<environment.Job instance at 0x7fbd3f08fa00>,8,12,[6 1],9,-1,22,-1,10
1,<environment.Job instance at 0x7fbd3f08fd70>,10,15,[6 2],11,-1,27,-1,12
1,<environment.Job instance at 0x7fbd3f08fdc0>,12,16,[5 3],13,-1,29,-1,13
1,<environment.Job instance at 0x7fbd3f08f0a0>,13,16,[9 5],14,-1,30,-1,14
1,<environment.Job instance at 0x7fbd3f08f190>,14,16,[8 5],15,-1,31,-1,15
1,<environment.Job instance at 0x7fbd3f08fbe0>,17,14,[ 5 10],18,-1,32,-1,18
1,<environment.Job instance at 0x7fbd3f9cf820>,19,16,[6 2],20,-1,36,-1,20
1,<environment.Job instance at 0x7fbd3f9cf3c0>,22,16,[9 3],23,-1,39,-1,23
1,<environment.Job instance at 0x7fbd3f9cf370>,23,14,[1 6],24,-1,38,-1,24
1,<environment.Job instance at 0x7fbd3f9cf5f0>,24,16,[7 3],25,-1,41,-1,25
1,<environment.Job instance at 0x7fbd3f9cf690>,25,22,[5 2],26,-1,48,-1,26
1,<environment.Job instance at 0x7fbd3f9da050>,35,18,[10  4],36,-1,56,-1,38
1,<environment.Job instance at 0x7fbd3f62b820>,37,15,[7 2],38,-1,53,-1,38
1,<environment.Job instance at 0x7fbd3e1ed910>,41,18,[4 9],42,-1,61,-1,43
1,<environment.Job instance at 0x7fbd3e1eda50>,45,16,[2 7],46,-1,62,-1,46
1,<environment.Job instance at 0x7fbd3e1ed8c0>,42,18,[3 6],43,-1,64,-1,46
1,<environment.Job instance at 0x7fbd3f087370>,48,18,[8 3],49,-1,68,-1,50
1,<environment.Job instance at 0x7fbd3f087b90>,57,18,[6 4],58,-1,80,-1,62
1,<environment.Job instance at 0x7fbd3f0877d0>,54,17,[10  3],55,-1,79,-1,62
1,<environment.Job instance at 0x7fbd3e21f960>,69,16,[12  5],70,-1,160,-1,144
1,<environment.Job instance at 0x7fbd3e21f230>,81,17,[9 4],82,-1,161,-1,144
1,<environment.Job instance at 0x7fbd3f0875a0>,55,18,[ 2 11],56,-1,162,-1,144
1,<environment.Job instance at 0x7fbd3e10b460>,84,14,[9 5],85,-1,158,-1,144
1,<environment.Job instance at 0x7fbd3e10baa0>,86,16,[3 8],87,-1,160,-1,144
1,<environment.Job instance at 0x7fbd3f087190>,59,15,[9 3],60,-1,159,-1,144
1,<environment.Job instance at 0x7fbd3e10bd70>,87,18,[ 5 10],88,-1,162,-1,144
1,<environment.Job instance at 0x7fbd3e10bdc0>,92,12,[10  2],93,-1,156,-1,144
1,<environment.Job instance at 0x7fbd3e10b7d0>,94,18,[ 2 10],95,-1,162,-1,144
1,<environment.Job instance at 0x7fbd3e10b140>,95,14,[8 4],96,-1,158,-1,144
1,<environment.Job instance at 0x7fbd3e10bb40>,88,15,[1 8],89,-1,160,-1,145
1,<environment.Job instance at 0x7fbd3e10b320>,96,18,[ 2 10],97,-1,163,-1,145
1,<environment.Job instance at 0x7fbd3e10baf0>,90,13,[7 3],91,-1,158,-1,145
1,<environment.Job instance at 0x7fbd3e10b870>,100,17,[8 2],101,-1,162,-1,145
1,<environment.Job instance at 0x7fbd3e10bcd0>,101,14,[4 9],102,-1,159,-1,145
1,<environment.Job instance at 0x7fbd3e10ba50>,102,16,[6 2],103,-1,161,-1,145
1,<environment.Job instance at 0x7fbd3e546e10>,104,15,[2 5],105,-1,160,-1,145
1,<environment.Job instance at 0x7fbd3f087410>,56,13,[11  3],57,-1,158,-1,145
1,<environment.Job instance at 0x7fbd3e5460f0>,105,13,[2 7],106,-1,158,-1,145
1,<environment.Job instance at 0x7fbd3e5462d0>,108,25,[5 5],109,-1,170,-1,145
1,<environment.Job instance at 0x7fbd3f08f230>,1,3,[13  1],2,-1,5,-1,2
1,<environment.Job instance at 0x7fbd3e1223c0>,15,1,[ 3 12],16,-1,23,-1,22
1,<environment.Job instance at 0x7fbd3e0e4e10>,18,3,[ 5 12],19,-1,40,-1,37
1,<environment.Job instance at 0x7fbd3f9d85a0>,26,1,[11  1],27,-1,71,-1,70
1,<environment.Job instance at 0x7fbd3eeb68c0>,30,13,[11  3],31,-1,96,-1,83
1,<environment.Job instance at 0x7fbd3e0f6820>,31,28,[7 5],32,-1,112,-1,84
1,<environment.Job instance at 0x7fbd3e0b8690>,33,2,[14  5],34,-1,86,-1,84
1,<environment.Job instance at 0x7fbd3e0b8f00>,34,26,[7 1],35,-1,112,-1,86
1,<environment.Job instance at 0x7fbd3f570960>,47,13,[13  4],48,-1,150,-1,137
1,<environment.Job instance at 0x7fbd3f2ddf50>,51,3,[ 4 12],52,-1,156,-1,153
1,<environment.Job instance at 0x7fbd63e54c30>,50,24,[10  5],51,-1,178,-1,154
1,<environment.Job instance at 0x7fbd3eb6b8c0>,55,18,[ 2 11],56,-1,189,-1,171
1,<environment.Job instance at 0x7fbd3e20f190>,56,13,[11  3],57,-1,184,-1,171
1,<environment.Job instance at 0x7fbd3f61ed20>,58,27,[5 1],59,-1,213,-1,186
1,<environment.Job instance at 0x7fbd3f5aa190>,68,27,[1 7],69,-1,246,-1,219
1,<environment.Job instance at 0x7fbd3e164370>,69,16,[12  5],70,-1,235,-1,219
1,<environment.Job instance at 0x7fbd3edc7aa0>,76,1,[14  4],77,-1,228,-1,227
1,<environment.Job instance at 0x7fbd3edc7dc0>,77,17,[13  5],78,-1,244,-1,227
1,<environment.Job instance at 0x7fbd3ea46d70>,108,25,[5 5],109,-1,396,-1,371
1,<environment.Job instance at 0x7fbd3ea46280>,110,18,[14  5],111,-1,389,-1,371
1,<environment.Job instance at 0x7fbd3f94feb0>,111,15,[ 1 12],112,-1,386,-1,371
1,<environment.Job instance at 0x7fbd3e70ebe0>,132,17,[ 3 14],133,-1,491,-1,474
1,<environment.Job instance at 0x7fbd3e5ae960>,135,16,[ 4 12],136,-1,494,-1,478
1,<environment.Job instance at 0x7fbd3f69d8c0>,138,18,[13  3],139,-1,507,-1,489
1,<environment.Job instance at 0x7fbd3f9f80a0>,139,1,[ 4 14],140,-1,490,-1,489
1,<environment.Job instance at 0x7fbd3f430f00>,142,16,[14  1],143,-1,509,-1,493
1,<environment.Job instance at 0x7fbd3fa96050>,145,1,[ 5 13],146,-1,508,-1,507
1,<environment.Job instance at 0x7fbd3e4f6190>,153,3,[ 5 11],154,-1,528,-1,525
1,<environment.Job instance at 0x7fbd3f1e5fa0>,10,12,[10  4],11,-1,24,-1,12
1,<environment.Job instance at 0x7fbd3f1e5e10>,12,18,[ 5 10],13,-1,31,-1,13
1,<environment.Job instance at 0x7fbd3f1e59b0>,16,16,[ 5 10],17,-1,33,-1,17
1,<environment.Job instance at 0x7fbd3ed0a550>,24,12,[3 9],25,-1,37,-1,25
1,<environment.Job instance at 0x7fbd3f081e60>,33,15,[8 4],34,-1,49,-1,34
1,<environment.Job instance at 0x7fbd3e80f140>,38,12,[1 6],39,-1,51,-1,39
1,<environment.Job instance at 0x7fbd3e80fc80>,40,16,[6 2],41,-1,60,-1,44
1,<environment.Job instance at 0x7fbd3f7b50f0>,44,14,[10  4],45,-1,59,-1,45
1,<environment.Job instance at 0x7fbd3f7b50a0>,43,21,[5 7],44,-1,66,-1,45
1,<environment.Job instance at 0x7fbd3f7b5c30>,45,17,[4 9],46,-1,65,-1,48
1,<environment.Job instance at 0x7fbd3f7b5550>,53,25,[9 3],54,-1,80,-1,55
1,<environment.Job instance at 0x7fbd3f7b5f50>,50,13,[10  1],51,-1,69,-1,56
1,<environment.Job instance at 0x7fbd3e084690>,56,19,[9 4],57,-1,76,-1,57
1,<environment.Job instance at 0x7fbd3f7b5be0>,52,19,[4 7],53,-1,78,-1,59
1,<environment.Job instance at 0x7fbd3e084140>,57,18,[4 7],58,-1,77,-1,59
1,<environment.Job instance at 0x7fbd3e0840a0>,68,24,[8 3],69,-1,147,-1,123
1,<environment.Job instance at 0x7fbd3e80faa0>,36,20,[4 9],37,-1,143,-1,123
1,<environment.Job instance at 0x7fbd3f828d70>,79,19,[2 9],80,-1,142,-1,123
1,<environment.Job instance at 0x7fbd3f8287d0>,84,13,[10  5],85,-1,138,-1,125
1,<environment.Job instance at 0x7fbd3f43f6e0>,1,3,[ 3 11],2,-1,5,-1,2
1,<environment.Job instance at 0x7fbd3f7b5d20>,8,18,[ 4 12],9,-1,27,-1,9
1,<environment.Job instance at 0x7fbd3e084a00>,14,26,[10  2],15,-1,50,-1,24
1,<environment.Job instance at 0x7fbd47fd40f0>,27,15,[13  3],28,-1,54,-1,39
1,<environment.Job instance at 0x7fbd3e303280>,41,2,[ 2 13],42,-1,72,-1,70
1,<environment.Job instance at 0x7fbd3f79f910>,48,2,[12  1],49,-1,98,-1,96
1,<environment.Job instance at 0x7fbd3f296690>,49,27,[ 5 11],50,-1,123,-1,96
1,<environment.Job instance at 0x7fbd485aeb90>,53,25,[9 3],54,-1,136,-1,111
1,<environment.Job instance at 0x7fbd3f9f8af0>,58,17,[ 2 12],59,-1,132,-1,115
1,<environment.Job instance at 0x7fbd3f69d320>,60,26,[9 4],61,-1,153,-1,127
1,<environment.Job instance at 0x7fbd3e70be60>,65,14,[13  2],66,-1,155,-1,141
1,<environment.Job instance at 0x7fbd3e70bd70>,68,24,[8 3],69,-1,182,-1,158
1,<environment.Job instance at 0x7fbd3f354230>,88,2,[ 4 12],89,-1,230,-1,228
1,<environment.Job instance at 0x7fbd48065280>,93,26,[2 9],94,-1,285,-1,259
1,<environment.Job instance at 0x7fbd3e4909b0>,96,13,[12  4],97,-1,272,-1,259
1,<environment.Job instance at 0x7fbd3e1d9640>,101,17,[13  5],102,-1,292,-1,275
1,<environment.Job instance at 0x7fbd3e21f780>,129,23,[5 5],130,-1,405,-1,382
1,<environment.Job instance at 0x7fbd3f9cf280>,135,24,[7 5],136,-1,445,-1,421
1,<environment.Job instance at 0x7fbd3f9cf550>,137,3,[ 2 13],138,-1,424,-1,421
1,<environment.Job instance at 0x7fbd3f88ff50>,150,1,[13  2],151,-1,473,-1,472
1,<environment.Job instance at 0x7fbd3ec6f0f0>,153,1,[ 2 13],154,-1,476,-1,475
1,<environment.Job instance at 0x7fbd3ec6f780>,156,1,[ 4 11],157,-1,492,-1,491
1,<environment.Job instance at 0x7fbd3e73bb40>,1,23,[7 5],2,-1,25,-1,2
1,<environment.Job instance at 0x7fbd3f9e50a0>,2,28,[8 2],3,-1,31,-1,3
1,<environment.Job instance at 0x7fbd3f9e5140>,3,22,[5 4],4,-1,26,-1,4
1,<environment.Job instance at 0x7fbd3f9e5280>,5,17,[ 4 10],6,-1,23,-1,6
1,<environment.Job instance at 0x7fbd3f9e5870>,11,17,[6 5],12,-1,29,-1,12
1,<environment.Job instance at 0x7fbd3f9e54b0>,13,18,[10  5],14,-1,32,-1,14
1,<environment.Job instance at 0x7fbd3f9e5c80>,16,16,[3 6],17,-1,33,-1,17
1,<environment.Job instance at 0x7fbd3f9dd4b0>,23,18,[4 9],24,-1,42,-1,24
1,<environment.Job instance at 0x7fbd3f9dd640>,24,26,[7 4],25,-1,51,-1,25
1,<environment.Job instance at 0x7fbd3f9dda00>,28,16,[1 8],29,-1,46,-1,30
1,<environment.Job instance at 0x7fbd3f9dd730>,29,12,[9 3],30,-1,42,-1,30
1,<environment.Job instance at 0x7fbd3f9ddf00>,34,17,[10  4],35,-1,56,-1,39
1,<environment.Job instance at 0x7fbd3f9f3500>,38,16,[14  5],39,-1,55,-1,39
1,<environment.Job instance at 0x7fbd3f9f3820>,41,16,[8 1],42,-1,59,-1,43
1,<environment.Job instance at 0x7fbd3f9f3af0>,45,15,[ 2 12],46,-1,61,-1,46
1,<environment.Job instance at 0x7fbd3f9f3be0>,47,19,[4 7],48,-1,67,-1,48
1,<environment.Job instance at 0x7fbd3f9f3d20>,49,15,[6 1],50,-1,65,-1,50
1,<environment.Job instance at 0x7fbd3fa18140>,50,17,[2 8],51,-1,68,-1,51
1,<environment.Job instance at 0x7fbd3fa181e0>,52,12,[10  3],53,-1,65,-1,53
1,<environment.Job instance at 0x7fbd3f042550>,54,16,[6 3],55,-1,71,-1,55
1,<environment.Job instance at 0x7fbd3e8aa0f0>,57,18,[7 1],58,-1,76,-1,58
1,<environment.Job instance at 0x7fbd3ea3e870>,58,16,[10  3],59,-1,75,-1,59
1,<environment.Job instance at 0x7fbd3e116370>,59,15,[9 3],60,-1,75,-1,60
1,<environment.Job instance at 0x7fbd3e7e2500>,62,22,[6 2],63,-1,85,-1,63
1,<environment.Job instance at 0x7fbd3e7e2be0>,63,16,[4 9],64,-1,80,-1,64
1,<environment.Job instance at 0x7fbd3e7e25f0>,64,23,[6 5],65,-1,88,-1,65
1,<environment.Job instance at 0x7fbd3ee2d1e0>,68,12,[ 3 10],69,-1,81,-1,69
1,<environment.Job instance at 0x7fbd3e7d3140>,72,17,[1 6],73,-1,90,-1,73
1,<environment.Job instance at 0x7fbd3e7d3320>,73,21,[7 4],74,-1,95,-1,74
1,<environment.Job instance at 0x7fbd3ef9ab40>,75,15,[ 5 11],76,-1,91,-1,76
1,<environment.Job instance at 0x7fbd3e946500>,80,26,[5 7],81,-1,107,-1,81
1,<environment.Job instance at 0x7fbd3e1153c0>,81,16,[ 2 10],82,-1,98,-1,82
1,<environment.Job instance at 0x7fbd3e0f05a0>,83,15,[10  1],84,-1,99,-1,84
1,<environment.Job instance at 0x7fbd3e8a5460>,84,20,[5 9],85,-1,105,-1,85
1,<environment.Job instance at 0x7fbd3e8a5e10>,87,15,[1 7],88,-1,103,-1,88
1,<environment.Job instance at 0x7fbd3e8c19b0>,88,18,[5 6],89,-1,107,-1,89
1,<environment.Job instance at 0x7fbd3e8c1960>,89,27,[5 9],90,-1,117,-1,90
1,<environment.Job instance at 0x7fbd3e7b52d0>,92,26,[ 1 10],93,-1,119,-1,93
1,<environment.Job instance at 0x7fbd3e7b51e0>,93,28,[3 5],94,-1,122,-1,94
1,<environment.Job instance at 0x7fbd3e7b5050>,94,16,[5 6],95,-1,111,-1,95
1,<environment.Job instance at 0x7fbd3e8d2dc0>,95,16,[10  2],96,-1,112,-1,96
1,<environment.Job instance at 0x7fbd3e8d2c80>,100,20,[5 8],101,-1,121,-1,101
1,<environment.Job instance at 0x7fbd3e8d20a0>,106,18,[3 5],107,-1,125,-1,107
1,<environment.Job instance at 0x7fbd3e7abdc0>,107,14,[8 3],108,-1,122,-1,108
1,<environment.Job instance at 0x7fbd3e7abfa0>,108,14,[7 5],109,-1,123,-1,109
1,<environment.Job instance at 0x7fbd3e7ab780>,110,21,[5 2],111,-1,132,-1,111
1,<environment.Job instance at 0x7fbd3f9f3910>,42,14,[ 2 12],43,-1,126,-1,112
1,<environment.Job instance at 0x7fbd3e7ab280>,114,18,[3 8],115,-1,135,-1,117
1,<environment.Job instance at 0x7fbd3e7abcd0>,120,14,[5 5],121,-1,135,-1,121
1,<environment.Job instance at 0x7fbd3e7abc30>,121,17,[2 9],122,-1,139,-1,122
1,<environment.Job instance at 0x7fbd3e7e00a0>,128,14,[7 3],129,-1,143,-1,129
1,<environment.Job instance at 0x7fbd3e7e03c0>,130,12,[3 8],131,-1,143,-1,131
1,<environment.Job instance at 0x7fbd3e7e0c80>,131,1,[6 1],132,-1,133,-1,132
1,<environment.Job instance at 0x7fbd3e7e0190>,134,18,[6 3],135,-1,153,-1,135
1,<environment.Job instance at 0x7fbd3e8ae1e0>,135,23,[7 4],136,-1,159,-1,136
1,<environment.Job instance at 0x7fbd3e8ae190>,136,23,[5 6],137,-1,160,-1,137
1,<environment.Job instance at 0x7fbd3e8ae9b0>,137,16,[2 6],138,-1,154,-1,138
1,<environment.Job instance at 0x7fbd3e0fa820>,142,18,[9 5],143,-1,162,-1,144
1,<environment.Job instance at 0x7fbd3e8d1050>,145,15,[9 5],146,-1,163,-1,148
1,<environment.Job instance at 0x7fbd3e8aebe0>,138,25,[ 5 10],139,-1,174,-1,149
1,<environment.Job instance at 0x7fbd3e8d15f0>,147,26,[ 2 10],148,-1,177,-1,151
1,<environment.Job instance at 0x7fbd3e0fa960>,139,15,[5 3],140,-1,166,-1,151
1,<environment.Job instance at 0x7fbd3e8d1460>,149,3,[2 9],150,-1,154,-1,151
1,<environment.Job instance at 0x7fbd3e8d1370>,150,13,[6 5],151,-1,164,-1,151
1,<environment.Job instance at 0x7fbd3e8d14b0>,151,16,[8 5],152,-1,169,-1,153
1,<environment.Job instance at 0x7fbd3e8d19b0>,154,17,[5 7],155,-1,173,-1,156
1,<environment.Job instance at 0x7fbd3f9e5820>,1,23,[7 5],2,-1,25,-1,2
1,<environment.Job instance at 0x7fbd3f9e5d70>,2,28,[8 2],3,-1,31,-1,3
1,<environment.Job instance at 0x7fbd3e7ab870>,25,1,[12  3],26,-1,50,-1,49
1,<environment.Job instance at 0x7fbd3e8d2640>,24,26,[7 4],25,-1,76,-1,50
1,<environment.Job instance at 0x7fbd3ec6f910>,38,16,[14  5],39,-1,92,-1,76
1,<environment.Job instance at 0x7fbd3f88fc80>,42,14,[ 2 12],43,-1,95,-1,81
1,<environment.Job instance at 0x7fbd3f88f780>,45,15,[ 2 12],46,-1,109,-1,94
1,<environment.Job instance at 0x7fbd3f869d20>,64,23,[6 5],65,-1,214,-1,191
1,<environment.Job instance at 0x7fbd47ff0960>,75,15,[ 5 11],76,-1,225,-1,210
1,<environment.Job instance at 0x7fbd3ed5af50>,80,26,[5 7],81,-1,240,-1,214
1,<environment.Job instance at 0x7fbd3f807d20>,89,27,[5 9],90,-1,274,-1,247
1,<environment.Job instance at 0x7fbd3e187500>,93,28,[3 5],94,-1,279,-1,251
1,<environment.Job instance at 0x7fbd3e187d20>,92,26,[ 1 10],93,-1,277,-1,251
1,<environment.Job instance at 0x7fbd3ef1dd20>,109,14,[ 1 13],110,-1,308,-1,294
1,<environment.Job instance at 0x7fbd3e70b820>,112,16,[11  5],113,-1,322,-1,306
1,<environment.Job instance at 0x7fbd3f753500>,135,23,[7 4],136,-1,411,-1,388
1,<environment.Job instance at 0x7fbd3f753a00>,136,23,[5 6],137,-1,411,-1,388
1,<environment.Job instance at 0x7fbd3f898320>,141,12,[ 5 11],142,-1,416,-1,404
1,<environment.Job instance at 0x7fbd3e484f50>,138,25,[ 5 10],139,-1,444,-1,419
1,<environment.Job instance at 0x7fbd3f52f5a0>,147,26,[ 2 10],148,-1,449,-1,423
1,<environment.Job instance at 0x7fbd3f36faf0>,153,17,[ 5 12],154,-1,465,-1,448
1,<environment.Job instance at 0x7fbd3f5290a0>,3,20,[5 2],4,-1,24,-1,4
1,<environment.Job instance at 0x7fbd3f5291e0>,5,15,[8 2],6,-1,21,-1,6
1,<environment.Job instance at 0x7fbd3f529780>,12,1,[ 4 10],13,-1,14,-1,13
1,<environment.Job instance at 0x7fbd3f7bfb90>,13,14,[2 9],14,-1,28,-1,14
1,<environment.Job instance at 0x7fbd3f7bfd20>,14,12,[9 4],15,-1,27,-1,15
1,<environment.Job instance at 0x7fbd3f7bf9b0>,18,12,[3 5],19,-1,31,-1,19
1,<environment.Job instance at 0x7fbd3f7bfcd0>,20,25,[8 3],21,-1,46,-1,21
1,<environment.Job instance at 0x7fbd3f7bf0f0>,21,27,[8 1],22,-1,49,-1,22
1,<environment.Job instance at 0x7fbd3e68b280>,26,17,[3 8],27,-1,44,-1,27
1,<environment.Job instance at 0x7fbd3e68b780>,29,18,[5 2],30,-1,51,-1,33
1,<environment.Job instance at 0x7fbd3f6426e0>,35,18,[5 5],36,-1,54,-1,36
1,<environment.Job instance at 0x7fbd3f642a00>,36,14,[10  1],37,-1,51,-1,37
1,<environment.Job instance at 0x7fbd3f642460>,37,26,[ 5 10],38,-1,64,-1,38
1,<environment.Job instance at 0x7fbd3f642550>,38,14,[3 7],39,-1,53,-1,39
1,<environment.Job instance at 0x7fbd3f6423c0>,32,13,[9 4],33,-1,52,-1,39
1,<environment.Job instance at 0x7fbd3f642eb0>,40,17,[4 8],41,-1,58,-1,41
1,<environment.Job instance at 0x7fbd3f642a50>,41,17,[3 6],42,-1,60,-1,43
1,<environment.Job instance at 0x7fbd3f642820>,42,17,[ 4 10],43,-1,61,-1,44
1,<environment.Job instance at 0x7fbd3f09c960>,51,18,[5 5],52,-1,70,-1,52
1,<environment.Job instance at 0x7fbd3f09c8c0>,56,17,[3 7],57,-1,74,-1,57
1,<environment.Job instance at 0x7fbd4833d0a0>,61,17,[ 4 10],62,-1,79,-1,62
1,<environment.Job instance at 0x7fbd3f2606e0>,64,23,[2 9],65,-1,88,-1,65
1,<environment.Job instance at 0x7fbd3f260190>,65,18,[5 3],66,-1,84,-1,66
1,<environment.Job instance at 0x7fbd3f8a4a50>,71,17,[6 1],72,-1,91,-1,74
1,<environment.Job instance at 0x7fbd3f8a4370>,72,16,[9 2],73,-1,91,-1,75
1,<environment.Job instance at 0x7fbd3f09cf50>,54,17,[6 1],55,-1,105,-1,88
1,<environment.Job instance at 0x7fbd4833d0f0>,60,14,[7 4],61,-1,102,-1,88
1,<environment.Job instance at 0x7fbd3f8a47d0>,78,26,[2 5],79,-1,115,-1,89
1,<environment.Job instance at 0x7fbd3f8a45a0>,79,28,[4 8],80,-1,117,-1,89
1,<environment.Job instance at 0x7fbd3f8a4dc0>,80,28,[1 5],81,-1,117,-1,89
1,<environment.Job instance at 0x7fbd3f8a4b40>,83,13,[10  1],84,-1,103,-1,90
1,<environment.Job instance at 0x7fbd3f8a4140>,86,22,[7 4],87,-1,112,-1,90
1,<environment.Job instance at 0x7fbd3f8a4960>,87,28,[ 1 10],88,-1,118,-1,90
1,<environment.Job instance at 0x7fbd3f2932d0>,88,18,[5 5],89,-1,108,-1,90
1,<environment.Job instance at 0x7fbd3e602b40>,89,15,[3 6],90,-1,105,-1,90
1,<environment.Job instance at 0x7fbd3e602c80>,94,18,[ 2 10],95,-1,113,-1,95
1,<environment.Job instance at 0x7fbd480a1870>,98,14,[9 3],99,-1,113,-1,99
1,<environment.Job instance at 0x7fbd3f4ac410>,108,12,[3 8],109,-1,121,-1,109
1,<environment.Job instance at 0x7fbd3f6a20f0>,104,16,[5 8],105,-1,125,-1,109
1,<environment.Job instance at 0x7fbd4805d820>,102,18,[7 2],103,-1,127,-1,109
1,<environment.Job instance at 0x7fbd3e9f3820>,109,16,[ 3 10],110,-1,136,-1,120
1,<environment.Job instance at 0x7fbd3f260a00>,69,13,[6 1],70,-1,133,-1,120
1,<environment.Job instance at 0x7fbd3ec3c9b0>,113,15,[3 5],114,-1,139,-1,124
1,<environment.Job instance at 0x7fbd3f828e10>,114,13,[6 5],115,-1,139,-1,126
1,<environment.Job instance at 0x7fbd3f2050a0>,116,20,[10  4],117,-1,146,-1,126
1,<environment.Job instance at 0x7fbd3f4aeaa0>,115,13,[6 1],116,-1,139,-1,126
1,<environment.Job instance at 0x7fbd3f061190>,119,13,[3 6],120,-1,139,-1,126
1,<environment.Job instance at 0x7fbd3effd4b0>,125,17,[5 8],126,-1,148,-1,131
1,<environment.Job instance at 0x7fbd3efef870>,111,2,[5 2],112,-1,137,-1,135
1,<environment.Job instance at 0x7fbd3f5c61e0>,131,12,[9 4],132,-1,147,-1,135
1,<environment.Job instance at 0x7fbd3f5c69b0>,132,17,[5 5],133,-1,152,-1,135
1,<environment.Job instance at 0x7fbd3f6c2b40>,133,24,[9 2],134,-1,159,-1,135
1,<environment.Job instance at 0x7fbd3e4d9820>,134,13,[6 5],135,-1,156,-1,143
1,<environment.Job instance at 0x7fbd3f061be0>,120,1,[ 2 10],121,-1,144,-1,143
1,<environment.Job instance at 0x7fbd3e8b2e60>,141,24,[2 6],142,-1,167,-1,143
1,<environment.Job instance at 0x7fbd3f2e26e0>,139,15,[10  5],140,-1,158,-1,143
1,<environment.Job instance at 0x7fbd3e8b20a0>,142,15,[4 9],143,-1,159,-1,144
1,<environment.Job instance at 0x7fbd3f5c6aa0>,130,16,[8 2],131,-1,160,-1,144
1,<environment.Job instance at 0x7fbd3f2e22d0>,140,12,[9 2],141,-1,157,-1,145
1,<environment.Job instance at 0x7fbd3f9732d0>,146,15,[6 4],147,-1,164,-1,149
1,<environment.Job instance at 0x7fbd3f068550>,149,16,[ 1 10],150,-1,166,-1,150
1,<environment.Job instance at 0x7fbd3f0680f0>,153,21,[5 4],154,-1,175,-1,154
1,<environment.Job instance at 0x7fbd3ea018c0>,158,3,[10  4],159,-1,162,-1,159
1,<environment.Job instance at 0x7fbd3f642050>,7,2,[ 5 11],8,-1,10,-1,8
1,<environment.Job instance at 0x7fbd3f09caa0>,8,12,[12  2],9,-1,21,-1,9
1,<environment.Job instance at 0x7fbd3f09ce60>,10,2,[ 4 14],11,-1,13,-1,11
1,<environment.Job instance at 0x7fbd3e8b24b0>,20,25,[8 3],21,-1,57,-1,32
1,<environment.Job instance at 0x7fbd3e7c1370>,21,27,[8 1],22,-1,59,-1,32
1,<environment.Job instance at 0x7fbd3f893320>,27,27,[2 6],28,-1,77,-1,50
1,<environment.Job instance at 0x7fbd3f9efd20>,37,26,[ 5 10],38,-1,98,-1,72
1,<environment.Job instance at 0x7fbd3efed9b0>,39,1,[12  4],40,-1,73,-1,72
1,<environment.Job instance at 0x7fbd3f96c140>,44,1,[ 1 11],45,-1,104,-1,103
1,<environment.Job instance at 0x7fbd3f96cf00>,45,1,[ 3 14],46,-1,104,-1,103
1,<environment.Job instance at 0x7fbd3eb9f190>,52,28,[5 1],53,-1,149,-1,121
1,<environment.Job instance at 0x7fbd3ec5e500>,59,13,[ 1 13],60,-1,154,-1,141
1,<environment.Job instance at 0x7fbd3f205500>,66,3,[14  4],67,-1,161,-1,158
1,<environment.Job instance at 0x7fbd3f8bb500>,64,23,[2 9],65,-1,198,-1,175
1,<environment.Job instance at 0x7fbd3e6b1280>,78,26,[2 5],79,-1,235,-1,209
1,<environment.Job instance at 0x7fbd3f521410>,80,28,[1 5],81,-1,240,-1,212
1,<environment.Job instance at 0x7fbd3e55cc30>,79,28,[4 8],80,-1,249,-1,221
1,<environment.Job instance at 0x7fbd3e2925f0>,87,28,[ 1 10],88,-1,257,-1,229
1,<environment.Job instance at 0x7fbd3ef40eb0>,133,24,[9 2],134,-1,397,-1,373
1,<environment.Job instance at 0x7fbd3ea67f00>,141,24,[2 6],142,-1,417,-1,393
1,<environment.Job instance at 0x7fbd3e78b0f0>,154,17,[11  5],155,-1,446,-1,429
1,<environment.Job instance at 0x7fbd3f93e280>,155,15,[ 2 12],156,-1,444,-1,429
1,<environment.Job instance at 0x7fbd3e6b5820>,2,18,[10  3],3,-1,23,-1,5
1,<environment.Job instance at 0x7fbd3e4dcaf0>,5,1,[1 5],6,-1,7,-1,6
1,<environment.Job instance at 0x7fbd3e4dc8c0>,4,24,[5 8],5,-1,30,-1,6
1,<environment.Job instance at 0x7fbd3e4dcaa0>,7,18,[3 8],8,-1,26,-1,8
1,<environment.Job instance at 0x7fbd3e4dca00>,9,12,[1 5],10,-1,24,-1,12
1,<environment.Job instance at 0x7fbd3e3955a0>,14,18,[1 8],15,-1,33,-1,15
1,<environment.Job instance at 0x7fbd3e395f50>,16,23,[9 5],17,-1,40,-1,17
1,<environment.Job instance at 0x7fbd3e395af0>,17,18,[1 8],18,-1,36,-1,18
1,<environment.Job instance at 0x7fbd3e3959b0>,19,17,[6 3],20,-1,37,-1,20
1,<environment.Job instance at 0x7fbd3e395320>,22,18,[1 6],23,-1,41,-1,23
1,<environment.Job instance at 0x7fbd3e614a50>,23,17,[10  3],24,-1,41,-1,24
1,<environment.Job instance at 0x7fbd3e6147d0>,25,16,[7 4],26,-1,42,-1,26
1,<environment.Job instance at 0x7fbd3e7c6820>,32,17,[6 3],33,-1,50,-1,33
1,<environment.Job instance at 0x7fbd3e7c6500>,33,27,[5 6],34,-1,61,-1,34
1,<environment.Job instance at 0x7fbd3e7c6e10>,36,16,[ 3 11],37,-1,53,-1,37
1,<environment.Job instance at 0x7fbd3ecfb6e0>,41,12,[10  1],42,-1,54,-1,42
1,<environment.Job instance at 0x7fbd3ecfbb90>,42,16,[7 1],43,-1,60,-1,44
1,<environment.Job instance at 0x7fbd3ecfb640>,44,27,[3 8],45,-1,72,-1,45
1,<environment.Job instance at 0x7fbd3ecfb780>,43,13,[6 5],44,-1,58,-1,45
1,<environment.Job instance at 0x7fbd3ecfb5f0>,49,17,[7 5],50,-1,68,-1,51
1,<environment.Job instance at 0x7fbd3e8985a0>,50,18,[12  3],51,-1,70,-1,52
1,<environment.Job instance at 0x7fbd3e898f50>,53,18,[1 8],54,-1,72,-1,54
1,<environment.Job instance at 0x7fbd3e898320>,54,17,[3 6],55,-1,72,-1,55
1,<environment.Job instance at 0x7fbd3e898cd0>,56,15,[8 5],57,-1,74,-1,59
1,<environment.Job instance at 0x7fbd3f4cf960>,59,17,[7 1],60,-1,81,-1,64
1,<environment.Job instance at 0x7fbd3e8989b0>,55,27,[4 6],56,-1,91,-1,64
1,<environment.Job instance at 0x7fbd3f4cf780>,63,12,[9 4],64,-1,76,-1,64
1,<environment.Job instance at 0x7fbd3f4cfb90>,70,14,[11  5],71,-1,86,-1,72
1,<environment.Job instance at 0x7fbd3f4cf910>,61,2,[5 3],62,-1,75,-1,73
1,<environment.Job instance at 0x7fbd3ebcba50>,72,17,[3 8],73,-1,90,-1,73
1,<environment.Job instance at 0x7fbd3f4cfc30>,60,16,[10  3],61,-1,89,-1,73
1,<environment.Job instance at 0x7fbd3f4cff50>,71,13,[ 1 10],72,-1,86,-1,73
1,<environment.Job instance at 0x7fbd3f4cf6e0>,69,13,[4 9],70,-1,86,-1,73
1,<environment.Job instance at 0x7fbd3ebcbd20>,73,14,[4 9],74,-1,88,-1,74
1,<environment.Job instance at 0x7fbd3ebcb9b0>,78,14,[10  3],79,-1,94,-1,80
1,<environment.Job instance at 0x7fbd3ebcb690>,75,13,[ 3 10],76,-1,94,-1,81
1,<environment.Job instance at 0x7fbd3f489410>,81,17,[5 4],82,-1,99,-1,82
1,<environment.Job instance at 0x7fbd3f489460>,80,24,[9 4],81,-1,106,-1,82
1,<environment.Job instance at 0x7fbd3f489e10>,86,18,[10  1],87,-1,105,-1,87
1,<environment.Job instance at 0x7fbd3ecfb4b0>,47,18,[4 5],48,-1,107,-1,89
1,<environment.Job instance at 0x7fbd3f489050>,84,14,[3 7],85,-1,103,-1,89
1,<environment.Job instance at 0x7fbd3f4892d0>,89,15,[ 4 10],90,-1,105,-1,90
1,<environment.Job instance at 0x7fbd3f489fa0>,88,16,[7 1],89,-1,107,-1,91
1,<environment.Job instance at 0x7fbd3f489780>,90,17,[3 8],91,-1,108,-1,91
1,<environment.Job instance at 0x7fbd3f489dc0>,87,12,[3 7],88,-1,104,-1,92
1,<environment.Job instance at 0x7fbd3f489d20>,93,17,[7 3],94,-1,111,-1,94
1,<environment.Job instance at 0x7fbd3f4fea00>,97,18,[3 9],98,-1,116,-1,98
1,<environment.Job instance at 0x7fbd47f6b9b0>,98,12,[3 9],99,-1,111,-1,99
1,<environment.Job instance at 0x7fbd3e07bc30>,103,17,[10  3],104,-1,121,-1,104
1,<environment.Job instance at 0x7fbd3e4c5cd0>,106,16,[2 9],107,-1,123,-1,107
1,<environment.Job instance at 0x7fbd47f6bdc0>,107,22,[10  4],108,-1,130,-1,108
1,<environment.Job instance at 0x7fbd3f427780>,109,3,[4 7],110,-1,127,-1,124
1,<environment.Job instance at 0x7fbd3ebcb370>,74,28,[4 7],75,-1,152,-1,124
1,<environment.Job instance at 0x7fbd3e8472d0>,114,15,[4 8],115,-1,139,-1,124
1,<environment.Job instance at 0x7fbd3f4895f0>,91,16,[12  1],92,-1,140,-1,124
1,<environment.Job instance at 0x7fbd3fa37fa0>,118,3,[14  4],119,-1,127,-1,124
1,<environment.Job instance at 0x7fbd483dbc80>,120,14,[12  5],121,-1,138,-1,124
1,<environment.Job instance at 0x7fbd3efa3640>,119,13,[3 8],120,-1,137,-1,124
1,<environment.Job instance at 0x7fbd3e8f9a50>,122,13,[2 6],123,-1,137,-1,124
1,<environment.Job instance at 0x7fbd3ed38e10>,123,17,[6 4],124,-1,141,-1,124
1,<environment.Job instance at 0x7fbd3f7abd70>,126,21,[10  2],127,-1,149,-1,128
1,<environment.Job instance at 0x7fbd3f6aab90>,127,15,[5 1],128,-1,144,-1,129
1,<environment.Job instance at 0x7fbd3f9ef690>,132,15,[3 8],133,-1,148,-1,133
1,<environment.Job instance at 0x7fbd3f9ef370>,134,16,[8 4],135,-1,151,-1,135
1,<environment.Job instance at 0x7fbd3efcf8c0>,135,12,[6 4],136,-1,149,-1,137
1,<environment.Job instance at 0x7fbd3efcfdc0>,137,14,[7 4],138,-1,152,-1,138
1,<environment.Job instance at 0x7fbd3efcf910>,138,14,[6 4],139,-1,154,-1,140
1,<environment.Job instance at 0x7fbd3f8f0a50>,140,25,[ 4 10],141,-1,166,-1,141
1,<environment.Job instance at 0x7fbd3f8f0fa0>,141,22,[9 1],142,-1,164,-1,142
1,<environment.Job instance at 0x7fbd3f3ccdc0>,142,14,[7 5],143,-1,157,-1,143
1,<environment.Job instance at 0x7fbd3f45f960>,144,14,[ 2 11],145,-1,159,-1,145
1,<environment.Job instance at 0x7fbd3e616eb0>,145,18,[2 9],146,-1,164,-1,146
1,<environment.Job instance at 0x7fbd3e616870>,146,18,[10  3],147,-1,165,-1,147
1,<environment.Job instance at 0x7fbd3e616b90>,147,19,[ 2 10],148,-1,167,-1,148
1,<environment.Job instance at 0x7fbd3eecbf00>,154,16,[2 8],155,-1,174,-1,158
1,<environment.Job instance at 0x7fbd3eecbaa0>,157,17,[ 5 10],158,-1,175,-1,158
1,<environment.Job instance at 0x7fbd3e395370>,4,24,[5 8],5,-1,38,-1,14
1,<environment.Job instance at 0x7fbd3ebcb460>,10,2,[14  3],11,-1,16,-1,14
1,<environment.Job instance at 0x7fbd3e898190>,6,24,[10  2],7,-1,45,-1,21
1,<environment.Job instance at 0x7fbd3efcfc30>,16,23,[9 5],17,-1,72,-1,49
1,<environment.Job instance at 0x7fbd3f061910>,29,1,[13  5],30,-1,70,-1,69
1,<environment.Job instance at 0x7fbd3e6b1280>,33,27,[5 6],34,-1,103,-1,76
1,<environment.Job instance at 0x7fbd3e6b1aa0>,36,16,[ 3 11],37,-1,92,-1,76
1,<environment.Job instance at 0x7fbd3f42cd70>,38,25,[11  1],39,-1,112,-1,87
1,<environment.Job instance at 0x7fbd3ec5ed20>,44,27,[3 8],45,-1,136,-1,109
1,<environment.Job instance at 0x7fbd3e97d280>,50,18,[12  3],51,-1,128,-1,110
1,<environment.Job instance at 0x7fbd3f9ef280>,55,27,[4 6],56,-1,165,-1,138
1,<environment.Job instance at 0x7fbd3ecfbd70>,70,14,[11  5],71,-1,213,-1,199
1,<environment.Job instance at 0x7fbd3e8b24b0>,74,28,[4 7],75,-1,243,-1,215
1,<environment.Job instance at 0x7fbd3f6218c0>,80,24,[9 4],81,-1,266,-1,242
1,<environment.Job instance at 0x7fbd3ec74640>,83,2,[12  3],84,-1,244,-1,242
1,<environment.Job instance at 0x7fbd3f4cc1e0>,91,16,[12  1],92,-1,304,-1,288
1,<environment.Job instance at 0x7fbd3f893320>,118,3,[14  4],119,-1,389,-1,386
1,<environment.Job instance at 0x7fbd3f893230>,120,14,[12  5],121,-1,402,-1,388
1,<environment.Job instance at 0x7fbd3e7c1780>,140,25,[ 4 10],141,-1,478,-1,453
1,<environment.Job instance at 0x7fbd3e7c1d70>,144,14,[ 2 11],145,-1,471,-1,457
1,<environment.Job instance at 0x7fbd3f4fef50>,150,17,[ 5 14],151,-1,502,-1,485
1,<environment.Job instance at 0x7fbd3e587cd0>,15,18,[7 4],16,-1,34,-1,16
1,<environment.Job instance at 0x7fbd3e5849b0>,18,13,[5 4],19,-1,34,-1,21
1,<environment.Job instance at 0x7fbd3f17afa0>,21,15,[5 1],22,-1,37,-1,22
1,<environment.Job instance at 0x7fbd3e2696e0>,25,17,[4 6],26,-1,43,-1,26
1,<environment.Job instance at 0x7fbd3ec58af0>,26,15,[10  5],27,-1,42,-1,27
1,<environment.Job instance at 0x7fbd3f84a0f0>,34,15,[7 5],35,-1,50,-1,35
1,<environment.Job instance at 0x7fbd3e5eb500>,36,15,[5 5],37,-1,55,-1,40
1,<environment.Job instance at 0x7fbd3eef5dc0>,38,12,[3 7],39,-1,53,-1,41
1,<environment.Job instance at 0x7fbd3f882af0>,40,18,[2 9],41,-1,59,-1,41
1,<environment.Job instance at 0x7fbd3e580550>,42,16,[2 8],43,-1,59,-1,43
1,<environment.Job instance at 0x7fbd3f161320>,19,17,[4 6],20,-1,61,-1,44
1,<environment.Job instance at 0x7fbd3f848730>,44,14,[7 2],45,-1,61,-1,47
1,<environment.Job instance at 0x7fbd3f848b90>,49,20,[7 2],50,-1,70,-1,50
1,<environment.Job instance at 0x7fbd3f8487d0>,46,13,[10  2],47,-1,64,-1,51
1,<environment.Job instance at 0x7fbd3f8481e0>,53,15,[9 4],54,-1,69,-1,54
1,<environment.Job instance at 0x7fbd3f851c80>,58,22,[ 3 10],59,-1,83,-1,61
1,<environment.Job instance at 0x7fbd3f851f00>,61,14,[ 5 10],62,-1,79,-1,65
1,<environment.Job instance at 0x7fbd3f851fa0>,62,17,[5 8],63,-1,82,-1,65
1,<environment.Job instance at 0x7fbd3f85d190>,63,14,[5 7],64,-1,79,-1,65
1,<environment.Job instance at 0x7fbd3f85d0f0>,64,19,[3 7],65,-1,84,-1,65
1,<environment.Job instance at 0x7fbd3f851cd0>,57,12,[ 2 10],58,-1,78,-1,66
1,<environment.Job instance at 0x7fbd3e269b90>,24,12,[ 4 13],25,-1,93,-1,81
1,<environment.Job instance at 0x7fbd3f85d320>,69,16,[1 8],70,-1,97,-1,81
1,<environment.Job instance at 0x7fbd3f857e60>,37,17,[9 4],38,-1,100,-1,83
1,<environment.Job instance at 0x7fbd3f85d640>,68,16,[1 9],69,-1,99,-1,83
1,<environment.Job instance at 0x7fbd3e5eb0f0>,6,16,[12  5],7,-1,23,-1,7
1,<environment.Job instance at 0x7fbd3f8482d0>,9,28,[4 8],10,-1,44,-1,16
1,<environment.Job instance at 0x7fbd3ec32140>,24,12,[ 4 13],25,-1,48,-1,36
1,<environment.Job instance at 0x7fbd3e2c0fa0>,30,2,[ 2 12],31,-1,46,-1,44
1,<environment.Job instance at 0x7fbd3e2c04b0>,31,13,[ 3 11],32,-1,57,-1,44
1,<environment.Job instance at 0x7fbd3f09ce60>,45,1,[14  5],46,-1,120,-1,119
1,<environment.Job instance at 0x7fbd3f4897d0>,47,2,[ 5 12],48,-1,132,-1,130
1,<environment.Job instance at 0x7fbd3f9ef2d0>,55,2,[ 2 12],56,-1,160,-1,158
1,<environment.Job instance at 0x7fbd3f9b3320>,60,13,[ 2 13],61,-1,179,-1,166
1,<environment.Job instance at 0x7fbd3f205e10>,67,23,[3 5],68,-1,224,-1,201
1,<environment.Job instance at 0x7fbd3f42ce60>,70,28,[2 6],71,-1,254,-1,226
1,<environment.Job instance at 0x7fbd3e6b5230>,80,1,[13  1],81,-1,248,-1,247
1,<environment.Job instance at 0x7fbd3efcfc30>,79,23,[8 2],80,-1,272,-1,249
1,<environment.Job instance at 0x7fbd3e78b730>,93,15,[ 3 14],94,-1,304,-1,289
1,<environment.Job instance at 0x7fbd3f75f730>,98,3,[13  1],99,-1,318,-1,315
1,<environment.Job instance at 0x7fbd3e677460>,105,15,[14  4],106,-1,349,-1,334
1,<environment.Job instance at 0x7fbd3e677320>,108,27,[6 3],109,-1,378,-1,351
1,<environment.Job instance at 0x7fbd3e677280>,109,27,[3 5],110,-1,378,-1,351
1,<environment.Job instance at 0x7fbd3e6a1370>,112,2,[12  2],113,-1,353,-1,351
1,<environment.Job instance at 0x7fbd3ecfbd70>,120,23,[5 8],121,-1,408,-1,385
1,<environment.Job instance at 0x7fbd3e91a5a0>,127,12,[ 2 14],128,-1,424,-1,412
1,<environment.Job instance at 0x7fbd3e697780>,148,28,[9 5],149,-1,533,-1,505
1,<environment.Job instance at 0x7fbd3f948780>,150,1,[11  1],151,-1,506,-1,505
1,<environment.Job instance at 0x7fbd3efc3730>,2,18,[7 3],3,-1,21,-1,3
1,<environment.Job instance at 0x7fbd3e2bba50>,10,15,[8 2],11,-1,27,-1,12
1,<environment.Job instance at 0x7fbd3e666f00>,11,16,[4 9],12,-1,28,-1,12
1,<environment.Job instance at 0x7fbd3e2bb0a0>,12,15,[9 5],13,-1,29,-1,14
1,<environment.Job instance at 0x7fbd3edc8b40>,16,16,[ 5 10],17,-1,33,-1,17
1,<environment.Job instance at 0x7fbd3edc8370>,17,13,[10  3],18,-1,31,-1,18
1,<environment.Job instance at 0x7fbd3edc8410>,18,18,[10  5],19,-1,37,-1,19
1,<environment.Job instance at 0x7fbd3edc8500>,20,17,[6 4],21,-1,38,-1,21
1,<environment.Job instance at 0x7fbd3edc8d70>,21,23,[9 2],22,-1,45,-1,22
1,<environment.Job instance at 0x7fbd3f15a870>,23,13,[8 4],24,-1,37,-1,24
1,<environment.Job instance at 0x7fbd3e6c2b40>,29,15,[ 5 10],30,-1,52,-1,37
1,<environment.Job instance at 0x7fbd3f740910>,34,14,[5 5],35,-1,58,-1,44
1,<environment.Job instance at 0x7fbd3f8f1af0>,39,17,[11  5],40,-1,63,-1,46
1,<environment.Job instance at 0x7fbd3eef3e10>,37,12,[ 4 10],38,-1,58,-1,46
1,<environment.Job instance at 0x7fbd47f89a50>,42,22,[ 4 11],43,-1,68,-1,46
1,<environment.Job instance at 0x7fbd47f89690>,43,13,[8 4],44,-1,60,-1,47
1,<environment.Job instance at 0x7fbd3f52ae10>,47,14,[4 9],48,-1,62,-1,48
1,<environment.Job instance at 0x7fbd3e2bb3c0>,13,13,[3 7],14,-1,62,-1,49
1,<environment.Job instance at 0x7fbd3ea89eb0>,48,15,[5 4],49,-1,65,-1,50
1,<environment.Job instance at 0x7fbd3e996c30>,50,17,[10  2],51,-1,68,-1,51
1,<environment.Job instance at 0x7fbd3e94ba00>,52,18,[1 5],53,-1,71,-1,53
1,<environment.Job instance at 0x7fbd3e94ba50>,54,22,[7 4],55,-1,77,-1,55
1,<environment.Job instance at 0x7fbd3e94b960>,56,17,[5 8],57,-1,74,-1,57
1,<environment.Job instance at 0x7fbd3f8f1370>,40,18,[3 7],41,-1,75,-1,57
1,<environment.Job instance at 0x7fbd3f065910>,57,16,[5 1],58,-1,74,-1,58
1,<environment.Job instance at 0x7fbd3f0885a0>,60,20,[ 3 10],61,-1,81,-1,61
1,<environment.Job instance at 0x7fbd3ea89f50>,49,13,[ 5 11],50,-1,74,-1,61
1,<environment.Job instance at 0x7fbd3e2c48c0>,64,16,[9 5],65,-1,84,-1,68
1,<environment.Job instance at 0x7fbd3f5faf50>,69,18,[1 9],70,-1,88,-1,70
1,<environment.Job instance at 0x7fbd3e94b4b0>,58,17,[14  2],59,-1,96,-1,79
1,<environment.Job instance at 0x7fbd3ea146e0>,76,14,[ 3 10],77,-1,93,-1,79
1,<environment.Job instance at 0x7fbd3ea14b90>,79,14,[5 4],80,-1,94,-1,80
1,<environment.Job instance at 0x7fbd3ed65190>,78,17,[3 8],79,-1,133,-1,116
1,<environment.Job instance at 0x7fbd3f20dc30>,88,14,[7 1],89,-1,130,-1,116
1,<environment.Job instance at 0x7fbd3ec957d0>,94,21,[1 8],95,-1,137,-1,116
1,<environment.Job instance at 0x7fbd3e443eb0>,97,13,[5 6],98,-1,129,-1,116
1,<environment.Job instance at 0x7fbd3ea910a0>,99,19,[2 5],100,-1,135,-1,116
1,<environment.Job instance at 0x7fbd3e5fa8c0>,92,17,[9 3],93,-1,137,-1,120
1,<environment.Job instance at 0x7fbd3f208af0>,106,14,[4 9],107,-1,134,-1,120
1,<environment.Job instance at 0x7fbd3e334be0>,108,17,[9 3],109,-1,137,-1,120
1,<environment.Job instance at 0x7fbd3f4e32d0>,109,18,[2 7],110,-1,138,-1,120
1,<environment.Job instance at 0x7fbd3e5ecc80>,110,16,[ 1 10],111,-1,136,-1,120
1,<environment.Job instance at 0x7fbd3f4e3280>,111,13,[4 5],112,-1,133,-1,120
1,<environment.Job instance at 0x7fbd3e0f5870>,113,23,[5 6],114,-1,145,-1,122
1,<environment.Job instance at 0x7fbd3f2e24b0>,116,16,[10  2],117,-1,138,-1,122
1,<environment.Job instance at 0x7fbd3f531b90>,89,18,[6 3],90,-1,140,-1,122
1,<environment.Job instance at 0x7fbd4805ed70>,107,17,[10  4],108,-1,139,-1,122
1,<environment.Job instance at 0x7fbd3eb5fe60>,115,2,[3 8],116,-1,124,-1,122
1,<environment.Job instance at 0x7fbd3e2c93c0>,119,17,[10  1],120,-1,139,-1,122
1,<environment.Job instance at 0x7fbd3f9040a0>,127,14,[10  2],128,-1,143,-1,129
1,<environment.Job instance at 0x7fbd3f904b90>,128,15,[5 3],129,-1,145,-1,130
1,<environment.Job instance at 0x7fbd3f057be0>,131,17,[9 4],132,-1,149,-1,132
1,<environment.Job instance at 0x7fbd3ef9bcd0>,135,16,[3 7],136,-1,152,-1,136
1,<environment.Job instance at 0x7fbd3f3fae60>,136,13,[9 1],137,-1,158,-1,145
1,<environment.Job instance at 0x7fbd3f904cd0>,7,1,[ 2 12],8,-1,9,-1,8
1,<environment.Job instance at 0x7fbd3f068be0>,21,23,[9 2],22,-1,75,-1,52
1,<environment.Job instance at 0x7fbd3f621960>,25,25,[ 2 11],26,-1,86,-1,61
1,<environment.Job instance at 0x7fbd3e599c30>,30,14,[13  1],31,-1,87,-1,73
1,<environment.Job instance at 0x7fbd3e7f4e10>,33,12,[12  5],34,-1,98,-1,86
1,<environment.Job instance at 0x7fbd3e5ec9b0>,39,17,[11  5],40,-1,123,-1,106
1,<environment.Job instance at 0x7fbd3ee53320>,42,22,[ 4 11],43,-1,140,-1,118
1,<environment.Job instance at 0x7fbd485b5320>,46,15,[13  2],47,-1,139,-1,124
1,<environment.Job instance at 0x7fbd3e1745a0>,49,13,[ 5 11],50,-1,146,-1,133
1,<environment.Job instance at 0x7fbd3f0b0be0>,53,3,[ 3 14],54,-1,150,-1,147
1,<environment.Job instance at 0x7fbd3e698b40>,58,17,[14  2],59,-1,182,-1,165
1,<environment.Job instance at 0x7fbd3f088910>,62,14,[11  5],63,-1,183,-1,169
1,<environment.Job instance at 0x7fbd3f50e230>,77,1,[12  4],78,-1,222,-1,221
1,<environment.Job instance at 0x7fbd3e371b90>,82,14,[ 2 11],83,-1,252,-1,238
1,<environment.Job instance at 0x7fbd3f43f730>,85,13,[ 3 14],86,-1,264,-1,251
1,<environment.Job instance at 0x7fbd3e16a190>,101,1,[12  1],102,-1,293,-1,292
1,<environment.Job instance at 0x7fbd3e16a280>,103,3,[ 3 12],104,-1,296,-1,293
1,<environment.Job instance at 0x7fbd3e9f35f0>,113,23,[5 6],114,-1,366,-1,343
1,<environment.Job instance at 0x7fbd4805ec80>,120,2,[13  2],121,-1,363,-1,361
1,<environment.Job instance at 0x7fbd3f58bfa0>,123,1,[14  1],124,-1,367,-1,366
1,<environment.Job instance at 0x7fbd3f893870>,138,2,[ 4 11],139,-1,433,-1,431
1,<environment.Job instance at 0x7fbd3ed144b0>,140,12,[ 1 14],141,-1,443,-1,431
1,<environment.Job instance at 0x7fbd3ed14cd0>,142,2,[ 1 14],143,-1,446,-1,444
1,<environment.Job instance at 0x7fbd3ed14320>,144,24,[4 8],145,-1,473,-1,449
1,<environment.Job instance at 0x7fbd3ed14c80>,146,23,[9 2],147,-1,483,-1,460
1,<environment.Job instance at 0x7fbd4868c6e0>,149,27,[ 5 10],150,-1,506,-1,479
1,<environment.Job instance at 0x7fbd3f933500>,150,28,[8 5],151,-1,519,-1,491
1,<environment.Job instance at 0x7fbd3f860a50>,153,17,[ 5 12],154,-1,508,-1,491
1,<environment.Job instance at 0x7fbd3f860f50>,154,18,[ 4 13],155,-1,509,-1,491
1,<environment.Job instance at 0x7fbd3f4615a0>,1,16,[4 7],2,-1,18,-1,2
1,<environment.Job instance at 0x7fbd3f461f00>,2,17,[10  4],3,-1,20,-1,3
1,<environment.Job instance at 0x7fbd3ec3d5f0>,8,18,[4 7],9,-1,27,-1,9
1,<environment.Job instance at 0x7fbd3e115b40>,9,15,[7 2],10,-1,25,-1,10
1,<environment.Job instance at 0x7fbd3ee056e0>,10,21,[9 2],11,-1,32,-1,11
1,<environment.Job instance at 0x7fbd3ee05910>,13,18,[ 4 10],14,-1,32,-1,14
1,<environment.Job instance at 0x7fbd3ee05960>,14,15,[3 5],15,-1,30,-1,15
1,<environment.Job instance at 0x7fbd3ee05dc0>,16,26,[3 5],17,-1,43,-1,17
1,<environment.Job instance at 0x7fbd3ee05cd0>,17,24,[9 4],18,-1,42,-1,18
1,<environment.Job instance at 0x7fbd3ee05aa0>,20,15,[1 8],21,-1,36,-1,21
1,<environment.Job instance at 0x7fbd3ee05a50>,21,14,[6 4],22,-1,36,-1,22
1,<environment.Job instance at 0x7fbd3ee05460>,24,17,[3 5],25,-1,42,-1,25
1,<environment.Job instance at 0x7fbd3ea92640>,25,18,[ 3 10],26,-1,44,-1,26
1,<environment.Job instance at 0x7fbd3e180aa0>,32,13,[9 5],33,-1,47,-1,34
1,<environment.Job instance at 0x7fbd3e914460>,37,17,[8 4],38,-1,55,-1,38
1,<environment.Job instance at 0x7fbd3f626460>,39,14,[1 5],40,-1,54,-1,40
1,<environment.Job instance at 0x7fbd3f626e10>,41,16,[1 8],42,-1,58,-1,42
1,<environment.Job instance at 0x7fbd3f6269b0>,43,24,[5 1],44,-1,68,-1,44
1,<environment.Job instance at 0x7fbd3e180050>,33,12,[ 3 10],34,-1,56,-1,44
1,<environment.Job instance at 0x7fbd3f0e1cd0>,45,22,[5 4],46,-1,68,-1,46
1,<environment.Job instance at 0x7fbd3f0e13c0>,46,28,[8 5],47,-1,75,-1,47
1,<environment.Job instance at 0x7fbd3e8aa780>,50,18,[5 8],51,-1,69,-1,51
1,<environment.Job instance at 0x7fbd3e8aa050>,54,25,[9 4],55,-1,80,-1,55
1,<environment.Job instance at 0x7fbd3f1691e0>,60,14,[9 4],61,-1,75,-1,61
1,<environment.Job instance at 0x7fbd3f1695a0>,61,17,[6 2],62,-1,79,-1,62
1,<environment.Job instance at 0x7fbd3e2656e0>,69,15,[10  5],70,-1,85,-1,70
1,<environment.Job instance at 0x7fbd3e5d4690>,77,17,[2 8],78,-1,96,-1,79
1,<environment.Job instance at 0x7fbd3ec95550>,79,24,[9 1],80,-1,104,-1,80
1,<environment.Job instance at 0x7fbd3ec950f0>,81,18,[8 2],82,-1,100,-1,82
1,<environment.Job instance at 0x7fbd3e4dc190>,82,16,[ 1 10],83,-1,99,-1,83
1,<environment.Job instance at 0x7fbd3e4dc3c0>,83,15,[4 8],84,-1,99,-1,84
1,<environment.Job instance at 0x7fbd3e8906e0>,85,14,[5 5],86,-1,100,-1,86
1,<environment.Job instance at 0x7fbd3e890a50>,87,17,[2 5],88,-1,105,-1,88
1,<environment.Job instance at 0x7fbd3e5eca00>,89,17,[9 4],90,-1,107,-1,90
1,<environment.Job instance at 0x7fbd3e5ecbe0>,90,15,[10  4],91,-1,106,-1,91
1,<environment.Job instance at 0x7fbd3e5ec5f0>,91,16,[5 1],92,-1,108,-1,92
1,<environment.Job instance at 0x7fbd3e5ec0f0>,92,14,[1 8],93,-1,107,-1,93
1,<environment.Job instance at 0x7fbd3e5ecb90>,93,17,[7 4],94,-1,111,-1,94
1,<environment.Job instance at 0x7fbd3e314780>,99,13,[5 3],100,-1,113,-1,100
1,<environment.Job instance at 0x7fbd3e314460>,101,23,[5 2],102,-1,125,-1,102
1,<environment.Job instance at 0x7fbd3f626eb0>,16,26,[3 5],17,-1,69,-1,43
1,<environment.Job instance at 0x7fbd3f626870>,17,24,[9 4],18,-1,82,-1,58
1,<environment.Job instance at 0x7fbd3efdd0a0>,28,1,[12  1],29,-1,87,-1,86
1,<environment.Job instance at 0x7fbd3ec95c80>,43,24,[5 1],44,-1,152,-1,128
1,<environment.Job instance at 0x7fbd3f9b1dc0>,46,28,[8 5],47,-1,157,-1,129
1,<environment.Job instance at 0x7fbd3e5ecf00>,54,25,[9 4],55,-1,173,-1,148
1,<environment.Job instance at 0x7fbd3efe6140>,56,18,[11  2],57,-1,166,-1,148
1,<environment.Job instance at 0x7fbd3efed870>,58,15,[ 1 14],59,-1,163,-1,148
1,<environment.Job instance at 0x7fbd4837c410>,63,2,[ 2 13],64,-1,164,-1,162
1,<environment.Job instance at 0x7fbd3f812780>,75,27,[4 6],76,-1,232,-1,205
1,<environment.Job instance at 0x7fbd3f04a550>,79,24,[9 1],80,-1,242,-1,218
1,<environment.Job instance at 0x7fbd3e563a00>,88,1,[ 2 12],89,-1,240,-1,239
1,<environment.Job instance at 0x7fbd3eca3550>,96,13,[11  2],97,-1,297,-1,284
1,<environment.Job instance at 0x7fbd3f232500>,101,23,[5 2],102,-1,323,-1,300
1,<environment.Job instance at 0x7fbd3f174d20>,102,17,[ 5 14],103,-1,317,-1,300
1,<environment.Job instance at 0x7fbd3f174e10>,103,28,[10  4],104,-1,328,-1,300
1,<environment.Job instance at 0x7fbd3f104960>,108,18,[ 4 13],109,-1,320,-1,302
1,<environment.Job instance at 0x7fbd3ee74730>,144,24,[5 9],145,-1,476,-1,452
1,<environment.Job instance at 0x7fbd3ee74c30>,146,28,[9 5],147,-1,480,-1,452
1,<environment.Job instance at 0x7fbd3f8f46e0>,3,18,[2 6],4,-1,22,-1,4
1,<environment.Job instance at 0x7fbd3f8f4e60>,7,18,[3 8],8,-1,26,-1,8
1,<environment.Job instance at 0x7fbd3f8f4140>,9,15,[10  3],10,-1,26,-1,11
1,<environment.Job instance at 0x7fbd3f8f45a0>,11,17,[9 5],12,-1,29,-1,12
1,<environment.Job instance at 0x7fbd3e9e52d0>,12,19,[1 5],13,-1,32,-1,13
1,<environment.Job instance at 0x7fbd3e9e5be0>,15,16,[ 4 10],16,-1,32,-1,16
1,<environment.Job instance at 0x7fbd3ea1abe0>,19,14,[9 3],20,-1,34,-1,20
1,<environment.Job instance at 0x7fbd3ea1afa0>,21,14,[7 4],22,-1,36,-1,22
1,<environment.Job instance at 0x7fbd3ea1a820>,22,12,[2 8],23,-1,35,-1,23
1,<environment.Job instance at 0x7fbd3ea1a8c0>,23,23,[5 6],24,-1,47,-1,24
1,<environment.Job instance at 0x7fbd3e747140>,24,15,[5 2],25,-1,40,-1,25
1,<environment.Job instance at 0x7fbd3ea7e870>,25,14,[1 5],26,-1,40,-1,26
1,<environment.Job instance at 0x7fbd3ea7e8c0>,27,12,[6 5],28,-1,41,-1,29
1,<environment.Job instance at 0x7fbd3ea7e910>,28,28,[3 8],29,-1,57,-1,29
1,<environment.Job instance at 0x7fbd3ea7e410>,29,16,[ 5 10],30,-1,46,-1,30
1,<environment.Job instance at 0x7fbd3f230370>,33,23,[5 7],34,-1,57,-1,34
1,<environment.Job instance at 0x7fbd3f2306e0>,34,28,[8 5],35,-1,63,-1,35
1,<environment.Job instance at 0x7fbd3f230280>,36,23,[3 7],37,-1,60,-1,37
1,<environment.Job instance at 0x7fbd3f230640>,37,24,[2 9],38,-1,62,-1,38
1,<environment.Job instance at 0x7fbd3f230910>,38,17,[8 1],39,-1,57,-1,40
1,<environment.Job instance at 0x7fbd3f230960>,40,15,[7 4],41,-1,56,-1,41
1,<environment.Job instance at 0x7fbd3e92a4b0>,43,12,[ 4 13],44,-1,56,-1,44
1,<environment.Job instance at 0x7fbd3e92af00>,44,20,[1 9],45,-1,65,-1,45
1,<environment.Job instance at 0x7fbd3f948870>,48,17,[1 8],49,-1,66,-1,49
1,<environment.Job instance at 0x7fbd3f2303c0>,39,22,[5 3],40,-1,71,-1,49
1,<environment.Job instance at 0x7fbd3f948eb0>,51,16,[5 8],52,-1,70,-1,54
1,<environment.Job instance at 0x7fbd3f9487d0>,53,26,[6 4],54,-1,80,-1,54
1,<environment.Job instance at 0x7fbd3f948e10>,55,12,[9 1],56,-1,69,-1,57
1,<environment.Job instance at 0x7fbd3f948b90>,56,24,[10  1],57,-1,81,-1,57
1,<environment.Job instance at 0x7fbd3f948280>,57,17,[ 3 10],58,-1,80,-1,63
1,<environment.Job instance at 0x7fbd3e9fb280>,66,26,[8 4],67,-1,294,-1,268
1,<environment.Job instance at 0x7fbd3e92c3c0>,71,27,[7 5],72,-1,297,-1,270
1,<environment.Job instance at 0x7fbd3e8af9b0>,100,27,[7 2],101,-1,297,-1,270
1,<environment.Job instance at 0x7fbd3e8af960>,99,18,[5 4],100,-1,288,-1,270
1,<environment.Job instance at 0x7fbd3e677af0>,92,18,[3 8],93,-1,288,-1,270
1,<environment.Job instance at 0x7fbd3e8af0a0>,105,15,[ 5 13],106,-1,285,-1,270
1,<environment.Job instance at 0x7fbd3e8af320>,101,26,[ 5 11],102,-1,296,-1,270
1,<environment.Job instance at 0x7fbd3f753f50>,122,17,[9 5],123,-1,348,-1,331
1,<environment.Job instance at 0x7fbd48059a00>,133,24,[10  4],134,-1,356,-1,332
1,<environment.Job instance at 0x7fbd3f7535a0>,121,17,[4 8],122,-1,350,-1,333
1,<environment.Job instance at 0x7fbd3e9fbcd0>,68,18,[12  4],69,-1,353,-1,335
1,<environment.Job instance at 0x7fbd47f897d0>,141,21,[2 7],142,-1,357,-1,336
1,<environment.Job instance at 0x7fbd47f892d0>,142,17,[7 2],143,-1,353,-1,336
1,<environment.Job instance at 0x7fbd3edf4c80>,143,14,[7 2],144,-1,350,-1,336
1,<environment.Job instance at 0x7fbd3ed937d0>,144,13,[2 8],145,-1,349,-1,336
1,<environment.Job instance at 0x7fbd4833d460>,145,17,[6 3],146,-1,353,-1,336
1,<environment.Job instance at 0x7fbd47fb6fa0>,146,12,[ 4 10],147,-1,348,-1,336
1,<environment.Job instance at 0x7fbd3f89f460>,147,14,[9 4],148,-1,350,-1,336
1,<environment.Job instance at 0x7fbd3f89f640>,148,18,[8 3],149,-1,354,-1,336
1,<environment.Job instance at 0x7fbd3f89f3c0>,149,16,[ 4 10],150,-1,355,-1,339
1,<environment.Job instance at 0x7fbd3ebaa690>,152,18,[3 8],153,-1,358,-1,340
1,<environment.Job instance at 0x7fbd3e3d4550>,114,13,[2 9],115,-1,353,-1,340
1,<environment.Job instance at 0x7fbd3e2e5aa0>,128,21,[5 3],129,-1,361,-1,340
1,<environment.Job instance at 0x7fbd3ecba870>,154,12,[7 2],155,-1,352,-1,340
1,<environment.Job instance at 0x7fbd3f16eaa0>,157,13,[ 5 10],158,-1,353,-1,340
1,<environment.Job instance at 0x7fbd3f7b5c30>,158,12,[ 2 12],159,-1,352,-1,340
1,<environment.Job instance at 0x7fbd3e9fbdc0>,65,16,[ 4 13],66,-1,356,-1,340
1,<environment.Job instance at 0x7fbd3e2e5050>,16,14,[14  5],17,-1,43,-1,29
1,<environment.Job instance at 0x7fbd3ec285f0>,23,23,[5 6],24,-1,93,-1,70
1,<environment.Job instance at 0x7fbd3ee74140>,28,28,[3 8],29,-1,112,-1,84
1,<environment.Job instance at 0x7fbd3f232140>,33,23,[5 7],34,-1,115,-1,92
1,<environment.Job instance at 0x7fbd3f232dc0>,34,28,[8 5],35,-1,120,-1,92
1,<environment.Job instance at 0x7fbd3eef3a50>,36,23,[3 7],37,-1,116,-1,93
1,<environment.Job instance at 0x7fbd3eef32d0>,37,24,[2 9],38,-1,126,-1,102
1,<environment.Job instance at 0x7fbd3e562230>,42,23,[13  5],43,-1,130,-1,107
1,<environment.Job instance at 0x7fbd3fa4f280>,43,12,[ 4 13],44,-1,119,-1,107
1,<environment.Job instance at 0x7fbd3f04a280>,47,20,[ 5 12],48,-1,135,-1,115
1,<environment.Job instance at 0x7fbd3f812780>,53,26,[6 4],54,-1,161,-1,135
1,<environment.Job instance at 0x7fbd3f812460>,56,24,[10  1],57,-1,163,-1,139
1,<environment.Job instance at 0x7fbd3f9eff50>,63,17,[11  1],64,-1,181,-1,164
1,<environment.Job instance at 0x7fbd3f9ef460>,65,16,[ 4 13],66,-1,181,-1,165
1,<environment.Job instance at 0x7fbd3f9efa00>,66,26,[8 4],67,-1,191,-1,165
1,<environment.Job instance at 0x7fbd3efed870>,68,18,[12  4],69,-1,183,-1,165
1,<environment.Job instance at 0x7fbd3f6216e0>,71,27,[7 5],72,-1,200,-1,173
1,<environment.Job instance at 0x7fbd3f621960>,77,15,[11  5],78,-1,211,-1,196
1,<environment.Job instance at 0x7fbd3e97d2d0>,81,3,[12  3],82,-1,212,-1,209
1,<environment.Job instance at 0x7fbd3e97d780>,82,3,[14  3],83,-1,212,-1,209
1,<environment.Job instance at 0x7fbd3e392d20>,86,25,[6 1],87,-1,241,-1,216
1,<environment.Job instance at 0x7fbd3e392eb0>,91,18,[ 3 12],92,-1,244,-1,226
1,<environment.Job instance at 0x7fbd3f904e10>,96,26,[8 5],97,-1,283,-1,257
1,<environment.Job instance at 0x7fbd3f904aa0>,100,27,[7 2],101,-1,296,-1,269
1,<environment.Job instance at 0x7fbd3f904230>,101,26,[ 5 11],102,-1,295,-1,269
1,<environment.Job instance at 0x7fbd3ee4a050>,105,15,[ 5 13],106,-1,285,-1,270
1,<environment.Job instance at 0x7fbd3ee4a820>,108,12,[12  3],109,-1,296,-1,284
1,<environment.Job instance at 0x7fbd3ee4ad20>,115,12,[14  1],116,-1,312,-1,300
1,<environment.Job instance at 0x7fbd3ee4a3c0>,117,16,[ 2 12],118,-1,316,-1,300
1,<environment.Job instance at 0x7fbd3ee4a140>,119,2,[ 1 11],120,-1,315,-1,313
1,<environment.Job instance at 0x7fbd3ee732d0>,133,24,[10  4],134,-1,367,-1,343
1,<environment.Job instance at 0x7fbd3e82d4b0>,137,2,[ 3 11],138,-1,348,-1,346
1,<environment.Job instance at 0x7fbd3e82d0f0>,155,25,[8 3],156,-1,440,-1,415
1,<environment.Job instance at 0x7fbd3ea08910>,158,12,[ 2 12],159,-1,439,-1,427
1,<environment.Job instance at 0x7fbd3e64f280>,6,19,[4 6],7,-1,26,-1,7
1,<environment.Job instance at 0x7fbd3e64f500>,9,21,[ 5 10],10,-1,31,-1,10
1,<environment.Job instance at 0x7fbd3e64f0a0>,11,18,[1 9],12,-1,30,-1,12
1,<environment.Job instance at 0x7fbd3e64f690>,13,21,[5 5],14,-1,35,-1,14
1,<environment.Job instance at 0x7fbd3e64fbe0>,17,16,[6 5],18,-1,34,-1,18
1,<environment.Job instance at 0x7fbd3e64fc80>,18,12,[9 5],19,-1,32,-1,20
1,<environment.Job instance at 0x7fbd3e64fe10>,20,18,[9 1],21,-1,39,-1,21
1,<environment.Job instance at 0x7fbd3e64fd20>,19,12,[ 5 10],20,-1,33,-1,21
1,<environment.Job instance at 0x7fbd3e6490f0>,23,27,[4 6],24,-1,51,-1,24
1,<environment.Job instance at 0x7fbd3e649190>,25,17,[10  2],26,-1,45,-1,28
1,<environment.Job instance at 0x7fbd3e649550>,28,14,[5 1],29,-1,43,-1,29
1,<environment.Job instance at 0x7fbd3e6495f0>,29,12,[6 2],30,-1,42,-1,30
1,<environment.Job instance at 0x7fbd3e649690>,30,3,[ 1 14],31,-1,34,-1,31
1,<environment.Job instance at 0x7fbd3e649730>,31,1,[10  3],32,-1,33,-1,32
1,<environment.Job instance at 0x7fbd3e6497d0>,32,1,[10  1],33,-1,34,-1,33
1,<environment.Job instance at 0x7fbd3e649870>,33,13,[8 5],34,-1,47,-1,34
1,<environment.Job instance at 0x7fbd3e649320>,26,16,[ 5 10],27,-1,51,-1,35
1,<environment.Job instance at 0x7fbd3e649a50>,36,16,[4 8],37,-1,53,-1,37
1,<environment.Job instance at 0x7fbd3e6499b0>,37,28,[8 2],38,-1,66,-1,38
1,<environment.Job instance at 0x7fbd3e649b40>,38,22,[5 8],39,-1,61,-1,39
1,<environment.Job instance at 0x7fbd3e649d70>,39,15,[8 3],40,-1,56,-1,41
1,<environment.Job instance at 0x7fbd3e649c80>,40,18,[7 4],41,-1,59,-1,41
1,<environment.Job instance at 0x7fbd3f20dcd0>,45,18,[5 9],46,-1,64,-1,46
1,<environment.Job instance at 0x7fbd3e627d70>,47,18,[7 1],48,-1,68,-1,50
1,<environment.Job instance at 0x7fbd3e6279b0>,49,17,[6 3],50,-1,67,-1,50
1,<environment.Job instance at 0x7fbd3e627b40>,52,14,[10  1],53,-1,71,-1,57
1,<environment.Job instance at 0x7fbd3e627460>,56,16,[3 5],57,-1,74,-1,58
1,<environment.Job instance at 0x7fbd3e9bffa0>,64,17,[7 5],65,-1,82,-1,65
1,<environment.Job instance at 0x7fbd3e836370>,66,21,[8 5],67,-1,92,-1,71
1,<environment.Job instance at 0x7fbd3e09faf0>,70,26,[6 1],71,-1,102,-1,76
1,<environment.Job instance at 0x7fbd3f597780>,79,24,[9 1],80,-1,104,-1,80
1,<environment.Job instance at 0x7fbd3f597b40>,83,25,[3 7],84,-1,109,-1,84
1,<environment.Job instance at 0x7fbd3f5972d0>,84,13,[ 2 13],85,-1,111,-1,98
1,<environment.Job instance at 0x7fbd3f597af0>,86,20,[12  4],87,-1,118,-1,98
1,<environment.Job instance at 0x7fbd3e65a7d0>,91,17,[10  4],92,-1,117,-1,100
1,<environment.Job instance at 0x7fbd3e65aaa0>,94,18,[6 3],95,-1,119,-1,101
1,<environment.Job instance at 0x7fbd3f5af780>,69,28,[3 6],70,-1,129,-1,101
1,<environment.Job instance at 0x7fbd3e65aa00>,96,14,[6 2],97,-1,115,-1,101
1,<environment.Job instance at 0x7fbd3e627d20>,51,15,[14  2],52,-1,116,-1,101
1,<environment.Job instance at 0x7fbd3f5970f0>,90,15,[13  3],91,-1,116,-1,101
1,<environment.Job instance at 0x7fbd3e65a690>,97,1,[6 3],98,-1,102,-1,101
1,<environment.Job instance at 0x7fbd3e65a230>,98,15,[13  1],99,-1,120,-1,105
1,<environment.Job instance at 0x7fbd3e65a370>,100,20,[6 3],101,-1,125,-1,105
1,<environment.Job instance at 0x7fbd3e65af50>,99,25,[9 3],100,-1,130,-1,105
1,<environment.Job instance at 0x7fbd3e65ad70>,95,26,[7 2],96,-1,131,-1,105
1,<environment.Job instance at 0x7fbd3e6440a0>,103,16,[1 7],104,-1,121,-1,105
1,<environment.Job instance at 0x7fbd3f594b90>,105,15,[9 1],106,-1,121,-1,106
1,<environment.Job instance at 0x7fbd3f594be0>,106,16,[8 3],107,-1,123,-1,107
1,<environment.Job instance at 0x7fbd3f594e10>,107,18,[2 7],108,-1,126,-1,108
1,<environment.Job instance at 0x7fbd3f594aa0>,108,17,[3 5],109,-1,128,-1,111
1,<environment.Job instance at 0x7fbd3e647dc0>,113,18,[5 5],114,-1,132,-1,114
1,<environment.Job instance at 0x7fbd3f5b4140>,117,15,[2 9],118,-1,134,-1,119
1,<environment.Job instance at 0x7fbd3e647be0>,112,28,[9 5],113,-1,147,-1,119
1,<environment.Job instance at 0x7fbd3f5b4280>,116,15,[ 5 10],117,-1,134,-1,119
1,<environment.Job instance at 0x7fbd3f5b4b40>,119,18,[3 8],120,-1,138,-1,120
1,<environment.Job instance at 0x7fbd3f5b4a00>,120,15,[3 9],121,-1,136,-1,121
1,<environment.Job instance at 0x7fbd3f5b4820>,121,1,[4 8],122,-1,123,-1,122
1,<environment.Job instance at 0x7fbd3f5b4aa0>,122,13,[ 4 10],123,-1,136,-1,123
1,<environment.Job instance at 0x7fbd3f5b4e10>,123,2,[7 3],124,-1,126,-1,124
1,<environment.Job instance at 0x7fbd3f5b4460>,125,14,[10  1],126,-1,140,-1,126
1,<environment.Job instance at 0x7fbd3f5b40a0>,127,28,[4 9],128,-1,156,-1,128
1,<environment.Job instance at 0x7fbd3f5b49b0>,128,17,[5 5],129,-1,146,-1,129
1,<environment.Job instance at 0x7fbd3f5b4870>,129,1,[9 1],130,-1,131,-1,130
1,<environment.Job instance at 0x7fbd3e647190>,110,17,[ 1 10],111,-1,147,-1,130
1,<environment.Job instance at 0x7fbd3f5b4640>,130,16,[7 5],131,-1,148,-1,132
1,<environment.Job instance at 0x7fbd3f5a3fa0>,133,17,[3 7],134,-1,151,-1,134
1,<environment.Job instance at 0x7fbd3f5b4b90>,131,14,[5 8],132,-1,149,-1,135
1,<environment.Job instance at 0x7fbd3f5a3b40>,139,17,[10  4],140,-1,157,-1,140
1,<environment.Job instance at 0x7fbd3f5a3f50>,141,26,[3 8],142,-1,192,-1,166
1,<environment.Job instance at 0x7fbd3f5a1a50>,157,17,[7 5],158,-1,194,-1,177
1,<environment.Job instance at 0x7fbd3e636550>,154,24,[ 3 10],155,-1,202,-1,178
1,<environment.Job instance at 0x7fbd3f5b4050>,23,27,[4 6],24,-1,75,-1,48
1,<environment.Job instance at 0x7fbd3f5a3690>,30,3,[ 1 14],31,-1,65,-1,62
1,<environment.Job instance at 0x7fbd3e65fcd0>,34,1,[ 2 11],35,-1,85,-1,84
1,<environment.Job instance at 0x7fbd3e82d280>,37,28,[8 2],38,-1,127,-1,99
1,<environment.Job instance at 0x7fbd3e82d370>,41,28,[ 3 10],42,-1,137,-1,109
1,<environment.Job instance at 0x7fbd3ee73960>,51,15,[14  2],52,-1,150,-1,135
1,<environment.Job instance at 0x7fbd3ee4a7d0>,61,12,[11  3],62,-1,184,-1,172
1,<environment.Job instance at 0x7fbd3ee4a2d0>,70,26,[6 1],71,-1,229,-1,203
1,<environment.Job instance at 0x7fbd3ee4a910>,71,2,[ 4 13],72,-1,205,-1,203
1,<environment.Job instance at 0x7fbd3ee4ac30>,69,28,[3 6],70,-1,231,-1,203
1,<environment.Job instance at 0x7fbd3ee4aa50>,79,24,[9 1],80,-1,245,-1,221
1,<environment.Job instance at 0x7fbd3f904dc0>,84,13,[ 2 13],85,-1,237,-1,224
1,<environment.Job instance at 0x7fbd3f904af0>,83,25,[3 7],84,-1,251,-1,226
1,<environment.Job instance at 0x7fbd3f904500>,86,20,[12  4],87,-1,246,-1,226
1,<environment.Job instance at 0x7fbd3e392b40>,90,15,[13  3],91,-1,242,-1,227
1,<environment.Job instance at 0x7fbd3e392960>,95,26,[7 2],96,-1,271,-1,245
1,<environment.Job instance at 0x7fbd3e392af0>,98,15,[13  1],99,-1,272,-1,257
1,<environment.Job instance at 0x7fbd3e97d5a0>,99,25,[9 3],100,-1,283,-1,258
1,<environment.Job instance at 0x7fbd3efed3c0>,112,28,[9 5],113,-1,338,-1,310
1,<environment.Job instance at 0x7fbd3f8125f0>,127,28,[4 9],128,-1,400,-1,372
1,<environment.Job instance at 0x7fbd3eef3a50>,135,18,[ 5 11],136,-1,413,-1,395
1,<environment.Job instance at 0x7fbd3f232f00>,141,26,[3 8],142,-1,438,-1,412
1,<environment.Job instance at 0x7fbd3f916af0>,143,17,[ 5 13],144,-1,429,-1,412
1,<environment.Job instance at 0x7fbd3ee740a0>,149,2,[ 1 14],150,-1,421,-1,419
1,<environment.Job instance at 0x7fbd3e2e52d0>,154,24,[ 3 10],155,-1,463,-1,439
1,<environment.Job instance at 0x7fbd3e2e55a0>,158,24,[10  5],159,-1,493,-1,469
1,<environment.Job instance at 0x7fbd3e639640>,3,19,[5 5],4,-1,23,-1,4
1,<environment.Job instance at 0x7fbd3e639190>,4,16,[1 7],5,-1,21,-1,5
1,<environment.Job instance at 0x7fbd3e6392d0>,8,15,[4 7],9,-1,24,-1,9
1,<environment.Job instance at 0x7fbd3e639be0>,10,17,[9 5],11,-1,28,-1,11
1,<environment.Job instance at 0x7fbd3ea13640>,11,14,[5 4],12,-1,26,-1,12
1,<environment.Job instance at 0x7fbd3ea13820>,12,12,[1 5],13,-1,26,-1,14
1,<environment.Job instance at 0x7fbd3ea139b0>,14,14,[9 2],15,-1,29,-1,15
1,<environment.Job instance at 0x7fbd3ea133c0>,15,3,[ 4 13],16,-1,19,-1,16
1,<environment.Job instance at 0x7fbd3ea132d0>,16,28,[2 6],17,-1,45,-1,17
1,<environment.Job instance at 0x7fbd3ea13230>,17,15,[3 7],18,-1,33,-1,18
1,<environment.Job instance at 0x7fbd3ea13370>,18,3,[8 3],19,-1,22,-1,19
1,<environment.Job instance at 0x7fbd3ea131e0>,19,26,[10  1],20,-1,46,-1,20
1,<environment.Job instance at 0x7fbd3ea23f50>,20,14,[6 3],21,-1,35,-1,21
1,<environment.Job instance at 0x7fbd3ea23410>,21,16,[9 2],22,-1,38,-1,22
1,<environment.Job instance at 0x7fbd3ea23500>,22,14,[2 8],23,-1,37,-1,23
1,<environment.Job instance at 0x7fbd3e627500>,13,20,[1 7],14,-1,44,-1,24
1,<environment.Job instance at 0x7fbd3e08dfa0>,25,16,[7 4],26,-1,43,-1,27
1,<environment.Job instance at 0x7fbd3ea211e0>,32,16,[1 7],33,-1,49,-1,33
1,<environment.Job instance at 0x7fbd3ea21b90>,33,15,[7 1],34,-1,50,-1,35
1,<environment.Job instance at 0x7fbd3e0954b0>,35,3,[2 8],36,-1,39,-1,36
1,<environment.Job instance at 0x7fbd3e095730>,38,26,[5 7],39,-1,65,-1,39
1,<environment.Job instance at 0x7fbd3e095f50>,39,28,[ 4 10],40,-1,68,-1,40
1,<environment.Job instance at 0x7fbd3e095e60>,43,13,[9 5],44,-1,57,-1,44
1,<environment.Job instance at 0x7fbd3e9f1140>,45,23,[ 3 10],46,-1,69,-1,46
1,<environment.Job instance at 0x7fbd3e9f1f50>,46,17,[9 2],47,-1,64,-1,47
1,<environment.Job instance at 0x7fbd3e9f1eb0>,50,18,[5 7],51,-1,69,-1,51
1,<environment.Job instance at 0x7fbd3e9f1500>,51,14,[1 9],52,-1,66,-1,52
1,<environment.Job instance at 0x7fbd3e9f1a00>,52,14,[5 8],53,-1,67,-1,53
1,<environment.Job instance at 0x7fbd3e9f16e0>,57,18,[10  1],58,-1,76,-1,58
1,<environment.Job instance at 0x7fbd3e9f1910>,58,14,[9 1],59,-1,73,-1,59
1,<environment.Job instance at 0x7fbd3e9f1550>,59,17,[2 7],60,-1,77,-1,60
1,<environment.Job instance at 0x7fbd3e09f8c0>,60,23,[7 1],61,-1,84,-1,61
1,<environment.Job instance at 0x7fbd3e09fa50>,61,17,[1 7],62,-1,79,-1,62
1,<environment.Job instance at 0x7fbd3e09f370>,63,14,[7 3],64,-1,78,-1,64
1,<environment.Job instance at 0x7fbd3e09fc80>,65,21,[5 2],66,-1,87,-1,66
1,<environment.Job instance at 0x7fbd3ea21e60>,34,13,[5 9],35,-1,111,-1,98
1,<environment.Job instance at 0x7fbd3e06de60>,73,18,[5 9],74,-1,116,-1,98
1,<environment.Job instance at 0x7fbd3e06d320>,78,27,[1 8],79,-1,125,-1,98
1,<environment.Job instance at 0x7fbd3e06df00>,77,18,[3 5],78,-1,123,-1,105
1,<environment.Job instance at 0x7fbd3e06d690>,82,18,[10  5],83,-1,123,-1,105
1,<environment.Job instance at 0x7fbd3e06d410>,83,17,[5 5],84,-1,122,-1,105
1,<environment.Job instance at 0x7fbd3e0698c0>,99,16,[9 2],100,-1,171,-1,155
1,<environment.Job instance at 0x7fbd3e069820>,97,15,[10  3],98,-1,170,-1,155
1,<environment.Job instance at 0x7fbd3e069370>,101,14,[ 2 10],102,-1,169,-1,155
1,<environment.Job instance at 0x7fbd3e069af0>,102,21,[2 7],103,-1,176,-1,155
1,<environment.Job instance at 0x7fbd3e069be0>,103,14,[5 6],104,-1,169,-1,155
1,<environment.Job instance at 0x7fbd3e069b40>,104,17,[9 4],105,-1,172,-1,155
1,<environment.Job instance at 0x7fbd3e9e9c30>,110,16,[5 4],111,-1,179,-1,163
1,<environment.Job instance at 0x7fbd3ecf7f50>,127,16,[8 2],128,-1,250,-1,234
1,<environment.Job instance at 0x7fbd3efda8c0>,124,15,[ 2 10],125,-1,249,-1,234
1,<environment.Job instance at 0x7fbd3e964910>,128,20,[5 5],129,-1,254,-1,234
1,<environment.Job instance at 0x7fbd3e6365f0>,123,18,[1 8],124,-1,279,-1,261
1,<environment.Job instance at 0x7fbd3f068dc0>,134,13,[10  1],135,-1,274,-1,261
1,<environment.Job instance at 0x7fbd3e8557d0>,138,17,[ 1 10],139,-1,278,-1,261
1,<environment.Job instance at 0x7fbd3e9dd370>,156,15,[10  1],157,-1,332,-1,317
1,<environment.Job instance at 0x7fbd3e636eb0>,122,14,[10  1],123,-1,332,-1,318
1,<environment.Job instance at 0x7fbd3e9e3690>,15,3,[ 4 13],16,-1,40,-1,37
1,<environment.Job instance at 0x7fbd3e9e3230>,16,28,[2 6],17,-1,76,-1,48
1,<environment.Job instance at 0x7fbd3ea1b550>,19,26,[10  1],20,-1,80,-1,54
1,<environment.Job instance at 0x7fbd3ee4af00>,27,16,[13  3],28,-1,98,-1,82
1,<environment.Job instance at 0x7fbd3ee4a7d0>,38,26,[5 7],39,-1,148,-1,122
1,<environment.Job instance at 0x7fbd3e9a6140>,39,28,[ 4 10],40,-1,150,-1,122
1,<environment.Job instance at 0x7fbd3f5a3af0>,42,2,[ 4 11],43,-1,126,-1,124
1,<environment.Job instance at 0x7fbd3f5a3500>,44,16,[14  4],45,-1,142,-1,126
1,<environment.Job instance at 0x7fbd3f5b47d0>,45,23,[ 3 10],46,-1,159,-1,136
1,<environment.Job instance at 0x7fbd3f7cca00>,60,23,[7 1],61,-1,225,-1,202
1,<environment.Job instance at 0x7fbd4819e050>,71,13,[ 1 12],72,-1,251,-1,238
1,<environment.Job instance at 0x7fbd47ffdc80>,79,3,[ 5 12],80,-1,267,-1,264
1,<environment.Job instance at 0x7fbd3f952730>,80,2,[ 5 14],81,-1,266,-1,264
1,<environment.Job instance at 0x7fbd47ffd870>,78,27,[1 8],79,-1,300,-1,273
1,<environment.Job instance at 0x7fbd3f0d8f00>,92,2,[13  4],93,-1,320,-1,318
1,<environment.Job instance at 0x7fbd3f2f8280>,94,14,[12  1],95,-1,333,-1,319
1,<environment.Job instance at 0x7fbd3f2f8140>,98,3,[ 3 14],99,-1,338,-1,335
1,<environment.Job instance at 0x7fbd3f2f89b0>,100,3,[13  3],101,-1,338,-1,335
1,<environment.Job instance at 0x7fbd3f0834b0>,105,2,[13  4],106,-1,355,-1,353
1,<environment.Job instance at 0x7fbd3e8bc5f0>,106,24,[7 1],107,-1,393,-1,369
1,<environment.Job instance at 0x7fbd3e6d84b0>,121,3,[ 5 11],122,-1,432,-1,429
1,<environment.Job instance at 0x7fbd3eb99690>,1,18,[2 8],2,-1,20,-1,2
1,<environment.Job instance at 0x7fbd3eb994b0>,2,18,[3 8],3,-1,21,-1,3
1,<environment.Job instance at 0x7fbd3eb99e10>,8,24,[7 5],9,-1,33,-1,9
1,<environment.Job instance at 0x7fbd3eb99af0>,9,14,[9 5],10,-1,25,-1,11
1,<environment.Job instance at 0x7fbd3f82f1e0>,11,21,[5 3],12,-1,33,-1,12
1,<environment.Job instance at 0x7fbd3f82ffa0>,13,18,[5 6],14,-1,32,-1,14
1,<environment.Job instance at 0x7fbd3f82f960>,14,15,[1 5],15,-1,30,-1,15
1,<environment.Job instance at 0x7fbd3f82f320>,17,12,[1 6],18,-1,30,-1,18
1,<environment.Job instance at 0x7fbd3f82f5a0>,20,18,[ 4 10],21,-1,39,-1,21
1,<environment.Job instance at 0x7fbd3f82faa0>,24,13,[8 4],25,-1,38,-1,25
1,<environment.Job instance at 0x7fbd3f82fa00>,25,1,[8 1],26,-1,27,-1,26
1,<environment.Job instance at 0x7fbd3f469870>,26,17,[10  3],27,-1,44,-1,27
1,<environment.Job instance at 0x7fbd3f469230>,27,25,[4 6],28,-1,53,-1,28
1,<environment.Job instance at 0x7fbd3f469a00>,28,17,[ 2 10],29,-1,46,-1,29
1,<environment.Job instance at 0x7fbd3f469cd0>,29,12,[2 8],30,-1,42,-1,30
1,<environment.Job instance at 0x7fbd3f469af0>,31,23,[10  1],32,-1,55,-1,32
1,<environment.Job instance at 0x7fbd3f469f50>,32,14,[5 8],33,-1,47,-1,33
1,<environment.Job instance at 0x7fbd3f469d70>,33,26,[10  2],34,-1,60,-1,34
1,<environment.Job instance at 0x7fbd3f469b40>,35,15,[5 2],36,-1,51,-1,36
1,<environment.Job instance at 0x7fbd3f469690>,36,16,[ 1 10],37,-1,53,-1,37
1,<environment.Job instance at 0x7fbd3f469dc0>,40,16,[6 1],41,-1,57,-1,41
1,<environment.Job instance at 0x7fbd3f469050>,41,24,[4 8],42,-1,66,-1,42
1,<environment.Job instance at 0x7fbd3e53ec80>,42,17,[5 8],43,-1,60,-1,43
1,<environment.Job instance at 0x7fbd3e53e6e0>,45,14,[ 2 11],46,-1,60,-1,46
1,<environment.Job instance at 0x7fbd3e53e0a0>,46,15,[6 2],47,-1,62,-1,47
1,<environment.Job instance at 0x7fbd3e53e730>,52,22,[10  1],53,-1,77,-1,55
1,<environment.Job instance at 0x7fbd3e4c86e0>,57,18,[3 8],58,-1,76,-1,58
1,<environment.Job instance at 0x7fbd3e4c8190>,59,23,[1 5],60,-1,83,-1,60
1,<environment.Job instance at 0x7fbd3e4c83c0>,60,18,[5 4],61,-1,79,-1,61
1,<environment.Job instance at 0x7fbd3e4c8280>,61,15,[7 5],62,-1,77,-1,62
1,<environment.Job instance at 0x7fbd3e4c8460>,63,25,[10  1],64,-1,89,-1,64
1,<environment.Job instance at 0x7fbd3e4c82d0>,64,13,[2 9],65,-1,78,-1,65
1,<environment.Job instance at 0x7fbd3e4c8370>,65,28,[1 7],66,-1,94,-1,66
1,<environment.Job instance at 0x7fbd3e4c8410>,66,15,[ 3 12],67,-1,82,-1,67
1,<environment.Job instance at 0x7fbd3e4c8500>,67,17,[10  5],68,-1,85,-1,68
1,<environment.Job instance at 0x7fbd3e0f5780>,71,18,[5 5],72,-1,90,-1,72
1,<environment.Job instance at 0x7fbd3e0f5aa0>,73,18,[5 4],74,-1,92,-1,74
1,<environment.Job instance at 0x7fbd3e0f5a00>,74,16,[10  1],75,-1,91,-1,75
1,<environment.Job instance at 0x7fbd3e0f51e0>,76,18,[3 7],77,-1,95,-1,77
1,<environment.Job instance at 0x7fbd3e0f5d20>,77,16,[7 4],78,-1,94,-1,78
1,<environment.Job instance at 0x7fbd3f232960>,82,14,[11  2],83,-1,97,-1,83
1,<environment.Job instance at 0x7fbd3f232320>,83,17,[ 1 10],84,-1,101,-1,84
1,<environment.Job instance at 0x7fbd3f232910>,84,16,[10  1],85,-1,101,-1,85
1,<environment.Job instance at 0x7fbd3f2326e0>,85,15,[10  1],86,-1,101,-1,86
1,<environment.Job instance at 0x7fbd3f232280>,86,18,[9 4],87,-1,105,-1,87
1,<environment.Job instance at 0x7fbd3f232190>,87,23,[1 8],88,-1,111,-1,88
1,<environment.Job instance at 0x7fbd3f232410>,89,15,[2 8],90,-1,105,-1,90
1,<environment.Job instance at 0x7fbd3f232b40>,90,26,[4 7],91,-1,117,-1,91
1,<environment.Job instance at 0x7fbd3f822c80>,91,16,[4 5],92,-1,108,-1,92
1,<environment.Job instance at 0x7fbd3f84a0a0>,100,13,[10  1],101,-1,114,-1,101
1,<environment.Job instance at 0x7fbd3ec43b40>,104,15,[5 5],105,-1,120,-1,105
1,<environment.Job instance at 0x7fbd47fd78c0>,105,16,[7 5],106,-1,122,-1,106
1,<environment.Job instance at 0x7fbd47fd7f50>,107,18,[10  1],108,-1,126,-1,108
1,<environment.Job instance at 0x7fbd3e694d70>,109,14,[5 7],110,-1,124,-1,110
1,<environment.Job instance at 0x7fbd3e9bf730>,111,15,[2 5],112,-1,127,-1,112
1,<environment.Job instance at 0x7fbd3e9bfeb0>,112,18,[4 9],113,-1,131,-1,113
1,<environment.Job instance at 0x7fbd3e9bf1e0>,113,23,[10  4],114,-1,137,-1,114
1,<environment.Job instance at 0x7fbd3e9bfb90>,114,19,[ 5 10],115,-1,134,-1,115
1,<environment.Job instance at 0x7fbd3eaf9e60>,118,12,[11  4],119,-1,131,-1,119
1,<environment.Job instance at 0x7fbd3f035f00>,119,16,[ 1 10],120,-1,136,-1,120
1,<environment.Job instance at 0x7fbd3ebd3eb0>,121,13,[9 4],122,-1,135,-1,122
1,<environment.Job instance at 0x7fbd3e5f3230>,122,17,[1 6],123,-1,140,-1,123
1,<environment.Job instance at 0x7fbd3f45eeb0>,123,15,[10  4],124,-1,139,-1,124
1,<environment.Job instance at 0x7fbd3f6aa500>,124,24,[1 8],125,-1,149,-1,125
1,<environment.Job instance at 0x7fbd3ef130f0>,125,13,[8 3],126,-1,139,-1,126
1,<environment.Job instance at 0x7fbd48059410>,126,15,[7 4],127,-1,142,-1,127
1,<environment.Job instance at 0x7fbd3f061e10>,129,17,[4 9],130,-1,147,-1,130
1,<environment.Job instance at 0x7fbd3eac0410>,132,26,[2 5],133,-1,159,-1,133
1,<environment.Job instance at 0x7fbd3eac0550>,136,16,[9 2],137,-1,153,-1,137
1,<environment.Job instance at 0x7fbd3e7085a0>,139,15,[3 6],140,-1,155,-1,140
1,<environment.Job instance at 0x7fbd3f8348c0>,140,18,[2 9],141,-1,159,-1,141
1,<environment.Job instance at 0x7fbd3f834d20>,141,18,[3 9],142,-1,160,-1,142
1,<environment.Job instance at 0x7fbd3f834320>,145,17,[7 3],146,-1,163,-1,146
1,<environment.Job instance at 0x7fbd3e4c85a0>,8,24,[7 5],9,-1,40,-1,16
1,<environment.Job instance at 0x7fbd3e78bbe0>,27,25,[4 6],28,-1,86,-1,61
1,<environment.Job instance at 0x7fbd3eb99d70>,31,23,[10  1],32,-1,105,-1,82
1,<environment.Job instance at 0x7fbd3e8c8550>,33,26,[10  2],34,-1,108,-1,82
1,<environment.Job instance at 0x7fbd3f14a960>,34,3,[ 3 12],35,-1,85,-1,82
1,<environment.Job instance at 0x7fbd3eb47870>,41,24,[4 8],42,-1,130,-1,106
1,<environment.Job instance at 0x7fbd3e8d7af0>,43,2,[12  5],44,-1,108,-1,106
1,<environment.Job instance at 0x7fbd3e8d7140>,45,14,[ 2 11],46,-1,131,-1,117
1,<environment.Job instance at 0x7fbd3e8b5e10>,48,13,[12  1],49,-1,131,-1,118
1,<environment.Job instance at 0x7fbd3eaa05f0>,55,16,[13  5],56,-1,150,-1,134
1,<environment.Job instance at 0x7fbd3eaa0320>,59,23,[1 5],60,-1,162,-1,139
1,<environment.Job instance at 0x7fbd3e6d8d20>,54,23,[ 5 10],55,-1,182,-1,159
1,<environment.Job instance at 0x7fbd3e8bc730>,63,25,[10  1],64,-1,192,-1,167
1,<environment.Job instance at 0x7fbd3f2f8140>,66,15,[ 3 12],67,-1,182,-1,167
1,<environment.Job instance at 0x7fbd3f2f8c80>,65,28,[1 7],66,-1,201,-1,173
1,<environment.Job instance at 0x7fbd3e0fde60>,82,14,[11  2],83,-1,236,-1,222
1,<environment.Job instance at 0x7fbd3e9cf870>,87,23,[1 8],88,-1,281,-1,258
1,<environment.Job instance at 0x7fbd3e627960>,90,26,[4 7],91,-1,287,-1,261
1,<environment.Job instance at 0x7fbd3efd6690>,113,23,[10  4],114,-1,362,-1,339
1,<environment.Job instance at 0x7fbd3ead8410>,118,12,[11  4],119,-1,362,-1,350
1,<environment.Job instance at 0x7fbd3f79f820>,124,24,[1 8],125,-1,395,-1,371
1,<environment.Job instance at 0x7fbd3f79ffa0>,127,18,[12  3],128,-1,393,-1,375
1,<environment.Job instance at 0x7fbd3e87bbe0>,132,26,[2 5],133,-1,430,-1,404
1,<environment.Job instance at 0x7fbd3ea74be0>,133,12,[12  2],134,-1,416,-1,404
1,<environment.Job instance at 0x7fbd3f699140>,138,1,[13  1],139,-1,409,-1,408
1,<environment.Job instance at 0x7fbd3f4870a0>,146,17,[14  3],147,-1,460,-1,443
1,<environment.Job instance at 0x7fbd3f487500>,147,26,[3 6],148,-1,472,-1,446
1,<environment.Job instance at 0x7fbd3e3b9fa0>,149,25,[ 1 10],150,-1,489,-1,464
1,<environment.Job instance at 0x7fbd3e614320>,154,2,[13  2],155,-1,468,-1,466
1,<environment.Job instance at 0x7fbd3e7c1be0>,158,1,[ 4 12],159,-1,478,-1,477
1,<environment.Job instance at 0x7fb7eeca46e0>,0,13,[9 3],1,-1,15,-1,2
1,<environment.Job instance at 0x7fb7eeca48c0>,1,22,[11  3],2,-1,24,-1,2
1,<environment.Job instance at 0x7fb7eeca4730>,2,22,[4 8],3,-1,25,-1,3
1,<environment.Job instance at 0x7fb7e56b4fa0>,9,18,[11  5],10,-1,28,-1,10
1,<environment.Job instance at 0x7fb7e56b70f0>,11,15,[4 8],12,-1,27,-1,12
1,<environment.Job instance at 0x7fb7e56b7320>,12,26,[ 1 10],13,-1,39,-1,13
1,<environment.Job instance at 0x7fb7e56b7230>,13,18,[ 4 10],14,-1,32,-1,14
1,<environment.Job instance at 0x7fb7e56b73c0>,14,13,[7 3],15,-1,28,-1,15
1,<environment.Job instance at 0x7fb7e56b7460>,15,18,[2 8],16,-1,34,-1,16
1,<environment.Job instance at 0x7fb7e56b7500>,16,16,[3 5],17,-1,33,-1,17
1,<environment.Job instance at 0x7fb7e56b7690>,23,27,[1 6],24,-1,51,-1,24
1,<environment.Job instance at 0x7fb7e56b7cd0>,24,18,[2 6],25,-1,43,-1,25
1,<environment.Job instance at 0x7fb7e56b7f50>,27,15,[8 4],28,-1,43,-1,28
1,<environment.Job instance at 0x7fb7e56ba140>,28,23,[10  4],29,-1,52,-1,29
1,<environment.Job instance at 0x7fb7e56ba0a0>,29,12,[5 4],30,-1,42,-1,30
1,<environment.Job instance at 0x7fb7e56ba280>,30,14,[5 2],31,-1,45,-1,31
1,<environment.Job instance at 0x7fb7e56ba3c0>,32,3,[5 1],33,-1,36,-1,33
1,<environment.Job instance at 0x7fb7e56ba5a0>,33,14,[5 5],34,-1,48,-1,34
1,<environment.Job instance at 0x7fb7e56ba460>,34,24,[1 8],35,-1,59,-1,35
1,<environment.Job instance at 0x7fb7e56ba640>,35,15,[9 5],36,-1,51,-1,36
1,<environment.Job instance at 0x7fb7e56bab40>,40,15,[10  3],41,-1,59,-1,44
1,<environment.Job instance at 0x7fb7e56bae60>,45,13,[6 5],46,-1,59,-1,46
1,<environment.Job instance at 0x7fb7e56bacd0>,43,18,[5 5],44,-1,64,-1,46
1,<environment.Job instance at 0x7fb7e56bc280>,48,15,[10  1],49,-1,66,-1,51
1,<environment.Job instance at 0x7fb7e56bc140>,50,16,[12  2],51,-1,67,-1,51
1,<environment.Job instance at 0x7fb7e56bc7d0>,53,17,[5 7],54,-1,71,-1,54
1,<environment.Job instance at 0x7fb7e56bca00>,56,17,[8 5],57,-1,75,-1,58
1,<environment.Job instance at 0x7fb7e56bcc80>,59,17,[1 6],60,-1,77,-1,60
1,<environment.Job instance at 0x7fb7e56bceb0>,62,22,[6 4],63,-1,85,-1,63
1,<environment.Job instance at 0x7fb7e56be0f0>,64,18,[2 9],65,-1,83,-1,65
1,<environment.Job instance at 0x7fb7e56be370>,65,20,[2 6],66,-1,86,-1,66
1,<environment.Job instance at 0x7fb7e56be460>,67,27,[ 1 10],68,-1,95,-1,68
1,<environment.Job instance at 0x7fb7e56bcaa0>,57,18,[2 8],58,-1,89,-1,71
1,<environment.Job instance at 0x7fb7e56bef00>,76,19,[4 8],77,-1,100,-1,81
1,<environment.Job instance at 0x7fb7e56c0410>,82,16,[ 4 10],83,-1,99,-1,83
1,<environment.Job instance at 0x7fb7e56bc820>,54,13,[13  1],55,-1,99,-1,86
1,<environment.Job instance at 0x7fb7e56c0140>,83,20,[7 1],84,-1,112,-1,92
1,<environment.Job instance at 0x7fb7e56c0460>,84,18,[3 7],85,-1,113,-1,95
1,<environment.Job instance at 0x7fb7e56c00a0>,80,14,[2 6],81,-1,109,-1,95
1,<environment.Job instance at 0x7fb7e56c0780>,86,18,[9 2],87,-1,114,-1,96
1,<environment.Job instance at 0x7fb7e56c0280>,87,3,[10  5],88,-1,99,-1,96
1,<environment.Job instance at 0x7fb7e56c0550>,85,17,[3 9],86,-1,113,-1,96
1,<environment.Job instance at 0x7fb7e56ab9b0>,102,16,[3 9],103,-1,148,-1,132
1,<environment.Job instance at 0x7fb7e56abe60>,103,16,[1 6],104,-1,159,-1,143
1,<environment.Job instance at 0x7fb7e56becd0>,75,14,[ 4 11],76,-1,159,-1,145
1,<environment.Job instance at 0x7fb7e56ab6e0>,106,15,[11  1],107,-1,160,-1,145
1,<environment.Job instance at 0x7fb7e56abc80>,105,14,[14  5],106,-1,160,-1,146
1,<environment.Job instance at 0x7fb7e56ae3c0>,100,18,[2 7],101,-1,164,-1,146
1,<environment.Job instance at 0x7fb7e56aba50>,107,17,[9 3],108,-1,163,-1,146
1,<environment.Job instance at 0x7fb7e57d9780>,111,26,[ 5 10],112,-1,172,-1,146
1,<environment.Job instance at 0x7fb7e573db90>,115,16,[7 5],116,-1,163,-1,147
1,<environment.Job instance at 0x7fb7e575e280>,123,12,[ 4 11],124,-1,165,-1,153
1,<environment.Job instance at 0x7fb7e57517d0>,125,21,[4 5],126,-1,175,-1,154
1,<environment.Job instance at 0x7fb7e56ab820>,104,15,[1 9],105,-1,169,-1,154
1,<environment.Job instance at 0x7fb7e58410f0>,127,22,[4 5],128,-1,177,-1,155
1,<environment.Job instance at 0x7fb7e5757460>,130,15,[8 3],131,-1,171,-1,156
1,<environment.Job instance at 0x7fb7e57d5b40>,128,23,[ 2 14],129,-1,180,-1,157
1,<environment.Job instance at 0x7fb7e56d7dc0>,133,16,[ 3 10],134,-1,173,-1,157
1,<environment.Job instance at 0x7fb7e57222d0>,119,20,[2 6],120,-1,177,-1,157
1,<environment.Job instance at 0x7fb7e56dcd70>,132,13,[ 5 10],133,-1,170,-1,157
1,<environment.Job instance at 0x7fb7e573d6e0>,114,14,[2 5],115,-1,172,-1,158
1,<environment.Job instance at 0x7fb7e56dc050>,138,16,[11  2],139,-1,175,-1,159
1,<environment.Job instance at 0x7fb7e56dc7d0>,135,14,[ 2 10],136,-1,173,-1,159
1,<environment.Job instance at 0x7fb7e56dc960>,140,16,[2 8],141,-1,175,-1,159
1,<environment.Job instance at 0x7fb7e56dc190>,141,13,[5 6],142,-1,172,-1,159
1,<environment.Job instance at 0x7fb7e57db910>,146,17,[1 7],147,-1,182,-1,165
1,<environment.Job instance at 0x7fb7e56dceb0>,137,20,[9 2],138,-1,185,-1,165
1,<environment.Job instance at 0x7fb7e56dce10>,139,18,[ 1 12],140,-1,183,-1,165
1,<environment.Job instance at 0x7fb7e57c1820>,149,12,[4 9],150,-1,177,-1,165
1,<environment.Job instance at 0x7fb7e57c1fa0>,151,15,[10  4],152,-1,180,-1,165
1,<environment.Job instance at 0x7fb7e5764c80>,154,14,[8 4],155,-1,179,-1,165
1,<environment.Job instance at 0x7fb7e5763500>,158,14,[9 5],159,-1,181,-1,167
1,<environment.Job instance at 0x7fb7e5763870>,161,15,[1 7],162,-1,183,-1,168
1,<environment.Job instance at 0x7fb7e56b7780>,1,22,[11  3],2,-1,24,-1,2
1,<environment.Job instance at 0x7fb7e56bcd20>,9,18,[11  5],10,-1,32,-1,14
1,<environment.Job instance at 0x7fb7e56be2d0>,12,26,[ 1 10],13,-1,82,-1,56
1,<environment.Job instance at 0x7fb7e57d77d0>,23,27,[1 6],24,-1,87,-1,60
1,<environment.Job instance at 0x7fb7e56e13c0>,28,23,[10  4],29,-1,97,-1,74
1,<environment.Job instance at 0x7fb7e569f230>,34,24,[1 8],35,-1,117,-1,93
1,<environment.Job instance at 0x7fb7e56a26e0>,36,13,[ 3 14],37,-1,106,-1,93
1,<environment.Job instance at 0x7fb7e5697500>,46,17,[12  2],47,-1,134,-1,117
1,<environment.Job instance at 0x7fb7e56a8230>,50,16,[12  2],51,-1,146,-1,130
1,<environment.Job instance at 0x7fb7e56a80f0>,54,13,[13  1],55,-1,158,-1,145
1,<environment.Job instance at 0x7fb7e56a47d0>,60,3,[12  3],61,-1,169,-1,166
1,<environment.Job instance at 0x7fb7e56c0cd0>,67,27,[ 1 10],68,-1,216,-1,189
1,<environment.Job instance at 0x7fb7e56c0d20>,69,13,[ 3 12],70,-1,202,-1,189
1,<environment.Job instance at 0x7fb7e564e320>,75,14,[ 4 11],76,-1,215,-1,201
1,<environment.Job instance at 0x7fb7e5651370>,97,2,[ 5 11],98,-1,294,-1,292
1,<environment.Job instance at 0x7fb7e56514b0>,99,18,[12  5],100,-1,312,-1,294
1,<environment.Job instance at 0x7fb7e56519b0>,105,14,[14  5],106,-1,341,-1,327
1,<environment.Job instance at 0x7fb7e56517d0>,106,15,[11  1],107,-1,342,-1,327
1,<environment.Job instance at 0x7fb7e56542d0>,116,3,[ 1 12],117,-1,363,-1,360
1,<environment.Job instance at 0x7fb7e5651eb0>,111,26,[ 5 10],112,-1,396,-1,370
1,<environment.Job instance at 0x7fb7e56545f0>,122,3,[ 4 12],123,-1,377,-1,374
1,<environment.Job instance at 0x7fb7e5654730>,123,12,[ 4 11],124,-1,386,-1,374
1,<environment.Job instance at 0x7fb7e5654a00>,128,23,[ 2 14],129,-1,419,-1,396
1,<environment.Job instance at 0x7fb7e5656140>,138,16,[11  2],139,-1,447,-1,431
1,<environment.Job instance at 0x7fb7e5656190>,139,18,[ 1 12],140,-1,449,-1,431
1,<environment.Job instance at 0x7fb7e5656460>,143,15,[ 1 12],144,-1,466,-1,451
1,<environment.Job instance at 0x7fb7e5656820>,145,3,[ 4 13],146,-1,455,-1,452
1,<environment.Job instance at 0x7fb7e5656910>,147,1,[ 1 14],148,-1,455,-1,454
1,<environment.Job instance at 0x7fb7e5659140>,160,3,[13  3],161,-1,503,-1,500
1,<environment.Job instance at 0x7fb7e5659320>,165,13,[ 1 14],166,-1,518,-1,505
1,<environment.Job instance at 0x7fb7e504b500>,3,18,[6 5],4,-1,22,-1,4
1,<environment.Job instance at 0x7fb7e504b280>,5,16,[ 2 10],6,-1,23,-1,7
1,<environment.Job instance at 0x7fb7e511a460>,7,21,[ 3 10],8,-1,29,-1,8
1,<environment.Job instance at 0x7fb7e511ab90>,11,13,[8 5],12,-1,26,-1,13
1,<environment.Job instance at 0x7fb7e5123140>,18,21,[9 4],19,-1,40,-1,19
1,<environment.Job instance at 0x7fb7e5123190>,19,12,[9 3],20,-1,32,-1,20
1,<environment.Job instance at 0x7fb7e51236e0>,20,18,[10  3],21,-1,39,-1,21
1,<environment.Job instance at 0x7fb7e5123960>,21,17,[10  2],22,-1,39,-1,22
1,<environment.Job instance at 0x7fb7e5123eb0>,24,12,[3 8],25,-1,37,-1,25
1,<environment.Job instance at 0x7fb7e5127c30>,26,14,[5 5],27,-1,41,-1,27
1,<environment.Job instance at 0x7fb7e51274b0>,30,13,[10  5],31,-1,45,-1,32
1,<environment.Job instance at 0x7fb7e5127370>,33,14,[7 5],34,-1,50,-1,36
1,<environment.Job instance at 0x7fb7e5127dc0>,35,14,[10  2],36,-1,50,-1,36
1,<environment.Job instance at 0x7fb7e52c0910>,44,16,[7 2],45,-1,63,-1,47
1,<environment.Job instance at 0x7fb7e565fc30>,50,18,[4 5],51,-1,69,-1,51
1,<environment.Job instance at 0x7fb7e4ec8f50>,51,18,[2 8],52,-1,70,-1,52
1,<environment.Job instance at 0x7fb7e4f33f00>,53,14,[11  3],54,-1,68,-1,54
1,<environment.Job instance at 0x7fb7e4f331e0>,54,16,[9 4],55,-1,71,-1,55
1,<environment.Job instance at 0x7fb7e4d40aa0>,56,14,[10  1],57,-1,72,-1,58
1,<environment.Job instance at 0x7fb7eee10e60>,58,15,[7 5],59,-1,74,-1,59
1,<environment.Job instance at 0x7fb7e4ce0140>,57,16,[9 2],58,-1,75,-1,59
1,<environment.Job instance at 0x7fb7e55b38c0>,60,13,[7 4],61,-1,74,-1,61
1,<environment.Job instance at 0x7fb7e4df39b0>,62,20,[1 7],63,-1,83,-1,63
1,<environment.Job instance at 0x7fb7e4c5deb0>,66,19,[2 7],67,-1,86,-1,67
1,<environment.Job instance at 0x7fb7e4d990a0>,68,18,[6 3],69,-1,87,-1,69
1,<environment.Job instance at 0x7fb7e4c688c0>,73,24,[7 4],74,-1,99,-1,75
1,<environment.Job instance at 0x7fb7e4c68960>,76,16,[7 4],77,-1,93,-1,77
1,<environment.Job instance at 0x7fb7e4c4baa0>,78,18,[4 6],79,-1,97,-1,79
1,<environment.Job instance at 0x7fb7e4c65c80>,81,27,[4 7],82,-1,109,-1,82
1,<environment.Job instance at 0x7fb7e4c65af0>,82,26,[8 4],83,-1,109,-1,83
1,<environment.Job instance at 0x7fb7e4c655a0>,83,12,[9 1],84,-1,96,-1,84
1,<environment.Job instance at 0x7fb7e4c65a50>,84,14,[5 5],85,-1,99,-1,85
1,<environment.Job instance at 0x7fb7e4c66870>,88,18,[4 5],89,-1,107,-1,89
1,<environment.Job instance at 0x7fb7e4c66730>,90,25,[ 3 10],91,-1,116,-1,91
1,<environment.Job instance at 0x7fb7e4c68be0>,74,16,[7 5],75,-1,111,-1,95
1,<environment.Job instance at 0x7fb7e4c642d0>,100,17,[2 6],101,-1,118,-1,101
1,<environment.Job instance at 0x7fb7e4c64780>,101,15,[8 4],102,-1,117,-1,102
1,<environment.Job instance at 0x7fb7e4c69b40>,103,23,[10  1],104,-1,130,-1,107
1,<environment.Job instance at 0x7fb7e4d960f0>,107,18,[5 9],108,-1,126,-1,108
1,<environment.Job instance at 0x7fb7e4d96780>,106,28,[6 5],107,-1,136,-1,108
1,<environment.Job instance at 0x7fb7e4da8230>,114,15,[10  4],115,-1,131,-1,116
1,<environment.Job instance at 0x7fb7e4c4f870>,115,18,[11  3],116,-1,135,-1,117
1,<environment.Job instance at 0x7fb7e4d98e60>,119,28,[5 3],120,-1,148,-1,120
1,<environment.Job instance at 0x7fb7e4d94fa0>,120,18,[6 1],121,-1,139,-1,121
1,<environment.Job instance at 0x7fb7e4ce4280>,122,18,[8 2],123,-1,141,-1,123
1,<environment.Job instance at 0x7fb7e4ce4320>,125,17,[4 6],126,-1,143,-1,126
1,<environment.Job instance at 0x7fb7e4d8d4b0>,129,16,[9 4],130,-1,147,-1,131
1,<environment.Job instance at 0x7fb7e4f3a5a0>,132,25,[6 3],133,-1,158,-1,133
1,<environment.Job instance at 0x7fb7e4f1e320>,134,17,[9 4],135,-1,152,-1,135
1,<environment.Job instance at 0x7fb7e4f15a50>,135,13,[6 4],136,-1,149,-1,136
1,<environment.Job instance at 0x7fb7e4c6ccd0>,130,15,[8 2],131,-1,153,-1,138
1,<environment.Job instance at 0x7fb7e4ed8550>,138,17,[3 6],139,-1,156,-1,139
1,<environment.Job instance at 0x7fb7e4ed31e0>,139,15,[ 5 10],140,-1,155,-1,140
1,<environment.Job instance at 0x7fb7e4ed3780>,143,20,[2 6],144,-1,173,-1,153
1,<environment.Job instance at 0x7fb7e4ecd550>,150,12,[9 2],151,-1,167,-1,155
1,<environment.Job instance at 0x7fb7e4c61b90>,154,12,[5 9],155,-1,167,-1,155
1,<environment.Job instance at 0x7fb7e5176910>,158,15,[7 5],159,-1,182,-1,167
1,<environment.Job instance at 0x7fb7e5176b40>,159,15,[ 3 10],160,-1,182,-1,167
1,<environment.Job instance at 0x7fb7e5176730>,160,24,[2 8],161,-1,191,-1,167
1,<environment.Job instance at 0x7fb7e5176a50>,161,24,[9 1],162,-1,191,-1,167
1,<environment.Job instance at 0x7fb7e5176190>,163,24,[10  5],164,-1,191,-1,167
1,<environment.Job instance at 0x7fb7e516f870>,164,23,[10  2],165,-1,190,-1,167
1,<environment.Job instance at 0x7fb7e516f960>,165,15,[ 1 11],166,-1,182,-1,167
1,<environment.Job instance at 0x7fb7e516fbe0>,166,16,[ 5 10],167,-1,183,-1,167
1,<environment.Job instance at 0x7fb7e5108370>,6,2,[11  5],7,-1,9,-1,7
1,<environment.Job instance at 0x7fb7e4c65280>,8,3,[14  4],9,-1,12,-1,9
1,<environment.Job instance at 0x7fb7e5656820>,28,12,[14  4],29,-1,68,-1,56
1,<environment.Job instance at 0x7fb7e5654e60>,38,2,[13  1],39,-1,98,-1,96
1,<environment.Job instance at 0x7fb7e5654af0>,41,3,[13  5],42,-1,100,-1,97
1,<environment.Job instance at 0x7fb7e5656140>,42,2,[ 1 12],43,-1,99,-1,97
1,<environment.Job instance at 0x7fb7e56545a0>,52,1,[ 4 13],53,-1,117,-1,116
1,<environment.Job instance at 0x7fb7e56543c0>,53,14,[11  3],54,-1,130,-1,116
1,<environment.Job instance at 0x7fb7e5651410>,70,24,[ 1 10],71,-1,205,-1,181
1,<environment.Job instance at 0x7fb7e5651460>,73,24,[7 4],74,-1,219,-1,195
1,<environment.Job instance at 0x7fb7e5651e60>,75,3,[12  3],76,-1,198,-1,195
1,<environment.Job instance at 0x7fb7e564eb90>,81,27,[4 7],82,-1,244,-1,217
1,<environment.Job instance at 0x7fb7e564ea50>,82,26,[8 4],83,-1,243,-1,217
1,<environment.Job instance at 0x7fb7e564eaa0>,85,16,[14  1],86,-1,235,-1,219
1,<environment.Job instance at 0x7fb7e564e640>,90,25,[ 3 10],91,-1,276,-1,251
1,<environment.Job instance at 0x7fb7e516fe60>,103,23,[10  1],104,-1,316,-1,293
1,<environment.Job instance at 0x7fb7e4ebdf00>,106,28,[6 5],107,-1,321,-1,293
1,<environment.Job instance at 0x7fb7e4e79500>,111,15,[14  1],112,-1,313,-1,298
1,<environment.Job instance at 0x7fb7e4e7b870>,115,18,[11  3],116,-1,331,-1,313
1,<environment.Job instance at 0x7fb7e4e7b730>,119,28,[5 3],120,-1,356,-1,328
1,<environment.Job instance at 0x7fb7e4f9d0f0>,132,25,[6 3],133,-1,406,-1,381
1,<environment.Job instance at 0x7fb7e4f09690>,149,18,[13  1],150,-1,452,-1,434
1,<environment.Job instance at 0x7fb7e4ea4910>,152,3,[ 3 11],153,-1,439,-1,436
1,<environment.Job instance at 0x7fb7e4e123c0>,160,24,[2 8],161,-1,502,-1,478
1,<environment.Job instance at 0x7fb7e4e12370>,161,24,[9 1],162,-1,508,-1,484
1,<environment.Job instance at 0x7fb7e4e27230>,163,24,[10  5],164,-1,508,-1,484
1,<environment.Job instance at 0x7fb7e4e27280>,164,23,[10  2],165,-1,507,-1,484
1,<environment.Job instance at 0x7fb7e4e27190>,165,15,[ 1 11],166,-1,499,-1,484
1,<environment.Job instance at 0x7fb7e4e36eb0>,1,17,[10  3],2,-1,19,-1,2
1,<environment.Job instance at 0x7fb7e4e30910>,9,16,[5 4],10,-1,27,-1,11
1,<environment.Job instance at 0x7fb7e4e36780>,10,14,[8 3],11,-1,25,-1,11
1,<environment.Job instance at 0x7fb7e4e30370>,14,18,[3 6],15,-1,33,-1,15
1,<environment.Job instance at 0x7fb7e4e30c30>,16,16,[9 2],17,-1,34,-1,18
1,<environment.Job instance at 0x7fb7e4e309b0>,17,16,[9 4],18,-1,34,-1,18
1,<environment.Job instance at 0x7fb7e4e2d8c0>,20,27,[ 5 10],21,-1,50,-1,23
1,<environment.Job instance at 0x7fb7e4e2d5f0>,24,15,[4 6],25,-1,40,-1,25
1,<environment.Job instance at 0x7fb7e4e2d0f0>,26,25,[ 5 10],27,-1,52,-1,27
1,<environment.Job instance at 0x7fb7e4e2dd20>,27,15,[5 3],28,-1,43,-1,28
1,<environment.Job instance at 0x7fb7e4e2dd70>,28,18,[1 5],29,-1,47,-1,29
1,<environment.Job instance at 0x7fb7e4e27870>,40,14,[7 5],41,-1,55,-1,41
1,<environment.Job instance at 0x7fb7e4e27f50>,45,16,[10  4],46,-1,62,-1,46
1,<environment.Job instance at 0x7fb7e4e2d0a0>,21,17,[7 5],22,-1,67,-1,50
1,<environment.Job instance at 0x7fb7e4e211e0>,50,18,[9 5],51,-1,69,-1,51
1,<environment.Job instance at 0x7fb7e4e21140>,54,17,[7 2],55,-1,74,-1,57
1,<environment.Job instance at 0x7fb7e4e1d230>,59,17,[8 1],60,-1,77,-1,60
1,<environment.Job instance at 0x7fb7e4e1dd70>,61,17,[2 6],62,-1,79,-1,62
1,<environment.Job instance at 0x7fb7e4e1d780>,62,19,[8 2],63,-1,82,-1,63
1,<environment.Job instance at 0x7fb7e4e18d70>,68,14,[ 2 10],69,-1,90,-1,76
1,<environment.Job instance at 0x7fb7e4e28d70>,7,15,[ 3 12],8,-1,23,-1,8
1,<environment.Job instance at 0x7fb7e4df71e0>,20,27,[ 5 10],21,-1,90,-1,63
1,<environment.Job instance at 0x7fb7e4df5410>,26,25,[ 5 10],27,-1,109,-1,84
1,<environment.Job instance at 0x7fb7e4dcab90>,42,17,[12  4],43,-1,129,-1,112
1,<environment.Job instance at 0x7fb7e4e21910>,55,2,[ 4 11],56,-1,153,-1,151
1,<environment.Job instance at 0x7fb7e4ed86e0>,63,2,[ 2 14],64,-1,187,-1,185
1,<environment.Job instance at 0x7fb7e5059be0>,64,17,[ 5 14],65,-1,202,-1,185
1,<environment.Job instance at 0x7fb7e4ee3050>,66,2,[11  3],67,-1,187,-1,185
1,<environment.Job instance at 0x7fb7e4ebd410>,67,2,[12  2],68,-1,187,-1,185
1,<environment.Job instance at 0x7fb7e4c697d0>,72,2,[12  5],73,-1,216,-1,214
1,<environment.Job instance at 0x7fb7e4ce4550>,74,1,[14  4],75,-1,215,-1,214
1,<environment.Job instance at 0x7fb7e4f1e730>,93,1,[ 5 12],94,-1,285,-1,284
1,<environment.Job instance at 0x7fb7e4f1ec80>,102,14,[ 1 11],103,-1,328,-1,314
1,<environment.Job instance at 0x7fb7e4f1e960>,104,3,[14  4],105,-1,317,-1,314
1,<environment.Job instance at 0x7fb7e4f71cd0>,106,2,[13  4],107,-1,330,-1,328
1,<environment.Job instance at 0x7fb7e4f71d20>,109,27,[1 5],110,-1,357,-1,330
1,<environment.Job instance at 0x7fb7e4f71190>,115,14,[ 5 12],116,-1,354,-1,340
1,<environment.Job instance at 0x7fb7e4f71a50>,117,19,[14  4],118,-1,362,-1,343
1,<environment.Job instance at 0x7fb7e4f713c0>,119,14,[ 5 11],120,-1,358,-1,344
1,<environment.Job instance at 0x7fb7e4efa910>,126,25,[3 8],127,-1,404,-1,379
1,<environment.Job instance at 0x7fb7e4efabe0>,128,3,[ 5 14],129,-1,382,-1,379
1,<environment.Job instance at 0x7fb7e4efac30>,129,27,[9 3],130,-1,420,-1,393
1,<environment.Job instance at 0x7fb7e4efa9b0>,132,24,[ 3 10],133,-1,420,-1,396
1,<environment.Job instance at 0x7fb7e4f6edc0>,137,12,[ 2 12],138,-1,411,-1,399
1,<environment.Job instance at 0x7fb7e4f6e460>,138,27,[1 7],139,-1,428,-1,401
1,<environment.Job instance at 0x7fb7e4e526e0>,155,2,[14  5],156,-1,475,-1,473
1,<environment.Job instance at 0x7fb7e4eef910>,1,16,[6 5],2,-1,18,-1,2
1,<environment.Job instance at 0x7fb7e4c27c80>,9,13,[5 9],10,-1,23,-1,10
1,<environment.Job instance at 0x7fb7e4c278c0>,11,18,[8 4],12,-1,30,-1,12
1,<environment.Job instance at 0x7fb7e4c27e10>,14,17,[3 9],15,-1,32,-1,15
1,<environment.Job instance at 0x7fb7e4c291e0>,15,13,[10  4],16,-1,29,-1,16
1,<environment.Job instance at 0x7fb7e4c290f0>,16,16,[5 5],17,-1,33,-1,17
1,<environment.Job instance at 0x7fb7e4c27e60>,17,22,[1 7],18,-1,40,-1,18
1,<environment.Job instance at 0x7fb7e4c292d0>,19,15,[7 1],20,-1,36,-1,21
1,<environment.Job instance at 0x7fb7e4c29460>,21,18,[3 6],22,-1,40,-1,22
1,<environment.Job instance at 0x7fb7e4c29690>,22,1,[9 3],23,-1,24,-1,23
1,<environment.Job instance at 0x7fb7e4c297d0>,24,14,[7 1],25,-1,39,-1,25
1,<environment.Job instance at 0x7fb7e4c29870>,25,25,[6 3],26,-1,51,-1,26
1,<environment.Job instance at 0x7fb7e4c29b90>,28,16,[8 5],29,-1,45,-1,29
1,<environment.Job instance at 0x7fb7e4c29cd0>,29,18,[7 5],30,-1,48,-1,30
1,<environment.Job instance at 0x7fb7e4c29d70>,31,14,[5 8],32,-1,46,-1,32
1,<environment.Job instance at 0x7fb7e4c29f50>,32,16,[9 2],33,-1,49,-1,33
1,<environment.Job instance at 0x7fb7e4c29e10>,33,15,[6 3],34,-1,49,-1,34
1,<environment.Job instance at 0x7fb7e4c294b0>,20,14,[6 4],21,-1,49,-1,35
1,<environment.Job instance at 0x7fb7e4c2a280>,35,18,[7 5],36,-1,54,-1,36
1,<environment.Job instance at 0x7fb7e4c2a4b0>,38,17,[10  3],39,-1,57,-1,40
1,<environment.Job instance at 0x7fb7e4c2a370>,40,1,[6 3],41,-1,42,-1,41
1,<environment.Job instance at 0x7fb7e4c2a690>,41,22,[ 1 10],42,-1,64,-1,42
1,<environment.Job instance at 0x7fb7e4c2a730>,42,18,[5 1],43,-1,61,-1,43
1,<environment.Job instance at 0x7fb7e4c2a7d0>,43,2,[5 6],44,-1,46,-1,44
1,<environment.Job instance at 0x7fb7e4c2a870>,44,2,[2 5],45,-1,47,-1,45
1,<environment.Job instance at 0x7fb7e4c2a5f0>,39,27,[ 5 10],40,-1,73,-1,46
1,<environment.Job instance at 0x7fb7e4c2ad20>,49,15,[ 1 10],50,-1,65,-1,50
1,<environment.Job instance at 0x7fb7e4c2f140>,52,15,[1 6],53,-1,68,-1,53
1,<environment.Job instance at 0x7fb7e4c2f4b0>,55,17,[7 1],56,-1,73,-1,56
1,<environment.Job instance at 0x7fb7e4c2f370>,57,18,[1 7],58,-1,76,-1,58
1,<environment.Job instance at 0x7fb7e4c2f7d0>,60,15,[1 6],61,-1,77,-1,62
1,<environment.Job instance at 0x7fb7e4c2f960>,61,14,[10  4],62,-1,76,-1,62
1,<environment.Job instance at 0x7fb7e504f5a0>,62,18,[5 5],63,-1,83,-1,65
1,<environment.Job instance at 0x7fb7e4c1d370>,68,21,[5 8],69,-1,90,-1,69
1,<environment.Job instance at 0x7fb7e4c1d640>,69,17,[7 2],70,-1,87,-1,70
1,<environment.Job instance at 0x7fb7e4c1d230>,71,28,[2 8],72,-1,102,-1,74
1,<environment.Job instance at 0x7fb7e4c1d0f0>,70,12,[8 1],71,-1,86,-1,74
1,<environment.Job instance at 0x7fb7e4c1df50>,64,12,[8 4],65,-1,87,-1,75
1,<environment.Job instance at 0x7fb7e501be60>,76,28,[1 7],77,-1,106,-1,78
1,<environment.Job instance at 0x7fb7e4c1d3c0>,3,27,[1 8],4,-1,40,-1,13
1,<environment.Job instance at 0x7fb7e4e52640>,23,3,[ 3 14],24,-1,66,-1,63
1,<environment.Job instance at 0x7fb7e4e527d0>,25,25,[6 3],26,-1,105,-1,80
1,<environment.Job instance at 0x7fb7e4e52fa0>,30,2,[ 5 11],31,-1,82,-1,80
1,<environment.Job instance at 0x7fb7e4f6e730>,39,27,[ 5 10],40,-1,144,-1,117
1,<environment.Job instance at 0x7fb7e4efa140>,56,13,[11  1],57,-1,177,-1,164
1,<environment.Job instance at 0x7fb7e4f71f00>,58,12,[ 5 12],59,-1,177,-1,165
1,<environment.Job instance at 0x7fb7e4f71af0>,71,28,[2 8],72,-1,272,-1,244
1,<environment.Job instance at 0x7fb7e4f71cd0>,73,27,[9 3],74,-1,278,-1,251
1,<environment.Job instance at 0x7fb7e4f1e3c0>,76,28,[1 7],77,-1,291,-1,263
1,<environment.Job instance at 0x7fb7e4f1ef50>,79,2,[ 4 11],80,-1,265,-1,263
1,<environment.Job instance at 0x7fb7e4f1e4b0>,84,3,[11  1],85,-1,274,-1,271
1,<environment.Job instance at 0x7fb7e4f1e1e0>,86,28,[9 2],87,-1,302,-1,274
1,<environment.Job instance at 0x7fb7e4c667d0>,97,3,[ 1 12],98,-1,304,-1,301
1,<environment.Job instance at 0x7fb7e4c66b40>,98,15,[ 3 11],99,-1,316,-1,301
1,<environment.Job instance at 0x7fb7e4ebd410>,105,15,[ 2 11],106,-1,346,-1,331
1,<environment.Job instance at 0x7fb7e4ecd230>,106,23,[7 4],107,-1,357,-1,334
1,<environment.Job instance at 0x7fb7e4e21230>,120,16,[14  3],121,-1,382,-1,366
1,<environment.Job instance at 0x7fb7e4dca320>,131,27,[5 1],132,-1,437,-1,410
1,<environment.Job instance at 0x7fb7e4c9e7d0>,136,25,[8 3],137,-1,451,-1,426
1,<environment.Job instance at 0x7fb7e4dd3140>,137,13,[13  1],138,-1,439,-1,426
1,<environment.Job instance at 0x7fb7e4cd9cd0>,146,25,[ 5 10],147,-1,522,-1,497
1,<environment.Job instance at 0x7fb7e4e30e10>,166,2,[13  5],167,-1,543,-1,541
1,<environment.Job instance at 0x7fb7e4c33cd0>,0,26,[6 3],1,-1,27,-1,1
1,<environment.Job instance at 0x7fb7e574d050>,7,17,[4 9],8,-1,27,-1,10
1,<environment.Job instance at 0x7fb7e574dd70>,11,17,[10  4],12,-1,31,-1,14
1,<environment.Job instance at 0x7fb7e574d8c0>,14,14,[7 4],15,-1,29,-1,15
1,<environment.Job instance at 0x7fb7e574d910>,15,18,[10  3],16,-1,35,-1,17
1,<environment.Job instance at 0x7fb7e574d410>,17,18,[3 6],18,-1,36,-1,18
1,<environment.Job instance at 0x7fb7e57fce10>,24,18,[4 7],25,-1,43,-1,25
1,<environment.Job instance at 0x7fb7e574d870>,16,13,[13  3],17,-1,40,-1,27
1,<environment.Job instance at 0x7fb7e585c960>,36,17,[11  2],37,-1,59,-1,42
1,<environment.Job instance at 0x7fb7e585c280>,31,14,[ 3 14],32,-1,56,-1,42
1,<environment.Job instance at 0x7fb7e585cc30>,38,15,[3 6],39,-1,57,-1,42
1,<environment.Job instance at 0x7fb7e585c550>,39,18,[9 5],40,-1,61,-1,43
1,<environment.Job instance at 0x7fb7e585ca50>,40,28,[5 6],41,-1,71,-1,43
1,<environment.Job instance at 0x7fb7e5729a50>,44,17,[6 5],45,-1,63,-1,46
1,<environment.Job instance at 0x7fb7e5729320>,47,16,[ 5 10],48,-1,64,-1,48
1,<environment.Job instance at 0x7fb7e57298c0>,52,16,[9 4],53,-1,74,-1,58
1,<environment.Job instance at 0x7fb7e585cb90>,33,16,[4 9],34,-1,76,-1,60
1,<environment.Job instance at 0x7fb7e57290a0>,57,14,[4 7],58,-1,74,-1,60
1,<environment.Job instance at 0x7fb7e5729b90>,50,13,[12  5],51,-1,73,-1,60
1,<environment.Job instance at 0x7fb7e574dfa0>,0,26,[6 3],1,-1,27,-1,1
1,<environment.Job instance at 0x7fb7e574daa0>,2,17,[ 2 11],3,-1,20,-1,3
1,<environment.Job instance at 0x7fb7e574deb0>,5,23,[7 1],6,-1,29,-1,6
1,<environment.Job instance at 0x7fb7e585daa0>,13,12,[ 1 14],14,-1,28,-1,16
1,<environment.Job instance at 0x7fb7e4e18f50>,16,13,[13  3],17,-1,38,-1,25
1,<environment.Job instance at 0x7fb7e4cf3c80>,18,1,[ 3 14],19,-1,26,-1,25
1,<environment.Job instance at 0x7fb7e4ddb7d0>,31,14,[ 3 14],32,-1,89,-1,75
1,<environment.Job instance at 0x7fb7e4e15c30>,35,13,[ 1 12],36,-1,94,-1,81
1,<environment.Job instance at 0x7fb7e4e15960>,36,17,[11  2],37,-1,98,-1,81
1,<environment.Job instance at 0x7fb7e4fa6cd0>,40,28,[5 6],41,-1,128,-1,100
1,<environment.Job instance at 0x7fb7e4ee3a50>,43,28,[ 1 11],44,-1,130,-1,102
1,<environment.Job instance at 0x7fb7e4c5d320>,45,23,[5 3],46,-1,129,-1,106
1,<environment.Job instance at 0x7fb7e4c61230>,46,14,[13  5],47,-1,120,-1,106
1,<environment.Job instance at 0x7fb7e4f15fa0>,50,13,[12  5],51,-1,132,-1,119
1,<environment.Job instance at 0x7fb7e4f1ed70>,58,15,[ 3 13],59,-1,163,-1,148
1,<environment.Job instance at 0x7fb7e4f71c80>,66,18,[ 3 13],67,-1,199,-1,181
1,<environment.Job instance at 0x7fb7e4f71140>,77,2,[ 4 14],78,-1,228,-1,226
1,<environment.Job instance at 0x7fb7e4efac30>,84,2,[ 1 12],85,-1,246,-1,244
1,<environment.Job instance at 0x7fb7e4f6e370>,90,25,[2 8],91,-1,317,-1,292
1,<environment.Job instance at 0x7fb7e4f6e730>,94,3,[ 3 14],95,-1,299,-1,296
1,<environment.Job instance at 0x7fb7e4f6e1e0>,99,2,[13  5],100,-1,325,-1,323
1,<environment.Job instance at 0x7fb7e4e52640>,108,1,[ 3 12],109,-1,363,-1,362
1,<environment.Job instance at 0x7fb7e53ab9b0>,125,18,[14  2],126,-1,448,-1,430
1,<environment.Job instance at 0x7fb7e57356e0>,137,25,[9 4],138,-1,515,-1,490
1,<environment.Job instance at 0x7fb7e5735820>,141,3,[ 4 12],142,-1,495,-1,492
1,<environment.Job instance at 0x7fb7e5722140>,146,16,[14  3],147,-1,524,-1,508
1,<environment.Job instance at 0x7fb7e5722820>,147,14,[12  5],148,-1,522,-1,508
1,<environment.Job instance at 0x7fb7e5722eb0>,154,25,[7 4],155,-1,569,-1,544
1,<environment.Job instance at 0x7fb7e57818c0>,165,23,[8 2],166,-1,609,-1,586
1,<environment.Job instance at 0x7fb7e5cc3870>,0,16,[5 9],1,-1,17,-1,1
1,<environment.Job instance at 0x7fb7e491c370>,1,15,[9 5],2,-1,17,-1,2
1,<environment.Job instance at 0x7fb7e491c460>,2,14,[9 1],3,-1,18,-1,4
1,<environment.Job instance at 0x7fb7e55e7dc0>,3,18,[ 2 11],4,-1,24,-1,6
1,<environment.Job instance at 0x7fb7e491c780>,9,16,[ 4 10],10,-1,26,-1,10
1,<environment.Job instance at 0x7fb7e49309b0>,10,18,[5 8],11,-1,29,-1,11
1,<environment.Job instance at 0x7fb7e49301e0>,11,17,[3 7],12,-1,29,-1,12
1,<environment.Job instance at 0x7fb7e4930f00>,12,23,[7 1],13,-1,36,-1,13
1,<environment.Job instance at 0x7fb7e48ccc80>,14,14,[10  1],15,-1,34,-1,20
1,<environment.Job instance at 0x7fb7e49e8910>,20,15,[4 9],21,-1,36,-1,21
1,<environment.Job instance at 0x7fb7e49e8550>,21,15,[7 5],22,-1,37,-1,22
1,<environment.Job instance at 0x7fb7e49e8370>,26,17,[9 3],27,-1,44,-1,27
1,<environment.Job instance at 0x7fb7e4956aa0>,29,15,[5 6],30,-1,45,-1,30
1,<environment.Job instance at 0x7fb7e48cc8c0>,30,15,[9 1],31,-1,47,-1,32
1,<environment.Job instance at 0x7fb7e49357d0>,33,16,[ 4 10],34,-1,50,-1,34
1,<environment.Job instance at 0x7fb7e4935140>,34,18,[1 8],35,-1,53,-1,35
1,<environment.Job instance at 0x7fb7e4935e60>,37,15,[6 1],38,-1,53,-1,38
1,<environment.Job instance at 0x7fb7e4935640>,38,18,[5 8],39,-1,57,-1,39
1,<environment.Job instance at 0x7fb7e4a45190>,40,20,[9 5],41,-1,61,-1,41
1,<environment.Job instance at 0x7fb7e4a45780>,44,15,[7 5],45,-1,60,-1,45
1,<environment.Job instance at 0x7fb7e4915960>,47,15,[ 1 10],48,-1,63,-1,48
1,<environment.Job instance at 0x7fb7e4977050>,48,3,[2 7],49,-1,52,-1,49
1,<environment.Job instance at 0x7fb7e4911e60>,51,18,[3 7],52,-1,70,-1,52
1,<environment.Job instance at 0x7fb7e59749b0>,52,17,[1 9],53,-1,70,-1,53
1,<environment.Job instance at 0x7fb7e61038c0>,53,14,[5 5],54,-1,68,-1,54
1,<environment.Job instance at 0x7fb7e61031e0>,54,22,[9 5],55,-1,77,-1,55
1,<environment.Job instance at 0x7fb7e494f230>,56,13,[3 7],57,-1,70,-1,57
1,<environment.Job instance at 0x7fb7e5907050>,57,16,[5 8],58,-1,74,-1,58
1,<environment.Job instance at 0x7fb7e623db90>,58,16,[1 6],59,-1,75,-1,59
1,<environment.Job instance at 0x7fb7e5895c80>,60,13,[11  4],61,-1,74,-1,61
1,<environment.Job instance at 0x7fb7e623d0a0>,61,12,[ 1 13],62,-1,74,-1,62
1,<environment.Job instance at 0x7fb7e543b960>,63,15,[4 9],64,-1,79,-1,64
1,<environment.Job instance at 0x7fb7e5a144b0>,64,14,[10  4],65,-1,79,-1,65
1,<environment.Job instance at 0x7fb7e5d6e230>,66,12,[9 4],67,-1,79,-1,67
1,<environment.Job instance at 0x7fb7e6235b90>,68,12,[10  1],69,-1,81,-1,69
1,<environment.Job instance at 0x7fb7e6235e60>,69,21,[1 7],70,-1,91,-1,70
1,<environment.Job instance at 0x7fb7e6235c80>,70,16,[9 2],71,-1,87,-1,71
1,<environment.Job instance at 0x7fb7e6235d20>,74,1,[10  4],75,-1,76,-1,75
1,<environment.Job instance at 0x7fb7e62355a0>,75,12,[5 9],76,-1,88,-1,76
1,<environment.Job instance at 0x7fb7e62350f0>,77,17,[8 2],78,-1,95,-1,78
1,<environment.Job instance at 0x7fb7e6235500>,78,17,[1 6],79,-1,96,-1,79
1,<environment.Job instance at 0x7fb7e4abdeb0>,79,17,[9 2],80,-1,97,-1,80
1,<environment.Job instance at 0x7fb7e4935f50>,31,23,[ 3 13],32,-1,105,-1,82
1,<environment.Job instance at 0x7fb7e5d33460>,87,16,[3 5],88,-1,104,-1,88
1,<environment.Job instance at 0x7fb7e5ccdfa0>,93,18,[ 2 10],94,-1,113,-1,95
1,<environment.Job instance at 0x7fb7e591f960>,97,17,[7 4],98,-1,115,-1,98
1,<environment.Job instance at 0x7fb7e6239780>,98,15,[8 3],99,-1,114,-1,99
1,<environment.Job instance at 0x7fb7e6239b40>,99,16,[10  5],100,-1,116,-1,100
1,<environment.Job instance at 0x7fb7e6239fa0>,101,16,[5 3],102,-1,118,-1,102
1,<environment.Job instance at 0x7fb7e5913af0>,105,17,[ 2 10],106,-1,123,-1,106
1,<environment.Job instance at 0x7fb7e618c870>,108,19,[7 1],109,-1,128,-1,109
1,<environment.Job instance at 0x7fb7e618ca00>,110,18,[9 2],111,-1,129,-1,111
1,<environment.Job instance at 0x7fb7e618cf00>,113,14,[5 5],114,-1,128,-1,114
1,<environment.Job instance at 0x7fb7e618c050>,117,14,[11  2],118,-1,132,-1,118
1,<environment.Job instance at 0x7fb7e5cb2d70>,119,18,[1 5],120,-1,138,-1,120
1,<environment.Job instance at 0x7fb7e5cb2eb0>,120,27,[7 4],121,-1,148,-1,121
1,<environment.Job instance at 0x7fb7e5cb2140>,122,16,[10  2],123,-1,139,-1,123
1,<environment.Job instance at 0x7fb7e5cb2280>,123,15,[4 8],124,-1,139,-1,124
1,<environment.Job instance at 0x7fb7e5cb2e60>,126,13,[9 5],127,-1,140,-1,127
1,<environment.Job instance at 0x7fb7e607b190>,127,18,[6 2],128,-1,146,-1,128
1,<environment.Job instance at 0x7fb7e5ce6dc0>,94,17,[8 3],95,-1,145,-1,128
1,<environment.Job instance at 0x7fb7e607bbe0>,131,14,[9 5],132,-1,147,-1,133
1,<environment.Job instance at 0x7fb7e607b780>,134,19,[9 1],135,-1,165,-1,146
1,<environment.Job instance at 0x7fb7e607b550>,138,13,[3 7],139,-1,207,-1,194
1,<environment.Job instance at 0x7fb7e607b0a0>,132,15,[7 3],133,-1,210,-1,195
1,<environment.Job instance at 0x7fb7e508fe60>,159,14,[3 8],160,-1,210,-1,196
1,<environment.Job instance at 0x7fb7e5ccd460>,3,18,[ 2 11],4,-1,22,-1,4
1,<environment.Job instance at 0x7fb7e5ccdd20>,5,3,[11  2],6,-1,9,-1,6
1,<environment.Job instance at 0x7fb7e5cb2c80>,12,23,[7 1],13,-1,60,-1,37
1,<environment.Job instance at 0x7fb7e607b320>,15,3,[13  2],16,-1,40,-1,37
1,<environment.Job instance at 0x7fb7e5e11730>,18,1,[13  4],19,-1,48,-1,47
1,<environment.Job instance at 0x7fb7e51b0320>,22,13,[14  4],23,-1,65,-1,52
1,<environment.Job instance at 0x7fb7e5e49a50>,31,23,[ 3 13],32,-1,117,-1,94
1,<environment.Job instance at 0x7fb7e4abd230>,55,3,[ 1 14],56,-1,192,-1,189
1,<environment.Job instance at 0x7fb7e61c0c30>,60,13,[11  4],61,-1,221,-1,208
1,<environment.Job instance at 0x7fb7e4abd690>,61,12,[ 1 13],62,-1,220,-1,208
1,<environment.Job instance at 0x7fb7e4930e10>,72,17,[ 2 14],73,-1,272,-1,255
1,<environment.Job instance at 0x7fb7e49e8a50>,85,16,[11  3],86,-1,325,-1,309
1,<environment.Job instance at 0x7fb7e491f910>,96,1,[11  2],97,-1,334,-1,333
1,<environment.Job instance at 0x7fb7e4ad8af0>,117,14,[11  2],118,-1,423,-1,409
1,<environment.Job instance at 0x7fb7e55cf960>,118,15,[ 3 14],119,-1,424,-1,409
1,<environment.Job instance at 0x7fb7e4b33e10>,120,27,[7 4],121,-1,439,-1,412
1,<environment.Job instance at 0x7fb7e55dc460>,125,2,[ 1 12],126,-1,438,-1,436
1,<environment.Job instance at 0x7fb7e609dd70>,130,25,[ 1 14],131,-1,479,-1,454
1,<environment.Job instance at 0x7fb7e5507280>,133,1,[ 4 13],134,-1,469,-1,468
1,<environment.Job instance at 0x7fb7e5507c80>,135,3,[ 4 11],136,-1,481,-1,478
1,<environment.Job instance at 0x7fb7e5090460>,148,3,[11  1],149,-1,534,-1,531
1,<environment.Job instance at 0x7fb7e4e7bf00>,0,17,[8 4],1,-1,19,-1,2
1,<environment.Job instance at 0x7fb7e618f5f0>,2,19,[8 3],3,-1,22,-1,3
1,<environment.Job instance at 0x7fb7e618f690>,3,13,[8 3],4,-1,17,-1,4
1,<environment.Job instance at 0x7fb7e618f730>,4,17,[8 5],5,-1,22,-1,5
1,<environment.Job instance at 0x7fb7e4ed8690>,1,14,[ 5 10],2,-1,20,-1,6
1,<environment.Job instance at 0x7fb7e4e7ba50>,6,23,[5 5],7,-1,30,-1,7
1,<environment.Job instance at 0x7fb7e618fa50>,8,14,[9 5],9,-1,24,-1,10
1,<environment.Job instance at 0x7fb7e618faf0>,9,25,[7 3],10,-1,35,-1,10
1,<environment.Job instance at 0x7fb7e618fe60>,13,17,[6 4],14,-1,31,-1,14
1,<environment.Job instance at 0x7fb7e618fe10>,14,17,[4 7],15,-1,32,-1,15
1,<environment.Job instance at 0x7fb7e619f0a0>,16,13,[10  5],17,-1,31,-1,18
1,<environment.Job instance at 0x7fb7e619f5f0>,22,14,[10  1],23,-1,37,-1,23
1,<environment.Job instance at 0x7fb7e619f640>,24,15,[8 1],25,-1,40,-1,25
1,<environment.Job instance at 0x7fb7e619f910>,25,14,[5 7],26,-1,40,-1,26
1,<environment.Job instance at 0x7fb7e619fa00>,27,15,[3 9],28,-1,43,-1,28
1,<environment.Job instance at 0x7fb7e619fa50>,28,15,[ 4 10],29,-1,44,-1,29
1,<environment.Job instance at 0x7fb7e619fc80>,30,18,[5 4],31,-1,49,-1,31
1,<environment.Job instance at 0x7fb7e619fcd0>,32,19,[6 2],33,-1,52,-1,33
1,<environment.Job instance at 0x7fb7e6183140>,38,18,[ 4 10],39,-1,57,-1,39
1,<environment.Job instance at 0x7fb7e6183640>,40,14,[2 6],41,-1,55,-1,41
1,<environment.Job instance at 0x7fb7e6183a00>,43,16,[3 8],44,-1,60,-1,44
1,<environment.Job instance at 0x7fb7e6183b40>,44,16,[9 2],45,-1,61,-1,45
1,<environment.Job instance at 0x7fb7e6183be0>,46,18,[3 6],47,-1,65,-1,47
1,<environment.Job instance at 0x7fb7e6183d70>,47,18,[5 5],48,-1,66,-1,48
1,<environment.Job instance at 0x7fb7e61a9410>,53,18,[4 5],54,-1,73,-1,55
1,<environment.Job instance at 0x7fb7e61a91e0>,55,18,[5 8],56,-1,74,-1,56
1,<environment.Job instance at 0x7fb7e61a9640>,56,18,[3 9],57,-1,75,-1,57
1,<environment.Job instance at 0x7fb7e61a97d0>,59,23,[4 9],60,-1,83,-1,60
1,<environment.Job instance at 0x7fb7e61a9910>,61,16,[6 5],62,-1,78,-1,62
1,<environment.Job instance at 0x7fb7e61a9d20>,65,16,[6 5],66,-1,82,-1,66
1,<environment.Job instance at 0x7fb7e61a9e10>,66,12,[ 1 10],67,-1,79,-1,67
1,<environment.Job instance at 0x7fb7e61aa0a0>,67,18,[9 4],68,-1,86,-1,68
1,<environment.Job instance at 0x7fb7e61aa140>,68,15,[1 8],69,-1,84,-1,69
1,<environment.Job instance at 0x7fb7e61aa280>,70,15,[5 1],71,-1,86,-1,71
1,<environment.Job instance at 0x7fb7e61aa780>,76,1,[1 8],77,-1,78,-1,77
1,<environment.Job instance at 0x7fb7e61a9e60>,64,22,[5 8],65,-1,100,-1,78
1,<environment.Job instance at 0x7fb7e61aa8c0>,79,18,[1 9],80,-1,112,-1,94
1,<environment.Job instance at 0x7fb7e5109500>,89,18,[2 9],90,-1,114,-1,96
1,<environment.Job instance at 0x7fb7e51098c0>,90,18,[5 5],91,-1,114,-1,96
1,<environment.Job instance at 0x7fb7e6183c80>,48,22,[ 1 13],49,-1,118,-1,96
1,<environment.Job instance at 0x7fb7e5109960>,93,18,[5 2],94,-1,114,-1,96
1,<environment.Job instance at 0x7fb7e51091e0>,84,17,[3 7],85,-1,113,-1,96
1,<environment.Job instance at 0x7fb7e6193460>,101,13,[9 1],102,-1,115,-1,102
1,<environment.Job instance at 0x7fb7e61937d0>,104,15,[10  2],105,-1,120,-1,105
1,<environment.Job instance at 0x7fb7e61839b0>,6,23,[5 5],7,-1,39,-1,16
1,<environment.Job instance at 0x7fb7e61a99b0>,10,1,[12  5],11,-1,19,-1,18
1,<environment.Job instance at 0x7fb7e61a9cd0>,9,25,[7 3],10,-1,43,-1,18
1,<environment.Job instance at 0x7fb7e52af820>,21,3,[ 3 11],22,-1,52,-1,49
1,<environment.Job instance at 0x7fb7e5090a00>,35,3,[14  4],36,-1,93,-1,90
1,<environment.Job instance at 0x7fb7eee10d70>,36,17,[ 1 13],37,-1,107,-1,90
1,<environment.Job instance at 0x7fb7eee107d0>,37,18,[ 3 12],38,-1,108,-1,90
1,<environment.Job instance at 0x7fb7e5fc61e0>,41,2,[11  4],42,-1,108,-1,106
1,<environment.Job instance at 0x7fb7e60df730>,48,22,[ 1 13],49,-1,149,-1,127
1,<environment.Job instance at 0x7fb7e61eec30>,58,2,[11  2],59,-1,171,-1,169
1,<environment.Job instance at 0x7fb7e55dc8c0>,59,23,[4 9],60,-1,210,-1,187
1,<environment.Job instance at 0x7fb7e4ad8af0>,62,13,[14  2],63,-1,200,-1,187
1,<environment.Job instance at 0x7fb7e5a5ac30>,80,2,[ 4 14],81,-1,244,-1,242
1,<environment.Job instance at 0x7fb7e4930dc0>,103,17,[14  2],104,-1,349,-1,332
1,<environment.Job instance at 0x7fb7e4abd780>,116,2,[ 5 12],117,-1,362,-1,360
1,<environment.Job instance at 0x7fb7e4abd230>,117,23,[6 1],118,-1,386,-1,363
1,<environment.Job instance at 0x7fb7e4a454b0>,130,25,[9 4],131,-1,438,-1,413
1,<environment.Job instance at 0x7fb7e4a45730>,134,28,[ 5 10],135,-1,458,-1,430
1,<environment.Job instance at 0x7fb7e5e49a50>,137,27,[2 9],138,-1,458,-1,431
1,<environment.Job instance at 0x7fb7e493e370>,138,26,[4 9],139,-1,457,-1,431
1,<environment.Job instance at 0x7fb7e4e77870>,146,16,[ 5 12],147,-1,478,-1,462
1,<environment.Job instance at 0x7fb7e5ce6730>,166,17,[ 2 14],167,-1,550,-1,533
1,<environment.Job instance at 0x7fb7e62352d0>,167,26,[10  5],168,-1,586,-1,560
1,<environment.Job instance at 0x7fb7e5143640>,0,18,[4 5],1,-1,19,-1,1
1,<environment.Job instance at 0x7fb7e51436e0>,1,18,[4 9],2,-1,20,-1,2
1,<environment.Job instance at 0x7fb7e4a76910>,3,13,[9 3],4,-1,18,-1,5
1,<environment.Job instance at 0x7fb7e4a76140>,5,14,[ 3 10],6,-1,20,-1,6
1,<environment.Job instance at 0x7fb7e4a76870>,6,14,[5 4],7,-1,21,-1,7
1,<environment.Job instance at 0x7fb7e55f8af0>,8,12,[1 9],9,-1,21,-1,9
1,<environment.Job instance at 0x7fb7e52afeb0>,4,19,[2 5],5,-1,29,-1,10
1,<environment.Job instance at 0x7fb7e61b7b90>,14,22,[1 8],15,-1,38,-1,16
1,<environment.Job instance at 0x7fb7e61b7910>,16,1,[6 4],17,-1,18,-1,17
1,<environment.Job instance at 0x7fb7e61b7820>,19,17,[9 1],20,-1,37,-1,20
1,<environment.Job instance at 0x7fb7e61b7d70>,20,16,[4 8],21,-1,37,-1,21
1,<environment.Job instance at 0x7fb7e61b7320>,22,26,[1 5],23,-1,49,-1,23
1,<environment.Job instance at 0x7fb7e61b7640>,23,17,[ 4 10],24,-1,41,-1,24
1,<environment.Job instance at 0x7fb7e6196370>,25,15,[8 3],26,-1,41,-1,26
1,<environment.Job instance at 0x7fb7e61961e0>,30,13,[10  5],31,-1,44,-1,31
1,<environment.Job instance at 0x7fb7e5895640>,32,22,[5 3],33,-1,55,-1,33
1,<environment.Job instance at 0x7fb7e5895d70>,34,15,[4 7],35,-1,50,-1,35
1,<environment.Job instance at 0x7fb7e5895410>,37,24,[2 8],38,-1,62,-1,38
1,<environment.Job instance at 0x7fb7e58958c0>,41,16,[4 9],42,-1,58,-1,42
1,<environment.Job instance at 0x7fb7eed49b40>,51,23,[9 4],52,-1,142,-1,119
1,<environment.Job instance at 0x7fb7e4d07960>,49,15,[ 1 14],50,-1,134,-1,119
1,<environment.Job instance at 0x7fb7eeba17d0>,66,3,[ 1 10],67,-1,122,-1,119
1,<environment.Job instance at 0x7fb7eeba1b40>,67,17,[4 6],68,-1,136,-1,119
1,<environment.Job instance at 0x7fb7eeba1b90>,70,18,[3 6],71,-1,138,-1,120
1,<environment.Job instance at 0x7fb7eeba1320>,73,13,[6 4],74,-1,135,-1,122
1,<environment.Job instance at 0x7fb7eeba1a00>,72,16,[1 9],73,-1,138,-1,122
1,<environment.Job instance at 0x7fb7eeba11e0>,76,16,[2 7],77,-1,138,-1,122
1,<environment.Job instance at 0x7fb7e4f68730>,84,17,[10  5],85,-1,356,-1,339
1,<environment.Job instance at 0x7fb7e500b460>,125,18,[10  4],126,-1,388,-1,370
1,<environment.Job instance at 0x7fb7e5024a00>,13,23,[1 7],14,-1,57,-1,34
1,<environment.Job instance at 0x7fb7e514b460>,18,13,[14  3],19,-1,48,-1,35
1,<environment.Job instance at 0x7fb7e5064820>,22,26,[1 5],23,-1,72,-1,46
1,<environment.Job instance at 0x7fb7e5479910>,37,24,[2 8],38,-1,127,-1,103
1,<environment.Job instance at 0x7fb7e5d378c0>,39,13,[14  2],40,-1,116,-1,103
1,<environment.Job instance at 0x7fb7e595ed20>,43,26,[1 8],44,-1,146,-1,120
1,<environment.Job instance at 0x7fb7e53d6190>,49,15,[ 1 14],50,-1,151,-1,136
1,<environment.Job instance at 0x7fb7e53d6500>,51,23,[9 4],52,-1,162,-1,139
1,<environment.Job instance at 0x7fb7e491c140>,87,16,[11  5],88,-1,304,-1,288
1,<environment.Job instance at 0x7fb7e491c320>,91,3,[13  1],92,-1,300,-1,297
1,<environment.Job instance at 0x7fb7e4930370>,105,1,[ 3 12],106,-1,350,-1,349
1,<environment.Job instance at 0x7fb7e4956230>,108,3,[ 5 12],109,-1,368,-1,365
1,<environment.Job instance at 0x7fb7e5a5ac30>,116,1,[11  1],117,-1,397,-1,396
1,<environment.Job instance at 0x7fb7e49356e0>,120,13,[11  3],121,-1,411,-1,398
1,<environment.Job instance at 0x7fb7e49353c0>,121,28,[7 5],122,-1,429,-1,401
1,<environment.Job instance at 0x7fb7e497d320>,123,2,[14  5],124,-1,403,-1,401
1,<environment.Job instance at 0x7fb7e4935410>,124,26,[7 1],125,-1,437,-1,411
1,<environment.Job instance at 0x7fb7e4ad8960>,137,13,[13  4],138,-1,463,-1,450
1,<environment.Job instance at 0x7fb7e4ad8e10>,141,3,[ 4 12],142,-1,471,-1,468
1,<environment.Job instance at 0x7fb7e4ad8410>,140,24,[10  5],141,-1,508,-1,484
1,<environment.Job instance at 0x7fb7e5062320>,145,18,[ 2 11],146,-1,502,-1,484
1,<environment.Job instance at 0x7fb7e5cb09b0>,146,13,[11  3],147,-1,497,-1,484
1,<environment.Job instance at 0x7fb7e5a0fe60>,148,27,[5 1],149,-1,528,-1,501
1,<environment.Job instance at 0x7fb7e5f9ec30>,158,27,[1 7],159,-1,564,-1,537
1,<environment.Job instance at 0x7fb7e5416cd0>,159,16,[12  5],160,-1,553,-1,537
1,<environment.Job instance at 0x7fb7e5a8bbe0>,166,1,[14  4],167,-1,547,-1,546
1,<environment.Job instance at 0x7fb7e5a8b050>,167,17,[13  5],168,-1,563,-1,546
1,<environment.Job instance at 0x7fb7e4daacd0>,0,17,[5 9],1,-1,18,-1,1
1,<environment.Job instance at 0x7fb7e4daa5f0>,1,17,[9 4],2,-1,19,-1,2
1,<environment.Job instance at 0x7fb7e4daa730>,4,14,[9 5],5,-1,20,-1,6
1,<environment.Job instance at 0x7fb7e4daa190>,5,14,[6 1],6,-1,20,-1,6
1,<environment.Job instance at 0x7fb7e4daaaf0>,6,16,[3 8],7,-1,23,-1,7
1,<environment.Job instance at 0x7fb7e4daa140>,7,18,[ 5 10],8,-1,26,-1,8
1,<environment.Job instance at 0x7fb7e4daa0a0>,12,12,[10  2],13,-1,27,-1,15
1,<environment.Job instance at 0x7fb7e4dbc500>,15,14,[8 4],16,-1,30,-1,16
1,<environment.Job instance at 0x7fb7e4dbc050>,16,18,[ 2 10],17,-1,35,-1,17
1,<environment.Job instance at 0x7fb7e4dbc460>,17,18,[5 9],18,-1,36,-1,18
1,<environment.Job instance at 0x7fb7e4dbc190>,14,18,[ 2 10],15,-1,37,-1,19
1,<environment.Job instance at 0x7fb7e4dbcf00>,20,17,[8 2],21,-1,39,-1,22
1,<environment.Job instance at 0x7fb7e4dbca50>,22,16,[6 2],23,-1,39,-1,23
1,<environment.Job instance at 0x7fb7e4dbc9b0>,24,15,[2 5],25,-1,40,-1,25
1,<environment.Job instance at 0x7fb7e4dbc1e0>,25,13,[2 7],26,-1,39,-1,26
1,<environment.Job instance at 0x7fb7e4dbc0a0>,28,25,[5 5],29,-1,54,-1,29
1,<environment.Job instance at 0x7fb7e4dacdc0>,35,14,[5 9],36,-1,50,-1,36
1,<environment.Job instance at 0x7fb7e4dac230>,36,15,[2 7],37,-1,52,-1,37
1,<environment.Job instance at 0x7fb7e4dac2d0>,37,16,[3 5],38,-1,54,-1,38
1,<environment.Job instance at 0x7fb7e4dac8c0>,38,17,[2 7],39,-1,56,-1,39
1,<environment.Job instance at 0x7fb7e4daca50>,39,16,[8 5],40,-1,56,-1,40
1,<environment.Job instance at 0x7fb7e4dac820>,40,22,[4 6],41,-1,63,-1,41
1,<environment.Job instance at 0x7fb7e4dacaa0>,42,18,[5 6],43,-1,61,-1,43
1,<environment.Job instance at 0x7fb7e4daccd0>,43,14,[4 8],44,-1,58,-1,44
1,<environment.Job instance at 0x7fb7e4dac410>,44,18,[10  2],45,-1,63,-1,45
1,<environment.Job instance at 0x7fb7e4dac910>,45,17,[3 9],46,-1,63,-1,46
1,<environment.Job instance at 0x7fb7e4dac5f0>,48,12,[10  5],49,-1,61,-1,49
1,<environment.Job instance at 0x7fb7e49ea640>,69,15,[4 9],70,-1,86,-1,71
1,<environment.Job instance at 0x7fb7e4c9b640>,55,16,[ 4 12],56,-1,88,-1,72
1,<environment.Job instance at 0x7fb7e4d96d70>,70,15,[1 6],71,-1,87,-1,72
1,<environment.Job instance at 0x7fb7e57d5960>,88,18,[ 4 12],89,-1,121,-1,103
1,<environment.Job instance at 0x7fb7e629b050>,75,16,[8 5],76,-1,119,-1,103
1,<environment.Job instance at 0x7fb7e4d96370>,71,22,[2 9],72,-1,138,-1,116
1,<environment.Job instance at 0x7fb7e4965e60>,94,26,[10  2],95,-1,142,-1,116
1,<environment.Job instance at 0x7fb7e5e61c80>,92,18,[ 5 10],93,-1,135,-1,117
1,<environment.Job instance at 0x7fb7e6218230>,143,18,[10  5],144,-1,1404,-1,1386
1,<environment.Job instance at 0x7fb7e49facd0>,129,27,[ 5 11],130,-1,1414,-1,1387
1,<environment.Job instance at 0x7fb7e6183410>,148,24,[8 3],149,-1,1412,-1,1388
1,<environment.Job instance at 0x7fb7e6183eb0>,149,14,[3 5],150,-1,1402,-1,1388
1,<environment.Job instance at 0x7fb7e58ae460>,133,25,[9 3],134,-1,1413,-1,1388
1,<environment.Job instance at 0x7fb7e49ecd20>,154,17,[9 5],155,-1,1405,-1,1388
1,<environment.Job instance at 0x7fb7e49d28c0>,155,14,[2 9],156,-1,1402,-1,1388
1,<environment.Job instance at 0x7fb7e494cf50>,159,19,[2 9],160,-1,1438,-1,1419
1,<environment.Job instance at 0x7fb7e4a075a0>,165,14,[10  1],166,-1,1433,-1,1419
1,<environment.Job instance at 0x7fb7e4b9e460>,167,17,[1 7],168,-1,1436,-1,1419
1,<environment.Job instance at 0x7fb7e4bc7f50>,28,25,[5 5],29,-1,138,-1,113
1,<environment.Job instance at 0x7fb7e4bc7870>,30,18,[14  5],31,-1,131,-1,113
1,<environment.Job instance at 0x7fb7e4bc7e10>,31,15,[ 1 12],32,-1,128,-1,113
1,<environment.Job instance at 0x7fb7e5a0fe60>,52,17,[ 3 14],53,-1,227,-1,210
1,<environment.Job instance at 0x7fb7e4939a50>,55,16,[ 4 12],56,-1,230,-1,214
1,<environment.Job instance at 0x7fb7e53d69b0>,58,18,[13  3],59,-1,243,-1,225
1,<environment.Job instance at 0x7fb7e53d60f0>,59,1,[ 4 14],60,-1,226,-1,225
1,<environment.Job instance at 0x7fb7e5cbcbe0>,62,16,[14  1],63,-1,246,-1,230
1,<environment.Job instance at 0x7fb7e512caa0>,65,1,[ 5 13],66,-1,232,-1,231
1,<environment.Job instance at 0x7fb7e52ec5f0>,73,3,[ 5 11],74,-1,266,-1,263
1,<environment.Job instance at 0x7fb7e4d07730>,81,3,[ 3 11],82,-1,273,-1,270
1,<environment.Job instance at 0x7fb7e49cdaf0>,88,18,[ 4 12],89,-1,311,-1,293
1,<environment.Job instance at 0x7fb7e499e640>,94,26,[10  2],95,-1,345,-1,319
1,<environment.Job instance at 0x7fb7e4dc7b90>,107,15,[13  3],108,-1,362,-1,347
1,<environment.Job instance at 0x7fb7e4dc7e60>,121,2,[ 2 13],122,-1,377,-1,375
1,<environment.Job instance at 0x7fb7e4c97960>,128,2,[12  1],129,-1,395,-1,393
1,<environment.Job instance at 0x7fb7e4c97b40>,129,27,[ 5 11],130,-1,420,-1,393
1,<environment.Job instance at 0x7fb7e4c977d0>,133,25,[9 3],134,-1,459,-1,434
1,<environment.Job instance at 0x7fb7e4c978c0>,138,17,[ 2 12],139,-1,456,-1,439
1,<environment.Job instance at 0x7fb7e4c97d20>,140,26,[9 4],141,-1,494,-1,468
1,<environment.Job instance at 0x7fb7e4d8af00>,145,14,[13  2],146,-1,482,-1,468
1,<environment.Job instance at 0x7fb7e4d8a3c0>,148,24,[8 3],149,-1,496,-1,472
1,<environment.Job instance at 0x7fb7e57b9f50>,2,17,[8 1],3,-1,21,-1,4
1,<environment.Job instance at 0x7fb7e57a2050>,4,13,[2 5],5,-1,18,-1,5
1,<environment.Job instance at 0x7fb7e57a21e0>,5,17,[1 8],6,-1,23,-1,6
1,<environment.Job instance at 0x7fb7e57a27d0>,12,18,[6 4],13,-1,31,-1,13
1,<environment.Job instance at 0x7fb7e57a2640>,13,18,[1 8],14,-1,32,-1,14
1,<environment.Job instance at 0x7fb7e57ba820>,28,18,[5 6],29,-1,47,-1,29
1,<environment.Job instance at 0x7fb7e59a50a0>,3,26,[2 9],4,-1,59,-1,33
1,<environment.Job instance at 0x7fb7e57ba960>,32,18,[7 3],33,-1,58,-1,40
1,<environment.Job instance at 0x7fb7e57baf00>,36,12,[4 6],37,-1,52,-1,40
1,<environment.Job instance at 0x7fb7e57ba460>,25,13,[2 6],26,-1,53,-1,40
1,<environment.Job instance at 0x7fb7e57bafa0>,37,16,[3 5],38,-1,56,-1,40
1,<environment.Job instance at 0x7fb7e57c3140>,39,23,[5 5],40,-1,63,-1,40
1,<environment.Job instance at 0x7fb7e57c3280>,40,17,[8 3],41,-1,59,-1,42
1,<environment.Job instance at 0x7fb7e57bae60>,35,16,[5 7],36,-1,58,-1,42
1,<environment.Job instance at 0x7fb7e4a91370>,43,13,[10  3],44,-1,65,-1,52
1,<environment.Job instance at 0x7fb7e4d9b910>,45,24,[7 5],46,-1,76,-1,52
1,<environment.Job instance at 0x7fb7e4a91f50>,44,17,[5 6],45,-1,69,-1,52
1,<environment.Job instance at 0x7fb7e4db4820>,52,17,[3 8],53,-1,87,-1,70
1,<environment.Job instance at 0x7fb7e4db40f0>,62,16,[6 3],63,-1,109,-1,93
1,<environment.Job instance at 0x7fb7e51d1dc0>,65,19,[8 1],66,-1,114,-1,95
1,<environment.Job instance at 0x7fb7e533d870>,71,23,[7 5],72,-1,118,-1,95
1,<environment.Job instance at 0x7fb7e624d410>,73,22,[5 4],74,-1,117,-1,95
1,<environment.Job instance at 0x7fb7e624d230>,75,17,[ 4 10],76,-1,112,-1,95
1,<environment.Job instance at 0x7fb7e4db42d0>,61,15,[3 9],62,-1,113,-1,98
1,<environment.Job instance at 0x7fb7e5d8b1e0>,80,16,[1 5],81,-1,114,-1,98
1,<environment.Job instance at 0x7fb7e5d71d70>,83,18,[10  5],84,-1,121,-1,103
1,<environment.Job instance at 0x7fb7e5a83c30>,81,17,[6 5],82,-1,120,-1,103
1,<environment.Job instance at 0x7fb7e5a32a00>,67,15,[6 1],68,-1,118,-1,103
1,<environment.Job instance at 0x7fb7e5d71050>,86,16,[3 6],87,-1,119,-1,103
1,<environment.Job instance at 0x7fb7e62704b0>,93,18,[4 9],94,-1,123,-1,105
1,<environment.Job instance at 0x7fb7e5a79870>,94,26,[7 4],95,-1,131,-1,105
1,<environment.Job instance at 0x7fb7e57436e0>,72,28,[8 2],73,-1,133,-1,105
1,<environment.Job instance at 0x7fb7e6270b90>,98,16,[1 8],99,-1,123,-1,107
1,<environment.Job instance at 0x7fb7e6270870>,101,13,[5 5],102,-1,120,-1,107
1,<environment.Job instance at 0x7fb7e6252050>,104,17,[10  4],105,-1,127,-1,110
1,<environment.Job instance at 0x7fb7e6252af0>,108,16,[14  5],109,-1,127,-1,111
1,<environment.Job instance at 0x7fb7e6252c30>,110,13,[8 3],111,-1,125,-1,112
1,<environment.Job instance at 0x7fb7e6252eb0>,111,16,[8 1],112,-1,129,-1,113
1,<environment.Job instance at 0x7fb7e4d8e410>,112,14,[ 2 12],113,-1,128,-1,114
1,<environment.Job instance at 0x7fb7e6270aa0>,99,12,[9 3],100,-1,127,-1,115
1,<environment.Job instance at 0x7fb7e5a9c5f0>,115,15,[ 2 12],116,-1,133,-1,118
1,<environment.Job instance at 0x7fb7e4db0550>,117,19,[4 7],118,-1,137,-1,118
1,<environment.Job instance at 0x7fb7e4db0320>,119,15,[6 1],120,-1,137,-1,122
1,<environment.Job instance at 0x7fb7e4db00a0>,120,17,[2 8],121,-1,140,-1,123
1,<environment.Job instance at 0x7fb7e4d9fb90>,127,18,[7 1],128,-1,151,-1,133
1,<environment.Job instance at 0x7fb7e4d9fbe0>,128,16,[10  3],129,-1,149,-1,133
1,<environment.Job instance at 0x7fb7e4d95370>,129,15,[9 3],130,-1,149,-1,134
1,<environment.Job instance at 0x7fb7e4d954b0>,134,23,[6 5],135,-1,165,-1,142
1,<environment.Job instance at 0x7fb7e4d95a00>,133,16,[4 9],134,-1,158,-1,142
1,<environment.Job instance at 0x7fb7e4d950f0>,138,12,[ 3 10],139,-1,154,-1,142
1,<environment.Job instance at 0x7fb7e4d9f640>,124,16,[6 3],125,-1,158,-1,142
1,<environment.Job instance at 0x7fb7e4d95140>,132,22,[6 2],133,-1,164,-1,142
1,<environment.Job instance at 0x7fb7e6240eb0>,142,17,[1 6],143,-1,160,-1,143
1,<environment.Job instance at 0x7fb7e62409b0>,143,21,[7 4],144,-1,165,-1,144
1,<environment.Job instance at 0x7fb7e6240500>,150,26,[5 7],151,-1,185,-1,159
1,<environment.Job instance at 0x7fb7e4be86e0>,151,16,[ 2 10],152,-1,175,-1,159
1,<environment.Job instance at 0x7fb7e4cfc870>,153,15,[10  1],154,-1,174,-1,159
1,<environment.Job instance at 0x7fb7e4e7daf0>,154,20,[5 9],155,-1,179,-1,159
1,<environment.Job instance at 0x7fb7e4dbdb40>,141,12,[1 7],142,-1,171,-1,159
1,<environment.Job instance at 0x7fb7e520a6e0>,157,15,[1 7],158,-1,174,-1,159
1,<environment.Job instance at 0x7fb7e61a8230>,158,18,[5 6],159,-1,177,-1,159
1,<environment.Job instance at 0x7fb7e6245af0>,165,16,[10  2],166,-1,182,-1,166
1,<environment.Job instance at 0x7fb7e57ba780>,3,26,[2 9],4,-1,30,-1,4
1,<environment.Job instance at 0x7fb7e5431be0>,6,13,[12  4],7,-1,20,-1,7
1,<environment.Job instance at 0x7fb7e5d4aeb0>,11,17,[13  5],12,-1,35,-1,18
1,<environment.Job instance at 0x7fb7e6245190>,39,23,[5 5],40,-1,121,-1,98
1,<environment.Job instance at 0x7fb7e4d8a230>,45,24,[7 5],46,-1,153,-1,129
1,<environment.Job instance at 0x7fb7e4d8a500>,47,3,[ 2 13],48,-1,132,-1,129
1,<environment.Job instance at 0x7fb7e4c97910>,60,1,[13  2],61,-1,172,-1,171
1,<environment.Job instance at 0x7fb7e4c971e0>,63,1,[ 2 13],64,-1,185,-1,184
1,<environment.Job instance at 0x7fb7e4c97c30>,66,1,[ 4 11],67,-1,200,-1,199
1,<environment.Job instance at 0x7fb7e4c97dc0>,71,23,[7 5],72,-1,226,-1,203
1,<environment.Job instance at 0x7fb7e4c97b40>,72,28,[8 2],73,-1,243,-1,215
1,<environment.Job instance at 0x7fb7e499e6e0>,94,26,[7 4],95,-1,276,-1,250
1,<environment.Job instance at 0x7fb7e499e7d0>,95,1,[12  3],96,-1,251,-1,250
1,<environment.Job instance at 0x7fb7e49cd820>,108,16,[14  5],109,-1,306,-1,290
1,<environment.Job instance at 0x7fb7e4d075f0>,112,14,[ 2 12],113,-1,307,-1,293
1,<environment.Job instance at 0x7fb7e52ec0f0>,115,15,[ 2 12],116,-1,322,-1,307
1,<environment.Job instance at 0x7fb7e53d6820>,134,23,[6 5],135,-1,428,-1,405
1,<environment.Job instance at 0x7fb7e4998e60>,145,15,[ 5 11],146,-1,439,-1,424
1,<environment.Job instance at 0x7fb7ee85daa0>,150,26,[5 7],151,-1,455,-1,429
1,<environment.Job instance at 0x7fb7e4cd0e10>,159,27,[5 9],160,-1,484,-1,457
1,<environment.Job instance at 0x7fb7e49965f0>,163,28,[3 5],164,-1,492,-1,464
1,<environment.Job instance at 0x7fb7e4996320>,162,26,[ 1 10],163,-1,500,-1,474
1,<environment.Job instance at 0x7fb7e5798aa0>,0,20,[5 8],1,-1,21,-1,1
1,<environment.Job instance at 0x7fb7e4c2f0a0>,6,18,[3 5],7,-1,25,-1,7
1,<environment.Job instance at 0x7fb7e4c2feb0>,10,21,[5 2],11,-1,32,-1,11
1,<environment.Job instance at 0x7fb7e4c2f5f0>,12,16,[11  5],13,-1,29,-1,13
1,<environment.Job instance at 0x7fb7e4c2f7d0>,14,18,[3 8],15,-1,33,-1,15
1,<environment.Job instance at 0x7fb7e4c2f730>,16,14,[3 9],17,-1,31,-1,17
1,<environment.Job instance at 0x7fb7e4be83c0>,18,13,[5 9],19,-1,32,-1,19
1,<environment.Job instance at 0x7fb7e4be8780>,20,14,[5 5],21,-1,35,-1,21
1,<environment.Job instance at 0x7fb7e4be87d0>,21,17,[2 9],22,-1,39,-1,22
1,<environment.Job instance at 0x7fb7e49455a0>,34,18,[6 3],35,-1,53,-1,35
1,<environment.Job instance at 0x7fb7e58c56e0>,35,23,[7 4],36,-1,59,-1,36
1,<environment.Job instance at 0x7fb7e58c5d20>,36,23,[5 6],37,-1,60,-1,37
1,<environment.Job instance at 0x7fb7e58c5230>,37,16,[2 6],38,-1,54,-1,38
1,<environment.Job instance at 0x7fb7e58c5c30>,39,15,[5 3],40,-1,56,-1,41
1,<environment.Job instance at 0x7fb7e4945410>,40,17,[6 4],41,-1,58,-1,41
1,<environment.Job instance at 0x7fb7e58c5690>,42,18,[9 5],43,-1,61,-1,43
1,<environment.Job instance at 0x7fb7e58c54b0>,45,15,[9 5],46,-1,61,-1,46
1,<environment.Job instance at 0x7fb7e58c5820>,47,26,[ 2 10],48,-1,74,-1,48
1,<environment.Job instance at 0x7fb7e5badeb0>,51,16,[8 5],52,-1,68,-1,52
1,<environment.Job instance at 0x7fb7e5badf00>,52,2,[5 1],53,-1,56,-1,54
1,<environment.Job instance at 0x7fb7e5060e60>,54,17,[5 7],55,-1,72,-1,55
1,<environment.Job instance at 0x7fb7e5060eb0>,55,12,[5 1],56,-1,68,-1,56
1,<environment.Job instance at 0x7fb7e5bad0a0>,53,17,[ 5 12],54,-1,73,-1,56
1,<environment.Job instance at 0x7fb7e5b40aa0>,68,12,[12  2],69,-1,221,-1,209
1,<environment.Job instance at 0x7fb7e5b40370>,87,27,[2 6],88,-1,236,-1,209
1,<environment.Job instance at 0x7fb7e5b40a50>,80,25,[8 3],81,-1,235,-1,210
1,<environment.Job instance at 0x7fb7e5b405a0>,86,17,[3 8],87,-1,227,-1,210
1,<environment.Job instance at 0x7fb7e5533640>,89,18,[5 2],90,-1,228,-1,210
1,<environment.Job instance at 0x7fb7e5533e60>,92,13,[9 4],93,-1,223,-1,210
1,<environment.Job instance at 0x7fb7e5533140>,95,18,[5 5],96,-1,228,-1,210
1,<environment.Job instance at 0x7fb7e5b40d20>,69,14,[8 5],70,-1,228,-1,214
1,<environment.Job instance at 0x7fb7e55334b0>,98,14,[3 7],99,-1,228,-1,214
1,<environment.Job instance at 0x7fb7e5533690>,96,14,[10  1],97,-1,228,-1,214
1,<environment.Job instance at 0x7fb7e55331e0>,100,17,[4 8],101,-1,233,-1,216
1,<environment.Job instance at 0x7fb7e55337d0>,101,17,[3 6],102,-1,233,-1,216
1,<environment.Job instance at 0x7fb7e5533cd0>,102,17,[ 4 10],103,-1,233,-1,216
1,<environment.Job instance at 0x7fb7e5533910>,109,18,[5 5],110,-1,234,-1,216
1,<environment.Job instance at 0x7fb7e5533370>,110,16,[5 4],111,-1,232,-1,216
1,<environment.Job instance at 0x7fb7e5533c30>,111,18,[5 5],112,-1,234,-1,216
1,<environment.Job instance at 0x7fb7e4ed3af0>,112,28,[5 1],113,-1,244,-1,216
1,<environment.Job instance at 0x7fb7e55338c0>,97,26,[ 5 10],98,-1,242,-1,216
1,<environment.Job instance at 0x7fb7e4ed3690>,116,17,[3 7],117,-1,234,-1,217
1,<environment.Job instance at 0x7fb7e4ed3370>,121,17,[ 4 10],122,-1,274,-1,257
1,<environment.Job instance at 0x7fb7e4ed36e0>,114,17,[6 1],115,-1,281,-1,264
1,<environment.Job instance at 0x7fb7e5b407d0>,81,27,[8 1],82,-1,291,-1,264
1,<environment.Job instance at 0x7fb7e4b0f0a0>,162,18,[7 2],163,-1,396,-1,378
1,<environment.Job instance at 0x7fb7e58c5af0>,38,25,[ 5 10],39,-1,403,-1,378
1,<environment.Job instance at 0x7fb7e5b40140>,9,14,[ 1 13],10,-1,24,-1,10
1,<environment.Job instance at 0x7fb7e4b0fdc0>,12,16,[11  5],13,-1,37,-1,21
1,<environment.Job instance at 0x7fb7e5112190>,35,23,[7 4],36,-1,111,-1,88
1,<environment.Job instance at 0x7fb7e5112f50>,36,23,[5 6],37,-1,111,-1,88
1,<environment.Job instance at 0x7fb7e4e1dd20>,41,12,[ 5 11],42,-1,116,-1,104
1,<environment.Job instance at 0x7fb7e4c2f500>,47,26,[ 2 10],48,-1,152,-1,126
1,<environment.Job instance at 0x7fb7e4e1d870>,38,25,[ 5 10],39,-1,165,-1,140
1,<environment.Job instance at 0x7fb7e4cd0d20>,53,17,[ 5 12],54,-1,157,-1,140
1,<environment.Job instance at 0x7fb7e4daa0f0>,67,2,[ 5 11],68,-1,184,-1,182
1,<environment.Job instance at 0x7fb7e4daaa00>,68,12,[12  2],69,-1,194,-1,182
1,<environment.Job instance at 0x7fb7e55078c0>,70,2,[ 4 14],71,-1,185,-1,183
1,<environment.Job instance at 0x7fb7e52ecbe0>,80,25,[8 3],81,-1,251,-1,226
1,<environment.Job instance at 0x7fb7e52ec7d0>,81,27,[8 1],82,-1,253,-1,226
1,<environment.Job instance at 0x7fb7e49cda00>,87,27,[2 6],88,-1,272,-1,245
1,<environment.Job instance at 0x7fb7e499e550>,97,26,[ 5 10],98,-1,294,-1,268
1,<environment.Job instance at 0x7fb7e499e4b0>,99,1,[12  4],100,-1,269,-1,268
1,<environment.Job instance at 0x7fb7e499ecd0>,104,1,[ 1 11],105,-1,299,-1,298
1,<environment.Job instance at 0x7fb7e499ef50>,105,1,[ 3 14],106,-1,299,-1,298
1,<environment.Job instance at 0x7fb7e4dc7370>,112,28,[5 1],113,-1,345,-1,317
1,<environment.Job instance at 0x7fb7e4dc7050>,119,13,[ 1 13],120,-1,349,-1,336
1,<environment.Job instance at 0x7fb7e4c97a00>,124,23,[2 9],125,-1,379,-1,356
1,<environment.Job instance at 0x7fb7e4c970f0>,126,3,[14  4],127,-1,359,-1,356
1,<environment.Job instance at 0x7fb7e4d8adc0>,138,26,[2 5],139,-1,446,-1,420
1,<environment.Job instance at 0x7fb7e4d8aaa0>,139,28,[4 8],140,-1,448,-1,420
1,<environment.Job instance at 0x7fb7e4d8af00>,140,28,[1 5],141,-1,448,-1,420
1,<environment.Job instance at 0x7fb7e4d8a5f0>,147,28,[ 1 10],148,-1,455,-1,427
1,<environment.Job instance at 0x7fb7ee869730>,6,20,[10  4],7,-1,27,-1,7
1,<environment.Job instance at 0x7fb7ee869b90>,9,13,[3 6],10,-1,23,-1,10
1,<environment.Job instance at 0x7fb7e5514410>,15,17,[5 8],16,-1,33,-1,16
1,<environment.Job instance at 0x7fb7e5589230>,20,16,[8 2],21,-1,38,-1,22
1,<environment.Job instance at 0x7fb7e55898c0>,22,17,[5 5],23,-1,40,-1,23
1,<environment.Job instance at 0x7fb7e5589a50>,23,24,[9 2],24,-1,48,-1,24
1,<environment.Job instance at 0x7fb7e5589050>,21,12,[9 4],22,-1,36,-1,24
1,<environment.Job instance at 0x7fb7e5589cd0>,26,1,[1 6],27,-1,28,-1,27
1,<environment.Job instance at 0x7fb7e5746c30>,29,15,[10  5],30,-1,45,-1,30
1,<environment.Job instance at 0x7fb7e57465a0>,30,12,[9 2],31,-1,43,-1,31
1,<environment.Job instance at 0x7fb7e5746280>,31,24,[2 6],32,-1,56,-1,32
1,<environment.Job instance at 0x7fb7e5746cd0>,32,15,[4 9],33,-1,48,-1,33
1,<environment.Job instance at 0x7fb7e5746d20>,36,15,[6 4],37,-1,52,-1,37
1,<environment.Job instance at 0x7fb7eebe1dc0>,39,16,[ 1 10],40,-1,56,-1,40
1,<environment.Job instance at 0x7fb7e54f11e0>,43,21,[5 4],44,-1,65,-1,44
1,<environment.Job instance at 0x7fb7e54f1f50>,44,17,[11  5],45,-1,62,-1,45
1,<environment.Job instance at 0x7fb7e54f1910>,46,12,[10  3],47,-1,62,-1,50
1,<environment.Job instance at 0x7fb7e5f1b7d0>,51,12,[4 6],52,-1,64,-1,52
1,<environment.Job instance at 0x7fb7e54f18c0>,52,18,[10  3],53,-1,71,-1,53
1,<environment.Job instance at 0x7fb7e54f1cd0>,49,14,[5 9],50,-1,67,-1,53
1,<environment.Job instance at 0x7fb7e5b83500>,54,24,[5 8],55,-1,79,-1,55
1,<environment.Job instance at 0x7fb7e50e9e60>,57,18,[3 8],58,-1,78,-1,60
1,<environment.Job instance at 0x7fb7e5057e60>,63,17,[7 2],64,-1,81,-1,64
1,<environment.Job instance at 0x7fb7ee872a50>,64,18,[1 8],65,-1,83,-1,65
1,<environment.Job instance at 0x7fb7e5c8f9b0>,66,23,[9 5],67,-1,91,-1,68
1,<environment.Job instance at 0x7fb7e4fb2640>,69,17,[6 3],70,-1,87,-1,70
1,<environment.Job instance at 0x7fb7e57b95f0>,72,18,[1 6],73,-1,91,-1,73
1,<environment.Job instance at 0x7fb7e57b9be0>,73,17,[10  3],74,-1,91,-1,74
1,<environment.Job instance at 0x7fb7e61b98c0>,75,16,[7 4],76,-1,92,-1,76
1,<environment.Job instance at 0x7fb7e61a8f50>,76,13,[4 6],77,-1,90,-1,77
1,<environment.Job instance at 0x7fb7e5c90c30>,82,17,[6 3],83,-1,100,-1,83
1,<environment.Job instance at 0x7fb7e5d55be0>,83,27,[5 6],84,-1,111,-1,84
1,<environment.Job instance at 0x7fb7e537f230>,23,24,[9 2],24,-1,76,-1,52
1,<environment.Job instance at 0x7fb7e4e1dcd0>,31,24,[2 6],32,-1,90,-1,66
1,<environment.Job instance at 0x7fb7e59d5dc0>,44,17,[11  5],45,-1,121,-1,104
1,<environment.Job instance at 0x7fb7e4ccd280>,45,15,[ 2 12],46,-1,119,-1,104
1,<environment.Job instance at 0x7fb7e4a76320>,54,24,[5 8],55,-1,174,-1,150
1,<environment.Job instance at 0x7fb7e4c8b4b0>,60,2,[14  3],61,-1,154,-1,152
1,<environment.Job instance at 0x7fb7e4a76820>,56,24,[10  2],57,-1,181,-1,157
1,<environment.Job instance at 0x7fb7e4dac050>,66,23,[9 5],67,-1,198,-1,175
1,<environment.Job instance at 0x7fb7e4d98af0>,79,1,[13  5],80,-1,226,-1,225
1,<environment.Job instance at 0x7fb7ee82b910>,83,27,[5 6],84,-1,268,-1,241
1,<environment.Job instance at 0x7fb7e5ff3410>,86,16,[ 3 11],87,-1,262,-1,246
1,<environment.Job instance at 0x7fb7ee869f00>,88,25,[11  1],89,-1,271,-1,246
1,<environment.Job instance at 0x7fb7e4d39c30>,94,27,[3 8],95,-1,280,-1,253
1,<environment.Job instance at 0x7fb7e5bbdf50>,100,18,[12  3],101,-1,281,-1,263
1,<environment.Job instance at 0x7fb7e5112690>,105,27,[4 6],106,-1,323,-1,296
1,<environment.Job instance at 0x7fb7e5680a50>,120,14,[11  5],121,-1,357,-1,343
1,<environment.Job instance at 0x7fb7e4d58e60>,124,28,[4 7],125,-1,402,-1,374
1,<environment.Job instance at 0x7fb7e6083780>,130,24,[9 4],131,-1,422,-1,398
1,<environment.Job instance at 0x7fb7e6083410>,133,2,[12  3],134,-1,400,-1,398
1,<environment.Job instance at 0x7fb7e58c95f0>,141,16,[12  1],142,-1,450,-1,434
1,<environment.Job instance at 0x7fb7e4cbbd20>,168,3,[14  4],169,-1,537,-1,534
1,<environment.Job instance at 0x7fb7e4c04be0>,6,21,[10  2],7,-1,34,-1,13
1,<environment.Job instance at 0x7fb7e48ec3c0>,14,16,[8 4],15,-1,31,-1,15
1,<environment.Job instance at 0x7fb7e5e10190>,16,14,[ 2 10],17,-1,31,-1,17
1,<environment.Job instance at 0x7fb7e5e105a0>,17,14,[7 4],18,-1,32,-1,18
1,<environment.Job instance at 0x7fb7e491f050>,20,25,[ 4 10],21,-1,46,-1,21
1,<environment.Job instance at 0x7fb7e5a0f2d0>,21,22,[9 1],22,-1,44,-1,22
1,<environment.Job instance at 0x7fb7e54c4b40>,22,14,[7 5],23,-1,37,-1,23
1,<environment.Job instance at 0x7fb7e5ea3280>,24,14,[ 2 11],25,-1,39,-1,25
1,<environment.Job instance at 0x7fb7e6211d70>,25,18,[2 9],26,-1,44,-1,26
1,<environment.Job instance at 0x7fb7e6211e10>,26,18,[10  3],27,-1,45,-1,27
1,<environment.Job instance at 0x7fb7e5e7b820>,27,19,[ 2 10],28,-1,47,-1,28
1,<environment.Job instance at 0x7fb7e4f70730>,29,17,[1 5],30,-1,47,-1,30
1,<environment.Job instance at 0x7fb7e4d58690>,33,15,[5 7],34,-1,49,-1,34
1,<environment.Job instance at 0x7fb7e61405a0>,34,16,[2 8],35,-1,51,-1,35
1,<environment.Job instance at 0x7fb7e4da9230>,37,17,[ 5 10],38,-1,55,-1,38
1,<environment.Job instance at 0x7fb7e583f140>,39,16,[5 5],40,-1,56,-1,40
1,<environment.Job instance at 0x7fb7e583f190>,41,14,[4 8],42,-1,56,-1,42
1,<environment.Job instance at 0x7fb7e4f15190>,49,28,[4 8],50,-1,78,-1,50
1,<environment.Job instance at 0x7fb7e4f15780>,50,13,[1 8],51,-1,64,-1,51
1,<environment.Job instance at 0x7fb7e493e140>,51,13,[8 2],52,-1,65,-1,52
1,<environment.Job instance at 0x7fb7e533c0f0>,55,18,[7 4],56,-1,74,-1,56
1,<environment.Job instance at 0x7fb7e5b4ea00>,59,17,[4 6],60,-1,77,-1,60
1,<environment.Job instance at 0x7fb7e55cbb40>,65,17,[4 6],66,-1,83,-1,66
1,<environment.Job instance at 0x7fb7e55cb050>,66,15,[10  5],67,-1,82,-1,67
1,<environment.Job instance at 0x7fb7e55ba410>,72,17,[ 1 10],73,-1,90,-1,73
1,<environment.Job instance at 0x7fb7e498e780>,74,15,[7 5],75,-1,90,-1,75
1,<environment.Job instance at 0x7fb7e5c9f5f0>,78,12,[3 7],79,-1,96,-1,84
1,<environment.Job instance at 0x7fb7e4c06370>,80,18,[2 9],81,-1,106,-1,88
1,<environment.Job instance at 0x7fb7e4f3a280>,0,14,[12  5],1,-1,15,-1,1
1,<environment.Job instance at 0x7fb7e61cbe60>,20,25,[ 4 10],21,-1,81,-1,56
1,<environment.Job instance at 0x7fb7e6083410>,24,14,[ 2 11],25,-1,70,-1,56
1,<environment.Job instance at 0x7fb7e6219730>,30,17,[ 5 14],31,-1,89,-1,72
1,<environment.Job instance at 0x7fb7e4b63aa0>,46,16,[12  5],47,-1,142,-1,126
1,<environment.Job instance at 0x7fb7e4f71690>,49,28,[4 8],50,-1,162,-1,134
1,<environment.Job instance at 0x7fb7e4f22be0>,64,12,[ 4 13],65,-1,182,-1,170
1,<environment.Job instance at 0x7fb7e611e190>,70,2,[ 2 12],71,-1,192,-1,190
1,<environment.Job instance at 0x7fb7e611e4b0>,71,13,[ 3 11],72,-1,203,-1,190
1,<environment.Job instance at 0x7fb7e5b40690>,85,1,[14  5],86,-1,256,-1,255
1,<environment.Job instance at 0x7fb7e5c7eeb0>,87,2,[ 5 12],88,-1,268,-1,266
1,<environment.Job instance at 0x7fb7e55a2690>,95,2,[ 2 12],96,-1,302,-1,300
1,<environment.Job instance at 0x7fb7e564d4b0>,100,13,[ 2 13],101,-1,327,-1,314
1,<environment.Job instance at 0x7fb7e53467d0>,107,23,[3 5],108,-1,367,-1,344
1,<environment.Job instance at 0x7fb7e48af050>,110,28,[2 6],111,-1,387,-1,359
1,<environment.Job instance at 0x7fb7e60b27d0>,120,1,[13  1],121,-1,395,-1,394
1,<environment.Job instance at 0x7fb7e4cbb190>,119,23,[8 2],120,-1,419,-1,396
1,<environment.Job instance at 0x7fb7e4a5ff00>,133,15,[ 3 14],134,-1,457,-1,442
1,<environment.Job instance at 0x7fb7e556abe0>,138,3,[13  1],139,-1,464,-1,461
1,<environment.Job instance at 0x7fb7e4a8e640>,145,15,[14  4],146,-1,497,-1,482
1,<environment.Job instance at 0x7fb7e4a8e460>,148,27,[6 3],149,-1,528,-1,501
1,<environment.Job instance at 0x7fb7e4a8edc0>,149,27,[3 5],150,-1,528,-1,501
1,<environment.Job instance at 0x7fb7e4911e10>,152,2,[12  2],153,-1,503,-1,501
1,<environment.Job instance at 0x7fb7e4a854b0>,160,23,[5 8],161,-1,564,-1,541
1,<environment.Job instance at 0x7fb7e5366c80>,167,12,[ 2 14],168,-1,572,-1,560
1,<environment.Job instance at 0x7fb7e5db43c0>,1,14,[9 3],2,-1,17,-1,3
1,<environment.Job instance at 0x7fb7e497d960>,6,13,[ 5 10],7,-1,20,-1,7
1,<environment.Job instance at 0x7fb7e58cc4b0>,10,18,[6 1],11,-1,29,-1,11
1,<environment.Job instance at 0x7fb7e58ccf00>,12,16,[1 7],13,-1,29,-1,13
1,<environment.Job instance at 0x7fb7e58cc960>,14,18,[2 5],15,-1,33,-1,15
1,<environment.Job instance at 0x7fb7e58cc0f0>,15,18,[2 9],16,-1,34,-1,16
1,<environment.Job instance at 0x7fb7e58ccaa0>,17,15,[10  1],18,-1,33,-1,18
1,<environment.Job instance at 0x7fb7e58cc460>,18,28,[9 5],19,-1,47,-1,19
1,<environment.Job instance at 0x7fb7e58ccfa0>,19,15,[2 5],20,-1,35,-1,20
1,<environment.Job instance at 0x7fb7e49117d0>,25,17,[8 3],26,-1,43,-1,26
1,<environment.Job instance at 0x7fb7e4911f00>,26,22,[4 9],27,-1,49,-1,27
1,<environment.Job instance at 0x7fb7e4911230>,28,14,[5 6],29,-1,43,-1,29
1,<environment.Job instance at 0x7fb7e4911280>,32,18,[7 3],33,-1,51,-1,33
1,<environment.Job instance at 0x7fb7e6219960>,35,14,[8 2],36,-1,50,-1,36
1,<environment.Job instance at 0x7fb7e6219e60>,40,15,[8 2],41,-1,56,-1,41
1,<environment.Job instance at 0x7fb7e62194b0>,41,16,[4 9],42,-1,58,-1,42
1,<environment.Job instance at 0x7fb7e6219af0>,42,15,[9 5],43,-1,58,-1,43
1,<environment.Job instance at 0x7fb7e6219dc0>,43,13,[3 7],44,-1,57,-1,44
1,<environment.Job instance at 0x7fb7e6219550>,46,16,[ 5 10],47,-1,63,-1,47
1,<environment.Job instance at 0x7fb7e6219b40>,47,13,[10  3],48,-1,61,-1,48
1,<environment.Job instance at 0x7fb7e6219280>,48,18,[10  5],49,-1,67,-1,49
1,<environment.Job instance at 0x7fb7e61cbf50>,50,17,[6 4],51,-1,68,-1,51
1,<environment.Job instance at 0x7fb7e61cbd20>,51,23,[9 2],52,-1,75,-1,52
1,<environment.Job instance at 0x7fb7e61cb0f0>,53,13,[8 4],54,-1,67,-1,54
1,<environment.Job instance at 0x7fb7e4f56c80>,59,15,[ 5 10],60,-1,75,-1,60
1,<environment.Job instance at 0x7fb7e4f56f50>,67,12,[ 4 10],68,-1,80,-1,68
1,<environment.Job instance at 0x7fb7e4f560f0>,68,2,[4 9],69,-1,71,-1,69
1,<environment.Job instance at 0x7fb7e4f568c0>,69,17,[11  5],70,-1,87,-1,70
1,<environment.Job instance at 0x7fb7e4f567d0>,70,18,[3 7],71,-1,89,-1,71
1,<environment.Job instance at 0x7fb7eecce5a0>,2,14,[ 3 10],3,-1,98,-1,84
1,<environment.Job instance at 0x7fb7e59c7e10>,82,18,[1 5],83,-1,102,-1,84
1,<environment.Job instance at 0x7fb7e59c77d0>,84,22,[7 4],85,-1,107,-1,85
1,<environment.Job instance at 0x7fb7e59c7870>,86,17,[5 8],87,-1,104,-1,87
1,<environment.Job instance at 0x7fb7e54f3dc0>,90,20,[ 3 10],91,-1,119,-1,99
1,<environment.Job instance at 0x7fb7e4911460>,18,28,[9 5],19,-1,78,-1,50
1,<environment.Job instance at 0x7fb7e4911410>,20,1,[11  1],21,-1,51,-1,50
1,<environment.Job instance at 0x7fb7e51b1e10>,37,1,[ 2 12],38,-1,77,-1,76
1,<environment.Job instance at 0x7fb7e496b050>,51,23,[9 2],52,-1,161,-1,138
1,<environment.Job instance at 0x7fb7e5c7e1e0>,55,25,[ 2 11],56,-1,169,-1,144
1,<environment.Job instance at 0x7fb7e5cb0fa0>,60,14,[13  1],61,-1,182,-1,168
1,<environment.Job instance at 0x7fb7e5a865a0>,63,12,[12  5],64,-1,183,-1,171
1,<environment.Job instance at 0x7fb7f5e0adc0>,69,17,[11  5],70,-1,215,-1,198
1,<environment.Job instance at 0x7fb7e534c690>,72,22,[ 4 11],73,-1,225,-1,203
1,<environment.Job instance at 0x7fb7e5112f50>,76,15,[13  2],77,-1,236,-1,221
1,<environment.Job instance at 0x7fb7eebcc7d0>,79,13,[ 5 11],80,-1,238,-1,225
1,<environment.Job instance at 0x7fb7e494c6e0>,83,3,[ 3 14],84,-1,242,-1,239
1,<environment.Job instance at 0x7fb7e5e886e0>,88,17,[14  2],89,-1,261,-1,244
1,<environment.Job instance at 0x7fb7e59c7fa0>,92,14,[11  5],93,-1,274,-1,260
1,<environment.Job instance at 0x7fb7e4f995a0>,107,1,[12  4],108,-1,292,-1,291
1,<environment.Job instance at 0x7fb7e60867d0>,112,14,[ 2 11],113,-1,327,-1,313
1,<environment.Job instance at 0x7fb7e48cc3c0>,115,13,[ 3 14],116,-1,336,-1,323
1,<environment.Job instance at 0x7fb7e4d9f460>,131,1,[12  1],132,-1,372,-1,371
1,<environment.Job instance at 0x7fb7e4d9f1e0>,133,3,[ 3 12],134,-1,375,-1,372
1,<environment.Job instance at 0x7fb7ee8725f0>,143,23,[5 6],144,-1,447,-1,424
1,<environment.Job instance at 0x7fb7e49f5b40>,150,2,[13  2],151,-1,444,-1,442
1,<environment.Job instance at 0x7fb7e49f5820>,153,1,[14  1],154,-1,459,-1,458
1,<environment.Job instance at 0x7fb7e5ca90f0>,168,2,[ 4 11],169,-1,510,-1,508
1,<environment.Job instance at 0x7fb7ee7f4780>,4,24,[4 8],5,-1,29,-1,5
1,<environment.Job instance at 0x7fb7e51aa6e0>,7,18,[3 6],8,-1,26,-1,8
1,<environment.Job instance at 0x7fb7e51aa690>,8,14,[10  1],9,-1,24,-1,10
1,<environment.Job instance at 0x7fb7e51aa190>,10,28,[8 5],11,-1,39,-1,11
1,<environment.Job instance at 0x7fb7e51aa640>,11,16,[6 2],12,-1,28,-1,12
1,<environment.Job instance at 0x7fb7e51aaf00>,13,17,[ 5 12],14,-1,31,-1,14
1,<environment.Job instance at 0x7fb7e51aab90>,15,14,[ 2 10],16,-1,30,-1,16
1,<environment.Job instance at 0x7fb7e51aa460>,16,17,[9 4],17,-1,34,-1,17
1,<environment.Job instance at 0x7fb7e57ab780>,18,14,[ 1 10],19,-1,33,-1,19
1,<environment.Job instance at 0x7fb7e51aa5f0>,20,13,[ 4 10],21,-1,34,-1,21
1,<environment.Job instance at 0x7fb7e4c5fa00>,21,16,[4 7],22,-1,38,-1,22
1,<environment.Job instance at 0x7fb7e4c5f2d0>,22,17,[10  4],23,-1,40,-1,23
1,<environment.Job instance at 0x7fb7e4c5f280>,23,13,[ 4 10],24,-1,37,-1,24
1,<environment.Job instance at 0x7fb7ee7f4a50>,9,27,[ 5 10],10,-1,54,-1,27
1,<environment.Job instance at 0x7fb7e5960820>,28,18,[4 7],29,-1,48,-1,30
1,<environment.Job instance at 0x7fb7e4b66050>,30,21,[9 2],31,-1,55,-1,34
1,<environment.Job instance at 0x7fb7e4c83870>,34,15,[3 5],35,-1,50,-1,35
1,<environment.Job instance at 0x7fb7e4ff0a00>,36,26,[3 5],37,-1,63,-1,37
1,<environment.Job instance at 0x7fb7e4ff8410>,37,24,[9 4],38,-1,62,-1,38
1,<environment.Job instance at 0x7fb7e4ff41e0>,39,13,[4 7],40,-1,53,-1,40
1,<environment.Job instance at 0x7fb7e4c77910>,40,15,[1 8],41,-1,56,-1,41
1,<environment.Job instance at 0x7fb7eed44f00>,41,14,[6 4],42,-1,56,-1,42
1,<environment.Job instance at 0x7fb7e48bd280>,44,17,[3 5],45,-1,62,-1,45
1,<environment.Job instance at 0x7fb7e5326f50>,45,18,[ 3 10],46,-1,64,-1,46
1,<environment.Job instance at 0x7fb7e567b820>,52,13,[9 5],53,-1,66,-1,53
1,<environment.Job instance at 0x7fb7e555eaa0>,53,12,[ 3 10],54,-1,66,-1,54
1,<environment.Job instance at 0x7fb7e543f7d0>,57,17,[8 4],58,-1,75,-1,58
1,<environment.Job instance at 0x7fb7e543fb40>,59,14,[1 5],60,-1,74,-1,60
1,<environment.Job instance at 0x7fb7e5478320>,61,16,[1 8],62,-1,78,-1,62
1,<environment.Job instance at 0x7fb7e4e18eb0>,63,24,[5 1],64,-1,88,-1,64
1,<environment.Job instance at 0x7fb7e596a6e0>,65,22,[5 4],66,-1,88,-1,66
1,<environment.Job instance at 0x7fb7e55a2eb0>,66,28,[8 5],67,-1,95,-1,67
1,<environment.Job instance at 0x7fb7e55a2960>,70,18,[5 8],71,-1,89,-1,71
1,<environment.Job instance at 0x7fb7e5e79d70>,72,13,[8 1],73,-1,86,-1,73
1,<environment.Job instance at 0x7fb7e5d615a0>,74,25,[9 4],75,-1,100,-1,75
1,<environment.Job instance at 0x7fb7e48ea1e0>,133,15,[5 6],134,-1,394,-1,379
1,<environment.Job instance at 0x7fb7e48ead70>,134,16,[10  5],135,-1,395,-1,379
1,<environment.Job instance at 0x7fb7e4c71dc0>,95,27,[4 6],96,-1,406,-1,379
1,<environment.Job instance at 0x7fb7e48cc910>,141,19,[10  5],142,-1,467,-1,448
1,<environment.Job instance at 0x7fb7e51a4b40>,127,17,[9 5],128,-1,466,-1,449
1,<environment.Job instance at 0x7fb7e5f12dc0>,156,18,[3 7],157,-1,490,-1,472
1,<environment.Job instance at 0x7fb7e48eaeb0>,136,18,[10  3],137,-1,490,-1,472
1,<environment.Job instance at 0x7fb7e5f12280>,166,28,[9 5],167,-1,500,-1,472
1,<environment.Job instance at 0x7fb7e4cd0a50>,0,12,[ 1 14],1,-1,13,-1,1
1,<environment.Job instance at 0x7fb7e4b66f50>,2,2,[ 1 14],3,-1,5,-1,3
1,<environment.Job instance at 0x7fb7e596a460>,4,24,[4 8],5,-1,29,-1,5
1,<environment.Job instance at 0x7fb7e55b36e0>,6,23,[9 2],7,-1,41,-1,18
1,<environment.Job instance at 0x7fb7e5f125a0>,9,27,[ 5 10],10,-1,45,-1,18
1,<environment.Job instance at 0x7fb7e5f12550>,10,28,[8 5],11,-1,46,-1,18
1,<environment.Job instance at 0x7fb7eeca40a0>,13,17,[ 5 12],14,-1,35,-1,18
1,<environment.Job instance at 0x7fb7eeca4730>,14,18,[ 4 13],15,-1,36,-1,18
1,<environment.Job instance at 0x7fb7e58cc7d0>,36,26,[3 5],37,-1,128,-1,102
1,<environment.Job instance at 0x7fb7eebcc7d0>,37,24,[9 4],38,-1,139,-1,115
1,<environment.Job instance at 0x7fb7e58d1d20>,48,1,[12  1],49,-1,137,-1,136
1,<environment.Job instance at 0x7fb7e54875a0>,63,24,[5 1],64,-1,202,-1,178
1,<environment.Job instance at 0x7fb7e57e5d70>,66,28,[8 5],67,-1,209,-1,181
1,<environment.Job instance at 0x7fb7e57bf1e0>,76,18,[11  2],77,-1,226,-1,208
1,<environment.Job instance at 0x7fb7e57b8730>,78,15,[ 1 14],79,-1,225,-1,210
1,<environment.Job instance at 0x7fb7e57c4a50>,74,25,[9 4],75,-1,237,-1,212
1,<environment.Job instance at 0x7fb7e57be690>,83,2,[ 2 13],84,-1,228,-1,226
1,<environment.Job instance at 0x7fb7e55260f0>,95,27,[4 6],96,-1,285,-1,258
1,<environment.Job instance at 0x7fb7e57ba870>,99,24,[9 1],100,-1,300,-1,276
1,<environment.Job instance at 0x7fb7e4f9beb0>,108,1,[ 2 12],109,-1,296,-1,295
1,<environment.Job instance at 0x7fb7e551a500>,116,13,[11  2],117,-1,343,-1,330
1,<environment.Job instance at 0x7fb7e553aa00>,121,23,[5 2],122,-1,370,-1,347
1,<environment.Job instance at 0x7fb7e553a2d0>,122,17,[ 5 14],123,-1,364,-1,347
1,<environment.Job instance at 0x7fb7e553d6e0>,123,28,[10  4],124,-1,375,-1,347
1,<environment.Job instance at 0x7fb7e550f2d0>,128,18,[ 4 13],129,-1,375,-1,357
1,<environment.Job instance at 0x7fb7e4e23460>,164,24,[5 9],165,-1,522,-1,498
1,<environment.Job instance at 0x7fb7e5953aa0>,166,28,[9 5],167,-1,537,-1,509
1,<environment.Job instance at 0x7fb7e5251280>,1,18,[9 3],2,-1,21,-1,3
1,<environment.Job instance at 0x7fb7e4c2f7d0>,3,18,[8 3],4,-1,22,-1,4
1,<environment.Job instance at 0x7fb7e6249370>,2,17,[4 8],3,-1,21,-1,4
1,<environment.Job instance at 0x7fb7e628c460>,11,14,[1 7],12,-1,26,-1,12
1,<environment.Job instance at 0x7fb7e602eaa0>,13,18,[2 6],14,-1,32,-1,14
1,<environment.Job instance at 0x7fb7e5b506e0>,17,18,[3 8],18,-1,36,-1,18
1,<environment.Job instance at 0x7fb7e5b50640>,19,15,[10  3],20,-1,35,-1,20
1,<environment.Job instance at 0x7fb7e5a86320>,21,17,[9 5],22,-1,39,-1,22
1,<environment.Job instance at 0x7fb7e48a0410>,22,19,[1 5],23,-1,42,-1,23
1,<environment.Job instance at 0x7fb7e4a5f7d0>,25,16,[ 4 10],26,-1,42,-1,26
1,<environment.Job instance at 0x7fb7e5e10690>,28,16,[8 1],29,-1,45,-1,29
1,<environment.Job instance at 0x7fb7e5fba1e0>,29,14,[9 3],30,-1,44,-1,30
1,<environment.Job instance at 0x7fb7e4c4bd20>,30,12,[3 6],31,-1,44,-1,32
1,<environment.Job instance at 0x7fb7e4c4b0f0>,32,12,[2 8],33,-1,45,-1,33
1,<environment.Job instance at 0x7fb7e4c83960>,33,23,[5 6],34,-1,57,-1,34
1,<environment.Job instance at 0x7fb7e52340f0>,34,15,[5 2],35,-1,50,-1,35
1,<environment.Job instance at 0x7fb7e5027e10>,35,14,[1 5],36,-1,50,-1,36
1,<environment.Job instance at 0x7fb7e5027f50>,38,28,[3 8],39,-1,67,-1,39
1,<environment.Job instance at 0x7fb7eee10dc0>,39,16,[ 5 10],40,-1,56,-1,40
1,<environment.Job instance at 0x7fb7e6268aa0>,40,13,[2 9],41,-1,54,-1,41
1,<environment.Job instance at 0x7fb7e6268cd0>,43,23,[5 7],44,-1,67,-1,44
1,<environment.Job instance at 0x7fb7e6268d20>,44,28,[8 5],45,-1,73,-1,45
1,<environment.Job instance at 0x7fb7e4fd5af0>,31,14,[7 4],32,-1,59,-1,45
1,<environment.Job instance at 0x7fb7e6268f00>,46,23,[3 7],47,-1,70,-1,47
1,<environment.Job instance at 0x7fb7e5e08640>,48,17,[8 1],49,-1,67,-1,50
1,<environment.Job instance at 0x7fb7e5e08b90>,50,15,[7 4],51,-1,66,-1,51
1,<environment.Job instance at 0x7fb7e5e084b0>,55,16,[6 3],56,-1,72,-1,56
1,<environment.Job instance at 0x7fb7e5e04550>,61,16,[5 8],62,-1,86,-1,70
1,<environment.Job instance at 0x7fb7e4cee5f0>,66,24,[10  1],67,-1,97,-1,73
1,<environment.Job instance at 0x7fb7e4cee0a0>,63,26,[6 4],64,-1,99,-1,73
1,<environment.Job instance at 0x7fb7e6268910>,49,22,[5 3],50,-1,95,-1,73
1,<environment.Job instance at 0x7fb7e4cd9be0>,57,20,[ 5 12],58,-1,104,-1,84
1,<environment.Job instance at 0x7fb7e5e08d20>,52,23,[13  5],53,-1,107,-1,84
1,<environment.Job instance at 0x7fb7e624ee60>,76,26,[8 4],77,-1,114,-1,88
1,<environment.Job instance at 0x7fb7e4c77410>,81,27,[7 5],82,-1,116,-1,89
1,<environment.Job instance at 0x7fb7e624e910>,78,18,[12  4],79,-1,110,-1,92
1,<environment.Job instance at 0x7fb7e4cca230>,87,15,[11  5],88,-1,149,-1,134
1,<environment.Job instance at 0x7fb7e624ef00>,73,17,[11  1],74,-1,151,-1,134
1,<environment.Job instance at 0x7fb7e624e8c0>,75,16,[ 4 13],76,-1,150,-1,134
1,<environment.Job instance at 0x7fb7e5350b90>,93,12,[1 8],94,-1,149,-1,137
1,<environment.Job instance at 0x7fb7e4c5b320>,89,15,[3 9],90,-1,152,-1,137
1,<environment.Job instance at 0x7fb7e4c7c960>,96,25,[6 1],97,-1,163,-1,138
1,<environment.Job instance at 0x7fb7e61a8a00>,98,14,[2 7],99,-1,153,-1,139
1,<environment.Job instance at 0x7fb7e4c7ca50>,101,18,[ 3 12],102,-1,157,-1,139
1,<environment.Job instance at 0x7fb7e4c56320>,102,18,[3 8],103,-1,157,-1,139
1,<environment.Job instance at 0x7fb7e4c565a0>,103,17,[4 7],104,-1,157,-1,140
1,<environment.Job instance at 0x7fb7e5df8c30>,106,26,[8 5],107,-1,166,-1,140
1,<environment.Job instance at 0x7fb7e4ba3e60>,100,12,[5 5],101,-1,152,-1,140
1,<environment.Job instance at 0x7fb7e5df8e10>,108,13,[2 7],109,-1,153,-1,140
1,<environment.Job instance at 0x7fb7e4c72be0>,110,27,[7 2],111,-1,169,-1,142
1,<environment.Job instance at 0x7fb7e4a8e7d0>,112,17,[7 2],113,-1,159,-1,142
1,<environment.Job instance at 0x7fb7e629bf50>,115,15,[ 5 13],116,-1,166,-1,151
1,<environment.Job instance at 0x7fb7e4c72320>,109,18,[5 4],110,-1,171,-1,153
1,<environment.Job instance at 0x7fb7e5a8e320>,124,13,[2 9],125,-1,180,-1,167
1,<environment.Job instance at 0x7fb7e5a8ec80>,127,16,[ 2 12],128,-1,221,-1,205
1,<environment.Job instance at 0x7fb7e53547d0>,143,24,[10  4],144,-1,229,-1,205
1,<environment.Job instance at 0x7fb7e58aef00>,131,17,[4 8],132,-1,223,-1,206
1,<environment.Job instance at 0x7fb7e4c7b8c0>,154,13,[2 8],155,-1,269,-1,256
1,<environment.Job instance at 0x7fb7e4c7b870>,159,16,[ 4 10],160,-1,273,-1,257
1,<environment.Job instance at 0x7fb7e4c7beb0>,158,18,[8 3],159,-1,275,-1,257
1,<environment.Job instance at 0x7fb7e4c7b6e0>,162,18,[3 8],163,-1,275,-1,257
1,<environment.Job instance at 0x7fb7e4c5c4b0>,165,25,[8 3],166,-1,282,-1,257
1,<environment.Job instance at 0x7fb7e4c7bb40>,157,14,[9 4],158,-1,273,-1,259
1,<environment.Job instance at 0x7fb7e53691e0>,26,14,[14  5],27,-1,79,-1,65
1,<environment.Job instance at 0x7fb7e53692d0>,33,23,[5 6],34,-1,134,-1,111
1,<environment.Job instance at 0x7fb7e4ebdf00>,38,28,[3 8],39,-1,153,-1,125
1,<environment.Job instance at 0x7fb7e61d7cd0>,44,28,[8 5],45,-1,174,-1,146
1,<environment.Job instance at 0x7fb7e52c6dc0>,43,23,[5 7],44,-1,171,-1,148
1,<environment.Job instance at 0x7fb7e48cdbe0>,47,24,[2 9],48,-1,172,-1,148
1,<environment.Job instance at 0x7fb7e48cde60>,46,23,[3 7],47,-1,171,-1,148
1,<environment.Job instance at 0x7fb7e4fe1b40>,52,23,[13  5],53,-1,171,-1,148
1,<environment.Job instance at 0x7fb7e4fe1c30>,53,12,[ 4 13],54,-1,160,-1,148
1,<environment.Job instance at 0x7fb7e4afc230>,57,20,[ 5 12],58,-1,184,-1,164
1,<environment.Job instance at 0x7fb7e4f5c320>,63,26,[6 4],64,-1,205,-1,179
1,<environment.Job instance at 0x7fb7e4b033c0>,66,24,[10  1],67,-1,216,-1,192
1,<environment.Job instance at 0x7fb7e5a902d0>,73,17,[11  1],74,-1,212,-1,195
1,<environment.Job instance at 0x7fb7e4f840f0>,75,16,[ 4 13],76,-1,223,-1,207
1,<environment.Job instance at 0x7fb7e4f84f00>,76,26,[8 4],77,-1,233,-1,207
1,<environment.Job instance at 0x7fb7e4b9ce10>,78,18,[12  4],79,-1,225,-1,207
1,<environment.Job instance at 0x7fb7e50ed320>,81,27,[7 5],82,-1,252,-1,225
1,<environment.Job instance at 0x7fb7e5803910>,87,15,[11  5],88,-1,253,-1,238
1,<environment.Job instance at 0x7fb7e60ace10>,91,3,[12  3],92,-1,254,-1,251
1,<environment.Job instance at 0x7fb7e60acc80>,92,3,[14  3],93,-1,254,-1,251
1,<environment.Job instance at 0x7fb7e4bbbaf0>,96,25,[6 1],97,-1,283,-1,258
1,<environment.Job instance at 0x7fb7e4f59550>,101,18,[ 3 12],102,-1,286,-1,268
1,<environment.Job instance at 0x7fb7e52cf960>,106,26,[8 5],107,-1,326,-1,300
1,<environment.Job instance at 0x7fb7e52cff50>,110,27,[7 2],111,-1,339,-1,312
1,<environment.Job instance at 0x7fb7e5a93b40>,111,26,[ 5 11],112,-1,338,-1,312
1,<environment.Job instance at 0x7fb7ee84d960>,115,15,[ 5 13],116,-1,328,-1,313
1,<environment.Job instance at 0x7fb7ee84d780>,118,12,[12  3],119,-1,339,-1,327
1,<environment.Job instance at 0x7fb7e60be690>,125,12,[14  1],126,-1,355,-1,343
1,<environment.Job instance at 0x7fb7ee84da50>,127,16,[ 2 12],128,-1,359,-1,343
1,<environment.Job instance at 0x7fb7eeb9a730>,129,2,[ 1 11],130,-1,358,-1,356
1,<environment.Job instance at 0x7fb7e5e7e910>,143,24,[10  4],144,-1,409,-1,385
1,<environment.Job instance at 0x7fb7e57e55f0>,147,2,[ 3 11],148,-1,390,-1,388
1,<environment.Job instance at 0x7fb7e6040820>,165,25,[8 3],166,-1,482,-1,457
1,<environment.Job instance at 0x7fb7e5a8dbe0>,168,12,[ 2 12],169,-1,481,-1,469
1,<environment.Job instance at 0x7fb7e5cb2780>,6,19,[4 6],7,-1,26,-1,7
1,<environment.Job instance at 0x7fb7e5cb2b40>,9,21,[ 5 10],10,-1,31,-1,10
1,<environment.Job instance at 0x7fb7e5cb2870>,11,18,[1 9],12,-1,30,-1,12
1,<environment.Job instance at 0x7fb7e5cb2640>,13,21,[5 5],14,-1,35,-1,14
1,<environment.Job instance at 0x7fb7e5cb21e0>,17,16,[6 5],18,-1,34,-1,18
1,<environment.Job instance at 0x7fb7e51e0a00>,20,18,[9 1],21,-1,39,-1,21
1,<environment.Job instance at 0x7fb7e595ebe0>,23,27,[4 6],24,-1,51,-1,24
1,<environment.Job instance at 0x7fb7e595ed20>,24,14,[3 5],25,-1,39,-1,25
1,<environment.Job instance at 0x7fb7e595e500>,25,17,[10  2],26,-1,43,-1,26
1,<environment.Job instance at 0x7fb7e595e190>,26,16,[ 5 10],27,-1,43,-1,27
1,<environment.Job instance at 0x7fb7e5df7640>,28,14,[5 1],29,-1,43,-1,29
1,<environment.Job instance at 0x7fb7e5df7410>,32,1,[10  1],33,-1,34,-1,33
1,<environment.Job instance at 0x7fb7e5df74b0>,33,13,[8 5],34,-1,47,-1,34
1,<environment.Job instance at 0x7fb7e5df7f00>,35,13,[6 4],36,-1,50,-1,37
1,<environment.Job instance at 0x7fb7e5df7cd0>,37,28,[8 2],38,-1,66,-1,38
1,<environment.Job instance at 0x7fb7e5df70f0>,38,22,[5 8],39,-1,61,-1,39
1,<environment.Job instance at 0x7fb7e5df7af0>,36,16,[4 8],37,-1,55,-1,39
1,<environment.Job instance at 0x7fb7e5df7140>,39,15,[8 3],40,-1,56,-1,41
1,<environment.Job instance at 0x7fb7e5df77d0>,40,18,[7 4],41,-1,59,-1,41
1,<environment.Job instance at 0x7fb7e5df7320>,41,28,[ 3 10],42,-1,70,-1,42
1,<environment.Job instance at 0x7fb7e5df7b40>,45,18,[5 9],46,-1,64,-1,46
1,<environment.Job instance at 0x7fb7e5e04f50>,47,18,[7 1],48,-1,66,-1,48
1,<environment.Job instance at 0x7fb7e5e04e60>,49,17,[6 3],50,-1,67,-1,50
1,<environment.Job instance at 0x7fb7e5e04780>,52,14,[10  1],53,-1,71,-1,57
1,<environment.Job instance at 0x7fb7e624a230>,61,12,[11  3],62,-1,74,-1,62
1,<environment.Job instance at 0x7fb7e624a6e0>,64,17,[7 5],65,-1,82,-1,65
1,<environment.Job instance at 0x7fb7e624a1e0>,66,21,[8 5],67,-1,88,-1,67
1,<environment.Job instance at 0x7fb7e624acd0>,67,14,[1 5],68,-1,82,-1,68
1,<environment.Job instance at 0x7fb7e624ab90>,68,12,[10  2],69,-1,81,-1,69
1,<environment.Job instance at 0x7fb7e624ac30>,69,28,[3 6],70,-1,98,-1,70
1,<environment.Job instance at 0x7fb7e624ae10>,70,26,[6 1],71,-1,97,-1,71
1,<environment.Job instance at 0x7fb7e5e1f460>,79,24,[9 1],80,-1,108,-1,84
1,<environment.Job instance at 0x7fb7e5e1f370>,88,18,[3 7],89,-1,107,-1,89
1,<environment.Job instance at 0x7fb7e5953e10>,89,13,[7 4],90,-1,103,-1,90
1,<environment.Job instance at 0x7fb7e5953e60>,91,17,[10  4],92,-1,109,-1,92
1,<environment.Job instance at 0x7fb7e5953870>,94,18,[6 3],95,-1,113,-1,95
1,<environment.Job instance at 0x7fb7e5953820>,95,26,[7 2],96,-1,122,-1,96
1,<environment.Job instance at 0x7fb7e5953460>,96,14,[6 2],97,-1,118,-1,104
1,<environment.Job instance at 0x7fb7e4cd9280>,99,25,[9 3],100,-1,155,-1,130
1,<environment.Job instance at 0x7fb7e5e1f280>,83,25,[3 7],84,-1,159,-1,134
1,<environment.Job instance at 0x7fb7e4c83690>,106,16,[8 3],107,-1,151,-1,135
1,<environment.Job instance at 0x7fb7e5fc35a0>,110,17,[ 1 10],111,-1,152,-1,135
1,<environment.Job instance at 0x7fb7e5fc35f0>,113,18,[5 5],114,-1,153,-1,135
1,<environment.Job instance at 0x7fb7e5ccc230>,116,15,[ 5 10],117,-1,150,-1,135
1,<environment.Job instance at 0x7fb7e5ccc820>,117,15,[2 9],118,-1,151,-1,136
1,<environment.Job instance at 0x7fb7e4e66eb0>,119,18,[3 8],120,-1,154,-1,136
1,<environment.Job instance at 0x7fb7e5fc3230>,108,17,[3 5],109,-1,154,-1,137
1,<environment.Job instance at 0x7fb7e4c5fd70>,122,13,[ 4 10],123,-1,152,-1,139
1,<environment.Job instance at 0x7fb7e4ce65a0>,125,14,[10  1],126,-1,153,-1,139
1,<environment.Job instance at 0x7fb7e5cd38c0>,127,28,[4 9],128,-1,172,-1,144
1,<environment.Job instance at 0x7fb7e5cd35f0>,128,17,[5 5],129,-1,161,-1,144
1,<environment.Job instance at 0x7fb7e4cd9500>,100,20,[6 3],101,-1,169,-1,149
1,<environment.Job instance at 0x7fb7e5e1f6e0>,86,20,[12  4],87,-1,169,-1,149
1,<environment.Job instance at 0x7fb7e57abaf0>,129,1,[9 1],130,-1,152,-1,151
1,<environment.Job instance at 0x7fb7e4cd9e60>,132,1,[ 1 10],133,-1,152,-1,151
1,<environment.Job instance at 0x7fb7e4cd9dc0>,130,16,[7 5],131,-1,168,-1,152
1,<environment.Job instance at 0x7fb7e4cd9f00>,131,14,[5 8],132,-1,166,-1,152
1,<environment.Job instance at 0x7fb7e4cd9f50>,135,18,[ 5 11],136,-1,170,-1,152
1,<environment.Job instance at 0x7fb7e4cd96e0>,133,17,[3 7],134,-1,169,-1,152
1,<environment.Job instance at 0x7fb7e5fc3410>,112,28,[9 5],113,-1,180,-1,152
1,<environment.Job instance at 0x7fb7e4c6d500>,139,17,[10  4],140,-1,169,-1,152
1,<environment.Job instance at 0x7fb7e4c6de60>,141,26,[3 8],142,-1,179,-1,153
1,<environment.Job instance at 0x7fb7e5ccc0f0>,115,14,[4 5],116,-1,167,-1,153
1,<environment.Job instance at 0x7fb7e4c6d7d0>,145,15,[3 5],146,-1,168,-1,153
1,<environment.Job instance at 0x7fb7e544ad20>,152,13,[4 8],153,-1,175,-1,162
1,<environment.Job instance at 0x7fb7e4ce0cd0>,154,24,[ 3 10],155,-1,186,-1,162
1,<environment.Job instance at 0x7fb7e4ce0a00>,155,13,[8 2],156,-1,175,-1,162
1,<environment.Job instance at 0x7fb7e4ce0b40>,156,13,[4 5],157,-1,175,-1,162
1,<environment.Job instance at 0x7fb7e4ce0320>,157,17,[7 5],158,-1,179,-1,162
1,<environment.Job instance at 0x7fb7e4ce0b90>,158,24,[10  5],159,-1,186,-1,162
1,<environment.Job instance at 0x7fb7e4ce0820>,159,15,[3 5],160,-1,177,-1,162
1,<environment.Job instance at 0x7fb7e4ce0050>,161,1,[8 1],162,-1,163,-1,162
1,<environment.Job instance at 0x7fb7e4ce0410>,163,19,[5 5],164,-1,183,-1,164
1,<environment.Job instance at 0x7fb7e4ce05f0>,164,16,[1 7],165,-1,181,-1,165
1,<environment.Job instance at 0x7fb7e4ce02d0>,166,14,[2 9],167,-1,181,-1,167
1,<environment.Job instance at 0x7fb7e59533c0>,98,15,[13  1],99,-1,184,-1,169
1,<environment.Job instance at 0x7fb7e4cca3c0>,167,13,[4 7],168,-1,182,-1,169
1,<environment.Job instance at 0x7fb7e4d058c0>,23,27,[4 6],24,-1,75,-1,48
1,<environment.Job instance at 0x7fb7eecce460>,30,3,[ 1 14],31,-1,65,-1,62
1,<environment.Job instance at 0x7fb7e5a8c730>,34,1,[ 2 11],35,-1,85,-1,84
1,<environment.Job instance at 0x7fb7e50052d0>,37,28,[8 2],38,-1,127,-1,99
1,<environment.Job instance at 0x7fb7eeca3dc0>,41,28,[ 3 10],42,-1,137,-1,109
1,<environment.Job instance at 0x7fb7ee84d1e0>,51,15,[14  2],52,-1,150,-1,135
1,<environment.Job instance at 0x7fb7e52cf050>,61,12,[11  3],62,-1,184,-1,172
1,<environment.Job instance at 0x7fb7e4f84140>,70,26,[6 1],71,-1,229,-1,203
1,<environment.Job instance at 0x7fb7e4f84d20>,71,2,[ 4 13],72,-1,205,-1,203
1,<environment.Job instance at 0x7fb7e4fe8870>,69,28,[3 6],70,-1,231,-1,203
1,<environment.Job instance at 0x7fb7e4f5c550>,79,24,[9 1],80,-1,245,-1,221
1,<environment.Job instance at 0x7fb7e4fe1a50>,84,13,[ 2 13],85,-1,237,-1,224
1,<environment.Job instance at 0x7fb7e4fe15a0>,83,25,[3 7],84,-1,251,-1,226
1,<environment.Job instance at 0x7fb7e52c6e10>,86,20,[12  4],87,-1,246,-1,226
1,<environment.Job instance at 0x7fb7e5a72cd0>,90,15,[13  3],91,-1,242,-1,227
1,<environment.Job instance at 0x7fb7e5369500>,95,26,[7 2],96,-1,271,-1,245
1,<environment.Job instance at 0x7fb7e5369af0>,98,15,[13  1],99,-1,272,-1,257
1,<environment.Job instance at 0x7fb7e5369690>,99,25,[9 3],100,-1,283,-1,258
1,<environment.Job instance at 0x7fb7e4c5c8c0>,112,28,[9 5],113,-1,338,-1,310
1,<environment.Job instance at 0x7fb7e5cb2af0>,127,28,[4 9],128,-1,400,-1,372
1,<environment.Job instance at 0x7fb7e5e04eb0>,135,18,[ 5 11],136,-1,413,-1,395
1,<environment.Job instance at 0x7fb7e4cd9a50>,141,26,[3 8],142,-1,438,-1,412
1,<environment.Job instance at 0x7fb7e4cca500>,143,17,[ 5 13],144,-1,429,-1,412
1,<environment.Job instance at 0x7fb7e4cca640>,149,2,[ 1 14],150,-1,421,-1,419
1,<environment.Job instance at 0x7fb7e4cca0f0>,154,24,[ 3 10],155,-1,463,-1,439
1,<environment.Job instance at 0x7fb7e5e2ed20>,158,24,[10  5],159,-1,497,-1,473
1,<environment.Job instance at 0x7fb7e5f1e3c0>,0,17,[9 5],1,-1,18,-1,1
1,<environment.Job instance at 0x7fb7e5341550>,3,20,[1 7],4,-1,24,-1,4
1,<environment.Job instance at 0x7fb7e5341640>,4,14,[9 2],5,-1,21,-1,7
1,<environment.Job instance at 0x7fb7e5341820>,7,15,[3 7],8,-1,23,-1,8
1,<environment.Job instance at 0x7fb7e5341a00>,11,16,[9 2],12,-1,28,-1,12
1,<environment.Job instance at 0x7fb7e5341e10>,15,16,[7 4],16,-1,32,-1,16
1,<environment.Job instance at 0x7fb7e5334550>,22,16,[1 7],23,-1,39,-1,23
1,<environment.Job instance at 0x7fb7e532e320>,36,17,[9 2],37,-1,59,-1,42
1,<environment.Job instance at 0x7fb7e532e140>,34,16,[14  4],35,-1,64,-1,48
1,<environment.Job instance at 0x7fb7e532e5a0>,40,18,[5 7],41,-1,66,-1,48
1,<environment.Job instance at 0x7fb7e5334a00>,28,26,[5 7],29,-1,499,-1,473
1,<environment.Job instance at 0x7fb7e4de5820>,99,14,[10  4],100,-1,487,-1,473
1,<environment.Job instance at 0x7fb7e4fd5050>,5,3,[ 4 13],6,-1,9,-1,6
1,<environment.Job instance at 0x7fb7e4dca820>,6,28,[2 6],7,-1,44,-1,16
1,<environment.Job instance at 0x7fb7e5331dc0>,9,26,[10  1],10,-1,61,-1,35
1,<environment.Job instance at 0x7fb7e5327640>,17,16,[13  3],18,-1,53,-1,37
1,<environment.Job instance at 0x7fb7e4df1c80>,28,26,[5 7],29,-1,105,-1,79
1,<environment.Job instance at 0x7fb7e4df16e0>,29,28,[ 4 10],30,-1,107,-1,79
1,<environment.Job instance at 0x7fb7e4df1a00>,32,2,[ 4 11],33,-1,81,-1,79
1,<environment.Job instance at 0x7fb7e5deeaf0>,34,16,[14  4],35,-1,97,-1,81
1,<environment.Job instance at 0x7fb7e5deef00>,35,23,[ 3 10],36,-1,107,-1,84
1,<environment.Job instance at 0x7fb7e5baf960>,50,23,[7 1],51,-1,165,-1,142
1,<environment.Job instance at 0x7fb7e5341dc0>,61,13,[ 1 12],62,-1,196,-1,183
1,<environment.Job instance at 0x7fb7e5e2eb40>,69,3,[ 5 12],70,-1,212,-1,209
1,<environment.Job instance at 0x7fb7e5e2e960>,70,2,[ 5 14],71,-1,211,-1,209
1,<environment.Job instance at 0x7fb7e5e2ef50>,68,27,[1 8],69,-1,245,-1,218
1,<environment.Job instance at 0x7fb7e6266320>,82,2,[13  4],83,-1,261,-1,259
1,<environment.Job instance at 0x7fb7e6268690>,84,14,[12  1],85,-1,273,-1,259
1,<environment.Job instance at 0x7fb7e4ce6c80>,88,3,[ 3 14],89,-1,276,-1,273
1,<environment.Job instance at 0x7fb7e5e08be0>,90,3,[13  3],91,-1,279,-1,276
1,<environment.Job instance at 0x7fb7e5e04230>,95,2,[13  4],96,-1,296,-1,294
1,<environment.Job instance at 0x7fb7e5cb2320>,96,24,[7 1],97,-1,331,-1,307
1,<environment.Job instance at 0x7fb7e4c5c6e0>,111,3,[ 5 11],112,-1,384,-1,381
1,<environment.Job instance at 0x7fb7e52cf960>,158,24,[7 5],159,-1,598,-1,574
1,<environment.Job instance at 0x7fb7e56b7640>,0,18,[ 4 10],1,-1,19,-1,1
1,<environment.Job instance at 0x7fb7e56b7dc0>,6,17,[10  3],7,-1,24,-1,7
1,<environment.Job instance at 0x7fb7e56b7550>,7,25,[4 6],8,-1,33,-1,8
1,<environment.Job instance at 0x7fb7e56b7fa0>,8,17,[ 2 10],9,-1,26,-1,9
1,<environment.Job instance at 0x7fb7e56ab5f0>,11,23,[10  1],12,-1,35,-1,12
1,<environment.Job instance at 0x7fb7e56ab410>,12,14,[5 8],13,-1,27,-1,13
1,<environment.Job instance at 0x7fb7e56ab5a0>,13,26,[10  2],14,-1,41,-1,15
1,<environment.Job instance at 0x7fb7e56abd20>,16,16,[ 1 10],17,-1,33,-1,17
1,<environment.Job instance at 0x7fb7e56abdc0>,21,24,[4 8],22,-1,46,-1,22
1,<environment.Job instance at 0x7fb7e5337550>,22,17,[5 8],23,-1,40,-1,23
1,<environment.Job instance at 0x7fb7e569dbe0>,34,23,[ 5 10],35,-1,58,-1,35
1,<environment.Job instance at 0x7fb7e53370a0>,26,15,[6 2],27,-1,51,-1,36
1,<environment.Job instance at 0x7fb7e569d7d0>,35,16,[13  5],36,-1,53,-1,37
1,<environment.Job instance at 0x7fb7e569d4b0>,37,18,[3 8],38,-1,57,-1,39
1,<environment.Job instance at 0x7fb7e569db90>,39,23,[1 5],40,-1,63,-1,40
1,<environment.Job instance at 0x7fb7e569df00>,40,18,[5 4],41,-1,59,-1,41
1,<environment.Job instance at 0x7fb7e569dfa0>,41,15,[7 5],42,-1,59,-1,44
1,<environment.Job instance at 0x7fb7e531ffa0>,45,28,[1 7],46,-1,74,-1,46
1,<environment.Job instance at 0x7fb7e4de8910>,47,17,[10  5],48,-1,68,-1,51
1,<environment.Job instance at 0x7fb7e531f050>,48,13,[1 5],49,-1,72,-1,59
1,<environment.Job instance at 0x7fb7e4de8370>,51,18,[5 5],52,-1,77,-1,59
1,<environment.Job instance at 0x7fb7e4de8140>,53,18,[5 4],54,-1,77,-1,59
1,<environment.Job instance at 0x7fb7e4de8690>,54,16,[10  1],55,-1,75,-1,59
1,<environment.Job instance at 0x7fb7e53374b0>,28,13,[12  1],29,-1,77,-1,64
1,<environment.Job instance at 0x7fb7e531feb0>,43,25,[10  1],44,-1,89,-1,64
1,<environment.Job instance at 0x7fb7e4de8050>,62,14,[11  2],63,-1,81,-1,67
1,<environment.Job instance at 0x7fb7e533be10>,65,15,[10  1],66,-1,82,-1,67
1,<environment.Job instance at 0x7fb7e533b820>,66,18,[9 4],67,-1,85,-1,67
1,<environment.Job instance at 0x7fb7e4de8a00>,63,17,[ 1 10],64,-1,84,-1,67
1,<environment.Job instance at 0x7fb7e533b460>,67,23,[1 8],68,-1,94,-1,71
1,<environment.Job instance at 0x7fb7e533b280>,70,26,[4 7],71,-1,103,-1,77
1,<environment.Job instance at 0x7fb7e4de85f0>,57,16,[7 4],58,-1,95,-1,79
1,<environment.Job instance at 0x7fb7e533be60>,71,16,[4 5],72,-1,95,-1,79
1,<environment.Job instance at 0x7fb7e533bd70>,64,16,[10  1],65,-1,95,-1,79
1,<environment.Job instance at 0x7fb7e569da00>,32,22,[10  1],33,-1,109,-1,87
1,<environment.Job instance at 0x7fb7e4dd1640>,87,18,[10  1],88,-1,112,-1,94
1,<environment.Job instance at 0x7fb7e5331aa0>,80,13,[10  1],81,-1,108,-1,95
1,<environment.Job instance at 0x7fb7e4dd15f0>,93,23,[10  4],94,-1,128,-1,105
1,<environment.Job instance at 0x7fb7e4dd1fa0>,94,19,[ 5 10],95,-1,124,-1,105
1,<environment.Job instance at 0x7fb7e4dd1820>,92,18,[4 9],93,-1,123,-1,105
1,<environment.Job instance at 0x7fb7e4df1460>,98,12,[11  4],99,-1,117,-1,105
1,<environment.Job instance at 0x7fb7e4dd17d0>,89,14,[5 7],90,-1,119,-1,105
1,<environment.Job instance at 0x7fb7e4df1e10>,99,16,[ 1 10],100,-1,121,-1,105
1,<environment.Job instance at 0x7fb7e4df13c0>,103,15,[10  4],104,-1,122,-1,107
1,<environment.Job instance at 0x7fb7e4df10f0>,104,24,[1 8],105,-1,131,-1,107
1,<environment.Job instance at 0x7fb7e4df1550>,101,13,[9 4],102,-1,120,-1,107
1,<environment.Job instance at 0x7fb7e4df1140>,102,17,[1 6],103,-1,124,-1,107
1,<environment.Job instance at 0x7fb7e5344690>,106,15,[7 4],107,-1,124,-1,109
1,<environment.Job instance at 0x7fb7e56bbc30>,105,13,[8 3],106,-1,129,-1,116
1,<environment.Job instance at 0x7fb7e6102730>,109,17,[4 9],110,-1,134,-1,117
1,<environment.Job instance at 0x7fb7e4dff640>,112,26,[2 5],113,-1,143,-1,117
1,<environment.Job instance at 0x7fb7e556d280>,113,12,[12  2],114,-1,129,-1,117
1,<environment.Job instance at 0x7fb7e4dffe60>,107,18,[12  3],108,-1,135,-1,117
1,<environment.Job instance at 0x7fb7e4ba4870>,116,16,[9 2],117,-1,134,-1,118
1,<environment.Job instance at 0x7fb7e5a77dc0>,119,15,[3 6],120,-1,135,-1,120
1,<environment.Job instance at 0x7fb7e4f87cd0>,120,18,[2 9],121,-1,139,-1,121
1,<environment.Job instance at 0x7fb7e59db2d0>,121,18,[3 9],122,-1,140,-1,122
1,<environment.Job instance at 0x7fb7e58d1960>,127,26,[3 6],128,-1,156,-1,130
1,<environment.Job instance at 0x7fb7e4dff500>,110,2,[7 3],111,-1,136,-1,134
1,<environment.Job instance at 0x7fb7e4d28320>,126,17,[14  3],127,-1,156,-1,139
1,<environment.Job instance at 0x7fb7e4dce1e0>,129,25,[ 1 10],130,-1,164,-1,139
1,<environment.Job instance at 0x7fb7e4b91960>,136,17,[7 2],137,-1,164,-1,147
1,<environment.Job instance at 0x7fb7e58d1640>,125,17,[7 3],126,-1,164,-1,147
1,<environment.Job instance at 0x7fb7e5deec30>,143,20,[2 7],144,-1,168,-1,148
1,<environment.Job instance at 0x7fb7e532a780>,145,14,[ 4 10],146,-1,163,-1,149
1,<environment.Job instance at 0x7fb7e532a5a0>,146,12,[9 2],147,-1,161,-1,149
1,<environment.Job instance at 0x7fb7e5dee050>,144,12,[5 5],145,-1,161,-1,149
1,<environment.Job instance at 0x7fb7e533a280>,148,16,[10  2],149,-1,165,-1,149
1,<environment.Job instance at 0x7fb7e533a460>,149,22,[1 9],150,-1,172,-1,150
1,<environment.Job instance at 0x7fb7e533a1e0>,150,18,[10  1],151,-1,170,-1,152
1,<environment.Job instance at 0x7fb7e603f230>,153,24,[ 4 10],154,-1,183,-1,159
1,<environment.Job instance at 0x7fb7e4ded280>,137,13,[3 7],138,-1,172,-1,159
1,<environment.Job instance at 0x7fb7e55cbd70>,156,18,[5 5],157,-1,177,-1,159
1,<environment.Job instance at 0x7fb7e52e0fa0>,152,18,[6 2],153,-1,177,-1,159
1,<environment.Job instance at 0x7fb7e55cb500>,157,15,[9 4],158,-1,175,-1,160
1,<environment.Job instance at 0x7fb7e4dd1cd0>,85,16,[7 5],86,-1,177,-1,161
1,<environment.Job instance at 0x7fb7e55cb0f0>,158,16,[ 4 10],159,-1,177,-1,161
1,<environment.Job instance at 0x7fb7e55cb370>,161,12,[8 4],162,-1,174,-1,162
1,<environment.Job instance at 0x7fb7e4dca0a0>,163,20,[3 8],164,-1,184,-1,164
1,<environment.Job instance at 0x7fb7e6103a00>,165,16,[10  1],166,-1,183,-1,167
1,<environment.Job instance at 0x7fb7e4cbb190>,7,25,[4 6],8,-1,44,-1,19
1,<environment.Job instance at 0x7fb7e4dd1870>,11,23,[10  1],12,-1,47,-1,24
1,<environment.Job instance at 0x7fb7e61032d0>,14,3,[ 3 12],15,-1,27,-1,24
1,<environment.Job instance at 0x7fb7e6103640>,13,26,[10  2],14,-1,50,-1,24
1,<environment.Job instance at 0x7fb7e4ded870>,21,24,[4 8],22,-1,59,-1,35
1,<environment.Job instance at 0x7fb7e4de82d0>,23,2,[12  5],24,-1,37,-1,35
1,<environment.Job instance at 0x7fb7e4de80a0>,25,14,[ 2 11],26,-1,64,-1,50
1,<environment.Job instance at 0x7fb7e5331d20>,28,13,[12  1],29,-1,64,-1,51
1,<environment.Job instance at 0x7fb7e5167c30>,34,23,[ 5 10],35,-1,91,-1,68
1,<environment.Job instance at 0x7fb7e496c640>,35,16,[13  5],36,-1,84,-1,68
1,<environment.Job instance at 0x7fb7e4dca640>,39,23,[1 5],40,-1,92,-1,69
1,<environment.Job instance at 0x7fb7e4949280>,43,25,[10  1],44,-1,121,-1,96
1,<environment.Job instance at 0x7fb7e5b7c140>,46,15,[ 3 12],47,-1,111,-1,96
1,<environment.Job instance at 0x7fb7e58d4a50>,45,28,[1 7],46,-1,133,-1,105
1,<environment.Job instance at 0x7fb7e5df45a0>,62,14,[11  2],63,-1,183,-1,169
1,<environment.Job instance at 0x7fb7e6215190>,67,23,[1 8],68,-1,211,-1,188
1,<environment.Job instance at 0x7fb7e5390960>,70,26,[4 7],71,-1,229,-1,203
1,<environment.Job instance at 0x7fb7e5e8f730>,93,23,[10  4],94,-1,313,-1,290
1,<environment.Job instance at 0x7fb7e6162140>,98,12,[11  4],99,-1,302,-1,290
1,<environment.Job instance at 0x7fb7e5baca50>,104,24,[1 8],105,-1,350,-1,326
1,<environment.Job instance at 0x7fb7e55ef8c0>,107,18,[12  3],108,-1,344,-1,326
1,<environment.Job instance at 0x7fb7e5a54230>,112,26,[2 5],113,-1,372,-1,346
1,<environment.Job instance at 0x7fb7e5a54cd0>,113,12,[12  2],114,-1,358,-1,346
1,<environment.Job instance at 0x7fb7e4b0f3c0>,118,1,[13  1],119,-1,372,-1,371
1,<environment.Job instance at 0x7fb7e52e69b0>,126,17,[14  3],127,-1,408,-1,391
1,<environment.Job instance at 0x7fb7e62235f0>,127,26,[3 6],128,-1,419,-1,393
1,<environment.Job instance at 0x7fb7e5dfa9b0>,129,25,[ 1 10],130,-1,433,-1,408
1,<environment.Job instance at 0x7fb7e5e26820>,134,2,[13  2],135,-1,415,-1,413
1,<environment.Job instance at 0x7fb7e5b880a0>,138,1,[ 4 12],139,-1,430,-1,429
1,<environment.Job instance at 0x7fb7e4e76320>,153,24,[ 4 10],154,-1,518,-1,494
1,<environment.Job instance at 0x7fb7e617aaa0>,168,13,[ 2 14],169,-1,572,-1,559
1,<environment.Job instance at 0x7fb7e56012d0>,2,17,[2 8],3,-1,21,-1,4
1,<environment.Job instance at 0x7fb7e5601870>,4,15,[5 6],5,-1,20,-1,5
1,<environment.Job instance at 0x7fb7e5e47a00>,3,16,[7 5],4,-1,21,-1,5
1,<environment.Job instance at 0x7fb7e5601960>,5,15,[9 2],6,-1,22,-1,7
1,<environment.Job instance at 0x7fb7e5601cd0>,7,16,[ 2 10],8,-1,24,-1,8
1,<environment.Job instance at 0x7fb7e5601550>,6,17,[5 4],7,-1,25,-1,8
1,<environment.Job instance at 0x7fb7e5601a50>,10,16,[9 1],11,-1,32,-1,16
1,<environment.Job instance at 0x7fb7e4a5f500>,15,14,[1 8],16,-1,31,-1,17
1,<environment.Job instance at 0x7fb7e532d780>,20,18,[5 8],21,-1,42,-1,24
1,<environment.Job instance at 0x7fb7e5341820>,24,17,[4 7],25,-1,42,-1,25
1,<environment.Job instance at 0x7fb7e53415f0>,26,14,[3 5],27,-1,41,-1,27
1,<environment.Job instance at 0x7fb7e61d78c0>,27,25,[1 7],28,-1,53,-1,28
1,<environment.Job instance at 0x7fb7e61d7690>,28,19,[5 8],29,-1,48,-1,29
1,<environment.Job instance at 0x7fb7e61d7aa0>,29,16,[7 4],30,-1,46,-1,30
1,<environment.Job instance at 0x7fb7e61d76e0>,33,14,[2 9],34,-1,48,-1,34
1,<environment.Job instance at 0x7fb7e61d7320>,34,18,[10  3],35,-1,53,-1,35
1,<environment.Job instance at 0x7fb7e57d1d70>,37,15,[2 8],38,-1,53,-1,38
1,<environment.Job instance at 0x7fb7e57d1aa0>,40,15,[ 4 10],41,-1,56,-1,41
1,<environment.Job instance at 0x7fb7e57d1460>,41,17,[9 3],42,-1,59,-1,42
1,<environment.Job instance at 0x7fb7e57d1af0>,42,20,[ 1 10],43,-1,63,-1,43
1,<environment.Job instance at 0x7fb7e4dce960>,46,19,[4 8],47,-1,66,-1,47
1,<environment.Job instance at 0x7fb7e4dcee60>,48,15,[1 9],49,-1,64,-1,49
1,<environment.Job instance at 0x7fb7e4dcec30>,49,17,[4 9],50,-1,67,-1,50
1,<environment.Job instance at 0x7fb7e4c44f50>,56,27,[6 1],57,-1,84,-1,57
1,<environment.Job instance at 0x7fb7e53413c0>,23,12,[10  4],24,-1,69,-1,57
1,<environment.Job instance at 0x7fb7e4c449b0>,59,17,[8 2],60,-1,78,-1,61
1,<environment.Job instance at 0x7fb7e4c44b40>,63,16,[3 5],64,-1,80,-1,64
1,<environment.Job instance at 0x7fb7e4c44f00>,64,23,[5 9],65,-1,88,-1,65
1,<environment.Job instance at 0x7fb7e5093e60>,65,16,[1 6],66,-1,82,-1,66
1,<environment.Job instance at 0x7fb7e50935f0>,66,13,[1 5],67,-1,80,-1,67
1,<environment.Job instance at 0x7fb7e5093dc0>,67,23,[6 2],68,-1,91,-1,68
1,<environment.Job instance at 0x7fb7e5093eb0>,68,15,[5 6],69,-1,84,-1,69
1,<environment.Job instance at 0x7fb7e5093b40>,70,26,[6 1],71,-1,97,-1,71
1,<environment.Job instance at 0x7fb7e50932d0>,72,17,[5 5],73,-1,90,-1,73
1,<environment.Job instance at 0x7fb7e5093a00>,74,14,[5 7],75,-1,89,-1,75
1,<environment.Job instance at 0x7fb7e50935a0>,75,14,[9 1],76,-1,90,-1,76
1,<environment.Job instance at 0x7fb7e50936e0>,76,13,[4 7],77,-1,90,-1,77
1,<environment.Job instance at 0x7fb7e5093af0>,79,13,[2 5],80,-1,93,-1,80
1,<environment.Job instance at 0x7fb7e50934b0>,80,18,[5 7],81,-1,99,-1,81
1,<environment.Job instance at 0x7fb7e5093410>,82,16,[1 9],83,-1,99,-1,83
1,<environment.Job instance at 0x7fb7e4a2a280>,83,19,[8 3],84,-1,103,-1,84
1,<environment.Job instance at 0x7fb7e5093f50>,85,15,[9 3],86,-1,112,-1,97
1,<environment.Job instance at 0x7fb7e4a2a3c0>,84,17,[12  2],85,-1,114,-1,97
1,<environment.Job instance at 0x7fb7e4a2ab90>,94,14,[13  2],95,-1,112,-1,98
1,<environment.Job instance at 0x7fb7e4a2a550>,95,20,[5 5],96,-1,125,-1,105
1,<environment.Job instance at 0x7fb7e4a6be10>,139,28,[8 2],140,-1,1862,-1,1834
1,<environment.Job instance at 0x7fb7e4e6a8c0>,142,23,[4 7],143,-1,1857,-1,1834
1,<environment.Job instance at 0x7fb7e55396e0>,143,16,[6 2],144,-1,1855,-1,1839
1,<environment.Job instance at 0x7fb7e55380f0>,136,17,[7 4],137,-1,1857,-1,1840
1,<environment.Job instance at 0x7fb7e5539fa0>,144,28,[3 5],145,-1,1874,-1,1846
1,<environment.Job instance at 0x7fb7e51aa960>,154,17,[6 1],155,-1,1870,-1,1853
1,<environment.Job instance at 0x7fb7e52f6820>,158,18,[ 5 10],159,-1,1886,-1,1868
1,<environment.Job instance at 0x7fb7e52f6640>,161,24,[ 3 10],162,-1,1892,-1,1868
1,<environment.Job instance at 0x7fb7e52f6690>,163,26,[5 1],164,-1,1911,-1,1885
1,<environment.Job instance at 0x7fb7e52f64b0>,164,16,[ 4 10],165,-1,1906,-1,1890
1,<environment.Job instance at 0x7fb7e5d71aa0>,166,17,[9 5],167,-1,1909,-1,1892
1,<environment.Job instance at 0x7fb7e4cfb9b0>,168,13,[7 5],169,-1,1915,-1,1902
1,<environment.Job instance at 0x7fb7e4dce550>,52,14,[14  2],53,-1,1916,-1,1902
1,<environment.Job instance at 0x7fb7e4a2aaf0>,96,17,[12  5],97,-1,1919,-1,1902
1,<environment.Job instance at 0x7fb7eed25230>,155,13,[9 5],156,-1,1917,-1,1904
1,<environment.Job instance at 0x7fb7e5ea0e10>,119,28,[9 4],120,-1,1932,-1,1904
1,<environment.Job instance at 0x7fb7e4a5f820>,0,3,[ 3 14],1,-1,4,-1,1
1,<environment.Job instance at 0x7fb7e4cfb6e0>,19,15,[12  2],20,-1,59,-1,44
1,<environment.Job instance at 0x7fb7e6245410>,27,25,[1 7],28,-1,99,-1,74
1,<environment.Job instance at 0x7fb7e6057a50>,31,2,[ 5 11],32,-1,76,-1,74
1,<environment.Job instance at 0x7fb7e4a3f0a0>,35,3,[ 3 11],36,-1,94,-1,91
1,<environment.Job instance at 0x7fb7e5dfaa50>,47,2,[14  5],48,-1,135,-1,133
1,<environment.Job instance at 0x7fb7e52e65f0>,52,14,[14  2],53,-1,165,-1,151
1,<environment.Job instance at 0x7fb7e52e6370>,55,1,[ 5 13],56,-1,157,-1,156
1,<environment.Job instance at 0x7fb7e4b0f0a0>,56,27,[6 1],57,-1,185,-1,158
1,<environment.Job instance at 0x7fb7e6162140>,64,23,[5 9],65,-1,204,-1,181
1,<environment.Job instance at 0x7fb7e6161870>,67,23,[6 2],68,-1,207,-1,184
1,<environment.Job instance at 0x7fb7e6213320>,70,26,[6 1],71,-1,216,-1,190
1,<environment.Job instance at 0x7fb7e5fa4cd0>,73,14,[ 4 13],74,-1,210,-1,196
1,<environment.Job instance at 0x7fb7e6155910>,81,14,[13  1],82,-1,242,-1,228
1,<environment.Job instance at 0x7fb7e5ef9aa0>,84,17,[12  2],85,-1,258,-1,241
1,<environment.Job instance at 0x7fb7e5df45a0>,89,26,[5 8],90,-1,290,-1,264
1,<environment.Job instance at 0x7fb7e61d8af0>,94,14,[13  2],95,-1,288,-1,274
1,<environment.Job instance at 0x7fb7e600e8c0>,96,17,[12  5],97,-1,298,-1,281
1,<environment.Job instance at 0x7fb7e5331190>,108,14,[14  2],109,-1,351,-1,337
1,<environment.Job instance at 0x7fb7e5deeaf0>,110,23,[ 1 10],111,-1,373,-1,350
1,<environment.Job instance at 0x7fb7e5337320>,119,28,[9 4],120,-1,416,-1,388
1,<environment.Job instance at 0x7fb7e569d820>,125,15,[13  2],126,-1,406,-1,391
1,<environment.Job instance at 0x7fb7ee8bdc30>,139,28,[8 2],140,-1,449,-1,421
1,<environment.Job instance at 0x7fb7e4c612d0>,142,23,[4 7],143,-1,471,-1,448
1,<environment.Job instance at 0x7fb7e4c61dc0>,144,28,[3 5],145,-1,476,-1,448
1,<environment.Job instance at 0x7fb7e4c61780>,148,3,[11  1],149,-1,454,-1,451
1,<environment.Job instance at 0x7fb7ee85eb90>,149,3,[12  3],150,-1,454,-1,451
1,<environment.Job instance at 0x7fb7e514b730>,161,24,[ 3 10],162,-1,526,-1,502
1,<environment.Job instance at 0x7fb7e514b460>,163,26,[5 1],164,-1,537,-1,511
1,<environment.Job instance at 0x7f1ffccc46e0>,0,13,[9 3],1,-1,15,-1,2
1,<environment.Job instance at 0x7f1ffccc48c0>,1,22,[11  3],2,-1,24,-1,2
1,<environment.Job instance at 0x7f1ffccc4730>,2,22,[4 8],3,-1,25,-1,3
1,<environment.Job instance at 0x7f1ff36d4fa0>,9,18,[11  5],10,-1,28,-1,10
1,<environment.Job instance at 0x7f1ff36d70f0>,11,15,[4 8],12,-1,27,-1,12
1,<environment.Job instance at 0x7f1ff36d7320>,12,26,[ 1 10],13,-1,39,-1,13
1,<environment.Job instance at 0x7f1ff36d7230>,13,18,[ 4 10],14,-1,32,-1,14
1,<environment.Job instance at 0x7f1ff36d7460>,15,18,[2 8],16,-1,34,-1,16
1,<environment.Job instance at 0x7f1ff36d7640>,16,16,[3 5],17,-1,33,-1,17
1,<environment.Job instance at 0x7f1ff36d78c0>,20,1,[7 5],21,-1,22,-1,21
1,<environment.Job instance at 0x7f1ff36d7aa0>,21,1,[6 5],22,-1,23,-1,22
1,<environment.Job instance at 0x7f1ff36d7910>,22,1,[2 7],23,-1,24,-1,23
1,<environment.Job instance at 0x7f1ff36d7b40>,23,27,[1 6],24,-1,51,-1,24
1,<environment.Job instance at 0x7f1ff36d7be0>,24,18,[2 6],25,-1,43,-1,25
1,<environment.Job instance at 0x7f1ff36d7c80>,25,12,[ 5 10],26,-1,38,-1,26
1,<environment.Job instance at 0x7f1ff36d7dc0>,27,15,[8 4],28,-1,43,-1,28
1,<environment.Job instance at 0x7f1ff36d7f50>,28,23,[10  4],29,-1,52,-1,29
1,<environment.Job instance at 0x7f1ff36da0a0>,30,14,[5 2],31,-1,45,-1,31
1,<environment.Job instance at 0x7f1ff36da1e0>,31,14,[2 5],32,-1,46,-1,32
1,<environment.Job instance at 0x7f1ff36da4b0>,34,24,[1 8],35,-1,59,-1,35
1,<environment.Job instance at 0x7f1ff36da640>,35,15,[9 5],36,-1,51,-1,36
1,<environment.Job instance at 0x7f1ff36daaa0>,40,15,[10  3],41,-1,59,-1,44
1,<environment.Job instance at 0x7f1ff36dabe0>,43,18,[5 5],44,-1,62,-1,44
1,<environment.Job instance at 0x7f1ff36dc0f0>,48,15,[10  1],49,-1,65,-1,50
1,<environment.Job instance at 0x7f1ff36dc730>,53,17,[5 7],54,-1,71,-1,54
1,<environment.Job instance at 0x7f1ff36dc960>,56,17,[8 5],57,-1,74,-1,57
1,<environment.Job instance at 0x7f1ff36dc870>,58,14,[2 7],59,-1,73,-1,59
1,<environment.Job instance at 0x7f1ff36dccd0>,59,17,[1 6],60,-1,77,-1,60
1,<environment.Job instance at 0x7f1ff36dcf50>,62,22,[6 4],63,-1,85,-1,63
1,<environment.Job instance at 0x7f1ff36e0140>,64,18,[2 9],65,-1,83,-1,65
1,<environment.Job instance at 0x7f1ff36e0280>,65,20,[2 6],66,-1,86,-1,66
1,<environment.Job instance at 0x7f1ff36e0d20>,81,15,[5 9],82,-1,138,-1,123
1,<environment.Job instance at 0x7f1ff36e0dc0>,82,16,[ 4 10],83,-1,139,-1,123
1,<environment.Job instance at 0x7f1ff36e0f00>,84,18,[3 7],85,-1,143,-1,125
1,<environment.Job instance at 0x7f1ff36e0fa0>,85,17,[3 9],86,-1,142,-1,125
1,<environment.Job instance at 0x7f1ff36de0a0>,86,18,[9 2],87,-1,143,-1,125
1,<environment.Job instance at 0x7f1ff36e0be0>,79,13,[9 4],80,-1,139,-1,126
1,<environment.Job instance at 0x7f1ff36de3c0>,92,20,[1 5],93,-1,155,-1,135
1,<environment.Job instance at 0x7f1ff36dee10>,99,18,[12  5],100,-1,153,-1,135
1,<environment.Job instance at 0x7f1ff36deeb0>,100,18,[2 7],101,-1,156,-1,138
1,<environment.Job instance at 0x7f1ff36debe0>,101,18,[ 1 10],102,-1,156,-1,138
1,<environment.Job instance at 0x7f1ff36dedc0>,102,16,[3 9],103,-1,154,-1,138
1,<environment.Job instance at 0x7f1ff36defa0>,103,16,[1 6],104,-1,154,-1,138
1,<environment.Job instance at 0x7f1ff36deb40>,95,15,[5 7],96,-1,153,-1,138
1,<environment.Job instance at 0x7f1ff36e6230>,105,14,[14  5],106,-1,155,-1,141
1,<environment.Job instance at 0x7f1ff36e6370>,107,17,[9 3],108,-1,158,-1,141
1,<environment.Job instance at 0x7f1ff36e62d0>,106,15,[11  1],107,-1,156,-1,141
1,<environment.Job instance at 0x7f1ff36cb820>,112,2,[6 2],113,-1,143,-1,141
1,<environment.Job instance at 0x7f1ff36cbc30>,113,15,[6 1],114,-1,156,-1,141
1,<environment.Job instance at 0x7f1ff372c820>,111,26,[ 5 10],112,-1,167,-1,141
1,<environment.Job instance at 0x7f1ff36e0a00>,76,19,[4 8],77,-1,160,-1,141
1,<environment.Job instance at 0x7f1ff36e6190>,104,15,[1 9],105,-1,156,-1,141
1,<environment.Job instance at 0x7f1ff36e03c0>,67,27,[ 1 10],68,-1,252,-1,225
1,<environment.Job instance at 0x7f1ff3789460>,130,15,[8 3],131,-1,241,-1,226
1,<environment.Job instance at 0x7f1ff37f53c0>,133,16,[ 3 10],134,-1,242,-1,226
1,<environment.Job instance at 0x7f1ff377e5f0>,135,14,[ 2 10],136,-1,240,-1,226
1,<environment.Job instance at 0x7f1ff377e410>,137,20,[9 2],138,-1,246,-1,226
1,<environment.Job instance at 0x7f1ff37cbeb0>,138,16,[11  2],139,-1,242,-1,226
1,<environment.Job instance at 0x7f1ff36f79b0>,139,18,[ 1 12],140,-1,244,-1,226
1,<environment.Job instance at 0x7f1ff36f7280>,140,16,[2 8],141,-1,243,-1,227
1,<environment.Job instance at 0x7f1ff36fc0f0>,146,17,[1 7],147,-1,248,-1,231
1,<environment.Job instance at 0x7f1ff37e25a0>,158,14,[9 5],159,-1,297,-1,283
1,<environment.Job instance at 0x7f1ff36d7730>,1,22,[11  3],2,-1,24,-1,2
1,<environment.Job instance at 0x7f1ff36dce10>,9,18,[11  5],10,-1,32,-1,14
1,<environment.Job instance at 0x7f1ff36e05f0>,12,26,[ 1 10],13,-1,82,-1,56
1,<environment.Job instance at 0x7f1ff36fc870>,23,27,[1 6],24,-1,87,-1,60
1,<environment.Job instance at 0x7f1ff3783640>,28,23,[10  4],29,-1,97,-1,74
1,<environment.Job instance at 0x7f1ff36b7690>,34,24,[1 8],35,-1,117,-1,93
1,<environment.Job instance at 0x7f1ff36b1fa0>,36,13,[ 3 14],37,-1,106,-1,93
1,<environment.Job instance at 0x7f1ff36c4960>,46,17,[12  2],47,-1,134,-1,117
1,<environment.Job instance at 0x7f1ff36d4be0>,50,16,[12  2],51,-1,146,-1,130
1,<environment.Job instance at 0x7f1ff36e65a0>,54,13,[13  1],55,-1,158,-1,145
1,<environment.Job instance at 0x7f1ff36e69b0>,60,3,[12  3],61,-1,169,-1,166
1,<environment.Job instance at 0x7f1ff36710f0>,67,27,[ 1 10],68,-1,216,-1,189
1,<environment.Job instance at 0x7f1ff36712d0>,69,13,[ 3 12],70,-1,202,-1,189
1,<environment.Job instance at 0x7f1ff36715a0>,75,14,[ 4 11],76,-1,215,-1,201
1,<environment.Job instance at 0x7f1ff36745f0>,97,2,[ 5 11],98,-1,294,-1,292
1,<environment.Job instance at 0x7f1ff3674730>,99,18,[12  5],100,-1,312,-1,294
1,<environment.Job instance at 0x7f1ff3674c30>,105,14,[14  5],106,-1,341,-1,327
1,<environment.Job instance at 0x7f1ff3674a50>,106,15,[11  1],107,-1,342,-1,327
1,<environment.Job instance at 0x7f1ff3676550>,116,3,[ 1 12],117,-1,363,-1,360
1,<environment.Job instance at 0x7f1ff3674e60>,111,26,[ 5 10],112,-1,396,-1,370
1,<environment.Job instance at 0x7f1ff3676870>,122,3,[ 4 12],123,-1,377,-1,374
1,<environment.Job instance at 0x7f1ff36769b0>,123,12,[ 4 11],124,-1,386,-1,374
1,<environment.Job instance at 0x7f1ff3676c80>,128,23,[ 2 14],129,-1,419,-1,396
1,<environment.Job instance at 0x7f1ff367a3c0>,138,16,[11  2],139,-1,447,-1,431
1,<environment.Job instance at 0x7f1ff367a460>,139,18,[ 1 12],140,-1,449,-1,431
1,<environment.Job instance at 0x7f1ff367a6e0>,143,15,[ 1 12],144,-1,466,-1,451
1,<environment.Job instance at 0x7f1ff367aaa0>,145,3,[ 4 13],146,-1,455,-1,452
1,<environment.Job instance at 0x7f1ff367ab90>,147,1,[ 1 14],148,-1,455,-1,454
1,<environment.Job instance at 0x7f1ff367c3c0>,160,3,[13  3],161,-1,503,-1,500
1,<environment.Job instance at 0x7f1ff367c5a0>,165,13,[ 1 14],166,-1,518,-1,505
1,<environment.Job instance at 0x7f1ff367cfa0>,176,2,[11  5],177,-1,542,-1,540
1,<environment.Job instance at 0x7f1ff367cf00>,178,3,[14  4],179,-1,543,-1,540
1,<environment.Job instance at 0x7f1ff31435a0>,8,21,[9 4],9,-1,30,-1,9
1,<environment.Job instance at 0x7f1ff3143870>,9,12,[9 3],10,-1,23,-1,11
1,<environment.Job instance at 0x7f1ff3134780>,10,18,[10  3],11,-1,29,-1,11
1,<environment.Job instance at 0x7f1ff31430f0>,11,17,[10  2],12,-1,30,-1,13
1,<environment.Job instance at 0x7f1ff31475a0>,20,13,[10  5],21,-1,35,-1,22
1,<environment.Job instance at 0x7f1ff3147b40>,23,14,[7 5],24,-1,38,-1,24
1,<environment.Job instance at 0x7f1ff3147730>,25,14,[10  2],26,-1,40,-1,26
1,<environment.Job instance at 0x7f1ff31b6d20>,34,16,[7 2],35,-1,51,-1,35
1,<environment.Job instance at 0x7f1ff32a0af0>,36,12,[ 3 10],37,-1,49,-1,37
1,<environment.Job instance at 0x7f1ff318adc0>,40,18,[4 5],41,-1,59,-1,41
1,<environment.Job instance at 0x7f1ff318a050>,41,18,[2 8],42,-1,60,-1,42
1,<environment.Job instance at 0x7f1ff3196aa0>,43,14,[11  3],44,-1,61,-1,47
1,<environment.Job instance at 0x7f1ff32b8960>,46,14,[10  1],47,-1,61,-1,47
1,<environment.Job instance at 0x7f1ffceed500>,47,16,[9 2],48,-1,65,-1,49
1,<environment.Job instance at 0x7f1ff315abe0>,50,13,[7 4],51,-1,64,-1,51
1,<environment.Job instance at 0x7f1ff3196780>,44,16,[9 4],45,-1,70,-1,54
1,<environment.Job instance at 0x7f1ff2f53910>,52,20,[1 7],53,-1,74,-1,54
1,<environment.Job instance at 0x7f1ff2f5a320>,56,19,[2 7],57,-1,76,-1,57
1,<environment.Job instance at 0x7f1ffce36af0>,58,18,[6 3],59,-1,77,-1,59
1,<environment.Job instance at 0x7f1ff2d635a0>,60,24,[ 1 10],61,-1,85,-1,61
1,<environment.Job instance at 0x7f1ff2ce0f50>,63,24,[7 4],64,-1,88,-1,64
1,<environment.Job instance at 0x7f1ff2db53c0>,64,16,[7 5],65,-1,81,-1,65
1,<environment.Job instance at 0x7f1ff2cc6140>,66,16,[7 4],67,-1,83,-1,67
1,<environment.Job instance at 0x7f1ff2d26500>,68,18,[4 6],69,-1,87,-1,69
1,<environment.Job instance at 0x7f1ff3081a50>,48,15,[7 5],49,-1,85,-1,70
1,<environment.Job instance at 0x7f1ff2c871e0>,77,17,[5 2],78,-1,95,-1,78
1,<environment.Job instance at 0x7f1ff2c87910>,78,18,[4 5],79,-1,97,-1,79
1,<environment.Job instance at 0x7f1ff2c86c80>,80,25,[ 3 10],81,-1,106,-1,81
1,<environment.Job instance at 0x7f1ff2c877d0>,75,16,[14  1],76,-1,101,-1,85
1,<environment.Job instance at 0x7f1ff2c6d960>,87,13,[9 2],88,-1,102,-1,89
1,<environment.Job instance at 0x7f1ff2c89eb0>,90,17,[2 6],91,-1,108,-1,91
1,<environment.Job instance at 0x7f1ff2c89050>,91,15,[8 4],92,-1,107,-1,92
1,<environment.Job instance at 0x7f1ff2c89320>,93,23,[10  1],94,-1,120,-1,97
1,<environment.Job instance at 0x7f1ff2c894b0>,96,28,[6 5],97,-1,125,-1,97
1,<environment.Job instance at 0x7f1ff2c890f0>,97,18,[5 9],98,-1,117,-1,99
1,<environment.Job instance at 0x7f1ff2d5a050>,104,15,[10  4],105,-1,121,-1,106
1,<environment.Job instance at 0x7f1ff2d04b40>,105,18,[11  3],106,-1,124,-1,106
1,<environment.Job instance at 0x7f1ff2c847d0>,110,18,[6 1],111,-1,129,-1,111
1,<environment.Job instance at 0x7f1ff2c845a0>,109,28,[5 3],110,-1,139,-1,111
1,<environment.Job instance at 0x7f1ff2d0b2d0>,112,18,[8 2],113,-1,136,-1,118
1,<environment.Job instance at 0x7f1ff2c885a0>,119,16,[9 4],120,-1,136,-1,120
1,<environment.Job instance at 0x7f1ff2db6be0>,124,17,[9 4],125,-1,142,-1,125
1,<environment.Job instance at 0x7f1ff2d0b1e0>,115,17,[4 6],116,-1,145,-1,128
1,<environment.Job instance at 0x7f1ff2f5f4b0>,127,13,[1 9],128,-1,142,-1,129
1,<environment.Job instance at 0x7f1ff2f432d0>,128,17,[3 6],129,-1,147,-1,130
1,<environment.Job instance at 0x7f1ff2daef00>,129,15,[ 5 10],130,-1,147,-1,132
1,<environment.Job instance at 0x7f1ff2ef68c0>,131,14,[8 2],132,-1,154,-1,140
1,<environment.Job instance at 0x7f1ff2c70f00>,133,20,[2 6],134,-1,161,-1,141
1,<environment.Job instance at 0x7f1ff2c70aa0>,134,15,[5 1],135,-1,177,-1,162
1,<environment.Job instance at 0x7f1ff2ef32d0>,149,15,[ 3 10],150,-1,177,-1,162
1,<environment.Job instance at 0x7f1ff2ef3190>,150,24,[2 8],151,-1,186,-1,162
1,<environment.Job instance at 0x7f1ff2db9f00>,140,12,[9 2],141,-1,174,-1,162
1,<environment.Job instance at 0x7f1ff2ef3870>,148,15,[7 5],149,-1,177,-1,162
1,<environment.Job instance at 0x7f1ff2db6550>,122,25,[6 3],123,-1,187,-1,162
1,<environment.Job instance at 0x7f1ff2ef3050>,155,15,[ 1 11],156,-1,177,-1,162
1,<environment.Job instance at 0x7f1ff2ef3690>,153,24,[10  5],154,-1,186,-1,162
1,<environment.Job instance at 0x7f1ff2ef35a0>,151,24,[9 1],152,-1,187,-1,163
1,<environment.Job instance at 0x7f1ff2ef3460>,154,23,[10  2],155,-1,186,-1,163
1,<environment.Job instance at 0x7f1ff2ef31e0>,156,16,[ 5 10],157,-1,179,-1,163
1,<environment.Job instance at 0x7f1ff3196230>,161,17,[10  3],162,-1,180,-1,163
1,<environment.Job instance at 0x7f1ff3196550>,159,13,[4 6],160,-1,178,-1,165
1,<environment.Job instance at 0x7f1ff31967d0>,160,15,[7 1],161,-1,180,-1,165
1,<environment.Job instance at 0x7f1ff3196320>,162,13,[1 6],163,-1,179,-1,166
1,<environment.Job instance at 0x7f1ff31932d0>,164,14,[1 5],165,-1,191,-1,177
1,<environment.Job instance at 0x7f1ff3193b90>,172,12,[8 1],173,-1,189,-1,177
1,<environment.Job instance at 0x7f1ff3193b40>,170,14,[8 3],171,-1,191,-1,177
1,<environment.Job instance at 0x7f1ff2c87870>,72,26,[8 4],73,-1,203,-1,177
1,<environment.Job instance at 0x7f1ff3176c80>,177,16,[9 4],178,-1,194,-1,178
1,<environment.Job instance at 0x7f1ff2eeb730>,18,12,[14  4],19,-1,44,-1,32
1,<environment.Job instance at 0x7f1ff367c1e0>,28,2,[13  1],29,-1,63,-1,61
1,<environment.Job instance at 0x7f1ff367c5a0>,31,3,[13  5],32,-1,73,-1,70
1,<environment.Job instance at 0x7f1ff367c460>,32,2,[ 1 12],33,-1,72,-1,70
1,<environment.Job instance at 0x7f1ff3676f50>,42,1,[ 4 13],43,-1,91,-1,90
1,<environment.Job instance at 0x7f1ff3676c80>,43,14,[11  3],44,-1,104,-1,90
1,<environment.Job instance at 0x7f1ff36e6e60>,60,24,[ 1 10],61,-1,193,-1,169
1,<environment.Job instance at 0x7f1ff36e6820>,63,24,[7 4],64,-1,206,-1,182
1,<environment.Job instance at 0x7f1ff36e69b0>,65,3,[12  3],66,-1,185,-1,182
1,<environment.Job instance at 0x7f1ff36e64b0>,71,27,[4 7],72,-1,232,-1,205
1,<environment.Job instance at 0x7f1ff36e6500>,72,26,[8 4],73,-1,231,-1,205
1,<environment.Job instance at 0x7f1ff2eae550>,75,16,[14  1],76,-1,221,-1,205
1,<environment.Job instance at 0x7f1ff2f49cd0>,80,25,[ 3 10],81,-1,261,-1,236
1,<environment.Job instance at 0x7f1ff3088fa0>,96,28,[6 5],97,-1,317,-1,289
1,<environment.Job instance at 0x7f1ff2e9bbe0>,93,23,[10  1],94,-1,312,-1,289
1,<environment.Job instance at 0x7f1ff314c140>,101,15,[14  1],102,-1,306,-1,291
1,<environment.Job instance at 0x7f1ff2fc7460>,105,18,[11  3],106,-1,313,-1,295
1,<environment.Job instance at 0x7f1ff2ee0640>,109,28,[5 3],110,-1,331,-1,303
1,<environment.Job instance at 0x7f1ff2f2c0f0>,122,25,[6 3],123,-1,381,-1,356
1,<environment.Job instance at 0x7f1ff2e32140>,139,18,[13  1],140,-1,431,-1,413
1,<environment.Job instance at 0x7f1ff2e458c0>,142,3,[ 3 11],143,-1,418,-1,415
1,<environment.Job instance at 0x7f1ff2e79190>,150,24,[2 8],151,-1,473,-1,449
1,<environment.Job instance at 0x7f1ff2e98140>,151,24,[9 1],152,-1,473,-1,449
1,<environment.Job instance at 0x7f1ff2e985a0>,153,24,[10  5],154,-1,476,-1,452
1,<environment.Job instance at 0x7f1ff2e983c0>,154,23,[10  2],155,-1,475,-1,452
1,<environment.Job instance at 0x7f1ff2e98fa0>,155,15,[ 1 11],156,-1,467,-1,452
1,<environment.Job instance at 0x7f1ff2fc8960>,167,15,[ 3 12],168,-1,514,-1,499
1,<environment.Job instance at 0x7f1ff2fc2aa0>,0,27,[ 5 10],1,-1,28,-1,1
1,<environment.Job instance at 0x7f1ff2fc2320>,1,17,[7 5],2,-1,19,-1,2
1,<environment.Job instance at 0x7f1ff2ec3640>,4,15,[4 6],5,-1,20,-1,5
1,<environment.Job instance at 0x7f1ff2ec3050>,6,25,[ 5 10],7,-1,32,-1,7
1,<environment.Job instance at 0x7f1ff2ec3f00>,8,18,[1 5],9,-1,27,-1,9
1,<environment.Job instance at 0x7f1ff2dfbbe0>,20,14,[7 5],21,-1,35,-1,21
1,<environment.Job instance at 0x7f1ff2dfbb40>,25,16,[10  4],26,-1,44,-1,28
1,<environment.Job instance at 0x7f1ff2e05730>,28,14,[7 5],29,-1,43,-1,29
1,<environment.Job instance at 0x7f1ff2e05d20>,30,18,[9 5],31,-1,49,-1,31
1,<environment.Job instance at 0x7f1ff2e05500>,34,17,[7 2],35,-1,52,-1,35
1,<environment.Job instance at 0x7f1ff2e05370>,37,15,[2 9],38,-1,53,-1,38
1,<environment.Job instance at 0x7f1ff2e01af0>,39,17,[8 1],40,-1,57,-1,40
1,<environment.Job instance at 0x7f1ff2e01050>,41,17,[2 6],42,-1,59,-1,42
1,<environment.Job instance at 0x7f1ff2e01230>,42,19,[8 2],43,-1,62,-1,43
1,<environment.Job instance at 0x7f1ff2dfe3c0>,48,14,[ 2 10],49,-1,63,-1,49
1,<environment.Job instance at 0x7f1ff2dfe370>,49,17,[9 1],50,-1,67,-1,50
1,<environment.Job instance at 0x7f1ff2dfe320>,50,18,[3 5],51,-1,69,-1,51
1,<environment.Job instance at 0x7f1ff2dfeeb0>,55,13,[ 1 10],56,-1,69,-1,56
1,<environment.Job instance at 0x7f1ff2dfe640>,58,14,[4 6],59,-1,73,-1,59
1,<environment.Job instance at 0x7f1ff2df7280>,59,15,[10  2],60,-1,75,-1,60
1,<environment.Job instance at 0x7f1ff2df74b0>,60,13,[5 6],61,-1,74,-1,61
1,<environment.Job instance at 0x7f1ff2df7b90>,63,13,[4 9],64,-1,77,-1,64
1,<environment.Job instance at 0x7f1ff2df70f0>,65,14,[7 4],66,-1,80,-1,66
1,<environment.Job instance at 0x7f1ff2df31e0>,70,16,[10  2],71,-1,87,-1,71
1,<environment.Job instance at 0x7f1ff2df3e10>,71,13,[4 5],72,-1,85,-1,72
1,<environment.Job instance at 0x7f1ff2df3140>,74,21,[7 2],75,-1,96,-1,75
1,<environment.Job instance at 0x7f1ff2df3a00>,75,12,[ 1 10],76,-1,88,-1,76
1,<environment.Job instance at 0x7f1ff2df3dc0>,78,16,[6 3],79,-1,95,-1,79
1,<environment.Job instance at 0x7f1ff2df3690>,79,14,[5 7],80,-1,94,-1,80
1,<environment.Job instance at 0x7f1ff2df36e0>,80,18,[4 7],81,-1,99,-1,81
1,<environment.Job instance at 0x7f1ff2deeeb0>,82,14,[ 1 11],83,-1,97,-1,83
1,<environment.Job instance at 0x7f1ff2dfb140>,27,12,[5 8],28,-1,97,-1,85
1,<environment.Job instance at 0x7f1ff2deee60>,88,15,[8 5],89,-1,104,-1,89
1,<environment.Job instance at 0x7f1ff2eaee60>,96,18,[4 6],97,-1,131,-1,113
1,<environment.Job instance at 0x7f1ff2e0a960>,0,27,[ 5 10],1,-1,28,-1,1
1,<environment.Job instance at 0x7f1ff2dfb0a0>,6,25,[ 5 10],7,-1,40,-1,15
1,<environment.Job instance at 0x7f1ff2f349b0>,22,17,[12  4],23,-1,61,-1,44
1,<environment.Job instance at 0x7f1ff2c92730>,35,2,[ 4 11],36,-1,63,-1,61
1,<environment.Job instance at 0x7f1ff2c86780>,43,2,[ 2 14],44,-1,94,-1,92
1,<environment.Job instance at 0x7f1ff2f53cd0>,44,17,[ 5 14],45,-1,109,-1,92
1,<environment.Job instance at 0x7f1ff2c87500>,46,2,[11  3],47,-1,94,-1,92
1,<environment.Job instance at 0x7f1ff349da50>,47,2,[12  2],48,-1,94,-1,92
1,<environment.Job instance at 0x7f1ff2cdb1e0>,52,2,[12  5],53,-1,126,-1,124
1,<environment.Job instance at 0x7f1ff2c729b0>,54,1,[14  4],55,-1,125,-1,124
1,<environment.Job instance at 0x7f1ff2dd8690>,73,1,[ 5 12],74,-1,195,-1,194
1,<environment.Job instance at 0x7f1ff2dba280>,82,14,[ 1 11],83,-1,233,-1,219
1,<environment.Job instance at 0x7f1ff2d13230>,84,3,[14  4],85,-1,229,-1,226
1,<environment.Job instance at 0x7f1ff2d13910>,86,2,[13  4],87,-1,230,-1,228
1,<environment.Job instance at 0x7f1ff2dcf5f0>,89,27,[1 5],90,-1,269,-1,242
1,<environment.Job instance at 0x7f1ff2daeeb0>,95,14,[ 5 12],96,-1,260,-1,246
1,<environment.Job instance at 0x7f1ff2dae780>,97,19,[14  4],98,-1,268,-1,249
1,<environment.Job instance at 0x7f1ff2daea50>,99,14,[ 5 11],100,-1,263,-1,249
1,<environment.Job instance at 0x7f1ff2db9910>,106,25,[3 8],107,-1,309,-1,284
1,<environment.Job instance at 0x7f1ff2db9d20>,108,3,[ 5 14],109,-1,287,-1,284
1,<environment.Job instance at 0x7f1ff2db90f0>,109,27,[9 3],110,-1,324,-1,297
1,<environment.Job instance at 0x7f1ff2deba00>,112,24,[ 3 10],113,-1,328,-1,304
1,<environment.Job instance at 0x7f1ff2debc80>,117,12,[ 2 12],118,-1,322,-1,310
1,<environment.Job instance at 0x7f1ff2deb9b0>,118,27,[1 7],119,-1,339,-1,312
1,<environment.Job instance at 0x7f1ff2de80f0>,135,2,[14  5],136,-1,393,-1,391
1,<environment.Job instance at 0x7f1ff2e4d320>,153,27,[1 8],154,-1,477,-1,450
1,<environment.Job instance at 0x7f1ff2e5fc80>,173,3,[ 3 14],174,-1,538,-1,535
1,<environment.Job instance at 0x7f1ff2e5fd70>,175,25,[6 3],176,-1,575,-1,550
1,<environment.Job instance at 0x7f1ff3534230>,2,16,[9 2],3,-1,19,-1,3
1,<environment.Job instance at 0x7f1ff3534dc0>,5,18,[7 5],6,-1,24,-1,6
1,<environment.Job instance at 0x7f1ff33c3c30>,8,17,[10  3],9,-1,26,-1,9
1,<environment.Job instance at 0x7f1ff33c38c0>,9,27,[ 5 10],10,-1,38,-1,11
1,<environment.Job instance at 0x7f1ff33c3be0>,11,22,[ 1 10],12,-1,34,-1,12
1,<environment.Job instance at 0x7f1ff3534e10>,10,1,[6 3],11,-1,13,-1,12
1,<environment.Job instance at 0x7f1ff33c3820>,12,18,[5 1],13,-1,31,-1,13
1,<environment.Job instance at 0x7f1ff35ff140>,18,20,[6 2],19,-1,39,-1,19
1,<environment.Job instance at 0x7f1ff35ff1e0>,19,15,[ 1 10],20,-1,35,-1,20
1,<environment.Job instance at 0x7f1ff35ff500>,22,15,[1 6],23,-1,38,-1,23
1,<environment.Job instance at 0x7f1ff35ff820>,25,17,[7 1],26,-1,43,-1,26
1,<environment.Job instance at 0x7f1ff35ff910>,26,13,[11  1],27,-1,40,-1,27
1,<environment.Job instance at 0x7f1ff35ff7d0>,27,18,[1 7],28,-1,46,-1,28
1,<environment.Job instance at 0x7f1ff35ffaa0>,29,14,[10  1],30,-1,45,-1,31
1,<environment.Job instance at 0x7f1ff35ffbe0>,31,14,[10  4],32,-1,46,-1,32
1,<environment.Job instance at 0x7f1ff35ffc80>,32,18,[5 5],33,-1,51,-1,33
1,<environment.Job instance at 0x7f1ff35fffa0>,35,15,[7 4],36,-1,51,-1,36
1,<environment.Job instance at 0x7f1ff3623280>,38,21,[5 8],39,-1,60,-1,39
1,<environment.Job instance at 0x7f1ff3623460>,39,17,[7 2],40,-1,57,-1,40
1,<environment.Job instance at 0x7f1ff3623500>,41,28,[2 8],42,-1,70,-1,42
1,<environment.Job instance at 0x7f1ff3623690>,42,18,[5 1],43,-1,61,-1,43
1,<environment.Job instance at 0x7f1ff35ff960>,30,15,[1 6],31,-1,58,-1,43
1,<environment.Job instance at 0x7f1ff36236e0>,43,27,[9 3],44,-1,71,-1,44
1,<environment.Job instance at 0x7f1ff3101820>,59,17,[1 5],60,-1,82,-1,65
1,<environment.Job instance at 0x7f1ff311c230>,70,14,[6 4],71,-1,86,-1,72
1,<environment.Job instance at 0x7f1ff3623820>,46,28,[1 7],47,-1,102,-1,74
1,<environment.Job instance at 0x7f1ff352e5a0>,73,3,[6 2],74,-1,77,-1,74
1,<environment.Job instance at 0x7f1ff3623960>,50,3,[4 8],51,-1,77,-1,74
1,<environment.Job instance at 0x7f1ff353d6e0>,74,15,[9 1],75,-1,91,-1,76
1,<environment.Job instance at 0x7f1ff30e8460>,76,23,[7 4],77,-1,100,-1,77
1,<environment.Job instance at 0x7f1ff3101a00>,62,13,[4 8],63,-1,92,-1,79
1,<environment.Job instance at 0x7f1ff30e8dc0>,78,17,[5 5],79,-1,97,-1,80
1,<environment.Job instance at 0x7f1ff30e85a0>,80,15,[9 4],81,-1,96,-1,81
1,<environment.Job instance at 0x7f1ff30e8be0>,83,20,[5 4],84,-1,113,-1,93
1,<environment.Job instance at 0x7f1ff420c730>,90,16,[14  3],91,-1,109,-1,93
1,<environment.Job instance at 0x7f1ff3056aa0>,94,15,[10  3],95,-1,111,-1,96
1,<environment.Job instance at 0x7f1ff3acd7d0>,95,20,[4 7],96,-1,116,-1,96
1,<environment.Job instance at 0x7f1ff41fbcd0>,96,21,[6 5],97,-1,118,-1,97
1,<environment.Job instance at 0x7f1ff2d89c30>,92,14,[6 5],93,-1,112,-1,98
1,<environment.Job instance at 0x7f1ff311c140>,68,15,[ 3 11],69,-1,115,-1,100
1,<environment.Job instance at 0x7f1ff3b14e10>,99,17,[5 9],100,-1,117,-1,100
1,<environment.Job instance at 0x7f1ff4206a50>,101,27,[5 1],102,-1,134,-1,107
1,<environment.Job instance at 0x7f1ff4206d20>,103,17,[8 5],104,-1,126,-1,109
1,<environment.Job instance at 0x7f1ff4206870>,102,21,[1 6],103,-1,130,-1,109
1,<environment.Job instance at 0x7f1ff41eaaa0>,97,13,[9 4],98,-1,122,-1,109
1,<environment.Job instance at 0x7f1ff302ce60>,106,25,[8 3],107,-1,134,-1,109
1,<environment.Job instance at 0x7f1ff302caa0>,108,16,[ 5 10],109,-1,131,-1,115
1,<environment.Job instance at 0x7f1ff302c460>,109,18,[7 3],110,-1,133,-1,115
1,<environment.Job instance at 0x7f1ff302c1e0>,110,16,[9 2],111,-1,132,-1,116
1,<environment.Job instance at 0x7f1ff302c820>,111,19,[10  1],112,-1,135,-1,116
1,<environment.Job instance at 0x7f1ff302ca00>,116,25,[ 5 10],117,-1,146,-1,121
1,<environment.Job instance at 0x7f1ff3041550>,122,18,[5 9],123,-1,150,-1,132
1,<environment.Job instance at 0x7f1ff30415f0>,123,16,[6 5],124,-1,148,-1,132
1,<environment.Job instance at 0x7f1ff3041cd0>,127,17,[5 2],128,-1,149,-1,132
1,<environment.Job instance at 0x7f1ff3041eb0>,128,18,[1 9],129,-1,150,-1,132
1,<environment.Job instance at 0x7f1ff3041140>,130,15,[3 9],131,-1,156,-1,141
1,<environment.Job instance at 0x7f1ff3053a00>,134,17,[9 5],135,-1,158,-1,141
1,<environment.Job instance at 0x7f1ff3053820>,135,16,[5 3],136,-1,157,-1,141
1,<environment.Job instance at 0x7f1ff3053a50>,138,14,[9 4],139,-1,160,-1,146
1,<environment.Job instance at 0x7f1ff3053d20>,139,13,[3 6],140,-1,159,-1,146
1,<environment.Job instance at 0x7f1ff3053fa0>,140,26,[6 3],141,-1,172,-1,146
1,<environment.Job instance at 0x7f1ff3048280>,141,14,[4 6],142,-1,160,-1,146
1,<environment.Job instance at 0x7f1ff30485a0>,142,17,[ 2 11],143,-1,163,-1,146
1,<environment.Job instance at 0x7f1ff3048370>,145,23,[7 1],146,-1,169,-1,146
1,<environment.Job instance at 0x7f1ff4208e60>,147,17,[4 9],148,-1,167,-1,150
1,<environment.Job instance at 0x7f1ff3046eb0>,151,17,[10  4],152,-1,174,-1,157
1,<environment.Job instance at 0x7f1ff36065a0>,153,12,[ 1 14],154,-1,172,-1,160
1,<environment.Job instance at 0x7f1ff302c6e0>,107,13,[13  1],108,-1,173,-1,160
1,<environment.Job instance at 0x7f1ff36062d0>,154,14,[7 4],155,-1,176,-1,162
1,<environment.Job instance at 0x7f1ff33b7230>,155,18,[10  3],156,-1,183,-1,165
1,<environment.Job instance at 0x7f1ff303c320>,156,13,[13  3],157,-1,178,-1,165
1,<environment.Job instance at 0x7f1ff303c410>,157,18,[3 6],158,-1,183,-1,165
1,<environment.Job instance at 0x7f1ff3119640>,164,18,[4 7],165,-1,183,-1,165
1,<environment.Job instance at 0x7f1ff2d76eb0>,166,17,[5 5],167,-1,184,-1,167
1,<environment.Job instance at 0x7f1ff30f7c80>,172,17,[1 6],173,-1,196,-1,179
1,<environment.Job instance at 0x7f1ff30f7230>,173,16,[4 9],174,-1,195,-1,179
1,<environment.Job instance at 0x7f1ff33c3f00>,0,2,[ 5 11],1,-1,3,-1,1
1,<environment.Job instance at 0x7f1ff31010a0>,9,27,[ 5 10],10,-1,46,-1,19
1,<environment.Job instance at 0x7f1ff3108460>,26,13,[11  1],27,-1,68,-1,55
1,<environment.Job instance at 0x7f1ff2e5f7d0>,28,12,[ 5 12],29,-1,67,-1,55
1,<environment.Job instance at 0x7f1ff2e4dcd0>,41,28,[2 8],42,-1,150,-1,122
1,<environment.Job instance at 0x7f1ff2e4d1e0>,43,27,[9 3],44,-1,166,-1,139
1,<environment.Job instance at 0x7f1ff2e4d320>,46,28,[1 7],47,-1,167,-1,139
1,<environment.Job instance at 0x7f1ff2deb9b0>,49,2,[ 4 11],50,-1,149,-1,147
1,<environment.Job instance at 0x7f1ff2deb5a0>,54,3,[11  1],55,-1,155,-1,152
1,<environment.Job instance at 0x7f1ff2dae230>,56,28,[9 2],57,-1,184,-1,156
1,<environment.Job instance at 0x7f1ff2dcf140>,67,3,[ 1 12],68,-1,181,-1,178
1,<environment.Job instance at 0x7f1ff2db5aa0>,68,15,[ 3 11],69,-1,193,-1,178
1,<environment.Job instance at 0x7f1ff2dbc3c0>,75,15,[ 2 11],76,-1,213,-1,198
1,<environment.Job instance at 0x7f1ff2dba5f0>,76,23,[7 4],77,-1,224,-1,201
1,<environment.Job instance at 0x7f1ff2c87c80>,90,16,[14  3],91,-1,252,-1,236
1,<environment.Job instance at 0x7f1ff2f5a2d0>,101,27,[5 1],102,-1,299,-1,272
1,<environment.Job instance at 0x7f1ff2f82140>,106,25,[8 3],107,-1,316,-1,291
1,<environment.Job instance at 0x7f1ff2df30a0>,107,13,[13  1],108,-1,304,-1,291
1,<environment.Job instance at 0x7f1ff2e01fa0>,116,25,[ 5 10],117,-1,380,-1,355
1,<environment.Job instance at 0x7f1ff2e05320>,136,2,[13  5],137,-1,407,-1,405
1,<environment.Job instance at 0x7f1ff3241b40>,140,26,[6 3],141,-1,454,-1,428
1,<environment.Job instance at 0x7f1ffce2d550>,142,17,[ 2 11],143,-1,445,-1,428
1,<environment.Job instance at 0x7f1ff3b96b90>,145,23,[7 1],146,-1,458,-1,435
1,<environment.Job instance at 0x7f1ff3a0ab90>,153,12,[ 1 14],154,-1,468,-1,456
1,<environment.Job instance at 0x7f1ff35d58c0>,156,13,[13  3],157,-1,487,-1,474
1,<environment.Job instance at 0x7f1ff3b998c0>,158,1,[ 3 14],159,-1,485,-1,484
1,<environment.Job instance at 0x7f1ff3312190>,171,14,[ 3 14],172,-1,550,-1,536
1,<environment.Job instance at 0x7f1ff32f3690>,175,13,[ 1 12],176,-1,569,-1,556
1,<environment.Job instance at 0x7f1ff32f3780>,176,17,[11  2],177,-1,573,-1,556
1,<environment.Job instance at 0x7f1ff3454780>,0,28,[5 6],1,-1,29,-1,1
1,<environment.Job instance at 0x7f1ff3e87fa0>,4,17,[6 5],5,-1,23,-1,6
1,<environment.Job instance at 0x7f1ff2e5f0f0>,5,23,[5 3],6,-1,29,-1,6
1,<environment.Job instance at 0x7f1ff3e87f00>,7,16,[ 5 10],8,-1,27,-1,11
1,<environment.Job instance at 0x7f1ff3cafb40>,12,16,[9 4],13,-1,29,-1,13
1,<environment.Job instance at 0x7f1ff3cafc80>,16,15,[9 5],17,-1,34,-1,19
1,<environment.Job instance at 0x7f1ff3caff50>,18,15,[ 3 13],19,-1,43,-1,28
1,<environment.Job instance at 0x7f1ff3e870f0>,17,14,[4 7],18,-1,42,-1,28
1,<environment.Job instance at 0x7f1ff3cafbe0>,26,18,[ 3 13],27,-1,46,-1,28
1,<environment.Job instance at 0x7f1ff3ce9af0>,27,18,[10  5],28,-1,49,-1,31
1,<environment.Job instance at 0x7f1ff3cafa00>,23,18,[ 1 10],24,-1,49,-1,31
1,<environment.Job instance at 0x7f1ff41f76e0>,39,17,[9 4],40,-1,57,-1,40
1,<environment.Job instance at 0x7f1ff3ce94b0>,30,15,[ 4 10],31,-1,57,-1,42
1,<environment.Job instance at 0x7f1ff41f7370>,41,18,[4 8],42,-1,62,-1,44
1,<environment.Job instance at 0x7f1ff41f70a0>,43,15,[10  4],44,-1,62,-1,47
1,<environment.Job instance at 0x7f1ff3caf460>,22,17,[4 5],23,-1,67,-1,50
1,<environment.Job instance at 0x7f1ff41f7d70>,50,25,[2 8],51,-1,76,-1,51
1,<environment.Job instance at 0x7f1ff41f7f00>,46,15,[ 5 10],47,-1,66,-1,51
1,<environment.Job instance at 0x7f1ff41f73c0>,52,18,[9 4],53,-1,71,-1,53
1,<environment.Job instance at 0x7f1ff41f7230>,53,18,[ 4 10],54,-1,83,-1,65
1,<environment.Job instance at 0x7f1ff41c2280>,57,15,[ 5 10],58,-1,81,-1,66
1,<environment.Job instance at 0x7f1ff41c2410>,61,16,[ 4 10],62,-1,83,-1,67
1,<environment.Job instance at 0x7f1ff41c2140>,58,17,[5 7],59,-1,84,-1,67
1,<environment.Job instance at 0x7f1ff3ce99b0>,33,15,[7 2],34,-1,82,-1,67
1,<environment.Job instance at 0x7f1ff3caf640>,21,16,[ 2 10],22,-1,98,-1,82
1,<environment.Job instance at 0x7f1ff41c2e10>,65,16,[4 6],66,-1,98,-1,82
1,<environment.Job instance at 0x7f1ffcc08500>,69,16,[2 8],70,-1,98,-1,82
1,<environment.Job instance at 0x7f1ff41c2e60>,66,18,[9 4],67,-1,100,-1,82
1,<environment.Job instance at 0x7f1ff41c2d20>,64,15,[ 2 10],65,-1,97,-1,82
1,<environment.Job instance at 0x7f1ff3ea4500>,75,17,[7 4],76,-1,99,-1,82
1,<environment.Job instance at 0x7f1ffcc08050>,71,13,[2 8],72,-1,117,-1,104
1,<environment.Job instance at 0x7f1ff3ea4910>,84,17,[3 6],85,-1,122,-1,105
1,<environment.Job instance at 0x7f1ff3ea4af0>,83,17,[10  5],84,-1,125,-1,108
1,<environment.Job instance at 0x7f1ff3ea4e60>,87,16,[1 5],88,-1,124,-1,108
1,<environment.Job instance at 0x7f1ff3ea45a0>,85,18,[14  2],86,-1,126,-1,108
1,<environment.Job instance at 0x7f1ff3ea43c0>,76,18,[4 6],77,-1,129,-1,111
1,<environment.Job instance at 0x7f1ff3d00d70>,91,16,[2 7],92,-1,127,-1,111
1,<environment.Job instance at 0x7f1ff3d00a00>,94,13,[5 4],95,-1,124,-1,111
1,<environment.Job instance at 0x7f1ff3ea49b0>,74,20,[9 5],75,-1,132,-1,112
1,<environment.Job instance at 0x7f1ff3d00460>,95,15,[9 1],96,-1,127,-1,112
1,<environment.Job instance at 0x7f1ff3d00500>,92,15,[3 8],93,-1,127,-1,112
1,<environment.Job instance at 0x7f1ff3d00140>,97,25,[9 4],98,-1,139,-1,114
1,<environment.Job instance at 0x7f1ff355a820>,103,17,[6 4],104,-1,131,-1,114
1,<environment.Job instance at 0x7f1ff3d18f00>,102,17,[1 7],103,-1,131,-1,114
1,<environment.Job instance at 0x7f1ff3bf7690>,105,16,[1 6],106,-1,130,-1,114
1,<environment.Job instance at 0x7f1ff3a40fa0>,108,14,[5 4],109,-1,129,-1,115
1,<environment.Job instance at 0x7f1ff3bf75f0>,111,18,[9 3],112,-1,133,-1,115
1,<environment.Job instance at 0x7f1ff3d00b40>,93,13,[6 5],94,-1,129,-1,116
1,<environment.Job instance at 0x7f1ff3bf7af0>,106,16,[14  3],107,-1,135,-1,119
1,<environment.Job instance at 0x7f1ff36a58c0>,116,22,[ 4 10],117,-1,147,-1,125
1,<environment.Job instance at 0x7f1ff3d00af0>,100,16,[2 8],101,-1,142,-1,126
1,<environment.Job instance at 0x7f1ff41b2320>,114,25,[7 4],115,-1,151,-1,126
1,<environment.Job instance at 0x7f1ff36a5910>,118,16,[2 7],119,-1,145,-1,129
1,<environment.Job instance at 0x7f1ff32034b0>,122,18,[5 8],123,-1,147,-1,129
1,<environment.Job instance at 0x7f1ff343fbe0>,125,23,[8 2],126,-1,164,-1,141
1,<environment.Job instance at 0x7f1ff31c1870>,131,15,[9 5],132,-1,156,-1,141
1,<environment.Job instance at 0x7f1ff31c1f00>,130,16,[5 9],131,-1,171,-1,155
1,<environment.Job instance at 0x7f1ff3786550>,138,14,[8 1],139,-1,169,-1,155
1,<environment.Job instance at 0x7f1ff37868c0>,139,16,[ 4 10],140,-1,171,-1,155
1,<environment.Job instance at 0x7f1ff3786500>,140,18,[5 8],141,-1,176,-1,158
1,<environment.Job instance at 0x7f1ff3bfee10>,121,13,[ 3 10],122,-1,172,-1,159
1,<environment.Job instance at 0x7f1ff39af140>,142,23,[7 1],143,-1,183,-1,160
1,<environment.Job instance at 0x7f1ff31c15f0>,133,18,[ 2 11],134,-1,178,-1,160
1,<environment.Job instance at 0x7f1ff39afc30>,141,17,[3 7],142,-1,177,-1,160
1,<environment.Job instance at 0x7f1ff3d58640>,144,14,[10  1],145,-1,178,-1,164
1,<environment.Job instance at 0x7f1ff2c899b0>,151,15,[7 5],152,-1,179,-1,164
1,<environment.Job instance at 0x7f1ff3ea4be0>,73,18,[ 5 10],74,-1,182,-1,164
1,<environment.Job instance at 0x7f1ff2d7eb90>,152,13,[14  4],153,-1,177,-1,164
1,<environment.Job instance at 0x7f1ff2e6a7d0>,149,13,[ 2 10],150,-1,179,-1,166
1,<environment.Job instance at 0x7f1ff2d04320>,156,17,[9 3],157,-1,184,-1,167
1,<environment.Job instance at 0x7f1ff39e70f0>,160,15,[9 1],161,-1,182,-1,167
1,<environment.Job instance at 0x7f1ff39e7af0>,161,23,[ 3 13],162,-1,190,-1,167
1,<environment.Job instance at 0x7f1ff362f280>,159,15,[5 6],160,-1,182,-1,167
1,<environment.Job instance at 0x7f1ff39e7050>,163,16,[ 4 10],164,-1,183,-1,167
1,<environment.Job instance at 0x7f1ff31aec80>,164,18,[1 8],165,-1,185,-1,167
1,<environment.Job instance at 0x7f1ff39e70a0>,165,13,[4 7],166,-1,180,-1,167
1,<environment.Job instance at 0x7f1ff3caf320>,0,28,[5 6],1,-1,29,-1,1
1,<environment.Job instance at 0x7f1ff3ce95a0>,3,28,[ 1 11],4,-1,32,-1,4
1,<environment.Job instance at 0x7f1ff41f7b40>,5,23,[5 3],6,-1,29,-1,6
1,<environment.Job instance at 0x7f1ff41f7aa0>,6,14,[13  5],7,-1,21,-1,7
1,<environment.Job instance at 0x7f1ffcc08230>,10,13,[12  5],11,-1,24,-1,11
1,<environment.Job instance at 0x7f1ff32b7460>,18,15,[ 3 13],19,-1,39,-1,24
1,<environment.Job instance at 0x7f1ff3c2fdc0>,26,18,[ 3 13],27,-1,74,-1,56
1,<environment.Job instance at 0x7f1ff3312af0>,37,2,[ 4 14],38,-1,92,-1,90
1,<environment.Job instance at 0x7f1ff33f3370>,44,2,[ 1 12],45,-1,108,-1,106
1,<environment.Job instance at 0x7f1ff322e6e0>,50,25,[2 8],51,-1,165,-1,140
1,<environment.Job instance at 0x7f1ff32e3320>,54,3,[ 3 14],55,-1,156,-1,153
1,<environment.Job instance at 0x7f20040abe10>,59,2,[13  5],60,-1,182,-1,180
1,<environment.Job instance at 0x7f1ff2c92730>,68,1,[ 3 12],69,-1,221,-1,220
1,<environment.Job instance at 0x7f1ff2debb40>,85,18,[14  2],86,-1,323,-1,305
1,<environment.Job instance at 0x7f1ff2e4da50>,97,25,[9 4],98,-1,394,-1,369
1,<environment.Job instance at 0x7f1ff2e4dc30>,101,3,[ 4 12],102,-1,376,-1,373
1,<environment.Job instance at 0x7f1ff33cce10>,106,16,[14  3],107,-1,407,-1,391
1,<environment.Job instance at 0x7f1ff2e5fe10>,107,14,[12  5],108,-1,405,-1,391
1,<environment.Job instance at 0x7f1ff310cb40>,114,25,[7 4],115,-1,443,-1,418
1,<environment.Job instance at 0x7f1ff30b8f50>,125,23,[8 2],126,-1,486,-1,463
1,<environment.Job instance at 0x7f1ff33c3f00>,133,18,[ 2 11],134,-1,497,-1,479
1,<environment.Job instance at 0x7f1ff35ff3c0>,135,3,[11  2],136,-1,488,-1,485
1,<environment.Job instance at 0x7f1ff3c54820>,142,23,[7 1],143,-1,553,-1,530
1,<environment.Job instance at 0x7f1ff42c7960>,145,3,[13  2],146,-1,533,-1,530
1,<environment.Job instance at 0x7f1ff42c7140>,148,1,[13  4],149,-1,534,-1,533
1,<environment.Job instance at 0x7f1ff42c73c0>,152,13,[14  4],153,-1,563,-1,550
1,<environment.Job instance at 0x7f1ff3d00050>,161,23,[ 3 13],162,-1,609,-1,586
1,<environment.Job instance at 0x7f1ffcc01690>,1,18,[3 7],2,-1,20,-1,2
1,<environment.Job instance at 0x7f1ffcc01c80>,2,17,[1 9],3,-1,20,-1,3
1,<environment.Job instance at 0x7f1ff3e7e280>,4,22,[9 5],5,-1,27,-1,5
1,<environment.Job instance at 0x7f1ff3e7e960>,7,16,[5 8],8,-1,24,-1,8
1,<environment.Job instance at 0x7f1ff3e7ef50>,8,16,[1 6],9,-1,25,-1,9
1,<environment.Job instance at 0x7f1ff3e7e500>,13,15,[4 9],14,-1,30,-1,15
1,<environment.Job instance at 0x7f1ff41b2e10>,15,12,[ 3 10],16,-1,28,-1,16
1,<environment.Job instance at 0x7f1ff41b28c0>,16,12,[9 4],17,-1,29,-1,17
1,<environment.Job instance at 0x7f1ff41b2cd0>,18,12,[10  1],19,-1,31,-1,19
1,<environment.Job instance at 0x7f1ff41b2fa0>,19,21,[1 7],20,-1,41,-1,20
1,<environment.Job instance at 0x7f1ff41b2780>,20,16,[9 2],21,-1,37,-1,21
1,<environment.Job instance at 0x7f1ff431e960>,27,17,[8 2],28,-1,45,-1,28
1,<environment.Job instance at 0x7f1ff431e870>,28,17,[1 6],29,-1,46,-1,29
1,<environment.Job instance at 0x7f1ff431e500>,29,17,[9 2],30,-1,47,-1,30
1,<environment.Job instance at 0x7f1ff2ef6f00>,32,15,[2 9],33,-1,48,-1,33
1,<environment.Job instance at 0x7f1ff2ef6a00>,35,16,[11  3],36,-1,52,-1,36
1,<environment.Job instance at 0x7f1ff2ef6a50>,37,16,[3 5],38,-1,54,-1,38
1,<environment.Job instance at 0x7f1ff316b960>,40,13,[6 4],41,-1,54,-1,41
1,<environment.Job instance at 0x7f1ffcc01640>,14,14,[10  4],15,-1,56,-1,42
1,<environment.Job instance at 0x7f1ff316b370>,43,18,[ 2 10],44,-1,63,-1,45
1,<environment.Job instance at 0x7f1ff316baf0>,44,17,[8 3],45,-1,62,-1,45
1,<environment.Job instance at 0x7f1ffccee460>,47,17,[7 4],48,-1,66,-1,49
1,<environment.Job instance at 0x7f1ffccee5f0>,49,16,[10  5],50,-1,67,-1,51
1,<environment.Job instance at 0x7f1ff3176500>,51,16,[5 3],52,-1,68,-1,52
1,<environment.Job instance at 0x7f1ff3176050>,55,17,[ 2 10],56,-1,73,-1,56
1,<environment.Job instance at 0x7f1ff3176b90>,58,19,[7 1],59,-1,78,-1,59
1,<environment.Job instance at 0x7f1ff3176f00>,60,18,[9 2],61,-1,79,-1,61
1,<environment.Job instance at 0x7f1ff30b97d0>,76,13,[9 5],77,-1,92,-1,79
1,<environment.Job instance at 0x7f1ff30b9c30>,77,18,[6 2],78,-1,97,-1,79
1,<environment.Job instance at 0x7f1ff30b95f0>,78,14,[ 4 10],79,-1,93,-1,79
1,<environment.Job instance at 0x7f1ff31f6640>,79,13,[7 5],80,-1,94,-1,81
1,<environment.Job instance at 0x7f1ff31f61e0>,80,25,[ 1 14],81,-1,106,-1,81
1,<environment.Job instance at 0x7f1ff31f60f0>,81,14,[9 5],82,-1,96,-1,82
1,<environment.Job instance at 0x7f1ff31f6af0>,82,15,[7 3],83,-1,98,-1,83
1,<environment.Job instance at 0x7f1ffccee0a0>,48,15,[8 3],49,-1,104,-1,89
1,<environment.Job instance at 0x7f1ff3caec80>,70,27,[7 4],71,-1,117,-1,90
1,<environment.Job instance at 0x7f1ff30b91e0>,72,16,[10  2],73,-1,106,-1,90
1,<environment.Job instance at 0x7f1ff31f6f50>,89,15,[8 5],90,-1,105,-1,90
1,<environment.Job instance at 0x7f1ff31f6320>,91,13,[9 4],92,-1,140,-1,127
1,<environment.Job instance at 0x7f1ff3229b40>,107,22,[6 1],108,-1,149,-1,127
1,<environment.Job instance at 0x7f1ff31f6e10>,92,16,[1 7],93,-1,143,-1,127
1,<environment.Job instance at 0x7f1ff32290f0>,108,15,[7 1],109,-1,142,-1,127
1,<environment.Job instance at 0x7f1ff3229870>,110,12,[5 9],111,-1,139,-1,127
1,<environment.Job instance at 0x7f1ff3229780>,111,18,[5 9],112,-1,145,-1,127
1,<environment.Job instance at 0x7f1ffc892730>,115,17,[10  3],116,-1,146,-1,129
1,<environment.Job instance at 0x7f1ff3229550>,106,16,[4 9],107,-1,145,-1,129
1,<environment.Job instance at 0x7f1ffc892960>,117,16,[8 4],118,-1,145,-1,129
1,<environment.Job instance at 0x7f1ff4123aa0>,116,12,[7 5],117,-1,145,-1,133
1,<environment.Job instance at 0x7f1ff2bacd20>,121,14,[ 5 10],122,-1,148,-1,134
1,<environment.Job instance at 0x7f1ff3229eb0>,102,14,[9 3],103,-1,148,-1,134
1,<environment.Job instance at 0x7f1ff42312d0>,122,19,[8 3],123,-1,153,-1,134
1,<environment.Job instance at 0x7f1ffc8924b0>,124,17,[8 5],125,-1,161,-1,144
1,<environment.Job instance at 0x7f1ff41b2050>,22,17,[ 2 14],23,-1,161,-1,144
1,<environment.Job instance at 0x7f1ff2adb4b0>,126,23,[5 5],127,-1,167,-1,144
1,<environment.Job instance at 0x7f1ff2a04d20>,123,13,[8 3],124,-1,157,-1,144
1,<environment.Job instance at 0x7f1ff425a230>,129,25,[7 3],130,-1,170,-1,145
1,<environment.Job instance at 0x7f1ff2f67780>,130,1,[12  5],131,-1,146,-1,145
1,<environment.Job instance at 0x7f1ff2adb9b0>,128,14,[9 5],129,-1,160,-1,146
1,<environment.Job instance at 0x7f1ffc91d9b0>,133,17,[6 4],134,-1,163,-1,146
1,<environment.Job instance at 0x7f1ff2ad5c30>,134,17,[4 7],135,-1,164,-1,147
1,<environment.Job instance at 0x7f1ff31f6fa0>,84,19,[9 1],85,-1,166,-1,147
1,<environment.Job instance at 0x7f1ff3caeeb0>,68,15,[ 3 14],69,-1,162,-1,147
1,<environment.Job instance at 0x7f1ff3be77d0>,120,17,[8 4],121,-1,164,-1,147
1,<environment.Job instance at 0x7f1ff2dba320>,142,14,[10  1],143,-1,161,-1,147
1,<environment.Job instance at 0x7f1ff3229a00>,109,14,[3 8],110,-1,161,-1,147
1,<environment.Job instance at 0x7f1ff3070e60>,145,14,[5 7],146,-1,198,-1,184
1,<environment.Job instance at 0x7f1ff34f37d0>,152,19,[6 2],153,-1,203,-1,184
1,<environment.Job instance at 0x7f1ff34f3c30>,158,18,[ 4 10],159,-1,205,-1,187
1,<environment.Job instance at 0x7f1ff34f3b40>,157,18,[ 3 12],158,-1,242,-1,224
1,<environment.Job instance at 0x7f1ff34f3aa0>,156,17,[ 1 13],157,-1,249,-1,232
1,<environment.Job instance at 0x7f1ff2a18c80>,167,18,[5 5],168,-1,250,-1,232
1,<environment.Job instance at 0x7f1ff2a66af0>,173,18,[4 5],174,-1,250,-1,232
1,<environment.Job instance at 0x7f1ff33c4f00>,176,18,[3 9],177,-1,250,-1,232
1,<environment.Job instance at 0x7f1ff31760a0>,5,3,[ 1 14],6,-1,9,-1,6
1,<environment.Job instance at 0x7f1ff3229140>,10,13,[11  4],11,-1,31,-1,18
1,<environment.Job instance at 0x7f1ff34f3280>,11,12,[ 1 13],12,-1,30,-1,18
1,<environment.Job instance at 0x7f1ff3ea4370>,22,17,[ 2 14],23,-1,77,-1,60
1,<environment.Job instance at 0x7f1ff2f88460>,35,16,[11  3],36,-1,124,-1,108
1,<environment.Job instance at 0x7f1ff2fbfaf0>,46,1,[11  2],47,-1,131,-1,130
1,<environment.Job instance at 0x7f1ff2b56230>,67,14,[11  2],68,-1,225,-1,211
1,<environment.Job instance at 0x7f1ff2b56190>,68,15,[ 3 14],69,-1,226,-1,211
1,<environment.Job instance at 0x7f1ff2b56dc0>,70,27,[7 4],71,-1,241,-1,214
1,<environment.Job instance at 0x7f1ff38041e0>,75,2,[ 1 12],76,-1,228,-1,226
1,<environment.Job instance at 0x7f1ff37221e0>,80,25,[ 1 14],81,-1,278,-1,253
1,<environment.Job instance at 0x7f1ff2b5b910>,83,1,[ 4 13],84,-1,268,-1,267
1,<environment.Job instance at 0x7f1ff30bf4b0>,85,3,[ 4 11],86,-1,281,-1,278
1,<environment.Job instance at 0x7f1ff2a14960>,98,3,[11  1],99,-1,329,-1,326
1,<environment.Job instance at 0x7f1ff2b52f00>,126,23,[5 5],127,-1,469,-1,446
1,<environment.Job instance at 0x7f1ffc84a230>,129,25,[7 3],130,-1,490,-1,465
1,<environment.Job instance at 0x7f1ffc84a4b0>,130,1,[12  5],131,-1,466,-1,465
1,<environment.Job instance at 0x7f1ff2c08dc0>,141,3,[ 3 11],142,-1,506,-1,503
1,<environment.Job instance at 0x7f1ff2c72320>,155,3,[14  4],156,-1,575,-1,572
1,<environment.Job instance at 0x7f1ff2ab1460>,156,17,[ 1 13],157,-1,589,-1,572
1,<environment.Job instance at 0x7f1ff2ab17d0>,157,18,[ 3 12],158,-1,590,-1,572
1,<environment.Job instance at 0x7f1ff2f7a1e0>,161,2,[11  4],162,-1,585,-1,583
1,<environment.Job instance at 0x7f1ff2ad6a50>,168,22,[ 1 13],169,-1,635,-1,613
1,<environment.Job instance at 0x7f1ff2c6d0a0>,5,16,[6 5],6,-1,22,-1,6
1,<environment.Job instance at 0x7f1ff2c6d3c0>,6,12,[ 1 10],7,-1,20,-1,8
1,<environment.Job instance at 0x7f1ff2c6d730>,7,18,[9 4],8,-1,26,-1,8
1,<environment.Job instance at 0x7f1ff2c6d4b0>,8,15,[1 8],9,-1,28,-1,13
1,<environment.Job instance at 0x7f1ffce3e730>,19,18,[1 9],20,-1,38,-1,20
1,<environment.Job instance at 0x7f1ff2c6d780>,10,15,[5 1],11,-1,39,-1,24
1,<environment.Job instance at 0x7f1ffce3ecd0>,26,14,[7 5],27,-1,42,-1,28
1,<environment.Job instance at 0x7f1ffce3edc0>,24,17,[3 7],25,-1,45,-1,28
1,<environment.Job instance at 0x7f1ff31d2230>,29,18,[2 9],30,-1,48,-1,30
1,<environment.Job instance at 0x7f1ff31d26e0>,30,18,[5 5],31,-1,50,-1,32
1,<environment.Job instance at 0x7f1ff31d2f00>,33,18,[5 2],34,-1,52,-1,34
1,<environment.Job instance at 0x7f1ff31d2c30>,34,16,[7 5],35,-1,51,-1,35
1,<environment.Job instance at 0x7f1ffce3e3c0>,23,14,[4 8],24,-1,57,-1,43
1,<environment.Job instance at 0x7f1ff30811e0>,41,13,[9 1],42,-1,56,-1,43
1,<environment.Job instance at 0x7f1ff3081e10>,44,15,[10  2],45,-1,60,-1,45
1,<environment.Job instance at 0x7f1ff30819b0>,45,20,[10  3],46,-1,67,-1,47
1,<environment.Job instance at 0x7f1ff3dfc2d0>,52,18,[9 2],53,-1,72,-1,54
1,<environment.Job instance at 0x7f1ff3dfc230>,54,14,[5 9],55,-1,69,-1,55
1,<environment.Job instance at 0x7f1ff41d3410>,57,23,[6 1],58,-1,89,-1,66
1,<environment.Job instance at 0x7f1ff31d2730>,31,14,[ 1 10],32,-1,80,-1,66
1,<environment.Job instance at 0x7f1ff403faa0>,64,2,[9 2],65,-1,68,-1,66
1,<environment.Job instance at 0x7f1ff41d3f50>,62,17,[5 1],63,-1,83,-1,66
1,<environment.Job instance at 0x7f1ff403f230>,66,18,[ 2 10],67,-1,86,-1,68
1,<environment.Job instance at 0x7f1ff403f1e0>,65,12,[8 3],66,-1,80,-1,68
1,<environment.Job instance at 0x7f1ff403f280>,68,14,[9 5],69,-1,83,-1,69
1,<environment.Job instance at 0x7f1ff403f370>,69,14,[8 5],70,-1,85,-1,71
1,<environment.Job instance at 0x7f1ff403feb0>,70,25,[9 4],71,-1,96,-1,71
1,<environment.Job instance at 0x7f1ff403f320>,71,15,[7 3],72,-1,88,-1,73
1,<environment.Job instance at 0x7f1ff2ce6e10>,78,26,[4 9],79,-1,105,-1,79
1,<environment.Job instance at 0x7f1ff403fd70>,67,17,[5 5],68,-1,99,-1,82
1,<environment.Job instance at 0x7f1ff2ce60f0>,80,18,[5 4],81,-1,100,-1,82
1,<environment.Job instance at 0x7f1ff403f910>,74,28,[ 5 10],75,-1,110,-1,82
1,<environment.Job instance at 0x7f1ff2ce65f0>,84,16,[8 1],85,-1,101,-1,85
1,<environment.Job instance at 0x7f1ff2ce6190>,86,16,[ 5 12],87,-1,115,-1,99
1,<environment.Job instance at 0x7f1ff2e79f50>,92,22,[5 4],93,-1,123,-1,101
1,<environment.Job instance at 0x7f1ff2ce6230>,88,19,[2 7],89,-1,120,-1,101
1,<environment.Job instance at 0x7f1ff2ce6af0>,77,27,[2 9],78,-1,129,-1,102
1,<environment.Job instance at 0x7f1ff2e79eb0>,94,13,[5 8],95,-1,117,-1,104
1,<environment.Job instance at 0x7f1ff3da6cd0>,99,13,[4 8],100,-1,117,-1,104
1,<environment.Job instance at 0x7f1ff3da6e10>,100,17,[10  1],101,-1,121,-1,104
1,<environment.Job instance at 0x7f1ff3e2d190>,101,16,[2 5],102,-1,120,-1,104
1,<environment.Job instance at 0x7f1ff3cb44b0>,102,15,[2 5],103,-1,119,-1,104
1,<environment.Job instance at 0x7f1ff3da6fa0>,103,16,[1 5],104,-1,120,-1,104
1,<environment.Job instance at 0x7f1ff418b370>,105,15,[5 4],106,-1,121,-1,106
1,<environment.Job instance at 0x7f1ff418b4b0>,107,26,[10  5],108,-1,134,-1,108
1,<environment.Job instance at 0x7f1ff2e79f00>,95,13,[5 5],96,-1,121,-1,108
1,<environment.Job instance at 0x7f1ff418b280>,109,16,[5 6],110,-1,127,-1,111
1,<environment.Job instance at 0x7f1ff3dae0f0>,111,18,[4 9],112,-1,131,-1,113
1,<environment.Job instance at 0x7f1ffca944b0>,115,14,[ 3 10],116,-1,138,-1,124
1,<environment.Job instance at 0x7f1ff418bf50>,110,18,[4 5],111,-1,156,-1,138
1,<environment.Job instance at 0x7f1ff2d26e10>,124,22,[1 8],125,-1,161,-1,139
1,<environment.Job instance at 0x7f1ff32e8d20>,125,18,[ 2 10],126,-1,157,-1,139
1,<environment.Job instance at 0x7f1ff2ad8730>,128,13,[14  3],129,-1,164,-1,151
1,<environment.Job instance at 0x7f1ff30f5460>,130,16,[4 8],131,-1,195,-1,179
1,<environment.Job instance at 0x7f1ff3c9e230>,135,15,[8 3],136,-1,194,-1,179
1,<environment.Job instance at 0x7f1ff418be10>,106,17,[ 2 14],107,-1,197,-1,180
1,<environment.Job instance at 0x7f1ff3c9eaf0>,134,15,[5 3],135,-1,199,-1,184
1,<environment.Job instance at 0x7f1ff3c9ea00>,133,17,[ 4 10],134,-1,201,-1,184
1,<environment.Job instance at 0x7f1ff40ffc30>,144,15,[4 7],145,-1,199,-1,184
1,<environment.Job instance at 0x7f1ff3da60a0>,98,17,[7 5],99,-1,201,-1,184
1,<environment.Job instance at 0x7f1ff40ffa50>,142,22,[5 3],143,-1,206,-1,184
1,<environment.Job instance at 0x7f1ff40ff7d0>,147,24,[2 8],148,-1,208,-1,184
1,<environment.Job instance at 0x7f1ff3a83eb0>,151,16,[4 9],152,-1,200,-1,184
1,<environment.Job instance at 0x7f1ff2b16af0>,152,15,[1 6],153,-1,199,-1,184
1,<environment.Job instance at 0x7f1ff379a190>,154,13,[1 9],155,-1,197,-1,184
1,<environment.Job instance at 0x7f1ff2a56280>,155,12,[5 2],156,-1,196,-1,184
1,<environment.Job instance at 0x7f1ff40ffe10>,140,13,[10  5],141,-1,197,-1,184
1,<environment.Job instance at 0x7f1ff3a83870>,153,26,[1 8],154,-1,232,-1,206
1,<environment.Job instance at 0x7f1ff39ed690>,161,23,[9 4],162,-1,229,-1,206
1,<environment.Job instance at 0x7f1ff2adbeb0>,166,16,[9 3],167,-1,222,-1,206
1,<environment.Job instance at 0x7f1ff40ff0a0>,137,12,[9 2],138,-1,221,-1,209
1,<environment.Job instance at 0x7f1ff3ce0c80>,170,17,[4 7],171,-1,226,-1,209
1,<environment.Job instance at 0x7f1ff39edfa0>,159,15,[ 1 14],160,-1,234,-1,219
1,<environment.Job instance at 0x7f1ff3ce0c30>,172,14,[6 3],173,-1,233,-1,219
1,<environment.Job instance at 0x7f1ff3d06cd0>,177,17,[4 6],178,-1,239,-1,222
1,<environment.Job instance at 0x7f1ffce3e960>,2,13,[14  2],3,-1,16,-1,3
1,<environment.Job instance at 0x7f1ff2ce61e0>,20,2,[ 4 14],21,-1,46,-1,44
1,<environment.Job instance at 0x7f1ff35c5780>,43,17,[14  2],44,-1,157,-1,140
1,<environment.Job instance at 0x7f1ff2c08050>,56,2,[ 5 12],57,-1,164,-1,162
1,<environment.Job instance at 0x7f1ff2c081e0>,57,23,[6 1],58,-1,188,-1,165
1,<environment.Job instance at 0x7f1ffc84ac30>,70,25,[9 4],71,-1,243,-1,218
1,<environment.Job instance at 0x7f1ff2be5910>,74,28,[ 5 10],75,-1,263,-1,235
1,<environment.Job instance at 0x7f1ff2ad8e10>,77,27,[2 9],78,-1,263,-1,236
1,<environment.Job instance at 0x7f1ff3e1da50>,78,26,[4 9],79,-1,262,-1,236
1,<environment.Job instance at 0x7f1ff2cfbbe0>,86,16,[ 5 12],87,-1,285,-1,269
1,<environment.Job instance at 0x7f1ff2cf5a00>,106,17,[ 2 14],107,-1,350,-1,333
1,<environment.Job instance at 0x7f1ffca220a0>,107,26,[10  5],108,-1,361,-1,335
1,<environment.Job instance at 0x7f1ff2c20e10>,123,23,[1 7],124,-1,418,-1,395
1,<environment.Job instance at 0x7f1ffca9b370>,128,13,[14  3],129,-1,408,-1,395
1,<environment.Job instance at 0x7f1ff3229320>,132,26,[1 5],133,-1,441,-1,415
1,<environment.Job instance at 0x7f1ff3992af0>,147,24,[2 8],148,-1,502,-1,478
1,<environment.Job instance at 0x7f1ff39925a0>,149,13,[14  2],150,-1,491,-1,478
1,<environment.Job instance at 0x7f1ff39928c0>,153,26,[1 8],154,-1,513,-1,487
1,<environment.Job instance at 0x7f1ff2e79fa0>,159,15,[ 1 14],160,-1,525,-1,510
1,<environment.Job instance at 0x7f1ff2e79730>,161,23,[9 4],162,-1,535,-1,512
1,<environment.Job instance at 0x7f1ff3cedc80>,0,18,[3 6],1,-1,19,-1,1
1,<environment.Job instance at 0x7f1ff2b382d0>,2,16,[1 9],3,-1,20,-1,4
1,<environment.Job instance at 0x7f1ff2b38370>,4,12,[10  3],5,-1,17,-1,5
1,<environment.Job instance at 0x7f1ff2b385a0>,6,16,[2 7],7,-1,23,-1,7
1,<environment.Job instance at 0x7f1ff2b386e0>,7,13,[7 1],8,-1,21,-1,8
1,<environment.Job instance at 0x7f1ff2b38460>,8,1,[8 3],9,-1,10,-1,9
1,<environment.Job instance at 0x7f1ff2b387d0>,9,12,[4 8],10,-1,22,-1,10
1,<environment.Job instance at 0x7f1ff2b38870>,10,14,[1 9],11,-1,25,-1,11
1,<environment.Job instance at 0x7f1ff2b389b0>,12,12,[1 7],13,-1,25,-1,13
1,<environment.Job instance at 0x7f1ff2b38b40>,14,17,[10  5],15,-1,32,-1,15
1,<environment.Job instance at 0x7f1ff2b38c80>,15,15,[1 6],16,-1,31,-1,16
1,<environment.Job instance at 0x7f1ff2b38d70>,17,16,[11  5],18,-1,34,-1,18
1,<environment.Job instance at 0x7f1ff2b38eb0>,18,13,[3 6],19,-1,32,-1,19
1,<environment.Job instance at 0x7f1ff2b38f00>,19,3,[10  4],20,-1,23,-1,20
1,<environment.Job instance at 0x7f1ff2b38fa0>,20,14,[3 5],21,-1,35,-1,21
1,<environment.Job instance at 0x7f1ff2ad6730>,3,13,[6 4],4,-1,34,-1,21
1,<environment.Job instance at 0x7f1ff2b34460>,25,17,[ 5 10],26,-1,44,-1,27
1,<environment.Job instance at 0x7f1ff2b34640>,28,12,[6 1],29,-1,41,-1,29
1,<environment.Job instance at 0x7f1ff2b343c0>,26,12,[5 6],27,-1,42,-1,30
1,<environment.Job instance at 0x7f1ff2b34c80>,33,16,[9 5],34,-1,50,-1,34
1,<environment.Job instance at 0x7f1ff2b34cd0>,34,16,[8 5],35,-1,51,-1,35
1,<environment.Job instance at 0x7f1ff2b34f00>,37,14,[ 5 10],38,-1,52,-1,38
1,<environment.Job instance at 0x7f1ff2b51640>,42,16,[9 3],43,-1,59,-1,43
1,<environment.Job instance at 0x7f1ff2b51730>,43,14,[1 6],44,-1,58,-1,44
1,<environment.Job instance at 0x7f1ff2b515f0>,44,16,[7 3],45,-1,61,-1,45
1,<environment.Job instance at 0x7f1ff2b51820>,45,22,[5 2],46,-1,68,-1,46
1,<environment.Job instance at 0x7f1ff2b51a00>,48,13,[5 7],49,-1,65,-1,52
1,<environment.Job instance at 0x7f1ff2b51cd0>,50,13,[11  3],51,-1,65,-1,52
1,<environment.Job instance at 0x7f1ff2b51f00>,52,14,[6 1],53,-1,67,-1,53
1,<environment.Job instance at 0x7f1ff2b51c80>,51,28,[7 5],52,-1,81,-1,53
1,<environment.Job instance at 0x7f1ff2b51fa0>,54,26,[7 1],55,-1,81,-1,55
1,<environment.Job instance at 0x7f1ff2b5f140>,55,18,[10  4],56,-1,74,-1,56
1,<environment.Job instance at 0x7f1ff2b5f820>,61,18,[4 9],62,-1,80,-1,62
1,<environment.Job instance at 0x7f1ff2b5f8c0>,62,18,[3 6],63,-1,81,-1,63
1,<environment.Job instance at 0x7f1ff2b5faf0>,65,16,[2 7],66,-1,83,-1,67
1,<environment.Job instance at 0x7f1ff2b5fb40>,68,18,[8 3],69,-1,88,-1,70
1,<environment.Job instance at 0x7f1ff323e140>,72,15,[ 2 10],73,-1,88,-1,73
1,<environment.Job instance at 0x7f1ff323e1e0>,74,17,[10  3],75,-1,92,-1,75
1,<environment.Job instance at 0x7f1ff323e5a0>,77,18,[6 4],78,-1,96,-1,78
1,<environment.Job instance at 0x7f1ff324a9b0>,17,16,[11  5],18,-1,64,-1,48
1,<environment.Job instance at 0x7f1ff3258640>,21,3,[13  1],22,-1,68,-1,65
1,<environment.Job instance at 0x7f1ff2e79730>,35,1,[ 3 12],36,-1,115,-1,114
1,<environment.Job instance at 0x7f1ff2e796e0>,38,3,[ 5 12],39,-1,122,-1,119
1,<environment.Job instance at 0x7f1ff3992190>,46,1,[11  1],47,-1,161,-1,160
1,<environment.Job instance at 0x7f1ff39925f0>,50,13,[11  3],51,-1,186,-1,173
1,<environment.Job instance at 0x7f1ff3992820>,51,28,[7 5],52,-1,202,-1,174
1,<environment.Job instance at 0x7f1ff3ab0dc0>,53,2,[14  5],54,-1,176,-1,174
1,<environment.Job instance at 0x7f1ff3ab0c80>,54,26,[7 1],55,-1,202,-1,176
1,<environment.Job instance at 0x7f1ff3229960>,67,13,[13  4],68,-1,229,-1,216
1,<environment.Job instance at 0x7f1ff3ec2820>,71,3,[ 4 12],72,-1,244,-1,241
1,<environment.Job instance at 0x7f1ffcd493c0>,70,24,[10  5],71,-1,283,-1,259
1,<environment.Job instance at 0x7f1ff2bda8c0>,75,18,[ 2 11],76,-1,277,-1,259
1,<environment.Job instance at 0x7f1ff2fbfaf0>,76,13,[11  3],77,-1,272,-1,259
1,<environment.Job instance at 0x7f1ff2cee190>,78,27,[5 1],79,-1,303,-1,276
1,<environment.Job instance at 0x7f1ff2cf5c30>,88,27,[1 7],89,-1,325,-1,298
1,<environment.Job instance at 0x7f1ff37cb3c0>,89,16,[12  5],90,-1,314,-1,298
1,<environment.Job instance at 0x7f1ff4091a50>,96,1,[14  4],97,-1,317,-1,316
1,<environment.Job instance at 0x7f1ff4091690>,97,17,[13  5],98,-1,333,-1,316
1,<environment.Job instance at 0x7f1ff2c08500>,128,25,[5 5],129,-1,487,-1,462
1,<environment.Job instance at 0x7f1ff2c08050>,130,18,[14  5],131,-1,480,-1,462
1,<environment.Job instance at 0x7f1ff2c080f0>,131,15,[ 1 12],132,-1,477,-1,462
1,<environment.Job instance at 0x7f1ff3d06460>,152,17,[ 3 14],153,-1,583,-1,566
1,<environment.Job instance at 0x7f1ff379a2d0>,155,16,[ 4 12],156,-1,586,-1,570
1,<environment.Job instance at 0x7f1ff32e8550>,158,18,[13  3],159,-1,594,-1,576
1,<environment.Job instance at 0x7f1ff418b140>,159,1,[ 4 14],160,-1,577,-1,576
1,<environment.Job instance at 0x7f1ff2ce60a0>,162,16,[14  1],163,-1,598,-1,582
1,<environment.Job instance at 0x7f1ff403f8c0>,165,1,[ 5 13],166,-1,587,-1,586
1,<environment.Job instance at 0x7f1ff3dfcf50>,170,3,[ 5 11],174,-1,604,-1,601
1,<environment.Job instance at 0x7f1ff32d37d0>,10,12,[10  4],11,-1,25,-1,13
1,<environment.Job instance at 0x7f1ff32dcf00>,14,26,[10  2],15,-1,41,-1,15
1,<environment.Job instance at 0x7f1ff4258c30>,12,18,[ 5 10],13,-1,33,-1,15
1,<environment.Job instance at 0x7f1ff32d2eb0>,16,16,[ 5 10],17,-1,34,-1,18
1,<environment.Job instance at 0x7f1ff32d2b90>,17,12,[6 2],18,-1,33,-1,21
1,<environment.Job instance at 0x7f1ff3a2da50>,24,12,[3 9],25,-1,38,-1,26
1,<environment.Job instance at 0x7f1ff32a9c80>,33,15,[8 4],34,-1,60,-1,45
1,<environment.Job instance at 0x7f1ff3e91f50>,44,14,[10  4],45,-1,59,-1,45
1,<environment.Job instance at 0x7f1ff3e91e10>,45,17,[4 9],46,-1,65,-1,48
1,<environment.Job instance at 0x7f1ff3dd5500>,50,13,[10  1],51,-1,87,-1,74
1,<environment.Job instance at 0x7f1ff3855140>,53,25,[9 3],54,-1,99,-1,74
1,<environment.Job instance at 0x7f1ff3e918c0>,43,21,[5 7],44,-1,95,-1,74
1,<environment.Job instance at 0x7f1ff38551e0>,56,19,[9 4],57,-1,93,-1,74
1,<environment.Job instance at 0x7f1ff3e610a0>,57,18,[4 7],58,-1,92,-1,74
1,<environment.Job instance at 0x7f1ff3942190>,60,26,[9 4],61,-1,100,-1,74
1,<environment.Job instance at 0x7f1ff3942050>,61,14,[2 7],62,-1,89,-1,75
1,<environment.Job instance at 0x7f1ff3855910>,52,19,[4 7],53,-1,94,-1,75
1,<environment.Job instance at 0x7f1ff3e82780>,68,24,[8 3],69,-1,104,-1,80
1,<environment.Job instance at 0x7f1ff3e82b40>,66,16,[5 2],67,-1,96,-1,80
1,<environment.Job instance at 0x7f1ff3e86550>,51,16,[5 7],52,-1,96,-1,80
1,<environment.Job instance at 0x7f1ff3e97eb0>,74,17,[9 5],75,-1,98,-1,81
1,<environment.Job instance at 0x7f1ff3e82960>,65,14,[13  2],66,-1,96,-1,82
1,<environment.Job instance at 0x7f1ff3e042d0>,49,27,[ 5 11],50,-1,109,-1,82
1,<environment.Job instance at 0x7f1ff3da69b0>,72,15,[ 3 10],73,-1,97,-1,82
1,<environment.Job instance at 0x7f1ff3e97f00>,79,19,[2 9],80,-1,110,-1,91
1,<environment.Job instance at 0x7f1ff3e97b40>,75,14,[2 9],76,-1,105,-1,91
1,<environment.Job instance at 0x7f1ff3e975f0>,80,22,[1 9],81,-1,114,-1,92
1,<environment.Job instance at 0x7f1ff3a651e0>,84,13,[10  5],85,-1,105,-1,92
1,<environment.Job instance at 0x7f1ff2ddf2d0>,89,17,[8 4],90,-1,115,-1,98
1,<environment.Job instance at 0x7f1ff387c1e0>,1,3,[ 3 11],2,-1,5,-1,2
1,<environment.Job instance at 0x7f1ff3a48c30>,8,18,[ 4 12],9,-1,27,-1,9
1,<environment.Job instance at 0x7f1ff3a7d320>,14,26,[10  2],15,-1,50,-1,24
1,<environment.Job instance at 0x7f1ff3964550>,27,15,[13  3],28,-1,54,-1,39
1,<environment.Job instance at 0x7f1ff3a2dd70>,41,2,[ 2 13],42,-1,72,-1,70
1,<environment.Job instance at 0x7f1ff32c6280>,48,2,[12  1],49,-1,98,-1,96
1,<environment.Job instance at 0x7f1ff3e91aa0>,49,27,[ 5 11],50,-1,123,-1,96
1,<environment.Job instance at 0x7f1ff343f0f0>,53,25,[9 3],54,-1,136,-1,111
1,<environment.Job instance at 0x7f1ff37facd0>,58,17,[ 2 12],59,-1,132,-1,115
1,<environment.Job instance at 0x7f1ff2e79dc0>,60,26,[9 4],61,-1,153,-1,127
1,<environment.Job instance at 0x7f1ff2e79fa0>,65,14,[13  2],66,-1,155,-1,141
1,<environment.Job instance at 0x7f1ff3258be0>,68,24,[8 3],69,-1,182,-1,158
1,<environment.Job instance at 0x7f1ff2b446e0>,88,2,[ 4 12],89,-1,230,-1,228
1,<environment.Job instance at 0x7f1ff3d16410>,93,26,[2 9],94,-1,285,-1,259
1,<environment.Job instance at 0x7f1ff35efdc0>,96,13,[12  4],97,-1,272,-1,259
1,<environment.Job instance at 0x7f1ff2a7aa00>,101,17,[13  5],102,-1,292,-1,275
1,<environment.Job instance at 0x7f1ff3759e10>,129,23,[5 5],130,-1,405,-1,382
1,<environment.Job instance at 0x7f1ff3044be0>,135,24,[7 5],136,-1,445,-1,421
1,<environment.Job instance at 0x7f1ff3044cd0>,137,3,[ 2 13],138,-1,424,-1,421
1,<environment.Job instance at 0x7f1ff2edafa0>,150,1,[13  2],151,-1,473,-1,472
1,<environment.Job instance at 0x7f1ff2eda690>,153,1,[ 2 13],154,-1,476,-1,475
1,<environment.Job instance at 0x7f1ff2eda8c0>,156,1,[ 4 11],157,-1,492,-1,491
1,<environment.Job instance at 0x7f1ff376d320>,161,23,[7 5],162,-1,532,-1,509
1,<environment.Job instance at 0x7f1ff3206cd0>,162,28,[8 2],163,-1,537,-1,509
1,<environment.Job instance at 0x7f1ff3112a50>,3,18,[4 9],4,-1,22,-1,4
1,<environment.Job instance at 0x7f1ff2e21a50>,4,26,[7 4],5,-1,31,-1,5
1,<environment.Job instance at 0x7f1ff2ab26e0>,8,16,[1 8],9,-1,26,-1,10
1,<environment.Job instance at 0x7f1ff2ab2e10>,11,13,[5 5],12,-1,25,-1,12
1,<environment.Job instance at 0x7f1ff376a370>,9,12,[9 3],10,-1,24,-1,12
1,<environment.Job instance at 0x7f1ff3752370>,14,17,[10  4],15,-1,36,-1,19
1,<environment.Job instance at 0x7f1ff3d40eb0>,18,16,[14  5],19,-1,35,-1,19
1,<environment.Job instance at 0x7f1ff37a40f0>,21,16,[8 1],22,-1,39,-1,23
1,<environment.Job instance at 0x7f1ff3d3cbe0>,27,19,[4 7],28,-1,47,-1,28
1,<environment.Job instance at 0x7f1ff29b15f0>,30,17,[2 8],31,-1,48,-1,31
1,<environment.Job instance at 0x7f1ff3d3feb0>,32,12,[10  3],33,-1,47,-1,35
1,<environment.Job instance at 0x7f1ff3d28aa0>,36,12,[1 9],37,-1,49,-1,37
1,<environment.Job instance at 0x7f1ff3d28d20>,37,18,[7 1],38,-1,56,-1,38
1,<environment.Job instance at 0x7f1ff3796320>,38,16,[10  3],39,-1,55,-1,39
1,<environment.Job instance at 0x7f1ff3796d70>,39,15,[9 3],40,-1,55,-1,40
1,<environment.Job instance at 0x7f1ff3d1ae10>,42,22,[6 2],43,-1,65,-1,43
1,<environment.Job instance at 0x7f1ff3d1a910>,43,16,[4 9],44,-1,60,-1,44
1,<environment.Job instance at 0x7f1ff3d1ac30>,44,23,[6 5],45,-1,68,-1,45
1,<environment.Job instance at 0x7f1ff3d19320>,48,12,[ 3 10],49,-1,61,-1,49
1,<environment.Job instance at 0x7f1ff3d199b0>,52,17,[1 6],53,-1,70,-1,53
1,<environment.Job instance at 0x7f1ff3d190f0>,53,21,[7 4],54,-1,75,-1,54
1,<environment.Job instance at 0x7f1ff333e4b0>,55,15,[ 5 11],56,-1,71,-1,56
1,<environment.Job instance at 0x7f1ff333e9b0>,60,26,[5 7],61,-1,87,-1,61
1,<environment.Job instance at 0x7f1ff333eaf0>,61,16,[ 2 10],62,-1,80,-1,64
1,<environment.Job instance at 0x7f1ff333ef50>,64,20,[5 9],65,-1,85,-1,65
1,<environment.Job instance at 0x7f1ff334f190>,67,15,[1 7],68,-1,83,-1,68
1,<environment.Job instance at 0x7f1ff334f140>,68,18,[5 6],69,-1,87,-1,69
1,<environment.Job instance at 0x7f1ff334f280>,69,27,[5 9],70,-1,97,-1,70
1,<environment.Job instance at 0x7f1ff334f690>,74,16,[5 6],75,-1,91,-1,75
1,<environment.Job instance at 0x7f1ff334f870>,75,16,[10  2],76,-1,94,-1,78
1,<environment.Job instance at 0x7f1ff334fc80>,79,12,[ 5 10],80,-1,93,-1,81
1,<environment.Job instance at 0x7f1ff334fd70>,81,2,[10  5],82,-1,84,-1,82
1,<environment.Job instance at 0x7f1ff334fbe0>,80,20,[5 8],81,-1,103,-1,83
1,<environment.Job instance at 0x7f1ff3331280>,86,18,[3 5],87,-1,105,-1,87
1,<environment.Job instance at 0x7f1ff3331500>,87,14,[8 3],88,-1,103,-1,89
1,<environment.Job instance at 0x7f1ff3331690>,90,21,[5 2],91,-1,112,-1,91
1,<environment.Job instance at 0x7f1ff3331910>,92,16,[11  5],93,-1,109,-1,93
1,<environment.Job instance at 0x7f1ff33319b0>,94,18,[3 8],95,-1,114,-1,96
1,<environment.Job instance at 0x7f1ff3331cd0>,96,14,[3 9],97,-1,111,-1,97
1,<environment.Job instance at 0x7f1ff334f7d0>,73,28,[3 5],74,-1,130,-1,102
1,<environment.Job instance at 0x7f1ff334e0a0>,101,17,[2 9],102,-1,119,-1,102
1,<environment.Job instance at 0x7f1ff334eeb0>,114,18,[6 3],115,-1,138,-1,120
1,<environment.Job instance at 0x7f1ff332f190>,115,23,[7 4],116,-1,143,-1,120
1,<environment.Job instance at 0x7f1ff332f140>,116,23,[5 6],117,-1,144,-1,121
1,<environment.Job instance at 0x7f1ff332f5f0>,121,12,[ 5 11],122,-1,174,-1,162
1,<environment.Job instance at 0x7f1ff332f550>,122,18,[9 5],123,-1,182,-1,164
1,<environment.Job instance at 0x7f1ff332f1e0>,118,25,[ 5 10],119,-1,189,-1,164
1,<environment.Job instance at 0x7f1ff332f690>,123,17,[5 1],124,-1,181,-1,164
1,<environment.Job instance at 0x7f1ff332f7d0>,125,15,[9 5],126,-1,179,-1,164
1,<environment.Job instance at 0x7f1ff332f370>,117,16,[2 6],118,-1,180,-1,164
1,<environment.Job instance at 0x7f1ff332f910>,127,26,[ 2 10],128,-1,190,-1,164
1,<environment.Job instance at 0x7f1ff332feb0>,131,16,[8 5],132,-1,180,-1,164
1,<environment.Job instance at 0x7f1ff332fa50>,128,14,[3 8],129,-1,178,-1,164
1,<environment.Job instance at 0x7f1ff332ff50>,133,17,[ 5 12],134,-1,181,-1,164
1,<environment.Job instance at 0x7f1ff332fc80>,134,17,[5 7],135,-1,181,-1,164
1,<environment.Job instance at 0x7f1ff33340a0>,143,20,[5 2],144,-1,198,-1,178
1,<environment.Job instance at 0x7f1ff3334690>,144,12,[ 4 10],145,-1,190,-1,178
1,<environment.Job instance at 0x7f1ff332fcd0>,130,13,[6 5],131,-1,191,-1,178
1,<environment.Job instance at 0x7f1ff335a230>,160,25,[8 3],161,-1,244,-1,219
1,<environment.Job instance at 0x7f1ff335a370>,161,27,[8 1],162,-1,246,-1,219
1,<environment.Job instance at 0x7f1ff3334aa0>,149,14,[8 5],150,-1,237,-1,223
1,<environment.Job instance at 0x7f1ff3d0eb40>,166,17,[3 8],167,-1,240,-1,223
1,<environment.Job instance at 0x7f1ff37a4dc0>,4,26,[7 4],5,-1,31,-1,5
1,<environment.Job instance at 0x7f1ff2ab2a00>,5,1,[12  3],6,-1,7,-1,6
1,<environment.Job instance at 0x7f1ff3331320>,18,16,[14  5],19,-1,37,-1,21
1,<environment.Job instance at 0x7f1ff334e640>,22,14,[ 2 12],23,-1,39,-1,25
1,<environment.Job instance at 0x7f1ff332f3c0>,25,15,[ 2 12],26,-1,52,-1,37
1,<environment.Job instance at 0x7f1ff4168b90>,44,23,[6 5],45,-1,122,-1,99
1,<environment.Job instance at 0x7f1ff3206cd0>,55,15,[ 5 11],56,-1,145,-1,130
1,<environment.Job instance at 0x7f1ff2eda2d0>,60,26,[5 7],61,-1,172,-1,146
1,<environment.Job instance at 0x7f1ff3e1d460>,69,27,[5 9],70,-1,194,-1,167
1,<environment.Job instance at 0x7f1ff31ee5f0>,72,26,[ 1 10],73,-1,193,-1,167
1,<environment.Job instance at 0x7f1ff31eea50>,73,28,[3 5],74,-1,195,-1,167
1,<environment.Job instance at 0x7f1ff374c0f0>,89,14,[ 1 13],90,-1,225,-1,211
1,<environment.Job instance at 0x7f1ff40a10f0>,92,16,[11  5],93,-1,237,-1,221
1,<environment.Job instance at 0x7f1ff2a7ad70>,115,23,[7 4],116,-1,328,-1,305
1,<environment.Job instance at 0x7f1ff2a7e870>,116,23,[5 6],117,-1,328,-1,305
1,<environment.Job instance at 0x7f1ff2b445a0>,121,12,[ 5 11],122,-1,333,-1,321
1,<environment.Job instance at 0x7f1ff3d16690>,118,25,[ 5 10],119,-1,361,-1,336
1,<environment.Job instance at 0x7f1ff2b51050>,127,26,[ 2 10],128,-1,366,-1,340
1,<environment.Job instance at 0x7f1ff324ae10>,133,17,[ 5 12],134,-1,382,-1,365
1,<environment.Job instance at 0x7f1ffcd3be10>,147,2,[ 5 11],148,-1,406,-1,404
1,<environment.Job instance at 0x7f1ff37faeb0>,148,12,[12  2],149,-1,416,-1,404
1,<environment.Job instance at 0x7f1ff37facd0>,150,2,[ 4 14],151,-1,407,-1,405
1,<environment.Job instance at 0x7f1ff2b2ab90>,160,25,[8 3],161,-1,485,-1,460
1,<environment.Job instance at 0x7f1ff3a2daf0>,161,27,[8 1],162,-1,487,-1,460
1,<environment.Job instance at 0x7f1ff32d2e10>,167,27,[2 6],168,-1,490,-1,463
1,<environment.Job instance at 0x7f1ff3e5a500>,177,26,[ 5 10],178,-1,526,-1,500
1,<environment.Job instance at 0x7f1ff322e2d0>,0,17,[4 8],1,-1,18,-1,1
1,<environment.Job instance at 0x7f1ff322eb40>,1,17,[3 6],2,-1,19,-1,2
1,<environment.Job instance at 0x7f1ff2e35d70>,2,17,[ 4 10],3,-1,21,-1,4
1,<environment.Job instance at 0x7f1ff2e35e10>,9,18,[5 5],10,-1,28,-1,10
1,<environment.Job instance at 0x7f1ff2e35230>,11,18,[5 5],12,-1,30,-1,12
1,<environment.Job instance at 0x7f1ff2e35960>,12,28,[5 1],13,-1,41,-1,13
1,<environment.Job instance at 0x7f1ff2e35d20>,16,17,[3 7],17,-1,34,-1,17
1,<environment.Job instance at 0x7f1ff2ac43c0>,21,17,[ 4 10],22,-1,39,-1,22
1,<environment.Job instance at 0x7f1ffc841410>,24,23,[2 9],25,-1,48,-1,25
1,<environment.Job instance at 0x7f1ffc841eb0>,25,18,[5 3],26,-1,44,-1,26
1,<environment.Job instance at 0x7f1ffc841910>,32,16,[9 2],33,-1,49,-1,33
1,<environment.Job instance at 0x7f1ffc841370>,33,15,[5 8],34,-1,49,-1,34
1,<environment.Job instance at 0x7f1ffc841f50>,31,17,[6 1],32,-1,53,-1,36
1,<environment.Job instance at 0x7f1ffc841690>,36,1,[10  5],37,-1,38,-1,37
1,<environment.Job instance at 0x7f1ff3fe3a00>,38,26,[2 5],39,-1,65,-1,39
1,<environment.Job instance at 0x7f1ff3fe3a50>,39,28,[4 8],40,-1,68,-1,40
1,<environment.Job instance at 0x7f1ff3fe3870>,40,28,[1 5],41,-1,69,-1,41
1,<environment.Job instance at 0x7f1ff3fe3690>,43,13,[10  1],44,-1,57,-1,44
1,<environment.Job instance at 0x7f1ff3fe3b40>,46,22,[7 4],47,-1,69,-1,47
1,<environment.Job instance at 0x7f1ff3fe3c30>,47,28,[ 1 10],48,-1,76,-1,48
1,<environment.Job instance at 0x7f1ff3b7e9b0>,48,18,[5 5],49,-1,67,-1,49
1,<environment.Job instance at 0x7f1ff3b7eaa0>,49,15,[3 6],50,-1,65,-1,50
1,<environment.Job instance at 0x7f1ff2efd410>,54,18,[ 2 10],55,-1,73,-1,55
1,<environment.Job instance at 0x7f1ff37359b0>,58,14,[9 3],59,-1,77,-1,63
1,<environment.Job instance at 0x7f1ffce2f3c0>,62,18,[7 2],63,-1,81,-1,63
1,<environment.Job instance at 0x7f1ff2d7e690>,64,16,[5 8],65,-1,82,-1,66
1,<environment.Job instance at 0x7f1ffce2f870>,65,16,[2 7],66,-1,82,-1,66
1,<environment.Job instance at 0x7f1ff3ec62d0>,67,12,[10  4],68,-1,82,-1,70
1,<environment.Job instance at 0x7f1ff3ec6cd0>,69,16,[ 3 10],70,-1,88,-1,72
1,<environment.Job instance at 0x7f1ff3ec67d0>,73,15,[3 5],74,-1,89,-1,74
1,<environment.Job instance at 0x7f1ffc8892d0>,75,13,[6 1],76,-1,89,-1,76
1,<environment.Job instance at 0x7f1ff4134960>,76,20,[10  4],77,-1,97,-1,77
1,<environment.Job instance at 0x7f1ff2c99230>,79,13,[3 6],80,-1,93,-1,80
1,<environment.Job instance at 0x7f1ff375d410>,85,17,[5 8],86,-1,103,-1,86
1,<environment.Job instance at 0x7f1ff32ceaa0>,90,16,[8 2],91,-1,108,-1,92
1,<environment.Job instance at 0x7f1ff32ce8c0>,92,17,[5 5],93,-1,110,-1,93
1,<environment.Job instance at 0x7f1ff3f19d20>,93,24,[9 2],94,-1,118,-1,94
1,<environment.Job instance at 0x7f1ff3b7a6e0>,91,12,[9 4],92,-1,106,-1,94
1,<environment.Job instance at 0x7f1ffc84a320>,99,15,[10  5],100,-1,116,-1,101
1,<environment.Job instance at 0x7f1ffc84a190>,100,12,[9 2],101,-1,113,-1,101
1,<environment.Job instance at 0x7f1ffc84abe0>,101,24,[2 6],102,-1,126,-1,102
1,<environment.Job instance at 0x7f1ffc84a0f0>,102,15,[4 9],103,-1,118,-1,103
1,<environment.Job instance at 0x7f1ffc84ac80>,108,3,[6 4],109,-1,112,-1,109
1,<environment.Job instance at 0x7f1ffc84aeb0>,109,16,[ 1 10],110,-1,126,-1,110
1,<environment.Job instance at 0x7f1ffc84a960>,111,13,[3 5],112,-1,125,-1,112
1,<environment.Job instance at 0x7f1ff2ecc280>,112,1,[2 8],113,-1,114,-1,113
1,<environment.Job instance at 0x7f1ff2ecc910>,113,21,[5 4],114,-1,135,-1,114
1,<environment.Job instance at 0x7f1ff3f493c0>,114,17,[11  5],115,-1,132,-1,115
1,<environment.Job instance at 0x7f1ff3f492d0>,116,12,[10  3],117,-1,129,-1,117
1,<environment.Job instance at 0x7f1ff3439a50>,119,14,[5 9],120,-1,134,-1,120
1,<environment.Job instance at 0x7f1ff35d7eb0>,122,18,[10  3],123,-1,141,-1,123
1,<environment.Job instance at 0x7f1ff35d76e0>,124,24,[5 8],125,-1,149,-1,125
1,<environment.Job instance at 0x7f1ff35d7cd0>,127,18,[3 8],128,-1,146,-1,128
1,<environment.Job instance at 0x7f1ff329b690>,137,18,[1 8],138,-1,156,-1,138
1,<environment.Job instance at 0x7f1ff372daf0>,134,18,[1 8],135,-1,158,-1,140
1,<environment.Job instance at 0x7f1ff372d960>,133,17,[7 2],134,-1,158,-1,141
1,<environment.Job instance at 0x7f1ff329b5f0>,143,17,[10  3],144,-1,161,-1,144
1,<environment.Job instance at 0x7f1ff329bf50>,145,16,[7 4],146,-1,162,-1,146
1,<environment.Job instance at 0x7f1ff329b640>,146,13,[4 6],147,-1,160,-1,147
1,<environment.Job instance at 0x7f1ff2dd5c30>,152,17,[6 3],153,-1,170,-1,153
1,<environment.Job instance at 0x7f1ff2dd5050>,153,27,[5 6],154,-1,182,-1,155
1,<environment.Job instance at 0x7f1ff4176a50>,156,16,[ 3 11],157,-1,176,-1,160
1,<environment.Job instance at 0x7f1ff42d3460>,161,12,[10  1],162,-1,175,-1,163
1,<environment.Job instance at 0x7f1ff42d3780>,158,25,[11  1],159,-1,189,-1,164
1,<environment.Job instance at 0x7f1ff29c1aa0>,163,13,[6 5],164,-1,177,-1,164
1,<environment.Job instance at 0x7f1ff2ac4140>,4,1,[ 1 11],5,-1,6,-1,5
1,<environment.Job instance at 0x7f1ff3b7e6e0>,5,1,[ 3 14],6,-1,7,-1,6
1,<environment.Job instance at 0x7f1ff3ec6780>,12,28,[5 1],13,-1,48,-1,20
1,<environment.Job instance at 0x7f1ff2dcf370>,19,13,[ 1 13],20,-1,55,-1,42
1,<environment.Job instance at 0x7f1ff35d7e10>,24,23,[2 9],25,-1,70,-1,47
1,<environment.Job instance at 0x7f1ff329bcd0>,26,3,[14  4],27,-1,50,-1,47
1,<environment.Job instance at 0x7f1ff2b2ac30>,38,26,[2 5],39,-1,123,-1,97
1,<environment.Job instance at 0x7f1ffcd3be10>,40,28,[1 5],41,-1,128,-1,100
1,<environment.Job instance at 0x7f1ff343faf0>,39,28,[4 8],40,-1,138,-1,110
1,<environment.Job instance at 0x7f1ff2e79960>,47,28,[ 1 10],48,-1,146,-1,118
1,<environment.Job instance at 0x7f1ff30442d0>,93,24,[9 2],94,-1,281,-1,257
1,<environment.Job instance at 0x7f1ff31eec30>,101,24,[2 6],102,-1,298,-1,274
1,<environment.Job instance at 0x7f1ff416a5f0>,114,17,[11  5],115,-1,345,-1,328
1,<environment.Job instance at 0x7f1ff416a1e0>,115,15,[ 2 12],116,-1,343,-1,328
1,<environment.Job instance at 0x7f1ff335a910>,124,24,[5 8],125,-1,398,-1,374
1,<environment.Job instance at 0x7f1ff29b1e10>,130,2,[14  3],131,-1,378,-1,376
1,<environment.Job instance at 0x7f1ff335a1e0>,126,24,[10  2],127,-1,403,-1,379
1,<environment.Job instance at 0x7f1ff332f9b0>,136,23,[9 5],137,-1,420,-1,397
1,<environment.Job instance at 0x7f1ff333e500>,149,1,[13  5],150,-1,448,-1,447
1,<environment.Job instance at 0x7f1ff3d40870>,153,27,[5 6],154,-1,478,-1,451
1,<environment.Job instance at 0x7f1ff3d198c0>,156,16,[ 3 11],157,-1,467,-1,451
1,<environment.Job instance at 0x7f1ff386c5f0>,158,25,[11  1],159,-1,491,-1,466
1,<environment.Job instance at 0x7f1ff387dc30>,164,27,[3 8],165,-1,522,-1,495
1,<environment.Job instance at 0x7f1ff36f7f50>,170,18,[12  3],171,-1,513,-1,495
1,<environment.Job instance at 0x7f1ff2d89370>,175,27,[4 6],176,-1,555,-1,528
1,<environment.Job instance at 0x7f1ff37ba500>,0,16,[10  3],1,-1,20,-1,4
1,<environment.Job instance at 0x7f1ff37ba690>,3,12,[9 4],4,-1,16,-1,4
1,<environment.Job instance at 0x7f1ff37baeb0>,10,14,[11  5],11,-1,25,-1,11
1,<environment.Job instance at 0x7f1ff37badc0>,11,13,[ 1 10],12,-1,25,-1,12
1,<environment.Job instance at 0x7f1ff37ba190>,12,17,[3 8],13,-1,30,-1,13
1,<environment.Job instance at 0x7f1ff37ba140>,13,14,[4 9],14,-1,28,-1,14
1,<environment.Job instance at 0x7f1ff37baa50>,14,28,[4 7],15,-1,43,-1,15
1,<environment.Job instance at 0x7f1ff37ba3c0>,15,13,[ 3 10],16,-1,29,-1,16
1,<environment.Job instance at 0x7f1ff2982280>,18,14,[10  3],19,-1,34,-1,20
1,<environment.Job instance at 0x7f1ff2982f50>,19,18,[8 2],20,-1,38,-1,20
1,<environment.Job instance at 0x7f1ff2982550>,26,18,[10  1],27,-1,46,-1,28
1,<environment.Job instance at 0x7f1ff2982c30>,28,16,[7 1],29,-1,45,-1,29
1,<environment.Job instance at 0x7f1ff2982dc0>,29,15,[ 4 10],30,-1,45,-1,30
1,<environment.Job instance at 0x7f1ff2982690>,30,17,[3 8],31,-1,48,-1,31
1,<environment.Job instance at 0x7f1ff426b410>,36,12,[4 6],37,-1,49,-1,37
1,<environment.Job instance at 0x7f1ff426b140>,37,18,[3 9],38,-1,56,-1,38
1,<environment.Job instance at 0x7f1ff426bbe0>,43,17,[10  3],44,-1,61,-1,44
1,<environment.Job instance at 0x7f1ff426b320>,44,15,[6 3],45,-1,60,-1,45
1,<environment.Job instance at 0x7f1ff426baa0>,46,16,[2 9],47,-1,63,-1,47
1,<environment.Job instance at 0x7f1ff426b550>,47,22,[10  4],48,-1,71,-1,49
1,<environment.Job instance at 0x7f1ff426f230>,52,21,[5 3],53,-1,74,-1,53
1,<environment.Job instance at 0x7f1ff426faf0>,54,15,[4 8],55,-1,70,-1,55
1,<environment.Job instance at 0x7f1ff426f780>,59,13,[3 8],60,-1,73,-1,60
1,<environment.Job instance at 0x7f1ff29974b0>,66,21,[10  2],67,-1,88,-1,67
1,<environment.Job instance at 0x7f1ff2997780>,67,15,[5 1],68,-1,83,-1,68
1,<environment.Job instance at 0x7f1ff2997230>,68,12,[1 5],69,-1,81,-1,69
1,<environment.Job instance at 0x7f1ff2997d70>,70,13,[1 5],71,-1,84,-1,71
1,<environment.Job instance at 0x7f1ff2997370>,72,15,[3 8],73,-1,88,-1,73
1,<environment.Job instance at 0x7f1ff2997e10>,74,16,[8 4],75,-1,91,-1,75
1,<environment.Job instance at 0x7f1ff2997be0>,76,14,[ 2 10],77,-1,91,-1,77
1,<environment.Job instance at 0x7f1ff426b6e0>,48,21,[7 1],49,-1,98,-1,77
1,<environment.Job instance at 0x7f1ff3149cd0>,77,14,[7 4],78,-1,93,-1,79
1,<environment.Job instance at 0x7f1ff31496e0>,81,22,[9 1],82,-1,104,-1,82
1,<environment.Job instance at 0x7f1ff3149c80>,82,14,[7 5],83,-1,97,-1,83
1,<environment.Job instance at 0x7f1ff31491e0>,85,18,[2 9],86,-1,104,-1,86
1,<environment.Job instance at 0x7f1ff426fb90>,60,14,[12  5],61,-1,101,-1,87
1,<environment.Job instance at 0x7f1ff3149f50>,86,18,[10  3],87,-1,105,-1,87
1,<environment.Job instance at 0x7f1ff3149b40>,87,19,[ 2 10],88,-1,107,-1,88
1,<environment.Job instance at 0x7f1ff31490a0>,80,25,[ 4 10],81,-1,115,-1,90
1,<environment.Job instance at 0x7f1ff31498c0>,84,14,[ 2 11],85,-1,104,-1,90
1,<environment.Job instance at 0x7f1ff31499b0>,90,17,[ 5 14],91,-1,108,-1,91
1,<environment.Job instance at 0x7f1ff3149320>,89,17,[1 5],90,-1,108,-1,91
1,<environment.Job instance at 0x7f1ff2986fa0>,93,15,[5 7],94,-1,110,-1,95
1,<environment.Job instance at 0x7f1ff2986280>,97,17,[ 5 10],98,-1,115,-1,98
1,<environment.Job instance at 0x7f1ff2986140>,99,16,[5 5],100,-1,116,-1,100
1,<environment.Job instance at 0x7f1ff3c150a0>,101,14,[4 8],102,-1,116,-1,102
1,<environment.Job instance at 0x7f1ff3c3a6e0>,111,13,[8 2],112,-1,125,-1,112
1,<environment.Job instance at 0x7f1ff3f2ed20>,115,18,[7 4],116,-1,134,-1,116
1,<environment.Job instance at 0x7f1ff3f51c30>,119,17,[4 6],120,-1,137,-1,120
1,<environment.Job instance at 0x7f1ff3b0de60>,132,17,[ 1 10],133,-1,150,-1,133
1,<environment.Job instance at 0x7f1ff29867d0>,94,16,[2 8],95,-1,151,-1,135
1,<environment.Job instance at 0x7f1ff3599c80>,126,15,[10  5],127,-1,150,-1,135
1,<environment.Job instance at 0x7f1ff3c13500>,106,16,[12  5],107,-1,152,-1,136
1,<environment.Job instance at 0x7f1ff3599370>,125,17,[4 6],126,-1,154,-1,137
1,<environment.Job instance at 0x7f1ff3111690>,135,15,[7 1],136,-1,152,-1,137
1,<environment.Job instance at 0x7f1ff3b0d550>,134,15,[7 5],135,-1,161,-1,146
1,<environment.Job instance at 0x7f1ff39e3460>,142,16,[2 8],143,-1,162,-1,146
1,<environment.Job instance at 0x7f1ff4206640>,140,18,[2 9],141,-1,170,-1,152
1,<environment.Job instance at 0x7f1ff3111190>,137,17,[9 4],138,-1,169,-1,152
1,<environment.Job instance at 0x7f1ff2e4dbe0>,146,13,[10  2],147,-1,165,-1,152
1,<environment.Job instance at 0x7f1ff3115b90>,149,20,[7 2],150,-1,172,-1,152
1,<environment.Job instance at 0x7f1ff3115f50>,150,16,[1 9],151,-1,168,-1,152
1,<environment.Job instance at 0x7f1ff3115d70>,151,12,[6 3],152,-1,164,-1,152
1,<environment.Job instance at 0x7f1ff3599d70>,124,12,[ 4 13],125,-1,164,-1,152
1,<environment.Job instance at 0x7f1ff360a5f0>,152,16,[5 3],153,-1,169,-1,153
1,<environment.Job instance at 0x7f1ff360a870>,153,15,[9 4],154,-1,169,-1,154
1,<environment.Job instance at 0x7f1ff374f3c0>,157,12,[ 2 10],158,-1,170,-1,158
1,<environment.Job instance at 0x7f1ff374fbe0>,158,22,[ 3 10],159,-1,181,-1,159
1,<environment.Job instance at 0x7f1ff374f500>,162,17,[5 8],163,-1,186,-1,169
1,<environment.Job instance at 0x7f1ff3122910>,164,19,[3 7],165,-1,192,-1,173
1,<environment.Job instance at 0x7f1ff3122e60>,167,23,[3 5],168,-1,203,-1,180
1,<environment.Job instance at 0x7f1ff3111eb0>,136,15,[5 5],137,-1,196,-1,181
1,<environment.Job instance at 0x7f1ff3122320>,168,16,[1 9],169,-1,197,-1,181
1,<environment.Job instance at 0x7f1ff3988be0>,170,28,[2 6],171,-1,209,-1,181
1,<environment.Job instance at 0x7f1ff426b7d0>,10,14,[11  5],11,-1,31,-1,17
1,<environment.Job instance at 0x7f1ff2997cd0>,14,28,[4 7],15,-1,59,-1,31
1,<environment.Job instance at 0x7f1ff31112d0>,20,24,[9 4],21,-1,79,-1,55
1,<environment.Job instance at 0x7f1ff3b0d2d0>,23,2,[12  3],24,-1,57,-1,55
1,<environment.Job instance at 0x7f1ff42dc410>,31,16,[12  1],32,-1,107,-1,91
1,<environment.Job instance at 0x7f1ff2bac0f0>,58,3,[14  4],59,-1,194,-1,191
1,<environment.Job instance at 0x7f1ff30c6b90>,60,14,[12  5],61,-1,207,-1,193
1,<environment.Job instance at 0x7f1ff3ac0280>,80,25,[ 4 10],81,-1,283,-1,258
1,<environment.Job instance at 0x7f1ff2ee04b0>,84,14,[ 2 11],85,-1,276,-1,262
1,<environment.Job instance at 0x7f1ff3e93e10>,90,17,[ 5 14],91,-1,305,-1,288
1,<environment.Job instance at 0x7f1ff2ff0c30>,106,16,[12  5],107,-1,370,-1,354
1,<environment.Job instance at 0x7f1ff2d0f190>,109,28,[4 8],110,-1,397,-1,369
1,<environment.Job instance at 0x7f1ffccfa7d0>,124,12,[ 4 13],125,-1,420,-1,408
1,<environment.Job instance at 0x7f1ff2e727d0>,130,2,[ 2 12],131,-1,436,-1,434
1,<environment.Job instance at 0x7f1ff2e72910>,131,13,[ 3 11],132,-1,447,-1,434
1,<environment.Job instance at 0x7f1ff3a8b5a0>,145,1,[14  5],146,-1,503,-1,502
1,<environment.Job instance at 0x7f1ff2ee2be0>,147,2,[ 5 12],148,-1,509,-1,507
1,<environment.Job instance at 0x7f1ff2c89b40>,155,2,[ 2 12],156,-1,547,-1,545
1,<environment.Job instance at 0x7f1ff29f9690>,160,13,[ 2 13],161,-1,580,-1,567
1,<environment.Job instance at 0x7f1ff2d43960>,167,23,[3 5],168,-1,636,-1,613
1,<environment.Job instance at 0x7f1ff2b5b820>,1,16,[1 7],2,-1,18,-1,2
1,<environment.Job instance at 0x7f1ff2b5b960>,3,19,[3 9],4,-1,23,-1,4
1,<environment.Job instance at 0x7f1ff2b5b730>,5,17,[9 1],6,-1,24,-1,7
1,<environment.Job instance at 0x7f1ff2b5b0a0>,7,14,[5 6],8,-1,22,-1,8
1,<environment.Job instance at 0x7f1ff38db870>,9,18,[5 3],10,-1,28,-1,10
1,<environment.Job instance at 0x7f1ff38dba50>,11,20,[10  2],12,-1,32,-1,12
1,<environment.Job instance at 0x7f1ff38db370>,14,14,[ 3 10],15,-1,29,-1,15
1,<environment.Job instance at 0x7f1ff38dbc80>,17,18,[1 8],18,-1,36,-1,18
1,<environment.Job instance at 0x7f1ff3fb1af0>,20,18,[8 3],21,-1,39,-1,21
1,<environment.Job instance at 0x7f1ff3fb1500>,24,12,[4 5],25,-1,37,-1,25
1,<environment.Job instance at 0x7f1ff3fb14b0>,27,20,[1 5],28,-1,48,-1,28
1,<environment.Job instance at 0x7f1ff4174320>,28,27,[6 3],29,-1,56,-1,29
1,<environment.Job instance at 0x7f1ff4174b40>,29,27,[3 5],30,-1,57,-1,30
1,<environment.Job instance at 0x7f1ff4174cd0>,31,16,[5 5],32,-1,48,-1,32
1,<environment.Job instance at 0x7f1ff41743c0>,37,17,[4 9],38,-1,55,-1,38
1,<environment.Job instance at 0x7f1ff4174a00>,39,13,[10  2],40,-1,54,-1,41
1,<environment.Job instance at 0x7f1ff39cf1e0>,48,15,[8 2],49,-1,65,-1,50
1,<environment.Job instance at 0x7f1ff39cf960>,49,13,[10  2],50,-1,63,-1,50
1,<environment.Job instance at 0x7f1ff39cffa0>,51,14,[9 3],52,-1,76,-1,62
1,<environment.Job instance at 0x7f1ff39cfcd0>,52,14,[ 3 10],53,-1,78,-1,64
1,<environment.Job instance at 0x7f1ff39cfa00>,56,13,[ 5 10],57,-1,77,-1,64
1,<environment.Job instance at 0x7f1ff4174820>,42,17,[ 5 10],43,-1,81,-1,64
1,<environment.Job instance at 0x7f1ff39cfc80>,58,1,[7 4],59,-1,65,-1,64
1,<environment.Job instance at 0x7f1ff39cf0a0>,60,18,[6 1],61,-1,82,-1,64
1,<environment.Job instance at 0x7f1ff39cf910>,61,3,[7 4],62,-1,67,-1,64
1,<environment.Job instance at 0x7f1ff39cfbe0>,62,16,[1 7],63,-1,81,-1,65
1,<environment.Job instance at 0x7f1ff39cfb40>,47,12,[ 2 14],48,-1,82,-1,70
1,<environment.Job instance at 0x7f1ff3950370>,65,18,[2 9],66,-1,88,-1,70
1,<environment.Job instance at 0x7f1ff3950500>,68,28,[9 5],69,-1,98,-1,70
1,<environment.Job instance at 0x7f1ff3950050>,67,15,[10  1],68,-1,85,-1,70
1,<environment.Job instance at 0x7f1ff343cdc0>,76,22,[4 9],77,-1,110,-1,88
1,<environment.Job instance at 0x7f1ff343ceb0>,78,14,[5 6],79,-1,102,-1,88
1,<environment.Job instance at 0x7f1ff343c320>,75,17,[8 3],76,-1,106,-1,89
1,<environment.Job instance at 0x7f1ff343c7d0>,85,14,[8 2],86,-1,107,-1,93
1,<environment.Job instance at 0x7f1ff3a401e0>,91,16,[4 9],92,-1,109,-1,93
1,<environment.Job instance at 0x7f1ff3a40f00>,92,15,[9 5],93,-1,110,-1,95
1,<environment.Job instance at 0x7f1ff4174780>,44,18,[3 5],45,-1,113,-1,95
1,<environment.Job instance at 0x7f1ff35ff3c0>,97,13,[10  3],98,-1,115,-1,102
1,<environment.Job instance at 0x7f1ff2f0ed20>,98,18,[10  5],99,-1,121,-1,103
1,<environment.Job instance at 0x7f1ff30aef50>,96,16,[ 5 10],97,-1,119,-1,103
1,<environment.Job instance at 0x7f1ff36233c0>,100,17,[6 4],101,-1,120,-1,103
1,<environment.Job instance at 0x7f1ff3623cd0>,101,23,[9 2],102,-1,129,-1,106
1,<environment.Job instance at 0x7f1ff30960a0>,106,15,[7 3],107,-1,122,-1,107
1,<environment.Job instance at 0x7f1ff35f3a50>,105,25,[ 2 11],106,-1,200,-1,175
1,<environment.Job instance at 0x7f1ff36ce7d0>,111,12,[7 5],112,-1,187,-1,175
1,<environment.Job instance at 0x7f1ff38047d0>,107,3,[8 4],108,-1,178,-1,175
1,<environment.Job instance at 0x7f1ff3d07230>,110,14,[13  1],111,-1,189,-1,175
1,<environment.Job instance at 0x7f1ff4023c30>,113,12,[12  5],114,-1,187,-1,175
1,<environment.Job instance at 0x7f1ff3721b90>,114,14,[5 5],115,-1,190,-1,176
1,<environment.Job instance at 0x7f1ff2c049b0>,116,12,[5 9],117,-1,189,-1,177
1,<environment.Job instance at 0x7f1ff3e869b0>,119,17,[11  5],120,-1,195,-1,178
1,<environment.Job instance at 0x7f1ff3218500>,120,18,[3 7],121,-1,196,-1,178
1,<environment.Job instance at 0x7f1ff32181e0>,122,22,[ 4 11],123,-1,200,-1,178
1,<environment.Job instance at 0x7f1ff2d236e0>,123,13,[8 4],124,-1,191,-1,178
1,<environment.Job instance at 0x7f1ff4174be0>,40,23,[5 8],41,-1,202,-1,179
1,<environment.Job instance at 0x7f1ff39eda00>,127,14,[4 9],128,-1,193,-1,179
1,<environment.Job instance at 0x7f1ff3580d20>,130,17,[10  2],131,-1,196,-1,179
1,<environment.Job instance at 0x7f1ff2e4d9b0>,132,18,[1 5],133,-1,197,-1,179
1,<environment.Job instance at 0x7f1ff3580c30>,129,13,[ 5 11],130,-1,194,-1,181
1,<environment.Job instance at 0x7f1ff2e4d690>,134,22,[7 4],135,-1,203,-1,181
1,<environment.Job instance at 0x7f1ff2e4d640>,135,3,[7 1],136,-1,184,-1,181
1,<environment.Job instance at 0x7f1ff2e4d1e0>,137,16,[5 1],138,-1,198,-1,182
1,<environment.Job instance at 0x7f1ff2e4d370>,136,17,[5 8],137,-1,199,-1,182
1,<environment.Job instance at 0x7f1ff32275f0>,140,20,[ 3 10],141,-1,202,-1,182
1,<environment.Job instance at 0x7f1ff32277d0>,142,14,[11  5],143,-1,196,-1,182
1,<environment.Job instance at 0x7f1ff3227550>,144,16,[9 5],145,-1,198,-1,182
1,<environment.Job instance at 0x7f1ff360b8c0>,147,15,[4 6],148,-1,199,-1,184
1,<environment.Job instance at 0x7f1ff360bb90>,149,18,[1 9],150,-1,203,-1,185
1,<environment.Job instance at 0x7f1ff353a050>,158,17,[3 8],159,-1,243,-1,226
1,<environment.Job instance at 0x7f1ff3a2f230>,166,13,[9 1],167,-1,239,-1,226
1,<environment.Job instance at 0x7f1ff35f68c0>,164,16,[9 1],165,-1,242,-1,226
1,<environment.Job instance at 0x7f1ff3a2fc30>,168,14,[7 1],169,-1,240,-1,226
1,<environment.Job instance at 0x7f1ff381efa0>,172,17,[9 3],173,-1,245,-1,228
1,<environment.Job instance at 0x7f1ff38dbe10>,0,1,[13  1],1,-1,2,-1,1
1,<environment.Job instance at 0x7f1ff343c780>,13,15,[ 3 14],14,-1,38,-1,23
1,<environment.Job instance at 0x7f1ff2da2c30>,18,3,[13  1],19,-1,38,-1,35
1,<environment.Job instance at 0x7f1ff3fb7f50>,25,15,[14  4],26,-1,59,-1,44
1,<environment.Job instance at 0x7f1ff3320640>,29,27,[3 5],30,-1,84,-1,57
1,<environment.Job instance at 0x7f1ff38460a0>,28,27,[6 3],29,-1,85,-1,58
1,<environment.Job instance at 0x7f1ff2e59910>,32,2,[12  2],33,-1,60,-1,58
1,<environment.Job instance at 0x7f1ff2b5ba00>,40,23,[5 8],41,-1,111,-1,88
1,<environment.Job instance at 0x7f1ff322d050>,47,12,[ 2 14],48,-1,125,-1,113
1,<environment.Job instance at 0x7f1ff3e37640>,68,28,[9 5],69,-1,234,-1,206
1,<environment.Job instance at 0x7f1ff2e1d8c0>,70,1,[11  1],71,-1,207,-1,206
1,<environment.Job instance at 0x7f1ff2aacd70>,87,1,[ 2 12],88,-1,244,-1,243
1,<environment.Job instance at 0x7f1ffcecd730>,101,23,[9 2],102,-1,329,-1,306
1,<environment.Job instance at 0x7f1ff41305a0>,105,25,[ 2 11],106,-1,333,-1,308
1,<environment.Job instance at 0x7f1ff2fbef50>,110,14,[13  1],111,-1,340,-1,326
1,<environment.Job instance at 0x7f1ff40de140>,113,12,[12  5],114,-1,350,-1,338
1,<environment.Job instance at 0x7f1ff42dc5f0>,119,17,[11  5],120,-1,373,-1,356
1,<environment.Job instance at 0x7f1ff426fe10>,122,22,[ 4 11],123,-1,392,-1,370
1,<environment.Job instance at 0x7f1ff426b5f0>,126,15,[13  2],127,-1,389,-1,374
1,<environment.Job instance at 0x7f1ff2982e60>,129,13,[ 5 11],130,-1,396,-1,383
1,<environment.Job instance at 0x7f1ff3dc0be0>,133,3,[ 3 14],134,-1,400,-1,397
1,<environment.Job instance at 0x7f1ff3655fa0>,138,17,[14  2],139,-1,421,-1,404
1,<environment.Job instance at 0x7f1ff2ab1f50>,142,14,[11  5],143,-1,435,-1,421
1,<environment.Job instance at 0x7f1ff31c9140>,157,1,[12  4],158,-1,464,-1,463
1,<environment.Job instance at 0x7f1ff31c9d70>,162,14,[ 2 11],163,-1,506,-1,492
1,<environment.Job instance at 0x7f1ff31c9e60>,165,13,[ 3 14],166,-1,508,-1,495
1,<environment.Job instance at 0x7f1ff29d2190>,7,17,[10  4],8,-1,26,-1,9
1,<environment.Job instance at 0x7f1ff41740f0>,8,17,[9 3],9,-1,26,-1,9
1,<environment.Job instance at 0x7f1ff29d2280>,9,18,[2 7],10,-1,28,-1,10
1,<environment.Job instance at 0x7f1ff29d2320>,10,16,[ 1 10],11,-1,28,-1,12
1,<environment.Job instance at 0x7f1ff29d2500>,13,23,[5 6],14,-1,37,-1,14
1,<environment.Job instance at 0x7f1ff29d27d0>,16,16,[10  2],17,-1,33,-1,17
1,<environment.Job instance at 0x7f1ff29d2960>,17,13,[5 5],18,-1,31,-1,18
1,<environment.Job instance at 0x7f1ff29d2a00>,19,17,[10  1],20,-1,37,-1,20
1,<environment.Job instance at 0x7f1ff29d2dc0>,22,14,[9 2],23,-1,37,-1,23
1,<environment.Job instance at 0x7f1ff29de3c0>,27,14,[10  2],28,-1,43,-1,29
1,<environment.Job instance at 0x7f1ff29de550>,29,15,[4 9],30,-1,45,-1,30
1,<environment.Job instance at 0x7f1ff29de6e0>,31,17,[9 4],32,-1,49,-1,32
1,<environment.Job instance at 0x7f1ff29dea50>,35,16,[3 7],36,-1,52,-1,36
1,<environment.Job instance at 0x7f1ff29decd0>,36,13,[9 1],37,-1,50,-1,37
1,<environment.Job instance at 0x7f1ff29de960>,37,18,[10  3],38,-1,56,-1,38
1,<environment.Job instance at 0x7f1ff29de4b0>,28,15,[5 3],29,-1,54,-1,39
1,<environment.Job instance at 0x7f1ff29b5140>,41,16,[1 7],42,-1,58,-1,42
1,<environment.Job instance at 0x7f1ff29b5320>,44,24,[4 8],45,-1,69,-1,45
1,<environment.Job instance at 0x7f1ff29b53c0>,46,23,[9 2],47,-1,70,-1,47
1,<environment.Job instance at 0x7f1ff29b5690>,47,18,[3 6],48,-1,66,-1,48
1,<environment.Job instance at 0x7f1ff29b55f0>,48,14,[10  1],49,-1,64,-1,50
1,<environment.Job instance at 0x7f1ff29b5820>,50,28,[8 5],51,-1,79,-1,51
1,<environment.Job instance at 0x7f1ff29b58c0>,51,16,[6 2],52,-1,68,-1,52
1,<environment.Job instance at 0x7f1ff29b5960>,52,2,[8 5],53,-1,55,-1,53
1,<environment.Job instance at 0x7f1ff29b5a00>,53,17,[ 5 12],54,-1,71,-1,54
1,<environment.Job instance at 0x7f1ff29b5aa0>,54,18,[ 4 13],55,-1,73,-1,55
1,<environment.Job instance at 0x7f1ff29b5b40>,55,14,[ 2 10],56,-1,70,-1,56
1,<environment.Job instance at 0x7f1ff29b5be0>,56,17,[9 4],57,-1,74,-1,57
1,<environment.Job instance at 0x7f1ff29b5c80>,57,2,[2 5],58,-1,60,-1,58
1,<environment.Job instance at 0x7f1ff29b5d20>,58,14,[ 1 10],59,-1,73,-1,59
1,<environment.Job instance at 0x7f1ff29b5dc0>,59,2,[3 7],60,-1,62,-1,60
1,<environment.Job instance at 0x7f1ff29b56e0>,49,27,[ 5 10],50,-1,87,-1,60
1,<environment.Job instance at 0x7f1ff29b5f00>,61,16,[4 7],62,-1,78,-1,62
1,<environment.Job instance at 0x7f1ff29e7140>,62,17,[10  4],63,-1,81,-1,64
1,<environment.Job instance at 0x7f1ff29b5e60>,63,13,[ 4 10],64,-1,80,-1,67
1,<environment.Job instance at 0x7f1ff29e7690>,68,18,[4 7],69,-1,87,-1,69
1,<environment.Job instance at 0x7f1ff29e7550>,70,21,[9 2],71,-1,92,-1,71
1,<environment.Job instance at 0x7f1ff29e7b90>,73,18,[ 4 10],74,-1,92,-1,74
1,<environment.Job instance at 0x7f1ff29e7d20>,74,15,[3 5],75,-1,90,-1,75
1,<environment.Job instance at 0x7f1ff29e7dc0>,76,26,[3 5],77,-1,103,-1,77
1,<environment.Job instance at 0x7f1ff29e7f50>,77,24,[9 4],78,-1,102,-1,78
1,<environment.Job instance at 0x7f1ff41f00a0>,79,13,[4 7],80,-1,93,-1,80
1,<environment.Job instance at 0x7f1ff41f01e0>,80,15,[1 8],81,-1,96,-1,81
1,<environment.Job instance at 0x7f1ff41f0140>,81,14,[6 4],82,-1,96,-1,82
1,<environment.Job instance at 0x7f1ff41f0550>,84,17,[3 5],85,-1,102,-1,85
1,<environment.Job instance at 0x7f1ff41f06e0>,85,18,[ 3 10],86,-1,104,-1,86
1,<environment.Job instance at 0x7f1ff41f0b40>,92,13,[9 5],93,-1,106,-1,93
1,<environment.Job instance at 0x7f1ff41f0f00>,93,12,[ 3 10],94,-1,106,-1,94
1,<environment.Job instance at 0x7f1ff41f0d70>,95,1,[6 4],96,-1,97,-1,96
1,<environment.Job instance at 0x7f1ff421f0a0>,97,17,[8 4],98,-1,117,-1,100
1,<environment.Job instance at 0x7f1ff421f410>,101,16,[1 8],102,-1,118,-1,102
1,<environment.Job instance at 0x7f1ff421f5a0>,103,24,[5 1],104,-1,128,-1,104
1,<environment.Job instance at 0x7f1ff2d4a550>,105,22,[5 4],106,-1,128,-1,106
1,<environment.Job instance at 0x7f1ff29c40a0>,106,28,[8 5],107,-1,135,-1,107
1,<environment.Job instance at 0x7f1ff421f280>,99,14,[1 5],100,-1,124,-1,110
1,<environment.Job instance at 0x7f1ff358bb90>,110,18,[5 8],111,-1,131,-1,113
1,<environment.Job instance at 0x7f1ff42064b0>,112,13,[8 1],113,-1,126,-1,113
1,<environment.Job instance at 0x7f1ff2985f50>,116,18,[11  2],117,-1,152,-1,134
1,<environment.Job instance at 0x7f1ff2e2ab90>,135,27,[4 6],136,-1,163,-1,136
1,<environment.Job instance at 0x7f1ff2e2a8c0>,137,17,[2 8],138,-1,155,-1,138
1,<environment.Job instance at 0x7f1ff34555f0>,127,13,[2 7],128,-1,152,-1,139
1,<environment.Job instance at 0x7f1ff2e2a730>,138,18,[5 5],139,-1,157,-1,139
1,<environment.Job instance at 0x7f1ff2e2a4b0>,139,24,[9 1],140,-1,166,-1,142
1,<environment.Job instance at 0x7f1ff2f1f050>,118,15,[ 1 14],119,-1,160,-1,145
1,<environment.Job instance at 0x7f1ff2e643c0>,143,15,[4 8],144,-1,161,-1,146
1,<environment.Job instance at 0x7f1ff2e2a280>,142,16,[ 1 10],143,-1,162,-1,146
1,<environment.Job instance at 0x7f1ff2e2a0a0>,141,18,[8 2],142,-1,164,-1,146
1,<environment.Job instance at 0x7f1ff2e641e0>,145,14,[5 5],146,-1,160,-1,146
1,<environment.Job instance at 0x7f1ff339baa0>,129,15,[10  5],130,-1,161,-1,146
1,<environment.Job instance at 0x7f1ff2f5be10>,147,17,[2 5],148,-1,167,-1,150
1,<environment.Job instance at 0x7f1ff2e640a0>,149,17,[9 4],150,-1,167,-1,150
1,<environment.Job instance at 0x7f1ff3a7c320>,150,15,[10  4],151,-1,179,-1,164
1,<environment.Job instance at 0x7f1ff2e2f3c0>,153,17,[7 4],154,-1,181,-1,164
1,<environment.Job instance at 0x7f1ff2e2f820>,161,23,[5 2],162,-1,191,-1,168
1,<environment.Job instance at 0x7f1ff2e2f780>,162,17,[ 5 14],163,-1,185,-1,168
1,<environment.Job instance at 0x7f1ff2e2f500>,163,28,[10  4],164,-1,196,-1,168
1,<environment.Job instance at 0x7f1ff2e2bd20>,167,17,[9 5],168,-1,190,-1,173
1,<environment.Job instance at 0x7f1ff2e2b870>,168,18,[ 4 13],169,-1,191,-1,173
1,<environment.Job instance at 0x7f1ff35f35a0>,114,25,[9 4],115,-1,198,-1,173
1,<environment.Job instance at 0x7f1ff2e2b730>,169,14,[ 1 10],170,-1,187,-1,173
1,<environment.Job instance at 0x7f1ff2e4f870>,173,15,[5 6],174,-1,189,-1,174
1,<environment.Job instance at 0x7f1ff2e4f370>,174,16,[10  5],175,-1,191,-1,175
1,<environment.Job instance at 0x7f1ff2e4f7d0>,176,18,[10  3],177,-1,195,-1,177
1,<environment.Job instance at 0x7f1ff2e2ff00>,156,13,[11  2],157,-1,199,-1,186
1,<environment.Job instance at 0x7f1ff29d2d70>,1,1,[12  1],2,-1,3,-1,2
1,<environment.Job instance at 0x7f1ff29de050>,3,3,[ 3 12],4,-1,7,-1,4
1,<environment.Job instance at 0x7f1ff41f0dc0>,13,23,[5 6],14,-1,48,-1,25
1,<environment.Job instance at 0x7f1ff2e2fbe0>,20,2,[13  2],21,-1,40,-1,38
1,<environment.Job instance at 0x7f1ff2e4f230>,23,1,[14  1],24,-1,43,-1,42
1,<environment.Job instance at 0x7f1ff37ba230>,38,2,[ 4 11],39,-1,106,-1,104
1,<environment.Job instance at 0x7f1ff37ba370>,40,12,[ 1 14],41,-1,118,-1,106
1,<environment.Job instance at 0x7f1ff2982c80>,42,2,[ 1 14],43,-1,121,-1,119
1,<environment.Job instance at 0x7f1ff426b7d0>,44,24,[4 8],45,-1,145,-1,121
1,<environment.Job instance at 0x7f1ff426be60>,46,23,[9 2],47,-1,156,-1,133
1,<environment.Job instance at 0x7f1ff2fc17d0>,49,27,[ 5 10],50,-1,180,-1,153
1,<environment.Job instance at 0x7f1ff3d9f190>,50,28,[8 5],51,-1,192,-1,164
1,<environment.Job instance at 0x7f1ff42dcc30>,53,17,[ 5 12],54,-1,181,-1,164
1,<environment.Job instance at 0x7f1ff2fbef50>,54,18,[ 4 13],55,-1,182,-1,164
1,<environment.Job instance at 0x7f1ff2d0ff00>,76,26,[3 5],77,-1,294,-1,268
1,<environment.Job instance at 0x7f1ff3515f00>,77,24,[9 4],78,-1,292,-1,268
1,<environment.Job instance at 0x7f1ff2ddd050>,88,1,[12  1],89,-1,299,-1,298
1,<environment.Job instance at 0x7f1ff40a6f50>,103,24,[5 1],104,-1,360,-1,336
1,<environment.Job instance at 0x7f1ff2a2d780>,106,28,[8 5],107,-1,367,-1,339
1,<environment.Job instance at 0x7f1ff39503c0>,114,25,[9 4],115,-1,395,-1,370
1,<environment.Job instance at 0x7f1ff4174140>,116,18,[11  2],117,-1,388,-1,370
1,<environment.Job instance at 0x7f1ff38db280>,118,15,[ 1 14],119,-1,385,-1,370
1,<environment.Job instance at 0x7f1ff3fb1230>,123,2,[ 2 13],124,-1,387,-1,385
1,<environment.Job instance at 0x7f1ff3c57550>,135,27,[4 6],136,-1,456,-1,429
1,<environment.Job instance at 0x7f1ff3c57c80>,139,24,[9 1],140,-1,465,-1,441
1,<environment.Job instance at 0x7f1ff3c84500>,148,1,[ 2 12],149,-1,463,-1,462
1,<environment.Job instance at 0x7f1ff2ac44b0>,156,13,[11  2],157,-1,520,-1,507
1,<environment.Job instance at 0x7f1ff2eda1e0>,161,23,[5 2],162,-1,546,-1,523
1,<environment.Job instance at 0x7f1ff2edabe0>,162,17,[ 5 14],163,-1,540,-1,523
1,<environment.Job instance at 0x7f1ff329be60>,163,28,[10  4],164,-1,551,-1,523
1,<environment.Job instance at 0x7f1ff31ee730>,168,18,[ 4 13],169,-1,543,-1,525
1,<environment.Job instance at 0x7f1ff4092aa0>,1,19,[10  5],2,-1,21,-1,2
1,<environment.Job instance at 0x7f1ff3ec68c0>,7,13,[ 1 10],8,-1,21,-1,8
1,<environment.Job instance at 0x7f1ff42d8820>,9,17,[2 5],10,-1,27,-1,10
1,<environment.Job instance at 0x7f1ff42d8280>,10,13,[ 2 10],11,-1,25,-1,12
1,<environment.Job instance at 0x7f1ff42d8aa0>,12,13,[5 5],13,-1,26,-1,13
1,<environment.Job instance at 0x7f1ff42d80a0>,13,12,[5 2],14,-1,26,-1,14
1,<environment.Job instance at 0x7f1ff42d8f00>,16,18,[3 7],17,-1,35,-1,17
1,<environment.Job instance at 0x7f1ff42d8460>,17,2,[2 8],18,-1,20,-1,18
1,<environment.Job instance at 0x7f1ff42d8b40>,18,12,[2 6],19,-1,31,-1,19
1,<environment.Job instance at 0x7f1ff42d89b0>,19,18,[6 5],20,-1,38,-1,20
1,<environment.Job instance at 0x7f1ff42d8230>,20,15,[5 5],21,-1,36,-1,21
1,<environment.Job instance at 0x7f1ff37d7550>,21,3,[8 1],22,-1,25,-1,22
1,<environment.Job instance at 0x7f1ff3ec6d70>,11,18,[4 5],12,-1,40,-1,22
1,<environment.Job instance at 0x7f1ff37d7cd0>,24,24,[5 9],25,-1,49,-1,25
1,<environment.Job instance at 0x7f1ff37d79b0>,25,18,[1 6],26,-1,44,-1,26
1,<environment.Job instance at 0x7f1ff37d7a00>,26,28,[9 5],27,-1,55,-1,27
1,<environment.Job instance at 0x7f1ff37d7e60>,29,17,[5 2],30,-1,47,-1,30
1,<environment.Job instance at 0x7f1ff39cbf50>,31,18,[9 3],32,-1,50,-1,32
1,<environment.Job instance at 0x7f1ff39cb730>,32,17,[4 8],33,-1,50,-1,33
1,<environment.Job instance at 0x7f1ff39cb050>,33,18,[8 3],34,-1,52,-1,34
1,<environment.Job instance at 0x7f1ff39cb960>,39,12,[1 7],40,-1,52,-1,40
1,<environment.Job instance at 0x7f1ff39cbc30>,41,14,[1 7],42,-1,56,-1,42
1,<environment.Job instance at 0x7f1ff39cb410>,43,18,[2 6],44,-1,62,-1,44
1,<environment.Job instance at 0x7f1ff31fb8c0>,44,13,[1 6],45,-1,58,-1,45
1,<environment.Job instance at 0x7f1ff31fbb40>,47,18,[3 8],48,-1,66,-1,48
1,<environment.Job instance at 0x7f1ff31fbdc0>,49,15,[10  3],50,-1,65,-1,50
1,<environment.Job instance at 0x7f1ff31fb730>,51,17,[9 5],52,-1,69,-1,52
1,<environment.Job instance at 0x7f1ff31fb960>,52,19,[1 5],53,-1,72,-1,53
1,<environment.Job instance at 0x7f1ff31fb460>,55,16,[ 4 10],56,-1,72,-1,56
1,<environment.Job instance at 0x7f1ff31fb5a0>,58,16,[8 1],59,-1,75,-1,59
1,<environment.Job instance at 0x7f1ff31fba50>,59,14,[9 3],60,-1,74,-1,60
1,<environment.Job instance at 0x7f1ff31fb910>,60,12,[3 6],61,-1,74,-1,62
1,<environment.Job instance at 0x7f1ff2c86280>,62,12,[2 8],63,-1,75,-1,63
1,<environment.Job instance at 0x7f1ff2c86af0>,63,23,[5 6],64,-1,87,-1,64
1,<environment.Job instance at 0x7f1ff2c86460>,64,15,[5 2],65,-1,80,-1,65
1,<environment.Job instance at 0x7f1ff2c868c0>,65,14,[1 5],66,-1,80,-1,66
1,<environment.Job instance at 0x7f1ff2c86370>,68,28,[3 8],69,-1,97,-1,69
1,<environment.Job instance at 0x7f1ff2c869b0>,69,16,[ 5 10],70,-1,86,-1,70
1,<environment.Job instance at 0x7f1ff2c86c30>,70,13,[2 9],71,-1,84,-1,71
1,<environment.Job instance at 0x7f1ff31fb550>,61,14,[7 4],62,-1,86,-1,72
1,<environment.Job instance at 0x7f1ff2c86a50>,73,23,[5 7],74,-1,97,-1,74
1,<environment.Job instance at 0x7f1ff2c86f00>,74,28,[8 5],75,-1,103,-1,75
1,<environment.Job instance at 0x7f1ff2c86b90>,76,23,[3 7],77,-1,100,-1,77
1,<environment.Job instance at 0x7f1ff2c86870>,77,24,[2 9],78,-1,103,-1,79
1,<environment.Job instance at 0x7f1ff2c86a00>,78,17,[8 1],79,-1,96,-1,79
1,<environment.Job instance at 0x7f1ff35ee780>,80,15,[7 4],81,-1,96,-1,81
1,<environment.Job instance at 0x7f1ff35eecd0>,84,20,[1 9],85,-1,106,-1,86
1,<environment.Job instance at 0x7f1ff35eeb90>,91,16,[5 8],92,-1,108,-1,92
1,<environment.Job instance at 0x7f1ff35ee370>,93,26,[6 4],94,-1,120,-1,94
1,<environment.Job instance at 0x7f1ff35ee7d0>,95,12,[9 1],96,-1,108,-1,96
1,<environment.Job instance at 0x7f1ff3443050>,132,18,[3 8],133,-1,342,-1,324
1,<environment.Job instance at 0x7f1ffce37550>,143,1,[5 3],144,-1,325,-1,324
1,<environment.Job instance at 0x7f1ff3cecf00>,142,17,[7 2],143,-1,341,-1,324
1,<environment.Job instance at 0x7f1ff34cb230>,140,27,[7 2],141,-1,351,-1,324
1,<environment.Job instance at 0x7f1ff41eef50>,148,12,[12  3],149,-1,338,-1,326
1,<environment.Job instance at 0x7f1ff322d5a0>,149,12,[7 5],150,-1,338,-1,326
1,<environment.Job instance at 0x7f1ff2c2d8c0>,154,13,[2 9],155,-1,339,-1,326
1,<environment.Job instance at 0x7f1ff2ab8870>,153,13,[6 3],154,-1,339,-1,326
1,<environment.Job instance at 0x7f1ff37c11e0>,111,27,[7 5],112,-1,353,-1,326
1,<environment.Job instance at 0x7f1ff3215cd0>,155,12,[14  1],156,-1,375,-1,363
1,<environment.Job instance at 0x7f1ff410fa00>,168,21,[5 3],169,-1,384,-1,363
1,<environment.Job instance at 0x7f1ff3e3f5a0>,24,24,[5 9],25,-1,102,-1,78
1,<environment.Job instance at 0x7f1ff3f51500>,26,28,[9 5],27,-1,106,-1,78
1,<environment.Job instance at 0x7f1ff3ec40f0>,56,14,[14  5],57,-1,203,-1,189
1,<environment.Job instance at 0x7f1ff2d43960>,63,23,[5 6],64,-1,263,-1,240
1,<environment.Job instance at 0x7f1ff3a9ecd0>,68,28,[3 8],69,-1,282,-1,254
1,<environment.Job instance at 0x7f1ff2fbe280>,73,23,[5 7],74,-1,293,-1,270
1,<environment.Job instance at 0x7f1ff3dc0be0>,74,28,[8 5],75,-1,298,-1,270
1,<environment.Job instance at 0x7f1ff41f00f0>,76,23,[3 7],77,-1,294,-1,271
1,<environment.Job instance at 0x7f1ff41f07d0>,77,24,[2 9],78,-1,296,-1,272
1,<environment.Job instance at 0x7f1ff29def00>,82,23,[13  5],83,-1,308,-1,285
1,<environment.Job instance at 0x7f1ff29de500>,83,12,[ 4 13],84,-1,297,-1,285
1,<environment.Job instance at 0x7f1ff33faaf0>,87,20,[ 5 12],88,-1,320,-1,300
1,<environment.Job instance at 0x7f1ff39e9e10>,93,26,[6 4],94,-1,333,-1,307
1,<environment.Job instance at 0x7f1ff2e84910>,96,24,[10  1],97,-1,354,-1,330
1,<environment.Job instance at 0x7f1ff3fdabe0>,103,17,[11  1],104,-1,356,-1,339
1,<environment.Job instance at 0x7f1ff3fdaaf0>,105,16,[ 4 13],106,-1,355,-1,339
1,<environment.Job instance at 0x7f1ff37302d0>,106,26,[8 4],107,-1,372,-1,346
1,<environment.Job instance at 0x7f1ff37e4780>,108,18,[12  4],109,-1,364,-1,346
1,<environment.Job instance at 0x7f1ff3f19c30>,111,27,[7 5],112,-1,390,-1,363
1,<environment.Job instance at 0x7f1ff3d13be0>,117,15,[11  5],118,-1,392,-1,377
1,<environment.Job instance at 0x7f1ff3596af0>,121,3,[12  3],122,-1,393,-1,390
1,<environment.Job instance at 0x7f1ff2bcdd70>,122,3,[14  3],123,-1,393,-1,390
1,<environment.Job instance at 0x7f1ff2bcd780>,126,25,[6 1],127,-1,422,-1,397
1,<environment.Job instance at 0x7f1ff320ad20>,131,18,[ 3 12],132,-1,425,-1,407
1,<environment.Job instance at 0x7f1ff37f7820>,136,26,[8 5],137,-1,465,-1,439
1,<environment.Job instance at 0x7f1ff36de730>,140,27,[7 2],141,-1,477,-1,450
1,<environment.Job instance at 0x7f1ff36def00>,141,26,[ 5 11],142,-1,476,-1,450
1,<environment.Job instance at 0x7f1ff38cef00>,145,15,[ 5 13],146,-1,467,-1,452
1,<environment.Job instance at 0x7f1ff38ce820>,148,12,[12  3],149,-1,477,-1,465
1,<environment.Job instance at 0x7f1ff374cf00>,155,12,[14  1],156,-1,493,-1,481
1,<environment.Job instance at 0x7f1ff374c820>,157,16,[ 2 12],158,-1,497,-1,481
1,<environment.Job instance at 0x7f1ff32b7410>,159,2,[ 1 11],160,-1,496,-1,494
1,<environment.Job instance at 0x7f1ff2e08dc0>,1,21,[2 7],2,-1,24,-1,3
1,<environment.Job instance at 0x7f1ff2a37eb0>,2,17,[7 2],3,-1,20,-1,3
1,<environment.Job instance at 0x7f1ff37c8d70>,5,17,[6 3],6,-1,23,-1,6
1,<environment.Job instance at 0x7f1ff37c8910>,7,14,[9 4],8,-1,22,-1,8
1,<environment.Job instance at 0x7f1ff37c8500>,8,18,[8 3],9,-1,27,-1,9
1,<environment.Job instance at 0x7f1ff37c8b40>,9,16,[ 4 10],10,-1,26,-1,10
1,<environment.Job instance at 0x7f1ff3615280>,12,18,[3 8],13,-1,31,-1,13
1,<environment.Job instance at 0x7f1ff303b8c0>,15,25,[8 3],16,-1,41,-1,16
1,<environment.Job instance at 0x7f1ff303b6e0>,18,12,[ 2 12],19,-1,31,-1,19
1,<environment.Job instance at 0x7f1ff303b960>,19,1,[7 1],20,-1,21,-1,20
1,<environment.Job instance at 0x7f1ff3038fa0>,20,16,[5 1],21,-1,37,-1,21
1,<environment.Job instance at 0x7f1ff3038190>,21,2,[9 4],22,-1,24,-1,22
1,<environment.Job instance at 0x7f1ff3d11500>,22,1,[2 7],23,-1,24,-1,23
1,<environment.Job instance at 0x7f1ff32def50>,26,19,[4 6],27,-1,46,-1,27
1,<environment.Job instance at 0x7f1ff32de820>,27,17,[6 2],28,-1,45,-1,28
1,<environment.Job instance at 0x7f1ff32de410>,29,21,[ 5 10],30,-1,51,-1,30
1,<environment.Job instance at 0x7f1ff3a81f00>,31,18,[1 9],32,-1,50,-1,32
1,<environment.Job instance at 0x7f1ff35a0e60>,33,21,[5 5],34,-1,55,-1,34
1,<environment.Job instance at 0x7f1ff38d8870>,37,16,[6 5],38,-1,54,-1,38
1,<environment.Job instance at 0x7f1ff38d8d70>,38,12,[9 5],39,-1,52,-1,40
1,<environment.Job instance at 0x7f1ff38d80f0>,40,18,[9 1],41,-1,59,-1,41
1,<environment.Job instance at 0x7f1ff38d8370>,41,12,[7 5],42,-1,54,-1,42
1,<environment.Job instance at 0x7f1ff38d8a50>,42,3,[5 5],43,-1,46,-1,43
1,<environment.Job instance at 0x7f1ff38d8f00>,43,27,[4 6],44,-1,71,-1,44
1,<environment.Job instance at 0x7f1ff38d8f50>,44,14,[3 5],45,-1,59,-1,45
1,<environment.Job instance at 0x7f1ff38d8d20>,45,17,[10  2],46,-1,63,-1,46
1,<environment.Job instance at 0x7f1ff38d8960>,39,12,[ 5 10],40,-1,58,-1,46
1,<environment.Job instance at 0x7f1ff38d8190>,46,16,[ 5 10],47,-1,63,-1,47
1,<environment.Job instance at 0x7f1ff34f35a0>,55,13,[6 4],56,-1,69,-1,56
1,<environment.Job instance at 0x7f1ff34f3d70>,56,16,[4 8],57,-1,73,-1,57
1,<environment.Job instance at 0x7f1ff34f3820>,57,28,[8 2],58,-1,86,-1,58
1,<environment.Job instance at 0x7f1ff34f3e60>,58,22,[5 8],59,-1,81,-1,59
1,<environment.Job instance at 0x7f1ff34f34b0>,59,15,[8 3],60,-1,75,-1,60
1,<environment.Job instance at 0x7f1ff34f3be0>,60,18,[7 4],61,-1,79,-1,61
1,<environment.Job instance at 0x7f1ff320a550>,65,18,[5 9],66,-1,84,-1,66
1,<environment.Job instance at 0x7f1ff402e370>,67,18,[7 1],68,-1,88,-1,70
1,<environment.Job instance at 0x7f1ff2cf5960>,69,17,[6 3],70,-1,88,-1,71
1,<environment.Job instance at 0x7f1ff2cf53c0>,72,14,[10  1],73,-1,91,-1,77
1,<environment.Job instance at 0x7f1ff2ee00a0>,76,16,[3 5],77,-1,93,-1,77
1,<environment.Job instance at 0x7f1ff2b475a0>,77,14,[5 1],78,-1,93,-1,79
1,<environment.Job instance at 0x7f1ff2b479b0>,78,14,[6 1],79,-1,93,-1,79
1,<environment.Job instance at 0x7f1ff3dc0b90>,84,17,[7 5],85,-1,104,-1,87
1,<environment.Job instance at 0x7f1ffc8595a0>,86,21,[8 5],87,-1,108,-1,87
1,<environment.Job instance at 0x7f1ff381d960>,90,26,[6 1],91,-1,117,-1,91
1,<environment.Job instance at 0x7f1ff350a1e0>,96,12,[ 3 10],97,-1,112,-1,100
1,<environment.Job instance at 0x7f1ff3a493c0>,89,28,[3 6],90,-1,129,-1,101
1,<environment.Job instance at 0x7f1ff3205410>,106,20,[12  4],107,-1,141,-1,121
1,<environment.Job instance at 0x7f1ff3aa8320>,111,17,[10  4],112,-1,146,-1,129
1,<environment.Job instance at 0x7f1ff3aa86e0>,110,15,[13  3],111,-1,144,-1,129
1,<environment.Job instance at 0x7f1ff3e57870>,114,18,[6 3],115,-1,147,-1,129
1,<environment.Job instance at 0x7f1ff3e57b90>,115,26,[7 2],116,-1,155,-1,129
1,<environment.Job instance at 0x7f1ff3e57050>,119,25,[9 3],120,-1,167,-1,142
1,<environment.Job instance at 0x7f1ff350a640>,15,25,[8 3],16,-1,73,-1,48
1,<environment.Job instance at 0x7f1ff3205e10>,18,12,[ 2 12],19,-1,63,-1,51
1,<environment.Job instance at 0x7f1ff36de5a0>,43,27,[4 6],44,-1,145,-1,118
1,<environment.Job instance at 0x7f1ff37f7820>,50,3,[ 1 14],51,-1,152,-1,149
1,<environment.Job instance at 0x7f1ff2bcdeb0>,54,1,[ 2 11],55,-1,168,-1,167
1,<environment.Job instance at 0x7f1ff3596910>,57,28,[8 2],58,-1,205,-1,177
1,<environment.Job instance at 0x7f1ff37e4820>,61,28,[ 3 10],62,-1,218,-1,190
1,<environment.Job instance at 0x7f1ff2e84d70>,71,15,[14  2],72,-1,230,-1,215
1,<environment.Job instance at 0x7f1ff350d410>,81,12,[11  3],82,-1,260,-1,248
1,<environment.Job instance at 0x7f1ff343c640>,89,28,[3 6],90,-1,297,-1,269
1,<environment.Job instance at 0x7f1ff335b6e0>,90,26,[6 1],91,-1,295,-1,269
1,<environment.Job instance at 0x7f1ff335b320>,91,2,[ 4 13],92,-1,271,-1,269
1,<environment.Job instance at 0x7f1ff3e3f5a0>,99,24,[9 1],100,-1,326,-1,302
1,<environment.Job instance at 0x7f1ff3f519b0>,103,25,[3 7],104,-1,329,-1,304
1,<environment.Job instance at 0x7f1ff3f515f0>,104,13,[ 2 13],105,-1,317,-1,304
1,<environment.Job instance at 0x7f1ff35efb40>,106,20,[12  4],107,-1,324,-1,304
1,<environment.Job instance at 0x7f1ff35a0f00>,110,15,[13  3],111,-1,331,-1,316
1,<environment.Job instance at 0x7f1ff35eeeb0>,115,26,[7 2],116,-1,372,-1,346
1,<environment.Job instance at 0x7f1ff31fb1e0>,118,15,[13  1],119,-1,361,-1,346
1,<environment.Job instance at 0x7f1ff37d7e10>,119,25,[9 3],120,-1,384,-1,359
1,<environment.Job instance at 0x7f1ff3fc4230>,132,28,[9 5],133,-1,438,-1,410
1,<environment.Job instance at 0x7f1ff38d33c0>,147,28,[4 9],148,-1,498,-1,470
1,<environment.Job instance at 0x7f1ff38d3c30>,155,18,[ 5 11],156,-1,518,-1,500
1,<environment.Job instance at 0x7f1ff2e97b90>,161,26,[3 8],162,-1,539,-1,513
1,<environment.Job instance at 0x7f1ff2e97870>,163,17,[ 5 13],164,-1,530,-1,513
1,<environment.Job instance at 0x7f1ff2e970a0>,169,2,[ 1 14],170,-1,526,-1,524
1,<environment.Job instance at 0x7f1ff41d8e10>,174,24,[ 3 10],175,-1,568,-1,544
1,<environment.Job instance at 0x7f1ff41d8fa0>,178,24,[10  5],179,-1,596,-1,572
1,<environment.Job instance at 0x7f1ff2d20dc0>,3,19,[5 5],4,-1,23,-1,4
1,<environment.Job instance at 0x7f1ff2cae5f0>,4,16,[1 7],5,-1,21,-1,5
1,<environment.Job instance at 0x7f1ff2caec80>,8,15,[4 7],9,-1,24,-1,9
1,<environment.Job instance at 0x7f1ff2caeb40>,10,17,[9 5],11,-1,28,-1,11
1,<environment.Job instance at 0x7f1ff2cae910>,11,14,[5 4],12,-1,26,-1,12
1,<environment.Job instance at 0x7f1ff2cae640>,12,12,[1 5],13,-1,26,-1,14
1,<environment.Job instance at 0x7f1ff2cae410>,13,20,[1 7],14,-1,34,-1,14
1,<environment.Job instance at 0x7f1ff2cae050>,14,14,[9 2],15,-1,31,-1,17
1,<environment.Job instance at 0x7f1ff2ce0910>,16,28,[2 6],17,-1,45,-1,17
1,<environment.Job instance at 0x7f1ff2ce0f00>,17,15,[3 7],18,-1,33,-1,18
1,<environment.Job instance at 0x7f1ff2ce01e0>,19,26,[10  1],20,-1,46,-1,20
1,<environment.Job instance at 0x7f1ff2ce0050>,20,14,[6 3],21,-1,36,-1,22
1,<environment.Job instance at 0x7f1ff3499b40>,22,14,[2 8],23,-1,37,-1,23
1,<environment.Job instance at 0x7f1ff2cd2c80>,21,16,[9 2],22,-1,39,-1,23
1,<environment.Job instance at 0x7f1ff2cb9500>,25,16,[7 4],26,-1,42,-1,26
1,<environment.Job instance at 0x7f1ff2cb9e60>,29,18,[7 3],30,-1,48,-1,30
1,<environment.Job instance at 0x7f1ff2cc5910>,32,16,[1 7],33,-1,49,-1,33
1,<environment.Job instance at 0x7f1ff2c01050>,39,28,[ 4 10],40,-1,68,-1,40
1,<environment.Job instance at 0x7f1ff2c060a0>,34,13,[5 9],35,-1,54,-1,41
1,<environment.Job instance at 0x7f1ff2c01550>,43,13,[9 5],44,-1,58,-1,45
1,<environment.Job instance at 0x7f1ff2c01c30>,44,16,[14  4],45,-1,61,-1,45
1,<environment.Job instance at 0x7f1ff2c01eb0>,46,17,[9 2],47,-1,68,-1,51
1,<environment.Job instance at 0x7f1ff2c27f50>,50,18,[5 7],51,-1,69,-1,51
1,<environment.Job instance at 0x7f1ff2c27500>,52,14,[5 8],53,-1,67,-1,53
1,<environment.Job instance at 0x7f1ff2c270a0>,51,14,[1 9],52,-1,69,-1,55
1,<environment.Job instance at 0x7f1ff2a4fa00>,57,18,[10  1],58,-1,76,-1,58
1,<environment.Job instance at 0x7f1ff2a33b90>,59,17,[2 7],60,-1,77,-1,60
1,<environment.Job instance at 0x7f1ff2a33410>,60,23,[7 1],61,-1,84,-1,61
1,<environment.Job instance at 0x7f1ff2c012d0>,38,26,[5 7],39,-1,88,-1,62
1,<environment.Job instance at 0x7f1ff2a2a960>,61,17,[1 7],62,-1,79,-1,62
1,<environment.Job instance at 0x7f1ff2a2a8c0>,63,14,[7 3],64,-1,78,-1,64
1,<environment.Job instance at 0x7f1ff2bea500>,65,21,[5 2],66,-1,87,-1,66
1,<environment.Job instance at 0x7f1ff2bee0f0>,73,18,[5 9],74,-1,92,-1,74
1,<environment.Job instance at 0x7f1ff2cdfaf0>,58,14,[9 1],59,-1,101,-1,87
1,<environment.Job instance at 0x7f1ff2beea00>,82,18,[10  5],83,-1,106,-1,88
1,<environment.Job instance at 0x7f1ff2beeaa0>,83,17,[5 5],84,-1,106,-1,89
1,<environment.Job instance at 0x7f1ff2bee820>,78,27,[1 8],79,-1,151,-1,124
1,<environment.Job instance at 0x7f1ff2bf4c80>,102,21,[2 7],103,-1,182,-1,161
1,<environment.Job instance at 0x7f1ff2bf47d0>,99,16,[9 2],100,-1,178,-1,162
1,<environment.Job instance at 0x7f1ff2bf4d70>,104,17,[9 4],105,-1,179,-1,162
1,<environment.Job instance at 0x7f1ff2bf4c30>,109,14,[10  4],110,-1,372,-1,358
1,<environment.Job instance at 0x7f1ff2c11cd0>,143,17,[2 8],144,-1,375,-1,358
1,<environment.Job instance at 0x7f1ff2c11dc0>,145,14,[ 4 10],146,-1,372,-1,358
1,<environment.Job instance at 0x7f1ff2c11d70>,144,12,[6 1],145,-1,374,-1,362
1,<environment.Job instance at 0x7f1ff2bf4f00>,108,13,[5 6],109,-1,375,-1,362
1,<environment.Job instance at 0x7f1ff2c0a370>,153,16,[1 8],154,-1,378,-1,362
1,<environment.Job instance at 0x7f1ff2c0a410>,154,13,[8 5],155,-1,378,-1,365
1,<environment.Job instance at 0x7f1ff2c0a500>,156,15,[10  1],157,-1,380,-1,365
1,<environment.Job instance at 0x7f1ff2c0a5f0>,157,17,[2 7],158,-1,382,-1,365
1,<environment.Job instance at 0x7f1ff2c0a640>,158,15,[4 7],159,-1,380,-1,365
1,<environment.Job instance at 0x7f1ff2c0a7d0>,159,21,[2 7],160,-1,386,-1,365
1,<environment.Job instance at 0x7f1ff2c0ae60>,168,24,[7 5],169,-1,459,-1,435
1,<environment.Job instance at 0x7f1ff2c0aa00>,161,18,[2 8],162,-1,453,-1,435
1,<environment.Job instance at 0x7f1ff2bf4870>,15,3,[ 4 13],16,-1,40,-1,37
1,<environment.Job instance at 0x7f1ff2beba50>,16,28,[2 6],17,-1,76,-1,48
1,<environment.Job instance at 0x7f1ff2c11960>,19,26,[10  1],20,-1,80,-1,54
1,<environment.Job instance at 0x7f1ff2bf39b0>,27,16,[13  3],28,-1,98,-1,82
1,<environment.Job instance at 0x7f1ff2bf6870>,38,26,[5 7],39,-1,148,-1,122
1,<environment.Job instance at 0x7f1ff2b15140>,39,28,[ 4 10],40,-1,150,-1,122
1,<environment.Job instance at 0x7f1ff2b15870>,42,2,[ 4 11],43,-1,126,-1,124
1,<environment.Job instance at 0x7f1ff2b15fa0>,44,16,[14  4],45,-1,142,-1,126
1,<environment.Job instance at 0x7f1ff2b15c80>,45,23,[ 3 10],46,-1,159,-1,136
1,<environment.Job instance at 0x7f1ff2e97910>,60,23,[7 1],61,-1,225,-1,202
1,<environment.Job instance at 0x7f1ff38d3690>,71,13,[ 1 12],72,-1,251,-1,238
1,<environment.Job instance at 0x7f1ff38d3dc0>,79,3,[ 5 12],80,-1,267,-1,264
1,<environment.Job instance at 0x7f1ff38d30a0>,80,2,[ 5 14],81,-1,266,-1,264
1,<environment.Job instance at 0x7f1ff38d36e0>,78,27,[1 8],79,-1,300,-1,273
1,<environment.Job instance at 0x7f1ff3fc4370>,92,2,[13  4],93,-1,320,-1,318
1,<environment.Job instance at 0x7f1ff3c84a00>,94,14,[12  1],95,-1,333,-1,319
1,<environment.Job instance at 0x7f1ff3c84730>,98,3,[ 3 14],99,-1,338,-1,335
1,<environment.Job instance at 0x7f1ff39cbaa0>,100,3,[13  3],101,-1,338,-1,335
1,<environment.Job instance at 0x7f1ff35eedc0>,105,2,[13  4],106,-1,355,-1,353
1,<environment.Job instance at 0x7f1ff31fbbe0>,106,24,[7 1],107,-1,393,-1,369
1,<environment.Job instance at 0x7f1ff3f51fa0>,121,3,[ 5 11],122,-1,432,-1,429
1,<environment.Job instance at 0x7f1ff37f7aa0>,168,24,[7 5],169,-1,656,-1,632
1,<environment.Job instance at 0x7f1ff398f2d0>,0,18,[ 4 10],1,-1,19,-1,1
1,<environment.Job instance at 0x7f1ff334fcd0>,6,17,[10  3],7,-1,24,-1,7
1,<environment.Job instance at 0x7f1ff334ffa0>,7,25,[4 6],8,-1,33,-1,8
1,<environment.Job instance at 0x7f1ff3aa8f00>,8,17,[ 2 10],9,-1,26,-1,9
1,<environment.Job instance at 0x7f1ff3aa8050>,11,23,[10  1],12,-1,35,-1,12
1,<environment.Job instance at 0x7f1ff3aa8cd0>,12,14,[5 8],13,-1,27,-1,13
1,<environment.Job instance at 0x7f1ff3aa8460>,13,26,[10  2],14,-1,41,-1,15
1,<environment.Job instance at 0x7f1ff334feb0>,14,3,[ 3 12],15,-1,19,-1,16
1,<environment.Job instance at 0x7f1ff3aa8e60>,16,16,[ 1 10],17,-1,33,-1,17
1,<environment.Job instance at 0x7f1ff3eb8320>,21,24,[4 8],22,-1,46,-1,22
1,<environment.Job instance at 0x7f1ff3de2b90>,22,17,[5 8],23,-1,40,-1,23
1,<environment.Job instance at 0x7f1ff39fc410>,32,22,[10  1],33,-1,57,-1,35
1,<environment.Job instance at 0x7f1ff38b53c0>,34,23,[ 5 10],35,-1,58,-1,35
1,<environment.Job instance at 0x7f1ff38b5cd0>,37,18,[3 8],38,-1,58,-1,40
1,<environment.Job instance at 0x7f1ff3d6c050>,40,18,[5 4],41,-1,59,-1,41
1,<environment.Job instance at 0x7f1ff36e3730>,45,28,[1 7],46,-1,74,-1,46
1,<environment.Job instance at 0x7f1ff3cea230>,39,23,[1 5],40,-1,69,-1,46
1,<environment.Job instance at 0x7f1ff36e36e0>,47,17,[10  5],48,-1,65,-1,48
1,<environment.Job instance at 0x7f1ff3c2a870>,51,18,[5 5],52,-1,70,-1,52
1,<environment.Job instance at 0x7f1ff37fb320>,53,18,[5 4],54,-1,72,-1,54
1,<environment.Job instance at 0x7f1ff29354b0>,54,16,[10  1],55,-1,72,-1,56
1,<environment.Job instance at 0x7f1ff2935af0>,56,18,[3 7],57,-1,75,-1,57
1,<environment.Job instance at 0x7f1ff2935960>,57,16,[7 4],58,-1,74,-1,58
1,<environment.Job instance at 0x7f1ff310cdc0>,65,15,[10  1],66,-1,82,-1,67
1,<environment.Job instance at 0x7f1ff37dd910>,28,13,[12  1],29,-1,80,-1,67
1,<environment.Job instance at 0x7f1ff310c5f0>,63,17,[ 1 10],64,-1,84,-1,67
1,<environment.Job instance at 0x7f1ff310c7d0>,66,18,[9 4],67,-1,96,-1,78
1,<environment.Job instance at 0x7f1ff3ce0730>,75,12,[2 9],76,-1,90,-1,78
1,<environment.Job instance at 0x7f1ff2e5f6e0>,64,16,[10  1],65,-1,94,-1,78
1,<environment.Job instance at 0x7f1ff374c280>,69,15,[2 8],70,-1,113,-1,98
1,<environment.Job instance at 0x7f1ffc88b0f0>,85,16,[7 5],86,-1,114,-1,98
1,<environment.Job instance at 0x7f1ff2938910>,80,13,[10  1],81,-1,111,-1,98
1,<environment.Job instance at 0x7f1ffc888780>,87,18,[10  1],88,-1,116,-1,98
1,<environment.Job instance at 0x7f1ff2e6c820>,93,23,[10  4],94,-1,130,-1,107
1,<environment.Job instance at 0x7f1ff2e6c1e0>,94,19,[ 5 10],95,-1,126,-1,107
1,<environment.Job instance at 0x7f1ffc84be60>,92,18,[4 9],93,-1,143,-1,125
1,<environment.Job instance at 0x7f1ff374c050>,70,26,[4 7],71,-1,151,-1,125
1,<environment.Job instance at 0x7f1ff3d11eb0>,103,15,[10  4],104,-1,140,-1,125
1,<environment.Job instance at 0x7f1ff32f4960>,89,14,[5 7],90,-1,139,-1,125
1,<environment.Job instance at 0x7f1ff382a870>,106,15,[7 4],107,-1,140,-1,125
1,<environment.Job instance at 0x7f1ff381d370>,107,18,[12  3],108,-1,144,-1,126
1,<environment.Job instance at 0x7f1ff3d11f00>,104,24,[1 8],105,-1,153,-1,129
1,<environment.Job instance at 0x7f1ff3ac0320>,102,17,[1 6],103,-1,147,-1,130
1,<environment.Job instance at 0x7f1ff3d6c780>,43,25,[10  1],44,-1,196,-1,171
1,<environment.Job instance at 0x7f1ff381da00>,121,18,[3 9],122,-1,189,-1,171
1,<environment.Job instance at 0x7f1ff381d190>,109,17,[4 9],110,-1,188,-1,171
1,<environment.Job instance at 0x7f1ff33da820>,127,26,[3 6],128,-1,197,-1,171
1,<environment.Job instance at 0x7f1ff344f960>,128,18,[1 5],129,-1,189,-1,171
1,<environment.Job instance at 0x7f1ff344f4b0>,129,25,[ 1 10],130,-1,196,-1,171
1,<environment.Job instance at 0x7f1ff31cb0a0>,126,17,[14  3],127,-1,196,-1,179
1,<environment.Job instance at 0x7f1ff2aa27d0>,136,17,[7 2],137,-1,197,-1,180
1,<environment.Job instance at 0x7f1ff41951e0>,150,18,[10  1],151,-1,299,-1,281
1,<environment.Job instance at 0x7f1ff37e4fa0>,159,18,[ 3 10],160,-1,331,-1,313
1,<environment.Job instance at 0x7f1ff37e4500>,157,15,[9 4],158,-1,328,-1,313
1,<environment.Job instance at 0x7f1ff37e48c0>,168,13,[ 2 14],169,-1,326,-1,313
1,<environment.Job instance at 0x7f1ff37e4dc0>,169,13,[2 9],170,-1,327,-1,314
1,<environment.Job instance at 0x7f1ff37e4c80>,166,18,[4 9],167,-1,332,-1,314
1,<environment.Job instance at 0x7f1ff381de60>,112,26,[2 5],113,-1,340,-1,314
1,<environment.Job instance at 0x7f1ff3e57a00>,173,16,[7 5],174,-1,330,-1,314
1,<environment.Job instance at 0x7f1ff3e572d0>,174,15,[5 6],175,-1,329,-1,314
1,<environment.Job instance at 0x7f1ff37e4280>,167,12,[4 8],168,-1,326,-1,314
1,<environment.Job instance at 0x7f1ff3e57690>,176,17,[5 4],177,-1,331,-1,314
1,<environment.Job instance at 0x7f1ff3e57a50>,177,16,[ 2 10],178,-1,330,-1,314
1,<environment.Job instance at 0x7f1ff4195690>,153,24,[ 4 10],154,-1,338,-1,314
1,<environment.Job instance at 0x7f1ff3e57f50>,172,17,[2 8],173,-1,331,-1,314
1,<environment.Job instance at 0x7f1ff2aa25a0>,7,25,[4 6],8,-1,44,-1,19
1,<environment.Job instance at 0x7f1ff3e57e60>,11,23,[10  1],12,-1,47,-1,24
1,<environment.Job instance at 0x7f1ff2e09c30>,14,3,[ 3 12],15,-1,27,-1,24
1,<environment.Job instance at 0x7f1ff3e571e0>,13,26,[10  2],14,-1,50,-1,24
1,<environment.Job instance at 0x7f1ff3974c80>,21,24,[4 8],22,-1,59,-1,35
1,<environment.Job instance at 0x7f1ff398ff00>,23,2,[12  5],24,-1,37,-1,35
1,<environment.Job instance at 0x7f1ff398fbe0>,25,14,[ 2 11],26,-1,64,-1,50
1,<environment.Job instance at 0x7f1ff2afee10>,28,13,[12  1],29,-1,64,-1,51
1,<environment.Job instance at 0x7f1ff2b15870>,34,23,[ 5 10],35,-1,91,-1,68
1,<environment.Job instance at 0x7f1ff2b15280>,35,16,[13  5],36,-1,84,-1,68
1,<environment.Job instance at 0x7f1ff2bf6870>,39,23,[1 5],40,-1,92,-1,69
1,<environment.Job instance at 0x7f1ff2c0a690>,43,25,[10  1],44,-1,121,-1,96
1,<environment.Job instance at 0x7f1ff2c11500>,46,15,[ 3 12],47,-1,111,-1,96
1,<environment.Job instance at 0x7f1ff2c115a0>,45,28,[1 7],46,-1,133,-1,105
1,<environment.Job instance at 0x7f1ff2e59780>,62,14,[11  2],63,-1,183,-1,169
1,<environment.Job instance at 0x7f1ffcc00050>,67,23,[1 8],68,-1,211,-1,188
1,<environment.Job instance at 0x7f1ff3df4c30>,70,26,[4 7],71,-1,229,-1,203
1,<environment.Job instance at 0x7f1ff3125690>,93,23,[10  4],94,-1,313,-1,290
1,<environment.Job instance at 0x7f1ff35337d0>,98,12,[11  4],99,-1,302,-1,290
1,<environment.Job instance at 0x7f1ff2aa46e0>,104,24,[1 8],105,-1,350,-1,326
1,<environment.Job instance at 0x7f1ff37dd690>,107,18,[12  3],108,-1,344,-1,326
1,<environment.Job instance at 0x7f1ffc8a1aa0>,112,26,[2 5],113,-1,372,-1,346
1,<environment.Job instance at 0x7f1ff2924b40>,113,12,[12  2],114,-1,358,-1,346
1,<environment.Job instance at 0x7f1ff2d22dc0>,118,1,[13  1],119,-1,372,-1,371
1,<environment.Job instance at 0x7f1ff3542cd0>,126,17,[14  3],127,-1,408,-1,391
1,<environment.Job instance at 0x7f1ff2a086e0>,127,26,[3 6],128,-1,419,-1,393
1,<environment.Job instance at 0x7f1ff37dac30>,129,25,[ 1 10],130,-1,433,-1,408
1,<environment.Job instance at 0x7f1ff41b29b0>,134,2,[13  2],135,-1,415,-1,413
1,<environment.Job instance at 0x7f1ff35e1c30>,138,1,[ 4 12],139,-1,430,-1,429
1,<environment.Job instance at 0x7f1ff4261d70>,153,24,[ 4 10],154,-1,518,-1,494
1,<environment.Job instance at 0x7f1ff2f8deb0>,168,13,[ 2 14],169,-1,572,-1,559
1,<environment.Job instance at 0x7f1ff2b11870>,170,3,[ 3 14],171,-1,563,-1,560
1,<environment.Job instance at 0x7f1ff2b87050>,0,16,[9 1],1,-1,22,-1,6
1,<environment.Job instance at 0x7f1ff3b98d70>,7,14,[5 1],8,-1,22,-1,8
1,<environment.Job instance at 0x7f1ff3b98190>,10,18,[5 8],11,-1,29,-1,11
1,<environment.Job instance at 0x7f1ff3b98eb0>,5,14,[1 8],6,-1,34,-1,20
1,<environment.Job instance at 0x7f1ff29372d0>,20,1,[5 2],21,-1,26,-1,25
1,<environment.Job instance at 0x7f1ff3b3b050>,24,18,[10  3],25,-1,47,-1,29
1,<environment.Job instance at 0x7f1ff303e8c0>,14,17,[4 7],15,-1,46,-1,29
1,<environment.Job instance at 0x7f1ff3846d20>,19,16,[7 4],20,-1,45,-1,29
1,<environment.Job instance at 0x7f1ff32067d0>,31,17,[9 3],32,-1,50,-1,33
1,<environment.Job instance at 0x7f1ff3786c80>,32,20,[ 1 10],33,-1,53,-1,33
1,<environment.Job instance at 0x7f1ff2a375a0>,33,3,[10  5],34,-1,37,-1,34
1,<environment.Job instance at 0x7f1ff3786cd0>,27,15,[2 8],28,-1,50,-1,35
1,<environment.Job instance at 0x7f1ff39d91e0>,23,14,[2 9],24,-1,49,-1,35
1,<environment.Job instance at 0x7f1ff2b6b320>,36,19,[4 8],37,-1,59,-1,40
1,<environment.Job instance at 0x7f1ff3461eb0>,38,15,[1 9],39,-1,65,-1,50
1,<environment.Job instance at 0x7f1ff3818cd0>,30,15,[ 4 10],31,-1,66,-1,51
1,<environment.Job instance at 0x7f1ff3a7dbe0>,51,3,[5 4],52,-1,55,-1,52
1,<environment.Job instance at 0x7f1ff34613c0>,39,17,[4 9],40,-1,69,-1,52
1,<environment.Job instance at 0x7f1ff416b6e0>,49,17,[8 2],50,-1,69,-1,52
1,<environment.Job instance at 0x7f1ff3a7d4b0>,50,16,[6 5],51,-1,68,-1,52
1,<environment.Job instance at 0x7f1ff3a7d910>,53,16,[3 5],54,-1,71,-1,55
1,<environment.Job instance at 0x7f1ff3a7d280>,54,23,[5 9],55,-1,78,-1,55
1,<environment.Job instance at 0x7f1ff3222820>,55,16,[1 6],56,-1,73,-1,57
1,<environment.Job instance at 0x7f1ff3222f00>,57,23,[6 2],58,-1,82,-1,59
1,<environment.Job instance at 0x7f1ff35e18c0>,60,26,[6 1],61,-1,87,-1,61
1,<environment.Job instance at 0x7f1ff35e1550>,62,17,[5 5],63,-1,80,-1,63
1,<environment.Job instance at 0x7f1ff3222460>,58,15,[5 6],59,-1,85,-1,70
1,<environment.Job instance at 0x7f1ff37897d0>,70,18,[5 7],71,-1,89,-1,71
1,<environment.Job instance at 0x7f1ff3789460>,73,19,[8 3],74,-1,93,-1,74
1,<environment.Job instance at 0x7f1ff3e9c7d0>,63,14,[ 4 13],64,-1,92,-1,78
1,<environment.Job instance at 0x7f1ff3789cd0>,72,16,[1 9],73,-1,102,-1,86
1,<environment.Job instance at 0x7f1ff3789960>,74,17,[12  2],75,-1,103,-1,86
1,<environment.Job instance at 0x7f1ff3533870>,77,17,[8 4],78,-1,103,-1,86
1,<environment.Job instance at 0x7f1ff41b5d20>,75,15,[9 3],76,-1,102,-1,87
1,<environment.Job instance at 0x7f1ff35335f0>,79,26,[5 8],80,-1,113,-1,87
1,<environment.Job instance at 0x7f1ff3215f00>,81,16,[1 8],82,-1,103,-1,87
1,<environment.Job instance at 0x7f1ff33da690>,85,20,[5 5],86,-1,107,-1,87
1,<environment.Job instance at 0x7f1ff42b14b0>,86,17,[12  5],87,-1,104,-1,87
1,<environment.Job instance at 0x7f1ff3853500>,83,14,[2 7],84,-1,106,-1,92
1,<environment.Job instance at 0x7f1ff3b0b280>,92,17,[9 3],93,-1,112,-1,95
1,<environment.Job instance at 0x7f1ff3b0bcd0>,93,14,[3 7],94,-1,109,-1,95
1,<environment.Job instance at 0x7f1ff33dac80>,84,14,[13  2],85,-1,109,-1,95
1,<environment.Job instance at 0x7f1ff4033d20>,95,16,[10  4],96,-1,112,-1,96
1,<environment.Job instance at 0x7f1ff41b5b40>,78,18,[6 5],79,-1,115,-1,97
1,<environment.Job instance at 0x7f1ffc8a1be0>,99,14,[10  3],100,-1,114,-1,100
1,<environment.Job instance at 0x7f1ff351fd70>,100,23,[ 1 10],101,-1,124,-1,101
1,<environment.Job instance at 0x7f1ff40c1fa0>,18,19,[5 8],19,-1,124,-1,105
1,<environment.Job instance at 0x7f1ff3a92a00>,103,17,[6 4],104,-1,123,-1,106
1,<environment.Job instance at 0x7f1ffc896c80>,96,13,[ 4 10],97,-1,120,-1,107
1,<environment.Job instance at 0x7f1ff3a92b90>,104,16,[9 2],105,-1,127,-1,111
1,<environment.Job instance at 0x7f1ff3e4aaf0>,89,18,[3 6],90,-1,129,-1,111
1,<environment.Job instance at 0x7f1ff2a1e7d0>,109,28,[9 4],110,-1,139,-1,111
1,<environment.Job instance at 0x7f1ff36dc640>,124,18,[10  1],125,-1,143,-1,125
1,<environment.Job instance at 0x7f1ff36dc2d0>,125,16,[5 9],126,-1,142,-1,126
1,<environment.Job instance at 0x7f1ff36dc320>,126,17,[7 4],127,-1,147,-1,130
1,<environment.Job instance at 0x7f1ff38550a0>,9,15,[12  2],10,-1,25,-1,10
1,<environment.Job instance at 0x7f1ff2f1c460>,17,25,[1 7],18,-1,53,-1,28
1,<environment.Job instance at 0x7f1ff2f1c140>,21,2,[ 5 11],22,-1,32,-1,30
1,<environment.Job instance at 0x7f1ffc8a1e10>,25,3,[ 3 11],26,-1,43,-1,40
1,<environment.Job instance at 0x7f1ff398ff00>,37,2,[14  5],38,-1,92,-1,90
1,<environment.Job instance at 0x7f20186d8c30>,42,14,[14  2],43,-1,120,-1,106
1,<environment.Job instance at 0x7f1ff3ccf0a0>,45,1,[ 5 13],46,-1,111,-1,110
1,<environment.Job instance at 0x7f1ff331a5f0>,46,27,[6 1],47,-1,138,-1,111
1,<environment.Job instance at 0x7f1ff2beb370>,54,23,[5 9],55,-1,154,-1,131
1,<environment.Job instance at 0x7f1ffce37e60>,57,23,[6 2],58,-1,156,-1,133
1,<environment.Job instance at 0x7f1ff3406960>,60,26,[6 1],61,-1,174,-1,148
1,<environment.Job instance at 0x7f1ffc889820>,63,14,[ 4 13],64,-1,163,-1,149
1,<environment.Job instance at 0x7f1ff2f5d500>,71,14,[13  1],72,-1,192,-1,178
1,<environment.Job instance at 0x7f1ff2916910>,74,17,[12  2],75,-1,210,-1,193
1,<environment.Job instance at 0x7f1ff314e320>,79,26,[5 8],80,-1,238,-1,212
1,<environment.Job instance at 0x7f1ff3130fa0>,84,14,[13  2],85,-1,240,-1,226
1,<environment.Job instance at 0x7f1ff31300f0>,86,17,[12  5],87,-1,246,-1,229
1,<environment.Job instance at 0x7f1ff40325f0>,98,14,[14  2],99,-1,303,-1,289
1,<environment.Job instance at 0x7f1ff2d0bb40>,100,23,[ 1 10],101,-1,325,-1,302
1,<environment.Job instance at 0x7f1ff2b906e0>,109,28,[9 4],110,-1,366,-1,338
1,<environment.Job instance at 0x7f1ff3c9e230>,115,15,[13  2],116,-1,356,-1,341
1,<environment.Job instance at 0x7f1ff2b76be0>,129,28,[8 2],130,-1,405,-1,377
1,<environment.Job instance at 0x7f1ff335dfa0>,132,23,[4 7],133,-1,421,-1,398
1,<environment.Job instance at 0x7f1ff2daf780>,134,28,[3 5],135,-1,426,-1,398
1,<environment.Job instance at 0x7f1ff2daf190>,138,3,[11  1],139,-1,404,-1,401
1,<environment.Job instance at 0x7f1ff2daf320>,139,3,[12  3],140,-1,404,-1,401
1,<environment.Job instance at 0x7f1ff37ce280>,151,24,[ 3 10],152,-1,476,-1,452
1,<environment.Job instance at 0x7f1ff37ced20>,153,26,[5 1],154,-1,487,-1,461
1,<environment.Job instance at 0x7f1ff2c962d0>,159,3,[11  2],160,-1,486,-1,483
1,<environment.Job instance at 0x7f1ff36c4640>,162,27,[6 5],163,-1,516,-1,489
1,<environment.Job instance at 0x7f1ff408d8c0>,166,15,[ 1 11],167,-1,517,-1,502
1,<environment.Job instance at 0x7f1ff37203c0>,6,24,[1 8],7,-1,31,-1,7
1,<environment.Job instance at 0x7f1ff3cea5f0>,8,14,[9 1],9,-1,24,-1,10
1,<environment.Job instance at 0x7f1ff3ceaa50>,10,13,[8 3],11,-1,24,-1,11
1,<environment.Job instance at 0x7f1ff3cea2d0>,11,14,[ 2 10],12,-1,26,-1,12
1,<environment.Job instance at 0x7f1ff3ceaeb0>,12,18,[7 1],13,-1,31,-1,13
1,<environment.Job instance at 0x7f1ffcef5b40>,16,15,[4 6],17,-1,32,-1,17
1,<environment.Job instance at 0x7f1ff3ceaaa0>,17,18,[ 1 10],18,-1,36,-1,18
1,<environment.Job instance at 0x7f1ff3112d20>,19,27,[10  2],20,-1,47,-1,20
1,<environment.Job instance at 0x7f1ff3e0d1e0>,23,17,[6 2],24,-1,42,-1,25
1,<environment.Job instance at 0x7f1ff3e0de60>,24,18,[10  1],25,-1,43,-1,25
1,<environment.Job instance at 0x7f1ff3e0daa0>,25,13,[10  1],26,-1,40,-1,27
1,<environment.Job instance at 0x7f1ff3e0daf0>,26,18,[7 3],27,-1,45,-1,27
1,<environment.Job instance at 0x7f1ff3e0d320>,28,18,[5 7],29,-1,47,-1,29
1,<environment.Job instance at 0x7f1ff3c209b0>,29,18,[8 1],30,-1,49,-1,31
1,<environment.Job instance at 0x7f1ff3c207d0>,32,13,[10  1],33,-1,46,-1,33
1,<environment.Job instance at 0x7f1ff3c20140>,33,16,[ 2 10],34,-1,50,-1,34
1,<environment.Job instance at 0x7f1ff3e0dd70>,30,15,[1 7],31,-1,51,-1,36
1,<environment.Job instance at 0x7f1ff32067d0>,36,17,[10  5],37,-1,55,-1,38
1,<environment.Job instance at 0x7f1ff3206b40>,38,13,[8 3],39,-1,52,-1,39
1,<environment.Job instance at 0x7f1ff3206370>,41,13,[7 1],42,-1,55,-1,42
1,<environment.Job instance at 0x7f1ff3206e10>,43,13,[8 3],44,-1,57,-1,44
1,<environment.Job instance at 0x7f1ff3206690>,45,22,[11  3],46,-1,68,-1,46
1,<environment.Job instance at 0x7f1ff3206f50>,47,17,[10  3],48,-1,65,-1,48
1,<environment.Job instance at 0x7f1ff3206780>,37,14,[7 3],38,-1,62,-1,48
1,<environment.Job instance at 0x7f1ff3206d20>,50,1,[7 1],51,-1,52,-1,51
1,<environment.Job instance at 0x7f1ff3da6d20>,51,17,[4 8],52,-1,69,-1,52
1,<environment.Job instance at 0x7f1ff3da6690>,52,16,[7 3],53,-1,69,-1,53
1,<environment.Job instance at 0x7f1ff3da64b0>,53,12,[1 6],54,-1,66,-1,54
1,<environment.Job instance at 0x7f1ff3da6cd0>,55,1,[3 9],56,-1,57,-1,56
1,<environment.Job instance at 0x7f1ff398f370>,57,1,[5 9],58,-1,59,-1,58
1,<environment.Job instance at 0x7f1ff398f280>,58,12,[2 6],59,-1,71,-1,59
1,<environment.Job instance at 0x7f1ff398f690>,59,2,[7 3],60,-1,62,-1,60
1,<environment.Job instance at 0x7f1ff398f0f0>,63,27,[5 1],64,-1,91,-1,64
1,<environment.Job instance at 0x7f1ff3206a50>,49,1,[5 4],50,-1,66,-1,65
1,<environment.Job instance at 0x7f1ff398f500>,65,15,[1 7],66,-1,81,-1,66
1,<environment.Job instance at 0x7f1ff398fa50>,67,1,[ 1 13],68,-1,70,-1,69
1,<environment.Job instance at 0x7f1ffc886550>,74,28,[6 4],75,-1,104,-1,76
1,<environment.Job instance at 0x7f1ff2b1c410>,78,16,[10  1],79,-1,95,-1,79
1,<environment.Job instance at 0x7f1ff2b1c4b0>,80,16,[3 9],81,-1,97,-1,81
1,<environment.Job instance at 0x7f1ffc8e9a50>,81,22,[6 1],82,-1,104,-1,82
1,<environment.Job instance at 0x7f1ffc8e9d70>,82,14,[3 6],83,-1,97,-1,83
1,<environment.Job instance at 0x7f1ffc8e9140>,83,17,[7 3],84,-1,101,-1,84
1,<environment.Job instance at 0x7f1ffc886b90>,75,12,[9 2],76,-1,96,-1,84
1,<environment.Job instance at 0x7f1ff2b1cc30>,84,18,[ 3 10],85,-1,104,-1,86
1,<environment.Job instance at 0x7f1ffc888230>,85,17,[7 2],86,-1,103,-1,86
1,<environment.Job instance at 0x7f1ff344f8c0>,89,14,[9 2],90,-1,106,-1,92
1,<environment.Job instance at 0x7f1ff344f550>,91,14,[9 5],92,-1,106,-1,92
1,<environment.Job instance at 0x7f1ff3206aa0>,6,24,[1 8],7,-1,31,-1,7
1,<environment.Job instance at 0x7f1ff3fbed20>,19,27,[10  2],20,-1,84,-1,57
1,<environment.Job instance at 0x7f1ff3720eb0>,21,23,[11  3],22,-1,80,-1,57
1,<environment.Job instance at 0x7f1ff3347f00>,45,22,[11  3],46,-1,192,-1,170
1,<environment.Job instance at 0x7f1ff37e1d20>,46,1,[ 5 12],47,-1,171,-1,170
1,<environment.Job instance at 0x7f1ff4039a00>,48,28,[11  3],49,-1,202,-1,174
1,<environment.Job instance at 0x7f1ff4032af0>,61,14,[14  2],62,-1,218,-1,204
1,<environment.Job instance at 0x7f1ff40329b0>,63,27,[5 1],64,-1,233,-1,206
1,<environment.Job instance at 0x7f1ffc809a50>,67,1,[ 1 13],68,-1,211,-1,210
1,<environment.Job instance at 0x7f1ffc809e10>,66,23,[2 9],67,-1,248,-1,225
1,<environment.Job instance at 0x7f1ff2e84640>,73,12,[ 2 13],74,-1,241,-1,229
1,<environment.Job instance at 0x7f1ff2e84eb0>,74,28,[6 4],75,-1,259,-1,231
1,<environment.Job instance at 0x7f1ff34068c0>,93,15,[ 5 11],94,-1,328,-1,313
1,<environment.Job instance at 0x7f1ff3dacc80>,100,14,[13  1],101,-1,356,-1,342
1,<environment.Job instance at 0x7f1ff398f230>,105,24,[ 3 10],106,-1,394,-1,370
1,<environment.Job instance at 0x7f1ff3f32a50>,112,27,[1 6],113,-1,428,-1,401
1,<environment.Job instance at 0x7f1ff34ffdc0>,114,14,[ 5 14],115,-1,415,-1,401
1,<environment.Job instance at 0x7f1ff34ff7d0>,115,1,[14  5],116,-1,402,-1,401
1,<environment.Job instance at 0x7f1ff385e9b0>,117,27,[8 2],118,-1,430,-1,403
1,<environment.Job instance at 0x7f1ff3db4910>,120,1,[ 5 12],121,-1,405,-1,404
1,<environment.Job instance at 0x7f1ff321eb40>,128,23,[13  2],129,-1,471,-1,448
1,<environment.Job instance at 0x7f1ff2a8c550>,140,14,[ 5 11],141,-1,502,-1,488
1,<environment.Job instance at 0x7f1ff2a8cfa0>,139,26,[8 1],140,-1,524,-1,498
1,<environment.Job instance at 0x7f1ff2a8cc80>,142,27,[1 6],143,-1,525,-1,498
1,<environment.Job instance at 0x7f1ff2a8c960>,143,26,[8 1],144,-1,524,-1,498
1,<environment.Job instance at 0x7f1ff3320550>,152,25,[10  4],153,-1,549,-1,524
1,<environment.Job instance at 0x7f1ff3320820>,159,13,[13  3],160,-1,544,-1,531
1,<environment.Job instance at 0x7f1ff3320cd0>,160,14,[ 5 14],161,-1,545,-1,531
1,<environment.Job instance at 0x7f1ff3320960>,161,28,[3 5],162,-1,559,-1,531
1,<environment.Job instance at 0x7f1ff36e3280>,164,1,[ 1 13],165,-1,533,-1,532
1,<environment.Job instance at 0x7faa778096e0>,0,13,[9 3],1,-1,15,-1,2
1,<environment.Job instance at 0x7faa778098c0>,1,22,[11  3],2,-1,24,-1,2
1,<environment.Job instance at 0x7faa77809730>,2,22,[4 8],3,-1,25,-1,3
1,<environment.Job instance at 0x7faa6e219fa0>,9,18,[11  5],10,-1,28,-1,10
1,<environment.Job instance at 0x7faa6e21c0f0>,11,15,[4 8],12,-1,27,-1,12
1,<environment.Job instance at 0x7faa6e21c230>,13,18,[ 4 10],14,-1,32,-1,14
1,<environment.Job instance at 0x7faa6e21c3c0>,14,13,[7 3],15,-1,29,-1,16
1,<environment.Job instance at 0x7faa6e219f50>,15,18,[2 8],16,-1,34,-1,16
1,<environment.Job instance at 0x7faa6e21c460>,16,16,[3 5],17,-1,33,-1,17
1,<environment.Job instance at 0x7faa6e21cb40>,24,18,[2 6],25,-1,46,-1,28
1,<environment.Job instance at 0x7faa6e21ce10>,27,15,[8 4],28,-1,43,-1,28
1,<environment.Job instance at 0x7faa6e21cfa0>,28,23,[10  4],29,-1,53,-1,30
1,<environment.Job instance at 0x7faa6e21f3c0>,34,24,[1 8],35,-1,59,-1,35
1,<environment.Job instance at 0x7faa6e21f5a0>,35,15,[9 5],36,-1,51,-1,36
1,<environment.Job instance at 0x7faa6e21f460>,36,13,[ 3 14],37,-1,72,-1,59
1,<environment.Job instance at 0x7faa6e21fc30>,41,1,[5 2],42,-1,60,-1,59
1,<environment.Job instance at 0x7faa6e21fd70>,46,17,[12  2],47,-1,79,-1,62
1,<environment.Job instance at 0x7faa6e21fdc0>,43,18,[5 5],44,-1,80,-1,62
1,<environment.Job instance at 0x7faa6e222460>,50,16,[12  2],51,-1,78,-1,62
1,<environment.Job instance at 0x7faa6e222500>,53,17,[5 7],54,-1,80,-1,63
1,<environment.Job instance at 0x7faa6e2226e0>,56,17,[8 5],57,-1,82,-1,65
1,<environment.Job instance at 0x7faa6e222140>,48,15,[10  1],49,-1,80,-1,65
1,<environment.Job instance at 0x7faa6e222870>,57,18,[2 8],58,-1,83,-1,65
1,<environment.Job instance at 0x7faa6e21caa0>,23,27,[1 6],24,-1,100,-1,73
1,<environment.Job instance at 0x7faa6e222c80>,62,22,[6 4],63,-1,95,-1,73
1,<environment.Job instance at 0x7faa6e224dc0>,82,16,[ 4 10],83,-1,300,-1,284
1,<environment.Job instance at 0x7faa6e224fa0>,85,17,[3 9],86,-1,304,-1,287
1,<environment.Job instance at 0x7faa6e2240a0>,67,27,[ 1 10],68,-1,320,-1,293
1,<environment.Job instance at 0x7faa6e224f00>,84,18,[3 7],85,-1,311,-1,293
1,<environment.Job instance at 0x7faa6e227280>,89,14,[5 3],90,-1,307,-1,293
1,<environment.Job instance at 0x7faa6e227460>,92,20,[1 5],93,-1,313,-1,293
1,<environment.Job instance at 0x7faa6e227640>,95,15,[5 7],96,-1,308,-1,293
1,<environment.Job instance at 0x7faa6e224e60>,83,20,[7 1],84,-1,313,-1,293
1,<environment.Job instance at 0x7faa6e2278c0>,99,18,[12  5],100,-1,311,-1,293
1,<environment.Job instance at 0x7faa6e227960>,100,18,[2 7],101,-1,311,-1,293
1,<environment.Job instance at 0x7faa6e227a00>,101,18,[ 1 10],102,-1,311,-1,293
1,<environment.Job instance at 0x7faa6e227aa0>,102,16,[3 9],103,-1,309,-1,293
1,<environment.Job instance at 0x7faa6e227b40>,103,16,[1 6],104,-1,309,-1,293
1,<environment.Job instance at 0x7faa6e227be0>,104,15,[1 9],105,-1,308,-1,293
1,<environment.Job instance at 0x7faa6e227d20>,106,15,[11  1],107,-1,308,-1,293
1,<environment.Job instance at 0x7faa6e227dc0>,107,17,[9 3],108,-1,310,-1,293
1,<environment.Job instance at 0x7faa6e22a0a0>,111,26,[ 5 10],112,-1,320,-1,294
1,<environment.Job instance at 0x7faa6e22a1e0>,113,15,[6 1],114,-1,310,-1,295
1,<environment.Job instance at 0x7faa6e22a320>,115,16,[7 5],116,-1,311,-1,295
1,<environment.Job instance at 0x7faa6e270b90>,119,20,[2 6],120,-1,318,-1,298
1,<environment.Job instance at 0x7faa6e210730>,124,1,[8 4],125,-1,301,-1,300
1,<environment.Job instance at 0x7faa6e2270a0>,86,18,[9 2],87,-1,319,-1,301
1,<environment.Job instance at 0x7faa6e210870>,125,21,[4 5],126,-1,322,-1,301
1,<environment.Job instance at 0x7faa6e210a50>,130,15,[8 3],131,-1,316,-1,301
1,<environment.Job instance at 0x7faa6e2100f0>,132,13,[ 5 10],133,-1,315,-1,302
1,<environment.Job instance at 0x7faa6e33e500>,133,16,[ 3 10],134,-1,318,-1,302
1,<environment.Job instance at 0x7faa6e3266e0>,135,14,[ 2 10],136,-1,316,-1,302
1,<environment.Job instance at 0x7faa6e2c3be0>,137,20,[9 2],138,-1,322,-1,302
1,<environment.Job instance at 0x7faa6e3c1320>,138,16,[11  2],139,-1,318,-1,302
1,<environment.Job instance at 0x7faa6e2c3730>,140,16,[2 8],141,-1,318,-1,302
1,<environment.Job instance at 0x7faa6e224a00>,74,14,[5 1],75,-1,386,-1,372
1,<environment.Job instance at 0x7faa6e23ce10>,154,14,[8 4],155,-1,386,-1,372
1,<environment.Job instance at 0x7faa6e3c22d0>,151,15,[10  4],152,-1,387,-1,372
1,<environment.Job instance at 0x7faa6e6e8b40>,152,14,[1 8],153,-1,389,-1,375
1,<environment.Job instance at 0x7faa6e33c050>,161,15,[1 7],162,-1,390,-1,375
1,<environment.Job instance at 0x7faa6e324a00>,158,14,[9 5],159,-1,389,-1,375
1,<environment.Job instance at 0x7faa6e2412d0>,168,19,[6 4],169,-1,395,-1,376
1,<environment.Job instance at 0x7faa6e241960>,169,14,[3 6],170,-1,391,-1,377
1,<environment.Job instance at 0x7faa6e241af0>,173,18,[6 5],174,-1,395,-1,377
1,<environment.Job instance at 0x7faa6e2dbe60>,143,15,[ 1 12],144,-1,432,-1,417
1,<environment.Job instance at 0x7faa6e370fa0>,182,14,[2 9],183,-1,431,-1,417
1,<environment.Job instance at 0x7faa6e21c7d0>,1,22,[11  3],2,-1,24,-1,2
1,<environment.Job instance at 0x7faa6e2221e0>,9,18,[11  5],10,-1,32,-1,14
1,<environment.Job instance at 0x7faa6e2245a0>,12,26,[ 1 10],13,-1,82,-1,56
1,<environment.Job instance at 0x7faa6e2c8690>,23,27,[1 6],24,-1,87,-1,60
1,<environment.Job instance at 0x7faa6e2bccd0>,28,23,[10  4],29,-1,97,-1,74
1,<environment.Job instance at 0x7faa6e1f6320>,34,24,[1 8],35,-1,117,-1,93
1,<environment.Job instance at 0x7faa6e1fc910>,36,13,[ 3 14],37,-1,106,-1,93
1,<environment.Job instance at 0x7faa6e209960>,46,17,[12  2],47,-1,134,-1,117
1,<environment.Job instance at 0x7faa6e219be0>,50,16,[12  2],51,-1,146,-1,130
1,<environment.Job instance at 0x7faa6e22aa50>,54,13,[13  1],55,-1,158,-1,145
1,<environment.Job instance at 0x7faa6e1b6190>,60,3,[12  3],61,-1,169,-1,166
1,<environment.Job instance at 0x7faa6e1b65f0>,67,27,[ 1 10],68,-1,216,-1,189
1,<environment.Job instance at 0x7faa6e1b67d0>,69,13,[ 3 12],70,-1,202,-1,189
1,<environment.Job instance at 0x7faa6e1b6aa0>,75,14,[ 4 11],76,-1,215,-1,201
1,<environment.Job instance at 0x7faa6e1b9af0>,97,2,[ 5 11],98,-1,294,-1,292
1,<environment.Job instance at 0x7faa6e1b9c30>,99,18,[12  5],100,-1,312,-1,294
1,<environment.Job instance at 0x7faa6e1b9e10>,105,14,[14  5],106,-1,341,-1,327
1,<environment.Job instance at 0x7faa6e1bb230>,106,15,[11  1],107,-1,342,-1,327
1,<environment.Job instance at 0x7faa6e1bba50>,116,3,[ 1 12],117,-1,363,-1,360
1,<environment.Job instance at 0x7faa6e1bb690>,111,26,[ 5 10],112,-1,396,-1,370
1,<environment.Job instance at 0x7faa6e1bbd70>,122,3,[ 4 12],123,-1,377,-1,374
1,<environment.Job instance at 0x7faa6e1bbc30>,123,12,[ 4 11],124,-1,386,-1,374
1,<environment.Job instance at 0x7faa6e1bf230>,128,23,[ 2 14],129,-1,419,-1,396
1,<environment.Job instance at 0x7faa6e1bf8c0>,138,16,[11  2],139,-1,447,-1,431
1,<environment.Job instance at 0x7faa6e1bf960>,139,18,[ 1 12],140,-1,449,-1,431
1,<environment.Job instance at 0x7faa6e1bfbe0>,143,15,[ 1 12],144,-1,466,-1,451
1,<environment.Job instance at 0x7faa6e1bfeb0>,145,3,[ 4 13],146,-1,455,-1,452
1,<environment.Job instance at 0x7faa6e1bffa0>,147,1,[ 1 14],148,-1,455,-1,454
1,<environment.Job instance at 0x7faa6e1c18c0>,160,3,[13  3],161,-1,503,-1,500
1,<environment.Job instance at 0x7faa6e1c1aa0>,165,13,[ 1 14],166,-1,518,-1,505
1,<environment.Job instance at 0x7faa6e1c43c0>,176,2,[11  5],177,-1,542,-1,540
1,<environment.Job instance at 0x7faa6e1c4640>,178,3,[14  4],179,-1,543,-1,540
1,<environment.Job instance at 0x7faa6e1ceeb0>,0,18,[10  3],1,-1,20,-1,2
1,<environment.Job instance at 0x7faa6e22a910>,1,17,[10  2],2,-1,19,-1,2
1,<environment.Job instance at 0x7faa6dbb7b40>,10,13,[10  5],11,-1,25,-1,12
1,<environment.Job instance at 0x7faa6dbb71e0>,13,14,[7 5],14,-1,28,-1,14
1,<environment.Job instance at 0x7faa6dc82730>,15,14,[10  2],16,-1,30,-1,16
1,<environment.Job instance at 0x7faa6dc82b40>,24,16,[7 2],25,-1,41,-1,25
1,<environment.Job instance at 0x7faa6dc8c280>,26,12,[ 3 10],27,-1,39,-1,27
1,<environment.Job instance at 0x7faa6dc8cc80>,30,18,[4 5],31,-1,49,-1,31
1,<environment.Job instance at 0x7faa6dc8cf50>,31,18,[2 8],32,-1,50,-1,32
1,<environment.Job instance at 0x7faa6dc911e0>,34,16,[9 4],35,-1,51,-1,35
1,<environment.Job instance at 0x7faa6dc91410>,36,14,[10  1],37,-1,52,-1,38
1,<environment.Job instance at 0x7faa6dc915f0>,38,15,[7 5],39,-1,54,-1,39
1,<environment.Job instance at 0x7faa6dc91910>,42,20,[1 7],43,-1,63,-1,43
1,<environment.Job instance at 0x7faa6de525f0>,46,19,[2 7],47,-1,66,-1,47
1,<environment.Job instance at 0x7faa6da32370>,48,18,[6 3],49,-1,67,-1,49
1,<environment.Job instance at 0x7faa6da9b5f0>,50,24,[ 1 10],51,-1,75,-1,51
1,<environment.Job instance at 0x7faa6d8a4370>,53,24,[7 4],54,-1,78,-1,54
1,<environment.Job instance at 0x7faa6d8a4550>,54,16,[7 5],55,-1,71,-1,55
1,<environment.Job instance at 0x7faa779ef230>,56,16,[7 4],57,-1,73,-1,57
1,<environment.Job instance at 0x7faa7788e3c0>,58,18,[4 6],59,-1,77,-1,59
1,<environment.Job instance at 0x7faa6d7c6e10>,61,27,[4 7],62,-1,89,-1,62
1,<environment.Job instance at 0x7faa6d7c6050>,62,26,[8 4],63,-1,89,-1,63
1,<environment.Job instance at 0x7faa6dc37c30>,64,14,[5 5],65,-1,79,-1,65
1,<environment.Job instance at 0x7faa6d8635f0>,67,17,[5 2],68,-1,85,-1,68
1,<environment.Job instance at 0x7faa6d7d0c80>,68,18,[4 5],69,-1,87,-1,69
1,<environment.Job instance at 0x7faa6d7d0d20>,70,25,[ 3 10],71,-1,96,-1,71
1,<environment.Job instance at 0x7faa6d7b46e0>,77,13,[9 2],78,-1,91,-1,78
1,<environment.Job instance at 0x7faa6d7b84b0>,78,15,[3 6],79,-1,94,-1,79
1,<environment.Job instance at 0x7faa6d7b8190>,80,17,[2 6],81,-1,98,-1,81
1,<environment.Job instance at 0x7faa6d7cda00>,81,15,[8 4],82,-1,97,-1,82
1,<environment.Job instance at 0x7faa6d7cd6e0>,83,23,[10  1],84,-1,107,-1,84
1,<environment.Job instance at 0x7faa6d7cd5f0>,86,28,[6 5],87,-1,115,-1,87
1,<environment.Job instance at 0x7faa6d7cdb40>,87,18,[5 9],88,-1,106,-1,88
1,<environment.Job instance at 0x7faa6d7cfcd0>,94,15,[10  4],95,-1,110,-1,95
1,<environment.Job instance at 0x7faa6dc91140>,37,16,[9 2],38,-1,133,-1,117
1,<environment.Job instance at 0x7faa6d8fdaf0>,110,15,[8 2],111,-1,132,-1,117
1,<environment.Job instance at 0x7faa6d7cce60>,102,18,[8 2],103,-1,135,-1,117
1,<environment.Job instance at 0x7faa6d8fd280>,109,16,[9 4],110,-1,133,-1,117
1,<environment.Job instance at 0x7faa6d8f5320>,114,17,[9 4],115,-1,134,-1,117
1,<environment.Job instance at 0x7faa6d8f5460>,112,25,[6 3],113,-1,143,-1,118
1,<environment.Job instance at 0x7faa6d7cc140>,100,18,[6 1],101,-1,141,-1,123
1,<environment.Job instance at 0x7faa77972550>,105,17,[4 6],106,-1,140,-1,123
1,<environment.Job instance at 0x7faa778b06e0>,118,17,[3 6],119,-1,140,-1,123
1,<environment.Job instance at 0x7faa6db9a050>,120,1,[ 1 10],121,-1,136,-1,135
1,<environment.Job instance at 0x7faa6da72be0>,119,15,[ 5 10],120,-1,150,-1,135
1,<environment.Job instance at 0x7faa6d855b90>,117,13,[1 9],118,-1,152,-1,139
1,<environment.Job instance at 0x7faa6dabcd20>,129,18,[13  1],130,-1,159,-1,141
1,<environment.Job instance at 0x7faa6d95da50>,125,3,[5 2],126,-1,144,-1,141
1,<environment.Job instance at 0x7faa6d7cfeb0>,95,18,[11  3],96,-1,159,-1,141
1,<environment.Job instance at 0x7faa6d7ceeb0>,130,12,[9 2],131,-1,153,-1,141
1,<environment.Job instance at 0x7faa6d7d65a0>,133,3,[2 5],134,-1,144,-1,141
1,<environment.Job instance at 0x7faa6d7d6410>,134,12,[5 9],135,-1,157,-1,145
1,<environment.Job instance at 0x7faa6d7d6910>,135,12,[2 6],136,-1,157,-1,145
1,<environment.Job instance at 0x7faa6d86cc30>,65,16,[14  1],66,-1,161,-1,145
1,<environment.Job instance at 0x7faa6d84f960>,123,20,[2 6],124,-1,165,-1,145
1,<environment.Job instance at 0x7faa6d8ff460>,136,15,[2 7],137,-1,162,-1,147
1,<environment.Job instance at 0x7faa6d84f370>,124,15,[5 1],125,-1,163,-1,148
1,<environment.Job instance at 0x7faa6d84ab90>,144,23,[10  2],145,-1,172,-1,149
1,<environment.Job instance at 0x7faa6da3c0f0>,141,24,[9 1],142,-1,173,-1,149
1,<environment.Job instance at 0x7faa6da3c0a0>,143,24,[10  5],144,-1,176,-1,152
1,<environment.Job instance at 0x7faa6da36b40>,146,16,[ 5 10],147,-1,169,-1,153
1,<environment.Job instance at 0x7faa6da36730>,151,17,[10  3],152,-1,170,-1,153
1,<environment.Job instance at 0x7faa6d8f6190>,139,15,[ 3 10],140,-1,175,-1,160
1,<environment.Job instance at 0x7faa6da36960>,150,15,[7 1],151,-1,178,-1,163
1,<environment.Job instance at 0x7faa6d7b7eb0>,159,16,[5 4],160,-1,181,-1,165
1,<environment.Job instance at 0x7faa77979b90>,156,1,[2 6],157,-1,166,-1,165
1,<environment.Job instance at 0x7faa6d9014b0>,160,14,[8 3],161,-1,179,-1,165
1,<environment.Job instance at 0x7faa6dcfd550>,162,12,[8 1],163,-1,177,-1,165
1,<environment.Job instance at 0x7faa6dc780a0>,164,18,[3 6],165,-1,183,-1,165
1,<environment.Job instance at 0x7faa6d7b78c0>,157,15,[ 3 12],158,-1,180,-1,165
1,<environment.Job instance at 0x7faa6da36230>,145,15,[ 1 11],146,-1,182,-1,167
1,<environment.Job instance at 0x7faa6dc6d0a0>,166,16,[9 2],167,-1,183,-1,167
1,<environment.Job instance at 0x7faa6dc6dd20>,167,16,[9 4],168,-1,184,-1,168
1,<environment.Job instance at 0x7faa6dd4faa0>,170,27,[ 5 10],171,-1,198,-1,171
1,<environment.Job instance at 0x7faa6dc6df50>,171,17,[7 5],172,-1,189,-1,172
1,<environment.Job instance at 0x7faa6de2a2d0>,176,25,[ 5 10],177,-1,209,-1,184
1,<environment.Job instance at 0x7faa6dcdda50>,178,18,[1 5],179,-1,202,-1,184
1,<environment.Job instance at 0x7faa6dcdd280>,183,2,[5 7],184,-1,187,-1,185
1,<environment.Job instance at 0x7faa6dcdd460>,184,1,[3 8],185,-1,187,-1,186
1,<environment.Job instance at 0x7faa6dcddf50>,177,15,[5 3],178,-1,201,-1,186
1,<environment.Job instance at 0x7faa6dd86b40>,174,15,[4 6],175,-1,201,-1,186
1,<environment.Job instance at 0x7faa6d80df00>,155,12,[ 4 10],156,-1,198,-1,186
1,<environment.Job instance at 0x7faa6dcdd5a0>,185,13,[5 5],186,-1,199,-1,186
1,<environment.Job instance at 0x7faa6d7b4cd0>,8,12,[14  4],9,-1,31,-1,19
1,<environment.Job instance at 0x7faa6d7cea00>,18,2,[13  1],19,-1,42,-1,40
1,<environment.Job instance at 0x7faa6d7cc6e0>,21,3,[13  5],22,-1,46,-1,43
1,<environment.Job instance at 0x7faa6da36190>,22,2,[ 1 12],23,-1,45,-1,43
1,<environment.Job instance at 0x7faa6e1c18c0>,32,1,[ 4 13],33,-1,64,-1,63
1,<environment.Job instance at 0x7faa6e1c1b90>,33,14,[11  3],34,-1,77,-1,63
1,<environment.Job instance at 0x7faa6e1bba50>,50,24,[ 1 10],51,-1,156,-1,132
1,<environment.Job instance at 0x7faa6e1bb6e0>,53,24,[7 4],54,-1,169,-1,145
1,<environment.Job instance at 0x7faa6e1bb5f0>,55,3,[12  3],56,-1,148,-1,145
1,<environment.Job instance at 0x7faa6da62e10>,61,27,[4 7],62,-1,195,-1,168
1,<environment.Job instance at 0x7faa6e1bb0f0>,62,26,[8 4],63,-1,194,-1,168
1,<environment.Job instance at 0x7faa6d9e2cd0>,65,16,[14  1],66,-1,184,-1,168
1,<environment.Job instance at 0x7faa6d9c9fa0>,70,25,[ 3 10],71,-1,224,-1,199
1,<environment.Job instance at 0x7faa6dc6d690>,83,23,[10  1],84,-1,275,-1,252
1,<environment.Job instance at 0x7faa6db01a00>,86,28,[6 5],87,-1,280,-1,252
1,<environment.Job instance at 0x7faa6d9f5690>,91,15,[14  1],92,-1,269,-1,254
1,<environment.Job instance at 0x7faa6d9ce960>,95,18,[11  3],96,-1,276,-1,258
1,<environment.Job instance at 0x7faa6d9ce3c0>,99,28,[5 3],100,-1,294,-1,266
1,<environment.Job instance at 0x7faa6d9d15f0>,112,25,[6 3],113,-1,344,-1,319
1,<environment.Job instance at 0x7faa6d97e870>,129,18,[13  1],130,-1,394,-1,376
1,<environment.Job instance at 0x7faa6d977eb0>,132,3,[ 3 11],133,-1,381,-1,378
1,<environment.Job instance at 0x7faa6da085f0>,140,24,[2 8],141,-1,444,-1,420
1,<environment.Job instance at 0x7faa6da08640>,141,24,[9 1],142,-1,449,-1,425
1,<environment.Job instance at 0x7faa6da08460>,143,24,[10  5],144,-1,449,-1,425
1,<environment.Job instance at 0x7faa6d981960>,144,23,[10  2],145,-1,448,-1,425
1,<environment.Job instance at 0x7faa6d98b0a0>,145,15,[ 1 11],146,-1,440,-1,425
1,<environment.Job instance at 0x7faa6d987730>,157,15,[ 3 12],158,-1,473,-1,458
1,<environment.Job instance at 0x7faa6d938190>,170,27,[ 5 10],171,-1,552,-1,525
1,<environment.Job instance at 0x7faa6d933320>,176,25,[ 5 10],177,-1,571,-1,546
1,<environment.Job instance at 0x7faa6d9a58c0>,5,16,[10  4],6,-1,24,-1,8
1,<environment.Job instance at 0x7faa6d9a2500>,10,18,[9 5],11,-1,29,-1,11
1,<environment.Job instance at 0x7faa6d9a2e60>,14,17,[7 2],15,-1,32,-1,15
1,<environment.Job instance at 0x7faa6db14aa0>,16,12,[8 3],17,-1,29,-1,17
1,<environment.Job instance at 0x7faa6db14f50>,17,15,[2 9],18,-1,33,-1,18
1,<environment.Job instance at 0x7faa6db14190>,19,17,[8 1],20,-1,37,-1,20
1,<environment.Job instance at 0x7faa6db145f0>,21,17,[2 6],22,-1,39,-1,22
1,<environment.Job instance at 0x7faa6db14c80>,22,19,[8 2],23,-1,42,-1,23
1,<environment.Job instance at 0x7faa6db14140>,28,14,[ 2 10],29,-1,43,-1,29
1,<environment.Job instance at 0x7faa6db14960>,29,17,[9 1],30,-1,47,-1,30
1,<environment.Job instance at 0x7faa6d99f5a0>,30,18,[3 5],31,-1,49,-1,31
1,<environment.Job instance at 0x7faa6d99f320>,38,14,[4 6],39,-1,53,-1,39
1,<environment.Job instance at 0x7faa6d99f3c0>,39,15,[10  2],40,-1,55,-1,40
1,<environment.Job instance at 0x7faa6d99ae10>,41,12,[5 5],42,-1,54,-1,42
1,<environment.Job instance at 0x7faa6d99a640>,43,13,[4 9],44,-1,57,-1,44
1,<environment.Job instance at 0x7faa6d99a1e0>,45,14,[7 4],46,-1,60,-1,46
1,<environment.Job instance at 0x7faa6d9930a0>,50,16,[10  2],51,-1,67,-1,51
1,<environment.Job instance at 0x7faa6d993960>,51,13,[4 5],52,-1,65,-1,52
1,<environment.Job instance at 0x7faa6d993230>,54,21,[7 2],55,-1,76,-1,55
1,<environment.Job instance at 0x7faa6d993be0>,55,12,[ 1 10],56,-1,68,-1,56
1,<environment.Job instance at 0x7faa6d993cd0>,58,16,[6 3],59,-1,75,-1,59
1,<environment.Job instance at 0x7faa6d993320>,59,14,[5 7],60,-1,74,-1,60
1,<environment.Job instance at 0x7faa6da81690>,60,18,[4 7],61,-1,79,-1,61
1,<environment.Job instance at 0x7faa6da816e0>,62,14,[ 1 11],63,-1,77,-1,63
1,<environment.Job instance at 0x7faa6d9a2c30>,7,12,[5 8],8,-1,79,-1,67
1,<environment.Job instance at 0x7faa6da81500>,68,15,[8 5],69,-1,84,-1,69
1,<environment.Job instance at 0x7faa6da25e60>,76,18,[4 6],77,-1,95,-1,77
1,<environment.Job instance at 0x7faa6d98e550>,89,27,[9 3],90,-1,142,-1,115
1,<environment.Job instance at 0x7faa6d98bc30>,92,24,[ 3 10],93,-1,143,-1,119
1,<environment.Job instance at 0x7faa6da25870>,79,14,[ 5 11],80,-1,133,-1,119
1,<environment.Job instance at 0x7faa6d98b5a0>,94,17,[8 5],95,-1,137,-1,120
1,<environment.Job instance at 0x7faa6d98baa0>,98,27,[1 7],99,-1,183,-1,156
1,<environment.Job instance at 0x7faa6d98b460>,97,12,[ 2 12],98,-1,172,-1,160
1,<environment.Job instance at 0x7faa6d987af0>,108,14,[10  3],109,-1,174,-1,160
1,<environment.Job instance at 0x7faa6d933be0>,111,18,[2 9],112,-1,178,-1,160
1,<environment.Job instance at 0x7faa6d933d70>,110,19,[1 5],111,-1,179,-1,160
1,<environment.Job instance at 0x7faa6d9337d0>,112,18,[10  4],113,-1,178,-1,160
1,<environment.Job instance at 0x7faa6d85db40>,113,13,[6 5],114,-1,173,-1,160
1,<environment.Job instance at 0x7faa6d85de60>,114,2,[7 5],115,-1,163,-1,161
1,<environment.Job instance at 0x7faa6d938be0>,117,18,[5 1],118,-1,179,-1,161
1,<environment.Job instance at 0x7faa6da25f00>,82,18,[6 3],83,-1,179,-1,161
1,<environment.Job instance at 0x7faa6d9505f0>,119,15,[9 5],120,-1,176,-1,161
1,<environment.Job instance at 0x7faa779eeeb0>,125,21,[2 5],126,-1,198,-1,177
1,<environment.Job instance at 0x7faa6e0128c0>,123,18,[5 9],124,-1,195,-1,177
1,<environment.Job instance at 0x7faa6d841370>,129,19,[9 1],130,-1,196,-1,177
1,<environment.Job instance at 0x7faa6d841780>,128,14,[5 9],129,-1,191,-1,177
1,<environment.Job instance at 0x7faa6d7cae10>,133,27,[1 8],134,-1,204,-1,177
1,<environment.Job instance at 0x7faa6d7ca9b0>,135,12,[2 9],136,-1,190,-1,178
1,<environment.Job instance at 0x7faa6d7cad70>,136,14,[3 9],137,-1,192,-1,178
1,<environment.Job instance at 0x7faa6e001a50>,139,13,[5 9],140,-1,195,-1,182
1,<environment.Job instance at 0x7faa6d7cc410>,141,18,[8 4],142,-1,204,-1,186
1,<environment.Job instance at 0x7faa6d7d0cd0>,144,17,[3 9],145,-1,203,-1,186
1,<environment.Job instance at 0x7faa6dfaccd0>,145,13,[10  4],146,-1,199,-1,186
1,<environment.Job instance at 0x7faa6dfa40a0>,131,16,[6 5],132,-1,202,-1,186
1,<environment.Job instance at 0x7faa6df9e2d0>,146,16,[5 5],147,-1,204,-1,188
1,<environment.Job instance at 0x7faa6da812d0>,2,17,[12  4],3,-1,20,-1,3
1,<environment.Job instance at 0x7faa6d93f9b0>,15,2,[ 4 11],16,-1,20,-1,18
1,<environment.Job instance at 0x7faa6d8f9f00>,23,2,[ 2 14],24,-1,51,-1,49
1,<environment.Job instance at 0x7faa6d93c050>,24,17,[ 5 14],25,-1,66,-1,49
1,<environment.Job instance at 0x7faa6d930690>,26,2,[11  3],27,-1,51,-1,49
1,<environment.Job instance at 0x7faa6d930820>,27,2,[12  2],28,-1,51,-1,49
1,<environment.Job instance at 0x7faa6d933460>,32,2,[12  5],33,-1,77,-1,75
1,<environment.Job instance at 0x7faa6d938f50>,34,1,[14  4],35,-1,76,-1,75
1,<environment.Job instance at 0x7faa6d9a2b90>,53,1,[ 5 12],54,-1,150,-1,149
1,<environment.Job instance at 0x7faa6d99fbe0>,62,14,[ 1 11],63,-1,195,-1,181
1,<environment.Job instance at 0x7faa6d99f0f0>,64,3,[14  4],65,-1,184,-1,181
1,<environment.Job instance at 0x7faa6d98bd70>,66,2,[13  4],67,-1,183,-1,181
1,<environment.Job instance at 0x7faa6d98b1e0>,69,27,[1 5],70,-1,224,-1,197
1,<environment.Job instance at 0x7faa6db01a00>,75,14,[ 5 12],76,-1,218,-1,204
1,<environment.Job instance at 0x7faa6ddb1550>,77,19,[14  4],78,-1,223,-1,204
1,<environment.Job instance at 0x7faa6da15870>,79,14,[ 5 11],80,-1,229,-1,215
1,<environment.Job instance at 0x7faa77972f00>,86,25,[3 8],87,-1,269,-1,244
1,<environment.Job instance at 0x7faa6d7cc500>,88,3,[ 5 14],89,-1,247,-1,244
1,<environment.Job instance at 0x7faa6d7cf690>,89,27,[9 3],90,-1,274,-1,247
1,<environment.Job instance at 0x7faa6d7cd640>,92,24,[ 3 10],93,-1,274,-1,250
1,<environment.Job instance at 0x7faa6d946190>,97,12,[ 2 12],98,-1,274,-1,262
1,<environment.Job instance at 0x7faa6d946280>,98,27,[1 7],99,-1,291,-1,264
1,<environment.Job instance at 0x7faa6d987870>,115,2,[14  5],116,-1,334,-1,332
1,<environment.Job instance at 0x7faa6d9812d0>,133,27,[1 8],134,-1,434,-1,407
1,<environment.Job instance at 0x7faa6d97eb90>,153,3,[ 3 14],154,-1,495,-1,492
1,<environment.Job instance at 0x7faa6d97e550>,155,25,[6 3],156,-1,532,-1,507
1,<environment.Job instance at 0x7faa6d97e190>,160,2,[ 5 11],161,-1,520,-1,518
1,<environment.Job instance at 0x7faa6da470a0>,169,27,[ 5 10],170,-1,589,-1,562
1,<environment.Job instance at 0x7faa6d9d1410>,186,13,[11  1],187,-1,641,-1,628
1,<environment.Job instance at 0x7faa6da008c0>,1,14,[10  4],2,-1,17,-1,3
1,<environment.Job instance at 0x7faa6e0973c0>,2,18,[5 5],3,-1,22,-1,4
1,<environment.Job instance at 0x7faa6ed400f0>,5,15,[7 4],6,-1,21,-1,6
1,<environment.Job instance at 0x7faa6e088f00>,8,21,[5 8],9,-1,30,-1,9
1,<environment.Job instance at 0x7faa6e088500>,9,17,[7 2],10,-1,27,-1,10
1,<environment.Job instance at 0x7faa6e088370>,12,18,[5 1],13,-1,31,-1,13
1,<environment.Job instance at 0x7faa6df25280>,17,12,[ 4 10],18,-1,30,-1,18
1,<environment.Job instance at 0x7faa6e07aaf0>,38,15,[ 3 11],39,-1,56,-1,41
1,<environment.Job instance at 0x7faa6e074140>,44,15,[9 1],45,-1,72,-1,57
1,<environment.Job instance at 0x7faa6e074500>,48,17,[5 5],49,-1,74,-1,57
1,<environment.Job instance at 0x7faa6e074640>,49,14,[3 7],50,-1,71,-1,57
1,<environment.Job instance at 0x7faa6e074370>,50,15,[9 4],51,-1,72,-1,57
1,<environment.Job instance at 0x7faa6e074190>,45,15,[ 2 11],46,-1,72,-1,57
1,<environment.Job instance at 0x7faa6e0743c0>,46,23,[7 4],47,-1,80,-1,57
1,<environment.Job instance at 0x7faa6df25be0>,26,28,[9 2],27,-1,89,-1,61
1,<environment.Job instance at 0x7faa6dc5e1e0>,60,16,[14  3],61,-1,77,-1,61
1,<environment.Job instance at 0x7faa6e0747d0>,52,13,[1 5],53,-1,76,-1,63
1,<environment.Job instance at 0x7faa6dc5e5a0>,65,20,[4 7],66,-1,86,-1,66
1,<environment.Job instance at 0x7faa6dc5e730>,66,21,[6 5],67,-1,89,-1,68
1,<environment.Job instance at 0x7faa6df251e0>,16,28,[1 7],17,-1,97,-1,69
1,<environment.Job instance at 0x7faa6dc5e8c0>,67,13,[9 4],68,-1,82,-1,69
1,<environment.Job instance at 0x7faa6e074870>,53,20,[5 4],54,-1,90,-1,70
1,<environment.Job instance at 0x7faa6dc5eb90>,69,17,[5 9],70,-1,87,-1,70
1,<environment.Job instance at 0x7faa6d9a5460>,71,27,[5 1],72,-1,99,-1,72
1,<environment.Job instance at 0x7faa6e084b90>,72,21,[1 6],73,-1,94,-1,73
1,<environment.Job instance at 0x7faa6e0848c0>,73,17,[8 5],74,-1,92,-1,75
1,<environment.Job instance at 0x7faa6e08ae60>,75,16,[4 5],76,-1,101,-1,85
1,<environment.Job instance at 0x7faa6e08a410>,78,16,[ 5 10],79,-1,101,-1,85
1,<environment.Job instance at 0x7faa6e08a2d0>,76,25,[8 3],77,-1,110,-1,85
1,<environment.Job instance at 0x7faa6e08aeb0>,77,13,[13  1],78,-1,99,-1,86
1,<environment.Job instance at 0x7faa6e08a6e0>,79,18,[7 3],80,-1,104,-1,86
1,<environment.Job instance at 0x7faa6e08a960>,80,16,[9 2],81,-1,102,-1,86
1,<environment.Job instance at 0x7faa6e08a910>,85,13,[2 6],86,-1,99,-1,86
1,<environment.Job instance at 0x7faa6e0816e0>,86,25,[ 5 10],87,-1,112,-1,87
1,<environment.Job instance at 0x7faa6e6535a0>,92,18,[5 9],93,-1,111,-1,93
1,<environment.Job instance at 0x7faa6e6532d0>,93,16,[6 5],94,-1,111,-1,95
1,<environment.Job instance at 0x7faa6db74cd0>,97,17,[5 2],98,-1,116,-1,99
1,<environment.Job instance at 0x7faa6e8b7460>,99,15,[6 3],100,-1,115,-1,100
1,<environment.Job instance at 0x7faa6db74050>,98,18,[1 9],99,-1,119,-1,101
1,<environment.Job instance at 0x7faa6e8b71e0>,100,15,[3 9],101,-1,123,-1,108
1,<environment.Job instance at 0x7faa6db8b0f0>,104,17,[9 5],105,-1,125,-1,108
1,<environment.Job instance at 0x7faa6dc5e640>,64,15,[10  3],65,-1,124,-1,109
1,<environment.Job instance at 0x7faa6db8bf50>,105,16,[5 3],106,-1,125,-1,109
1,<environment.Job instance at 0x7faa6db8b550>,109,13,[3 6],110,-1,123,-1,110
1,<environment.Job instance at 0x7faa6e8cbb90>,110,26,[6 3],111,-1,137,-1,111
1,<environment.Job instance at 0x7faa6e8cb5f0>,111,14,[4 6],112,-1,126,-1,112
1,<environment.Job instance at 0x7faa6dba0910>,117,17,[4 9],118,-1,135,-1,118
1,<environment.Job instance at 0x7faa6dba0780>,119,14,[6 1],120,-1,134,-1,120
1,<environment.Job instance at 0x7faa6dba0c80>,121,17,[10  4],122,-1,139,-1,122
1,<environment.Job instance at 0x7faa6dba7d70>,122,14,[3 9],123,-1,137,-1,123
1,<environment.Job instance at 0x7faa6dba78c0>,124,14,[7 4],125,-1,140,-1,126
1,<environment.Job instance at 0x7faa6e074d20>,11,28,[2 8],12,-1,61,-1,33
1,<environment.Job instance at 0x7faa6d9e37d0>,13,27,[9 3],14,-1,72,-1,45
1,<environment.Job instance at 0x7faa6deee780>,16,28,[1 7],17,-1,75,-1,47
1,<environment.Job instance at 0x7faa6dc4d820>,19,2,[ 4 11],20,-1,49,-1,47
1,<environment.Job instance at 0x7faa6da47550>,24,3,[11  1],25,-1,64,-1,61
1,<environment.Job instance at 0x7faa6da47280>,26,28,[9 2],27,-1,93,-1,65
1,<environment.Job instance at 0x7faa6d97e190>,37,3,[ 1 12],38,-1,99,-1,96
1,<environment.Job instance at 0x7faa6d97eb40>,38,15,[ 3 11],39,-1,111,-1,96
1,<environment.Job instance at 0x7faa6d97e640>,45,15,[ 2 11],46,-1,117,-1,102
1,<environment.Job instance at 0x7faa6d97e370>,46,23,[7 4],47,-1,127,-1,104
1,<environment.Job instance at 0x7faa6d987d20>,60,16,[14  3],61,-1,152,-1,136
1,<environment.Job instance at 0x7faa6d8c31e0>,71,27,[5 1],72,-1,183,-1,156
1,<environment.Job instance at 0x7faa6d7cf1e0>,77,13,[13  1],78,-1,184,-1,171
1,<environment.Job instance at 0x7faa77972f00>,76,25,[8 3],77,-1,212,-1,187
1,<environment.Job instance at 0x7faa6d95f6e0>,86,25,[ 5 10],87,-1,257,-1,232
1,<environment.Job instance at 0x7faa6d9a28c0>,106,2,[13  5],107,-1,293,-1,291
1,<environment.Job instance at 0x7faa6d99a230>,110,26,[6 3],111,-1,343,-1,317
1,<environment.Job instance at 0x7faa6d938af0>,112,17,[ 2 11],113,-1,334,-1,317
1,<environment.Job instance at 0x7faa6d933500>,115,23,[7 1],116,-1,344,-1,321
1,<environment.Job instance at 0x7faa6d93fa50>,123,12,[ 1 14],124,-1,359,-1,347
1,<environment.Job instance at 0x7faa6dac10f0>,126,13,[13  3],127,-1,377,-1,364
1,<environment.Job instance at 0x7faa77974140>,128,1,[ 3 14],129,-1,374,-1,373
1,<environment.Job instance at 0x7faa6e398960>,141,14,[ 3 14],142,-1,436,-1,422
1,<environment.Job instance at 0x7faa6ed20690>,145,13,[ 1 12],146,-1,453,-1,440
1,<environment.Job instance at 0x7faa6e4bbb90>,146,17,[11  2],147,-1,457,-1,440
1,<environment.Job instance at 0x7faa6e480aa0>,150,28,[5 6],151,-1,485,-1,457
1,<environment.Job instance at 0x7faa6e1da320>,153,28,[ 1 11],154,-1,487,-1,459
1,<environment.Job instance at 0x7faa6dfa2640>,155,23,[5 3],156,-1,485,-1,462
1,<environment.Job instance at 0x7faa6e6b5320>,156,14,[13  5],157,-1,476,-1,462
1,<environment.Job instance at 0x7faa6e0010a0>,160,13,[12  5],161,-1,491,-1,478
1,<environment.Job instance at 0x7faa6e6acaa0>,168,15,[ 3 13],169,-1,518,-1,503
1,<environment.Job instance at 0x7faa6e157140>,176,18,[ 3 13],177,-1,558,-1,540
1,<environment.Job instance at 0x7faa6e137230>,187,2,[ 4 14],188,-1,589,-1,587
1,<environment.Job instance at 0x7faa6e5edf50>,1,18,[4 8],2,-1,20,-1,2
1,<environment.Job instance at 0x7faa6e6de910>,3,15,[10  4],4,-1,21,-1,6
1,<environment.Job instance at 0x7faa6e6deeb0>,6,15,[ 5 10],7,-1,22,-1,7
1,<environment.Job instance at 0x7faa6e6de5f0>,8,14,[8 3],9,-1,23,-1,9
1,<environment.Job instance at 0x7faa6e6de500>,9,14,[9 5],10,-1,24,-1,10
1,<environment.Job instance at 0x7faa6e6debe0>,10,25,[2 8],11,-1,36,-1,11
1,<environment.Job instance at 0x7faa6e6de4b0>,11,13,[5 8],12,-1,25,-1,12
1,<environment.Job instance at 0x7faa6e6de1e0>,12,18,[9 4],13,-1,31,-1,13
1,<environment.Job instance at 0x7faa6e6de9b0>,13,18,[ 4 10],14,-1,32,-1,14
1,<environment.Job instance at 0x7faa6e6de7d0>,17,15,[ 5 10],18,-1,33,-1,18
1,<environment.Job instance at 0x7faa6e6deaa0>,18,17,[5 7],19,-1,36,-1,19
1,<environment.Job instance at 0x7faa6e4d4aa0>,21,16,[ 4 10],22,-1,38,-1,22
1,<environment.Job instance at 0x7faa6e4d4fa0>,24,15,[ 2 10],25,-1,40,-1,25
1,<environment.Job instance at 0x7faa6e4d4e60>,25,16,[4 6],26,-1,42,-1,26
1,<environment.Job instance at 0x7faa6e4d4280>,26,18,[9 4],27,-1,46,-1,28
1,<environment.Job instance at 0x7faa6e4d4050>,29,16,[2 8],30,-1,46,-1,30
1,<environment.Job instance at 0x7faa6e4d4640>,32,18,[5 1],33,-1,51,-1,33
1,<environment.Job instance at 0x7faa6e4d49b0>,33,18,[ 5 10],34,-1,52,-1,34
1,<environment.Job instance at 0x7faa6e5cf9b0>,34,20,[9 5],35,-1,55,-1,35
1,<environment.Job instance at 0x7faa6e5cf870>,35,17,[7 4],36,-1,53,-1,36
1,<environment.Job instance at 0x7faa6e5cfcd0>,36,18,[4 6],37,-1,55,-1,37
1,<environment.Job instance at 0x7faa6e5cf320>,37,14,[5 5],38,-1,52,-1,38
1,<environment.Job instance at 0x7faa6e5cfdc0>,43,17,[10  5],44,-1,61,-1,44
1,<environment.Job instance at 0x7faa6e5cf0f0>,44,17,[3 6],45,-1,62,-1,45
1,<environment.Job instance at 0x7faa6e209af0>,51,16,[2 7],52,-1,68,-1,52
1,<environment.Job instance at 0x7faa6e209d20>,52,15,[3 8],53,-1,68,-1,53
1,<environment.Job instance at 0x7faa6e209370>,54,13,[5 4],55,-1,68,-1,55
1,<environment.Job instance at 0x7faa6e209320>,55,15,[9 1],56,-1,71,-1,56
1,<environment.Job instance at 0x7faa6e209190>,57,25,[9 4],58,-1,83,-1,58
1,<environment.Job instance at 0x7faa6e209730>,60,16,[2 8],61,-1,77,-1,61
1,<environment.Job instance at 0x7faa6e6bfc30>,62,17,[1 7],63,-1,80,-1,63
1,<environment.Job instance at 0x7faa6e6bf5a0>,63,17,[6 4],64,-1,81,-1,64
1,<environment.Job instance at 0x7faa6e6bf280>,65,16,[1 6],66,-1,82,-1,66
1,<environment.Job instance at 0x7faa6e6bf050>,71,18,[9 3],72,-1,92,-1,74
1,<environment.Job instance at 0x7faa6e6e3cd0>,74,25,[7 4],75,-1,100,-1,75
1,<environment.Job instance at 0x7faa6e6e30f0>,76,22,[ 4 10],77,-1,99,-1,77
1,<environment.Job instance at 0x7faa6e6e3910>,82,18,[5 8],83,-1,101,-1,83
1,<environment.Job instance at 0x7faa6e6e3050>,90,16,[5 9],91,-1,110,-1,94
1,<environment.Job instance at 0x7faa6e6e38c0>,91,15,[9 5],92,-1,109,-1,94
1,<environment.Job instance at 0x7faa6e6e3b40>,81,13,[ 3 10],82,-1,107,-1,94
1,<environment.Job instance at 0x7faa6d86ce60>,92,14,[9 1],93,-1,108,-1,94
1,<environment.Job instance at 0x7faa6e6e3230>,78,16,[2 7],79,-1,114,-1,98
1,<environment.Job instance at 0x7faa6d86cd70>,93,18,[ 2 11],94,-1,117,-1,99
1,<environment.Job instance at 0x7faa6e570910>,98,14,[8 1],99,-1,113,-1,99
1,<environment.Job instance at 0x7faa6e6bfe10>,67,14,[12  5],68,-1,114,-1,100
1,<environment.Job instance at 0x7faa6ee5ff50>,99,16,[ 4 10],100,-1,116,-1,100
1,<environment.Job instance at 0x7faa6e570870>,100,18,[5 8],101,-1,119,-1,101
1,<environment.Job instance at 0x7faa6e570410>,101,17,[3 7],102,-1,119,-1,102
1,<environment.Job instance at 0x7faa6e570e60>,102,23,[7 1],103,-1,126,-1,103
1,<environment.Job instance at 0x7faa6e570320>,104,14,[10  1],105,-1,124,-1,110
1,<environment.Job instance at 0x7faa6e570500>,110,15,[4 9],111,-1,127,-1,112
1,<environment.Job instance at 0x7faa6e23ccd0>,111,15,[7 5],112,-1,130,-1,115
1,<environment.Job instance at 0x7faa6e6bb1e0>,113,16,[8 2],114,-1,131,-1,115
1,<environment.Job instance at 0x7faa6e198780>,116,17,[9 3],117,-1,134,-1,117
1,<environment.Job instance at 0x7faa6e6e3870>,79,16,[ 3 10],80,-1,136,-1,120
1,<environment.Job instance at 0x7faa6e6b2410>,109,13,[ 2 10],110,-1,133,-1,120
1,<environment.Job instance at 0x7faa6ddeb140>,119,15,[5 6],120,-1,136,-1,121
1,<environment.Job instance at 0x7faa6d9e25f0>,123,16,[ 4 10],124,-1,141,-1,125
1,<environment.Job instance at 0x7faa6e6bb230>,112,13,[14  4],113,-1,138,-1,125
1,<environment.Job instance at 0x7faa6e0ca640>,124,18,[1 8],125,-1,143,-1,125
1,<environment.Job instance at 0x7faa6e5ae320>,130,20,[9 5],131,-1,157,-1,137
1,<environment.Job instance at 0x7faa6d9a9190>,134,15,[7 5],135,-1,159,-1,144
1,<environment.Job instance at 0x7faa6e1d7b90>,120,15,[9 1],121,-1,160,-1,145
1,<environment.Job instance at 0x7faa6e5bfaf0>,137,15,[ 1 10],138,-1,162,-1,147
1,<environment.Job instance at 0x7faa6e514b40>,143,14,[5 5],144,-1,163,-1,149
1,<environment.Job instance at 0x7faa6e734910>,121,23,[ 3 13],122,-1,172,-1,149
1,<environment.Job instance at 0x7faa6e7537d0>,144,22,[9 5],145,-1,172,-1,150
1,<environment.Job instance at 0x7faa6da62320>,142,17,[1 9],143,-1,174,-1,157
1,<environment.Job instance at 0x7faa6dc7e3c0>,148,16,[1 6],149,-1,175,-1,159
1,<environment.Job instance at 0x7faa6e753140>,145,3,[ 1 14],146,-1,164,-1,161
1,<environment.Job instance at 0x7faa6dc7e550>,151,12,[ 1 13],152,-1,173,-1,161
1,<environment.Job instance at 0x7faa6dc7e8c0>,147,16,[5 8],148,-1,178,-1,162
1,<environment.Job instance at 0x7faa6e5aebe0>,128,18,[5 8],129,-1,184,-1,166
1,<environment.Job instance at 0x7faa6dc7ef00>,153,15,[4 9],154,-1,182,-1,167
1,<environment.Job instance at 0x7faa6dc7e140>,150,13,[11  4],151,-1,180,-1,167
1,<environment.Job instance at 0x7faa6d99a690>,158,12,[10  1],159,-1,179,-1,167
1,<environment.Job instance at 0x7faa6d99a460>,159,21,[1 7],160,-1,188,-1,167
1,<environment.Job instance at 0x7faa6dc7efa0>,155,12,[ 3 10],156,-1,179,-1,167
1,<environment.Job instance at 0x7faa6d99ae60>,160,16,[9 2],161,-1,183,-1,167
1,<environment.Job instance at 0x7faa6d99aeb0>,162,17,[ 2 14],163,-1,184,-1,167
1,<environment.Job instance at 0x7faa6dc7ebe0>,156,12,[9 4],157,-1,179,-1,167
1,<environment.Job instance at 0x7faa6e497730>,165,12,[5 9],166,-1,179,-1,167
1,<environment.Job instance at 0x7faa6dc7e230>,154,14,[10  4],155,-1,182,-1,168
1,<environment.Job instance at 0x7faa6dd2e230>,167,17,[8 2],168,-1,187,-1,170
1,<environment.Job instance at 0x7faa6dd2e500>,169,17,[9 2],170,-1,187,-1,170
1,<environment.Job instance at 0x7faa6e8c8d70>,172,15,[2 9],173,-1,189,-1,174
1,<environment.Job instance at 0x7faa6e589c30>,175,16,[11  3],176,-1,194,-1,178
1,<environment.Job instance at 0x7faa6e9d16e0>,177,16,[3 5],178,-1,195,-1,179
1,<environment.Job instance at 0x7faa6e77d690>,183,18,[ 2 10],184,-1,202,-1,184
1,<environment.Job instance at 0x7faa6e77d780>,184,17,[8 3],185,-1,202,-1,185
1,<environment.Job instance at 0x7faa6e5d1500>,187,17,[7 4],188,-1,205,-1,188
1,<environment.Job instance at 0x7faa6e4d4910>,4,2,[ 1 12],5,-1,7,-1,5
1,<environment.Job instance at 0x7faa6e2094b0>,10,25,[2 8],11,-1,45,-1,20
1,<environment.Job instance at 0x7faa6e6bf7d0>,14,3,[ 3 14],15,-1,36,-1,33
1,<environment.Job instance at 0x7faa6e570460>,19,2,[13  5],20,-1,49,-1,47
1,<environment.Job instance at 0x7faa6d9a9050>,28,1,[ 3 12],29,-1,99,-1,98
1,<environment.Job instance at 0x7faa6e1a03c0>,45,18,[14  2],46,-1,181,-1,163
1,<environment.Job instance at 0x7faa6e6dbaf0>,57,25,[9 4],58,-1,251,-1,226
1,<environment.Job instance at 0x7faa6dd334b0>,61,3,[ 4 12],62,-1,233,-1,230
1,<environment.Job instance at 0x7faa77974140>,66,16,[14  3],67,-1,264,-1,248
1,<environment.Job instance at 0x7faa6db878c0>,67,14,[12  5],68,-1,262,-1,248
1,<environment.Job instance at 0x7faa6dac10f0>,74,25,[7 4],75,-1,306,-1,281
1,<environment.Job instance at 0x7faa6d99af50>,85,23,[8 2],86,-1,350,-1,327
1,<environment.Job instance at 0x7faa6d9a22d0>,93,18,[ 2 11],94,-1,365,-1,347
1,<environment.Job instance at 0x7faa6d993f00>,95,3,[11  2],96,-1,361,-1,358
1,<environment.Job instance at 0x7faa6d98bcd0>,102,23,[7 1],103,-1,415,-1,392
1,<environment.Job instance at 0x7faa6db26730>,105,3,[13  2],106,-1,410,-1,407
1,<environment.Job instance at 0x7faa6da15870>,108,1,[13  4],109,-1,422,-1,421
1,<environment.Job instance at 0x7faa6db147d0>,112,13,[14  4],113,-1,439,-1,426
1,<environment.Job instance at 0x7faa6d987280>,121,23,[ 3 13],122,-1,482,-1,459
1,<environment.Job instance at 0x7faa6dba0190>,145,3,[ 1 14],146,-1,575,-1,572
1,<environment.Job instance at 0x7faa6e074d20>,150,13,[11  4],151,-1,604,-1,591
1,<environment.Job instance at 0x7faa6e07af00>,151,12,[ 1 13],152,-1,603,-1,591
1,<environment.Job instance at 0x7faa6e1c8f00>,162,17,[ 2 14],163,-1,655,-1,638
1,<environment.Job instance at 0x7faa6d8f5e10>,5,17,[ 2 10],6,-1,26,-1,9
1,<environment.Job instance at 0x7faa6d8f5960>,8,19,[7 1],9,-1,28,-1,9
1,<environment.Job instance at 0x7faa6d8f5870>,10,18,[9 2],11,-1,32,-1,14
1,<environment.Job instance at 0x7faa6e7c30a0>,14,12,[7 4],15,-1,27,-1,15
1,<environment.Job instance at 0x7faa6e7c36e0>,17,14,[11  2],18,-1,32,-1,18
1,<environment.Job instance at 0x7faa6e753460>,19,18,[1 5],20,-1,38,-1,20
1,<environment.Job instance at 0x7faa6e7536e0>,20,27,[7 4],21,-1,48,-1,21
1,<environment.Job instance at 0x7faa6e9c3910>,22,16,[10  2],23,-1,39,-1,23
1,<environment.Job instance at 0x7faa6e9c3500>,23,15,[4 8],24,-1,39,-1,24
1,<environment.Job instance at 0x7faa6e5bf050>,13,14,[5 5],14,-1,39,-1,25
1,<environment.Job instance at 0x7faa6e9c3b40>,27,18,[6 2],28,-1,46,-1,28
1,<environment.Job instance at 0x7faa6e9c3960>,28,14,[ 4 10],29,-1,44,-1,30
1,<environment.Job instance at 0x7faa6e9c3050>,31,14,[9 5],32,-1,46,-1,32
1,<environment.Job instance at 0x7faa6e9c3af0>,32,15,[7 3],33,-1,48,-1,33
1,<environment.Job instance at 0x7faa6e9c3320>,34,19,[9 1],35,-1,54,-1,35
1,<environment.Job instance at 0x7faa6e722d20>,38,13,[3 7],39,-1,52,-1,39
1,<environment.Job instance at 0x7faa6e722910>,39,15,[8 5],40,-1,55,-1,40
1,<environment.Job instance at 0x7faa6e722e60>,41,13,[9 4],42,-1,55,-1,42
1,<environment.Job instance at 0x7faa6e722550>,42,16,[1 7],43,-1,59,-1,43
1,<environment.Job instance at 0x7faa6e722dc0>,44,15,[6 4],45,-1,60,-1,45
1,<environment.Job instance at 0x7faa6e722c80>,47,16,[7 2],48,-1,64,-1,48
1,<environment.Job instance at 0x7faa6e6bbaf0>,52,14,[9 3],53,-1,67,-1,53
1,<environment.Job instance at 0x7faa6e6bbc80>,56,16,[4 9],57,-1,73,-1,57
1,<environment.Job instance at 0x7faa6e6bbe10>,57,22,[6 1],58,-1,80,-1,58
1,<environment.Job instance at 0x7faa6e6bbb40>,59,14,[3 8],60,-1,74,-1,60
1,<environment.Job instance at 0x7faa6e6bb780>,60,12,[5 9],61,-1,73,-1,61
1,<environment.Job instance at 0x7faa6e734640>,61,18,[5 9],62,-1,80,-1,62
1,<environment.Job instance at 0x7faa6e7345a0>,65,17,[10  3],66,-1,83,-1,66
1,<environment.Job instance at 0x7faa6e734c80>,67,16,[8 4],68,-1,84,-1,68
1,<environment.Job instance at 0x7faa6e734280>,68,14,[6 3],69,-1,83,-1,69
1,<environment.Job instance at 0x7faa6e734e10>,70,17,[8 4],71,-1,88,-1,71
1,<environment.Job instance at 0x7faa6e5707d0>,71,14,[ 5 10],72,-1,86,-1,72
1,<environment.Job instance at 0x7faa6e570fa0>,72,19,[8 3],73,-1,92,-1,73
1,<environment.Job instance at 0x7faa6e570c30>,73,13,[8 3],74,-1,87,-1,74
1,<environment.Job instance at 0x7faa6e570aa0>,74,17,[8 5],75,-1,92,-1,75
1,<environment.Job instance at 0x7faa6e570a00>,76,23,[5 5],77,-1,100,-1,77
1,<environment.Job instance at 0x7faa6e5706e0>,78,14,[9 5],79,-1,93,-1,79
1,<environment.Job instance at 0x7faa6e570960>,79,25,[7 3],80,-1,105,-1,80
1,<environment.Job instance at 0x7faa6d8b0cd0>,83,17,[6 4],84,-1,101,-1,84
1,<environment.Job instance at 0x7faa6d8b00f0>,84,17,[4 7],85,-1,102,-1,85
1,<environment.Job instance at 0x7faa6d8b03c0>,86,13,[10  5],87,-1,100,-1,87
1,<environment.Job instance at 0x7faa6e77d3c0>,92,14,[10  1],93,-1,107,-1,93
1,<environment.Job instance at 0x7faa6e77deb0>,95,14,[5 7],96,-1,110,-1,96
1,<environment.Job instance at 0x7faa6e5d15f0>,97,15,[3 9],98,-1,113,-1,98
1,<environment.Job instance at 0x7faa6e5d10a0>,98,15,[ 4 10],99,-1,114,-1,99
1,<environment.Job instance at 0x7faa6e5d1c30>,100,18,[5 4],101,-1,119,-1,101
1,<environment.Job instance at 0x7faa6e9d1640>,102,19,[6 2],103,-1,122,-1,103
1,<environment.Job instance at 0x7faa6dbff780>,108,18,[ 4 10],109,-1,127,-1,109
1,<environment.Job instance at 0x7faa6d9e3b90>,113,16,[3 8],114,-1,130,-1,114
1,<environment.Job instance at 0x7faa6ed1db40>,114,16,[9 2],115,-1,131,-1,115
1,<environment.Job instance at 0x7faa6ec44410>,116,18,[3 6],117,-1,135,-1,117
1,<environment.Job instance at 0x7faa6da0e370>,117,18,[5 5],118,-1,136,-1,118
1,<environment.Job instance at 0x7faa6d620320>,123,18,[4 5],124,-1,142,-1,124
1,<environment.Job instance at 0x7faa6d8aad70>,129,23,[4 9],130,-1,153,-1,130
1,<environment.Job instance at 0x7faa6e9c38c0>,29,13,[7 5],30,-1,147,-1,134
1,<environment.Job instance at 0x7faa777065a0>,118,22,[ 1 13],119,-1,158,-1,136
1,<environment.Job instance at 0x7faa6d757500>,125,18,[5 8],126,-1,154,-1,136
1,<environment.Job instance at 0x7faa6d4ee0f0>,126,18,[3 9],127,-1,154,-1,136
1,<environment.Job instance at 0x7faa6e9d1b40>,106,17,[ 1 13],107,-1,153,-1,136
1,<environment.Job instance at 0x7faa6d569690>,137,18,[9 4],138,-1,156,-1,138
1,<environment.Job instance at 0x7faa6d569230>,134,22,[5 8],135,-1,173,-1,151
1,<environment.Job instance at 0x7faa6def2dc0>,138,15,[1 8],139,-1,166,-1,151
1,<environment.Job instance at 0x7faa6def2be0>,143,1,[2 9],144,-1,152,-1,151
1,<environment.Job instance at 0x7faa6d5c0f00>,147,3,[4 5],148,-1,154,-1,151
1,<environment.Job instance at 0x7faa6d5c0fa0>,148,14,[7 2],149,-1,165,-1,151
1,<environment.Job instance at 0x7faa6d5c0e60>,149,18,[1 9],150,-1,169,-1,151
1,<environment.Job instance at 0x7faa6d5b9f50>,151,14,[6 1],152,-1,166,-1,152
1,<environment.Job instance at 0x7faa6d5c0190>,145,3,[5 7],146,-1,156,-1,153
1,<environment.Job instance at 0x7faa6d5b95f0>,154,17,[3 7],155,-1,172,-1,155
1,<environment.Job instance at 0x7faa6d5b9410>,153,14,[4 8],154,-1,169,-1,155
1,<environment.Job instance at 0x7faa6d5698c0>,135,16,[6 5],136,-1,174,-1,158
1,<environment.Job instance at 0x7faa6ed6f690>,155,3,[10  2],156,-1,161,-1,158
1,<environment.Job instance at 0x7faa6ed6f640>,158,2,[ 2 10],159,-1,161,-1,159
1,<environment.Job instance at 0x7faa6d615a00>,159,18,[2 9],160,-1,178,-1,160
1,<environment.Job instance at 0x7faa6d615960>,160,18,[5 5],161,-1,179,-1,161
1,<environment.Job instance at 0x7faa6ed6fe10>,156,14,[7 5],157,-1,175,-1,161
1,<environment.Job instance at 0x7faa6d61c3c0>,163,18,[5 2],164,-1,183,-1,165
1,<environment.Job instance at 0x7faa6d61c9b0>,166,12,[8 3],167,-1,179,-1,167
1,<environment.Job instance at 0x7faa6d766e60>,171,13,[9 1],172,-1,185,-1,172
1,<environment.Job instance at 0x7faa6d86c370>,17,14,[11  2],18,-1,39,-1,25
1,<environment.Job instance at 0x7faa6d86c690>,18,15,[ 3 14],19,-1,40,-1,25
1,<environment.Job instance at 0x7faa6d86c500>,20,27,[7 4],21,-1,56,-1,29
1,<environment.Job instance at 0x7faa6d597f00>,25,2,[ 1 12],26,-1,43,-1,41
1,<environment.Job instance at 0x7faa6e80c3c0>,30,25,[ 1 14],31,-1,86,-1,61
1,<environment.Job instance at 0x7faa6d5fc2d0>,33,1,[ 4 13],34,-1,75,-1,74
1,<environment.Job instance at 0x7faa6e9ea230>,35,3,[ 4 11],36,-1,88,-1,85
1,<environment.Job instance at 0x7faa6e954730>,48,3,[11  1],49,-1,137,-1,134
1,<environment.Job instance at 0x7faa6da30e10>,76,23,[5 5],77,-1,264,-1,241
1,<environment.Job instance at 0x7faa6da305f0>,79,25,[7 3],80,-1,281,-1,256
1,<environment.Job instance at 0x7faa6d6a5050>,80,1,[12  5],81,-1,257,-1,256
1,<environment.Job instance at 0x7faa6da4caa0>,91,3,[ 3 11],92,-1,296,-1,293
1,<environment.Job instance at 0x7faa6d6aeaa0>,105,3,[14  4],106,-1,348,-1,345
1,<environment.Job instance at 0x7faa6d6ae460>,106,17,[ 1 13],107,-1,362,-1,345
1,<environment.Job instance at 0x7faa6e1c10f0>,107,18,[ 3 12],108,-1,363,-1,345
1,<environment.Job instance at 0x7faa77348b90>,111,2,[11  4],112,-1,363,-1,361
1,<environment.Job instance at 0x7faa773a5050>,118,22,[ 1 13],119,-1,415,-1,393
1,<environment.Job instance at 0x7faa6d75d5a0>,128,2,[11  2],129,-1,435,-1,433
1,<environment.Job instance at 0x7faa6d61be60>,129,23,[4 9],130,-1,457,-1,434
1,<environment.Job instance at 0x7faa6d554aa0>,132,13,[14  2],133,-1,449,-1,436
1,<environment.Job instance at 0x7faa77979c30>,150,2,[ 4 14],151,-1,504,-1,502
1,<environment.Job instance at 0x7faa77701af0>,173,17,[14  2],174,-1,609,-1,592
1,<environment.Job instance at 0x7faa6e3a3b90>,6,18,[ 2 10],7,-1,25,-1,7
1,<environment.Job instance at 0x7faa6e3a3d20>,7,17,[5 5],8,-1,25,-1,8
1,<environment.Job instance at 0x7faa6e3a3dc0>,8,14,[9 5],9,-1,23,-1,9
1,<environment.Job instance at 0x7faa6e3a3e10>,9,14,[8 5],10,-1,24,-1,10
1,<environment.Job instance at 0x7faa6e3a3be0>,10,25,[9 4],11,-1,36,-1,11
1,<environment.Job instance at 0x7faa6de32500>,12,17,[1 5],13,-1,30,-1,13
1,<environment.Job instance at 0x7faa6de32eb0>,21,14,[8 4],22,-1,36,-1,22
1,<environment.Job instance at 0x7faa6de32410>,24,16,[8 1],25,-1,41,-1,25
1,<environment.Job instance at 0x7faa6de321e0>,25,3,[10  3],26,-1,29,-1,26
1,<environment.Job instance at 0x7faa6de32fa0>,26,16,[ 5 12],27,-1,43,-1,27
1,<environment.Job instance at 0x7faa6e1565a0>,28,19,[2 7],29,-1,48,-1,29
1,<environment.Job instance at 0x7faa6e1560f0>,30,12,[2 6],31,-1,43,-1,31
1,<environment.Job instance at 0x7faa6de32190>,20,18,[5 4],21,-1,50,-1,32
1,<environment.Job instance at 0x7faa6e156820>,32,22,[5 4],33,-1,57,-1,35
1,<environment.Job instance at 0x7faa6e156cd0>,36,18,[1 5],37,-1,55,-1,37
1,<environment.Job instance at 0x7faa6e156f00>,40,17,[10  1],41,-1,58,-1,41
1,<environment.Job instance at 0x7faa7797c0a0>,41,16,[2 5],42,-1,58,-1,42
1,<environment.Job instance at 0x7faa7797ce60>,42,15,[2 5],43,-1,60,-1,45
1,<environment.Job instance at 0x7faa6d9dca50>,49,16,[5 6],50,-1,77,-1,61
1,<environment.Job instance at 0x7faa6d9dc5f0>,50,18,[4 5],51,-1,79,-1,61
1,<environment.Job instance at 0x7faa6d9dc140>,53,13,[9 3],54,-1,74,-1,61
1,<environment.Job instance at 0x7faa6d9dc730>,51,18,[4 9],52,-1,80,-1,62
1,<environment.Job instance at 0x7faa6e156c30>,38,17,[7 5],39,-1,79,-1,62
1,<environment.Job instance at 0x7faa6d9dcaf0>,54,19,[2 5],55,-1,81,-1,62
1,<environment.Job instance at 0x7faa7797c5a0>,47,26,[10  5],48,-1,88,-1,62
1,<environment.Job instance at 0x7faa6de32f00>,18,26,[4 9],19,-1,88,-1,62
1,<environment.Job instance at 0x7faa6e607730>,64,22,[1 8],65,-1,87,-1,65
1,<environment.Job instance at 0x7faa6d9dc460>,55,14,[ 3 10],56,-1,80,-1,66
1,<environment.Job instance at 0x7faa6e607960>,65,18,[ 2 10],66,-1,84,-1,66
1,<environment.Job instance at 0x7faa6e607d20>,69,17,[9 1],70,-1,87,-1,70
1,<environment.Job instance at 0x7faa6e607f00>,70,16,[4 8],71,-1,88,-1,72
1,<environment.Job instance at 0x7faa6e6075f0>,73,17,[ 4 10],74,-1,91,-1,74
1,<environment.Job instance at 0x7faa6e607370>,77,12,[9 2],78,-1,92,-1,80
1,<environment.Job instance at 0x7faa6d9dc410>,63,23,[1 7],64,-1,103,-1,80
1,<environment.Job instance at 0x7faa6e607c30>,72,26,[1 5],73,-1,106,-1,80
1,<environment.Job instance at 0x7faa778087d0>,80,13,[10  5],81,-1,94,-1,81
1,<environment.Job instance at 0x7faa6e607dc0>,68,13,[14  3],69,-1,99,-1,86
1,<environment.Job instance at 0x7faa7783f910>,84,15,[4 7],85,-1,108,-1,93
1,<environment.Job instance at 0x7faa7783f7d0>,87,24,[2 8],88,-1,117,-1,93
1,<environment.Job instance at 0x7faa77808f00>,82,22,[5 3],83,-1,115,-1,93
1,<environment.Job instance at 0x7faa6e392cd0>,91,16,[4 9],92,-1,109,-1,93
1,<environment.Job instance at 0x7faa6e3929b0>,89,13,[14  2],90,-1,494,-1,481
1,<environment.Job instance at 0x7faa6dcb4370>,160,2,[5 4],161,-1,484,-1,482
1,<environment.Job instance at 0x7faa6dcb4640>,159,16,[6 2],160,-1,499,-1,483
1,<environment.Job instance at 0x7faa6ee07140>,162,16,[9 3],163,-1,499,-1,483
1,<environment.Job instance at 0x7faa6ee07780>,163,14,[1 6],164,-1,497,-1,483
1,<environment.Job instance at 0x7faa7797cb40>,46,17,[ 2 14],47,-1,500,-1,483
1,<environment.Job instance at 0x7faa6ee075a0>,165,22,[5 2],166,-1,507,-1,485
1,<environment.Job instance at 0x7faa6ee07960>,161,12,[2 5],162,-1,497,-1,485
1,<environment.Job instance at 0x7faa6e5d1640>,108,16,[5 1],109,-1,501,-1,485
1,<environment.Job instance at 0x7faa6ee07be0>,168,13,[5 7],169,-1,498,-1,485
1,<environment.Job instance at 0x7faa6ee07cd0>,170,13,[11  3],171,-1,498,-1,485
1,<environment.Job instance at 0x7faa6e1b95a0>,171,28,[7 5],172,-1,513,-1,485
1,<environment.Job instance at 0x7faa6e1b9e10>,172,14,[6 1],173,-1,499,-1,485
1,<environment.Job instance at 0x7faa6e44b280>,174,26,[7 1],175,-1,511,-1,485
1,<environment.Job instance at 0x7faa6e8ed1e0>,175,18,[10  4],176,-1,503,-1,485
1,<environment.Job instance at 0x7faa6ee63320>,181,18,[4 9],182,-1,505,-1,487
1,<environment.Job instance at 0x7faa6ee633c0>,182,18,[3 6],183,-1,506,-1,488
1,<environment.Job instance at 0x7faa6e793140>,188,18,[8 3],189,-1,506,-1,488
1,<environment.Job instance at 0x7faa6e607230>,10,25,[9 4],11,-1,46,-1,21
1,<environment.Job instance at 0x7faa6e3a6730>,14,28,[ 5 10],15,-1,65,-1,37
1,<environment.Job instance at 0x7faa6d8f4190>,17,27,[2 9],18,-1,65,-1,38
1,<environment.Job instance at 0x7faa6e21f960>,18,26,[4 9],19,-1,64,-1,38
1,<environment.Job instance at 0x7faa6e4b32d0>,26,16,[ 5 12],27,-1,72,-1,56
1,<environment.Job instance at 0x7faa6e41d410>,46,17,[ 2 14],47,-1,134,-1,117
1,<environment.Job instance at 0x7faa6e41d690>,47,26,[10  5],48,-1,161,-1,135
1,<environment.Job instance at 0x7faa6d9e1230>,63,23,[1 7],64,-1,200,-1,177
1,<environment.Job instance at 0x7faa6ecb1a00>,68,13,[14  3],69,-1,192,-1,179
1,<environment.Job instance at 0x7faa77334410>,72,26,[1 5],73,-1,225,-1,199
1,<environment.Job instance at 0x7faa6d69e960>,87,24,[2 8],88,-1,292,-1,268
1,<environment.Job instance at 0x7faa6d69e6e0>,89,13,[14  2],90,-1,281,-1,268
1,<environment.Job instance at 0x7faa773a5050>,93,26,[1 8],94,-1,308,-1,282
1,<environment.Job instance at 0x7faa6db5e1e0>,99,15,[ 1 14],100,-1,318,-1,303
1,<environment.Job instance at 0x7faa77348c30>,101,23,[9 4],102,-1,332,-1,309
1,<environment.Job instance at 0x7faa6e1a0eb0>,137,16,[11  5],138,-1,474,-1,458
1,<environment.Job instance at 0x7faa6e80dcd0>,141,3,[13  1],142,-1,468,-1,465
1,<environment.Job instance at 0x7faa6d5b95a0>,155,1,[ 3 12],156,-1,526,-1,525
1,<environment.Job instance at 0x7faa6e722730>,158,3,[ 5 12],159,-1,530,-1,527
1,<environment.Job instance at 0x7faa6e486230>,166,1,[11  1],167,-1,562,-1,561
1,<environment.Job instance at 0x7faa6e486cd0>,170,13,[11  3],171,-1,596,-1,583
1,<environment.Job instance at 0x7faa6e486140>,171,28,[7 5],172,-1,614,-1,586
1,<environment.Job instance at 0x7faa6e486c30>,173,2,[14  5],174,-1,588,-1,586
1,<environment.Job instance at 0x7faa6e4861e0>,174,26,[7 1],175,-1,613,-1,587
1,<environment.Job instance at 0x7faa6e8f3dc0>,187,13,[13  4],188,-1,647,-1,634
1,<environment.Job instance at 0x7faa777012d0>,2,15,[ 2 10],3,-1,18,-1,3
1,<environment.Job instance at 0x7faa6dc21aa0>,3,18,[6 3],4,-1,23,-1,5
1,<environment.Job instance at 0x7faa6dc219b0>,4,17,[10  3],5,-1,22,-1,5
1,<environment.Job instance at 0x7faa6dc21e60>,9,15,[9 3],10,-1,25,-1,10
1,<environment.Job instance at 0x7faa6dbfae60>,18,27,[1 7],19,-1,46,-1,19
1,<environment.Job instance at 0x7faa6dbf5fa0>,35,14,[6 1],36,-1,67,-1,53
1,<environment.Job instance at 0x7faa6dbf5d20>,37,18,[ 5 10],38,-1,74,-1,56
1,<environment.Job instance at 0x7faa6dbf5280>,31,17,[9 4],32,-1,83,-1,66
1,<environment.Job instance at 0x7faa6dbf5b90>,34,14,[9 5],35,-1,80,-1,66
1,<environment.Job instance at 0x7faa6dbf5410>,27,17,[13  5],28,-1,83,-1,66
1,<environment.Job instance at 0x7faa6dbf9b40>,46,18,[ 2 10],47,-1,84,-1,66
1,<environment.Job instance at 0x7faa6dbf9550>,47,18,[5 9],48,-1,84,-1,66
1,<environment.Job instance at 0x7faa6dbf5c30>,30,17,[5 9],31,-1,85,-1,68
1,<environment.Job instance at 0x7faa6dbf5a50>,38,15,[1 8],39,-1,84,-1,69
1,<environment.Job instance at 0x7faa6dbf97d0>,50,17,[8 2],51,-1,91,-1,74
1,<environment.Job instance at 0x7faa6dc21be0>,6,13,[11  3],7,-1,88,-1,75
1,<environment.Job instance at 0x7faa6dbf9d70>,55,13,[2 7],56,-1,88,-1,75
1,<environment.Job instance at 0x7faa6dbf9aa0>,58,25,[5 5],59,-1,106,-1,81
1,<environment.Job instance at 0x7faa6dbf94b0>,65,14,[5 9],66,-1,113,-1,99
1,<environment.Job instance at 0x7faa6dbf5140>,45,14,[8 4],46,-1,113,-1,99
1,<environment.Job instance at 0x7faa6dbf9b90>,51,14,[4 9],52,-1,113,-1,99
1,<environment.Job instance at 0x7faa6dbf62d0>,68,17,[2 7],69,-1,116,-1,99
1,<environment.Job instance at 0x7faa6dbf6f00>,69,16,[8 5],70,-1,116,-1,100
1,<environment.Job instance at 0x7faa6dbf6dc0>,70,22,[4 6],71,-1,123,-1,101
1,<environment.Job instance at 0x7faa6dbf6960>,72,18,[5 6],73,-1,119,-1,101
1,<environment.Job instance at 0x7faa6dbf98c0>,52,16,[6 2],53,-1,117,-1,101
1,<environment.Job instance at 0x7faa6dbf6280>,73,14,[4 8],74,-1,115,-1,101
1,<environment.Job instance at 0x7faa6dbf6230>,75,17,[3 9],76,-1,120,-1,103
1,<environment.Job instance at 0x7faa6dbf6910>,74,18,[10  2],75,-1,121,-1,103
1,<environment.Job instance at 0x7faa6dbf6550>,78,12,[10  5],79,-1,115,-1,103
1,<environment.Job instance at 0x7faa6dbf6c30>,82,17,[ 3 14],83,-1,121,-1,104
1,<environment.Job instance at 0x7faa6dbf69b0>,66,15,[2 7],67,-1,119,-1,104
1,<environment.Job instance at 0x7faa6dc1a2d0>,85,16,[ 4 12],86,-1,120,-1,104
1,<environment.Job instance at 0x7faa6dc1a550>,90,14,[ 3 10],91,-1,118,-1,104
1,<environment.Job instance at 0x7faa6dc1a910>,93,14,[9 2],94,-1,118,-1,104
1,<environment.Job instance at 0x7faa6dbf9c80>,61,15,[ 1 12],62,-1,123,-1,108
1,<environment.Job instance at 0x7faa6dc1ae60>,99,15,[4 9],100,-1,124,-1,109
1,<environment.Job instance at 0x7faa6dc1ae10>,100,15,[1 6],101,-1,124,-1,109
1,<environment.Job instance at 0x7faa6dbfa5f0>,0,24,[10  5],1,-1,25,-1,1
1,<environment.Job instance at 0x7faa6dbfa500>,1,3,[ 4 12],2,-1,5,-1,2
1,<environment.Job instance at 0x7faa6dbf50a0>,5,18,[ 2 11],6,-1,24,-1,6
1,<environment.Job instance at 0x7faa6e7c0cd0>,6,13,[11  3],7,-1,20,-1,7
1,<environment.Job instance at 0x7faa6dbf55a0>,8,27,[5 1],9,-1,36,-1,9
1,<environment.Job instance at 0x7faa6e49bcd0>,18,27,[1 7],19,-1,63,-1,36
1,<environment.Job instance at 0x7faa6dc2a5f0>,19,16,[12  5],20,-1,52,-1,36
1,<environment.Job instance at 0x7faa6e8f3eb0>,26,1,[14  4],27,-1,42,-1,41
1,<environment.Job instance at 0x7faa6e8f3460>,27,17,[13  5],28,-1,58,-1,41
1,<environment.Job instance at 0x7faa6e8037d0>,58,25,[5 5],59,-1,210,-1,185
1,<environment.Job instance at 0x7faa6d5fc320>,60,18,[14  5],61,-1,203,-1,185
1,<environment.Job instance at 0x7faa6e954d70>,61,15,[ 1 12],62,-1,200,-1,185
1,<environment.Job instance at 0x7faa6da30f50>,82,17,[ 3 14],83,-1,303,-1,286
1,<environment.Job instance at 0x7faa6d5fe370>,85,16,[ 4 12],86,-1,306,-1,290
1,<environment.Job instance at 0x7faa6d6b4190>,88,18,[13  3],89,-1,318,-1,300
1,<environment.Job instance at 0x7faa6d6b4050>,89,1,[ 4 14],90,-1,301,-1,300
1,<environment.Job instance at 0x7faa6d6b41e0>,92,16,[14  1],93,-1,321,-1,305
1,<environment.Job instance at 0x7faa6d662f00>,95,1,[ 5 13],96,-1,319,-1,318
1,<environment.Job instance at 0x7faa6d6a4aa0>,103,3,[ 5 11],104,-1,352,-1,349
1,<environment.Job instance at 0x7faa6e049550>,111,3,[ 3 11],112,-1,357,-1,354
1,<environment.Job instance at 0x7faa6db59870>,118,18,[ 4 12],119,-1,398,-1,380
1,<environment.Job instance at 0x7faa773341e0>,124,26,[10  2],125,-1,424,-1,398
1,<environment.Job instance at 0x7faa77701aa0>,137,15,[13  3],138,-1,442,-1,427
1,<environment.Job instance at 0x7faa6e41d500>,151,2,[ 2 13],152,-1,474,-1,472
1,<environment.Job instance at 0x7faa6e72cd20>,158,2,[12  1],159,-1,490,-1,488
1,<environment.Job instance at 0x7faa6e2133c0>,159,27,[ 5 11],160,-1,515,-1,488
1,<environment.Job instance at 0x7faa6e72c0a0>,163,25,[9 3],164,-1,542,-1,517
1,<environment.Job instance at 0x7faa6ee63550>,168,17,[ 2 12],169,-1,542,-1,525
1,<environment.Job instance at 0x7faa6e4b35f0>,170,26,[9 4],171,-1,569,-1,543
1,<environment.Job instance at 0x7faa6e21f640>,175,14,[13  2],176,-1,571,-1,557
1,<environment.Job instance at 0x7faa6e38ccd0>,4,13,[10  5],5,-1,19,-1,6
1,<environment.Job instance at 0x7faa6e38c910>,5,14,[10  1],6,-1,20,-1,6
1,<environment.Job instance at 0x7faa6e9dc0f0>,7,17,[1 7],8,-1,25,-1,8
1,<environment.Job instance at 0x7faa6e9dcb40>,9,17,[8 4],10,-1,27,-1,10
1,<environment.Job instance at 0x7faa6e9dcf50>,11,16,[2 6],12,-1,28,-1,12
1,<environment.Job instance at 0x7faa6e9dc280>,12,17,[8 1],13,-1,31,-1,14
1,<environment.Job instance at 0x7faa6e9dc050>,14,13,[2 5],15,-1,28,-1,15
1,<environment.Job instance at 0x7faa6e9dc820>,15,17,[1 8],16,-1,33,-1,16
1,<environment.Job instance at 0x7faa6e9dc230>,16,13,[12  4],17,-1,30,-1,17
1,<environment.Job instance at 0x7faa6e38c960>,13,26,[2 9],14,-1,44,-1,18
1,<environment.Job instance at 0x7faa6dd4a230>,22,18,[6 4],23,-1,42,-1,24
1,<environment.Job instance at 0x7faa6e3a63c0>,23,18,[1 8],24,-1,47,-1,29
1,<environment.Job instance at 0x7faa6ec062d0>,29,15,[8 4],30,-1,45,-1,30
1,<environment.Job instance at 0x7faa6e795cd0>,34,16,[5 3],35,-1,52,-1,36
1,<environment.Job instance at 0x7faa6e7f6b40>,38,18,[5 6],39,-1,57,-1,39
1,<environment.Job instance at 0x7faa6d9f5140>,42,18,[7 3],43,-1,61,-1,43
1,<environment.Job instance at 0x7faa6dbdb6e0>,43,13,[4 7],44,-1,57,-1,44
1,<environment.Job instance at 0x7faa6dddaf00>,45,16,[5 7],46,-1,62,-1,46
1,<environment.Job instance at 0x7faa6ddda140>,46,12,[4 6],47,-1,59,-1,47
1,<environment.Job instance at 0x7faa6ddda190>,47,16,[3 5],48,-1,64,-1,48
1,<environment.Job instance at 0x7faa6d8f4820>,49,23,[5 5],50,-1,73,-1,50
1,<environment.Job instance at 0x7faa6dc29dc0>,50,17,[8 3],51,-1,68,-1,51
1,<environment.Job instance at 0x7faa6da628c0>,53,13,[10  3],54,-1,67,-1,54
1,<environment.Job instance at 0x7faa6dd5e910>,54,17,[5 6],55,-1,72,-1,55
1,<environment.Job instance at 0x7faa6dd5e7d0>,55,24,[7 5],56,-1,80,-1,56
1,<environment.Job instance at 0x7faa6ed3a9b0>,56,15,[1 5],57,-1,72,-1,57
1,<environment.Job instance at 0x7faa6e53a190>,60,14,[6 1],61,-1,75,-1,61
1,<environment.Job instance at 0x7faa6dcb0730>,62,17,[3 8],63,-1,80,-1,63
1,<environment.Job instance at 0x7faa7734eaf0>,66,13,[ 1 10],67,-1,80,-1,67
1,<environment.Job instance at 0x7faa7734e8c0>,67,14,[9 3],68,-1,82,-1,68
1,<environment.Job instance at 0x7faa6dbb36e0>,69,15,[8 4],70,-1,85,-1,70
1,<environment.Job instance at 0x7faa6dbb3dc0>,71,15,[3 9],72,-1,87,-1,72
1,<environment.Job instance at 0x7faa6dbb3aa0>,75,19,[8 1],76,-1,95,-1,76
1,<environment.Job instance at 0x7faa7738f820>,81,23,[7 5],82,-1,105,-1,82
1,<environment.Job instance at 0x7faa7738f320>,82,28,[8 2],83,-1,111,-1,83
1,<environment.Job instance at 0x7faa7738f780>,83,22,[5 4],84,-1,106,-1,84
1,<environment.Job instance at 0x7faa7738f690>,85,17,[ 4 10],86,-1,103,-1,86
1,<environment.Job instance at 0x7faa6dc7e3c0>,90,16,[1 5],91,-1,107,-1,91
1,<environment.Job instance at 0x7faa6dc7ea00>,91,17,[6 5],92,-1,109,-1,92
1,<environment.Job instance at 0x7faa6dc7eaa0>,93,18,[10  5],94,-1,112,-1,94
1,<environment.Job instance at 0x7faa6dc7efa0>,96,16,[3 6],97,-1,113,-1,97
1,<environment.Job instance at 0x7faa6e631c30>,103,18,[4 9],104,-1,122,-1,104
1,<environment.Job instance at 0x7faa6ec17320>,114,17,[10  4],115,-1,133,-1,116
1,<environment.Job instance at 0x7faa6ec178c0>,120,13,[8 3],121,-1,135,-1,122
1,<environment.Job instance at 0x7faa77462cd0>,129,15,[6 1],130,-1,147,-1,132
1,<environment.Job instance at 0x7faa77462960>,127,19,[4 7],128,-1,152,-1,133
1,<environment.Job instance at 0x7faa6ec173c0>,121,16,[8 1],122,-1,177,-1,161
1,<environment.Job instance at 0x7faa6e61e640>,134,16,[6 3],135,-1,177,-1,161
1,<environment.Job instance at 0x7faa6e39a4b0>,142,22,[6 2],143,-1,183,-1,161
1,<environment.Job instance at 0x7faa6e39a910>,144,23,[6 5],145,-1,184,-1,161
1,<environment.Job instance at 0x7faa6dcb3640>,139,15,[9 3],140,-1,177,-1,162
1,<environment.Job instance at 0x7faa6e61ea00>,132,12,[10  3],133,-1,177,-1,165
1,<environment.Job instance at 0x7faa6da78d20>,153,21,[7 4],154,-1,186,-1,165
1,<environment.Job instance at 0x7faa6e39aa00>,143,16,[4 9],144,-1,181,-1,165
1,<environment.Job instance at 0x7faa6da78280>,155,15,[ 5 11],156,-1,180,-1,165
1,<environment.Job instance at 0x7faa6df835a0>,148,12,[ 3 10],149,-1,178,-1,166
1,<environment.Job instance at 0x7faa6da781e0>,160,26,[5 7],161,-1,193,-1,167
1,<environment.Job instance at 0x7faa6da78730>,152,17,[1 6],153,-1,184,-1,167
1,<environment.Job instance at 0x7faa6da78eb0>,159,1,[9 1],160,-1,168,-1,167
1,<environment.Job instance at 0x7faa6ea15c30>,161,16,[ 2 10],162,-1,183,-1,167
1,<environment.Job instance at 0x7faa6ea15870>,164,20,[5 9],165,-1,204,-1,184
1,<environment.Job instance at 0x7faa6ec175f0>,118,16,[14  5],119,-1,201,-1,185
1,<environment.Job instance at 0x7faa6e344910>,169,27,[5 9],170,-1,212,-1,185
1,<environment.Job instance at 0x7faa6e344820>,168,18,[5 6],169,-1,203,-1,185
1,<environment.Job instance at 0x7faa6dbdb140>,8,2,[ 4 12],9,-1,11,-1,9
1,<environment.Job instance at 0x7faa7738f410>,16,13,[12  4],17,-1,54,-1,41
1,<environment.Job instance at 0x7faa7734e0a0>,13,26,[2 9],14,-1,70,-1,44
1,<environment.Job instance at 0x7faa7738f460>,21,17,[13  5],22,-1,66,-1,49
1,<environment.Job instance at 0x7faa6e7d2f00>,49,23,[5 5],50,-1,163,-1,140
1,<environment.Job instance at 0x7faa6ddfb690>,55,24,[7 5],56,-1,195,-1,171
1,<environment.Job instance at 0x7faa6db59870>,57,3,[ 2 13],58,-1,174,-1,171
1,<environment.Job instance at 0x7faa6dc1acd0>,70,1,[13  2],71,-1,214,-1,213
1,<environment.Job instance at 0x7faa6dc2a5f0>,73,1,[ 2 13],74,-1,227,-1,226
1,<environment.Job instance at 0x7faa6dbf65a0>,76,1,[ 4 11],77,-1,242,-1,241
1,<environment.Job instance at 0x7faa6dbfac80>,81,23,[7 5],82,-1,268,-1,245
1,<environment.Job instance at 0x7faa6dbfa500>,82,28,[8 2],83,-1,285,-1,257
1,<environment.Job instance at 0x7faa6e9fce10>,104,26,[7 4],105,-1,318,-1,292
1,<environment.Job instance at 0x7faa6e9fc4b0>,105,1,[12  3],106,-1,293,-1,292
1,<environment.Job instance at 0x7faa6e9fc730>,118,16,[14  5],119,-1,348,-1,332
1,<environment.Job instance at 0x7faa6e9fc3c0>,122,14,[ 2 12],123,-1,349,-1,335
1,<environment.Job instance at 0x7faa6d6955f0>,125,15,[ 2 12],126,-1,364,-1,349
1,<environment.Job instance at 0x7faa6dcc7640>,144,23,[6 5],145,-1,470,-1,447
1,<environment.Job instance at 0x7faa6e9e6dc0>,155,15,[ 5 11],156,-1,481,-1,466
1,<environment.Job instance at 0x7faa6e9e6a50>,160,26,[5 7],161,-1,496,-1,470
1,<environment.Job instance at 0x7faa6e32e5a0>,169,27,[5 9],170,-1,531,-1,504
1,<environment.Job instance at 0x7faa6e32eeb0>,172,26,[ 1 10],173,-1,533,-1,507
1,<environment.Job instance at 0x7faa6e32e140>,173,28,[3 5],174,-1,535,-1,507
1,<environment.Job instance at 0x7faa6d8152d0>,2,16,[11  5],3,-1,19,-1,3
1,<environment.Job instance at 0x7faa6d8151e0>,4,18,[3 8],5,-1,23,-1,5
1,<environment.Job instance at 0x7faa6d815410>,6,14,[3 9],7,-1,21,-1,7
1,<environment.Job instance at 0x7faa6d815a50>,11,17,[2 9],12,-1,29,-1,12
1,<environment.Job instance at 0x7faa6d815eb0>,16,12,[9 1],17,-1,29,-1,17
1,<environment.Job instance at 0x7faa6d7f50a0>,18,14,[7 3],19,-1,33,-1,19
1,<environment.Job instance at 0x7faa6d7f50f0>,20,12,[3 8],21,-1,33,-1,21
1,<environment.Job instance at 0x7faa6d7f5780>,24,18,[6 3],25,-1,43,-1,25
1,<environment.Job instance at 0x7faa6d7f58c0>,25,23,[7 4],26,-1,49,-1,26
1,<environment.Job instance at 0x7faa6d7f5730>,26,23,[5 6],27,-1,50,-1,27
1,<environment.Job instance at 0x7faa6d7f5960>,27,16,[2 6],28,-1,44,-1,28
1,<environment.Job instance at 0x7faa6d7f5a00>,28,25,[ 5 10],29,-1,54,-1,29
1,<environment.Job instance at 0x7faa6d7f5b40>,30,17,[6 4],31,-1,48,-1,31
1,<environment.Job instance at 0x7faa6d7f5cd0>,31,12,[ 5 11],32,-1,44,-1,32
1,<environment.Job instance at 0x7faa6d7f5b90>,32,18,[9 5],33,-1,51,-1,33
1,<environment.Job instance at 0x7faa6d7f5dc0>,33,17,[5 1],34,-1,51,-1,34
1,<environment.Job instance at 0x7faa6d7f5f00>,35,15,[9 5],36,-1,51,-1,36
1,<environment.Job instance at 0x7faa6d80e500>,40,13,[6 5],41,-1,55,-1,42
1,<environment.Job instance at 0x7faa6d80e640>,42,2,[5 1],43,-1,45,-1,43
1,<environment.Job instance at 0x7faa6d80e6e0>,43,17,[ 5 12],44,-1,61,-1,44
1,<environment.Job instance at 0x7faa6d80e780>,44,17,[5 7],45,-1,62,-1,45
1,<environment.Job instance at 0x7faa6d80e820>,45,12,[5 1],46,-1,58,-1,46
1,<environment.Job instance at 0x7faa6d80e550>,41,16,[8 5],42,-1,62,-1,46
1,<environment.Job instance at 0x7faa6d80ef50>,52,1,[7 2],53,-1,55,-1,54
1,<environment.Job instance at 0x7faa6d7ff140>,54,12,[ 4 10],55,-1,67,-1,55
1,<environment.Job instance at 0x7faa6d7ff1e0>,55,15,[8 2],56,-1,71,-1,56
1,<environment.Job instance at 0x7faa6d80edc0>,53,20,[5 2],54,-1,77,-1,57
1,<environment.Job instance at 0x7faa6d7ff0a0>,59,14,[8 5],60,-1,76,-1,62
1,<environment.Job instance at 0x7faa6d7ff780>,61,18,[6 1],62,-1,80,-1,62
1,<environment.Job instance at 0x7faa6d7ff730>,63,14,[2 9],64,-1,79,-1,65
1,<environment.Job instance at 0x7faa6d7ffa50>,64,12,[9 4],65,-1,77,-1,65
1,<environment.Job instance at 0x7faa6e77a0a0>,70,25,[8 3],71,-1,96,-1,71
1,<environment.Job instance at 0x7faa6e77a1e0>,71,27,[8 1],72,-1,99,-1,72
1,<environment.Job instance at 0x7faa6e77a780>,76,17,[3 8],77,-1,95,-1,78
1,<environment.Job instance at 0x7faa6e77a8c0>,77,27,[2 6],78,-1,106,-1,79
1,<environment.Job instance at 0x7faa6e77a870>,79,18,[5 2],80,-1,101,-1,83
1,<environment.Job instance at 0x7faa6e77acd0>,82,13,[9 4],83,-1,96,-1,83
1,<environment.Job instance at 0x7faa6e77aeb0>,85,18,[5 5],86,-1,105,-1,87
1,<environment.Job instance at 0x7faa6e7731e0>,86,14,[10  1],87,-1,101,-1,87
1,<environment.Job instance at 0x7faa6e773140>,87,26,[ 5 10],88,-1,119,-1,93
1,<environment.Job instance at 0x7faa6d7fb7d0>,99,18,[5 5],100,-1,120,-1,102
1,<environment.Job instance at 0x7faa6e773370>,91,17,[3 6],92,-1,127,-1,110
1,<environment.Job instance at 0x7faa6e773690>,92,17,[ 4 10],93,-1,128,-1,111
1,<environment.Job instance at 0x7faa6e773320>,90,17,[4 8],91,-1,128,-1,111
1,<environment.Job instance at 0x7faa6d7fb280>,101,18,[5 5],102,-1,129,-1,111
1,<environment.Job instance at 0x7faa6d9e05a0>,106,17,[3 7],107,-1,130,-1,113
1,<environment.Job instance at 0x7faa6dbbf410>,102,28,[5 1],103,-1,145,-1,117
1,<environment.Job instance at 0x7faa6db70550>,115,18,[5 3],116,-1,139,-1,121
1,<environment.Job instance at 0x7faa6d7ff3c0>,58,12,[12  2],59,-1,146,-1,134
1,<environment.Job instance at 0x7faa6d7f9c80>,111,17,[ 4 10],112,-1,157,-1,140
1,<environment.Job instance at 0x7faa6e0bdaf0>,123,15,[5 8],124,-1,156,-1,141
1,<environment.Job instance at 0x7faa6db34c30>,122,16,[9 2],123,-1,159,-1,143
1,<environment.Job instance at 0x7faa6e0fa820>,128,26,[2 5],129,-1,169,-1,143
1,<environment.Job instance at 0x7faa6e337690>,121,17,[6 1],122,-1,162,-1,145
1,<environment.Job instance at 0x7faa6d7f9500>,109,13,[ 1 13],110,-1,162,-1,149
1,<environment.Job instance at 0x7faa6e8c99b0>,131,1,[9 5],132,-1,151,-1,150
1,<environment.Job instance at 0x7faa6e8c9d20>,132,3,[5 9],133,-1,153,-1,150
1,<environment.Job instance at 0x7faa6e0fae60>,130,28,[1 5],131,-1,182,-1,154
1,<environment.Job instance at 0x7faa6e0fa320>,129,28,[4 8],130,-1,182,-1,154
1,<environment.Job instance at 0x7faa6e4ac960>,136,22,[7 4],137,-1,176,-1,154
1,<environment.Job instance at 0x7faa6e9dde10>,138,18,[5 5],139,-1,178,-1,160
1,<environment.Job instance at 0x7faa6e4ac410>,137,28,[ 1 10],138,-1,188,-1,160
1,<environment.Job instance at 0x7faa6e9ddeb0>,139,15,[3 6],140,-1,175,-1,160
1,<environment.Job instance at 0x7faa6e894a00>,144,18,[ 2 10],145,-1,178,-1,160
1,<environment.Job instance at 0x7faa6e894190>,146,1,[10  4],147,-1,161,-1,160
1,<environment.Job instance at 0x7faa6e8abf50>,150,2,[ 4 10],151,-1,162,-1,160
1,<environment.Job instance at 0x7faa6e8aba00>,151,1,[9 1],152,-1,161,-1,160
1,<environment.Job instance at 0x7faa6e8abc30>,152,18,[7 2],153,-1,179,-1,161
1,<environment.Job instance at 0x7faa6e8ab140>,149,1,[8 3],150,-1,162,-1,161
1,<environment.Job instance at 0x7faa6ed04960>,154,16,[5 8],155,-1,179,-1,163
1,<environment.Job instance at 0x7faa6e8ab370>,155,16,[2 7],156,-1,179,-1,163
1,<environment.Job instance at 0x7faa6e32c6e0>,157,12,[10  4],158,-1,175,-1,163
1,<environment.Job instance at 0x7faa6e4b20f0>,158,12,[3 8],159,-1,175,-1,163
1,<environment.Job instance at 0x7faa6e8910a0>,159,16,[ 3 10],160,-1,179,-1,163
1,<environment.Job instance at 0x7faa6e3333c0>,141,1,[9 3],142,-1,164,-1,163
1,<environment.Job instance at 0x7faa6dd513c0>,160,13,[8 2],161,-1,176,-1,163
1,<environment.Job instance at 0x7faa6dd51050>,162,13,[1 7],163,-1,176,-1,163
1,<environment.Job instance at 0x7faa6e04d0a0>,163,15,[3 5],164,-1,180,-1,165
1,<environment.Job instance at 0x7faa6e8ab5a0>,148,14,[9 3],149,-1,179,-1,165
1,<environment.Job instance at 0x7faa6dd51d20>,165,13,[6 1],166,-1,179,-1,166
1,<environment.Job instance at 0x7faa6e8b49b0>,166,20,[10  4],167,-1,187,-1,167
1,<environment.Job instance at 0x7faa6e8a3230>,169,13,[3 6],170,-1,183,-1,170
1,<environment.Job instance at 0x7faa6e6447d0>,180,16,[8 2],181,-1,198,-1,182
1,<environment.Job instance at 0x7faa6d7f9cd0>,114,23,[2 9],115,-1,205,-1,182
1,<environment.Job instance at 0x7faa6e644af0>,181,12,[9 4],182,-1,194,-1,182
1,<environment.Job instance at 0x7faa6e644820>,182,17,[5 5],183,-1,200,-1,183
1,<environment.Job instance at 0x7faa6e641b40>,183,24,[9 2],184,-1,208,-1,184
1,<environment.Job instance at 0x7faa6d80eb90>,2,16,[11  5],3,-1,19,-1,3
1,<environment.Job instance at 0x7faa6e8a3320>,25,23,[7 4],26,-1,79,-1,56
1,<environment.Job instance at 0x7faa6e6106e0>,26,23,[5 6],27,-1,79,-1,56
1,<environment.Job instance at 0x7faa6def1640>,28,25,[ 5 10],29,-1,87,-1,62
1,<environment.Job instance at 0x7faa6d81cd20>,31,12,[ 5 11],32,-1,82,-1,70
1,<environment.Job instance at 0x7faa6d8158c0>,37,26,[ 2 10],38,-1,134,-1,108
1,<environment.Job instance at 0x7faa6e32ef50>,43,17,[ 5 12],44,-1,137,-1,120
1,<environment.Job instance at 0x7faa6e32e960>,57,2,[ 5 11],58,-1,157,-1,155
1,<environment.Job instance at 0x7faa6e9e6410>,58,12,[12  2],59,-1,167,-1,155
1,<environment.Job instance at 0x7faa6e9e6a50>,60,2,[ 4 14],61,-1,158,-1,156
1,<environment.Job instance at 0x7faa6dcc7af0>,71,27,[8 1],72,-1,237,-1,210
1,<environment.Job instance at 0x7faa6dcc7780>,70,25,[8 3],71,-1,235,-1,210
1,<environment.Job instance at 0x7faa6dcc7320>,77,27,[2 6],78,-1,243,-1,216
1,<environment.Job instance at 0x7faa6d695870>,87,26,[ 5 10],88,-1,267,-1,241
1,<environment.Job instance at 0x7faa6d695140>,89,1,[12  4],90,-1,242,-1,241
1,<environment.Job instance at 0x7faa6e9fc1e0>,94,1,[ 1 11],95,-1,273,-1,272
1,<environment.Job instance at 0x7faa6e9fc7d0>,95,1,[ 3 14],96,-1,273,-1,272
1,<environment.Job instance at 0x7faa6e9fcc80>,102,28,[5 1],103,-1,321,-1,293
1,<environment.Job instance at 0x7faa6e9fc6e0>,109,13,[ 1 13],110,-1,316,-1,303
1,<environment.Job instance at 0x7faa6e637820>,114,23,[2 9],115,-1,350,-1,327
1,<environment.Job instance at 0x7faa6e637be0>,116,3,[14  4],117,-1,330,-1,327
1,<environment.Job instance at 0x7faa6dbfa9b0>,128,26,[2 5],129,-1,406,-1,380
1,<environment.Job instance at 0x7faa6dbf58c0>,130,28,[1 5],131,-1,414,-1,386
1,<environment.Job instance at 0x7faa6dbf5460>,129,28,[4 8],130,-1,418,-1,390
1,<environment.Job instance at 0x7faa6dbf6820>,137,28,[ 1 10],138,-1,432,-1,404
1,<environment.Job instance at 0x7faa6e8df370>,183,24,[9 2],184,-1,571,-1,547
1,<environment.Job instance at 0x7faa6e757370>,0,12,[9 2],1,-1,14,-1,2
1,<environment.Job instance at 0x7faa6e6409b0>,1,24,[2 6],2,-1,26,-1,2
1,<environment.Job instance at 0x7faa6d981d20>,9,16,[ 1 10],10,-1,26,-1,10
1,<environment.Job instance at 0x7faa6e3407d0>,11,13,[3 5],12,-1,25,-1,12
1,<environment.Job instance at 0x7faa6e3401e0>,13,21,[5 4],14,-1,35,-1,14
1,<environment.Job instance at 0x7faa6e340f50>,14,17,[11  5],15,-1,32,-1,15
1,<environment.Job instance at 0x7faa6e3405a0>,16,12,[10  3],17,-1,32,-1,20
1,<environment.Job instance at 0x7faa6e340c80>,19,14,[5 9],20,-1,35,-1,21
1,<environment.Job instance at 0x7faa6e340690>,22,18,[10  3],23,-1,43,-1,25
1,<environment.Job instance at 0x7faa6e340870>,24,24,[5 8],25,-1,50,-1,26
1,<environment.Job instance at 0x7faa6d602910>,26,24,[10  2],27,-1,51,-1,27
1,<environment.Job instance at 0x7faa6e340aa0>,27,18,[3 8],28,-1,48,-1,30
1,<environment.Job instance at 0x7faa6e72c190>,33,17,[7 2],34,-1,51,-1,34
1,<environment.Job instance at 0x7faa6e72ca00>,34,18,[1 8],35,-1,53,-1,35
1,<environment.Job instance at 0x7faa6e72c280>,36,23,[9 5],37,-1,60,-1,37
1,<environment.Job instance at 0x7faa6de7fd20>,37,18,[1 8],38,-1,56,-1,38
1,<environment.Job instance at 0x7faa6de7f2d0>,39,17,[6 3],40,-1,57,-1,40
1,<environment.Job instance at 0x7faa6dfe26e0>,42,18,[1 6],43,-1,61,-1,43
1,<environment.Job instance at 0x7faa6dfe2eb0>,43,17,[10  3],44,-1,63,-1,46
1,<environment.Job instance at 0x7faa6dfe2370>,45,16,[7 4],46,-1,62,-1,46
1,<environment.Job instance at 0x7faa6e8d40f0>,52,17,[6 3],53,-1,71,-1,54
1,<environment.Job instance at 0x7faa6e8d4690>,54,2,[5 3],55,-1,57,-1,55
1,<environment.Job instance at 0x7faa6e8d4820>,53,27,[5 6],54,-1,83,-1,56
1,<environment.Job instance at 0x7faa6e9e3500>,64,27,[3 8],65,-1,110,-1,83
1,<environment.Job instance at 0x7faa773a5e10>,73,18,[1 8],74,-1,103,-1,85
1,<environment.Job instance at 0x7faa773a5280>,74,17,[3 6],75,-1,102,-1,85
1,<environment.Job instance at 0x7faa773a5320>,75,27,[4 6],76,-1,112,-1,85
1,<environment.Job instance at 0x7faa6e9e36e0>,70,18,[12  3],71,-1,105,-1,87
1,<environment.Job instance at 0x7faa6dad86e0>,76,15,[8 5],77,-1,103,-1,88
1,<environment.Job instance at 0x7faa6dcbe0f0>,80,16,[10  3],81,-1,113,-1,97
1,<environment.Job instance at 0x7faa6e8d4410>,56,16,[ 3 11],57,-1,124,-1,108
1,<environment.Job instance at 0x7faa6e9e3690>,61,12,[10  1],62,-1,121,-1,109
1,<environment.Job instance at 0x7faa6e94ba50>,90,14,[11  5],91,-1,124,-1,110
1,<environment.Job instance at 0x7faa6d92d730>,92,17,[3 8],93,-1,135,-1,118
1,<environment.Job instance at 0x7faa6d838410>,91,13,[ 1 10],92,-1,131,-1,118
1,<environment.Job instance at 0x7faa6d6fc0a0>,94,28,[4 7],95,-1,151,-1,123
1,<environment.Job instance at 0x7faa6d640f00>,95,13,[ 3 10],96,-1,136,-1,123
1,<environment.Job instance at 0x7faa6d950910>,98,14,[10  3],99,-1,142,-1,128
1,<environment.Job instance at 0x7faa6e675c30>,100,24,[9 4],101,-1,152,-1,128
1,<environment.Job instance at 0x7faa6e9e3550>,71,15,[4 9],72,-1,143,-1,128
1,<environment.Job instance at 0x7faa77391640>,101,17,[5 4],102,-1,145,-1,128
1,<environment.Job instance at 0x7faa6e5c8460>,99,18,[8 2],100,-1,150,-1,132
1,<environment.Job instance at 0x7faa6d6a2460>,106,18,[10  1],107,-1,150,-1,132
1,<environment.Job instance at 0x7faa6dfb0a50>,109,15,[ 4 10],110,-1,158,-1,143
1,<environment.Job instance at 0x7faa6dfb0410>,110,17,[3 8],111,-1,160,-1,143
1,<environment.Job instance at 0x7faa6dbf5cd0>,86,15,[5 2],87,-1,159,-1,144
1,<environment.Job instance at 0x7faa6dfb0e10>,113,17,[7 3],114,-1,163,-1,146
1,<environment.Job instance at 0x7faa6ed798c0>,108,16,[7 1],109,-1,162,-1,146
1,<environment.Job instance at 0x7faa6e2ce870>,116,12,[4 6],117,-1,158,-1,146
1,<environment.Job instance at 0x7faa6dfb0fa0>,111,16,[12  1],112,-1,170,-1,154
1,<environment.Job instance at 0x7faa6eb2bfa0>,123,17,[10  3],124,-1,175,-1,158
1,<environment.Job instance at 0x7faa6eb2b190>,126,16,[2 9],127,-1,176,-1,160
1,<environment.Job instance at 0x7faa6d8e4f50>,127,22,[10  4],128,-1,182,-1,160
1,<environment.Job instance at 0x7faa6e9e3af0>,69,17,[7 5],70,-1,177,-1,160
1,<environment.Job instance at 0x7faa6dc7eb40>,129,3,[4 7],130,-1,163,-1,160
1,<environment.Job instance at 0x7faa6dc7e9b0>,128,21,[7 1],129,-1,181,-1,160
1,<environment.Job instance at 0x7faa6eb79820>,132,21,[5 3],133,-1,181,-1,160
1,<environment.Job instance at 0x7faa6eb79870>,134,15,[4 8],135,-1,177,-1,162
1,<environment.Job instance at 0x7faa6d987910>,143,17,[6 4],144,-1,197,-1,180
1,<environment.Job instance at 0x7faa77359b90>,146,21,[10  2],147,-1,204,-1,183
1,<environment.Job instance at 0x7faa6dfe8500>,152,15,[3 8],153,-1,202,-1,187
1,<environment.Job instance at 0x7faa6dfb06e0>,114,13,[7 1],115,-1,200,-1,187
1,<environment.Job instance at 0x7faa6e2ce820>,117,18,[3 9],118,-1,205,-1,187
1,<environment.Job instance at 0x7faa6dfe8820>,154,16,[8 4],155,-1,203,-1,187
1,<environment.Job instance at 0x7faa6eb7eaa0>,165,18,[2 9],166,-1,260,-1,242
1,<environment.Job instance at 0x7faa6e33e3c0>,157,14,[7 4],158,-1,256,-1,242
1,<environment.Job instance at 0x7faa6dbfb190>,167,19,[ 2 10],168,-1,261,-1,242
1,<environment.Job instance at 0x7faa6e33e280>,156,14,[ 2 10],157,-1,256,-1,242
1,<environment.Job instance at 0x7faa6dbfb370>,169,17,[1 5],170,-1,259,-1,242
1,<environment.Job instance at 0x7faa6eb7e730>,166,18,[10  3],167,-1,261,-1,243
1,<environment.Job instance at 0x7faa6d5bc1e0>,172,1,[3 7],173,-1,244,-1,243
1,<environment.Job instance at 0x7faa6d5bc960>,171,3,[1 5],172,-1,246,-1,243
1,<environment.Job instance at 0x7faa6ed888c0>,177,17,[ 5 10],178,-1,265,-1,248
1,<environment.Job instance at 0x7faa6ed88410>,178,15,[2 6],179,-1,263,-1,248
1,<environment.Job instance at 0x7faa6e8d1960>,179,16,[5 5],180,-1,264,-1,248
1,<environment.Job instance at 0x7faa6df85910>,180,17,[6 1],181,-1,265,-1,248
1,<environment.Job instance at 0x7faa6e9723c0>,181,14,[4 8],182,-1,262,-1,248
1,<environment.Job instance at 0x7faa6d5bc410>,173,15,[5 7],174,-1,263,-1,248
1,<environment.Job instance at 0x7faa6e4b7730>,186,16,[12  5],187,-1,264,-1,248
1,<environment.Job instance at 0x7faa6d5c4050>,175,1,[8 4],176,-1,249,-1,248
1,<environment.Job instance at 0x7faa6e340550>,15,15,[ 2 12],16,-1,263,-1,248
1,<environment.Job instance at 0x7faa6d5bc6e0>,170,17,[ 5 14],171,-1,265,-1,248
1,<environment.Job instance at 0x7faa6e4b7a50>,188,2,[3 7],189,-1,252,-1,250
1,<environment.Job instance at 0x7faa6d987e10>,140,14,[12  5],141,-1,265,-1,251
1,<environment.Job instance at 0x7faa6e3406e0>,1,24,[2 6],2,-1,26,-1,2
1,<environment.Job instance at 0x7faa6da585a0>,14,17,[11  5],15,-1,38,-1,21
1,<environment.Job instance at 0x7faa6e804d20>,15,15,[ 2 12],16,-1,36,-1,21
1,<environment.Job instance at 0x7faa6dbfbb90>,24,24,[5 8],25,-1,73,-1,49
1,<environment.Job instance at 0x7faa6e9720a0>,26,24,[10  2],27,-1,79,-1,55
1,<environment.Job instance at 0x7faa6d7884b0>,30,2,[14  3],31,-1,58,-1,56
1,<environment.Job instance at 0x7faa6d981870>,36,23,[9 5],37,-1,129,-1,106
1,<environment.Job instance at 0x7faa6dcb3c80>,49,1,[13  5],50,-1,129,-1,128
1,<environment.Job instance at 0x7faa6da78f00>,53,27,[5 6],54,-1,184,-1,157
1,<environment.Job instance at 0x7faa6ea15af0>,56,16,[ 3 11],57,-1,173,-1,157
1,<environment.Job instance at 0x7faa6d9d15a0>,58,25,[11  1],59,-1,182,-1,157
1,<environment.Job instance at 0x7faa6e7d20f0>,64,27,[3 8],65,-1,191,-1,164
1,<environment.Job instance at 0x7faa6dc2a5f0>,70,18,[12  3],71,-1,196,-1,178
1,<environment.Job instance at 0x7faa6dbf9a50>,75,27,[4 6],76,-1,231,-1,204
1,<environment.Job instance at 0x7faa6e6375a0>,90,14,[11  5],91,-1,269,-1,255
1,<environment.Job instance at 0x7faa6e637640>,94,28,[4 7],95,-1,317,-1,289
1,<environment.Job instance at 0x7faa6e9fcd20>,100,24,[9 4],101,-1,332,-1,308
1,<environment.Job instance at 0x7faa6e9fcc80>,103,2,[12  3],104,-1,310,-1,308
1,<environment.Job instance at 0x7faa6e9fca50>,111,16,[12  1],112,-1,365,-1,349
1,<environment.Job instance at 0x7faa6e9e6730>,138,3,[14  4],139,-1,452,-1,449
1,<environment.Job instance at 0x7faa6e9e6a00>,140,14,[12  5],141,-1,465,-1,451
1,<environment.Job instance at 0x7faa6d815230>,160,25,[ 4 10],161,-1,541,-1,516
1,<environment.Job instance at 0x7faa6e6446e0>,164,14,[ 2 11],165,-1,546,-1,532
1,<environment.Job instance at 0x7faa6def1640>,170,17,[ 5 14],171,-1,582,-1,565
1,<environment.Job instance at 0x7faa6d7ffeb0>,186,16,[12  5],187,-1,636,-1,620
1,<environment.Job instance at 0x7faa6d6448c0>,5,18,[7 4],6,-1,24,-1,6
1,<environment.Job instance at 0x7faa6d482cd0>,9,17,[4 6],10,-1,27,-1,10
1,<environment.Job instance at 0x7faa6d482b90>,15,17,[4 6],16,-1,33,-1,16
1,<environment.Job instance at 0x7faa6d482140>,16,15,[10  5],17,-1,37,-1,22
1,<environment.Job instance at 0x7faa6d4d87d0>,22,17,[ 1 10],23,-1,40,-1,23
1,<environment.Job instance at 0x7faa6d4d8c80>,24,15,[7 5],25,-1,40,-1,25
1,<environment.Job instance at 0x7faa6d4d8b40>,25,15,[7 1],26,-1,41,-1,26
1,<environment.Job instance at 0x7faa6d4d8c30>,26,15,[5 5],27,-1,42,-1,27
1,<environment.Job instance at 0x7faa6d4d8870>,27,17,[9 4],28,-1,45,-1,28
1,<environment.Job instance at 0x7faa6d4733c0>,30,18,[2 9],31,-1,49,-1,31
1,<environment.Job instance at 0x7faa6d473aa0>,32,16,[2 8],33,-1,49,-1,33
1,<environment.Job instance at 0x7faa6d4735f0>,34,14,[7 2],35,-1,49,-1,35
1,<environment.Job instance at 0x7faa6d473730>,36,13,[10  2],37,-1,50,-1,37
1,<environment.Job instance at 0x7faa6d4731e0>,39,20,[7 2],40,-1,60,-1,40
1,<environment.Job instance at 0x7faa6d473a50>,40,16,[1 9],41,-1,57,-1,41
1,<environment.Job instance at 0x7faa6d4c9b90>,43,15,[9 4],44,-1,59,-1,44
1,<environment.Job instance at 0x7faa6d473d20>,42,16,[5 3],43,-1,68,-1,52
1,<environment.Job instance at 0x7faa6d4c95f0>,51,14,[ 5 10],52,-1,78,-1,64
1,<environment.Job instance at 0x7faa6d4c9fa0>,48,22,[ 3 10],49,-1,88,-1,66
1,<environment.Job instance at 0x7faa6d4c9a50>,52,17,[5 8],53,-1,83,-1,66
1,<environment.Job instance at 0x7faa6d4c9c80>,53,14,[5 7],54,-1,82,-1,68
1,<environment.Job instance at 0x7faa6d47a460>,57,23,[3 5],58,-1,93,-1,70
1,<environment.Job instance at 0x7faa6d4c9b40>,50,13,[ 2 13],51,-1,83,-1,70
1,<environment.Job instance at 0x7faa6d4c9e10>,54,19,[3 7],55,-1,90,-1,71
1,<environment.Job instance at 0x7faa6d47ac80>,60,28,[2 6],61,-1,99,-1,71
1,<environment.Job instance at 0x7faa6d4d83c0>,21,13,[ 3 11],22,-1,84,-1,71
1,<environment.Job instance at 0x7faa6d47af00>,67,2,[9 2],68,-1,73,-1,71
1,<environment.Job instance at 0x7faa6e58e8c0>,68,2,[8 1],69,-1,73,-1,71
1,<environment.Job instance at 0x7faa6d47a0f0>,59,16,[1 8],60,-1,92,-1,76
1,<environment.Job instance at 0x7faa6d47afa0>,66,16,[6 2],67,-1,92,-1,76
1,<environment.Job instance at 0x7faa6e58e640>,73,19,[3 9],74,-1,98,-1,79
1,<environment.Job instance at 0x7faa6e58e690>,75,17,[9 1],76,-1,96,-1,79
1,<environment.Job instance at 0x7faa6e58e230>,69,23,[8 2],70,-1,117,-1,94
1,<environment.Job instance at 0x7faa6e58e9b0>,81,20,[10  2],82,-1,116,-1,96
1,<environment.Job instance at 0x7faa6e5b1dc0>,83,15,[ 3 14],84,-1,111,-1,96
1,<environment.Job instance at 0x7faa6e5b1aa0>,84,14,[ 3 10],85,-1,116,-1,102
1,<environment.Job instance at 0x7faa6e5b1f50>,85,15,[2 6],86,-1,119,-1,104
1,<environment.Job instance at 0x7faa6e5b1050>,90,18,[8 3],91,-1,130,-1,112
1,<environment.Job instance at 0x7faa6e5b1370>,87,18,[1 8],88,-1,130,-1,112
1,<environment.Job instance at 0x7faa6e5b1550>,95,15,[14  4],96,-1,131,-1,116
1,<environment.Job instance at 0x7faa6d47a0a0>,58,16,[1 9],59,-1,134,-1,118
1,<environment.Job instance at 0x7faa6e5b1fa0>,97,20,[1 5],98,-1,139,-1,119
1,<environment.Job instance at 0x7faa6e5b71e0>,99,27,[3 5],100,-1,147,-1,120
1,<environment.Job instance at 0x7faa6e5b1460>,92,1,[1 9],93,-1,121,-1,120
1,<environment.Job instance at 0x7faa6e5b7320>,98,27,[6 3],99,-1,147,-1,120
1,<environment.Job instance at 0x7faa6e5b1eb0>,93,17,[6 1],94,-1,140,-1,123
1,<environment.Job instance at 0x7faa6e586c80>,103,13,[3 7],104,-1,136,-1,123
1,<environment.Job instance at 0x7faa6d922a00>,104,15,[7 4],105,-1,139,-1,124
1,<environment.Job instance at 0x7faa6e5b7c80>,101,16,[5 5],102,-1,148,-1,132
1,<environment.Job instance at 0x7faa6e5af0a0>,110,23,[5 8],111,-1,164,-1,141
1,<environment.Job instance at 0x7faa6d47a320>,65,15,[4 9],66,-1,156,-1,141
1,<environment.Job instance at 0x7faa6e5af2d0>,109,13,[10  2],110,-1,154,-1,141
1,<environment.Job instance at 0x7faa6e5afdc0>,114,18,[3 5],115,-1,160,-1,142
1,<environment.Job instance at 0x7faa6e864eb0>,116,13,[5 4],117,-1,155,-1,142
1,<environment.Job instance at 0x7faa6d4c8280>,118,15,[8 2],119,-1,157,-1,142
1,<environment.Job instance at 0x7faa6d4ca5a0>,112,17,[ 5 10],113,-1,159,-1,142
1,<environment.Job instance at 0x7faa6de0cc80>,121,14,[9 3],122,-1,156,-1,142
1,<environment.Job instance at 0x7faa6ecb19b0>,119,13,[10  2],120,-1,155,-1,142
1,<environment.Job instance at 0x7faa6d5c1050>,122,14,[ 3 10],123,-1,156,-1,142
1,<environment.Job instance at 0x7faa6e5af780>,111,12,[8 5],112,-1,154,-1,142
1,<environment.Job instance at 0x7faa6e5afc30>,107,17,[4 9],108,-1,159,-1,142
1,<environment.Job instance at 0x7faa6d7cd730>,130,18,[6 1],131,-1,160,-1,142
1,<environment.Job instance at 0x7faa6ea08370>,135,18,[2 9],136,-1,161,-1,143
1,<environment.Job instance at 0x7faa6e63a870>,126,13,[ 5 10],127,-1,157,-1,144
1,<environment.Job instance at 0x7faa6ea08640>,132,16,[1 7],133,-1,160,-1,144
1,<environment.Job instance at 0x7faa6e6710a0>,137,15,[10  1],138,-1,159,-1,144
1,<environment.Job instance at 0x7faa6ea08d70>,134,18,[2 5],135,-1,166,-1,148
1,<environment.Job instance at 0x7faa6df4b4b0>,138,28,[9 5],139,-1,178,-1,150
1,<environment.Job instance at 0x7faa6df2f370>,146,22,[4 9],147,-1,175,-1,153
1,<environment.Job instance at 0x7faa6e1f4780>,139,15,[2 5],140,-1,168,-1,153
1,<environment.Job instance at 0x7faa6d6ef870>,145,17,[8 3],146,-1,170,-1,153
1,<environment.Job instance at 0x7faa6d7f5a00>,152,18,[7 3],153,-1,171,-1,153
1,<environment.Job instance at 0x7faa6e2f8eb0>,162,15,[9 5],163,-1,183,-1,168
1,<environment.Job instance at 0x7faa6dd16230>,166,16,[ 5 10],167,-1,184,-1,168
1,<environment.Job instance at 0x7faa6dd16550>,168,18,[10  5],169,-1,195,-1,177
1,<environment.Job instance at 0x7faa6e19fa00>,160,15,[8 2],161,-1,192,-1,177
1,<environment.Job instance at 0x7faa6e2f8190>,163,13,[3 7],164,-1,190,-1,177
1,<environment.Job instance at 0x7faa6e7540a0>,171,23,[9 2],172,-1,201,-1,178
1,<environment.Job instance at 0x7faa6e754780>,170,17,[6 4],171,-1,195,-1,178
1,<environment.Job instance at 0x7faa6ecf29b0>,161,16,[4 9],162,-1,195,-1,179
1,<environment.Job instance at 0x7faa6dd17dc0>,176,15,[7 3],177,-1,194,-1,179
1,<environment.Job instance at 0x7faa6e597a00>,179,15,[ 5 10],180,-1,195,-1,180
1,<environment.Job instance at 0x7faa6d4d5370>,181,12,[7 5],182,-1,198,-1,186
1,<environment.Job instance at 0x7faa6de81b90>,184,14,[5 5],185,-1,201,-1,187
1,<environment.Job instance at 0x7faa6d64ed70>,186,12,[5 9],187,-1,200,-1,188
1,<environment.Job instance at 0x7faa6e63ae10>,14,12,[ 4 13],15,-1,31,-1,19
1,<environment.Job instance at 0x7faa6df2fcd0>,20,2,[ 2 12],21,-1,37,-1,35
1,<environment.Job instance at 0x7faa6eb2ef00>,21,13,[ 3 11],22,-1,48,-1,35
1,<environment.Job instance at 0x7faa6d644d20>,35,1,[14  5],36,-1,99,-1,98
1,<environment.Job instance at 0x7faa6d644dc0>,37,2,[ 5 12],38,-1,100,-1,98
1,<environment.Job instance at 0x7faa6d815230>,45,2,[ 2 12],46,-1,133,-1,131
1,<environment.Job instance at 0x7faa774623c0>,50,13,[ 2 13],51,-1,162,-1,149
1,<environment.Job instance at 0x7faa6d69d410>,57,23,[3 5],58,-1,200,-1,177
1,<environment.Job instance at 0x7faa6e72c910>,60,28,[2 6],61,-1,231,-1,203
1,<environment.Job instance at 0x7faa6d655cd0>,70,1,[13  1],71,-1,211,-1,210
1,<environment.Job instance at 0x7faa6d655c80>,69,23,[8 2],70,-1,235,-1,212
1,<environment.Job instance at 0x7faa6e5b78c0>,83,15,[ 3 14],84,-1,271,-1,256
1,<environment.Job instance at 0x7faa6e593780>,88,3,[13  1],89,-1,278,-1,275
1,<environment.Job instance at 0x7faa6e593b40>,95,15,[14  4],96,-1,307,-1,292
1,<environment.Job instance at 0x7faa6e593c30>,98,27,[6 3],99,-1,337,-1,310
1,<environment.Job instance at 0x7faa6e593e10>,99,27,[3 5],100,-1,350,-1,323
1,<environment.Job instance at 0x7faa6e593f00>,102,2,[12  2],103,-1,325,-1,323
1,<environment.Job instance at 0x7faa6d4844b0>,110,23,[5 8],111,-1,385,-1,362
1,<environment.Job instance at 0x7faa6d484640>,117,12,[ 2 14],118,-1,379,-1,367
1,<environment.Job instance at 0x7faa6d65baa0>,138,28,[9 5],139,-1,496,-1,468
1,<environment.Job instance at 0x7faa6d65b4b0>,140,1,[11  1],141,-1,469,-1,468
1,<environment.Job instance at 0x7faa6d4a8e60>,157,1,[ 2 12],158,-1,503,-1,502
1,<environment.Job instance at 0x7faa6d4c3730>,171,23,[9 2],172,-1,600,-1,577
1,<environment.Job instance at 0x7faa6d4c3460>,175,25,[ 2 11],176,-1,603,-1,578
1,<environment.Job instance at 0x7faa6e010fa0>,0,18,[3 7],1,-1,19,-1,1
1,<environment.Job instance at 0x7faa6e77ad20>,9,13,[ 5 11],10,-1,24,-1,11
1,<environment.Job instance at 0x7faa6d62b9b0>,12,18,[1 5],13,-1,31,-1,13
1,<environment.Job instance at 0x7faa6d62b280>,14,22,[7 4],15,-1,37,-1,15
1,<environment.Job instance at 0x7faa6d62b1e0>,16,17,[5 8],17,-1,34,-1,17
1,<environment.Job instance at 0x7faa6dc56460>,10,17,[10  2],11,-1,37,-1,20
1,<environment.Job instance at 0x7faa6d62beb0>,20,20,[ 3 10],21,-1,43,-1,23
1,<environment.Job instance at 0x7faa6e550230>,24,16,[9 5],25,-1,41,-1,25
1,<environment.Job instance at 0x7faa6e550690>,27,15,[4 6],28,-1,43,-1,28
1,<environment.Job instance at 0x7faa6e550550>,29,18,[1 9],30,-1,48,-1,30
1,<environment.Job instance at 0x7faa6e579140>,36,14,[ 3 10],37,-1,51,-1,37
1,<environment.Job instance at 0x7faa6e5790a0>,38,17,[3 8],39,-1,56,-1,39
1,<environment.Job instance at 0x7faa6e579230>,39,14,[5 4],40,-1,54,-1,40
1,<environment.Job instance at 0x7faa6e579aa0>,46,13,[9 1],47,-1,60,-1,47
1,<environment.Job instance at 0x7faa6e579be0>,48,14,[7 1],49,-1,63,-1,49
1,<environment.Job instance at 0x7faa6e579d20>,49,18,[6 3],50,-1,68,-1,50
1,<environment.Job instance at 0x7faa6e579fa0>,52,17,[9 3],53,-1,70,-1,53
1,<environment.Job instance at 0x7faa6d607050>,54,21,[1 8],55,-1,76,-1,55
1,<environment.Job instance at 0x7faa6d607690>,59,19,[2 5],60,-1,79,-1,60
1,<environment.Job instance at 0x7faa6d607e60>,66,14,[4 9],67,-1,81,-1,67
1,<environment.Job instance at 0x7faa6e579730>,44,16,[9 1],45,-1,84,-1,68
1,<environment.Job instance at 0x7faa6d5fa0f0>,67,17,[10  4],68,-1,85,-1,68
1,<environment.Job instance at 0x7faa6d607c30>,68,17,[9 3],69,-1,86,-1,69
1,<environment.Job instance at 0x7faa6d5fa1e0>,69,18,[2 7],70,-1,88,-1,70
1,<environment.Job instance at 0x7faa6e262b40>,70,16,[ 1 10],71,-1,87,-1,71
1,<environment.Job instance at 0x7faa6d691fa0>,73,23,[5 6],74,-1,97,-1,74
1,<environment.Job instance at 0x7faa6d4c2f50>,79,17,[10  1],80,-1,100,-1,83
1,<environment.Job instance at 0x7faa6e8f3b40>,76,16,[10  2],77,-1,99,-1,83
1,<environment.Job instance at 0x7faa6e909be0>,87,14,[10  2],88,-1,109,-1,95
1,<environment.Job instance at 0x7faa6e773190>,91,17,[9 4],92,-1,112,-1,95
1,<environment.Job instance at 0x7faa6e589910>,95,16,[3 7],96,-1,112,-1,96
1,<environment.Job instance at 0x7faa6e7eb2d0>,104,24,[4 8],105,-1,164,-1,140
1,<environment.Job instance at 0x7faa6e7eb190>,107,18,[3 6],108,-1,162,-1,144
1,<environment.Job instance at 0x7faa6e7ebc30>,108,14,[10  1],109,-1,159,-1,145
1,<environment.Job instance at 0x7faa6e7eb410>,109,27,[ 5 10],110,-1,172,-1,145
1,<environment.Job instance at 0x7faa6e7eb690>,110,28,[8 5],111,-1,173,-1,145
1,<environment.Job instance at 0x7faa6ed30aa0>,116,17,[9 4],117,-1,169,-1,152
1,<environment.Job instance at 0x7faa6e7d9910>,121,16,[4 7],122,-1,184,-1,168
1,<environment.Job instance at 0x7faa6e7d9fa0>,122,17,[10  4],123,-1,185,-1,168
1,<environment.Job instance at 0x7faa6e7e1e10>,128,18,[4 7],129,-1,204,-1,186
1,<environment.Job instance at 0x7faa6e7e1cd0>,137,24,[9 4],138,-1,328,-1,304
1,<environment.Job instance at 0x7faa6d62b690>,18,17,[14  2],19,-1,337,-1,320
1,<environment.Job instance at 0x7faa6e7d8960>,145,18,[ 3 10],146,-1,350,-1,332
1,<environment.Job instance at 0x7faa6dfabcd0>,163,24,[5 1],164,-1,357,-1,333
1,<environment.Job instance at 0x7faa6e00d7d0>,166,28,[8 5],167,-1,361,-1,333
1,<environment.Job instance at 0x7faa6e0095f0>,157,17,[8 4],158,-1,350,-1,333
1,<environment.Job instance at 0x7faa6df7b1e0>,170,18,[5 8],171,-1,351,-1,333
1,<environment.Job instance at 0x7faa6df86f50>,174,25,[9 4],175,-1,358,-1,333
1,<environment.Job instance at 0x7faa6e7ebb90>,106,23,[9 2],107,-1,398,-1,375
1,<environment.Job instance at 0x7faa6e5505f0>,2,22,[ 4 11],3,-1,25,-1,3
1,<environment.Job instance at 0x7faa6e550eb0>,6,15,[13  2],7,-1,22,-1,7
1,<environment.Job instance at 0x7faa6e579f50>,9,13,[ 5 11],10,-1,23,-1,10
1,<environment.Job instance at 0x7faa6d5ee910>,13,3,[ 3 14],14,-1,22,-1,19
1,<environment.Job instance at 0x7faa6eb1cfa0>,18,17,[14  2],19,-1,39,-1,22
1,<environment.Job instance at 0x7faa6e0230a0>,22,14,[11  5],23,-1,52,-1,38
1,<environment.Job instance at 0x7faa6d5fa780>,37,1,[12  4],38,-1,68,-1,67
1,<environment.Job instance at 0x7faa6d5fa550>,42,14,[ 2 11],43,-1,101,-1,87
1,<environment.Job instance at 0x7faa6d4a8d70>,45,13,[ 3 14],46,-1,102,-1,89
1,<environment.Job instance at 0x7faa6d65baf0>,61,1,[12  1],62,-1,142,-1,141
1,<environment.Job instance at 0x7faa6d65b690>,63,3,[ 3 12],64,-1,145,-1,142
1,<environment.Job instance at 0x7faa6d65bb40>,73,23,[5 6],74,-1,230,-1,207
1,<environment.Job instance at 0x7faa6e593320>,80,2,[13  2],81,-1,216,-1,214
1,<environment.Job instance at 0x7faa6e593c30>,83,1,[14  1],84,-1,220,-1,219
1,<environment.Job instance at 0x7faa6e8d4460>,98,2,[ 4 11],99,-1,277,-1,275
1,<environment.Job instance at 0x7faa6e8d4730>,100,12,[ 1 14],101,-1,293,-1,281
1,<environment.Job instance at 0x7faa6e8c8d70>,102,2,[ 1 14],103,-1,290,-1,288
1,<environment.Job instance at 0x7faa6da78f00>,104,24,[4 8],105,-1,319,-1,295
1,<environment.Job instance at 0x7faa6de81cd0>,106,23,[9 2],107,-1,327,-1,304
1,<environment.Job instance at 0x7faa6d7f5b90>,109,27,[ 5 10],110,-1,352,-1,325
1,<environment.Job instance at 0x7faa6d674b90>,110,28,[8 5],111,-1,363,-1,335
1,<environment.Job instance at 0x7faa6dd71140>,113,17,[ 5 12],114,-1,352,-1,335
1,<environment.Job instance at 0x7faa6e73e3c0>,114,18,[ 4 13],115,-1,353,-1,335
1,<environment.Job instance at 0x7faa6d6ba140>,136,26,[3 5],137,-1,465,-1,439
1,<environment.Job instance at 0x7faa6dd6ef50>,137,24,[9 4],138,-1,463,-1,439
1,<environment.Job instance at 0x7faa6ea006e0>,148,1,[12  1],149,-1,470,-1,469
1,<environment.Job instance at 0x7faa6e853be0>,163,24,[5 1],164,-1,531,-1,507
1,<environment.Job instance at 0x7faa6e853af0>,166,28,[8 5],167,-1,556,-1,528
1,<environment.Job instance at 0x7faa6d64eb40>,174,25,[9 4],175,-1,574,-1,549
1,<environment.Job instance at 0x7faa6ec065f0>,176,18,[11  2],177,-1,567,-1,549
1,<environment.Job instance at 0x7faa6e2200f0>,178,15,[ 1 14],179,-1,564,-1,549
1,<environment.Job instance at 0x7faa6d815230>,183,2,[ 2 13],184,-1,571,-1,569
1,<environment.Job instance at 0x7faa6e262e60>,5,27,[4 6],6,-1,33,-1,6
1,<environment.Job instance at 0x7faa6e597cd0>,7,17,[2 8],8,-1,26,-1,9
1,<environment.Job instance at 0x7faa6e5e90f0>,9,24,[9 1],10,-1,34,-1,10
1,<environment.Job instance at 0x7faa773d4a50>,8,18,[5 5],9,-1,28,-1,10
1,<environment.Job instance at 0x7faa6e5e92d0>,11,18,[8 2],12,-1,30,-1,12
1,<environment.Job instance at 0x7faa6e959cd0>,12,16,[ 1 10],13,-1,30,-1,14
1,<environment.Job instance at 0x7faa6e5e94b0>,13,15,[4 8],14,-1,30,-1,15
1,<environment.Job instance at 0x7faa6e7f4cd0>,19,17,[9 4],20,-1,37,-1,20
1,<environment.Job instance at 0x7faa6e5d6f50>,20,15,[10  4],21,-1,37,-1,22
1,<environment.Job instance at 0x7faa6d7fe3c0>,22,14,[1 8],23,-1,37,-1,23
1,<environment.Job instance at 0x7faa6e8320f0>,23,17,[7 4],24,-1,41,-1,24
1,<environment.Job instance at 0x7faa6e959370>,21,16,[5 1],22,-1,41,-1,25
1,<environment.Job instance at 0x7faa6d916af0>,31,23,[5 2],32,-1,56,-1,33
1,<environment.Job instance at 0x7faa6d9163c0>,33,28,[10  4],34,-1,62,-1,34
1,<environment.Job instance at 0x7faa6e76cd20>,37,17,[9 5],38,-1,55,-1,38
1,<environment.Job instance at 0x7faa6e76c5f0>,38,18,[ 4 13],39,-1,57,-1,39
1,<environment.Job instance at 0x7faa6e76c640>,39,14,[ 1 10],40,-1,54,-1,40
1,<environment.Job instance at 0x7faa6e150d70>,32,17,[ 5 14],33,-1,58,-1,41
1,<environment.Job instance at 0x7faa6eaff870>,44,16,[10  5],45,-1,61,-1,45
1,<environment.Job instance at 0x7faa6eaff3c0>,46,18,[10  3],47,-1,68,-1,50
1,<environment.Job instance at 0x7faa6e38a1e0>,50,14,[5 6],51,-1,65,-1,51
1,<environment.Job instance at 0x7faa6e38a410>,51,19,[10  5],52,-1,71,-1,52
1,<environment.Job instance at 0x7faa6de8d960>,56,15,[5 8],57,-1,72,-1,57
1,<environment.Job instance at 0x7faa6eb2e5f0>,57,13,[ 1 10],58,-1,71,-1,58
1,<environment.Job instance at 0x7faa6eb2ec30>,59,17,[2 5],60,-1,77,-1,60
1,<environment.Job instance at 0x7faa6e068730>,60,13,[ 2 10],61,-1,74,-1,61
1,<environment.Job instance at 0x7faa6e3ab0a0>,61,18,[4 5],62,-1,80,-1,62
1,<environment.Job instance at 0x7faa6e2f6410>,66,18,[3 7],67,-1,85,-1,67
1,<environment.Job instance at 0x7faa6e2f69b0>,69,18,[6 5],70,-1,88,-1,70
1,<environment.Job instance at 0x7faa6e2f68c0>,70,15,[5 5],71,-1,86,-1,71
1,<environment.Job instance at 0x7faa6e2f6d20>,72,14,[4 6],73,-1,87,-1,73
1,<environment.Job instance at 0x7faa6e2f6640>,74,24,[5 9],75,-1,99,-1,75
1,<environment.Job instance at 0x7faa6e2f6050>,75,18,[1 6],76,-1,94,-1,76
1,<environment.Job instance at 0x7faa6e2f6280>,76,28,[9 5],77,-1,105,-1,77
1,<environment.Job instance at 0x7faa6e2f67d0>,79,17,[5 2],80,-1,97,-1,80
1,<environment.Job instance at 0x7faa6ec54aa0>,81,18,[9 3],82,-1,100,-1,82
1,<environment.Job instance at 0x7faa6ec54dc0>,82,17,[4 8],83,-1,100,-1,83
1,<environment.Job instance at 0x7faa6ec545f0>,83,18,[8 3],84,-1,102,-1,84
1,<environment.Job instance at 0x7faa6ec54b40>,85,15,[2 7],86,-1,101,-1,86
1,<environment.Job instance at 0x7faa6ec54780>,91,14,[1 7],92,-1,106,-1,92
1,<environment.Job instance at 0x7faa6ec54640>,93,18,[2 6],94,-1,112,-1,94
1,<environment.Job instance at 0x7faa6ec54a50>,94,13,[1 6],95,-1,108,-1,95
1,<environment.Job instance at 0x7faa6e04d910>,97,18,[3 8],98,-1,116,-1,98
1,<environment.Job instance at 0x7faa6e04d0a0>,99,15,[10  3],100,-1,115,-1,100
1,<environment.Job instance at 0x7faa6e04df50>,101,17,[9 5],102,-1,119,-1,102
1,<environment.Job instance at 0x7faa6e04dbe0>,102,19,[1 5],103,-1,122,-1,103
1,<environment.Job instance at 0x7faa6e04d8c0>,108,16,[8 1],109,-1,125,-1,109
1,<environment.Job instance at 0x7faa6e04da00>,109,14,[9 3],110,-1,124,-1,110
1,<environment.Job instance at 0x7faa6ed79e10>,113,23,[5 6],114,-1,141,-1,118
1,<environment.Job instance at 0x7faa6ed79280>,114,15,[5 2],115,-1,136,-1,121
1,<environment.Job instance at 0x7faa6ed79a00>,117,12,[6 5],118,-1,133,-1,121
1,<environment.Job instance at 0x7faa6e04d550>,105,16,[ 4 10],106,-1,142,-1,126
1,<environment.Job instance at 0x7faa6ed797d0>,118,28,[3 8],119,-1,155,-1,127
1,<environment.Job instance at 0x7faa6ed795a0>,119,16,[ 5 10],120,-1,143,-1,127
1,<environment.Job instance at 0x7faa6ed79b40>,124,28,[8 5],125,-1,155,-1,127
1,<environment.Job instance at 0x7faa6df01b40>,126,23,[3 7],127,-1,150,-1,127
1,<environment.Job instance at 0x7faa6df01140>,127,24,[2 9],128,-1,152,-1,128
1,<environment.Job instance at 0x7faa6ed79a50>,123,23,[5 7],124,-1,152,-1,129
1,<environment.Job instance at 0x7faa6df015a0>,129,22,[5 3],130,-1,152,-1,130
1,<environment.Job instance at 0x7faa6df01d20>,132,23,[13  5],133,-1,163,-1,140
1,<environment.Job instance at 0x7faa6df01410>,134,20,[1 9],135,-1,160,-1,140
1,<environment.Job instance at 0x7faa6df01370>,137,20,[ 5 12],138,-1,160,-1,140
1,<environment.Job instance at 0x7faa6eb7e410>,138,17,[1 8],139,-1,157,-1,140
1,<environment.Job instance at 0x7faa6eb7ed70>,141,16,[5 8],142,-1,158,-1,142
1,<environment.Job instance at 0x7faa6eb7e870>,143,26,[6 4],144,-1,170,-1,144
1,<environment.Job instance at 0x7faa6df01500>,135,16,[6 3],136,-1,163,-1,147
1,<environment.Job instance at 0x7faa6db994b0>,151,14,[1 6],152,-1,182,-1,168
1,<environment.Job instance at 0x7faa6db99730>,155,16,[ 4 13],156,-1,184,-1,168
1,<environment.Job instance at 0x7faa6db999b0>,156,26,[8 4],157,-1,194,-1,168
1,<environment.Job instance at 0x7faa6db99690>,153,17,[11  1],154,-1,185,-1,168
1,<environment.Job instance at 0x7faa6e3874b0>,158,18,[12  4],159,-1,186,-1,168
1,<environment.Job instance at 0x7faa6db99c30>,152,16,[1 9],153,-1,185,-1,169
1,<environment.Job instance at 0x7faa6e387a00>,162,17,[ 2 10],163,-1,187,-1,170
1,<environment.Job instance at 0x7faa6e068690>,5,27,[4 6],6,-1,33,-1,6
1,<environment.Job instance at 0x7faa6e2f6460>,9,24,[9 1],10,-1,54,-1,30
1,<environment.Job instance at 0x7faa6ed79fa0>,18,1,[ 2 12],19,-1,31,-1,30
1,<environment.Job instance at 0x7faa6eb7e6e0>,26,13,[11  2],27,-1,72,-1,59
1,<environment.Job instance at 0x7faa6d502be0>,31,23,[5 2],32,-1,98,-1,75
1,<environment.Job instance at 0x7faa6e5fbf50>,32,17,[ 5 14],33,-1,92,-1,75
1,<environment.Job instance at 0x7faa6e5fbb40>,33,28,[10  4],34,-1,103,-1,75
1,<environment.Job instance at 0x7faa6d912500>,38,18,[ 4 13],39,-1,96,-1,78
1,<environment.Job instance at 0x7faa6e593a50>,74,24,[5 9],75,-1,236,-1,212
1,<environment.Job instance at 0x7faa6d65be60>,76,28,[9 5],77,-1,257,-1,229
1,<environment.Job instance at 0x7faa6d5fa4b0>,106,14,[14  5],107,-1,351,-1,337
1,<environment.Job instance at 0x7faa773d4f00>,113,23,[5 6],114,-1,405,-1,382
1,<environment.Job instance at 0x7faa6e023910>,118,28,[3 8],119,-1,433,-1,405
1,<environment.Job instance at 0x7faa6dcc7960>,123,23,[5 7],124,-1,444,-1,421
1,<environment.Job instance at 0x7faa6eb1c0a0>,124,28,[8 5],125,-1,461,-1,433
1,<environment.Job instance at 0x7faa6d5ee910>,126,23,[3 7],127,-1,457,-1,434
1,<environment.Job instance at 0x7faa6e959230>,127,24,[2 9],128,-1,458,-1,434
1,<environment.Job instance at 0x7faa6d6071e0>,132,23,[13  5],133,-1,457,-1,434
1,<environment.Job instance at 0x7faa6e579410>,133,12,[ 4 13],134,-1,446,-1,434
1,<environment.Job instance at 0x7faa6e550370>,137,20,[ 5 12],138,-1,469,-1,449
1,<environment.Job instance at 0x7faa6d482280>,143,26,[6 4],144,-1,481,-1,455
1,<environment.Job instance at 0x7faa6e2dde60>,146,24,[10  1],147,-1,503,-1,479
1,<environment.Job instance at 0x7faa6e2dd9b0>,153,17,[11  1],154,-1,503,-1,486
1,<environment.Job instance at 0x7faa6e2dd8c0>,155,16,[ 4 13],156,-1,502,-1,486
1,<environment.Job instance at 0x7faa6e2dd0a0>,156,26,[8 4],157,-1,521,-1,495
1,<environment.Job instance at 0x7faa6ddda910>,158,18,[12  4],159,-1,513,-1,495
1,<environment.Job instance at 0x7faa6ddda0a0>,161,27,[7 5],162,-1,531,-1,504
1,<environment.Job instance at 0x7faa6dddab40>,167,15,[11  5],168,-1,542,-1,527
1,<environment.Job instance at 0x7faa6ddda690>,171,3,[12  3],172,-1,546,-1,543
1,<environment.Job instance at 0x7faa6dddad70>,172,3,[14  3],173,-1,546,-1,543
1,<environment.Job instance at 0x7faa6d64e500>,176,25,[6 1],177,-1,580,-1,555
1,<environment.Job instance at 0x7faa6d64efa0>,181,18,[ 3 12],182,-1,586,-1,568
1,<environment.Job instance at 0x7faa6d64e0a0>,186,26,[8 5],187,-1,627,-1,601
1,<environment.Job instance at 0x7faa6e51e910>,0,27,[7 2],1,-1,28,-1,1
1,<environment.Job instance at 0x7faa6d9f8e60>,21,17,[4 8],22,-1,39,-1,22
1,<environment.Job instance at 0x7faa6d9f82d0>,22,17,[9 5],23,-1,40,-1,23
1,<environment.Job instance at 0x7faa6e1eccd0>,42,17,[7 2],43,-1,97,-1,80
1,<environment.Job instance at 0x7faa6e8110f0>,48,18,[8 3],49,-1,99,-1,81
1,<environment.Job instance at 0x7faa6e811460>,49,16,[ 4 10],50,-1,97,-1,81
1,<environment.Job instance at 0x7faa6e811be0>,52,18,[3 8],53,-1,99,-1,81
1,<environment.Job instance at 0x7faa6d9f8640>,0,27,[7 2],1,-1,28,-1,1
1,<environment.Job instance at 0x7faa6d9f84b0>,1,26,[ 5 11],2,-1,28,-1,2
1,<environment.Job instance at 0x7faa6e811500>,5,15,[ 5 13],6,-1,21,-1,6
1,<environment.Job instance at 0x7faa6da23b40>,8,12,[12  3],9,-1,21,-1,9
1,<environment.Job instance at 0x7faa6dd99780>,15,12,[14  1],16,-1,32,-1,20
1,<environment.Job instance at 0x7faa6de004b0>,17,16,[ 2 12],18,-1,37,-1,21
1,<environment.Job instance at 0x7faa6de00dc0>,19,2,[ 1 11],20,-1,24,-1,22
1,<environment.Job instance at 0x7faa6de20d20>,33,24,[10  4],34,-1,73,-1,49
1,<environment.Job instance at 0x7faa6de20a50>,37,2,[ 3 11],38,-1,52,-1,50
1,<environment.Job instance at 0x7faa6ddf9960>,55,25,[8 3],56,-1,143,-1,118
1,<environment.Job instance at 0x7faa6ddf9aa0>,58,12,[ 2 12],59,-1,130,-1,118
1,<environment.Job instance at 0x7faa6e9f2780>,83,27,[4 6],84,-1,235,-1,208
1,<environment.Job instance at 0x7faa6e4e9640>,90,3,[ 1 14],91,-1,213,-1,210
1,<environment.Job instance at 0x7faa6e4df5a0>,94,1,[ 2 11],95,-1,224,-1,223
1,<environment.Job instance at 0x7faa6e4dfe60>,97,28,[8 2],98,-1,266,-1,238
1,<environment.Job instance at 0x7faa6e4dffa0>,101,28,[ 3 10],102,-1,293,-1,265
1,<environment.Job instance at 0x7faa6e54c050>,111,15,[14  2],112,-1,303,-1,288
1,<environment.Job instance at 0x7faa6e553b90>,121,12,[11  3],122,-1,335,-1,323
1,<environment.Job instance at 0x7faa6e572d70>,129,28,[3 6],130,-1,390,-1,362
1,<environment.Job instance at 0x7faa6e5644b0>,130,26,[6 1],131,-1,388,-1,362
1,<environment.Job instance at 0x7faa6e572280>,131,2,[ 4 13],132,-1,364,-1,362
1,<environment.Job instance at 0x7faa6e582230>,139,24,[9 1],140,-1,414,-1,390
1,<environment.Job instance at 0x7faa6e01b4b0>,144,13,[ 2 13],145,-1,405,-1,392
1,<environment.Job instance at 0x7faa6e006dc0>,146,20,[12  4],147,-1,413,-1,393
1,<environment.Job instance at 0x7faa6e01b5a0>,143,25,[3 7],144,-1,422,-1,397
1,<environment.Job instance at 0x7faa6e006d20>,150,15,[13  3],151,-1,412,-1,397
1,<environment.Job instance at 0x7faa6dfff910>,155,26,[7 2],156,-1,438,-1,412
1,<environment.Job instance at 0x7faa6e007820>,158,15,[13  1],159,-1,441,-1,426
1,<environment.Job instance at 0x7faa6e501b90>,159,25,[9 3],160,-1,453,-1,428
1,<environment.Job instance at 0x7faa6e7550a0>,172,28,[9 5],173,-1,508,-1,480
1,<environment.Job instance at 0x7faa6df94cd0>,187,28,[4 9],188,-1,577,-1,549
1,<environment.Job instance at 0x7faa6e4f3460>,0,16,[7 5],1,-1,17,-1,1
1,<environment.Job instance at 0x7faa6e899910>,3,17,[3 7],4,-1,21,-1,4
1,<environment.Job instance at 0x7faa6e899280>,9,17,[10  4],10,-1,29,-1,12
1,<environment.Job instance at 0x7faa6e899460>,11,26,[3 8],12,-1,38,-1,12
1,<environment.Job instance at 0x7faa6e8990f0>,13,17,[ 5 13],14,-1,31,-1,14
1,<environment.Job instance at 0x7faa6e8993c0>,14,2,[7 1],15,-1,17,-1,15
1,<environment.Job instance at 0x7faa6d514dc0>,23,18,[2 9],24,-1,42,-1,24
1,<environment.Job instance at 0x7faa6d514320>,26,13,[4 5],27,-1,41,-1,28
1,<environment.Job instance at 0x7faa6d514820>,27,17,[7 5],28,-1,45,-1,28
1,<environment.Job instance at 0x7faa6e8a4820>,33,19,[5 5],34,-1,53,-1,34
1,<environment.Job instance at 0x7faa6e8a4320>,34,16,[1 7],35,-1,52,-1,36
1,<environment.Job instance at 0x7faa6e8a4050>,37,13,[4 7],38,-1,51,-1,38
1,<environment.Job instance at 0x7faa6e8a4960>,38,15,[4 7],39,-1,54,-1,39
1,<environment.Job instance at 0x7faa6e8a42d0>,39,13,[3 7],40,-1,53,-1,40
1,<environment.Job instance at 0x7faa6e8a4780>,40,17,[9 5],41,-1,58,-1,41
1,<environment.Job instance at 0x7faa6e8a4aa0>,41,14,[5 4],42,-1,56,-1,42
1,<environment.Job instance at 0x7faa6e8a4230>,43,20,[1 7],44,-1,65,-1,45
1,<environment.Job instance at 0x7faa6d913230>,46,28,[2 6],47,-1,75,-1,47
1,<environment.Job instance at 0x7faa6d913be0>,47,15,[3 7],48,-1,63,-1,48
1,<environment.Job instance at 0x7faa6e8a4c30>,44,14,[9 2],45,-1,70,-1,56
1,<environment.Job instance at 0x7faa6d9130f0>,55,16,[7 4],56,-1,74,-1,58
1,<environment.Job instance at 0x7faa6d913f50>,59,18,[7 3],60,-1,78,-1,60
1,<environment.Job instance at 0x7faa6d913780>,57,16,[13  3],58,-1,86,-1,70
1,<environment.Job instance at 0x7faa6e964e10>,68,26,[5 7],69,-1,102,-1,76
1,<environment.Job instance at 0x7faa6e964550>,69,28,[ 4 10],70,-1,104,-1,76
1,<environment.Job instance at 0x7faa6d913820>,51,16,[9 2],52,-1,94,-1,78
1,<environment.Job instance at 0x7faa6df8c820>,70,13,[5 2],71,-1,91,-1,78
1,<environment.Job instance at 0x7faa6df8ccd0>,73,13,[9 5],74,-1,92,-1,79
1,<environment.Job instance at 0x7faa6df8c5a0>,74,16,[14  4],75,-1,95,-1,79
1,<environment.Job instance at 0x7faa6df8ca50>,75,23,[ 3 10],76,-1,102,-1,79
1,<environment.Job instance at 0x7faa6df8cb90>,76,17,[9 2],77,-1,97,-1,80
1,<environment.Job instance at 0x7faa6e964a50>,65,3,[2 8],66,-1,83,-1,80
1,<environment.Job instance at 0x7faa6df8c230>,77,12,[6 5],78,-1,92,-1,80
1,<environment.Job instance at 0x7faa6d514370>,28,24,[10  5],29,-1,104,-1,80
1,<environment.Job instance at 0x7faa6df8c050>,80,18,[5 7],81,-1,99,-1,81
1,<environment.Job instance at 0x7faa6e501cd0>,82,14,[5 8],83,-1,99,-1,85
1,<environment.Job instance at 0x7faa6e501050>,87,18,[10  1],88,-1,110,-1,92
1,<environment.Job instance at 0x7faa6e501500>,88,14,[9 1],89,-1,106,-1,92
1,<environment.Job instance at 0x7faa6e964690>,62,16,[1 7],63,-1,112,-1,96
1,<environment.Job instance at 0x7faa6e4e8a50>,92,13,[5 1],93,-1,109,-1,96
1,<environment.Job instance at 0x7faa6e501c30>,84,12,[ 2 10],85,-1,110,-1,98
1,<environment.Job instance at 0x7faa6e4e8320>,95,21,[5 2],96,-1,119,-1,98
1,<environment.Job instance at 0x7faa6e4e8910>,97,13,[6 5],98,-1,112,-1,99
1,<environment.Job instance at 0x7faa6e4e88c0>,93,14,[7 3],94,-1,113,-1,99
1,<environment.Job instance at 0x7faa6e4e8a00>,98,14,[3 9],99,-1,113,-1,99
1,<environment.Job instance at 0x7faa6e9e5f50>,103,18,[5 9],104,-1,124,-1,106
1,<environment.Job instance at 0x7faa6e9e5870>,105,14,[ 2 10],106,-1,120,-1,106
1,<environment.Job instance at 0x7faa6e501eb0>,91,17,[1 7],92,-1,124,-1,107
1,<environment.Job instance at 0x7faa6df83550>,106,12,[5 5],107,-1,120,-1,108
1,<environment.Job instance at 0x7faa6df830a0>,107,18,[3 5],108,-1,127,-1,109
1,<environment.Job instance at 0x7faa6ea7aeb0>,112,18,[10  5],113,-1,134,-1,116
1,<environment.Job instance at 0x7faa6df83d70>,108,27,[1 8],109,-1,143,-1,116
1,<environment.Job instance at 0x7faa6d57a140>,113,17,[5 5],114,-1,133,-1,116
1,<environment.Job instance at 0x7faa6d913c30>,52,14,[2 8],53,-1,133,-1,119
1,<environment.Job instance at 0x7faa6e44c230>,118,18,[2 5],119,-1,137,-1,119
1,<environment.Job instance at 0x7faa778a6140>,119,13,[4 9],120,-1,134,-1,121
1,<environment.Job instance at 0x7faa6da47370>,121,17,[1 5],122,-1,139,-1,122
1,<environment.Job instance at 0x7faa6e501f00>,89,17,[2 7],90,-1,152,-1,135
1,<environment.Job instance at 0x7faa6eb03370>,127,15,[10  3],128,-1,150,-1,135
1,<environment.Job instance at 0x7faa6ed40370>,129,16,[9 2],130,-1,151,-1,135
1,<environment.Job instance at 0x7faa6d57af50>,115,13,[5 5],116,-1,148,-1,135
1,<environment.Job instance at 0x7faa6dcfb230>,132,21,[2 7],133,-1,159,-1,138
1,<environment.Job instance at 0x7faa6eb03140>,133,14,[5 6],134,-1,152,-1,138
1,<environment.Job instance at 0x7faa6dcfb280>,134,17,[9 4],135,-1,155,-1,138
1,<environment.Job instance at 0x7faa6e9f7a50>,136,24,[7 1],137,-1,164,-1,140
1,<environment.Job instance at 0x7faa6d873d70>,131,14,[ 2 10],132,-1,154,-1,140
1,<environment.Job instance at 0x7faa6e9f7f00>,137,13,[1 7],138,-1,153,-1,140
1,<environment.Job instance at 0x7faa6d87c730>,139,14,[10  4],140,-1,154,-1,140
1,<environment.Job instance at 0x7faa6e9f7c80>,140,16,[5 4],141,-1,158,-1,142
1,<environment.Job instance at 0x7faa6d87c910>,138,13,[5 6],139,-1,155,-1,142
1,<environment.Job instance at 0x7faa6d526dc0>,148,15,[8 3],149,-1,176,-1,161
1,<environment.Job instance at 0x7faa6d526780>,144,14,[1 9],145,-1,177,-1,163
1,<environment.Job instance at 0x7faa6d526410>,149,16,[8 1],150,-1,180,-1,164
1,<environment.Job instance at 0x7faa6e4e84b0>,101,13,[ 1 12],102,-1,177,-1,164
1,<environment.Job instance at 0x7faa6d526cd0>,152,14,[10  1],153,-1,179,-1,165
1,<environment.Job instance at 0x7faa6d526d70>,150,22,[6 5],151,-1,187,-1,165
1,<environment.Job instance at 0x7faa6e6da190>,154,15,[ 2 10],155,-1,180,-1,165
1,<environment.Job instance at 0x7faa6d526500>,153,18,[1 8],154,-1,183,-1,165
1,<environment.Job instance at 0x7faa6e958960>,157,16,[8 2],158,-1,181,-1,165
1,<environment.Job instance at 0x7faa6d526870>,145,16,[3 6],146,-1,181,-1,165
1,<environment.Job instance at 0x7faa6e958d20>,159,15,[6 5],160,-1,181,-1,166
1,<environment.Job instance at 0x7faa6e035f00>,162,14,[ 2 10],163,-1,180,-1,166
1,<environment.Job instance at 0x7faa6e0355a0>,163,19,[2 6],164,-1,185,-1,166
1,<environment.Job instance at 0x7faa6e41d500>,164,13,[10  1],165,-1,179,-1,166
1,<environment.Job instance at 0x7faa6dfa0d70>,168,17,[ 1 10],169,-1,186,-1,169
1,<environment.Job instance at 0x7faa6e9587d0>,158,20,[5 5],159,-1,193,-1,173
1,<environment.Job instance at 0x7faa6e04fd70>,172,16,[6 4],173,-1,189,-1,173
1,<environment.Job instance at 0x7faa6e04ffa0>,173,17,[2 8],174,-1,191,-1,174
1,<environment.Job instance at 0x7faa6e04fc30>,174,12,[6 1],175,-1,200,-1,188
1,<environment.Job instance at 0x7faa6ed9bc80>,183,16,[1 8],184,-1,204,-1,188
1,<environment.Job instance at 0x7faa6e50baa0>,188,15,[4 7],189,-1,216,-1,201
1,<environment.Job instance at 0x7faa6dee2690>,184,13,[8 5],185,-1,214,-1,201
1,<environment.Job instance at 0x7faa6d9137d0>,5,18,[ 5 11],6,-1,24,-1,6
1,<environment.Job instance at 0x7faa6e44ccd0>,11,26,[3 8],12,-1,45,-1,19
1,<environment.Job instance at 0x7faa6df8c870>,13,17,[ 5 13],14,-1,36,-1,19
1,<environment.Job instance at 0x7faa6e642370>,19,2,[ 1 14],20,-1,25,-1,23
1,<environment.Job instance at 0x7faa6dfa0370>,24,24,[ 3 10],25,-1,58,-1,34
1,<environment.Job instance at 0x7faa6df9ae60>,28,24,[10  5],29,-1,71,-1,47
1,<environment.Job instance at 0x7faa6dfff730>,45,3,[ 4 13],46,-1,123,-1,120
1,<environment.Job instance at 0x7faa6e582730>,46,28,[2 6],47,-1,148,-1,120
1,<environment.Job instance at 0x7faa6e564a00>,49,26,[10  1],50,-1,154,-1,128
1,<environment.Job instance at 0x7faa6e4d64b0>,57,16,[13  3],58,-1,172,-1,156
1,<environment.Job instance at 0x7faa6e4ec5a0>,68,26,[5 7],69,-1,231,-1,205
1,<environment.Job instance at 0x7faa6e4dffa0>,69,28,[ 4 10],70,-1,233,-1,205
1,<environment.Job instance at 0x7faa6e4df820>,72,2,[ 4 11],73,-1,209,-1,207
1,<environment.Job instance at 0x7faa6e4dfd70>,74,16,[14  4],75,-1,225,-1,209
1,<environment.Job instance at 0x7faa6e4df320>,75,23,[ 3 10],76,-1,235,-1,212
1,<environment.Job instance at 0x7faa6d8f5a50>,90,23,[7 1],91,-1,301,-1,278
1,<environment.Job instance at 0x7faa6e049140>,101,13,[ 1 12],102,-1,325,-1,312
1,<environment.Job instance at 0x7faa6dc77730>,108,27,[1 8],109,-1,368,-1,341
1,<environment.Job instance at 0x7faa6d7f0eb0>,109,3,[ 5 12],110,-1,344,-1,341
1,<environment.Job instance at 0x7faa6ec44780>,110,2,[ 5 14],111,-1,343,-1,341
1,<environment.Job instance at 0x7faa6d61dd20>,122,2,[13  4],123,-1,399,-1,397
1,<environment.Job instance at 0x7faa6e514960>,124,14,[12  1],125,-1,414,-1,400
1,<environment.Job instance at 0x7faa6e852320>,128,3,[ 3 14],129,-1,409,-1,406
1,<environment.Job instance at 0x7faa6e20c0a0>,130,3,[13  3],131,-1,417,-1,414
1,<environment.Job instance at 0x7faa6d4bad70>,135,2,[13  4],136,-1,434,-1,432
1,<environment.Job instance at 0x7faa6d4ba460>,136,24,[7 1],137,-1,472,-1,448
1,<environment.Job instance at 0x7faa773b7c80>,151,3,[ 5 11],152,-1,512,-1,509
1,<environment.Job instance at 0x7faa6e0078c0>,1,18,[2 8],2,-1,20,-1,2
1,<environment.Job instance at 0x7faa6d6f2370>,2,18,[3 8],3,-1,21,-1,3
1,<environment.Job instance at 0x7faa6d6f2640>,8,24,[7 5],9,-1,33,-1,9
1,<environment.Job instance at 0x7faa6d4d29b0>,9,14,[9 5],10,-1,25,-1,11
1,<environment.Job instance at 0x7faa6d4d2b40>,11,21,[5 3],12,-1,33,-1,12
1,<environment.Job instance at 0x7faa6d4d2690>,13,18,[5 6],14,-1,32,-1,14
1,<environment.Job instance at 0x7faa6ea8e320>,10,13,[5 6],11,-1,27,-1,14
1,<environment.Job instance at 0x7faa6d4d2730>,20,18,[ 4 10],21,-1,39,-1,21
1,<environment.Job instance at 0x7faa773a0dc0>,26,17,[10  3],27,-1,44,-1,27
1,<environment.Job instance at 0x7faa773a0820>,27,25,[4 6],28,-1,53,-1,28
1,<environment.Job instance at 0x7faa773a0cd0>,28,17,[ 2 10],29,-1,46,-1,29
1,<environment.Job instance at 0x7faa6ed0d640>,31,23,[10  1],32,-1,55,-1,32
1,<environment.Job instance at 0x7faa6ed0db90>,32,14,[5 8],33,-1,47,-1,33
1,<environment.Job instance at 0x7faa6ed0d0f0>,33,26,[10  2],34,-1,60,-1,34
1,<environment.Job instance at 0x7faa6ed0d0a0>,35,15,[5 2],36,-1,51,-1,36
1,<environment.Job instance at 0x7faa6ed0d690>,36,16,[ 1 10],37,-1,53,-1,37
1,<environment.Job instance at 0x7faa6ed0da00>,41,24,[4 8],42,-1,66,-1,42
1,<environment.Job instance at 0x7faa6ed0d320>,42,17,[5 8],43,-1,60,-1,43
1,<environment.Job instance at 0x7faa6ecb15f0>,46,15,[6 2],47,-1,62,-1,47
1,<environment.Job instance at 0x7faa6e5fe9b0>,52,22,[10  1],53,-1,77,-1,55
1,<environment.Job instance at 0x7faa6e5fe230>,55,16,[13  5],56,-1,72,-1,56
1,<environment.Job instance at 0x7faa6e5fe4b0>,54,23,[ 5 10],55,-1,79,-1,56
1,<environment.Job instance at 0x7faa6e5fe460>,57,18,[3 8],58,-1,76,-1,58
1,<environment.Job instance at 0x7faa6e5fef50>,60,18,[5 4],61,-1,82,-1,64
1,<environment.Job instance at 0x7faa6e5fe8c0>,63,25,[10  1],64,-1,94,-1,69
1,<environment.Job instance at 0x7faa6e5feeb0>,65,28,[1 7],66,-1,97,-1,69
1,<environment.Job instance at 0x7faa6e5feb90>,66,15,[ 3 12],67,-1,84,-1,69
1,<environment.Job instance at 0x7faa6e5febe0>,67,17,[10  5],68,-1,86,-1,69
1,<environment.Job instance at 0x7faa6ea96d20>,71,18,[5 5],72,-1,100,-1,82
1,<environment.Job instance at 0x7faa6ea96820>,73,18,[5 4],74,-1,100,-1,82
1,<environment.Job instance at 0x7faa6d609f00>,48,13,[12  1],49,-1,96,-1,83
1,<environment.Job instance at 0x7faa6ea96730>,74,16,[10  1],75,-1,99,-1,83
1,<environment.Job instance at 0x7faa6ea96b90>,77,16,[7 4],78,-1,99,-1,83
1,<environment.Job instance at 0x7faa6e95f820>,83,17,[ 1 10],84,-1,106,-1,89
1,<environment.Job instance at 0x7faa6e95fa00>,84,16,[10  1],85,-1,106,-1,90
1,<environment.Job instance at 0x7faa6e95f0f0>,85,15,[10  1],86,-1,107,-1,92
1,<environment.Job instance at 0x7faa6e95f050>,86,18,[9 4],87,-1,111,-1,93
1,<environment.Job instance at 0x7faa6ea96e60>,82,14,[11  2],83,-1,111,-1,97
1,<environment.Job instance at 0x7faa6e95f410>,87,23,[1 8],88,-1,122,-1,99
1,<environment.Job instance at 0x7faa6e95f730>,90,26,[4 7],91,-1,127,-1,101
1,<environment.Job instance at 0x7faa6e95f5f0>,91,16,[4 5],92,-1,118,-1,102
1,<environment.Job instance at 0x7faa6e5fea50>,62,1,[8 3],63,-1,103,-1,102
1,<environment.Job instance at 0x7faa6e03d230>,100,13,[10  1],101,-1,116,-1,103
1,<environment.Job instance at 0x7faa6e439b40>,97,3,[10  5],98,-1,107,-1,104
1,<environment.Job instance at 0x7faa6e5487d0>,102,3,[10  3],103,-1,107,-1,104
1,<environment.Job instance at 0x7faa6ea96f00>,76,18,[3 7],77,-1,122,-1,104
1,<environment.Job instance at 0x7faa6e548190>,103,2,[1 8],104,-1,106,-1,104
1,<environment.Job instance at 0x7faa6e548be0>,104,15,[5 5],105,-1,124,-1,109
1,<environment.Job instance at 0x7faa6e548960>,107,18,[10  1],108,-1,127,-1,109
1,<environment.Job instance at 0x7faa6e1fa500>,105,16,[7 5],106,-1,125,-1,109
1,<environment.Job instance at 0x7faa6ecd4b40>,109,14,[5 7],110,-1,125,-1,111
1,<environment.Job instance at 0x7faa6eb731e0>,112,18,[4 9],113,-1,132,-1,114
1,<environment.Job instance at 0x7faa6df71dc0>,113,23,[10  4],114,-1,137,-1,114
1,<environment.Job instance at 0x7faa6e4da820>,111,15,[2 5],112,-1,131,-1,116
1,<environment.Job instance at 0x7faa6df71f50>,114,19,[ 5 10],115,-1,135,-1,116
1,<environment.Job instance at 0x7faa6e7d9cd0>,118,12,[11  4],119,-1,134,-1,122
1,<environment.Job instance at 0x7faa6d6c9c80>,119,16,[ 1 10],120,-1,142,-1,126
1,<environment.Job instance at 0x7faa6e3ab9b0>,123,15,[10  4],124,-1,157,-1,142
1,<environment.Job instance at 0x7faa6e645dc0>,121,13,[9 4],122,-1,155,-1,142
1,<environment.Job instance at 0x7faa6e11f8c0>,101,13,[5 3],102,-1,161,-1,148
1,<environment.Job instance at 0x7faa773b7500>,124,24,[1 8],125,-1,181,-1,157
1,<environment.Job instance at 0x7faa6ed2a280>,127,18,[12  3],128,-1,175,-1,157
1,<environment.Job instance at 0x7faa6e3abf50>,122,17,[1 6],123,-1,174,-1,157
1,<environment.Job instance at 0x7faa6edf65a0>,125,13,[8 3],126,-1,170,-1,157
1,<environment.Job instance at 0x7faa6d514e10>,129,17,[4 9],130,-1,174,-1,157
1,<environment.Job instance at 0x7faa6dbd7230>,132,26,[2 5],133,-1,183,-1,157
1,<environment.Job instance at 0x7faa6dbd7c80>,136,16,[9 2],137,-1,173,-1,157
1,<environment.Job instance at 0x7faa6e154b90>,126,15,[7 4],127,-1,172,-1,157
1,<environment.Job instance at 0x7faa6dbd7b90>,139,15,[3 6],140,-1,172,-1,157
1,<environment.Job instance at 0x7faa6dbd7f50>,141,18,[3 9],142,-1,176,-1,158
1,<environment.Job instance at 0x7faa6dbd7870>,133,12,[12  2],134,-1,185,-1,173
1,<environment.Job instance at 0x7faa6e552550>,147,26,[3 6],148,-1,200,-1,174
1,<environment.Job instance at 0x7faa6e552d20>,149,25,[ 1 10],150,-1,199,-1,174
1,<environment.Job instance at 0x7faa6e552460>,155,16,[7 3],156,-1,191,-1,175
1,<environment.Job instance at 0x7faa6ed18aa0>,145,17,[7 3],146,-1,192,-1,175
1,<environment.Job instance at 0x7faa6e552b40>,148,18,[1 5],149,-1,193,-1,175
1,<environment.Job instance at 0x7faa6e150910>,159,16,[1 5],160,-1,193,-1,177
1,<environment.Job instance at 0x7faa6e552140>,156,17,[7 2],157,-1,194,-1,177
1,<environment.Job instance at 0x7faa6ed18c80>,146,17,[14  3],147,-1,195,-1,178
1,<environment.Job instance at 0x7faa6e068730>,157,13,[3 7],158,-1,191,-1,178
1,<environment.Job instance at 0x7faa6e150780>,163,20,[2 7],164,-1,198,-1,178
1,<environment.Job instance at 0x7faa6e150c30>,164,12,[5 5],165,-1,190,-1,178
1,<environment.Job instance at 0x7faa6d4c4280>,167,12,[5 2],168,-1,190,-1,178
1,<environment.Job instance at 0x7faa6d4c4b40>,168,16,[10  2],169,-1,194,-1,178
1,<environment.Job instance at 0x7faa6d4c44b0>,165,14,[ 4 10],166,-1,192,-1,178
1,<environment.Job instance at 0x7faa6d4c4e60>,169,22,[1 9],170,-1,201,-1,179
1,<environment.Job instance at 0x7faa6d4c4190>,170,18,[10  1],171,-1,198,-1,180
1,<environment.Job instance at 0x7faa6d4c49b0>,173,24,[ 4 10],174,-1,204,-1,180
1,<environment.Job instance at 0x7faa6d4c4320>,166,12,[9 2],167,-1,192,-1,180
1,<environment.Job instance at 0x7faa6edb4190>,175,18,[5 3],176,-1,199,-1,181
1,<environment.Job instance at 0x7faa6d6917d0>,176,18,[5 5],177,-1,201,-1,183
1,<environment.Job instance at 0x7faa6e00d780>,177,15,[9 4],178,-1,198,-1,183
1,<environment.Job instance at 0x7faa6e7f7f50>,178,16,[ 4 10],179,-1,199,-1,183
1,<environment.Job instance at 0x7faa6e00d5f0>,179,18,[ 3 10],180,-1,201,-1,183
1,<environment.Job instance at 0x7faa6e95c2d0>,181,12,[8 4],182,-1,195,-1,183
1,<environment.Job instance at 0x7faa6dbd7780>,140,18,[2 9],141,-1,202,-1,184
1,<environment.Job instance at 0x7faa6e6005f0>,183,20,[3 8],184,-1,204,-1,184
1,<environment.Job instance at 0x7faa6e8e6190>,185,16,[10  1],186,-1,202,-1,186
1,<environment.Job instance at 0x7faa6e8e6050>,186,18,[4 9],187,-1,207,-1,189
1,<environment.Job instance at 0x7faa6ed0d050>,8,24,[7 5],9,-1,40,-1,16
1,<environment.Job instance at 0x7faa6edb4410>,27,25,[4 6],28,-1,86,-1,61
1,<environment.Job instance at 0x7faa6e1480f0>,31,23,[10  1],32,-1,105,-1,82
1,<environment.Job instance at 0x7faa6d86e7d0>,33,26,[10  2],34,-1,108,-1,82
1,<environment.Job instance at 0x7faa6d6f2960>,34,3,[ 3 12],35,-1,85,-1,82
1,<environment.Job instance at 0x7faa6de19d20>,41,24,[4 8],42,-1,130,-1,106
1,<environment.Job instance at 0x7faa6e7f3370>,43,2,[12  5],44,-1,108,-1,106
1,<environment.Job instance at 0x7faa6e7f3320>,45,14,[ 2 11],46,-1,131,-1,117
1,<environment.Job instance at 0x7faa6de02f50>,48,13,[12  1],49,-1,131,-1,118
1,<environment.Job instance at 0x7faa773b7c80>,55,16,[13  5],56,-1,150,-1,134
1,<environment.Job instance at 0x7faa7797e410>,59,23,[1 5],60,-1,162,-1,139
1,<environment.Job instance at 0x7faa6de02140>,54,23,[ 5 10],55,-1,182,-1,159
1,<environment.Job instance at 0x7faa6e82e690>,63,25,[10  1],64,-1,192,-1,167
1,<environment.Job instance at 0x7faa6e82e6e0>,66,15,[ 3 12],67,-1,182,-1,167
1,<environment.Job instance at 0x7faa6dc65320>,65,28,[1 7],66,-1,201,-1,173
1,<environment.Job instance at 0x7faa6e5146e0>,82,14,[11  2],83,-1,236,-1,222
1,<environment.Job instance at 0x7faa6dd675a0>,87,23,[1 8],88,-1,281,-1,258
1,<environment.Job instance at 0x7faa6e480eb0>,90,26,[4 7],91,-1,287,-1,261
1,<environment.Job instance at 0x7faa6df83b40>,113,23,[10  4],114,-1,362,-1,339
1,<environment.Job instance at 0x7faa6e4df320>,118,12,[11  4],119,-1,362,-1,350
1,<environment.Job instance at 0x7faa6e4eceb0>,124,24,[1 8],125,-1,395,-1,371
1,<environment.Job instance at 0x7faa6e581370>,127,18,[12  3],128,-1,393,-1,375
1,<environment.Job instance at 0x7faa6e4d60f0>,132,26,[2 5],133,-1,430,-1,404
1,<environment.Job instance at 0x7faa6e4d6f50>,133,12,[12  2],134,-1,416,-1,404
1,<environment.Job instance at 0x7faa6e564230>,138,1,[13  1],139,-1,409,-1,408
1,<environment.Job instance at 0x7faa6dfff6e0>,146,17,[14  3],147,-1,460,-1,443
1,<environment.Job instance at 0x7faa6dfff820>,147,26,[3 6],148,-1,472,-1,446
1,<environment.Job instance at 0x7faa6e501280>,149,25,[ 1 10],150,-1,489,-1,464
1,<environment.Job instance at 0x7faa6e5012d0>,154,2,[13  2],155,-1,468,-1,466
1,<environment.Job instance at 0x7faa6e755a00>,158,1,[ 4 12],159,-1,478,-1,477
1,<environment.Job instance at 0x7faa6e44ccd0>,173,24,[ 4 10],174,-1,555,-1,531
1,<environment.Job instance at 0x7faa6d514e60>,188,13,[ 2 14],189,-1,633,-1,620
1,<environment.Job instance at 0x7faa6dcb1f00>,2,17,[2 8],3,-1,21,-1,4
1,<environment.Job instance at 0x7faa6e807870>,3,16,[7 5],4,-1,20,-1,4
1,<environment.Job instance at 0x7faa6dcb1230>,5,15,[9 2],6,-1,22,-1,7
1,<environment.Job instance at 0x7faa6dcb1b40>,7,16,[ 2 10],8,-1,24,-1,8
1,<environment.Job instance at 0x7faa6dfed690>,8,17,[5 1],9,-1,26,-1,9
1,<environment.Job instance at 0x7faa6dfedf00>,9,3,[4 8],10,-1,13,-1,10
1,<environment.Job instance at 0x7faa6dfed640>,10,16,[9 1],11,-1,27,-1,11
1,<environment.Job instance at 0x7faa6dcb1eb0>,6,17,[5 4],7,-1,28,-1,11
1,<environment.Job instance at 0x7faa6e975550>,20,18,[5 8],21,-1,39,-1,21
1,<environment.Job instance at 0x7faa6e975640>,23,12,[10  4],24,-1,37,-1,25
1,<environment.Job instance at 0x7faa6e975aa0>,26,14,[3 5],27,-1,41,-1,27
1,<environment.Job instance at 0x7faa6e975a50>,27,25,[1 7],28,-1,53,-1,28
1,<environment.Job instance at 0x7faa6e975be0>,28,19,[5 8],29,-1,48,-1,29
1,<environment.Job instance at 0x7faa6e975460>,29,16,[7 4],30,-1,46,-1,30
1,<environment.Job instance at 0x7faa6db1e9b0>,32,14,[6 2],33,-1,47,-1,33
1,<environment.Job instance at 0x7faa6db1eb90>,33,14,[2 9],34,-1,48,-1,34
1,<environment.Job instance at 0x7faa6db1e410>,34,18,[10  3],35,-1,53,-1,35
1,<environment.Job instance at 0x7faa6db1efa0>,37,15,[2 8],38,-1,53,-1,38
1,<environment.Job instance at 0x7faa6db1ed20>,40,15,[ 4 10],41,-1,56,-1,41
1,<environment.Job instance at 0x7faa6db1e960>,41,17,[9 3],42,-1,59,-1,42
1,<environment.Job instance at 0x7faa6db1e820>,42,20,[ 1 10],43,-1,63,-1,43
1,<environment.Job instance at 0x7faa6da393c0>,46,19,[4 8],47,-1,66,-1,47
1,<environment.Job instance at 0x7faa6da39b40>,48,15,[1 9],49,-1,64,-1,49
1,<environment.Job instance at 0x7faa6da39cd0>,49,17,[4 9],50,-1,67,-1,50
1,<environment.Job instance at 0x7faa6da39a00>,56,27,[6 1],57,-1,84,-1,57
1,<environment.Job instance at 0x7faa6e8218c0>,59,17,[8 2],60,-1,77,-1,60
1,<environment.Job instance at 0x7faa6e8211e0>,60,16,[6 5],61,-1,77,-1,61
1,<environment.Job instance at 0x7faa6e821e10>,63,16,[3 5],64,-1,80,-1,64
1,<environment.Job instance at 0x7faa6e821c30>,64,23,[5 9],65,-1,88,-1,65
1,<environment.Job instance at 0x7faa6d803b90>,65,16,[1 6],66,-1,82,-1,66
1,<environment.Job instance at 0x7faa6d803fa0>,66,13,[1 5],67,-1,80,-1,67
1,<environment.Job instance at 0x7faa6d803690>,67,23,[6 2],68,-1,91,-1,68
1,<environment.Job instance at 0x7faa6d8037d0>,68,15,[5 6],69,-1,84,-1,69
1,<environment.Job instance at 0x7faa6d8039b0>,70,26,[6 1],71,-1,97,-1,71
1,<environment.Job instance at 0x7faa6d8035f0>,72,17,[5 5],73,-1,90,-1,73
1,<environment.Job instance at 0x7faa6d803730>,74,14,[5 7],75,-1,89,-1,75
1,<environment.Job instance at 0x7faa6e975690>,24,17,[4 7],25,-1,92,-1,75
1,<environment.Job instance at 0x7faa6d8032d0>,80,18,[5 7],81,-1,99,-1,81
1,<environment.Job instance at 0x7faa6e637e60>,82,16,[1 9],83,-1,100,-1,84
1,<environment.Job instance at 0x7faa6d8035a0>,83,19,[8 3],84,-1,112,-1,93
1,<environment.Job instance at 0x7faa6e637550>,85,15,[9 3],86,-1,112,-1,97
1,<environment.Job instance at 0x7faa6e6375a0>,87,17,[8 4],88,-1,114,-1,97
1,<environment.Job instance at 0x7faa6e637fa0>,89,26,[5 8],90,-1,123,-1,97
1,<environment.Job instance at 0x7faa6e637d70>,88,18,[6 5],89,-1,115,-1,97
1,<environment.Job instance at 0x7faa6e637410>,91,16,[1 8],92,-1,113,-1,97
1,<environment.Job instance at 0x7faa6e6376e0>,94,14,[13  2],95,-1,111,-1,97
1,<environment.Job instance at 0x7faa6e637d20>,95,20,[5 5],96,-1,117,-1,97
1,<environment.Job instance at 0x7faa6e637dc0>,96,17,[12  5],97,-1,114,-1,97
1,<environment.Job instance at 0x7faa6e637640>,81,14,[13  1],82,-1,111,-1,97
1,<environment.Job instance at 0x7faa6da39550>,52,14,[14  2],53,-1,112,-1,98
1,<environment.Job instance at 0x7faa6d620870>,98,14,[6 4],99,-1,113,-1,99
1,<environment.Job instance at 0x7faa6d620960>,99,18,[3 6],100,-1,118,-1,100
1,<environment.Job instance at 0x7faa6d620fa0>,101,18,[3 6],102,-1,120,-1,102
1,<environment.Job instance at 0x7faa6d6207d0>,102,17,[9 3],103,-1,120,-1,103
1,<environment.Job instance at 0x7faa6d620410>,103,14,[3 7],104,-1,120,-1,106
1,<environment.Job instance at 0x7faa6d620730>,106,13,[ 4 10],107,-1,120,-1,107
1,<environment.Job instance at 0x7faa6d620640>,105,16,[10  4],106,-1,125,-1,109
1,<environment.Job instance at 0x7faa6e3baaa0>,109,14,[10  3],110,-1,125,-1,111
1,<environment.Job instance at 0x7faa6d62fbe0>,110,23,[ 1 10],111,-1,134,-1,111
1,<environment.Job instance at 0x7faa77746aa0>,113,17,[6 4],114,-1,132,-1,115
1,<environment.Job instance at 0x7faa6e131cd0>,116,13,[7 5],117,-1,130,-1,117
1,<environment.Job instance at 0x7faa6e20c4b0>,118,15,[7 1],119,-1,134,-1,119
1,<environment.Job instance at 0x7faa778ae5f0>,119,28,[9 4],120,-1,148,-1,120
1,<environment.Job instance at 0x7faa6dfd5730>,114,16,[9 2],115,-1,136,-1,120
1,<environment.Job instance at 0x7faa6e4d6f00>,135,16,[5 9],136,-1,152,-1,136
1,<environment.Job instance at 0x7faa6e4d63c0>,136,17,[7 4],137,-1,154,-1,137
1,<environment.Job instance at 0x7faa6ee4b8c0>,142,23,[4 7],143,-1,166,-1,143
1,<environment.Job instance at 0x7faa6dc9f690>,139,28,[8 2],140,-1,184,-1,156
1,<environment.Job instance at 0x7faa6d615a00>,108,14,[14  2],109,-1,177,-1,163
1,<environment.Job instance at 0x7faa6e4fdeb0>,146,15,[1 6],147,-1,178,-1,163
1,<environment.Job instance at 0x7faa6e4fd370>,150,12,[7 2],151,-1,175,-1,163
1,<environment.Job instance at 0x7faa6e4fd0f0>,151,12,[6 1],152,-1,175,-1,163
1,<environment.Job instance at 0x7faa6e4fdb90>,154,17,[6 1],155,-1,180,-1,163
1,<environment.Job instance at 0x7faa6e155730>,155,13,[9 5],156,-1,176,-1,163
1,<environment.Job instance at 0x7faa6df72410>,156,18,[2 9],157,-1,183,-1,165
1,<environment.Job instance at 0x7faa6ee4bd70>,144,28,[3 5],145,-1,193,-1,165
1,<environment.Job instance at 0x7faa6ecb9870>,161,24,[ 3 10],162,-1,189,-1,165
1,<environment.Job instance at 0x7faa6e637370>,84,17,[12  2],85,-1,182,-1,165
1,<environment.Job instance at 0x7faa6e1551e0>,157,12,[4 5],158,-1,177,-1,165
1,<environment.Job instance at 0x7faa6ecb9e10>,164,16,[ 4 10],165,-1,181,-1,165
1,<environment.Job instance at 0x7faa6ecb9050>,162,16,[10  3],163,-1,182,-1,166
1,<environment.Job instance at 0x7faa6eb68be0>,166,17,[9 5],167,-1,184,-1,167
1,<environment.Job instance at 0x7faa6eb68780>,168,13,[7 5],169,-1,183,-1,170
1,<environment.Job instance at 0x7faa6eb68af0>,171,16,[7 3],172,-1,188,-1,172
1,<environment.Job instance at 0x7faa6e879cd0>,176,15,[ 1 11],177,-1,195,-1,180
1,<environment.Job instance at 0x7faa6e1b78c0>,177,17,[8 3],178,-1,197,-1,180
1,<environment.Job instance at 0x7faa6e2f9050>,178,15,[10  3],179,-1,195,-1,180
1,<environment.Job instance at 0x7faa6e155820>,158,18,[ 5 10],159,-1,200,-1,182
1,<environment.Job instance at 0x7faa6e67b730>,175,13,[10  5],176,-1,196,-1,183
1,<environment.Job instance at 0x7faa6ecb9e60>,163,26,[5 1],164,-1,209,-1,183
1,<environment.Job instance at 0x7faa6e2e4aa0>,181,19,[9 2],182,-1,204,-1,185
1,<environment.Job instance at 0x7faa6e1d3a00>,172,27,[6 5],173,-1,221,-1,194
1,<environment.Job instance at 0x7faa6d5bc550>,187,20,[9 4],188,-1,214,-1,194
1,<environment.Job instance at 0x7faa6e975230>,0,3,[ 3 14],1,-1,4,-1,1
1,<environment.Job instance at 0x7faa6ecb95a0>,19,15,[12  2],20,-1,59,-1,44
1,<environment.Job instance at 0x7faa6e47f6e0>,27,25,[1 7],28,-1,99,-1,74
1,<environment.Job instance at 0x7faa6e29af50>,31,2,[ 5 11],32,-1,76,-1,74
1,<environment.Job instance at 0x7faa6db15e60>,35,3,[ 3 11],36,-1,94,-1,91
1,<environment.Job instance at 0x7faa6ebf2190>,47,2,[14  5],48,-1,135,-1,133
1,<environment.Job instance at 0x7faa6db0d370>,52,14,[14  2],53,-1,165,-1,151
1,<environment.Job instance at 0x7faa6ebde0f0>,55,1,[ 5 13],56,-1,157,-1,156
1,<environment.Job instance at 0x7faa6d71e5a0>,56,27,[6 1],57,-1,185,-1,158
1,<environment.Job instance at 0x7faa6ebe52d0>,64,23,[5 9],65,-1,204,-1,181
1,<environment.Job instance at 0x7faa6db18820>,67,23,[6 2],68,-1,207,-1,184
1,<environment.Job instance at 0x7faa6ec0af00>,70,26,[6 1],71,-1,216,-1,190
1,<environment.Job instance at 0x7faa6d715a00>,73,14,[ 4 13],74,-1,210,-1,196
1,<environment.Job instance at 0x7faa6e287af0>,81,14,[13  1],82,-1,242,-1,228
1,<environment.Job instance at 0x7faa6ec0e6e0>,84,17,[12  2],85,-1,258,-1,241
1,<environment.Job instance at 0x7faa6e0b4c80>,89,26,[5 8],90,-1,290,-1,264
1,<environment.Job instance at 0x7faa6ebd9a00>,94,14,[13  2],95,-1,288,-1,274
1,<environment.Job instance at 0x7faa6dcc8f00>,96,17,[12  5],97,-1,298,-1,281
1,<environment.Job instance at 0x7faa6d72aa00>,108,14,[14  2],109,-1,351,-1,337
1,<environment.Job instance at 0x7faa6d72a320>,110,23,[ 1 10],111,-1,373,-1,350
1,<environment.Job instance at 0x7faa6d718f00>,119,28,[9 4],120,-1,416,-1,388
1,<environment.Job instance at 0x7faa6e460f00>,125,15,[13  2],126,-1,406,-1,391
1,<environment.Job instance at 0x7faa6dccfa00>,139,28,[8 2],140,-1,449,-1,421
1,<environment.Job instance at 0x7faa6dcbb230>,142,23,[4 7],143,-1,471,-1,448
1,<environment.Job instance at 0x7faa6dcbb280>,144,28,[3 5],145,-1,476,-1,448
1,<environment.Job instance at 0x7faa6d84f5f0>,148,3,[11  1],149,-1,454,-1,451
1,<environment.Job instance at 0x7faa6dcdb780>,149,3,[12  3],150,-1,454,-1,451
1,<environment.Job instance at 0x7faa6d868b40>,161,24,[ 3 10],162,-1,526,-1,502
1,<environment.Job instance at 0x7faa6ec0d730>,163,26,[5 1],164,-1,537,-1,511
1,<environment.Job instance at 0x7faa6d86c280>,169,3,[11  2],170,-1,536,-1,533
1,<environment.Job instance at 0x7faa6d8310f0>,172,27,[6 5],173,-1,566,-1,539
1,<environment.Job instance at 0x7faa6d83f500>,176,15,[ 1 11],177,-1,567,-1,552
1,<environment.Job instance at 0x7faa6d82fe60>,8,14,[9 1],9,-1,25,-1,11
1,<environment.Job instance at 0x7faa6d82fc80>,10,13,[8 3],11,-1,24,-1,11
1,<environment.Job instance at 0x7faa6d82fbe0>,11,14,[ 2 10],12,-1,27,-1,13
1,<environment.Job instance at 0x7faa6d82f280>,12,18,[7 1],13,-1,31,-1,13
1,<environment.Job instance at 0x7faa6d82f500>,17,18,[ 1 10],18,-1,36,-1,18
1,<environment.Job instance at 0x7faa6d86c140>,24,18,[10  1],25,-1,51,-1,33
1,<environment.Job instance at 0x7faa6d86cb40>,28,18,[5 7],29,-1,52,-1,34
1,<environment.Job instance at 0x7faa6d8687d0>,32,13,[10  1],33,-1,52,-1,39
1,<environment.Job instance at 0x7faa6d868960>,37,14,[7 3],38,-1,53,-1,39
1,<environment.Job instance at 0x7faa6d86c780>,26,18,[7 3],27,-1,57,-1,39
1,<environment.Job instance at 0x7faa6d868190>,38,13,[8 3],39,-1,52,-1,39
1,<environment.Job instance at 0x7faa6d868870>,33,16,[ 2 10],34,-1,56,-1,40
1,<environment.Job instance at 0x7faa6d856be0>,41,13,[7 1],42,-1,56,-1,43
1,<environment.Job instance at 0x7faa6d86cbe0>,29,18,[8 1],30,-1,63,-1,45
1,<environment.Job instance at 0x7faa6d856960>,43,13,[8 3],44,-1,58,-1,45
1,<environment.Job instance at 0x7faa6d856870>,45,22,[11  3],46,-1,589,-1,567
1,<environment.Job instance at 0x7faa6d84f230>,48,28,[11  3],49,-1,596,-1,568
1,<environment.Job instance at 0x7faa6d84f050>,66,23,[2 9],67,-1,591,-1,568
1,<environment.Job instance at 0x7faa6db2c730>,71,16,[7 1],72,-1,584,-1,568
1,<environment.Job instance at 0x7faa6e3a8140>,6,24,[1 8],7,-1,31,-1,7
1,<environment.Job instance at 0x7faa6e879280>,19,27,[10  2],20,-1,84,-1,57
1,<environment.Job instance at 0x7faa6d981e10>,21,23,[11  3],22,-1,80,-1,57
1,<environment.Job instance at 0x7faa6d83f320>,45,22,[11  3],46,-1,192,-1,170
1,<environment.Job instance at 0x7faa6d8311e0>,46,1,[ 5 12],47,-1,171,-1,170
1,<environment.Job instance at 0x7faa6d831190>,48,28,[11  3],49,-1,202,-1,174
1,<environment.Job instance at 0x7faa6d868b40>,61,14,[14  2],62,-1,218,-1,204
1,<environment.Job instance at 0x7faa6d716aa0>,63,27,[5 1],64,-1,233,-1,206
1,<environment.Job instance at 0x7faa6d84f640>,67,1,[ 1 13],68,-1,211,-1,210
1,<environment.Job instance at 0x7faa6d716f00>,66,23,[2 9],67,-1,248,-1,225
1,<environment.Job instance at 0x7faa6e0bd0a0>,73,12,[ 2 13],74,-1,241,-1,229
1,<environment.Job instance at 0x7faa6e0bd910>,74,28,[6 4],75,-1,259,-1,231
1,<environment.Job instance at 0x7faa6db0dc80>,93,15,[ 5 11],94,-1,328,-1,313
1,<environment.Job instance at 0x7faa6e2a7730>,100,14,[13  1],101,-1,356,-1,342
1,<environment.Job instance at 0x7faa6eb685f0>,105,24,[ 3 10],106,-1,394,-1,370
1,<environment.Job instance at 0x7faa6d803d70>,112,27,[1 6],113,-1,428,-1,401
1,<environment.Job instance at 0x7faa6d803be0>,114,14,[ 5 14],115,-1,415,-1,401
1,<environment.Job instance at 0x7faa6e821b90>,115,1,[14  5],116,-1,402,-1,401
1,<environment.Job instance at 0x7faa6e8215a0>,117,27,[8 2],118,-1,430,-1,403
1,<environment.Job instance at 0x7faa6da39e10>,120,1,[ 5 12],121,-1,405,-1,404
1,<environment.Job instance at 0x7faa6e295be0>,128,23,[13  2],129,-1,471,-1,448
1,<environment.Job instance at 0x7faa6e2954b0>,140,14,[ 5 11],141,-1,502,-1,488
1,<environment.Job instance at 0x7faa6e295780>,139,26,[8 1],140,-1,524,-1,498
1,<environment.Job instance at 0x7faa6e0cd9b0>,142,27,[1 6],143,-1,525,-1,498
1,<environment.Job instance at 0x7faa6e0cd2d0>,143,26,[8 1],144,-1,524,-1,498
1,<environment.Job instance at 0x7faa6dcbb730>,152,25,[10  4],153,-1,549,-1,524
1,<environment.Job instance at 0x7faa6dcbb0a0>,159,13,[13  3],160,-1,544,-1,531
1,<environment.Job instance at 0x7faa6dcbb190>,160,14,[ 5 14],161,-1,545,-1,531
1,<environment.Job instance at 0x7faa6dcbb8c0>,161,28,[3 5],162,-1,559,-1,531
1,<environment.Job instance at 0x7faa6dcc68c0>,164,1,[ 1 13],165,-1,533,-1,532
1,<environment.Job instance at 0x7faa6dc084b0>,3,18,[5 6],4,-1,22,-1,4
1,<environment.Job instance at 0x7faa6d4aa280>,11,18,[1 5],12,-1,30,-1,12
1,<environment.Job instance at 0x7faa6d4aa2d0>,13,16,[4 9],14,-1,30,-1,14
1,<environment.Job instance at 0x7faa6d4aa5f0>,14,13,[8 5],15,-1,29,-1,16
1,<environment.Job instance at 0x7faa6d4aa960>,18,25,[8 3],19,-1,44,-1,19
1,<environment.Job instance at 0x7faa6d4aad20>,22,26,[5 3],23,-1,49,-1,23
1,<environment.Job instance at 0x7faa6deef3c0>,29,24,[5 6],30,-1,56,-1,32
1,<environment.Job instance at 0x7faa6deef6e0>,32,17,[1 8],33,-1,51,-1,34
1,<environment.Job instance at 0x7faa6deef910>,35,15,[11  3],36,-1,81,-1,66
1,<environment.Job instance at 0x7faa6deef4b0>,30,14,[6 5],31,-1,80,-1,66
1,<environment.Job instance at 0x7faa6deefbe0>,43,22,[5 3],44,-1,88,-1,66
1,<environment.Job instance at 0x7faa6df20690>,49,18,[2 5],50,-1,84,-1,66
1,<environment.Job instance at 0x7faa6df20730>,50,20,[6 3],51,-1,87,-1,67
1,<environment.Job instance at 0x7faa6df20190>,44,3,[5 5],45,-1,72,-1,69
1,<environment.Job instance at 0x7faa6df20550>,47,16,[5 1],48,-1,85,-1,69
1,<environment.Job instance at 0x7faa6df20a50>,55,15,[1 8],56,-1,84,-1,69
1,<environment.Job instance at 0x7faa6df20af0>,56,2,[6 1],57,-1,71,-1,69
1,<environment.Job instance at 0x7faa6df20fa0>,63,3,[9 1],64,-1,72,-1,69
1,<environment.Job instance at 0x7faa6d4aacd0>,23,14,[14  3],24,-1,87,-1,73
1,<environment.Job instance at 0x7faa6e94c5a0>,66,15,[3 7],67,-1,89,-1,74
1,<environment.Job instance at 0x7faa6e94c1e0>,64,3,[6 1],65,-1,77,-1,74
1,<environment.Job instance at 0x7faa6e94c870>,68,15,[5 2],69,-1,90,-1,75
1,<environment.Job instance at 0x7faa6e94ca00>,70,28,[5 9],71,-1,103,-1,75
1,<environment.Job instance at 0x7faa6e94cdc0>,71,12,[6 3],72,-1,87,-1,75
1,<environment.Job instance at 0x7faa6e94ce60>,72,12,[9 3],73,-1,87,-1,75
1,<environment.Job instance at 0x7faa6deef230>,28,13,[ 4 12],29,-1,88,-1,75
1,<environment.Job instance at 0x7faa6e0abe10>,73,18,[5 4],74,-1,95,-1,77
1,<environment.Job instance at 0x7faa6dcf10f0>,74,15,[5 7],75,-1,92,-1,77
1,<environment.Job instance at 0x7faa6e92a5a0>,75,25,[3 7],76,-1,102,-1,77
1,<environment.Job instance at 0x7faa6e92aa50>,76,24,[5 8],77,-1,101,-1,77
1,<environment.Job instance at 0x7faa6e92afa0>,77,16,[ 4 10],78,-1,94,-1,78
1,<environment.Job instance at 0x7faa6e92ac30>,80,15,[9 3],81,-1,96,-1,81
1,<environment.Job instance at 0x7faa6e080870>,82,1,[ 5 10],83,-1,84,-1,83
1,<environment.Job instance at 0x7faa6e15ee10>,84,14,[6 5],85,-1,100,-1,86
1,<environment.Job instance at 0x7faa6e7345a0>,85,14,[ 4 14],86,-1,100,-1,86
1,<environment.Job instance at 0x7faa6dc23730>,83,15,[5 5],84,-1,102,-1,87
1,<environment.Job instance at 0x7faa6dea3e60>,86,12,[3 6],87,-1,101,-1,89
1,<environment.Job instance at 0x7faa6e929550>,91,16,[8 1],92,-1,109,-1,93
1,<environment.Job instance at 0x7faa6e929c80>,92,15,[6 2],93,-1,108,-1,93
1,<environment.Job instance at 0x7faa6e9e8780>,89,15,[14  3],90,-1,116,-1,101
1,<environment.Job instance at 0x7faa6de7db90>,102,2,[5 7],103,-1,105,-1,103
1,<environment.Job instance at 0x7faa6da560a0>,97,26,[1 5],98,-1,135,-1,109
1,<environment.Job instance at 0x7faa6df200f0>,45,15,[7 2],46,-1,124,-1,109
1,<environment.Job instance at 0x7faa6e9dffa0>,103,21,[5 6],104,-1,130,-1,109
1,<environment.Job instance at 0x7faa6de6e190>,107,25,[5 8],108,-1,134,-1,109
1,<environment.Job instance at 0x7faa6df207d0>,51,27,[8 3],52,-1,136,-1,109
1,<environment.Job instance at 0x7faa6dc5a410>,114,18,[1 7],115,-1,133,-1,115
1,<environment.Job instance at 0x7faa6dc5ab40>,116,18,[6 5],117,-1,135,-1,117
1,<environment.Job instance at 0x7faa6de98b40>,119,18,[ 4 10],120,-1,138,-1,120
1,<environment.Job instance at 0x7faa6de98a00>,121,16,[10  2],122,-1,144,-1,128
1,<environment.Job instance at 0x7faa6de988c0>,123,20,[2 5],124,-1,148,-1,128
1,<environment.Job instance at 0x7faa6de985a0>,124,22,[4 8],125,-1,150,-1,128
1,<environment.Job instance at 0x7faa6de98d20>,117,18,[7 4],118,-1,154,-1,136
1,<environment.Job instance at 0x7faa6de7aa00>,129,16,[11  3],130,-1,162,-1,146
1,<environment.Job instance at 0x7faa6de982d0>,120,27,[9 3],121,-1,174,-1,147
1,<environment.Job instance at 0x7faa6de858c0>,135,25,[10  3],136,-1,172,-1,147
1,<environment.Job instance at 0x7faa6de85a00>,137,22,[4 8],138,-1,178,-1,156
1,<environment.Job instance at 0x7faa6de85d20>,142,18,[9 5],143,-1,182,-1,164
1,<environment.Job instance at 0x7faa6de91e60>,144,13,[8 2],145,-1,177,-1,164
1,<environment.Job instance at 0x7faa6de91b90>,145,14,[9 2],146,-1,178,-1,164
1,<environment.Job instance at 0x7faa6de98190>,125,27,[3 7],126,-1,191,-1,164
1,<environment.Job instance at 0x7faa6de910f0>,146,22,[ 2 10],147,-1,186,-1,164
1,<environment.Job instance at 0x7faa6de91cd0>,148,17,[4 6],149,-1,182,-1,165
1,<environment.Job instance at 0x7faa6de91f00>,149,14,[7 4],150,-1,179,-1,165
1,<environment.Job instance at 0x7faa6de85eb0>,139,1,[3 5],140,-1,166,-1,165
1,<environment.Job instance at 0x7faa6eded780>,151,14,[ 2 10],152,-1,180,-1,166
1,<environment.Job instance at 0x7faa6eded3c0>,150,13,[5 5],151,-1,179,-1,166
1,<environment.Job instance at 0x7faa6e078190>,154,14,[3 6],155,-1,180,-1,166
1,<environment.Job instance at 0x7faa6e0780a0>,155,18,[9 3],156,-1,186,-1,168
1,<environment.Job instance at 0x7faa6dc6a320>,156,13,[5 9],157,-1,181,-1,168
1,<environment.Job instance at 0x7faa6e0aca00>,160,16,[6 2],161,-1,185,-1,169
1,<environment.Job instance at 0x7faa6e0ac8c0>,161,22,[9 1],162,-1,191,-1,169
1,<environment.Job instance at 0x7faa6de79e10>,162,15,[7 5],163,-1,184,-1,169
1,<environment.Job instance at 0x7faa6e940d20>,165,12,[5 5],166,-1,181,-1,169
1,<environment.Job instance at 0x7faa6de6e5f0>,106,13,[ 4 13],107,-1,182,-1,169
1,<environment.Job instance at 0x7faa6d47f870>,167,15,[1 6],168,-1,186,-1,171
1,<environment.Job instance at 0x7faa6def6910>,163,13,[ 1 12],164,-1,184,-1,171
1,<environment.Job instance at 0x7faa6df1da00>,169,12,[ 5 10],170,-1,183,-1,171
1,<environment.Job instance at 0x7faa6de7a500>,132,18,[10  2],133,-1,191,-1,173
1,<environment.Job instance at 0x7faa6df1dcd0>,170,15,[8 2],171,-1,188,-1,173
1,<environment.Job instance at 0x7faa6e9182d0>,172,18,[3 7],173,-1,191,-1,173
1,<environment.Job instance at 0x7faa6de8b730>,173,15,[10  4],174,-1,189,-1,174
1,<environment.Job instance at 0x7faa6e0a0230>,176,13,[10  5],177,-1,190,-1,177
1,<environment.Job instance at 0x7faa6e07c640>,177,17,[5 5],178,-1,195,-1,178
1,<environment.Job instance at 0x7faa6e92d230>,179,17,[2 8],180,-1,197,-1,180
1,<environment.Job instance at 0x7faa6e93cb40>,184,15,[10  5],185,-1,203,-1,188
1,<environment.Job instance at 0x7faa6e93c280>,188,15,[2 6],189,-1,204,-1,189
1,<environment.Job instance at 0x7faa6deefb40>,6,14,[11  4],7,-1,21,-1,7
1,<environment.Job instance at 0x7faa6e09aeb0>,10,3,[ 1 12],11,-1,14,-1,11
1,<environment.Job instance at 0x7faa6de91460>,16,21,[ 3 14],17,-1,50,-1,29
1,<environment.Job instance at 0x7faa6e92d460>,18,25,[8 3],19,-1,56,-1,31
1,<environment.Job instance at 0x7faa6dcbb7d0>,22,26,[5 3],23,-1,61,-1,35
1,<environment.Job instance at 0x7faa6dcbb050>,23,14,[14  3],24,-1,49,-1,35
1,<environment.Job instance at 0x7faa6dcbb730>,24,24,[ 4 13],25,-1,59,-1,35
1,<environment.Job instance at 0x7faa6dcbb820>,25,2,[ 4 14],26,-1,37,-1,35
1,<environment.Job instance at 0x7faa6dcbb640>,28,13,[ 4 12],29,-1,53,-1,40
1,<environment.Job instance at 0x7faa6dcbbcd0>,29,24,[5 6],30,-1,65,-1,41
1,<environment.Job instance at 0x7faa6db1e640>,35,15,[11  3],36,-1,72,-1,57
1,<environment.Job instance at 0x7faa6d5ea910>,51,27,[8 3],52,-1,130,-1,103
1,<environment.Job instance at 0x7faa6e2b7e10>,52,3,[ 5 13],53,-1,106,-1,103
1,<environment.Job instance at 0x7faa6ddce500>,53,1,[ 3 11],54,-1,104,-1,103
1,<environment.Job instance at 0x7faa6d718c30>,70,28,[5 9],71,-1,160,-1,132
1,<environment.Job instance at 0x7faa6d84f3c0>,75,25,[3 7],76,-1,187,-1,162
1,<environment.Job instance at 0x7faa6d7168c0>,76,24,[5 8],77,-1,186,-1,162
1,<environment.Job instance at 0x7faa6d860a50>,85,14,[ 4 14],86,-1,193,-1,179
1,<environment.Job instance at 0x7faa6e15e460>,89,15,[14  3],90,-1,208,-1,193
1,<environment.Job instance at 0x7faa6e0548c0>,93,2,[11  5],94,-1,207,-1,205
1,<environment.Job instance at 0x7faa6e95a5a0>,97,26,[1 5],98,-1,236,-1,210
1,<environment.Job instance at 0x7faa6e6f1190>,106,13,[ 4 13],107,-1,245,-1,232
1,<environment.Job instance at 0x7faa77979370>,107,25,[5 8],108,-1,271,-1,246
1,<environment.Job instance at 0x7faa6e79c050>,120,27,[9 3],121,-1,313,-1,286
1,<environment.Job instance at 0x7faa6e7b4be0>,125,27,[3 7],126,-1,337,-1,310
1,<environment.Job instance at 0x7faa6e436b90>,129,16,[11  3],130,-1,326,-1,310
1,<environment.Job instance at 0x7faa6e79da50>,135,25,[10  3],136,-1,358,-1,333
1,<environment.Job instance at 0x7faa6d652b40>,152,3,[12  4],153,-1,414,-1,411
1,<environment.Job instance at 0x7faa6d65a500>,163,13,[ 1 12],164,-1,473,-1,460
1,<environment.Job instance at 0x7faa6de5c320>,180,15,[14  4],181,-1,550,-1,535
1,<environment.Job instance at 0x7efda2cbb2d0>,3,22,[2 5],4,-1,26,-1,4
1,<environment.Job instance at 0x7efda2cbb370>,4,13,[3 6],5,-1,18,-1,5
1,<environment.Job instance at 0x7efda2cbb410>,6,15,[2 8],7,-1,22,-1,7
1,<environment.Job instance at 0x7efda2cbb5a0>,7,14,[7 5],8,-1,22,-1,8
1,<environment.Job instance at 0x7efda2cbb460>,8,17,[1 8],9,-1,26,-1,9
1,<environment.Job instance at 0x7efda2cbb6e0>,10,22,[8 1],11,-1,33,-1,11
1,<environment.Job instance at 0x7efda2cbb780>,12,23,[6 4],13,-1,36,-1,13
1,<environment.Job instance at 0x7efda2cbba50>,13,18,[5 9],14,-1,32,-1,14
1,<environment.Job instance at 0x7efda2cbb960>,14,21,[8 1],15,-1,36,-1,15
1,<environment.Job instance at 0x7efda2cbbb40>,16,18,[7 3],17,-1,35,-1,17
1,<environment.Job instance at 0x7efda2cbbc30>,18,26,[7 4],19,-1,45,-1,19
1,<environment.Job instance at 0x7efda2cbbe60>,19,25,[5 9],20,-1,45,-1,20
1,<environment.Job instance at 0x7efda2cbbf00>,21,18,[9 4],22,-1,40,-1,22
1,<environment.Job instance at 0x7efda2cbf0a0>,23,16,[6 2],24,-1,40,-1,24
1,<environment.Job instance at 0x7efda2cbf5f0>,27,17,[4 6],28,-1,45,-1,28
1,<environment.Job instance at 0x7efda2cbf7d0>,30,26,[9 4],31,-1,57,-1,31
1,<environment.Job instance at 0x7efda2cbf8c0>,32,21,[5 9],33,-1,54,-1,33
1,<environment.Job instance at 0x7efda2cbfa00>,33,26,[3 6],34,-1,60,-1,34
1,<environment.Job instance at 0x7efda2cbf730>,34,14,[1 9],35,-1,50,-1,36
1,<environment.Job instance at 0x7efda2cbfcd0>,35,16,[1 9],36,-1,52,-1,36
1,<environment.Job instance at 0x7efda2cc10f0>,39,14,[9 4],40,-1,54,-1,40
1,<environment.Job instance at 0x7efda2cc1190>,40,26,[ 1 10],41,-1,67,-1,41
1,<environment.Job instance at 0x7efda2cc1140>,41,1,[7 1],42,-1,43,-1,42
1,<environment.Job instance at 0x7efda2cc1640>,45,15,[7 5],46,-1,61,-1,46
1,<environment.Job instance at 0x7efda2cc1500>,47,13,[ 3 10],48,-1,61,-1,48
1,<environment.Job instance at 0x7efda2cc19b0>,48,12,[9 2],49,-1,61,-1,49
1,<environment.Job instance at 0x7efda2cc1fa0>,12,23,[6 4],13,-1,53,-1,30
1,<environment.Job instance at 0x7efda2cc4460>,18,26,[7 4],19,-1,70,-1,44
1,<environment.Job instance at 0x7efda2cc4320>,19,25,[5 9],20,-1,83,-1,58
1,<environment.Job instance at 0x7efda2cc49b0>,28,17,[ 1 13],29,-1,87,-1,70
1,<environment.Job instance at 0x7efda2cc4c30>,30,26,[9 4],31,-1,110,-1,84
1,<environment.Job instance at 0x7efda2cc4c80>,31,1,[ 2 14],32,-1,85,-1,84
1,<environment.Job instance at 0x7efda2cc4d20>,33,26,[3 6],34,-1,110,-1,84
1,<environment.Job instance at 0x7efda2cc83c0>,40,26,[ 1 10],41,-1,139,-1,113
1,<environment.Job instance at 0x7efda23fe3c0>,4,18,[7 1],5,-1,24,-1,6
1,<environment.Job instance at 0x7efda23fe820>,7,16,[ 2 11],8,-1,24,-1,8
1,<environment.Job instance at 0x7efda23fe0a0>,8,17,[3 7],9,-1,26,-1,9
1,<environment.Job instance at 0x7efda23fe690>,9,19,[1 7],10,-1,29,-1,10
1,<environment.Job instance at 0x7efda23fb050>,12,14,[4 9],13,-1,27,-1,13
1,<environment.Job instance at 0x7efda23fb730>,17,16,[1 9],18,-1,34,-1,18
1,<environment.Job instance at 0x7efda23fda00>,18,14,[6 4],19,-1,33,-1,19
1,<environment.Job instance at 0x7efda23fd050>,19,14,[9 4],20,-1,34,-1,20
1,<environment.Job instance at 0x7efda23fdf00>,22,18,[3 5],23,-1,41,-1,23
1,<environment.Job instance at 0x7efda23f33c0>,26,13,[10  1],27,-1,41,-1,28
1,<environment.Job instance at 0x7efda23f32d0>,27,16,[8 1],28,-1,44,-1,28
1,<environment.Job instance at 0x7efda24dd910>,29,19,[10  3],30,-1,49,-1,30
1,<environment.Job instance at 0x7efda24dd230>,31,14,[8 5],32,-1,46,-1,32
1,<environment.Job instance at 0x7efda2535c30>,32,21,[4 8],33,-1,54,-1,33
1,<environment.Job instance at 0x7efda2277690>,33,18,[ 3 10],34,-1,52,-1,34
1,<environment.Job instance at 0x7efda2266460>,37,18,[7 1],38,-1,56,-1,38
1,<environment.Job instance at 0x7efda22665f0>,38,16,[4 9],39,-1,55,-1,39
1,<environment.Job instance at 0x7efda23dc5f0>,46,18,[2 6],47,-1,65,-1,47
1,<environment.Job instance at 0x7efda2cbfe10>,7,16,[ 2 11],8,-1,24,-1,8
1,<environment.Job instance at 0x7efda24734b0>,39,17,[ 5 14],40,-1,114,-1,97
1,<environment.Job instance at 0x7efda2473e60>,43,25,[ 1 10],44,-1,140,-1,115
1,<environment.Job instance at 0x7efdac1e8af0>,3,16,[1 9],4,-1,20,-1,4
1,<environment.Job instance at 0x7efda2339a00>,5,16,[7 5],6,-1,22,-1,6
1,<environment.Job instance at 0x7efda2339f00>,7,18,[5 5],8,-1,26,-1,8
1,<environment.Job instance at 0x7efda2339af0>,9,27,[3 9],10,-1,37,-1,10
1,<environment.Job instance at 0x7efda2339780>,10,23,[5 1],11,-1,34,-1,11
1,<environment.Job instance at 0x7efda23390a0>,11,17,[6 4],12,-1,29,-1,12
1,<environment.Job instance at 0x7efda2339550>,18,16,[5 2],19,-1,36,-1,20
1,<environment.Job instance at 0x7efda2339820>,19,28,[7 5],20,-1,48,-1,20
1,<environment.Job instance at 0x7efda22bd3c0>,22,18,[7 5],23,-1,41,-1,23
1,<environment.Job instance at 0x7efda22bdb40>,30,17,[9 5],31,-1,48,-1,31
1,<environment.Job instance at 0x7efda22bd780>,32,18,[10  4],33,-1,51,-1,33
1,<environment.Job instance at 0x7efda22b0910>,34,12,[5 4],35,-1,47,-1,35
1,<environment.Job instance at 0x7efda22b03c0>,35,15,[8 3],36,-1,51,-1,36
1,<environment.Job instance at 0x7efda22b09b0>,37,28,[ 2 10],38,-1,66,-1,38
1,<environment.Job instance at 0x7efda22b2230>,41,14,[ 3 10],42,-1,56,-1,42
1,<environment.Job instance at 0x7efda22b20f0>,9,27,[3 9],10,-1,45,-1,18
1,<environment.Job instance at 0x7efda22b2050>,10,23,[5 1],11,-1,41,-1,18
1,<environment.Job instance at 0x7efda22e7410>,17,3,[ 3 13],18,-1,26,-1,23
1,<environment.Job instance at 0x7efda22e7be0>,19,28,[7 5],20,-1,63,-1,35
1,<environment.Job instance at 0x7efda23359b0>,20,19,[ 5 12],21,-1,54,-1,35
1,<environment.Job instance at 0x7efda2335960>,37,28,[ 2 10],38,-1,129,-1,101
1,<environment.Job instance at 0x7efda22a81e0>,42,15,[ 2 13],43,-1,122,-1,107
1,<environment.Job instance at 0x7efda22a8500>,44,20,[13  4],45,-1,133,-1,113
1,<environment.Job instance at 0x7efda3391cd0>,1,22,[5 6],2,-1,24,-1,2
1,<environment.Job instance at 0x7efda2fa9780>,5,17,[10  4],6,-1,24,-1,7
1,<environment.Job instance at 0x7efda2fa94b0>,7,21,[10  4],8,-1,29,-1,8
1,<environment.Job instance at 0x7efda2fa9b90>,10,24,[1 5],11,-1,35,-1,11
1,<environment.Job instance at 0x7efda2fa9820>,12,20,[10  5],13,-1,33,-1,13
1,<environment.Job instance at 0x7efda2fa9d20>,14,14,[10  5],15,-1,29,-1,15
1,<environment.Job instance at 0x7efda2fa91e0>,19,14,[ 5 10],20,-1,34,-1,20
1,<environment.Job instance at 0x7efda27a7820>,20,17,[4 7],21,-1,38,-1,21
1,<environment.Job instance at 0x7efda27a7370>,23,24,[3 7],24,-1,48,-1,24
1,<environment.Job instance at 0x7efda27a7780>,24,19,[3 8],25,-1,44,-1,25
1,<environment.Job instance at 0x7efda313ef50>,27,16,[8 4],28,-1,44,-1,28
1,<environment.Job instance at 0x7efda313e370>,30,17,[3 5],31,-1,48,-1,31
1,<environment.Job instance at 0x7efda313ec30>,31,18,[6 2],32,-1,50,-1,32
1,<environment.Job instance at 0x7efda313e730>,34,19,[6 2],35,-1,54,-1,35
1,<environment.Job instance at 0x7efda313efa0>,36,17,[9 1],37,-1,55,-1,38
1,<environment.Job instance at 0x7efda313e190>,43,12,[1 9],44,-1,56,-1,44
1,<environment.Job instance at 0x7efda2fa9dc0>,3,1,[12  5],4,-1,5,-1,4
1,<environment.Job instance at 0x7efda33916e0>,10,24,[1 5],11,-1,43,-1,19
1,<environment.Job instance at 0x7efda3391b90>,16,13,[ 5 14],17,-1,34,-1,21
1,<environment.Job instance at 0x7efda300aa50>,23,24,[3 7],24,-1,65,-1,41
1,<environment.Job instance at 0x7efda3070cd0>,38,27,[ 3 12],39,-1,105,-1,78
1,<environment.Job instance at 0x7efda3070aa0>,42,15,[ 2 14],43,-1,107,-1,92
1,<environment.Job instance at 0x7efda3070460>,44,26,[3 9],45,-1,134,-1,108
1,<environment.Job instance at 0x7efda3154cd0>,0,23,[4 7],1,-1,24,-1,1
1,<environment.Job instance at 0x7efda2702e60>,5,19,[ 1 10],6,-1,25,-1,6
1,<environment.Job instance at 0x7efda26d04b0>,6,16,[6 5],7,-1,23,-1,7
1,<environment.Job instance at 0x7efda26d0280>,8,20,[ 2 10],9,-1,30,-1,10
1,<environment.Job instance at 0x7efda26d0e10>,10,1,[14  4],11,-1,12,-1,11
1,<environment.Job instance at 0x7efda26ecc80>,11,17,[3 6],12,-1,29,-1,12
1,<environment.Job instance at 0x7efda27066e0>,12,13,[2 5],13,-1,26,-1,13
1,<environment.Job instance at 0x7efda2706320>,13,1,[4 8],14,-1,15,-1,14
1,<environment.Job instance at 0x7efda27065a0>,14,16,[5 6],15,-1,31,-1,15
1,<environment.Job instance at 0x7efda2f3de10>,9,15,[5 5],10,-1,30,-1,15
1,<environment.Job instance at 0x7efda26f80a0>,16,16,[1 8],17,-1,33,-1,17
1,<environment.Job instance at 0x7efda27063c0>,18,23,[1 9],19,-1,42,-1,19
1,<environment.Job instance at 0x7efda30fa8c0>,19,17,[8 5],20,-1,38,-1,21
1,<environment.Job instance at 0x7efda30eb7d0>,22,15,[8 2],23,-1,39,-1,24
1,<environment.Job instance at 0x7efda2704af0>,24,15,[8 5],25,-1,40,-1,25
1,<environment.Job instance at 0x7efda27044b0>,28,19,[4 7],29,-1,48,-1,29
1,<environment.Job instance at 0x7efda30eb280>,23,18,[5 1],24,-1,51,-1,33
1,<environment.Job instance at 0x7efda2992190>,33,22,[9 1],34,-1,58,-1,36
1,<environment.Job instance at 0x7efda23a0500>,38,13,[2 7],39,-1,52,-1,39
1,<environment.Job instance at 0x7efda239b190>,40,13,[5 9],41,-1,54,-1,41
1,<environment.Job instance at 0x7efda23a6e60>,41,13,[8 1],42,-1,55,-1,42
1,<environment.Job instance at 0x7efda29a5f50>,42,12,[ 5 10],43,-1,55,-1,43
1,<environment.Job instance at 0x7efda29a5730>,43,13,[9 2],44,-1,57,-1,44
1,<environment.Job instance at 0x7efda298f280>,44,13,[4 5],45,-1,58,-1,45
1,<environment.Job instance at 0x7efda29b3aa0>,45,27,[6 1],46,-1,73,-1,46
1,<environment.Job instance at 0x7efda29b3f50>,46,1,[4 7],47,-1,48,-1,47
1,<environment.Job instance at 0x7efda29b3910>,47,14,[10  3],48,-1,62,-1,48
1,<environment.Job instance at 0x7efda29b3870>,48,3,[5 1],49,-1,52,-1,49
1,<environment.Job instance at 0x7efda239ffa0>,35,18,[5 4],36,-1,68,-1,50
1,<environment.Job instance at 0x7efda2702780>,0,23,[4 7],1,-1,24,-1,1
1,<environment.Job instance at 0x7efda3070460>,10,1,[14  4],11,-1,17,-1,16
1,<environment.Job instance at 0x7efda3070f50>,17,18,[ 1 14],18,-1,51,-1,33
1,<environment.Job instance at 0x7efda30709b0>,18,23,[1 9],19,-1,57,-1,34
1,<environment.Job instance at 0x7efda300ab40>,25,17,[12  1],26,-1,68,-1,51
1,<environment.Job instance at 0x7efda300a230>,30,16,[14  3],31,-1,88,-1,72
1,<environment.Job instance at 0x7efda33915a0>,37,2,[ 1 12],38,-1,87,-1,85
1,<environment.Job instance at 0x7efda313e5a0>,45,27,[6 1],46,-1,141,-1,114
1,<environment.Job instance at 0x7efda26deeb0>,1,16,[5 8],2,-1,18,-1,2
1,<environment.Job instance at 0x7efda26de910>,7,14,[10  5],8,-1,24,-1,10
1,<environment.Job instance at 0x7efda30fd960>,11,17,[10  2],12,-1,31,-1,14
1,<environment.Job instance at 0x7efda30fd550>,14,3,[5 4],15,-1,18,-1,15
1,<environment.Job instance at 0x7efda30fd0a0>,15,18,[ 1 10],16,-1,34,-1,16
1,<environment.Job instance at 0x7efda30fd370>,16,15,[6 5],17,-1,32,-1,17
1,<environment.Job instance at 0x7efda30fde10>,13,26,[5 3],14,-1,43,-1,17
1,<environment.Job instance at 0x7efda30fd050>,18,17,[1 5],19,-1,36,-1,19
1,<environment.Job instance at 0x7efda30fd820>,20,18,[5 8],21,-1,39,-1,21
1,<environment.Job instance at 0x7efda30fd9b0>,22,18,[3 8],23,-1,41,-1,23
1,<environment.Job instance at 0x7efda30fd140>,23,13,[8 3],24,-1,37,-1,24
1,<environment.Job instance at 0x7efda30f0c80>,26,17,[8 4],27,-1,44,-1,27
1,<environment.Job instance at 0x7efda30f0cd0>,27,15,[3 6],28,-1,43,-1,28
1,<environment.Job instance at 0x7efda30f0c30>,28,20,[5 2],29,-1,49,-1,29
1,<environment.Job instance at 0x7efda30f0eb0>,31,20,[ 4 10],32,-1,52,-1,32
1,<environment.Job instance at 0x7efda30f0780>,32,15,[9 2],33,-1,50,-1,35
1,<environment.Job instance at 0x7efda30f0050>,37,27,[9 5],38,-1,65,-1,38
1,<environment.Job instance at 0x7efda30f0a00>,38,13,[8 4],39,-1,52,-1,39
1,<environment.Job instance at 0x7efda30ee5f0>,44,12,[8 3],45,-1,57,-1,45
1,<environment.Job instance at 0x7efda30eee60>,46,13,[8 2],47,-1,60,-1,47
1,<environment.Job instance at 0x7efda30fdd20>,2,23,[1 8],3,-1,41,-1,18
1,<environment.Job instance at 0x7efda30eeaf0>,13,26,[5 3],14,-1,44,-1,18
1,<environment.Job instance at 0x7efda239a690>,29,26,[2 8],30,-1,93,-1,67
1,<environment.Job instance at 0x7efda239aaa0>,37,27,[9 5],38,-1,128,-1,101
1,<environment.Job instance at 0x7efda239a370>,39,14,[12  2],40,-1,115,-1,101
1,<environment.Job instance at 0x7efda2a4c370>,3,17,[7 4],4,-1,22,-1,5
1,<environment.Job instance at 0x7efda30ebc80>,4,17,[13  5],5,-1,23,-1,6
1,<environment.Job instance at 0x7efda2a4cc80>,13,16,[4 5],14,-1,31,-1,15
1,<environment.Job instance at 0x7efda2a4ccd0>,15,16,[7 5],16,-1,32,-1,16
1,<environment.Job instance at 0x7efda2a82190>,19,18,[5 6],20,-1,38,-1,20
1,<environment.Job instance at 0x7efda2a82370>,20,16,[8 3],21,-1,37,-1,21
1,<environment.Job instance at 0x7efda2a825f0>,23,16,[ 4 10],24,-1,40,-1,24
1,<environment.Job instance at 0x7efda2a824b0>,25,27,[4 5],26,-1,53,-1,26
1,<environment.Job instance at 0x7efda2a82e60>,32,20,[4 9],33,-1,54,-1,34
1,<environment.Job instance at 0x7efda2a82640>,1,17,[ 5 14],2,-1,19,-1,2
1,<environment.Job instance at 0x7efda2a829b0>,2,25,[ 3 11],3,-1,28,-1,3
1,<environment.Job instance at 0x7efda2a7e140>,4,17,[13  5],5,-1,22,-1,5
1,<environment.Job instance at 0x7efda2a7ea50>,5,13,[ 5 14],6,-1,19,-1,6
1,<environment.Job instance at 0x7efda239a640>,25,27,[4 5],26,-1,86,-1,59
1,<environment.Job instance at 0x7efda239a5f0>,27,12,[13  4],28,-1,71,-1,59
1,<environment.Job instance at 0x7efda239afa0>,28,12,[ 5 12],29,-1,71,-1,59
1,<environment.Job instance at 0x7efda26deaf0>,47,13,[12  1],48,-1,120,-1,107
1,<environment.Job instance at 0x7efda26dec30>,48,12,[14  3],49,-1,119,-1,107
1,<environment.Job instance at 0x7efda3071370>,10,26,[8 3],11,-1,37,-1,11
1,<environment.Job instance at 0x7efda25f4140>,15,13,[9 1],16,-1,29,-1,16
1,<environment.Job instance at 0x7efda25f4550>,16,18,[8 3],17,-1,35,-1,17
1,<environment.Job instance at 0x7efda25f47d0>,18,16,[5 2],19,-1,36,-1,20
1,<environment.Job instance at 0x7efda25f4be0>,20,12,[3 8],21,-1,34,-1,22
1,<environment.Job instance at 0x7efda2535780>,22,14,[2 8],23,-1,37,-1,23
1,<environment.Job instance at 0x7efda2535e60>,23,2,[10  2],24,-1,26,-1,24
1,<environment.Job instance at 0x7efda25f4c30>,21,18,[5 8],22,-1,43,-1,25
1,<environment.Job instance at 0x7efda27505a0>,27,13,[ 5 10],28,-1,43,-1,30
1,<environment.Job instance at 0x7efda2750c30>,30,16,[ 4 10],31,-1,47,-1,31
1,<environment.Job instance at 0x7efda2750e60>,31,15,[5 7],32,-1,47,-1,32
1,<environment.Job instance at 0x7efda2750410>,32,17,[8 2],33,-1,50,-1,33
1,<environment.Job instance at 0x7efda2750e10>,34,17,[6 1],35,-1,52,-1,35
1,<environment.Job instance at 0x7efda2750190>,36,17,[7 4],37,-1,54,-1,37
1,<environment.Job instance at 0x7efda2652e60>,39,18,[10  4],40,-1,58,-1,40
1,<environment.Job instance at 0x7efda26520f0>,40,15,[1 9],41,-1,56,-1,41
1,<environment.Job instance at 0x7efda2750be0>,29,18,[5 2],30,-1,59,-1,41
1,<environment.Job instance at 0x7efda2652320>,44,18,[10  5],45,-1,63,-1,45
1,<environment.Job instance at 0x7efda2652280>,46,16,[2 9],47,-1,65,-1,49
1,<environment.Job instance at 0x7efda3804050>,48,15,[10  4],49,-1,66,-1,51
1,<environment.Job instance at 0x7efda3071730>,6,25,[2 8],7,-1,40,-1,15
1,<environment.Job instance at 0x7efda30ee730>,10,26,[8 3],11,-1,49,-1,23
1,<environment.Job instance at 0x7efda239adc0>,24,2,[11  3],25,-1,46,-1,44
1,<environment.Job instance at 0x7efda2a4c960>,35,17,[12  4],36,-1,107,-1,90
1,<environment.Job instance at 0x7efda3804500>,47,2,[ 3 11],48,-1,141,-1,139
1,<environment.Job instance at 0x7efdabde6fa0>,0,16,[8 5],1,-1,17,-1,1
1,<environment.Job instance at 0x7efdabde6af0>,2,27,[8 3],3,-1,30,-1,3
1,<environment.Job instance at 0x7efda368d0f0>,3,18,[1 6],4,-1,22,-1,4
1,<environment.Job instance at 0x7efda368dd20>,4,17,[2 6],5,-1,22,-1,5
1,<environment.Job instance at 0x7efda368dcd0>,6,27,[2 6],7,-1,34,-1,7
1,<environment.Job instance at 0x7efda368d3c0>,8,16,[9 2],9,-1,26,-1,10
1,<environment.Job instance at 0x7efda2faf0a0>,15,14,[6 1],16,-1,35,-1,21
1,<environment.Job instance at 0x7efda2fafaa0>,17,1,[2 8],18,-1,22,-1,21
1,<environment.Job instance at 0x7efda3643500>,20,12,[10  5],21,-1,33,-1,21
1,<environment.Job instance at 0x7efda3643be0>,22,16,[6 4],23,-1,41,-1,25
1,<environment.Job instance at 0x7efda3440dc0>,26,21,[ 4 10],27,-1,48,-1,27
1,<environment.Job instance at 0x7efda3440370>,27,23,[2 8],28,-1,52,-1,29
1,<environment.Job instance at 0x7efda2b01410>,35,17,[ 5 10],36,-1,54,-1,37
1,<environment.Job instance at 0x7efda2b01e60>,39,17,[12  4],40,-1,58,-1,41
1,<environment.Job instance at 0x7efda2b01aa0>,40,25,[6 4],41,-1,66,-1,41
1,<environment.Job instance at 0x7efda2b01f00>,36,14,[9 4],37,-1,58,-1,44
1,<environment.Job instance at 0x7efda3133d70>,43,13,[ 4 10],44,-1,58,-1,45
1,<environment.Job instance at 0x7efda31335f0>,44,24,[5 5],45,-1,69,-1,45
1,<environment.Job instance at 0x7efda36430f0>,2,27,[8 3],3,-1,44,-1,17
1,<environment.Job instance at 0x7efda2b010a0>,6,27,[2 6],7,-1,44,-1,17
1,<environment.Job instance at 0x7efdabde6e60>,10,14,[ 4 14],11,-1,31,-1,17
1,<environment.Job instance at 0x7efda2f216e0>,28,3,[11  1],29,-1,72,-1,69
1,<environment.Job instance at 0x7efda2f21230>,29,19,[13  3],30,-1,88,-1,69
1,<environment.Job instance at 0x7efda2f21e60>,27,23,[2 8],28,-1,92,-1,69
1,<environment.Job instance at 0x7efda2f214b0>,34,13,[ 4 11],35,-1,96,-1,83
1,<environment.Job instance at 0x7efda306e820>,39,17,[12  4],40,-1,113,-1,96
1,<environment.Job instance at 0x7efda306ec30>,40,25,[6 4],41,-1,122,-1,97
1,<environment.Job instance at 0x7efda306e8c0>,42,3,[14  5],43,-1,100,-1,97
1,<environment.Job instance at 0x7efda306e140>,44,24,[5 5],45,-1,133,-1,109
1,<environment.Job instance at 0x7efda2eecd20>,48,28,[ 5 10],49,-1,153,-1,125
1,<environment.Job instance at 0x7efda2da2c80>,1,17,[7 5],2,-1,19,-1,2
1,<environment.Job instance at 0x7efda35f2230>,8,15,[2 9],9,-1,24,-1,9
1,<environment.Job instance at 0x7efda3604230>,13,15,[6 4],14,-1,29,-1,14
1,<environment.Job instance at 0x7efda3604a00>,16,12,[10  2],17,-1,29,-1,17
1,<environment.Job instance at 0x7efda3604c80>,17,12,[6 2],18,-1,31,-1,19
1,<environment.Job instance at 0x7efda3604910>,19,1,[9 2],20,-1,21,-1,20
1,<environment.Job instance at 0x7efda3604280>,20,12,[3 7],21,-1,33,-1,21
1,<environment.Job instance at 0x7efda3604f00>,22,14,[5 3],23,-1,37,-1,23
1,<environment.Job instance at 0x7efda3604190>,23,12,[2 7],24,-1,36,-1,24
1,<environment.Job instance at 0x7efda3604af0>,24,22,[7 3],25,-1,47,-1,25
1,<environment.Job instance at 0x7efda3604320>,25,20,[7 5],26,-1,46,-1,26
1,<environment.Job instance at 0x7efda3156dc0>,31,15,[7 1],32,-1,47,-1,32
1,<environment.Job instance at 0x7efda3156500>,35,12,[4 5],36,-1,48,-1,36
1,<environment.Job instance at 0x7efda3156960>,37,18,[8 2],38,-1,56,-1,38
1,<environment.Job instance at 0x7efda314d1e0>,40,15,[2 5],41,-1,56,-1,41
1,<environment.Job instance at 0x7efda314d7d0>,42,17,[4 5],43,-1,60,-1,43
1,<environment.Job instance at 0x7efda314dfa0>,43,14,[9 3],44,-1,58,-1,44
1,<environment.Job instance at 0x7efda3604410>,18,13,[8 3],19,-1,58,-1,45
1,<environment.Job instance at 0x7efda314d190>,45,17,[8 2],46,-1,63,-1,46
1,<environment.Job instance at 0x7efda314d460>,46,16,[1 9],47,-1,63,-1,47
1,<environment.Job instance at 0x7efda314d690>,47,16,[7 2],48,-1,64,-1,48
1,<environment.Job instance at 0x7efda314d0f0>,6,12,[ 5 12],7,-1,19,-1,7
1,<environment.Job instance at 0x7efda35f2320>,9,2,[ 5 14],10,-1,17,-1,15
1,<environment.Job instance at 0x7efda2586d20>,21,16,[ 1 14],22,-1,65,-1,49
1,<environment.Job instance at 0x7efda23398c0>,34,17,[14  5],35,-1,94,-1,77
1,<environment.Job instance at 0x7efda2441320>,41,2,[14  5],42,-1,95,-1,93
1,<environment.Job instance at 0x7efdac2cf960>,2,16,[10  4],3,-1,20,-1,4
1,<environment.Job instance at 0x7efda2a15190>,3,16,[6 5],4,-1,20,-1,4
1,<environment.Job instance at 0x7efda20bc280>,4,16,[9 5],5,-1,21,-1,5
1,<environment.Job instance at 0x7efda2fce2d0>,7,28,[5 9],8,-1,36,-1,8
1,<environment.Job instance at 0x7efda2fceeb0>,9,18,[5 8],10,-1,28,-1,10
1,<environment.Job instance at 0x7efda2fce140>,10,18,[ 2 10],11,-1,30,-1,12
1,<environment.Job instance at 0x7efda2fce780>,12,13,[1 5],13,-1,26,-1,13
1,<environment.Job instance at 0x7efda239f5f0>,11,15,[8 1],12,-1,28,-1,13
1,<environment.Job instance at 0x7efda2f21b40>,16,18,[ 5 10],17,-1,36,-1,18
1,<environment.Job instance at 0x7efda379ba00>,18,13,[9 1],19,-1,35,-1,22
1,<environment.Job instance at 0x7efdabde41e0>,17,28,[9 1],18,-1,50,-1,22
1,<environment.Job instance at 0x7efda31f6500>,22,26,[5 8],23,-1,49,-1,23
1,<environment.Job instance at 0x7efda2de1dc0>,29,18,[1 7],30,-1,48,-1,30
1,<environment.Job instance at 0x7efda23feeb0>,28,15,[2 8],29,-1,45,-1,30
1,<environment.Job instance at 0x7efda23fee60>,30,14,[7 2],31,-1,47,-1,33
1,<environment.Job instance at 0x7efdabe53c30>,32,17,[8 1],33,-1,50,-1,33
1,<environment.Job instance at 0x7efda2964410>,33,22,[3 5],34,-1,57,-1,35
1,<environment.Job instance at 0x7efda3403c80>,35,18,[4 6],36,-1,54,-1,36
1,<environment.Job instance at 0x7efda29a0a00>,38,2,[12  3],39,-1,42,-1,40
1,<environment.Job instance at 0x7efda3403fa0>,39,18,[3 8],40,-1,58,-1,40
1,<environment.Job instance at 0x7efda29a0550>,40,22,[7 1],41,-1,64,-1,42
1,<environment.Job instance at 0x7efda2bff050>,42,21,[5 7],43,-1,64,-1,43
1,<environment.Job instance at 0x7efda2bff2d0>,45,16,[4 7],46,-1,62,-1,46
1,<environment.Job instance at 0x7efda2bffe60>,46,18,[9 3],47,-1,65,-1,47
1,<environment.Job instance at 0x7efda24413c0>,7,28,[5 9],8,-1,66,-1,38
1,<environment.Job instance at 0x7efda2586550>,17,28,[9 1],18,-1,82,-1,54
1,<environment.Job instance at 0x7efda2586fa0>,22,26,[5 8],23,-1,89,-1,63
1,<environment.Job instance at 0x7efda35f2050>,26,2,[ 5 13],27,-1,74,-1,72
1,<environment.Job instance at 0x7efda314daf0>,31,1,[13  4],32,-1,85,-1,84
1,<environment.Job instance at 0x7efda3156320>,37,28,[ 5 10],38,-1,142,-1,114
1,<environment.Job instance at 0x7efda2bff460>,38,2,[12  3],39,-1,116,-1,114
1,<environment.Job instance at 0x7efda2c572d0>,3,17,[4 7],4,-1,21,-1,4
1,<environment.Job instance at 0x7efda2c570a0>,4,16,[ 5 10],5,-1,21,-1,5
1,<environment.Job instance at 0x7efda25f3f00>,10,26,[3 7],11,-1,37,-1,11
1,<environment.Job instance at 0x7efda25f3d20>,14,16,[1 5],15,-1,31,-1,15
1,<environment.Job instance at 0x7efda25f3870>,15,18,[4 9],16,-1,34,-1,16
1,<environment.Job instance at 0x7efda25f38c0>,17,18,[10  5],18,-1,37,-1,19
1,<environment.Job instance at 0x7efda3071960>,20,13,[10  1],21,-1,34,-1,21
1,<environment.Job instance at 0x7efda3115640>,22,24,[1 9],23,-1,47,-1,23
1,<environment.Job instance at 0x7efda3512910>,23,14,[6 5],24,-1,38,-1,24
1,<environment.Job instance at 0x7efda33dbf50>,24,12,[9 3],25,-1,37,-1,25
1,<environment.Job instance at 0x7efda33bc640>,26,12,[10  1],27,-1,39,-1,27
1,<environment.Job instance at 0x7efda1ea52d0>,30,17,[5 6],31,-1,48,-1,31
1,<environment.Job instance at 0x7efda1ea5eb0>,31,27,[7 1],32,-1,59,-1,32
1,<environment.Job instance at 0x7efda25f3dc0>,18,13,[5 5],19,-1,46,-1,33
1,<environment.Job instance at 0x7efda1f52c30>,35,21,[ 2 10],36,-1,58,-1,37
1,<environment.Job instance at 0x7efda58a7370>,36,15,[10  2],37,-1,54,-1,39
1,<environment.Job instance at 0x7efda2d11410>,40,16,[10  1],41,-1,58,-1,42
1,<environment.Job instance at 0x7efda295e8c0>,10,26,[3 7],11,-1,38,-1,12
1,<environment.Job instance at 0x7efda296f9b0>,11,18,[11  5],12,-1,30,-1,12
1,<environment.Job instance at 0x7efda294b8c0>,19,1,[12  2],20,-1,40,-1,39
1,<environment.Job instance at 0x7efda2536f00>,22,24,[1 9],23,-1,79,-1,55
1,<environment.Job instance at 0x7efda2e3c780>,31,27,[7 1],32,-1,126,-1,99
1,<environment.Job instance at 0x7efda2e3ca00>,33,2,[ 3 13],34,-1,101,-1,99
1,<environment.Job instance at 0x7efda2f7e280>,37,1,[ 3 14],38,-1,103,-1,102
1,<environment.Job instance at 0x7efda2f7efa0>,38,12,[ 2 11],39,-1,114,-1,102
1,<environment.Job instance at 0x7efda2e3c5a0>,32,26,[ 3 10],33,-1,131,-1,105
1,<environment.Job instance at 0x7efda2f7e0f0>,41,17,[11  3],42,-1,122,-1,105
1,<environment.Job instance at 0x7efda2f88820>,42,16,[12  1],43,-1,121,-1,105
1,<environment.Job instance at 0x7efda2f881e0>,43,15,[ 4 13],44,-1,120,-1,105
1,<environment.Job instance at 0x7efda22623c0>,0,17,[10  2],1,-1,19,-1,2
1,<environment.Job instance at 0x7efda2262be0>,2,14,[5 1],3,-1,17,-1,3
1,<environment.Job instance at 0x7efda2262910>,1,13,[10  2],2,-1,16,-1,3
1,<environment.Job instance at 0x7efda2262eb0>,6,14,[8 4],7,-1,22,-1,8
1,<environment.Job instance at 0x7efda2251410>,12,18,[6 2],13,-1,31,-1,13
1,<environment.Job instance at 0x7efda2251d70>,14,18,[6 2],15,-1,33,-1,15
1,<environment.Job instance at 0x7efda2251cd0>,15,19,[6 3],16,-1,35,-1,16
1,<environment.Job instance at 0x7efda2251140>,21,14,[3 6],22,-1,36,-1,22
1,<environment.Job instance at 0x7efda2251550>,22,27,[5 7],23,-1,50,-1,23
1,<environment.Job instance at 0x7efda226daf0>,25,16,[9 2],26,-1,42,-1,26
1,<environment.Job instance at 0x7efda226d640>,26,15,[10  3],27,-1,42,-1,27
1,<environment.Job instance at 0x7efda226d190>,27,15,[9 1],28,-1,43,-1,28
1,<environment.Job instance at 0x7efda2262960>,7,14,[9 2],8,-1,57,-1,43
1,<environment.Job instance at 0x7efda251f320>,4,13,[ 5 12],5,-1,18,-1,5
1,<environment.Job instance at 0x7efda1e93190>,5,2,[ 2 11],6,-1,8,-1,6
1,<environment.Job instance at 0x7efda251f4b0>,3,24,[2 6],4,-1,41,-1,17
1,<environment.Job instance at 0x7efda311e640>,22,27,[5 7],23,-1,76,-1,49
1,<environment.Job instance at 0x7efda37d6cd0>,24,24,[13  2],25,-1,73,-1,49
1,<environment.Job instance at 0x7efda1ea2280>,28,15,[11  4],29,-1,73,-1,58
1,<environment.Job instance at 0x7efda27c4410>,31,14,[ 4 13],32,-1,90,-1,76
1,<environment.Job instance at 0x7efda38131e0>,47,14,[11  4],48,-1,154,-1,140
1,<environment.Job instance at 0x7efda2f66d20>,1,18,[ 3 10],2,-1,21,-1,3
1,<environment.Job instance at 0x7efda2b30eb0>,3,24,[8 5],4,-1,28,-1,4
1,<environment.Job instance at 0x7efda2b30cd0>,4,14,[ 1 10],5,-1,19,-1,5
1,<environment.Job instance at 0x7efda28a63c0>,11,15,[8 1],12,-1,28,-1,13
1,<environment.Job instance at 0x7efda2b1a0a0>,13,15,[ 3 10],14,-1,29,-1,14
1,<environment.Job instance at 0x7efda34478c0>,15,15,[5 6],16,-1,31,-1,16
1,<environment.Job instance at 0x7efda204b640>,17,14,[7 2],18,-1,32,-1,18
1,<environment.Job instance at 0x7efda37ba370>,18,20,[3 9],19,-1,39,-1,19
1,<environment.Job instance at 0x7efda58bf370>,20,16,[5 4],21,-1,37,-1,21
1,<environment.Job instance at 0x7efda58a5280>,21,17,[ 4 10],22,-1,39,-1,22
1,<environment.Job instance at 0x7efdac078230>,24,17,[3 5],25,-1,42,-1,25
1,<environment.Job instance at 0x7efda2f7f550>,26,14,[6 5],27,-1,41,-1,27
1,<environment.Job instance at 0x7efda3726140>,27,21,[4 8],28,-1,49,-1,28
1,<environment.Job instance at 0x7efda3726c80>,28,23,[3 9],29,-1,52,-1,29
1,<environment.Job instance at 0x7efda3442370>,29,13,[10  5],30,-1,43,-1,30
1,<environment.Job instance at 0x7efda33e03c0>,34,18,[6 4],35,-1,53,-1,35
1,<environment.Job instance at 0x7efda33e06e0>,35,15,[4 7],36,-1,51,-1,36
1,<environment.Job instance at 0x7efda28a6230>,0,18,[ 4 11],1,-1,19,-1,1
1,<environment.Job instance at 0x7efda2251a00>,3,24,[8 5],4,-1,39,-1,15
1,<environment.Job instance at 0x7efda2b1a500>,8,13,[12  1],9,-1,28,-1,15
1,<environment.Job instance at 0x7efda1e932d0>,16,3,[14  2],17,-1,40,-1,37
1,<environment.Job instance at 0x7efda33b9cd0>,23,14,[ 5 13],24,-1,77,-1,63
1,<environment.Job instance at 0x7efda25ccfa0>,28,23,[3 9],29,-1,105,-1,82
1,<environment.Job instance at 0x7efda25cc3c0>,40,2,[ 1 11],41,-1,130,-1,128
1,<environment.Job instance at 0x7efda58f5af0>,47,12,[ 3 14],48,-1,166,-1,154
1,<environment.Job instance at 0x7efdac418870>,1,16,[8 4],2,-1,20,-1,4
1,<environment.Job instance at 0x7efda303d550>,3,18,[6 4],4,-1,23,-1,5
1,<environment.Job instance at 0x7efda30471e0>,15,21,[9 5],16,-1,37,-1,16
1,<environment.Job instance at 0x7efda30472d0>,16,18,[10  5],17,-1,35,-1,17
1,<environment.Job instance at 0x7efda3047140>,17,14,[1 9],18,-1,32,-1,18
1,<environment.Job instance at 0x7efda3047820>,21,16,[1 6],22,-1,38,-1,22
1,<environment.Job instance at 0x7efda3047870>,23,27,[3 5],24,-1,51,-1,24
1,<environment.Job instance at 0x7efda3047e60>,27,17,[5 7],28,-1,45,-1,28
1,<environment.Job instance at 0x7efda3047e10>,29,12,[1 9],30,-1,42,-1,30
1,<environment.Job instance at 0x7efda302b0f0>,31,2,[4 5],32,-1,34,-1,32
1,<environment.Job instance at 0x7efda302b370>,32,3,[4 7],33,-1,36,-1,33
1,<environment.Job instance at 0x7efda302b230>,33,12,[9 3],34,-1,46,-1,34
1,<environment.Job instance at 0x7efda302b460>,34,12,[1 5],35,-1,47,-1,35
1,<environment.Job instance at 0x7efda302b500>,35,14,[5 2],36,-1,50,-1,36
1,<environment.Job instance at 0x7efda302b5a0>,36,12,[6 4],37,-1,49,-1,37
1,<environment.Job instance at 0x7efda302b640>,37,17,[2 6],38,-1,55,-1,38
1,<environment.Job instance at 0x7efda302b6e0>,38,17,[5 4],39,-1,56,-1,39
1,<environment.Job instance at 0x7efda302b820>,40,16,[9 4],41,-1,57,-1,41
1,<environment.Job instance at 0x7efda3689a50>,43,13,[5 6],44,-1,57,-1,44
1,<environment.Job instance at 0x7efda3689730>,45,18,[3 9],46,-1,64,-1,46
1,<environment.Job instance at 0x7efda36890f0>,46,27,[10  4],47,-1,74,-1,47
1,<environment.Job instance at 0x7efda303d410>,8,16,[13  3],9,-1,25,-1,9
1,<environment.Job instance at 0x7efda25cceb0>,23,27,[3 5],24,-1,66,-1,39
1,<environment.Job instance at 0x7efda3862780>,24,1,[12  4],25,-1,40,-1,39
1,<environment.Job instance at 0x7efda25cc1e0>,25,2,[14  1],26,-1,41,-1,39
1,<environment.Job instance at 0x7efda3447b90>,46,27,[10  4],47,-1,182,-1,155
1,<environment.Job instance at 0x7efda2457640>,1,18,[4 8],2,-1,20,-1,2
1,<environment.Job instance at 0x7efda244bc30>,6,17,[2 9],7,-1,25,-1,8
1,<environment.Job instance at 0x7efda244bcd0>,9,14,[4 7],10,-1,24,-1,10
1,<environment.Job instance at 0x7efda244b190>,10,16,[10  3],11,-1,28,-1,12
1,<environment.Job instance at 0x7efda244b9b0>,11,17,[10  5],12,-1,30,-1,13
1,<environment.Job instance at 0x7efda244b5f0>,19,18,[5 2],20,-1,38,-1,20
1,<environment.Job instance at 0x7efda244ba50>,16,13,[8 5],17,-1,39,-1,26
1,<environment.Job instance at 0x7efda3690370>,29,14,[7 2],30,-1,45,-1,31
1,<environment.Job instance at 0x7efda3690e10>,24,12,[3 7],25,-1,43,-1,31
1,<environment.Job instance at 0x7efda3690780>,27,16,[2 7],28,-1,48,-1,32
1,<environment.Job instance at 0x7efda3690730>,32,14,[8 5],33,-1,47,-1,33
1,<environment.Job instance at 0x7efda2458730>,35,26,[4 8],36,-1,62,-1,36
1,<environment.Job instance at 0x7efda2458a00>,36,20,[4 8],37,-1,58,-1,38
1,<environment.Job instance at 0x7efda24589b0>,38,16,[8 4],39,-1,58,-1,42
1,<environment.Job instance at 0x7efda2458370>,40,25,[5 4],41,-1,67,-1,42
1,<environment.Job instance at 0x7efda2458500>,41,21,[5 5],42,-1,63,-1,42
1,<environment.Job instance at 0x7efda2458d20>,43,18,[ 2 10],44,-1,62,-1,44
1,<environment.Job instance at 0x7efda3690d20>,30,18,[1 7],31,-1,64,-1,46
1,<environment.Job instance at 0x7efda2458460>,45,25,[5 7],46,-1,71,-1,46
1,<environment.Job instance at 0x7efda2458c80>,47,22,[5 8],48,-1,72,-1,50
1,<environment.Job instance at 0x7efda244beb0>,0,1,[ 5 11],1,-1,2,-1,1
1,<environment.Job instance at 0x7efda244baf0>,2,25,[7 3],3,-1,28,-1,3
1,<environment.Job instance at 0x7efda3690a00>,4,13,[ 3 12],5,-1,18,-1,5
1,<environment.Job instance at 0x7efda246aeb0>,18,14,[13  2],19,-1,58,-1,44
1,<environment.Job instance at 0x7efda2468640>,35,26,[4 8],36,-1,138,-1,112
1,<environment.Job instance at 0x7efda2ff6a00>,40,25,[5 4],41,-1,143,-1,118
1,<environment.Job instance at 0x7efda2ff6d20>,45,25,[5 7],46,-1,157,-1,132
1,<environment.Job instance at 0x7efda3294730>,3,27,[8 5],4,-1,31,-1,4
1,<environment.Job instance at 0x7efdac0780f0>,13,24,[3 5],14,-1,38,-1,14
1,<environment.Job instance at 0x7efdac07b2d0>,15,14,[10  1],16,-1,30,-1,16
1,<environment.Job instance at 0x7efdac078b90>,16,15,[3 6],17,-1,32,-1,17
1,<environment.Job instance at 0x7efdac19d690>,17,17,[2 7],18,-1,35,-1,18
1,<environment.Job instance at 0x7efdac19d190>,18,15,[5 5],19,-1,34,-1,19
1,<environment.Job instance at 0x7efdac19d780>,21,18,[5 9],22,-1,40,-1,22
1,<environment.Job instance at 0x7efda336fb90>,23,18,[3 7],24,-1,42,-1,24
1,<environment.Job instance at 0x7efda336fcd0>,24,27,[1 8],25,-1,52,-1,25
1,<environment.Job instance at 0x7efda336f7d0>,26,15,[5 1],27,-1,42,-1,27
1,<environment.Job instance at 0x7efda336f0f0>,28,12,[1 8],29,-1,41,-1,29
1,<environment.Job instance at 0x7efda336f4b0>,30,18,[2 7],31,-1,49,-1,31
1,<environment.Job instance at 0x7efda336f8c0>,31,15,[6 3],32,-1,48,-1,33
1,<environment.Job instance at 0x7efda336f960>,32,12,[6 2],33,-1,45,-1,33
1,<environment.Job instance at 0x7efda336f230>,34,23,[4 5],35,-1,58,-1,35
1,<environment.Job instance at 0x7efda2f81280>,35,13,[8 4],36,-1,50,-1,37
1,<environment.Job instance at 0x7efda2f81e10>,39,18,[7 4],40,-1,58,-1,40
1,<environment.Job instance at 0x7efda30ca870>,44,18,[3 6],45,-1,63,-1,45
1,<environment.Job instance at 0x7efdac19da50>,3,27,[8 5],4,-1,32,-1,5
1,<environment.Job instance at 0x7efdac19d0f0>,4,12,[ 5 13],5,-1,17,-1,5
1,<environment.Job instance at 0x7efda2f813c0>,9,1,[12  4],10,-1,11,-1,10
1,<environment.Job instance at 0x7efda30ca410>,13,24,[3 5],14,-1,42,-1,18
1,<environment.Job instance at 0x7efda2632410>,24,27,[1 8],25,-1,92,-1,65
1,<environment.Job instance at 0x7efda2b52e10>,34,23,[4 5],35,-1,106,-1,83
1,<environment.Job instance at 0x7efda2b52690>,37,13,[12  5],38,-1,104,-1,91
1,<environment.Job instance at 0x7efda2b527d0>,43,14,[ 4 11],44,-1,131,-1,117
1,<environment.Job instance at 0x7efda2b528c0>,46,26,[8 5],47,-1,154,-1,128
1,<environment.Job instance at 0x7efda2b52dc0>,48,18,[13  1],49,-1,146,-1,128
1,<environment.Job instance at 0x7efda23ff780>,0,17,[5 8],1,-1,18,-1,1
1,<environment.Job instance at 0x7efda22bfc80>,3,20,[5 3],4,-1,24,-1,4
1,<environment.Job instance at 0x7efda22bf9b0>,4,16,[2 7],5,-1,21,-1,5
1,<environment.Job instance at 0x7efda22bf0a0>,6,14,[10  1],7,-1,24,-1,10
1,<environment.Job instance at 0x7efda229c820>,10,18,[5 6],11,-1,29,-1,11
1,<environment.Job instance at 0x7efda229c050>,11,17,[2 9],12,-1,29,-1,12
1,<environment.Job instance at 0x7efda229ce60>,12,2,[5 2],13,-1,15,-1,13
1,<environment.Job instance at 0x7efda229cdc0>,14,12,[10  2],15,-1,27,-1,15
1,<environment.Job instance at 0x7efda229cc80>,15,2,[10  1],16,-1,18,-1,16
1,<environment.Job instance at 0x7efda229cfa0>,16,13,[9 1],17,-1,30,-1,17
1,<environment.Job instance at 0x7efda229c730>,17,22,[10  1],18,-1,40,-1,18
1,<environment.Job instance at 0x7efda229c5f0>,19,14,[5 1],20,-1,34,-1,20
1,<environment.Job instance at 0x7efda229c280>,20,20,[3 8],21,-1,41,-1,21
1,<environment.Job instance at 0x7efda22b5e60>,22,13,[9 2],23,-1,36,-1,23
1,<environment.Job instance at 0x7efda20badc0>,26,26,[9 5],27,-1,53,-1,27
1,<environment.Job instance at 0x7efda2930eb0>,32,13,[ 3 10],33,-1,46,-1,33
1,<environment.Job instance at 0x7efda2b78f00>,33,16,[6 3],34,-1,50,-1,34
1,<environment.Job instance at 0x7efda2b78a00>,34,17,[1 8],35,-1,52,-1,35
1,<environment.Job instance at 0x7efda2927230>,35,13,[4 7],36,-1,49,-1,36
1,<environment.Job instance at 0x7efda2915d20>,39,22,[7 3],40,-1,62,-1,40
1,<environment.Job instance at 0x7efda22bf910>,9,12,[7 5],10,-1,52,-1,40
1,<environment.Job instance at 0x7efda2b52f00>,18,16,[13  1],19,-1,62,-1,46
1,<environment.Job instance at 0x7efda2b52550>,21,3,[11  4],22,-1,59,-1,56
1,<environment.Job instance at 0x7efda2632280>,26,26,[9 5],27,-1,97,-1,71
1,<environment.Job instance at 0x7efda26323c0>,37,1,[ 4 12],38,-1,103,-1,102
1,<environment.Job instance at 0x7efda30ca190>,40,15,[13  3],41,-1,119,-1,104
1,<environment.Job instance at 0x7efda2f813c0>,42,25,[7 5],43,-1,131,-1,106
1,<environment.Job instance at 0x7efda2f816e0>,43,2,[14  5],44,-1,108,-1,106
1,<environment.Job instance at 0x7efda336f730>,44,2,[13  4],45,-1,108,-1,106
1,<environment.Job instance at 0x7efdac19d0f0>,46,12,[12  4],47,-1,118,-1,106
1,<environment.Job instance at 0x7efda20acc30>,0,16,[ 2 10],1,-1,20,-1,4
1,<environment.Job instance at 0x7efda20ac820>,3,15,[4 8],4,-1,19,-1,4
1,<environment.Job instance at 0x7efda20ac3c0>,6,18,[5 8],7,-1,26,-1,8
1,<environment.Job instance at 0x7efda20ac640>,9,17,[ 2 10],10,-1,27,-1,10
1,<environment.Job instance at 0x7efda20ac0f0>,11,18,[8 1],12,-1,30,-1,12
1,<environment.Job instance at 0x7efda20acd70>,12,15,[3 9],13,-1,28,-1,13
1,<environment.Job instance at 0x7efda20ac280>,13,20,[8 4],14,-1,34,-1,14
1,<environment.Job instance at 0x7efda2938190>,17,27,[8 5],18,-1,45,-1,18
1,<environment.Job instance at 0x7efda29383c0>,19,17,[1 5],20,-1,37,-1,20
1,<environment.Job instance at 0x7efda29389b0>,20,13,[3 8],21,-1,34,-1,21
1,<environment.Job instance at 0x7efda2938eb0>,21,15,[2 7],22,-1,37,-1,22
1,<environment.Job instance at 0x7efda2938050>,22,17,[3 5],23,-1,40,-1,23
1,<environment.Job instance at 0x7efda2938a50>,25,13,[10  5],26,-1,39,-1,26
1,<environment.Job instance at 0x7efda2938910>,26,17,[7 3],27,-1,44,-1,27
1,<environment.Job instance at 0x7efda2935b40>,30,13,[1 9],31,-1,44,-1,31
1,<environment.Job instance at 0x7efda2935be0>,31,17,[9 4],32,-1,49,-1,32
1,<environment.Job instance at 0x7efda2935820>,32,24,[4 6],33,-1,57,-1,33
1,<environment.Job instance at 0x7efda2935780>,34,18,[5 2],35,-1,53,-1,35
1,<environment.Job instance at 0x7efda2935af0>,35,14,[10  1],36,-1,50,-1,36
1,<environment.Job instance at 0x7efda29351e0>,36,12,[9 5],37,-1,49,-1,37
1,<environment.Job instance at 0x7efda2935410>,40,16,[5 4],41,-1,57,-1,41
1,<environment.Job instance at 0x7efda2935e60>,41,18,[7 2],42,-1,60,-1,42
1,<environment.Job instance at 0x7efda29350a0>,42,12,[5 2],43,-1,55,-1,43
1,<environment.Job instance at 0x7efda2935eb0>,43,13,[ 3 11],44,-1,57,-1,44
1,<environment.Job instance at 0x7efda2935230>,44,12,[7 2],45,-1,57,-1,45
1,<environment.Job instance at 0x7efda20ac550>,5,15,[ 4 12],6,-1,21,-1,6
1,<environment.Job instance at 0x7efda2632050>,17,27,[8 5],18,-1,86,-1,59
1,<environment.Job instance at 0x7efda2b50640>,29,2,[ 2 12],30,-1,93,-1,91
1,<environment.Job instance at 0x7efda245eb40>,32,24,[4 6],33,-1,131,-1,107
1,<environment.Job instance at 0x7efda245eb90>,33,15,[ 2 13],34,-1,122,-1,107
1,<environment.Job instance at 0x7efda245ed20>,37,18,[14  1],38,-1,126,-1,108
1,<environment.Job instance at 0x7efda245e460>,43,13,[ 3 11],44,-1,151,-1,138
1,<environment.Job instance at 0x7efda2096e60>,46,15,[11  2],47,-1,157,-1,142
1,<environment.Job instance at 0x7efda1f66fa0>,6,13,[8 4],7,-1,21,-1,8
1,<environment.Job instance at 0x7efda1f590a0>,8,16,[6 5],9,-1,25,-1,9
1,<environment.Job instance at 0x7efda30ca410>,7,17,[6 2],8,-1,26,-1,9
1,<environment.Job instance at 0x7efda1f59230>,10,25,[10  4],11,-1,36,-1,11
1,<environment.Job instance at 0x7efda1f596e0>,15,17,[8 5],16,-1,33,-1,16
1,<environment.Job instance at 0x7efda1f59780>,17,1,[5 4],18,-1,19,-1,18
1,<environment.Job instance at 0x7efda1f59a50>,18,3,[3 5],19,-1,22,-1,19
1,<environment.Job instance at 0x7efda1f59960>,19,12,[1 6],20,-1,32,-1,20
1,<environment.Job instance at 0x7efda1f59af0>,20,18,[6 4],21,-1,39,-1,21
1,<environment.Job instance at 0x7efda1f59c30>,22,15,[4 9],23,-1,38,-1,23
1,<environment.Job instance at 0x7efda1f59dc0>,23,18,[8 3],24,-1,42,-1,24
1,<environment.Job instance at 0x7efda1f59eb0>,25,15,[7 1],26,-1,41,-1,26
1,<environment.Job instance at 0x7efda1f7d0f0>,26,16,[7 5],27,-1,43,-1,27
1,<environment.Job instance at 0x7efda1f7d190>,28,13,[7 1],29,-1,43,-1,30
1,<environment.Job instance at 0x7efda1f7d500>,32,18,[8 1],33,-1,51,-1,33
1,<environment.Job instance at 0x7efda1f7d230>,34,14,[5 8],35,-1,49,-1,35
1,<environment.Job instance at 0x7efda1f7d6e0>,36,20,[10  4],37,-1,59,-1,39
1,<environment.Job instance at 0x7efda1f7dcd0>,39,14,[7 5],40,-1,54,-1,40
1,<environment.Job instance at 0x7efda1f7db90>,38,17,[9 2],39,-1,57,-1,40
1,<environment.Job instance at 0x7efda1f59550>,0,12,[ 3 12],1,-1,13,-1,1
1,<environment.Job instance at 0x7efda2096140>,10,25,[10  4],11,-1,60,-1,35
1,<environment.Job instance at 0x7efda229caa0>,27,16,[13  1],28,-1,88,-1,72
1,<environment.Job instance at 0x7efda22b12d0>,31,2,[13  4],32,-1,97,-1,95
1,<environment.Job instance at 0x7efda2632f50>,40,27,[ 3 13],41,-1,155,-1,128
1,<environment.Job instance at 0x7efda2632b40>,43,27,[1 7],44,-1,166,-1,139
1,<environment.Job instance at 0x7efda20acd20>,45,18,[ 3 12],46,-1,161,-1,143
1,<environment.Job instance at 0x7f6fc9c6a0a0>,2,14,[ 2 10],3,-1,18,-1,4
1,<environment.Job instance at 0x7f6fd3251aa0>,3,22,[2 5],4,-1,26,-1,4
1,<environment.Job instance at 0x7f6fc9c6a500>,7,14,[7 5],8,-1,22,-1,8
1,<environment.Job instance at 0x7f6fc9c6a5f0>,8,17,[1 8],9,-1,26,-1,9
1,<environment.Job instance at 0x7f6fc9c6a6e0>,10,22,[8 1],11,-1,33,-1,11
1,<environment.Job instance at 0x7f6fc9c6a4b0>,12,23,[6 4],13,-1,36,-1,13
1,<environment.Job instance at 0x7f6fc9c6a9b0>,13,18,[5 9],14,-1,32,-1,14
1,<environment.Job instance at 0x7f6fc9c6a780>,14,21,[8 1],15,-1,36,-1,15
1,<environment.Job instance at 0x7f6fc9c6ab40>,16,18,[7 3],17,-1,35,-1,17
1,<environment.Job instance at 0x7f6fc9c6ab90>,18,26,[7 4],19,-1,45,-1,19
1,<environment.Job instance at 0x7f6fc9c6ae10>,19,25,[5 9],20,-1,45,-1,20
1,<environment.Job instance at 0x7f6fc9c6af00>,21,18,[9 4],22,-1,40,-1,22
1,<environment.Job instance at 0x7f6fc9c6d050>,23,16,[6 2],24,-1,40,-1,24
1,<environment.Job instance at 0x7f6fc9c6d500>,26,12,[8 5],27,-1,39,-1,27
1,<environment.Job instance at 0x7f6fc9c6d640>,27,17,[4 6],28,-1,45,-1,28
1,<environment.Job instance at 0x7f6fc9c6d780>,30,26,[9 4],31,-1,61,-1,35
1,<environment.Job instance at 0x7f6fc9c6da00>,35,16,[1 9],36,-1,52,-1,36
1,<environment.Job instance at 0x7f6fc9c6d960>,32,21,[5 9],33,-1,62,-1,41
1,<environment.Job instance at 0x7f6fc9c6de60>,37,14,[5 8],38,-1,55,-1,41
1,<environment.Job instance at 0x7f6fc9c6de10>,39,14,[9 4],40,-1,56,-1,42
1,<environment.Job instance at 0x7f6fc9c6f280>,43,12,[4 5],44,-1,58,-1,46
1,<environment.Job instance at 0x7f6fc9c6f460>,45,15,[7 5],46,-1,62,-1,47
1,<environment.Job instance at 0x7f6fc9c6f780>,47,13,[ 3 10],48,-1,62,-1,49
1,<environment.Job instance at 0x7f6fc9c6f960>,49,17,[10  2],50,-1,68,-1,51
1,<environment.Job instance at 0x7f6fc9c6feb0>,54,18,[7 1],55,-1,75,-1,57
1,<environment.Job instance at 0x7f6fc9c71460>,57,16,[ 2 11],58,-1,75,-1,59
1,<environment.Job instance at 0x7f6fc9c64fa0>,12,23,[6 4],13,-1,53,-1,30
1,<environment.Job instance at 0x7f6fc9c71d70>,18,26,[7 4],19,-1,70,-1,44
1,<environment.Job instance at 0x7f6fc9c71c30>,19,25,[5 9],20,-1,83,-1,58
1,<environment.Job instance at 0x7f6fc9c74320>,28,17,[ 1 13],29,-1,87,-1,70
1,<environment.Job instance at 0x7f6fc9c745a0>,30,26,[9 4],31,-1,110,-1,84
1,<environment.Job instance at 0x7f6fc9c745f0>,31,1,[ 2 14],32,-1,85,-1,84
1,<environment.Job instance at 0x7f6fc9c74690>,33,26,[3 6],34,-1,110,-1,84
1,<environment.Job instance at 0x7f6fc9c74cd0>,40,26,[ 1 10],41,-1,139,-1,113
1,<environment.Job instance at 0x7f6fc9c5a500>,57,16,[ 2 11],58,-1,183,-1,167
1,<environment.Job instance at 0x7f6fc93ada50>,7,16,[1 9],8,-1,24,-1,8
1,<environment.Job instance at 0x7f6fc93ad550>,9,14,[9 4],10,-1,24,-1,10
1,<environment.Job instance at 0x7f6fc93aa1e0>,12,18,[3 5],13,-1,31,-1,13
1,<environment.Job instance at 0x7f6fc93aaf00>,17,16,[8 1],18,-1,35,-1,19
1,<environment.Job instance at 0x7f6fc93a2a00>,19,19,[10  3],20,-1,39,-1,20
1,<environment.Job instance at 0x7f6fc93a2fa0>,22,21,[4 8],23,-1,44,-1,23
1,<environment.Job instance at 0x7f6fc93a2960>,23,18,[ 3 10],24,-1,42,-1,24
1,<environment.Job instance at 0x7f6fc93a7e10>,25,15,[1 7],26,-1,41,-1,26
1,<environment.Job instance at 0x7f6fc965e280>,27,18,[7 1],28,-1,46,-1,28
1,<environment.Job instance at 0x7f6fc93a7230>,28,16,[4 9],29,-1,45,-1,29
1,<environment.Job instance at 0x7f6fc948beb0>,31,18,[5 4],32,-1,50,-1,32
1,<environment.Job instance at 0x7f6fc948b910>,32,12,[5 5],33,-1,45,-1,33
1,<environment.Job instance at 0x7f6fc948ba50>,33,25,[ 1 10],34,-1,59,-1,34
1,<environment.Job instance at 0x7f6fc921a4b0>,36,18,[2 6],37,-1,55,-1,37
1,<environment.Job instance at 0x7f6fc927a0f0>,41,15,[2 7],42,-1,57,-1,42
1,<environment.Job instance at 0x7f6fc921aa50>,42,13,[9 4],43,-1,56,-1,43
1,<environment.Job instance at 0x7f6fc9351b90>,43,16,[1 9],44,-1,60,-1,44
1,<environment.Job instance at 0x7f6fc9b4d910>,45,16,[7 5],46,-1,62,-1,46
1,<environment.Job instance at 0x7f6fc92e9320>,47,18,[5 5],48,-1,66,-1,48
1,<environment.Job instance at 0x7f6fc9404b40>,29,17,[ 5 14],30,-1,86,-1,69
1,<environment.Job instance at 0x7f6fc95190a0>,33,25,[ 1 10],34,-1,113,-1,88
1,<environment.Job instance at 0x7f6fc9420aa0>,49,27,[3 9],50,-1,168,-1,141
1,<environment.Job instance at 0x7f6fc94234b0>,50,23,[5 1],51,-1,164,-1,141
1,<environment.Job instance at 0x7f6fc9429870>,57,3,[ 3 13],58,-1,159,-1,156
1,<environment.Job instance at 0x7f6fd33cf280>,10,17,[9 5],11,-1,28,-1,11
1,<environment.Job instance at 0x7f6fd33c43c0>,12,18,[10  4],13,-1,31,-1,13
1,<environment.Job instance at 0x7f6fd33c4320>,15,15,[8 3],16,-1,31,-1,16
1,<environment.Job instance at 0x7f6fd33cdcd0>,21,14,[ 3 10],22,-1,36,-1,22
1,<environment.Job instance at 0x7f6fc927a8c0>,26,13,[10  5],27,-1,43,-1,30
1,<environment.Job instance at 0x7f6fc927af00>,31,22,[5 6],32,-1,54,-1,32
1,<environment.Job instance at 0x7f6fc927a4b0>,35,17,[10  4],36,-1,53,-1,36
1,<environment.Job instance at 0x7f6fc927aa50>,36,12,[1 6],37,-1,49,-1,37
1,<environment.Job instance at 0x7f6fc93ab410>,37,21,[10  4],38,-1,59,-1,38
1,<environment.Job instance at 0x7f6fc93ab2d0>,40,24,[1 5],41,-1,65,-1,41
1,<environment.Job instance at 0x7f6fc93ab280>,42,20,[10  5],43,-1,63,-1,43
1,<environment.Job instance at 0x7f6fc93ab190>,44,14,[10  5],45,-1,59,-1,45
1,<environment.Job instance at 0x7f6fd33cf460>,0,19,[ 5 12],1,-1,20,-1,1
1,<environment.Job instance at 0x7f6fd33bffa0>,17,28,[ 2 10],18,-1,65,-1,37
1,<environment.Job instance at 0x7f6fd33c21e0>,22,15,[ 2 13],23,-1,55,-1,40
1,<environment.Job instance at 0x7f6fc920d0f0>,24,20,[13  4],25,-1,61,-1,41
1,<environment.Job instance at 0x7f6fc920dcd0>,33,1,[12  5],34,-1,73,-1,72
1,<environment.Job instance at 0x7f6fc920dc30>,40,24,[1 5],41,-1,114,-1,90
1,<environment.Job instance at 0x7f6fd327c4b0>,46,13,[ 5 14],47,-1,122,-1,109
1,<environment.Job instance at 0x7f6fc927ff50>,53,24,[3 7],54,-1,151,-1,127
1,<environment.Job instance at 0x7f6fc99f9b90>,0,17,[3 5],1,-1,18,-1,1
1,<environment.Job instance at 0x7f6fc99f9fa0>,6,17,[9 1],7,-1,25,-1,8
1,<environment.Job instance at 0x7f6fd33cd640>,14,26,[3 9],15,-1,41,-1,15
1,<environment.Job instance at 0x7f6fd33cda50>,15,15,[5 3],16,-1,31,-1,16
1,<environment.Job instance at 0x7f6fd327d960>,18,21,[2 7],19,-1,40,-1,19
1,<environment.Job instance at 0x7f6fd327db90>,20,23,[4 7],21,-1,44,-1,21
1,<environment.Job instance at 0x7f6fc99f9280>,12,15,[ 2 14],13,-1,37,-1,22
1,<environment.Job instance at 0x7f6fc99f9e10>,10,17,[9 5],11,-1,42,-1,25
1,<environment.Job instance at 0x7f6fd327daf0>,23,14,[5 9],24,-1,39,-1,25
1,<environment.Job instance at 0x7f6fd327d6e0>,25,19,[ 1 10],26,-1,45,-1,26
1,<environment.Job instance at 0x7f6fc9352050>,26,16,[6 5],27,-1,43,-1,27
1,<environment.Job instance at 0x7f6fc93522d0>,28,20,[ 2 10],29,-1,50,-1,30
1,<environment.Job instance at 0x7f6fc9352be0>,31,17,[3 6],32,-1,49,-1,32
1,<environment.Job instance at 0x7f6fc9352d20>,34,16,[5 6],35,-1,51,-1,35
1,<environment.Job instance at 0x7f6fc9352b40>,35,21,[1 6],36,-1,57,-1,36
1,<environment.Job instance at 0x7f6fc9352aa0>,36,16,[1 8],37,-1,53,-1,37
1,<environment.Job instance at 0x7f6fc91fa1e0>,38,23,[1 9],39,-1,62,-1,39
1,<environment.Job instance at 0x7f6fc91faaf0>,39,17,[8 5],40,-1,57,-1,40
1,<environment.Job instance at 0x7f6fc91fab40>,42,15,[8 2],43,-1,58,-1,43
1,<environment.Job instance at 0x7f6fc91fa050>,43,18,[5 1],44,-1,62,-1,44
1,<environment.Job instance at 0x7f6fc91faaa0>,44,15,[8 5],45,-1,60,-1,45
1,<environment.Job instance at 0x7f6fc91fa4b0>,48,19,[4 7],49,-1,68,-1,49
1,<environment.Job instance at 0x7f6fc91fa0f0>,49,13,[4 5],50,-1,63,-1,50
1,<environment.Job instance at 0x7f6fc91fa230>,8,27,[ 3 12],9,-1,36,-1,9
1,<environment.Job instance at 0x7f6fc93ae140>,12,15,[ 2 14],13,-1,37,-1,22
1,<environment.Job instance at 0x7f6fc93add20>,14,26,[3 9],15,-1,60,-1,34
1,<environment.Job instance at 0x7f6fc920de60>,20,23,[4 7],21,-1,65,-1,42
1,<environment.Job instance at 0x7f6fd33ce640>,30,1,[14  4],31,-1,68,-1,67
1,<environment.Job instance at 0x7f6fc97ef7d0>,37,18,[ 1 14],38,-1,108,-1,90
1,<environment.Job instance at 0x7f6fc97efdc0>,38,23,[1 9],39,-1,113,-1,90
1,<environment.Job instance at 0x7f6fc925ef50>,45,17,[12  1],46,-1,123,-1,106
1,<environment.Job instance at 0x7f6fc97f1dc0>,50,16,[14  3],51,-1,144,-1,128
1,<environment.Job instance at 0x7f6fc91f9190>,57,2,[ 1 12],58,-1,145,-1,143
1,<environment.Job instance at 0x7f6fc9a5d7d0>,3,13,[9 2],4,-1,18,-1,5
1,<environment.Job instance at 0x7f6fc9a47c80>,5,27,[6 1],6,-1,33,-1,6
1,<environment.Job instance at 0x7f6fc9a712d0>,7,14,[10  3],8,-1,22,-1,8
1,<environment.Job instance at 0x7f6fc9a71eb0>,10,13,[3 5],11,-1,24,-1,11
1,<environment.Job instance at 0x7f6fc9a71730>,11,16,[5 8],12,-1,28,-1,12
1,<environment.Job instance at 0x7f6fc9a71af0>,12,23,[1 8],13,-1,36,-1,13
1,<environment.Job instance at 0x7f6fc9a77230>,17,14,[10  5],18,-1,32,-1,18
1,<environment.Job instance at 0x7f6fc9a76190>,21,17,[10  2],22,-1,39,-1,22
1,<environment.Job instance at 0x7f6fc9a76d70>,23,26,[5 3],24,-1,50,-1,24
1,<environment.Job instance at 0x7f6fc93711e0>,25,18,[ 1 10],26,-1,44,-1,26
1,<environment.Job instance at 0x7f6fc9371e10>,26,15,[6 5],27,-1,42,-1,27
1,<environment.Job instance at 0x7f6fc9341410>,28,17,[1 5],29,-1,46,-1,29
1,<environment.Job instance at 0x7f6fc95b9d20>,29,18,[5 2],30,-1,48,-1,30
1,<environment.Job instance at 0x7f6fc96b7730>,30,18,[5 8],31,-1,49,-1,31
1,<environment.Job instance at 0x7f6fc95db0a0>,32,18,[3 8],33,-1,51,-1,33
1,<environment.Job instance at 0x7f6fc9681230>,33,13,[8 3],34,-1,47,-1,34
1,<environment.Job instance at 0x7f6fc9690cd0>,36,17,[8 4],37,-1,54,-1,37
1,<environment.Job instance at 0x7f6fc95c3c30>,37,15,[3 6],38,-1,53,-1,38
1,<environment.Job instance at 0x7f6fc95c3140>,38,20,[5 2],39,-1,59,-1,39
1,<environment.Job instance at 0x7f6fc95c35f0>,39,26,[2 8],40,-1,66,-1,40
1,<environment.Job instance at 0x7f6fc95d4780>,40,15,[5 8],41,-1,56,-1,41
1,<environment.Job instance at 0x7f6fc9340aa0>,41,20,[ 4 10],42,-1,62,-1,42
1,<environment.Job instance at 0x7f6fc994d2d0>,42,15,[9 2],43,-1,58,-1,43
1,<environment.Job instance at 0x7f6fc994d9b0>,44,16,[7 5],45,-1,61,-1,45
1,<environment.Job instance at 0x7f6fc95da320>,47,27,[9 5],48,-1,75,-1,48
1,<environment.Job instance at 0x7f6fc9686640>,48,13,[8 4],49,-1,62,-1,49
1,<environment.Job instance at 0x7f6fc9a76e60>,5,27,[6 1],6,-1,41,-1,14
1,<environment.Job instance at 0x7f6fca0be960>,12,23,[1 8],13,-1,51,-1,28
1,<environment.Job instance at 0x7f6fc925e6e0>,23,26,[5 3],24,-1,75,-1,49
1,<environment.Job instance at 0x7f6fc920d5a0>,39,26,[2 8],40,-1,139,-1,113
1,<environment.Job instance at 0x7f6fc920de10>,47,27,[9 5],48,-1,174,-1,147
1,<environment.Job instance at 0x7f6fc920d410>,49,14,[12  2],50,-1,161,-1,147
1,<environment.Job instance at 0x7f6fca0b2e60>,3,17,[7 4],4,-1,22,-1,5
1,<environment.Job instance at 0x7f6fca0b2190>,4,17,[13  5],5,-1,22,-1,5
1,<environment.Job instance at 0x7f6fca0aae60>,13,16,[4 5],14,-1,31,-1,15
1,<environment.Job instance at 0x7f6fca0aa3c0>,15,16,[7 5],16,-1,32,-1,16
1,<environment.Job instance at 0x7f6fca0aa0a0>,20,16,[8 3],21,-1,37,-1,21
1,<environment.Job instance at 0x7f6fc93760f0>,23,16,[ 4 10],24,-1,40,-1,24
1,<environment.Job instance at 0x7f6fc9376820>,25,27,[4 5],26,-1,53,-1,26
1,<environment.Job instance at 0x7f6fc9376140>,32,20,[4 9],33,-1,69,-1,49
1,<environment.Job instance at 0x7f6fca0aa640>,1,17,[ 5 14],2,-1,19,-1,2
1,<environment.Job instance at 0x7f6fca0aa140>,2,25,[ 3 11],3,-1,28,-1,3
1,<environment.Job instance at 0x7f6fc9376d70>,4,17,[13  5],5,-1,22,-1,5
1,<environment.Job instance at 0x7f6fc9376370>,5,13,[ 5 14],6,-1,19,-1,6
1,<environment.Job instance at 0x7f6fc9341870>,25,27,[4 5],26,-1,86,-1,59
1,<environment.Job instance at 0x7f6fc9a76be0>,27,12,[13  4],28,-1,71,-1,59
1,<environment.Job instance at 0x7f6fc9a42dc0>,28,12,[ 5 12],29,-1,71,-1,59
1,<environment.Job instance at 0x7f6fc96ba0f0>,47,13,[12  1],48,-1,120,-1,107
1,<environment.Job instance at 0x7f6fc96ba410>,48,12,[14  3],49,-1,119,-1,107
1,<environment.Job instance at 0x7f6fc96baf00>,49,1,[ 4 11],50,-1,108,-1,107
1,<environment.Job instance at 0x7f6fc96ba190>,56,25,[2 8],57,-1,153,-1,128
1,<environment.Job instance at 0x7f6fc96f10f0>,0,26,[8 3],1,-1,27,-1,1
1,<environment.Job instance at 0x7f6fc96b4730>,5,13,[9 1],6,-1,20,-1,7
1,<environment.Job instance at 0x7f6fc93ad460>,6,18,[8 3],7,-1,25,-1,7
1,<environment.Job instance at 0x7f6fc96b4b90>,11,18,[5 8],12,-1,30,-1,12
1,<environment.Job instance at 0x7f6fc96b4c80>,12,14,[2 8],13,-1,27,-1,13
1,<environment.Job instance at 0x7f6fc96b4eb0>,15,15,[1 5],16,-1,31,-1,16
1,<environment.Job instance at 0x7f6fc967e050>,17,13,[ 5 10],18,-1,31,-1,18
1,<environment.Job instance at 0x7f6fc967e190>,19,18,[5 2],20,-1,38,-1,20
1,<environment.Job instance at 0x7f6fc967e280>,20,16,[ 4 10],21,-1,37,-1,21
1,<environment.Job instance at 0x7f6fc967e320>,21,15,[5 7],22,-1,37,-1,22
1,<environment.Job instance at 0x7f6fc967e500>,22,17,[8 2],23,-1,40,-1,23
1,<environment.Job instance at 0x7f6fc967e640>,24,17,[6 1],25,-1,42,-1,25
1,<environment.Job instance at 0x7f6fc967ebe0>,29,18,[10  4],30,-1,48,-1,30
1,<environment.Job instance at 0x7f6fc967e960>,31,13,[1 7],32,-1,45,-1,32
1,<environment.Job instance at 0x7f6fc967eb90>,33,14,[5 6],34,-1,48,-1,34
1,<environment.Job instance at 0x7f6fc96a67d0>,34,18,[10  5],35,-1,53,-1,35
1,<environment.Job instance at 0x7f6fc96a6af0>,36,16,[2 9],37,-1,53,-1,37
1,<environment.Job instance at 0x7f6fc96a6fa0>,38,15,[10  4],39,-1,56,-1,41
1,<environment.Job instance at 0x7f6fc96a6f50>,41,16,[4 5],42,-1,58,-1,42
1,<environment.Job instance at 0x7f6fc96a6b90>,42,27,[8 3],43,-1,70,-1,43
1,<environment.Job instance at 0x7f6fc96a6730>,40,16,[8 5],41,-1,59,-1,43
1,<environment.Job instance at 0x7f6fc96a6230>,43,18,[1 6],44,-1,62,-1,44
1,<environment.Job instance at 0x7f6fc96a6a00>,44,17,[2 6],45,-1,63,-1,46
1,<environment.Job instance at 0x7f6fc96a6410>,46,27,[2 6],47,-1,74,-1,47
1,<environment.Job instance at 0x7f6fc96a68c0>,50,14,[ 4 14],51,-1,67,-1,53
1,<environment.Job instance at 0x7f6fc9925320>,54,12,[8 1],55,-1,68,-1,56
1,<environment.Job instance at 0x7f6fc967e690>,0,26,[8 3],1,-1,27,-1,1
1,<environment.Job instance at 0x7f6fc96ba820>,14,2,[11  3],15,-1,25,-1,23
1,<environment.Job instance at 0x7f6fc96abd70>,25,17,[12  4],26,-1,86,-1,69
1,<environment.Job instance at 0x7f6fc9371730>,37,2,[ 3 11],38,-1,120,-1,118
1,<environment.Job instance at 0x7f6fc925e1e0>,42,27,[8 3],43,-1,177,-1,150
1,<environment.Job instance at 0x7f6fc925e370>,46,27,[2 6],47,-1,194,-1,167
1,<environment.Job instance at 0x7f6fc967b1e0>,50,14,[ 4 14],51,-1,197,-1,183
1,<environment.Job instance at 0x7f6fca19abe0>,0,12,[10  5],1,-1,15,-1,3
1,<environment.Job instance at 0x7f6fca19afa0>,3,1,[7 1],4,-1,5,-1,4
1,<environment.Job instance at 0x7f6fca19aaf0>,2,16,[6 4],3,-1,20,-1,4
1,<environment.Job instance at 0x7f6fca19a460>,6,21,[ 4 10],7,-1,28,-1,7
1,<environment.Job instance at 0x7f6fca19ad20>,7,23,[2 8],8,-1,31,-1,8
1,<environment.Job instance at 0x7f6fca301500>,15,17,[ 5 10],16,-1,33,-1,16
1,<environment.Job instance at 0x7f6fca301a50>,16,14,[9 4],17,-1,31,-1,17
1,<environment.Job instance at 0x7f6fca301aa0>,18,14,[8 2],19,-1,34,-1,20
1,<environment.Job instance at 0x7f6fca301410>,20,25,[6 4],21,-1,46,-1,21
1,<environment.Job instance at 0x7f6fca301e60>,23,13,[ 4 10],24,-1,37,-1,24
1,<environment.Job instance at 0x7f6fca3015f0>,24,24,[5 5],25,-1,49,-1,25
1,<environment.Job instance at 0x7f6fca301190>,26,14,[2 5],27,-1,41,-1,27
1,<environment.Job instance at 0x7f6fca301050>,28,28,[ 5 10],29,-1,57,-1,29
1,<environment.Job instance at 0x7f6fca1aa730>,29,15,[9 5],30,-1,45,-1,30
1,<environment.Job instance at 0x7f6fca1aa8c0>,31,17,[7 5],32,-1,49,-1,32
1,<environment.Job instance at 0x7f6fca44e690>,35,14,[3 8],36,-1,50,-1,36
1,<environment.Job instance at 0x7f6fca44ec30>,36,12,[ 5 12],37,-1,49,-1,37
1,<environment.Job instance at 0x7f6fca44e280>,37,13,[3 7],38,-1,51,-1,38
1,<environment.Job instance at 0x7f6fca44e550>,38,15,[2 9],39,-1,54,-1,39
1,<environment.Job instance at 0x7f6fca44e320>,43,15,[6 4],44,-1,59,-1,44
1,<environment.Job instance at 0x7f6fca44eaf0>,45,13,[6 3],46,-1,59,-1,46
1,<environment.Job instance at 0x7f6fca44e3c0>,46,12,[10  2],47,-1,59,-1,47
1,<environment.Job instance at 0x7f6fca44e6e0>,47,12,[6 2],48,-1,60,-1,48
1,<environment.Job instance at 0x7f6fca44ee10>,48,13,[8 3],49,-1,62,-1,49
1,<environment.Job instance at 0x7f6fca19a500>,19,17,[12  4],20,-1,68,-1,51
1,<environment.Job instance at 0x7f6fc95fe8c0>,54,22,[7 3],55,-1,78,-1,56
1,<environment.Job instance at 0x7f6fca44e870>,7,23,[2 8],8,-1,36,-1,13
1,<environment.Job instance at 0x7f6fca19a140>,8,3,[11  1],9,-1,16,-1,13
1,<environment.Job instance at 0x7f6fca19a7d0>,9,19,[13  3],10,-1,32,-1,13
1,<environment.Job instance at 0x7f6fc96a6190>,14,13,[ 4 11],15,-1,32,-1,19
1,<environment.Job instance at 0x7f6fc967eb40>,19,17,[12  4],20,-1,47,-1,30
1,<environment.Job instance at 0x7f6fc9a9be60>,20,25,[6 4],21,-1,58,-1,33
1,<environment.Job instance at 0x7f6fc95fe690>,22,3,[14  5],23,-1,36,-1,33
1,<environment.Job instance at 0x7f6fc95fe500>,24,24,[5 5],25,-1,67,-1,43
1,<environment.Job instance at 0x7f6fc95fee60>,28,28,[ 5 10],29,-1,87,-1,59
1,<environment.Job instance at 0x7f6fd33c78c0>,36,12,[ 5 12],37,-1,89,-1,77
1,<environment.Job instance at 0x7f6fd33c70f0>,39,2,[ 5 14],40,-1,92,-1,90
1,<environment.Job instance at 0x7f6fc93886e0>,51,16,[ 1 14],52,-1,151,-1,135
1,<environment.Job instance at 0x7f6fc8fac4b0>,7,18,[8 2],8,-1,29,-1,11
1,<environment.Job instance at 0x7f6fc90b1c30>,12,17,[4 5],13,-1,30,-1,13
1,<environment.Job instance at 0x7f6fc90b1460>,13,14,[9 3],14,-1,28,-1,14
1,<environment.Job instance at 0x7f6fc90b1f00>,15,17,[8 2],16,-1,33,-1,16
1,<environment.Job instance at 0x7f6fc90b1a50>,16,16,[1 9],17,-1,33,-1,17
1,<environment.Job instance at 0x7f6fc90b10f0>,22,16,[10  4],23,-1,39,-1,23
1,<environment.Job instance at 0x7f6fc90b19b0>,23,16,[6 5],24,-1,40,-1,24
1,<environment.Job instance at 0x7f6fc90b1690>,24,16,[9 5],25,-1,41,-1,25
1,<environment.Job instance at 0x7f6fc90b1e10>,26,22,[1 8],27,-1,49,-1,27
1,<environment.Job instance at 0x7f6fc90b7550>,27,28,[5 9],28,-1,56,-1,28
1,<environment.Job instance at 0x7f6fc90b7500>,29,18,[5 8],30,-1,48,-1,30
1,<environment.Job instance at 0x7f6fc90b7960>,30,18,[ 2 10],31,-1,49,-1,31
1,<environment.Job instance at 0x7f6fc90b7a00>,31,15,[8 1],32,-1,50,-1,35
1,<environment.Job instance at 0x7f6fc90b7f50>,36,18,[ 5 10],37,-1,55,-1,37
1,<environment.Job instance at 0x7f6fc90b7640>,37,28,[9 1],38,-1,66,-1,38
1,<environment.Job instance at 0x7f6fc90b7e10>,38,13,[9 1],39,-1,52,-1,39
1,<environment.Job instance at 0x7f6fc90b7690>,41,14,[9 2],42,-1,56,-1,42
1,<environment.Job instance at 0x7f6fc90b7780>,42,26,[5 8],43,-1,69,-1,43
1,<environment.Job instance at 0x7f6fc9097c80>,49,18,[1 7],50,-1,68,-1,50
1,<environment.Job instance at 0x7f6fc9097230>,52,17,[8 1],53,-1,70,-1,53
1,<environment.Job instance at 0x7f6fc90976e0>,53,22,[3 5],54,-1,76,-1,54
1,<environment.Job instance at 0x7f6fc9097320>,54,12,[3 9],55,-1,70,-1,58
1,<environment.Job instance at 0x7f6fca186190>,57,28,[ 5 10],58,-1,86,-1,58
1,<environment.Job instance at 0x7f6fc90b7be0>,4,17,[14  5],5,-1,22,-1,5
1,<environment.Job instance at 0x7f6fc93de820>,11,2,[14  5],12,-1,21,-1,19
1,<environment.Job instance at 0x7f6fc93b95f0>,27,28,[5 9],28,-1,100,-1,72
1,<environment.Job instance at 0x7f6fc94d7f50>,37,28,[9 1],38,-1,145,-1,117
1,<environment.Job instance at 0x7f6fc94d4780>,42,26,[5 8],43,-1,173,-1,147
1,<environment.Job instance at 0x7f6fc93cda50>,46,2,[ 5 13],47,-1,149,-1,147
1,<environment.Job instance at 0x7f6fc94cb6e0>,51,1,[13  4],52,-1,163,-1,162
1,<environment.Job instance at 0x7f6fc94da5f0>,58,2,[12  3],59,-1,180,-1,178
1,<environment.Job instance at 0x7f6fd313e2d0>,57,28,[ 5 10],58,-1,249,-1,221
1,<environment.Job instance at 0x7f6fd2d93c80>,0,22,[7 1],1,-1,24,-1,2
1,<environment.Job instance at 0x7f6fd2d93e60>,2,21,[5 7],3,-1,24,-1,3
1,<environment.Job instance at 0x7f6fd2d93a00>,5,16,[4 7],6,-1,22,-1,6
1,<environment.Job instance at 0x7f6fd2d93690>,6,18,[9 3],7,-1,25,-1,7
1,<environment.Job instance at 0x7f6fd2d93cd0>,8,16,[1 7],9,-1,25,-1,9
1,<environment.Job instance at 0x7f6fd2d930f0>,9,18,[8 2],10,-1,28,-1,10
1,<environment.Job instance at 0x7f6fc9c55820>,13,17,[4 7],14,-1,31,-1,14
1,<environment.Job instance at 0x7f6fc9c55f00>,14,16,[ 5 10],15,-1,31,-1,15
1,<environment.Job instance at 0x7f6fc9c550a0>,15,15,[5 9],16,-1,31,-1,16
1,<environment.Job instance at 0x7f6fc9c555a0>,20,26,[3 7],21,-1,47,-1,21
1,<environment.Job instance at 0x7f6fc97a37d0>,21,18,[11  5],22,-1,40,-1,22
1,<environment.Job instance at 0x7f6fc97a3be0>,23,12,[8 2],24,-1,36,-1,24
1,<environment.Job instance at 0x7f6fc97a3460>,24,16,[1 5],25,-1,41,-1,25
1,<environment.Job instance at 0x7f6fc97a3230>,25,18,[4 9],26,-1,44,-1,26
1,<environment.Job instance at 0x7f6fc97a3190>,27,18,[10  5],28,-1,46,-1,28
1,<environment.Job instance at 0x7f6fc97a35f0>,28,13,[5 5],29,-1,42,-1,29
1,<environment.Job instance at 0x7f6fc97a31e0>,30,13,[10  1],31,-1,44,-1,31
1,<environment.Job instance at 0x7f6fc97a32d0>,32,24,[1 9],33,-1,57,-1,33
1,<environment.Job instance at 0x7f6fc97a3870>,33,14,[6 5],34,-1,48,-1,34
1,<environment.Job instance at 0x7f6fc97a34b0>,34,12,[9 3],35,-1,47,-1,35
1,<environment.Job instance at 0x7f6fc9b87320>,40,17,[5 6],41,-1,58,-1,41
1,<environment.Job instance at 0x7f6fc9b87f50>,45,21,[ 2 10],46,-1,68,-1,47
1,<environment.Job instance at 0x7f6fc9b874b0>,46,15,[10  2],47,-1,62,-1,47
1,<environment.Job instance at 0x7f6fc9b877d0>,50,16,[10  1],51,-1,69,-1,53
1,<environment.Job instance at 0x7f6fc93cd780>,20,26,[3 7],21,-1,89,-1,63
1,<environment.Job instance at 0x7f6fc93cdfa0>,21,18,[11  5],22,-1,81,-1,63
1,<environment.Job instance at 0x7f6fc94eaf50>,29,1,[12  2],30,-1,88,-1,87
1,<environment.Job instance at 0x7f6fc93e1c80>,32,24,[1 9],33,-1,127,-1,103
1,<environment.Job instance at 0x7f6fc93b9b40>,41,27,[7 1],42,-1,160,-1,133
1,<environment.Job instance at 0x7f6fc93e05f0>,43,2,[ 3 13],44,-1,135,-1,133
1,<environment.Job instance at 0x7f6fc93e0c30>,42,26,[ 3 10],43,-1,170,-1,144
1,<environment.Job instance at 0x7f6fc93c2730>,47,1,[ 3 14],48,-1,145,-1,144
1,<environment.Job instance at 0x7f6fc93de780>,48,12,[ 2 11],49,-1,156,-1,144
1,<environment.Job instance at 0x7f6fc93de690>,51,17,[11  3],52,-1,162,-1,145
1,<environment.Job instance at 0x7f6fc93dec30>,52,16,[12  1],53,-1,161,-1,145
1,<environment.Job instance at 0x7f6fc90b7c80>,53,15,[ 4 13],54,-1,160,-1,145
1,<environment.Job instance at 0x7f6fca2d0b90>,0,17,[10  2],1,-1,19,-1,2
1,<environment.Job instance at 0x7f6fc94da550>,1,13,[10  2],2,-1,15,-1,2
1,<environment.Job instance at 0x7f6fc9b34280>,10,14,[5 8],11,-1,25,-1,11
1,<environment.Job instance at 0x7f6fc9b34050>,12,18,[6 2],13,-1,31,-1,13
1,<environment.Job instance at 0x7f6fc9d93f00>,14,18,[6 2],15,-1,33,-1,15
1,<environment.Job instance at 0x7f6fc9d93d70>,15,19,[6 3],16,-1,35,-1,16
1,<environment.Job instance at 0x7f6fc9d932d0>,21,14,[3 6],22,-1,36,-1,22
1,<environment.Job instance at 0x7f6fc9d93b90>,22,27,[5 7],23,-1,50,-1,23
1,<environment.Job instance at 0x7f6fc9d93820>,25,16,[9 2],26,-1,43,-1,27
1,<environment.Job instance at 0x7f6fc9294730>,26,15,[10  3],27,-1,42,-1,27
1,<environment.Job instance at 0x7f6fc92945f0>,27,15,[9 1],28,-1,44,-1,29
1,<environment.Job instance at 0x7f6fc9294e10>,28,15,[11  4],29,-1,44,-1,29
1,<environment.Job instance at 0x7f6fc9294cd0>,29,17,[5 2],30,-1,48,-1,31
1,<environment.Job instance at 0x7f6fc9d88820>,39,17,[6 2],40,-1,57,-1,40
1,<environment.Job instance at 0x7f6fc9d88c30>,40,17,[5 2],41,-1,64,-1,47
1,<environment.Job instance at 0x7f6fc9d885a0>,47,14,[11  4],48,-1,63,-1,49
1,<environment.Job instance at 0x7f6fc9d88460>,49,16,[7 4],50,-1,70,-1,54
1,<environment.Job instance at 0x7f6fc9d93960>,4,13,[ 5 12],5,-1,18,-1,5
1,<environment.Job instance at 0x7f6fc9294be0>,5,2,[ 2 11],6,-1,8,-1,6
1,<environment.Job instance at 0x7f6fc92948c0>,3,24,[2 6],4,-1,41,-1,17
1,<environment.Job instance at 0x7f6fc93e0c80>,22,27,[5 7],23,-1,76,-1,49
1,<environment.Job instance at 0x7f6fc93e0730>,24,24,[13  2],25,-1,73,-1,49
1,<environment.Job instance at 0x7f6fc93b97d0>,28,15,[11  4],29,-1,73,-1,58
1,<environment.Job instance at 0x7f6fc93b9f50>,31,14,[ 4 13],32,-1,90,-1,76
1,<environment.Job instance at 0x7f6fc94cb820>,47,14,[11  4],48,-1,154,-1,140
1,<environment.Job instance at 0x7f6fc94d15a0>,50,18,[ 4 11],51,-1,170,-1,152
1,<environment.Job instance at 0x7f6fc9b87f00>,53,24,[8 5],54,-1,198,-1,174
1,<environment.Job instance at 0x7f6fc9c55960>,58,13,[12  1],59,-1,201,-1,188
1,<environment.Job instance at 0x7f6fc8f9e500>,1,15,[8 1],2,-1,18,-1,3
1,<environment.Job instance at 0x7f6fc8f9e2d0>,3,15,[ 3 10],4,-1,19,-1,4
1,<environment.Job instance at 0x7f6fc96f1eb0>,4,2,[2 7],5,-1,7,-1,5
1,<environment.Job instance at 0x7f6fc96f1d20>,5,15,[5 6],6,-1,21,-1,6
1,<environment.Job instance at 0x7f6fc96f1a00>,6,3,[14  2],7,-1,10,-1,7
1,<environment.Job instance at 0x7f6fc96f1780>,7,14,[7 2],8,-1,22,-1,8
1,<environment.Job instance at 0x7f6fc96f16e0>,8,20,[3 9],9,-1,29,-1,9
1,<environment.Job instance at 0x7f6fc96f1cd0>,9,1,[5 5],10,-1,11,-1,10
1,<environment.Job instance at 0x7f6fc96f1870>,10,16,[5 4],11,-1,27,-1,11
1,<environment.Job instance at 0x7f6fc96f1730>,11,17,[ 4 10],12,-1,29,-1,12
1,<environment.Job instance at 0x7f6fc8f9e320>,2,16,[5 4],3,-1,28,-1,12
1,<environment.Job instance at 0x7f6fc96f1820>,17,21,[4 8],18,-1,39,-1,18
1,<environment.Job instance at 0x7f6fc96f10f0>,18,23,[3 9],19,-1,42,-1,19
1,<environment.Job instance at 0x7f6fc96f1d70>,19,13,[10  5],20,-1,35,-1,22
1,<environment.Job instance at 0x7f6fc96f1af0>,22,14,[2 6],23,-1,37,-1,23
1,<environment.Job instance at 0x7f6fc96f1140>,24,18,[6 4],25,-1,43,-1,25
1,<environment.Job instance at 0x7f6fc90c2730>,25,15,[4 7],26,-1,41,-1,26
1,<environment.Job instance at 0x7f6fc90c2b90>,27,17,[8 4],28,-1,45,-1,28
1,<environment.Job instance at 0x7f6fc90c20a0>,28,16,[1 7],29,-1,45,-1,29
1,<environment.Job instance at 0x7f6fc90c2d20>,29,15,[ 2 10],30,-1,45,-1,30
1,<environment.Job instance at 0x7f6fca29a460>,41,16,[8 4],42,-1,58,-1,42
1,<environment.Job instance at 0x7f6fca29ac30>,43,18,[6 4],44,-1,62,-1,44
1,<environment.Job instance at 0x7f6fca20bf00>,52,12,[4 7],53,-1,65,-1,53
1,<environment.Job instance at 0x7f6fca20b960>,53,15,[6 2],54,-1,69,-1,54
1,<environment.Job instance at 0x7f6fca20baf0>,55,21,[9 5],56,-1,77,-1,56
1,<environment.Job instance at 0x7f6fc9899f00>,56,18,[10  5],57,-1,76,-1,58
1,<environment.Job instance at 0x7f6fc98994b0>,58,12,[7 5],59,-1,71,-1,59
1,<environment.Job instance at 0x7f6fca29ac80>,6,3,[14  2],7,-1,10,-1,7
1,<environment.Job instance at 0x7f6fc98991e0>,13,14,[ 5 13],14,-1,32,-1,18
1,<environment.Job instance at 0x7f6fc9899870>,18,23,[3 9],19,-1,60,-1,37
1,<environment.Job instance at 0x7f6fc94171e0>,30,2,[ 1 11],31,-1,87,-1,85
1,<environment.Job instance at 0x7f6fc906a9b0>,37,12,[ 3 14],38,-1,118,-1,106
1,<environment.Job instance at 0x7f6fc906a410>,48,16,[13  3],49,-1,144,-1,128
1,<environment.Job instance at 0x7f6fc9c60eb0>,1,16,[1 6],2,-1,18,-1,2
1,<environment.Job instance at 0x7f6fc9c605f0>,3,27,[3 5],4,-1,31,-1,4
1,<environment.Job instance at 0x7f6fc9c60870>,7,17,[5 7],8,-1,25,-1,8
1,<environment.Job instance at 0x7f6fc9c60820>,9,12,[1 9],10,-1,22,-1,10
1,<environment.Job instance at 0x7f6fc949bd20>,13,12,[9 3],14,-1,26,-1,14
1,<environment.Job instance at 0x7f6fc949bf50>,15,14,[5 2],16,-1,30,-1,16
1,<environment.Job instance at 0x7f6fc949bc30>,16,12,[6 4],17,-1,29,-1,17
1,<environment.Job instance at 0x7f6fc949b690>,17,17,[2 6],18,-1,35,-1,18
1,<environment.Job instance at 0x7f6fc949b410>,18,17,[5 4],19,-1,36,-1,19
1,<environment.Job instance at 0x7f6fc949b550>,20,16,[9 4],21,-1,37,-1,21
1,<environment.Job instance at 0x7f6fca0eb690>,24,1,[4 7],25,-1,26,-1,25
1,<environment.Job instance at 0x7f6fca0eba00>,25,18,[3 9],26,-1,44,-1,26
1,<environment.Job instance at 0x7f6fca0eb230>,26,27,[10  4],27,-1,54,-1,27
1,<environment.Job instance at 0x7f6fca0ebf50>,28,14,[4 5],29,-1,43,-1,29
1,<environment.Job instance at 0x7f6fca0ebd20>,29,14,[9 4],30,-1,44,-1,30
1,<environment.Job instance at 0x7f6fca0ebbe0>,31,18,[4 8],32,-1,50,-1,32
1,<environment.Job instance at 0x7f6fca0eb780>,32,25,[7 3],33,-1,58,-1,33
1,<environment.Job instance at 0x7f6fca0eb820>,36,17,[2 9],37,-1,55,-1,38
1,<environment.Job instance at 0x7f6fca0ebf00>,39,14,[4 7],40,-1,55,-1,41
1,<environment.Job instance at 0x7f6fc96cc690>,41,17,[10  5],42,-1,67,-1,50
1,<environment.Job instance at 0x7f6fca0eb280>,37,13,[4 7],38,-1,63,-1,50
1,<environment.Job instance at 0x7f6fc96cc050>,46,13,[8 5],47,-1,63,-1,50
1,<environment.Job instance at 0x7f6fc96cc1e0>,48,14,[13  2],49,-1,64,-1,50
1,<environment.Job instance at 0x7f6fca0eb500>,40,16,[10  3],41,-1,68,-1,52
1,<environment.Job instance at 0x7f6fc96cc640>,49,18,[5 2],50,-1,71,-1,53
1,<environment.Job instance at 0x7f6fc96ccfa0>,54,12,[3 7],55,-1,67,-1,55
1,<environment.Job instance at 0x7f6fc96ccb90>,53,3,[4 8],54,-1,59,-1,56
1,<environment.Job instance at 0x7f6fc96cc780>,55,12,[3 7],56,-1,68,-1,56
1,<environment.Job instance at 0x7f6fc96cc6e0>,57,16,[2 7],58,-1,74,-1,58
1,<environment.Job instance at 0x7f6fc96f1e10>,4,1,[12  4],5,-1,6,-1,5
1,<environment.Job instance at 0x7f6fc9c60640>,5,2,[14  1],6,-1,8,-1,6
1,<environment.Job instance at 0x7f6fc96ccc30>,3,27,[3 5],4,-1,40,-1,13
1,<environment.Job instance at 0x7f6fc96ec460>,26,27,[10  4],27,-1,98,-1,71
1,<environment.Job instance at 0x7f6fc96ecf50>,30,1,[ 5 11],31,-1,73,-1,72
1,<environment.Job instance at 0x7f6fc96ec9b0>,32,25,[7 3],33,-1,127,-1,102
1,<environment.Job instance at 0x7f6fc94b5d70>,34,13,[ 3 12],35,-1,115,-1,102
1,<environment.Job instance at 0x7f6fc9f54230>,48,14,[13  2],49,-1,177,-1,163
1,<environment.Job instance at 0x7f6fca428190>,0,18,[1 7],1,-1,19,-1,1
1,<environment.Job instance at 0x7f6fc9c00aa0>,5,26,[4 8],6,-1,32,-1,6
1,<environment.Job instance at 0x7f6fd314b550>,6,20,[4 8],7,-1,27,-1,7
1,<environment.Job instance at 0x7f6fd314b460>,8,16,[8 4],9,-1,25,-1,9
1,<environment.Job instance at 0x7f6fd314b0a0>,10,25,[5 4],11,-1,36,-1,11
1,<environment.Job instance at 0x7f6fc9f03190>,11,21,[5 5],12,-1,33,-1,12
1,<environment.Job instance at 0x7f6fc9f03550>,13,18,[ 2 10],14,-1,33,-1,15
1,<environment.Job instance at 0x7f6fc9f035a0>,15,25,[5 7],16,-1,41,-1,16
1,<environment.Job instance at 0x7f6fc9f03780>,16,12,[5 9],17,-1,29,-1,17
1,<environment.Job instance at 0x7f6fc9c00eb0>,14,13,[7 3],15,-1,30,-1,17
1,<environment.Job instance at 0x7f6fc9f03c80>,17,22,[5 8],18,-1,40,-1,18
1,<environment.Job instance at 0x7f6fc9f030a0>,23,27,[8 5],24,-1,51,-1,24
1,<environment.Job instance at 0x7f6fca387550>,33,24,[3 5],34,-1,58,-1,34
1,<environment.Job instance at 0x7f6fca387460>,34,14,[4 6],35,-1,49,-1,35
1,<environment.Job instance at 0x7f6fca387190>,35,14,[10  1],36,-1,51,-1,37
1,<environment.Job instance at 0x7f6fca387af0>,37,17,[2 7],38,-1,55,-1,38
1,<environment.Job instance at 0x7f6fca387a00>,38,15,[5 5],39,-1,54,-1,39
1,<environment.Job instance at 0x7f6fca387640>,36,15,[3 6],37,-1,54,-1,39
1,<environment.Job instance at 0x7f6fca387b40>,41,18,[5 9],42,-1,60,-1,42
1,<environment.Job instance at 0x7f6fca3871e0>,43,18,[3 7],44,-1,62,-1,44
1,<environment.Job instance at 0x7f6fca0e9be0>,50,18,[2 7],51,-1,70,-1,52
1,<environment.Job instance at 0x7f6fca0e9140>,53,13,[5 2],54,-1,68,-1,55
1,<environment.Job instance at 0x7f6fca0e9aa0>,55,13,[8 4],56,-1,69,-1,56
1,<environment.Job instance at 0x7f6fca0e9550>,51,15,[6 3],52,-1,72,-1,57
1,<environment.Job instance at 0x7f6fca0e93c0>,57,13,[12  5],58,-1,71,-1,58
1,<environment.Job instance at 0x7f6fc9df4b40>,5,26,[4 8],6,-1,42,-1,16
1,<environment.Job instance at 0x7f6fca0e9f50>,10,25,[5 4],11,-1,42,-1,17
1,<environment.Job instance at 0x7f6fca4280f0>,15,25,[5 7],16,-1,45,-1,20
1,<environment.Job instance at 0x7f6fc923d230>,19,3,[11  3],20,-1,35,-1,32
1,<environment.Job instance at 0x7f6fc923d780>,23,27,[8 5],24,-1,64,-1,37
1,<environment.Job instance at 0x7f6fc923d820>,24,12,[ 5 13],25,-1,49,-1,37
1,<environment.Job instance at 0x7f6fc923d0f0>,29,1,[12  4],30,-1,49,-1,48
1,<environment.Job instance at 0x7f6fca39d410>,33,24,[3 5],34,-1,77,-1,53
1,<environment.Job instance at 0x7f6fc94ac910>,44,27,[1 8],45,-1,140,-1,113
1,<environment.Job instance at 0x7f6fc926bd70>,54,23,[4 5],55,-1,170,-1,147
1,<environment.Job instance at 0x7f6fc926beb0>,57,13,[12  5],58,-1,160,-1,147
1,<environment.Job instance at 0x7f6fca10b500>,10,17,[5 8],11,-1,31,-1,14
1,<environment.Job instance at 0x7f6fd2dbd230>,14,16,[2 7],15,-1,31,-1,15
1,<environment.Job instance at 0x7f6fd2dbd280>,15,17,[6 3],16,-1,33,-1,16
1,<environment.Job instance at 0x7f6fca3b7230>,13,20,[5 3],14,-1,36,-1,16
1,<environment.Job instance at 0x7f6fca3b7be0>,16,14,[10  1],17,-1,34,-1,20
1,<environment.Job instance at 0x7f6fca242e60>,19,12,[7 5],20,-1,32,-1,20
1,<environment.Job instance at 0x7f6fca56e5f0>,20,18,[5 6],21,-1,40,-1,22
1,<environment.Job instance at 0x7f6fc95d5cd0>,21,17,[2 9],22,-1,39,-1,22
1,<environment.Job instance at 0x7f6fc95d55a0>,27,22,[10  1],28,-1,50,-1,28
1,<environment.Job instance at 0x7f6fc95d57d0>,28,16,[13  1],29,-1,45,-1,29
1,<environment.Job instance at 0x7f6fd2d930f0>,3,14,[ 4 11],4,-1,18,-1,4
1,<environment.Job instance at 0x7f6fc9d3b230>,6,26,[8 5],7,-1,34,-1,8
1,<environment.Job instance at 0x7f6fd2d932d0>,8,18,[13  1],9,-1,27,-1,9
1,<environment.Job instance at 0x7f6fc938fd70>,28,16,[13  1],29,-1,82,-1,66
1,<environment.Job instance at 0x7f6fc938f0a0>,31,3,[11  4],32,-1,72,-1,69
1,<environment.Job instance at 0x7f6fca24d2d0>,36,26,[9 5],37,-1,121,-1,95
1,<environment.Job instance at 0x7f6fc9cc2b90>,47,1,[ 4 12],48,-1,115,-1,114
1,<environment.Job instance at 0x7f6fc9cbaf00>,50,15,[13  3],51,-1,131,-1,116
1,<environment.Job instance at 0x7f6fc99a8af0>,52,25,[7 5],53,-1,150,-1,125
1,<environment.Job instance at 0x7f6fc99a8be0>,53,2,[14  5],54,-1,127,-1,125
1,<environment.Job instance at 0x7f6fc99a8a50>,54,2,[13  4],55,-1,127,-1,125
1,<environment.Job instance at 0x7f6fc9214a50>,56,12,[12  4],57,-1,137,-1,125
1,<environment.Job instance at 0x7f6fc92131e0>,0,16,[ 2 10],1,-1,20,-1,4
1,<environment.Job instance at 0x7f6fc9213370>,5,15,[ 4 12],6,-1,21,-1,6
1,<environment.Job instance at 0x7f6fc9213e60>,6,18,[5 8],7,-1,25,-1,7
1,<environment.Job instance at 0x7f6fc9213b90>,7,13,[5 8],8,-1,21,-1,8
1,<environment.Job instance at 0x7f6fc9213640>,8,13,[5 5],9,-1,22,-1,9
1,<environment.Job instance at 0x7f6fc937ecd0>,9,17,[ 2 10],10,-1,27,-1,10
1,<environment.Job instance at 0x7f6fc937e230>,10,14,[6 3],11,-1,25,-1,11
1,<environment.Job instance at 0x7f6fc937e7d0>,11,18,[8 1],12,-1,30,-1,12
1,<environment.Job instance at 0x7f6fc937ed70>,12,15,[3 9],13,-1,28,-1,13
1,<environment.Job instance at 0x7f6fc937e690>,13,20,[8 4],14,-1,34,-1,14
1,<environment.Job instance at 0x7f6fc9213140>,3,15,[4 8],4,-1,31,-1,16
1,<environment.Job instance at 0x7f6fc937eb40>,17,27,[8 5],18,-1,45,-1,18
1,<environment.Job instance at 0x7f6fc937e5a0>,21,15,[2 7],22,-1,37,-1,22
1,<environment.Job instance at 0x7f6fc937eeb0>,22,17,[3 5],23,-1,40,-1,23
1,<environment.Job instance at 0x7f6fc922a9b0>,25,13,[10  5],26,-1,40,-1,27
1,<environment.Job instance at 0x7f6fc922a7d0>,27,3,[10  5],28,-1,31,-1,28
1,<environment.Job instance at 0x7f6fc922acd0>,28,13,[8 3],29,-1,42,-1,29
1,<environment.Job instance at 0x7f6fc922a8c0>,26,17,[7 3],27,-1,46,-1,29
1,<environment.Job instance at 0x7f6fc922ab40>,31,17,[9 4],32,-1,50,-1,33
1,<environment.Job instance at 0x7f6fc922af50>,32,24,[4 6],33,-1,57,-1,33
1,<environment.Job instance at 0x7f6fc922a190>,35,14,[10  1],36,-1,51,-1,37
1,<environment.Job instance at 0x7f6fca228280>,40,16,[5 4],41,-1,57,-1,41
1,<environment.Job instance at 0x7f6fca2280f0>,41,18,[7 2],42,-1,60,-1,42
1,<environment.Job instance at 0x7f6fca228c80>,46,15,[11  2],47,-1,68,-1,53
1,<environment.Job instance at 0x7f6fc9fd6370>,52,19,[2 5],53,-1,73,-1,54
1,<environment.Job instance at 0x7f6fc9fd6690>,51,15,[5 5],52,-1,69,-1,54
1,<environment.Job instance at 0x7f6fc99a89b0>,5,15,[ 4 12],6,-1,21,-1,6
1,<environment.Job instance at 0x7f6fc9d06f50>,17,27,[8 5],18,-1,86,-1,59
1,<environment.Job instance at 0x7f6fc922a4b0>,29,2,[ 2 12],30,-1,93,-1,91
1,<environment.Job instance at 0x7f6fc938f320>,32,24,[4 6],33,-1,131,-1,107
1,<environment.Job instance at 0x7f6fc935f870>,33,15,[ 2 13],34,-1,122,-1,107
1,<environment.Job instance at 0x7f6fca238870>,37,18,[14  1],38,-1,126,-1,108
1,<environment.Job instance at 0x7f6fc93b68c0>,43,13,[ 3 11],44,-1,151,-1,138
1,<environment.Job instance at 0x7f6fc93b6dc0>,46,15,[11  2],47,-1,157,-1,142
1,<environment.Job instance at 0x7f6fc93b6730>,50,12,[ 3 12],51,-1,171,-1,159
1,<environment.Job instance at 0x7f6fca649780>,5,17,[8 5],6,-1,24,-1,7
1,<environment.Job instance at 0x7f6fca649c30>,10,18,[6 4],11,-1,29,-1,11
1,<environment.Job instance at 0x7f6fca649be0>,12,15,[4 9],13,-1,28,-1,13
1,<environment.Job instance at 0x7f6fca649eb0>,13,18,[8 3],14,-1,32,-1,14
1,<environment.Job instance at 0x7f6fca634190>,16,16,[7 5],17,-1,33,-1,17
1,<environment.Job instance at 0x7f6fca634730>,22,18,[8 1],23,-1,41,-1,23
1,<environment.Job instance at 0x7f6fca634690>,24,14,[5 8],25,-1,41,-1,27
1,<environment.Job instance at 0x7f6fca634be0>,28,17,[9 2],29,-1,46,-1,29
1,<environment.Job instance at 0x7f6fca6498c0>,6,14,[5 7],7,-1,44,-1,30
1,<environment.Job instance at 0x7f6fca634e60>,30,27,[ 3 13],31,-1,58,-1,31
1,<environment.Job instance at 0x7f6fca634dc0>,29,14,[7 5],30,-1,47,-1,33
1,<environment.Job instance at 0x7f6fca634e10>,32,18,[5 3],33,-1,51,-1,33
1,<environment.Job instance at 0x7f6fca63c0a0>,34,18,[6 3],35,-1,54,-1,36
1,<environment.Job instance at 0x7f6fca63c4b0>,39,15,[4 7],40,-1,55,-1,40
1,<environment.Job instance at 0x7f6fca63c140>,35,18,[ 3 12],36,-1,64,-1,46
1,<environment.Job instance at 0x7f6fca634b40>,26,20,[10  4],27,-1,66,-1,46
1,<environment.Job instance at 0x7f6fca63c690>,42,17,[5 9],43,-1,63,-1,46
1,<environment.Job instance at 0x7f6fca63c910>,43,18,[5 5],44,-1,68,-1,50
1,<environment.Job instance at 0x7f6fca63c190>,33,27,[1 7],34,-1,77,-1,50
1,<environment.Job instance at 0x7f6fca63c9b0>,45,17,[6 4],46,-1,67,-1,50
1,<environment.Job instance at 0x7f6fca63ce10>,48,18,[ 3 10],49,-1,68,-1,50
1,<environment.Job instance at 0x7f6fca63cd70>,47,18,[5 5],48,-1,68,-1,50
1,<environment.Job instance at 0x7f6fca63cf50>,50,27,[5 4],51,-1,78,-1,51
1,<environment.Job instance at 0x7f6fca63ccd0>,46,17,[1 6],47,-1,71,-1,54
1,<environment.Job instance at 0x7f6fca647190>,53,28,[8 2],54,-1,82,-1,54
1,<environment.Job instance at 0x7f6fca63ceb0>,49,13,[8 4],50,-1,67,-1,54
1,<environment.Job instance at 0x7f6fca647370>,54,16,[2 5],55,-1,71,-1,55
1,<environment.Job instance at 0x7f6fca647140>,55,13,[ 5 10],56,-1,69,-1,56
1,<environment.Job instance at 0x7f6fca6475f0>,58,17,[5 3],59,-1,76,-1,59
1,<environment.Job instance at 0x7f6fca634370>,0,25,[10  4],1,-1,26,-1,1
1,<environment.Job instance at 0x7f6fc93b6c80>,17,16,[13  1],18,-1,41,-1,25
1,<environment.Job instance at 0x7f6fc93b6050>,21,2,[13  4],22,-1,55,-1,53
1,<environment.Job instance at 0x7f6fc9d305f0>,30,27,[ 3 13],31,-1,103,-1,76
1,<environment.Job instance at 0x7f6fc938fd70>,33,27,[1 7],34,-1,117,-1,90
1,<environment.Job instance at 0x7f6fc922aa50>,35,18,[ 3 12],36,-1,118,-1,100
1,<environment.Job instance at 0x7f6fc9213f00>,40,1,[12  1],41,-1,125,-1,124
1,<environment.Job instance at 0x7f6fc9d06f50>,41,25,[9 1],42,-1,152,-1,127
1,<environment.Job instance at 0x7f6fc9cc29b0>,50,27,[5 4],51,-1,205,-1,178
1,<environment.Job instance at 0x7f6fc9cc2aa0>,51,28,[7 5],52,-1,206,-1,178
1,<environment.Job instance at 0x7f6fc9cbaf00>,53,28,[8 2],54,-1,217,-1,189
1,<environment.Job instance at 0x7f6fca0d3dc0>,4,12,[9 3],5,-1,17,-1,5
1,<environment.Job instance at 0x7f6fca0d36e0>,7,18,[2 6],8,-1,26,-1,8
1,<environment.Job instance at 0x7f6fca0d3730>,8,15,[3 9],9,-1,24,-1,9
1,<environment.Job instance at 0x7f6fca0d3050>,9,12,[10  4],10,-1,23,-1,11
1,<environment.Job instance at 0x7f6fca212a00>,11,1,[ 5 14],12,-1,13,-1,12
1,<environment.Job instance at 0x7f6fca212fa0>,12,1,[7 1],13,-1,14,-1,13
1,<environment.Job instance at 0x7f6fc93b60f0>,10,13,[7 1],11,-1,26,-1,13
1,<environment.Job instance at 0x7f6fca0d3820>,13,19,[7 1],14,-1,33,-1,14
1,<environment.Job instance at 0x7f6fca212f00>,14,15,[10  1],15,-1,31,-1,16
1,<environment.Job instance at 0x7f6fca2126e0>,15,18,[7 4],16,-1,35,-1,17
1,<environment.Job instance at 0x7f6fca212870>,18,18,[ 2 10],19,-1,38,-1,20
1,<environment.Job instance at 0x7f6fca2120a0>,20,17,[ 5 13],21,-1,38,-1,21
1,<environment.Job instance at 0x7f6fca212c30>,22,14,[4 6],23,-1,37,-1,23
1,<environment.Job instance at 0x7f6fca2123c0>,23,27,[5 1],24,-1,51,-1,24
1,<environment.Job instance at 0x7f6fca212c80>,24,15,[5 5],25,-1,40,-1,25
1,<environment.Job instance at 0x7f6fc96031e0>,25,14,[5 9],26,-1,40,-1,26
1,<environment.Job instance at 0x7f6fca2128c0>,19,13,[5 8],20,-1,41,-1,28
1,<environment.Job instance at 0x7f6fc9df8190>,33,18,[6 4],34,-1,52,-1,34
1,<environment.Job instance at 0x7f6fc9df8280>,34,18,[9 1],35,-1,53,-1,35
1,<environment.Job instance at 0x7f6fc90339b0>,38,16,[1 7],39,-1,55,-1,39
1,<environment.Job instance at 0x7f6fc94b3960>,40,18,[2 9],41,-1,59,-1,41
1,<environment.Job instance at 0x7f6fc94b3c30>,43,18,[5 3],44,-1,62,-1,44
1,<environment.Job instance at 0x7f6fc94b3690>,47,26,[3 7],48,-1,74,-1,48
1,<environment.Job instance at 0x7f6fc9a52c30>,50,13,[1 6],51,-1,64,-1,51
1,<environment.Job instance at 0x7f6fca0d3190>,11,1,[ 5 14],12,-1,20,-1,19
1,<environment.Job instance at 0x7f6fc9fea780>,20,17,[ 5 13],21,-1,62,-1,45
1,<environment.Job instance at 0x7f6fc9b4fd70>,23,27,[5 1],24,-1,88,-1,61
1,<environment.Job instance at 0x7f6fca413550>,26,2,[ 5 12],27,-1,75,-1,73
1,<environment.Job instance at 0x7f6fca238960>,35,17,[14  4],36,-1,116,-1,99
1,<environment.Job instance at 0x7f6fc93b61e0>,41,12,[13  5],42,-1,138,-1,126
1,<environment.Job instance at 0x7f6fc93b6960>,47,26,[3 7],48,-1,184,-1,158
1,<environment.Job instance at 0x7f6fca63c550>,57,1,[ 2 11],58,-1,177,-1,176
1,<environment.Job instance at 0x7f6fc9e9afa0>,0,17,[7 1],1,-1,19,-1,2
1,<environment.Job instance at 0x7f6fc9e9aeb0>,1,17,[7 4],2,-1,19,-1,2
1,<environment.Job instance at 0x7f6fc91a88c0>,5,18,[8 2],6,-1,26,-1,8
1,<environment.Job instance at 0x7f6fc8e865f0>,8,1,[3 8],9,-1,10,-1,9
1,<environment.Job instance at 0x7f6fc9df6a50>,9,1,[10  3],10,-1,11,-1,10
1,<environment.Job instance at 0x7f6fc96710f0>,7,28,[4 9],8,-1,39,-1,11
1,<environment.Job instance at 0x7f6fc944a370>,16,15,[10  2],17,-1,36,-1,21
1,<environment.Job instance at 0x7f6fc93760a0>,28,16,[10  1],29,-1,45,-1,29
1,<environment.Job instance at 0x7f6fc94586e0>,29,18,[8 2],30,-1,48,-1,30
1,<environment.Job instance at 0x7f6fca40d410>,30,18,[2 8],31,-1,49,-1,31
1,<environment.Job instance at 0x7f6fc937ef50>,34,15,[7 2],35,-1,50,-1,35
1,<environment.Job instance at 0x7f6fc937e500>,35,18,[9 1],36,-1,54,-1,36
1,<environment.Job instance at 0x7f6fca3fd5a0>,37,12,[9 1],38,-1,50,-1,38
1,<environment.Job instance at 0x7f6fca3fdfa0>,40,15,[5 8],41,-1,56,-1,41
1,<environment.Job instance at 0x7f6fc963ea00>,42,12,[5 5],43,-1,55,-1,43
1,<environment.Job instance at 0x7f6fca7fb3c0>,44,21,[8 1],45,-1,66,-1,45
1,<environment.Job instance at 0x7f6fc9cb54b0>,49,25,[ 3 10],50,-1,75,-1,50
1,<environment.Job instance at 0x7f6fc8f99c80>,50,18,[ 2 11],51,-1,69,-1,51
1,<environment.Job instance at 0x7f6fca27b910>,55,15,[9 4],56,-1,71,-1,56
1,<environment.Job instance at 0x7f6fc9f11780>,56,15,[4 7],57,-1,72,-1,57
1,<environment.Job instance at 0x7f6fc98cc910>,57,23,[9 2],58,-1,81,-1,58
1,<environment.Job instance at 0x7f6fca3fddc0>,7,28,[4 9],8,-1,46,-1,18
1,<environment.Job instance at 0x7f6fca40d780>,11,18,[13  5],12,-1,37,-1,19
1,<environment.Job instance at 0x7f6fc91abb40>,15,14,[11  2],16,-1,49,-1,35
1,<environment.Job instance at 0x7f6fc9cba0a0>,18,1,[14  2],19,-1,38,-1,37
1,<environment.Job instance at 0x7f6fc9cba0f0>,19,1,[ 1 11],20,-1,38,-1,37
1,<environment.Job instance at 0x7f6fc8e846e0>,50,18,[ 2 11],51,-1,151,-1,133
1,<environment.Job instance at 0x7f6fc9626e10>,49,25,[ 3 10],50,-1,172,-1,147
1,<environment.Job instance at 0x7f6fca404cd0>,57,23,[9 2],58,-1,189,-1,166
1,<environment.Job instance at 0x7f6fc9ded8c0>,3,17,[7 4],4,-1,22,-1,5
1,<environment.Job instance at 0x7f6fc9ded690>,5,15,[9 1],6,-1,24,-1,9
1,<environment.Job instance at 0x7f6fc9e0d280>,8,16,[6 5],9,-1,25,-1,9
1,<environment.Job instance at 0x7f6fca73f550>,11,14,[1 5],12,-1,26,-1,12
1,<environment.Job instance at 0x7f6fca73fcd0>,12,18,[ 2 10],13,-1,32,-1,14
1,<environment.Job instance at 0x7f6fc9e0dcd0>,13,14,[4 9],14,-1,28,-1,14
1,<environment.Job instance at 0x7f6fc920d5a0>,21,18,[5 5],22,-1,40,-1,22
1,<environment.Job instance at 0x7f6fca5d5410>,22,14,[5 7],23,-1,38,-1,24
1,<environment.Job instance at 0x7f6fca5d5320>,24,16,[4 7],25,-1,41,-1,25
1,<environment.Job instance at 0x7f6fd32f99b0>,23,24,[4 7],24,-1,51,-1,27
1,<environment.Job instance at 0x7f6fc9daed20>,32,14,[4 9],33,-1,50,-1,36
1,<environment.Job instance at 0x7f6fc9224870>,37,18,[3 9],38,-1,56,-1,38
1,<environment.Job instance at 0x7f6fca5fe140>,42,15,[ 1 10],43,-1,58,-1,43
1,<environment.Job instance at 0x7f6fca5e5460>,53,17,[4 9],54,-1,73,-1,56
1,<environment.Job instance at 0x7f6fca6050a0>,58,16,[9 2],59,-1,75,-1,59
1,<environment.Job instance at 0x7f6fc9ad1870>,16,17,[ 1 14],17,-1,48,-1,31
1,<environment.Job instance at 0x7f6fc8e84320>,19,18,[14  4],20,-1,61,-1,43
1,<environment.Job instance at 0x7f6fc9626640>,23,24,[4 7],24,-1,83,-1,59
1,<environment.Job instance at 0x7f6fc9552370>,28,23,[ 4 10],29,-1,98,-1,75
1,<environment.Job instance at 0x7f6fc99ab500>,35,13,[ 3 12],36,-1,96,-1,83
1,<environment.Job instance at 0x7f6fc99ab5f0>,36,13,[ 4 12],37,-1,96,-1,83
1,<environment.Job instance at 0x7f6fca212190>,43,24,[3 5],44,-1,125,-1,101
1,<environment.Job instance at 0x7f2e86dc2af0>,2,14,[ 2 10],3,-1,18,-1,4
1,<environment.Job instance at 0x7f2e903b28c0>,3,22,[2 5],4,-1,26,-1,4
1,<environment.Job instance at 0x7f2e86dc2d70>,6,15,[2 8],7,-1,22,-1,7
1,<environment.Job instance at 0x7f2e86dc2e60>,7,14,[7 5],8,-1,22,-1,8
1,<environment.Job instance at 0x7f2e86dc2eb0>,8,17,[1 8],9,-1,26,-1,9
1,<environment.Job instance at 0x7f2e86dc5050>,10,22,[8 1],11,-1,33,-1,11
1,<environment.Job instance at 0x7f2e86dc50f0>,12,23,[6 4],13,-1,36,-1,13
1,<environment.Job instance at 0x7f2e86dc53c0>,13,18,[5 9],14,-1,32,-1,14
1,<environment.Job instance at 0x7f2e86dc52d0>,14,21,[8 1],15,-1,38,-1,17
1,<environment.Job instance at 0x7f2e86dc54b0>,16,18,[7 3],17,-1,35,-1,17
1,<environment.Job instance at 0x7f2e86dc55a0>,18,26,[7 4],19,-1,45,-1,19
1,<environment.Job instance at 0x7f2e86dc5780>,19,25,[5 9],20,-1,45,-1,20
1,<environment.Job instance at 0x7f2e86dc5870>,21,18,[9 4],22,-1,41,-1,23
1,<environment.Job instance at 0x7f2e86dc5910>,23,16,[6 2],24,-1,40,-1,24
1,<environment.Job instance at 0x7f2e86dc5d20>,26,12,[8 5],27,-1,39,-1,27
1,<environment.Job instance at 0x7f2e86dc5e60>,27,17,[4 6],28,-1,45,-1,28
1,<environment.Job instance at 0x7f2e86dc5960>,22,12,[3 8],23,-1,41,-1,29
1,<environment.Job instance at 0x7f2e86dc8a00>,40,26,[ 1 10],41,-1,67,-1,41
1,<environment.Job instance at 0x7f2e86dc8140>,32,21,[5 9],33,-1,67,-1,46
1,<environment.Job instance at 0x7f2e86dc80f0>,33,26,[3 6],34,-1,72,-1,46
1,<environment.Job instance at 0x7f2e86dc8f50>,45,15,[7 5],46,-1,61,-1,46
1,<environment.Job instance at 0x7f2e86dc86e0>,39,14,[9 4],40,-1,63,-1,49
1,<environment.Job instance at 0x7f2e86dc8320>,34,14,[1 9],35,-1,63,-1,49
1,<environment.Job instance at 0x7f2e86dcb190>,48,12,[9 2],49,-1,62,-1,50
1,<environment.Job instance at 0x7f2e86dcb820>,54,18,[7 1],55,-1,73,-1,55
1,<environment.Job instance at 0x7f2e86dcb140>,49,17,[10  2],50,-1,73,-1,56
1,<environment.Job instance at 0x7f2e86dcbc30>,58,17,[3 7],59,-1,76,-1,59
1,<environment.Job instance at 0x7f2e86dcb960>,59,19,[1 7],60,-1,82,-1,63
1,<environment.Job instance at 0x7f2e86dc2d20>,12,23,[6 4],13,-1,53,-1,30
1,<environment.Job instance at 0x7f2e86dcfe60>,18,26,[7 4],19,-1,70,-1,44
1,<environment.Job instance at 0x7f2e86dcfd20>,19,25,[5 9],20,-1,83,-1,58
1,<environment.Job instance at 0x7f2e86dd3410>,28,17,[ 1 13],29,-1,87,-1,70
1,<environment.Job instance at 0x7f2e86e77be0>,30,26,[9 4],31,-1,110,-1,84
1,<environment.Job instance at 0x7f2e86ecf500>,31,1,[ 2 14],32,-1,85,-1,84
1,<environment.Job instance at 0x7f2e86ee82d0>,33,26,[3 6],34,-1,110,-1,84
1,<environment.Job instance at 0x7f2e86e37780>,40,26,[ 1 10],41,-1,139,-1,113
1,<environment.Job instance at 0x7f2e86ff3820>,57,16,[ 2 11],58,-1,183,-1,167
1,<environment.Job instance at 0x7f2e86508c30>,2,18,[3 5],3,-1,21,-1,3
1,<environment.Job instance at 0x7f2e864e6280>,6,13,[10  1],7,-1,21,-1,8
1,<environment.Job instance at 0x7f2e86508d20>,7,16,[8 1],8,-1,24,-1,8
1,<environment.Job instance at 0x7f2e864e9140>,9,19,[10  3],10,-1,29,-1,10
1,<environment.Job instance at 0x7f2e864e94b0>,11,14,[8 5],12,-1,27,-1,13
1,<environment.Job instance at 0x7f2e86505f00>,13,18,[ 3 10],14,-1,32,-1,14
1,<environment.Job instance at 0x7f2e86505410>,14,1,[5 5],15,-1,16,-1,15
1,<environment.Job instance at 0x7f2e865050f0>,15,15,[1 7],16,-1,31,-1,16
1,<environment.Job instance at 0x7f2e86505370>,16,3,[6 3],17,-1,20,-1,17
1,<environment.Job instance at 0x7f2e86505730>,17,18,[7 1],18,-1,36,-1,18
1,<environment.Job instance at 0x7f2e86505870>,18,16,[4 9],19,-1,35,-1,19
1,<environment.Job instance at 0x7f2e864e60a0>,12,21,[4 8],13,-1,41,-1,20
1,<environment.Job instance at 0x7f2e8650b320>,23,25,[ 1 10],24,-1,49,-1,24
1,<environment.Job instance at 0x7f2e8650b230>,26,18,[2 6],27,-1,45,-1,27
1,<environment.Job instance at 0x7f2e8650aeb0>,32,13,[9 4],33,-1,46,-1,33
1,<environment.Job instance at 0x7f2e8650a370>,33,16,[1 9],34,-1,50,-1,34
1,<environment.Job instance at 0x7f2e903f8460>,35,16,[7 5],36,-1,52,-1,36
1,<environment.Job instance at 0x7f2e8636bc80>,37,18,[5 5],38,-1,56,-1,38
1,<environment.Job instance at 0x7f2e86455870>,42,12,[1 6],43,-1,55,-1,43
1,<environment.Job instance at 0x7f2e86455cd0>,43,17,[5 1],44,-1,61,-1,44
1,<environment.Job instance at 0x7f2e86440500>,46,12,[8 4],47,-1,59,-1,47
1,<environment.Job instance at 0x7f2e86447c30>,48,16,[5 2],49,-1,66,-1,50
1,<environment.Job instance at 0x7f2e86447eb0>,49,28,[7 5],50,-1,78,-1,50
1,<environment.Job instance at 0x7f2e9051e5f0>,52,18,[7 5],53,-1,76,-1,58
1,<environment.Job instance at 0x7f2e863aad20>,57,14,[7 2],58,-1,73,-1,59
1,<environment.Job instance at 0x7f2e863b55a0>,60,17,[9 5],61,-1,79,-1,62
1,<environment.Job instance at 0x7f2e863cbdc0>,62,18,[10  4],63,-1,81,-1,63
1,<environment.Job instance at 0x7f2e863bfeb0>,65,15,[8 3],66,-1,81,-1,66
1,<environment.Job instance at 0x7f2e863f2a50>,61,13,[3 8],62,-1,93,-1,80
1,<environment.Job instance at 0x7f2e86561eb0>,19,17,[ 5 14],20,-1,57,-1,40
1,<environment.Job instance at 0x7f2e86564550>,23,25,[ 1 10],24,-1,89,-1,64
1,<environment.Job instance at 0x7f2e86573a00>,39,27,[3 9],40,-1,139,-1,112
1,<environment.Job instance at 0x7f2e86582550>,40,23,[5 1],41,-1,135,-1,112
1,<environment.Job instance at 0x7f2e86580a00>,47,3,[ 3 13],48,-1,147,-1,144
1,<environment.Job instance at 0x7f2e865c3230>,49,28,[7 5],50,-1,173,-1,145
1,<environment.Job instance at 0x7f2e86570230>,50,19,[ 5 12],51,-1,164,-1,145
1,<environment.Job instance at 0x7f2e8658baf0>,67,28,[ 2 10],68,-1,236,-1,208
1,<environment.Job instance at 0x7f2e86447d70>,6,13,[10  5],7,-1,23,-1,10
1,<environment.Job instance at 0x7f2e8644f0f0>,11,22,[5 6],12,-1,34,-1,12
1,<environment.Job instance at 0x7f2e8644fa00>,15,17,[10  4],16,-1,33,-1,16
1,<environment.Job instance at 0x7f2e8644fd20>,17,21,[10  4],18,-1,39,-1,18
1,<environment.Job instance at 0x7f2e90429050>,20,24,[1 5],21,-1,45,-1,21
1,<environment.Job instance at 0x7f2e8644fb40>,22,20,[10  5],23,-1,43,-1,23
1,<environment.Job instance at 0x7f2e90524c30>,24,14,[10  5],25,-1,39,-1,25
1,<environment.Job instance at 0x7f2e86364f50>,29,14,[ 5 10],30,-1,44,-1,30
1,<environment.Job instance at 0x7f2e86364a00>,30,17,[4 7],31,-1,48,-1,31
1,<environment.Job instance at 0x7f2e86364140>,33,24,[3 7],34,-1,58,-1,34
1,<environment.Job instance at 0x7f2e86364550>,34,19,[3 8],35,-1,54,-1,35
1,<environment.Job instance at 0x7f2e86364500>,35,17,[5 1],36,-1,53,-1,36
1,<environment.Job instance at 0x7f2e86364d20>,37,16,[8 4],38,-1,54,-1,38
1,<environment.Job instance at 0x7f2e8644f820>,9,17,[5 7],10,-1,55,-1,38
1,<environment.Job instance at 0x7f2e86364f00>,40,17,[3 5],41,-1,59,-1,42
1,<environment.Job instance at 0x7f2e86364af0>,41,18,[6 2],42,-1,62,-1,44
1,<environment.Job instance at 0x7f2e863bcdc0>,46,17,[9 1],47,-1,65,-1,48
1,<environment.Job instance at 0x7f2e8644f6e0>,2,15,[ 2 13],3,-1,18,-1,3
1,<environment.Job instance at 0x7f2e86364690>,4,20,[13  4],5,-1,25,-1,5
1,<environment.Job instance at 0x7f2e86dcb7d0>,13,1,[12  5],14,-1,18,-1,17
1,<environment.Job instance at 0x7f2e863e6f50>,20,24,[1 5],21,-1,50,-1,26
1,<environment.Job instance at 0x7f2e863e6af0>,26,13,[ 5 14],27,-1,49,-1,36
1,<environment.Job instance at 0x7f2e863f4050>,33,24,[3 7],34,-1,80,-1,56
1,<environment.Job instance at 0x7f2e86509dc0>,48,27,[ 3 12],49,-1,123,-1,96
1,<environment.Job instance at 0x7f2e86509b40>,52,15,[ 2 14],53,-1,124,-1,109
1,<environment.Job instance at 0x7f2e865094b0>,54,26,[3 9],55,-1,140,-1,114
1,<environment.Job instance at 0x7f2e865090a0>,60,23,[4 7],61,-1,155,-1,132
1,<environment.Job instance at 0x7f2e90525690>,1,17,[3 6],2,-1,19,-1,2
1,<environment.Job instance at 0x7f2e90525e60>,4,16,[5 6],5,-1,21,-1,5
1,<environment.Job instance at 0x7f2e90525fa0>,6,16,[1 8],7,-1,23,-1,7
1,<environment.Job instance at 0x7f2e873515a0>,8,23,[1 9],9,-1,32,-1,9
1,<environment.Job instance at 0x7f2e87351190>,9,17,[8 5],10,-1,27,-1,10
1,<environment.Job instance at 0x7f2e87351550>,13,18,[5 1],14,-1,32,-1,14
1,<environment.Job instance at 0x7f2e87444cd0>,14,15,[8 5],15,-1,30,-1,15
1,<environment.Job instance at 0x7f2e874445f0>,18,19,[4 7],19,-1,38,-1,19
1,<environment.Job instance at 0x7f2e874440f0>,23,22,[9 1],24,-1,46,-1,24
1,<environment.Job instance at 0x7f2e87444190>,25,18,[5 4],26,-1,44,-1,26
1,<environment.Job instance at 0x7f2e903b20a0>,32,12,[ 5 10],33,-1,46,-1,34
1,<environment.Job instance at 0x7f2e903b2870>,35,27,[6 1],36,-1,63,-1,36
1,<environment.Job instance at 0x7f2e903b2050>,33,13,[9 2],34,-1,51,-1,38
1,<environment.Job instance at 0x7f2e868b3910>,37,14,[10  3],38,-1,52,-1,38
1,<environment.Job instance at 0x7f2e868b3af0>,41,16,[5 8],42,-1,58,-1,42
1,<environment.Job instance at 0x7f2e868b3d20>,42,23,[1 8],43,-1,66,-1,43
1,<environment.Job instance at 0x7f2e867cf870>,47,14,[10  5],48,-1,62,-1,48
1,<environment.Job instance at 0x7f2e867cfc30>,51,17,[10  2],52,-1,71,-1,54
1,<environment.Job instance at 0x7f2e867cfa50>,55,18,[ 1 10],56,-1,74,-1,56
1,<environment.Job instance at 0x7f2e873510f0>,0,1,[14  4],1,-1,2,-1,1
1,<environment.Job instance at 0x7f2e868b3e10>,7,18,[ 1 14],8,-1,26,-1,8
1,<environment.Job instance at 0x7f2e867cf3c0>,8,23,[1 9],9,-1,39,-1,16
1,<environment.Job instance at 0x7f2e90525370>,15,17,[12  1],16,-1,37,-1,20
1,<environment.Job instance at 0x7f2e874455f0>,20,16,[14  3],21,-1,55,-1,39
1,<environment.Job instance at 0x7f2e87445190>,27,2,[ 1 12],28,-1,54,-1,52
1,<environment.Job instance at 0x7f2e8726a230>,35,27,[6 1],36,-1,110,-1,83
1,<environment.Job instance at 0x7f2e8726a280>,42,23,[1 8],43,-1,119,-1,96
1,<environment.Job instance at 0x7f2e872542d0>,53,26,[5 3],54,-1,156,-1,130
1,<environment.Job instance at 0x7f2e86daa370>,1,20,[ 4 10],2,-1,22,-1,2
1,<environment.Job instance at 0x7f2e8720f0f0>,2,15,[9 2],3,-1,20,-1,5
1,<environment.Job instance at 0x7f2e8720f410>,4,16,[7 5],5,-1,21,-1,5
1,<environment.Job instance at 0x7f2e8720f820>,7,27,[9 5],8,-1,35,-1,8
1,<environment.Job instance at 0x7f2e8720f6e0>,15,1,[6 3],16,-1,17,-1,16
1,<environment.Job instance at 0x7f2e86ac4870>,16,13,[8 2],17,-1,30,-1,17
1,<environment.Job instance at 0x7f2e872130f0>,18,12,[5 5],19,-1,31,-1,19
1,<environment.Job instance at 0x7f2e87213a50>,19,15,[6 5],20,-1,35,-1,20
1,<environment.Job instance at 0x7f2e872125a0>,23,17,[7 4],24,-1,41,-1,24
1,<environment.Job instance at 0x7f2e86babc80>,39,18,[5 6],40,-1,67,-1,49
1,<environment.Job instance at 0x7f2e86bab6e0>,40,16,[8 3],41,-1,65,-1,49
1,<environment.Job instance at 0x7f2e86c2f8c0>,45,27,[4 5],46,-1,76,-1,49
1,<environment.Job instance at 0x7f2e86b9df00>,62,17,[5 9],63,-1,153,-1,136
1,<environment.Job instance at 0x7f2e86c45140>,7,27,[9 5],8,-1,45,-1,18
1,<environment.Job instance at 0x7f2e86babd20>,9,14,[12  2],10,-1,32,-1,18
1,<environment.Job instance at 0x7f2e86b99b40>,21,17,[ 5 14],22,-1,54,-1,37
1,<environment.Job instance at 0x7f2e872546e0>,22,25,[ 3 11],23,-1,62,-1,37
1,<environment.Job instance at 0x7f2e872540f0>,24,17,[13  5],25,-1,55,-1,38
1,<environment.Job instance at 0x7f2e87254f00>,25,13,[ 5 14],26,-1,51,-1,38
1,<environment.Job instance at 0x7f2e8726a2d0>,45,27,[4 5],46,-1,155,-1,128
1,<environment.Job instance at 0x7f2e8726a230>,47,12,[13  4],48,-1,140,-1,128
1,<environment.Job instance at 0x7f2e8726a410>,48,12,[ 5 12],49,-1,140,-1,128
1,<environment.Job instance at 0x7f2e90525280>,67,13,[12  1],68,-1,187,-1,174
1,<environment.Job instance at 0x7f2e90525370>,68,12,[14  3],69,-1,186,-1,174
1,<environment.Job instance at 0x7f2e86742140>,10,26,[8 3],11,-1,37,-1,11
1,<environment.Job instance at 0x7f2e867421e0>,14,14,[3 8],15,-1,29,-1,15
1,<environment.Job instance at 0x7f2e871c39b0>,15,13,[9 1],16,-1,30,-1,17
1,<environment.Job instance at 0x7f2e871c3c30>,16,18,[8 3],17,-1,35,-1,17
1,<environment.Job instance at 0x7f2e871c3910>,21,18,[5 8],22,-1,40,-1,22
1,<environment.Job instance at 0x7f2e871c3f50>,22,14,[2 8],23,-1,37,-1,23
1,<environment.Job instance at 0x7f2e871c3050>,23,2,[10  2],24,-1,26,-1,24
1,<environment.Job instance at 0x7f2e871c3190>,25,15,[1 5],26,-1,41,-1,26
1,<environment.Job instance at 0x7f2e871c30a0>,27,13,[ 5 10],28,-1,43,-1,30
1,<environment.Job instance at 0x7f2e86a9d780>,30,16,[ 4 10],31,-1,47,-1,31
1,<environment.Job instance at 0x7f2e86a9dfa0>,31,15,[5 7],32,-1,47,-1,32
1,<environment.Job instance at 0x7f2e86a9dc30>,32,17,[8 2],33,-1,50,-1,33
1,<environment.Job instance at 0x7f2e86a9dd20>,34,17,[6 1],35,-1,52,-1,35
1,<environment.Job instance at 0x7f2e86a9df00>,36,17,[7 4],37,-1,54,-1,37
1,<environment.Job instance at 0x7f2e86a9d3c0>,39,18,[10  4],40,-1,58,-1,40
1,<environment.Job instance at 0x7f2e868409b0>,40,15,[1 9],41,-1,56,-1,41
1,<environment.Job instance at 0x7f2e86840320>,43,14,[5 6],44,-1,58,-1,44
1,<environment.Job instance at 0x7f2e86840a00>,44,18,[10  5],45,-1,63,-1,45
1,<environment.Job instance at 0x7f2e86840410>,46,16,[2 9],47,-1,63,-1,47
1,<environment.Job instance at 0x7f2e86840d70>,48,15,[10  4],49,-1,64,-1,49
1,<environment.Job instance at 0x7f2e86840460>,50,16,[8 5],51,-1,67,-1,51
1,<environment.Job instance at 0x7f2e871d02d0>,51,16,[4 5],52,-1,68,-1,52
1,<environment.Job instance at 0x7f2e871d04b0>,52,27,[8 3],53,-1,80,-1,53
1,<environment.Job instance at 0x7f2e871d0c80>,53,18,[1 6],54,-1,72,-1,54
1,<environment.Job instance at 0x7f2e871d0f00>,54,17,[2 6],55,-1,72,-1,55
1,<environment.Job instance at 0x7f2e871d07d0>,57,16,[7 4],58,-1,82,-1,66
1,<environment.Job instance at 0x7f2e86a9ddc0>,6,25,[2 8],7,-1,40,-1,15
1,<environment.Job instance at 0x7f2e86850b40>,10,26,[8 3],11,-1,49,-1,23
1,<environment.Job instance at 0x7f2e8726aaa0>,24,2,[11  3],25,-1,46,-1,44
1,<environment.Job instance at 0x7f2e87213230>,35,17,[12  4],36,-1,107,-1,90
1,<environment.Job instance at 0x7f2e871c9fa0>,47,2,[ 3 11],48,-1,141,-1,139
1,<environment.Job instance at 0x7f2e871e7c80>,52,27,[8 3],53,-1,198,-1,171
1,<environment.Job instance at 0x7f2e871e7dc0>,56,27,[2 6],57,-1,215,-1,188
1,<environment.Job instance at 0x7f2e871e7f00>,60,14,[ 4 14],61,-1,219,-1,205
1,<environment.Job instance at 0x7f2e871c8320>,0,12,[10  5],1,-1,15,-1,3
1,<environment.Job instance at 0x7f2e866964b0>,2,16,[6 4],3,-1,19,-1,3
1,<environment.Job instance at 0x7f2e86c56370>,6,21,[ 4 10],7,-1,28,-1,7
1,<environment.Job instance at 0x7f2e864ffaf0>,7,23,[2 8],8,-1,31,-1,8
1,<environment.Job instance at 0x7f2e865040a0>,15,17,[ 5 10],16,-1,34,-1,17
1,<environment.Job instance at 0x7f2e86a39eb0>,18,14,[8 2],19,-1,33,-1,19
1,<environment.Job instance at 0x7f2e866cc370>,20,25,[6 4],21,-1,46,-1,21
1,<environment.Job instance at 0x7f2e866cc5a0>,24,24,[5 5],25,-1,51,-1,27
1,<environment.Job instance at 0x7f2e86c56870>,16,14,[9 4],17,-1,42,-1,28
1,<environment.Job instance at 0x7f2e86c7d9b0>,29,15,[9 5],30,-1,46,-1,31
1,<environment.Job instance at 0x7f2e87464410>,31,17,[7 5],32,-1,49,-1,32
1,<environment.Job instance at 0x7f2e86c46140>,35,14,[3 8],36,-1,50,-1,36
1,<environment.Job instance at 0x7f2e864f6500>,54,22,[7 3],55,-1,132,-1,110
1,<environment.Job instance at 0x7f2e864f60a0>,51,16,[ 1 14],52,-1,137,-1,121
1,<environment.Job instance at 0x7f2e864f6d20>,55,20,[7 5],56,-1,142,-1,122
1,<environment.Job instance at 0x7f2e8726a780>,7,23,[2 8],8,-1,36,-1,13
1,<environment.Job instance at 0x7f2e8726a320>,8,3,[11  1],9,-1,16,-1,13
1,<environment.Job instance at 0x7f2e8726a4b0>,9,19,[13  3],10,-1,32,-1,13
1,<environment.Job instance at 0x7f2e87455230>,14,13,[ 4 11],15,-1,32,-1,19
1,<environment.Job instance at 0x7f2e87455a50>,19,17,[12  4],20,-1,47,-1,30
1,<environment.Job instance at 0x7f2e87455c30>,20,25,[6 4],21,-1,58,-1,33
1,<environment.Job instance at 0x7f2e87455cd0>,22,3,[14  5],23,-1,36,-1,33
1,<environment.Job instance at 0x7f2e86f6a3c0>,24,24,[5 5],25,-1,67,-1,43
1,<environment.Job instance at 0x7f2e86b99550>,28,28,[ 5 10],29,-1,87,-1,59
1,<environment.Job instance at 0x7f2e86c1b870>,36,12,[ 5 12],37,-1,89,-1,77
1,<environment.Job instance at 0x7f2e8671d640>,39,2,[ 5 14],40,-1,92,-1,90
1,<environment.Job instance at 0x7f2e86742eb0>,51,16,[ 1 14],52,-1,151,-1,135
1,<environment.Job instance at 0x7f2e871574b0>,64,17,[14  5],65,-1,186,-1,169
1,<environment.Job instance at 0x7f2e86da54b0>,2,17,[4 5],3,-1,20,-1,3
1,<environment.Job instance at 0x7f2e86da5370>,3,14,[9 3],4,-1,20,-1,6
1,<environment.Job instance at 0x7f2e86da5230>,5,17,[8 2],6,-1,23,-1,6
1,<environment.Job instance at 0x7f2e86da5fa0>,6,16,[1 9],7,-1,23,-1,7
1,<environment.Job instance at 0x7f2e86cda190>,12,16,[10  4],13,-1,31,-1,15
1,<environment.Job instance at 0x7f2e86cda550>,16,22,[1 8],17,-1,39,-1,17
1,<environment.Job instance at 0x7f2e86cdaa50>,17,28,[5 9],18,-1,47,-1,19
1,<environment.Job instance at 0x7f2e86cdaf50>,19,18,[5 8],20,-1,64,-1,46
1,<environment.Job instance at 0x7f2e86cdac80>,26,18,[ 5 10],27,-1,70,-1,52
1,<environment.Job instance at 0x7f2e86cda780>,27,28,[9 1],28,-1,80,-1,52
1,<environment.Job instance at 0x7f2e86cda500>,28,13,[9 1],29,-1,69,-1,56
1,<environment.Job instance at 0x7f2e86cda280>,32,26,[5 8],33,-1,87,-1,61
1,<environment.Job instance at 0x7f2e86cda640>,14,16,[9 5],15,-1,77,-1,61
1,<environment.Job instance at 0x7f2e86cda460>,31,14,[9 2],32,-1,77,-1,63
1,<environment.Job instance at 0x7f2e904fd8c0>,38,15,[2 8],39,-1,78,-1,63
1,<environment.Job instance at 0x7f2e904fdcd0>,42,17,[8 1],43,-1,80,-1,63
1,<environment.Job instance at 0x7f2e904fdb40>,43,22,[3 5],44,-1,85,-1,63
1,<environment.Job instance at 0x7f2e904fd320>,39,18,[1 7],40,-1,81,-1,63
1,<environment.Job instance at 0x7f2e904fdeb0>,45,18,[4 6],46,-1,81,-1,63
1,<environment.Job instance at 0x7f2e904fd3c0>,40,14,[7 2],41,-1,77,-1,63
1,<environment.Job instance at 0x7f2e86a02960>,47,28,[ 5 10],48,-1,91,-1,63
1,<environment.Job instance at 0x7f2e904fd780>,44,12,[3 9],45,-1,75,-1,63
1,<environment.Job instance at 0x7f2e86a02d20>,49,18,[3 8],50,-1,81,-1,63
1,<environment.Job instance at 0x7f2e86a02af0>,50,22,[7 1],51,-1,85,-1,63
1,<environment.Job instance at 0x7f2e86a02550>,52,21,[5 7],53,-1,85,-1,64
1,<environment.Job instance at 0x7f2e86a02640>,55,16,[4 7],56,-1,80,-1,64
1,<environment.Job instance at 0x7f2e86a02a00>,56,18,[9 3],57,-1,82,-1,64
1,<environment.Job instance at 0x7f2e86a02140>,57,1,[ 4 10],58,-1,65,-1,64
1,<environment.Job instance at 0x7f2e86a02b40>,58,16,[1 7],59,-1,80,-1,64
1,<environment.Job instance at 0x7f2e86cda9b0>,20,18,[ 2 10],21,-1,85,-1,67
1,<environment.Job instance at 0x7f2e86a021e0>,59,18,[8 2],60,-1,85,-1,67
1,<environment.Job instance at 0x7f2e86a02b90>,51,12,[1 6],52,-1,79,-1,67
1,<environment.Job instance at 0x7f2e86808cd0>,64,16,[ 5 10],65,-1,86,-1,70
1,<environment.Job instance at 0x7f2e86808aa0>,61,12,[2 6],62,-1,82,-1,70
1,<environment.Job instance at 0x7f2e868085f0>,65,15,[5 9],66,-1,85,-1,70
1,<environment.Job instance at 0x7f2e86f220f0>,1,2,[14  5],2,-1,4,-1,2
1,<environment.Job instance at 0x7f2e87455140>,17,28,[5 9],18,-1,68,-1,40
1,<environment.Job instance at 0x7f2e86808410>,27,28,[9 1],28,-1,114,-1,86
1,<environment.Job instance at 0x7f2e86808870>,32,26,[5 8],33,-1,127,-1,101
1,<environment.Job instance at 0x7f2e86504690>,36,2,[ 5 13],37,-1,117,-1,115
1,<environment.Job instance at 0x7f2e86ffebe0>,41,1,[13  4],42,-1,123,-1,122
1,<environment.Job instance at 0x7f2e86ffea50>,47,28,[ 5 10],48,-1,182,-1,154
1,<environment.Job instance at 0x7f2e86ffe730>,48,2,[12  3],49,-1,156,-1,154
1,<environment.Job instance at 0x7f2e86118820>,0,26,[3 7],1,-1,27,-1,1
1,<environment.Job instance at 0x7f2e861182d0>,4,16,[1 5],5,-1,21,-1,5
1,<environment.Job instance at 0x7f2e86118230>,5,18,[4 9],6,-1,24,-1,6
1,<environment.Job instance at 0x7f2e9051bd20>,7,18,[10  5],8,-1,26,-1,8
1,<environment.Job instance at 0x7f2e8612f050>,8,13,[5 5],9,-1,22,-1,9
1,<environment.Job instance at 0x7f2e8612f460>,9,1,[12  2],10,-1,11,-1,10
1,<environment.Job instance at 0x7f2e8612f690>,10,13,[10  1],11,-1,24,-1,11
1,<environment.Job instance at 0x7f2e8612fe60>,11,3,[5 1],12,-1,15,-1,12
1,<environment.Job instance at 0x7f2e8612f5a0>,12,24,[1 9],13,-1,37,-1,13
1,<environment.Job instance at 0x7f2e8612f550>,16,12,[10  1],17,-1,33,-1,21
1,<environment.Job instance at 0x7f2e8612ff00>,20,17,[5 6],21,-1,38,-1,21
1,<environment.Job instance at 0x7f2e8612feb0>,21,27,[7 1],22,-1,49,-1,22
1,<environment.Job instance at 0x7f2e8612f140>,25,21,[ 2 10],26,-1,48,-1,27
1,<environment.Job instance at 0x7f2e8612fbe0>,26,15,[10  2],27,-1,44,-1,29
1,<environment.Job instance at 0x7f2e86081410>,30,16,[10  1],31,-1,48,-1,32
1,<environment.Job instance at 0x7f2e861f8eb0>,42,14,[5 1],43,-1,70,-1,56
1,<environment.Job instance at 0x7f2e86081730>,31,17,[11  3],32,-1,74,-1,57
1,<environment.Job instance at 0x7f2e861f80a0>,47,14,[9 2],48,-1,71,-1,57
1,<environment.Job instance at 0x7f2e861f8690>,43,24,[2 6],44,-1,81,-1,57
1,<environment.Job instance at 0x7f2e861f4c30>,62,27,[5 7],63,-1,159,-1,132
1,<environment.Job instance at 0x7f2e861f4550>,65,16,[9 2],66,-1,149,-1,133
1,<environment.Job instance at 0x7f2e861f4be0>,64,24,[13  2],65,-1,157,-1,133
1,<environment.Job instance at 0x7f2e876b2aa0>,68,15,[11  4],69,-1,148,-1,133
1,<environment.Job instance at 0x7f2e86ffe5a0>,66,15,[10  3],67,-1,149,-1,134
1,<environment.Job instance at 0x7f2e8612f5f0>,0,26,[3 7],1,-1,27,-1,1
1,<environment.Job instance at 0x7f2e8612f640>,1,18,[11  5],2,-1,20,-1,2
1,<environment.Job instance at 0x7f2e861181e0>,9,1,[12  2],10,-1,16,-1,15
1,<environment.Job instance at 0x7f2e868082d0>,12,24,[1 9],13,-1,52,-1,28
1,<environment.Job instance at 0x7f2e86ed2690>,21,27,[7 1],22,-1,81,-1,54
1,<environment.Job instance at 0x7f2e86ed2a00>,22,26,[ 3 10],23,-1,80,-1,54
1,<environment.Job instance at 0x7f2e86ed2c30>,23,2,[ 3 13],24,-1,56,-1,54
1,<environment.Job instance at 0x7f2e86ecb320>,27,1,[ 3 14],28,-1,56,-1,55
1,<environment.Job instance at 0x7f2e86ecb960>,28,12,[ 2 11],29,-1,67,-1,55
1,<environment.Job instance at 0x7f2e86ecbd70>,31,17,[11  3],32,-1,82,-1,65
1,<environment.Job instance at 0x7f2e86565b40>,32,16,[12  1],33,-1,81,-1,65
1,<environment.Job instance at 0x7f2e86eac320>,33,15,[ 4 13],34,-1,80,-1,65
1,<environment.Job instance at 0x7f2e87960780>,43,24,[2 6],44,-1,134,-1,110
1,<environment.Job instance at 0x7f2e87960a00>,44,13,[ 5 12],45,-1,123,-1,110
1,<environment.Job instance at 0x7f2e87960730>,45,2,[ 2 11],46,-1,112,-1,110
1,<environment.Job instance at 0x7f2e86eefa50>,62,27,[5 7],63,-1,211,-1,184
1,<environment.Job instance at 0x7f2e86eef280>,64,24,[13  2],65,-1,208,-1,184
1,<environment.Job instance at 0x7f2e86ee43c0>,68,15,[11  4],69,-1,218,-1,203
1,<environment.Job instance at 0x7f2e868089b0>,7,3,[10  1],8,-1,11,-1,8
1,<environment.Job instance at 0x7f2e8684a9b0>,11,18,[4 9],12,-1,34,-1,16
1,<environment.Job instance at 0x7f2e8684adc0>,15,16,[6 2],16,-1,32,-1,16
1,<environment.Job instance at 0x7f2e871e8780>,16,16,[8 2],17,-1,33,-1,17
1,<environment.Job instance at 0x7f2e871e8460>,17,14,[11  4],18,-1,32,-1,18
1,<environment.Job instance at 0x7f2e871e8dc0>,18,14,[8 5],19,-1,33,-1,19
1,<environment.Job instance at 0x7f2e871e8820>,19,16,[7 4],20,-1,36,-1,20
1,<environment.Job instance at 0x7f2e871e8320>,20,18,[ 4 11],21,-1,39,-1,21
1,<environment.Job instance at 0x7f2e871e8960>,21,18,[ 3 10],22,-1,42,-1,24
1,<environment.Job instance at 0x7f2e8684ae60>,10,17,[5 2],11,-1,42,-1,25
1,<environment.Job instance at 0x7f2e871e8730>,23,24,[8 5],24,-1,50,-1,26
1,<environment.Job instance at 0x7f2e871e8910>,24,14,[ 1 10],25,-1,40,-1,26
1,<environment.Job instance at 0x7f2e871d0410>,31,15,[8 1],32,-1,47,-1,32
1,<environment.Job instance at 0x7f2e871d02d0>,32,16,[5 4],33,-1,49,-1,33
1,<environment.Job instance at 0x7f2e871d0a00>,33,15,[ 3 10],34,-1,49,-1,34
1,<environment.Job instance at 0x7f2e871d0f50>,35,15,[5 6],36,-1,51,-1,36
1,<environment.Job instance at 0x7f2e871d0730>,38,20,[3 9],39,-1,59,-1,39
1,<environment.Job instance at 0x7f2e871d0aa0>,40,16,[5 4],41,-1,57,-1,41
1,<environment.Job instance at 0x7f2e871d09b0>,41,17,[ 4 10],42,-1,65,-1,48
1,<environment.Job instance at 0x7f2e878645f0>,44,17,[3 5],45,-1,65,-1,48
1,<environment.Job instance at 0x7f2e871d0af0>,43,14,[ 5 13],44,-1,62,-1,48
1,<environment.Job instance at 0x7f2e87864e60>,46,14,[6 5],47,-1,62,-1,48
1,<environment.Job instance at 0x7f2e87864a50>,48,23,[3 9],49,-1,73,-1,50
1,<environment.Job instance at 0x7f2e87864e10>,49,13,[10  5],50,-1,63,-1,50
1,<environment.Job instance at 0x7f2e87864640>,47,21,[4 8],48,-1,74,-1,53
1,<environment.Job instance at 0x7f2e871d0820>,37,14,[7 2],38,-1,69,-1,55
1,<environment.Job instance at 0x7f2e87864cd0>,52,14,[2 6],53,-1,69,-1,55
1,<environment.Job instance at 0x7f2e87864b90>,55,15,[4 7],56,-1,71,-1,56
1,<environment.Job instance at 0x7f2e878644b0>,57,17,[8 4],58,-1,75,-1,58
1,<environment.Job instance at 0x7f2e87864230>,58,16,[1 7],59,-1,75,-1,59
1,<environment.Job instance at 0x7f2e86ecdc80>,59,15,[ 2 10],60,-1,76,-1,61
1,<environment.Job instance at 0x7f2e871d0690>,1,14,[ 4 13],2,-1,16,-1,2
1,<environment.Job instance at 0x7f2e86eef870>,17,14,[11  4],18,-1,45,-1,31
1,<environment.Job instance at 0x7f2e86ebcbe0>,20,18,[ 4 11],21,-1,65,-1,47
1,<environment.Job instance at 0x7f2e87960b40>,23,24,[8 5],24,-1,89,-1,65
1,<environment.Job instance at 0x7f2e879609b0>,28,13,[12  1],29,-1,95,-1,82
1,<environment.Job instance at 0x7f2e86565be0>,36,3,[14  2],37,-1,102,-1,99
1,<environment.Job instance at 0x7f2e86ecb960>,43,14,[ 5 13],44,-1,140,-1,126
1,<environment.Job instance at 0x7f2e86ed2410>,48,23,[3 9],49,-1,169,-1,146
1,<environment.Job instance at 0x7f2e861f8b40>,60,2,[ 1 11],61,-1,198,-1,196
1,<environment.Job instance at 0x7f2e86ecdfa0>,67,12,[ 3 14],68,-1,232,-1,220
1,<environment.Job instance at 0x7f2e87064960>,1,16,[8 4],2,-1,18,-1,2
1,<environment.Job instance at 0x7f2e87961c80>,3,18,[6 4],4,-1,22,-1,4
1,<environment.Job instance at 0x7f2e86018aa0>,15,21,[9 5],16,-1,37,-1,16
1,<environment.Job instance at 0x7f2e86018b90>,16,18,[10  5],17,-1,35,-1,17
1,<environment.Job instance at 0x7f2e86018500>,17,14,[1 9],18,-1,32,-1,18
1,<environment.Job instance at 0x7f2e860fe280>,21,16,[1 6],22,-1,38,-1,22
1,<environment.Job instance at 0x7f2e860fe500>,23,27,[3 5],24,-1,51,-1,24
1,<environment.Job instance at 0x7f2e866b1320>,27,17,[5 7],28,-1,45,-1,28
1,<environment.Job instance at 0x7f2e866b15a0>,28,12,[7 5],29,-1,41,-1,29
1,<environment.Job instance at 0x7f2e866b1370>,29,12,[1 9],30,-1,42,-1,30
1,<environment.Job instance at 0x7f2e866b1c30>,33,12,[9 3],34,-1,46,-1,34
1,<environment.Job instance at 0x7f2e866988c0>,34,12,[1 5],35,-1,47,-1,35
1,<environment.Job instance at 0x7f2e86698d70>,35,14,[5 2],36,-1,51,-1,37
1,<environment.Job instance at 0x7f2e866984b0>,37,17,[2 6],38,-1,55,-1,38
1,<environment.Job instance at 0x7f2e86698f50>,38,17,[5 4],39,-1,56,-1,39
1,<environment.Job instance at 0x7f2e86698910>,40,16,[9 4],41,-1,57,-1,41
1,<environment.Job instance at 0x7f2e86698280>,43,13,[5 6],44,-1,57,-1,44
1,<environment.Job instance at 0x7f2e8732c1e0>,45,18,[3 9],46,-1,64,-1,46
1,<environment.Job instance at 0x7f2e8732cd70>,46,27,[10  4],47,-1,74,-1,47
1,<environment.Job instance at 0x7f2e875ac460>,48,14,[4 5],49,-1,63,-1,49
1,<environment.Job instance at 0x7f2e875acbe0>,49,14,[9 4],50,-1,64,-1,50
1,<environment.Job instance at 0x7f2e875acaf0>,51,18,[4 8],52,-1,70,-1,52
1,<environment.Job instance at 0x7f2e86695690>,52,25,[7 3],53,-1,78,-1,53
1,<environment.Job instance at 0x7f2e86e84780>,54,13,[ 3 12],55,-1,68,-1,55
1,<environment.Job instance at 0x7f2e86f0bdc0>,56,17,[2 9],57,-1,74,-1,57
1,<environment.Job instance at 0x7f2e86e84b40>,57,13,[4 7],58,-1,71,-1,58
1,<environment.Job instance at 0x7f2e8715d550>,58,13,[ 3 10],59,-1,72,-1,59
1,<environment.Job instance at 0x7f2e8715d280>,59,14,[4 7],60,-1,74,-1,60
1,<environment.Job instance at 0x7f2e867ff690>,60,16,[10  3],61,-1,77,-1,61
1,<environment.Job instance at 0x7f2e86089230>,36,12,[6 4],37,-1,73,-1,61
1,<environment.Job instance at 0x7f2e87314e10>,61,17,[10  5],62,-1,81,-1,64
1,<environment.Job instance at 0x7f2e86f3b0a0>,63,17,[6 1],64,-1,81,-1,64
1,<environment.Job instance at 0x7f2e866b1f50>,8,16,[13  3],9,-1,25,-1,9
1,<environment.Job instance at 0x7f2e86582320>,23,27,[3 5],24,-1,66,-1,39
1,<environment.Job instance at 0x7f2e861f87d0>,24,1,[12  4],25,-1,40,-1,39
1,<environment.Job instance at 0x7f2e861f8780>,25,2,[14  1],26,-1,41,-1,39
1,<environment.Job instance at 0x7f2e87960780>,50,1,[ 5 11],51,-1,148,-1,147
1,<environment.Job instance at 0x7f2e86ebf730>,52,25,[7 3],53,-1,186,-1,161
1,<environment.Job instance at 0x7f2e879606e0>,46,27,[10  4],47,-1,188,-1,161
1,<environment.Job instance at 0x7f2e86f15960>,54,13,[ 3 12],55,-1,174,-1,161
1,<environment.Job instance at 0x7f2e878643c0>,68,14,[13  2],69,-1,239,-1,225
1,<environment.Job instance at 0x7f2e87591a50>,7,16,[2 7],8,-1,24,-1,8
1,<environment.Job instance at 0x7f2e87591460>,9,14,[7 2],10,-1,24,-1,10
1,<environment.Job instance at 0x7f2e875913c0>,10,18,[1 7],11,-1,29,-1,11
1,<environment.Job instance at 0x7f2e87591e60>,11,14,[1 7],12,-1,26,-1,12
1,<environment.Job instance at 0x7f2e87591780>,12,14,[8 5],13,-1,27,-1,13
1,<environment.Job instance at 0x7f2e87591190>,15,26,[4 8],16,-1,42,-1,16
1,<environment.Job instance at 0x7f2e87591af0>,16,20,[4 8],17,-1,37,-1,17
1,<environment.Job instance at 0x7f2e875918c0>,18,16,[8 4],19,-1,37,-1,21
1,<environment.Job instance at 0x7f2e8685af50>,20,25,[5 4],21,-1,46,-1,21
1,<environment.Job instance at 0x7f2e8685a5f0>,21,21,[5 5],22,-1,43,-1,22
1,<environment.Job instance at 0x7f2e8685adc0>,23,18,[ 2 10],24,-1,43,-1,25
1,<environment.Job instance at 0x7f2e8685af00>,25,25,[5 7],26,-1,51,-1,26
1,<environment.Job instance at 0x7f2e8685a690>,26,12,[5 9],27,-1,39,-1,27
1,<environment.Job instance at 0x7f2e8685a0a0>,27,22,[5 8],28,-1,50,-1,28
1,<environment.Job instance at 0x7f2e8685ae10>,28,1,[6 4],29,-1,30,-1,29
1,<environment.Job instance at 0x7f2e8685ad20>,29,3,[11  3],30,-1,33,-1,30
1,<environment.Job instance at 0x7f2e8685aeb0>,30,15,[3 8],31,-1,46,-1,31
1,<environment.Job instance at 0x7f2e8685a230>,31,12,[3 9],32,-1,44,-1,32
1,<environment.Job instance at 0x7f2e8685a640>,33,27,[8 5],34,-1,61,-1,34
1,<environment.Job instance at 0x7f2e8685afa0>,24,13,[7 3],25,-1,47,-1,34
1,<environment.Job instance at 0x7f2e86293c80>,45,14,[10  1],46,-1,61,-1,47
1,<environment.Job instance at 0x7f2e869761e0>,47,17,[2 7],48,-1,65,-1,48
1,<environment.Job instance at 0x7f2e86976730>,48,15,[5 5],49,-1,64,-1,49
1,<environment.Job instance at 0x7f2e86976460>,51,18,[5 9],52,-1,70,-1,52
1,<environment.Job instance at 0x7f2e86976eb0>,53,18,[3 7],54,-1,72,-1,54
1,<environment.Job instance at 0x7f2e86f48320>,60,18,[2 7],61,-1,79,-1,61
1,<environment.Job instance at 0x7f2e86f48410>,61,15,[6 3],62,-1,77,-1,62
1,<environment.Job instance at 0x7f2e8701c230>,15,26,[4 8],16,-1,62,-1,36
1,<environment.Job instance at 0x7f2e879c6af0>,20,25,[5 4],21,-1,66,-1,41
1,<environment.Job instance at 0x7f2e879c6730>,25,25,[5 7],26,-1,81,-1,56
1,<environment.Job instance at 0x7f2e879c6cd0>,29,3,[11  3],30,-1,59,-1,56
1,<environment.Job instance at 0x7f2e876a5730>,33,27,[8 5],34,-1,108,-1,81
1,<environment.Job instance at 0x7f2e876a5d20>,34,12,[ 5 13],35,-1,93,-1,81
1,<environment.Job instance at 0x7f2e876a54b0>,39,1,[12  4],40,-1,85,-1,84
1,<environment.Job instance at 0x7f2e876a5370>,43,24,[3 5],44,-1,113,-1,89
1,<environment.Job instance at 0x7f2e86e5b1e0>,54,27,[1 8],55,-1,177,-1,150
1,<environment.Job instance at 0x7f2e86968280>,64,23,[4 5],65,-1,195,-1,172
1,<environment.Job instance at 0x7f2e86968190>,67,13,[12  5],68,-1,185,-1,172
1,<environment.Job instance at 0x7f2e8635fa50>,4,18,[3 6],5,-1,25,-1,7
1,<environment.Job instance at 0x7f2e8635f9b0>,6,26,[8 5],7,-1,33,-1,7
1,<environment.Job instance at 0x7f2e86363230>,13,20,[5 3],14,-1,35,-1,15
1,<environment.Job instance at 0x7f2e86363be0>,15,17,[6 3],16,-1,33,-1,16
1,<environment.Job instance at 0x7f2e86363af0>,16,14,[10  1],17,-1,35,-1,21
1,<environment.Job instance at 0x7f2e86363c80>,21,17,[2 9],22,-1,39,-1,22
1,<environment.Job instance at 0x7f2e86363cd0>,24,12,[10  2],25,-1,37,-1,25
1,<environment.Job instance at 0x7f2e86382a50>,26,13,[9 1],27,-1,40,-1,27
1,<environment.Job instance at 0x7f2e863828c0>,27,22,[10  1],28,-1,60,-1,38
1,<environment.Job instance at 0x7f2e86382d70>,29,14,[5 1],30,-1,52,-1,38
1,<environment.Job instance at 0x7f2e863825a0>,32,13,[9 2],33,-1,51,-1,38
1,<environment.Job instance at 0x7f2e86382eb0>,36,26,[9 5],37,-1,65,-1,39
1,<environment.Job instance at 0x7f2e86382500>,30,20,[3 8],31,-1,60,-1,40
1,<environment.Job instance at 0x7f2e86392d20>,43,16,[6 3],44,-1,62,-1,46
1,<environment.Job instance at 0x7f2e86392f50>,42,13,[ 3 10],43,-1,61,-1,48
1,<environment.Job instance at 0x7f2e863562d0>,49,22,[7 3],50,-1,73,-1,51
1,<environment.Job instance at 0x7f2e86382dc0>,28,16,[13  1],29,-1,72,-1,56
1,<environment.Job instance at 0x7f2e86356640>,52,25,[7 5],53,-1,81,-1,56
1,<environment.Job instance at 0x7f2e86356be0>,50,15,[13  3],51,-1,71,-1,56
1,<environment.Job instance at 0x7f2e863568c0>,44,17,[1 8],45,-1,74,-1,57
1,<environment.Job instance at 0x7f2e86356230>,54,2,[13  4],55,-1,59,-1,57
1,<environment.Job instance at 0x7f2e86385410>,57,13,[5 3],58,-1,71,-1,58
1,<environment.Job instance at 0x7f2e86385aa0>,56,12,[12  4],57,-1,70,-1,58
1,<environment.Job instance at 0x7f2e86385870>,58,12,[10  2],59,-1,72,-1,60
1,<environment.Job instance at 0x7f2e86385910>,60,16,[ 2 10],61,-1,77,-1,61
1,<environment.Job instance at 0x7f2e863852d0>,63,15,[4 8],64,-1,79,-1,64
1,<environment.Job instance at 0x7f2e86385460>,66,18,[5 8],67,-1,85,-1,67
1,<environment.Job instance at 0x7f2e86385500>,68,13,[5 5],69,-1,82,-1,69
1,<environment.Job instance at 0x7f2e86382690>,3,14,[ 4 11],4,-1,18,-1,4
1,<environment.Job instance at 0x7f2e86392870>,6,26,[8 5],7,-1,34,-1,8
1,<environment.Job instance at 0x7f2e86356f00>,8,18,[13  1],9,-1,27,-1,9
1,<environment.Job instance at 0x7f2e879c6eb0>,28,16,[13  1],29,-1,82,-1,66
1,<environment.Job instance at 0x7f2e879c69b0>,31,3,[11  4],32,-1,72,-1,69
1,<environment.Job instance at 0x7f2e87591050>,36,26,[9 5],37,-1,121,-1,95
1,<environment.Job instance at 0x7f2e86370a00>,47,1,[ 4 12],48,-1,115,-1,114
1,<environment.Job instance at 0x7f2e867a1b40>,50,15,[13  3],51,-1,131,-1,116
1,<environment.Job instance at 0x7f2e867a1050>,52,25,[7 5],53,-1,150,-1,125
1,<environment.Job instance at 0x7f2e867a19b0>,53,2,[14  5],54,-1,127,-1,125
1,<environment.Job instance at 0x7f2e867a17d0>,54,2,[13  4],55,-1,127,-1,125
1,<environment.Job instance at 0x7f2e867a1870>,56,12,[12  4],57,-1,137,-1,125
1,<environment.Job instance at 0x7f2e867b6a50>,65,15,[ 4 12],66,-1,174,-1,159
1,<environment.Job instance at 0x7f2e867af910>,1,18,[8 1],2,-1,21,-1,3
1,<environment.Job instance at 0x7f2e878042d0>,3,20,[8 4],4,-1,24,-1,4
1,<environment.Job instance at 0x7f2e87804730>,7,27,[8 5],8,-1,35,-1,8
1,<environment.Job instance at 0x7f2e874ff870>,9,17,[1 5],10,-1,27,-1,10
1,<environment.Job instance at 0x7f2e874ffa50>,10,13,[3 8],11,-1,24,-1,11
1,<environment.Job instance at 0x7f2e874ffd70>,11,15,[2 7],12,-1,27,-1,12
1,<environment.Job instance at 0x7f2e874ffe10>,12,17,[3 5],13,-1,30,-1,13
1,<environment.Job instance at 0x7f2e874ff0f0>,13,16,[5 2],14,-1,30,-1,14
1,<environment.Job instance at 0x7f2e874ff460>,15,13,[10  5],16,-1,29,-1,16
1,<environment.Job instance at 0x7f2e874ff370>,16,17,[7 3],17,-1,34,-1,17
1,<environment.Job instance at 0x7f2e86968fa0>,2,15,[3 9],3,-1,33,-1,18
1,<environment.Job instance at 0x7f2e8711c370>,21,17,[9 4],22,-1,39,-1,22
1,<environment.Job instance at 0x7f2e8711c3c0>,22,24,[4 6],23,-1,47,-1,23
1,<environment.Job instance at 0x7f2e8711c8c0>,30,16,[5 4],31,-1,51,-1,35
1,<environment.Job instance at 0x7f2e8711cdc0>,32,12,[5 2],33,-1,48,-1,36
1,<environment.Job instance at 0x7f2e8711c7d0>,27,18,[14  1],28,-1,60,-1,42
1,<environment.Job instance at 0x7f2e8711cf00>,34,12,[7 2],35,-1,54,-1,42
1,<environment.Job instance at 0x7f2e870f10f0>,36,15,[11  2],37,-1,57,-1,42
1,<environment.Job instance at 0x7f2e8711cb40>,31,18,[7 2],32,-1,61,-1,43
1,<environment.Job instance at 0x7f2e870f1280>,40,12,[ 3 12],41,-1,55,-1,43
1,<environment.Job instance at 0x7f2e870f1460>,42,19,[2 5],43,-1,62,-1,43
1,<environment.Job instance at 0x7f2e8711cfa0>,37,12,[7 2],38,-1,56,-1,44
1,<environment.Job instance at 0x7f2e870f1320>,41,15,[5 5],42,-1,60,-1,45
1,<environment.Job instance at 0x7f2e870f1550>,43,16,[6 1],44,-1,61,-1,45
1,<environment.Job instance at 0x7f2e870f13c0>,44,12,[7 1],45,-1,59,-1,47
1,<environment.Job instance at 0x7f2e870f11e0>,39,18,[ 5 10],40,-1,65,-1,47
1,<environment.Job instance at 0x7f2e870f19b0>,47,17,[6 2],48,-1,65,-1,48
1,<environment.Job instance at 0x7f2e870f1870>,48,16,[6 5],49,-1,65,-1,49
1,<environment.Job instance at 0x7f2e870f1b40>,50,25,[10  4],51,-1,76,-1,51
1,<environment.Job instance at 0x7f2e87837140>,55,17,[8 5],56,-1,73,-1,56
1,<environment.Job instance at 0x7f2e878370a0>,56,14,[5 7],57,-1,71,-1,57
1,<environment.Job instance at 0x7f2e87837690>,60,18,[6 4],61,-1,79,-1,61
1,<environment.Job instance at 0x7f2e87837460>,62,15,[4 9],63,-1,78,-1,63
1,<environment.Job instance at 0x7f2e878379b0>,63,18,[8 3],64,-1,82,-1,64
1,<environment.Job instance at 0x7f2e87837c30>,68,13,[7 1],69,-1,82,-1,69
1,<environment.Job instance at 0x7f2e8711ce60>,33,13,[ 3 11],34,-1,85,-1,72
1,<environment.Job instance at 0x7f2e87837a00>,65,15,[7 1],66,-1,87,-1,72
1,<environment.Job instance at 0x7f2e87837e60>,7,27,[8 5],8,-1,48,-1,21
1,<environment.Job instance at 0x7f2e867a1550>,19,2,[ 2 12],20,-1,49,-1,47
1,<environment.Job instance at 0x7f2e867a1500>,22,24,[4 6],23,-1,87,-1,63
1,<environment.Job instance at 0x7f2e867a1140>,23,15,[ 2 13],24,-1,78,-1,63
1,<environment.Job instance at 0x7f2e863701e0>,27,18,[14  1],28,-1,98,-1,80
1,<environment.Job instance at 0x7f2e86370690>,33,13,[ 3 11],34,-1,105,-1,92
1,<environment.Job instance at 0x7f2e863705f0>,36,15,[11  2],37,-1,121,-1,106
1,<environment.Job instance at 0x7f2e87591500>,40,12,[ 3 12],41,-1,133,-1,121
1,<environment.Job instance at 0x7f2e879c6cd0>,50,25,[10  4],51,-1,210,-1,185
1,<environment.Job instance at 0x7f2e86392960>,67,16,[13  1],68,-1,247,-1,231
1,<environment.Job instance at 0x7f2e86353870>,2,18,[8 1],3,-1,23,-1,5
1,<environment.Job instance at 0x7f2e86e44960>,4,14,[5 8],5,-1,20,-1,6
1,<environment.Job instance at 0x7f2e864b6730>,6,20,[10  4],7,-1,29,-1,9
1,<environment.Job instance at 0x7f2e870a1c80>,8,17,[9 2],9,-1,26,-1,9
1,<environment.Job instance at 0x7f2e86ebadc0>,12,18,[5 3],13,-1,31,-1,13
1,<environment.Job instance at 0x7f2e86ebab90>,13,27,[1 7],14,-1,41,-1,14
1,<environment.Job instance at 0x7f2e87172320>,19,15,[4 7],20,-1,35,-1,20
1,<environment.Job instance at 0x7f2e8696bf00>,20,1,[12  1],21,-1,23,-1,22
1,<environment.Job instance at 0x7f2e8696b0f0>,22,17,[5 9],23,-1,40,-1,23
1,<environment.Job instance at 0x7f2e8695fa00>,23,18,[5 5],24,-1,42,-1,24
1,<environment.Job instance at 0x7f2e8695f140>,24,15,[8 2],25,-1,40,-1,25
1,<environment.Job instance at 0x7f2e87172aa0>,21,25,[9 1],22,-1,50,-1,25
1,<environment.Job instance at 0x7f2e8696b5a0>,25,17,[6 4],26,-1,43,-1,26
1,<environment.Job instance at 0x7f2e871d0f00>,26,17,[1 6],27,-1,44,-1,27
1,<environment.Job instance at 0x7f2e871d0640>,27,18,[5 5],28,-1,46,-1,28
1,<environment.Job instance at 0x7f2e871d0dc0>,28,18,[ 3 10],29,-1,48,-1,30
1,<environment.Job instance at 0x7f2e871d01e0>,30,27,[5 4],31,-1,58,-1,31
1,<environment.Job instance at 0x7f2e871d0370>,31,28,[7 5],32,-1,60,-1,32
1,<environment.Job instance at 0x7f2e862b0a50>,33,28,[8 2],34,-1,62,-1,34
1,<environment.Job instance at 0x7f2e862b06e0>,34,16,[2 5],35,-1,51,-1,35
1,<environment.Job instance at 0x7f2e862b0af0>,35,13,[ 5 10],36,-1,49,-1,36
1,<environment.Job instance at 0x7f2e863b3690>,38,17,[5 3],39,-1,56,-1,39
1,<environment.Job instance at 0x7f2e8ff60960>,42,14,[3 8],43,-1,57,-1,43
1,<environment.Job instance at 0x7f2e8776b0a0>,43,16,[7 2],44,-1,60,-1,44
1,<environment.Job instance at 0x7f2e8776b320>,44,12,[9 3],45,-1,57,-1,45
1,<environment.Job instance at 0x7f2e8736cb40>,47,18,[2 6],48,-1,66,-1,48
1,<environment.Job instance at 0x7f2e8776b640>,48,15,[3 9],49,-1,64,-1,49
1,<environment.Job instance at 0x7f2e8617aeb0>,49,12,[10  4],50,-1,62,-1,50
1,<environment.Job instance at 0x7f2e869e1be0>,53,19,[7 1],54,-1,73,-1,54
1,<environment.Job instance at 0x7f2e869e11e0>,54,15,[10  1],55,-1,70,-1,55
1,<environment.Job instance at 0x7f2e869e1820>,55,18,[7 4],56,-1,74,-1,56
1,<environment.Job instance at 0x7f2e9051a6e0>,58,18,[ 2 10],59,-1,77,-1,59
1,<environment.Job instance at 0x7f2e867ecd20>,62,14,[4 6],63,-1,77,-1,63
1,<environment.Job instance at 0x7f2e867ec910>,63,27,[5 1],64,-1,91,-1,64
1,<environment.Job instance at 0x7f2e865e0730>,64,15,[5 5],65,-1,80,-1,65
1,<environment.Job instance at 0x7f2e865e0960>,65,14,[5 9],66,-1,80,-1,66
1,<environment.Job instance at 0x7f2e86e447d0>,1,2,[13  4],2,-1,4,-1,2
1,<environment.Job instance at 0x7f2e862b0a00>,10,27,[ 3 13],11,-1,46,-1,19
1,<environment.Job instance at 0x7f2e87443410>,13,27,[1 7],14,-1,51,-1,24
1,<environment.Job instance at 0x7f2e879c6dc0>,15,18,[ 3 12],16,-1,42,-1,24
1,<environment.Job instance at 0x7f2e879c62d0>,20,1,[12  1],21,-1,31,-1,30
1,<environment.Job instance at 0x7f2e87804870>,21,25,[9 1],22,-1,73,-1,48
1,<environment.Job instance at 0x7f2e870f1d20>,30,27,[5 4],31,-1,123,-1,96
1,<environment.Job instance at 0x7f2e870f1640>,31,28,[7 5],32,-1,124,-1,96
1,<environment.Job instance at 0x7f2e8711cb90>,33,28,[8 2],34,-1,137,-1,109
1,<environment.Job instance at 0x7f2e86ed29b0>,51,1,[ 5 14],52,-1,164,-1,163
1,<environment.Job instance at 0x7f2e8fef1c80>,60,17,[ 5 13],61,-1,206,-1,189
1,<environment.Job instance at 0x7f2e870dbeb0>,63,27,[5 1],64,-1,234,-1,207
1,<environment.Job instance at 0x7f2e870db190>,66,2,[ 5 12],67,-1,212,-1,210
1,<environment.Job instance at 0x7f2e868a7820>,3,18,[6 4],4,-1,22,-1,4
1,<environment.Job instance at 0x7f2e868a72d0>,4,18,[9 1],5,-1,23,-1,5
1,<environment.Job instance at 0x7f2e868a75f0>,8,16,[1 7],9,-1,25,-1,9
1,<environment.Job instance at 0x7f2e868a7dc0>,10,18,[2 9],11,-1,29,-1,11
1,<environment.Job instance at 0x7f2e8ffcf3c0>,13,18,[5 3],14,-1,41,-1,23
1,<environment.Job instance at 0x7f2e864a64b0>,31,17,[7 4],32,-1,52,-1,35
1,<environment.Job instance at 0x7f2e864a6aa0>,30,17,[7 1],31,-1,54,-1,37
1,<environment.Job instance at 0x7f2e864a6550>,34,12,[1 5],35,-1,49,-1,37
1,<environment.Job instance at 0x7f2e864a6910>,26,18,[5 4],27,-1,55,-1,37
1,<environment.Job instance at 0x7f2e864a65f0>,32,15,[3 6],33,-1,52,-1,37
1,<environment.Job instance at 0x7f2e864a6820>,35,18,[8 2],36,-1,55,-1,37
1,<environment.Job instance at 0x7f2e873914b0>,50,14,[10  4],51,-1,68,-1,54
1,<environment.Job instance at 0x7f2e86c460a0>,46,15,[10  2],47,-1,82,-1,67
1,<environment.Job instance at 0x7f2e87391870>,58,16,[10  1],59,-1,83,-1,67
1,<environment.Job instance at 0x7f2e873912d0>,60,18,[2 8],61,-1,85,-1,67
1,<environment.Job instance at 0x7f2e86c468c0>,45,14,[11  2],46,-1,82,-1,68
1,<environment.Job instance at 0x7f2e87391a00>,59,18,[8 2],60,-1,86,-1,68
1,<environment.Job instance at 0x7f2e8ffcfc80>,5,17,[14  4],6,-1,23,-1,6
1,<environment.Job instance at 0x7f2e86145500>,11,12,[13  5],12,-1,30,-1,18
1,<environment.Job instance at 0x7f2e86ecc460>,17,26,[3 7],18,-1,73,-1,47
1,<environment.Job instance at 0x7f2e86ecc7d0>,27,1,[ 2 11],28,-1,67,-1,66
1,<environment.Job instance at 0x7f2e8641b280>,29,25,[3 8],30,-1,92,-1,67
1,<environment.Job instance at 0x7f2e8773d050>,37,28,[4 9],38,-1,124,-1,96
1,<environment.Job instance at 0x7f2e86d1beb0>,41,18,[13  5],42,-1,118,-1,100
1,<environment.Job instance at 0x7f2e8653ac80>,45,14,[11  2],46,-1,129,-1,115
1,<environment.Job instance at 0x7f2e872615f0>,48,1,[14  2],49,-1,119,-1,118
1,<environment.Job instance at 0x7f2e86f3a140>,49,1,[ 1 11],50,-1,119,-1,118
1,<environment.Job instance at 0x7f2e877d0780>,4,21,[8 1],5,-1,26,-1,5
1,<environment.Job instance at 0x7f2e863cb690>,9,25,[ 3 10],10,-1,35,-1,10
1,<environment.Job instance at 0x7f2e86ed0960>,14,17,[5 4],15,-1,33,-1,16
1,<environment.Job instance at 0x7f2e86ed0b40>,17,23,[9 2],18,-1,41,-1,18
1,<environment.Job instance at 0x7f2e8771e190>,18,3,[6 1],19,-1,22,-1,19
1,<environment.Job instance at 0x7f2e86c6c690>,20,15,[4 8],21,-1,36,-1,21
1,<environment.Job instance at 0x7f2e86205b90>,23,17,[7 4],24,-1,41,-1,24
1,<environment.Job instance at 0x7f2e86cd4b90>,15,15,[9 4],16,-1,40,-1,25
1,<environment.Job instance at 0x7f2e86e7f370>,25,15,[9 1],26,-1,44,-1,29
1,<environment.Job instance at 0x7f2e8ffd7e60>,31,14,[1 5],32,-1,46,-1,32
1,<environment.Job instance at 0x7f2e90013690>,32,18,[ 2 10],33,-1,51,-1,33
1,<environment.Job instance at 0x7f2e86ff4730>,28,16,[6 5],29,-1,49,-1,33
1,<environment.Job instance at 0x7f2e8700e910>,34,12,[9 4],35,-1,49,-1,37
1,<environment.Job instance at 0x7f2e873d3190>,37,15,[1 6],38,-1,53,-1,38
1,<environment.Job instance at 0x7f2e873d3dc0>,36,17,[ 1 14],37,-1,57,-1,40
1,<environment.Job instance at 0x7f2e86f41910>,40,16,[3 7],41,-1,57,-1,41
1,<environment.Job instance at 0x7f2e8fefb870>,41,18,[5 5],42,-1,60,-1,42
1,<environment.Job instance at 0x7f2e8fefb780>,43,24,[4 7],44,-1,68,-1,44
1,<environment.Job instance at 0x7f2e8fefb5a0>,44,16,[4 7],45,-1,61,-1,45
1,<environment.Job instance at 0x7f2e86863af0>,48,23,[ 4 10],49,-1,72,-1,49
1,<environment.Job instance at 0x7f2e8760f0f0>,52,14,[4 9],53,-1,67,-1,53
1,<environment.Job instance at 0x7f2e86edb140>,57,18,[3 9],58,-1,78,-1,60
1,<environment.Job instance at 0x7f2e86edbc80>,62,15,[ 1 10],63,-1,78,-1,63
1,<environment.Job instance at 0x7f2e86edbb40>,63,24,[3 5],64,-1,88,-1,64
1,<environment.Job instance at 0x7f2e86edb780>,65,16,[5 5],66,-1,82,-1,66
1,<environment.Job instance at 0x7f2e86b1eeb0>,10,18,[ 2 11],11,-1,34,-1,16
1,<environment.Job instance at 0x7f2e86537550>,9,25,[ 3 10],10,-1,42,-1,17
1,<environment.Job instance at 0x7f2e873f2870>,17,23,[9 2],18,-1,64,-1,41
1,<environment.Job instance at 0x7f2e8763b5a0>,36,17,[ 1 14],37,-1,109,-1,92
1,<environment.Job instance at 0x7f2e863f9fa0>,39,18,[14  4],40,-1,112,-1,94
1,<environment.Job instance at 0x7f2e863f9c30>,43,24,[4 7],44,-1,135,-1,111
1,<environment.Job instance at 0x7f2e8fedd050>,48,23,[ 4 10],49,-1,166,-1,143
1,<environment.Job instance at 0x7f2e866aac80>,55,13,[ 3 12],56,-1,160,-1,147
1,<environment.Job instance at 0x7f2e866aa3c0>,56,13,[ 4 12],57,-1,160,-1,147
1,<environment.Job instance at 0x7f2e87912910>,63,24,[3 5],64,-1,189,-1,165
1,<environment.Job instance at 0x7f2e86e5ff50>,1,17,[4 7],2,-1,19,-1,2
1,<environment.Job instance at 0x7f2e86acd5f0>,3,17,[4 9],4,-1,21,-1,4
1,<environment.Job instance at 0x7f2e873d37d0>,8,16,[9 2],9,-1,25,-1,9
1,<environment.Job instance at 0x7f2e873d32d0>,9,24,[7 1],10,-1,34,-1,10
1,<environment.Job instance at 0x7f2e873d3a00>,10,26,[4 8],11,-1,37,-1,11
1,<environment.Job instance at 0x7f2e873d3640>,11,16,[2 7],12,-1,28,-1,12
1,<environment.Job instance at 0x7f2e873d3c30>,15,18,[6 2],16,-1,34,-1,16
1,<environment.Job instance at 0x7f2e873d35f0>,17,13,[ 5 10],18,-1,31,-1,18
1,<environment.Job instance at 0x7f2e8ff82eb0>,18,13,[ 5 10],19,-1,32,-1,19
1,<environment.Job instance at 0x7f2e8ff82c30>,20,18,[8 5],21,-1,41,-1,23
1,<environment.Job instance at 0x7f2e8ff82870>,23,18,[8 1],24,-1,42,-1,24
1,<environment.Job instance at 0x7f2e8ff828c0>,24,13,[4 6],25,-1,38,-1,25
1,<environment.Job instance at 0x7f2e8ff82410>,28,17,[10  4],29,-1,46,-1,29
1,<environment.Job instance at 0x7f2e8ff82e60>,29,15,[5 9],30,-1,45,-1,30
1,<environment.Job instance at 0x7f2e86915b40>,35,22,[1 9],36,-1,58,-1,36
1,<environment.Job instance at 0x7f2e8ff82f00>,22,18,[4 5],23,-1,56,-1,38
1,<environment.Job instance at 0x7f2e86915370>,39,18,[ 3 12],40,-1,58,-1,40
1,<environment.Job instance at 0x7f2e869158c0>,40,18,[7 3],41,-1,59,-1,41
1,<environment.Job instance at 0x7f2e86915a00>,43,17,[10  3],44,-1,61,-1,44
1,<environment.Job instance at 0x7f2e867b0b40>,46,12,[4 7],47,-1,59,-1,47
1,<environment.Job instance at 0x7f2e867b0c80>,47,15,[6 4],48,-1,63,-1,48
1,<environment.Job instance at 0x7f2e867b0460>,48,17,[3 8],49,-1,66,-1,49
1,<environment.Job instance at 0x7f2e867b07d0>,49,15,[ 5 10],50,-1,65,-1,50
1,<environment.Job instance at 0x7f2e867b0730>,50,19,[5 4],51,-1,70,-1,51
1,<environment.Job instance at 0x7f2e867b0be0>,51,17,[ 2 10],52,-1,69,-1,52
1,<environment.Job instance at 0x7f2e867b0b90>,53,18,[9 2],54,-1,72,-1,54
1,<environment.Job instance at 0x7f2e867b0a50>,54,24,[5 9],55,-1,79,-1,55
1,<environment.Job instance at 0x7f2e867b0dc0>,55,16,[10  3],56,-1,72,-1,56
1,<environment.Job instance at 0x7f2e8ff82c80>,26,13,[5 6],27,-1,70,-1,57
1,<environment.Job instance at 0x7f2e8694d370>,57,26,[8 5],58,-1,84,-1,58
1,<environment.Job instance at 0x7f2e8694deb0>,60,17,[10  1],61,-1,80,-1,63
1,<environment.Job instance at 0x7f2e8694d640>,62,13,[9 1],63,-1,76,-1,63
1,<environment.Job instance at 0x7f2e8694d5f0>,63,26,[7 5],64,-1,90,-1,64
1,<environment.Job instance at 0x7f2e8694d870>,64,16,[3 9],65,-1,81,-1,65
1,<environment.Job instance at 0x7f2e8694d690>,66,20,[3 6],67,-1,88,-1,68
1,<environment.Job instance at 0x7f2e86898730>,68,16,[3 5],69,-1,85,-1,69
1,<environment.Job instance at 0x7f2e8694d550>,9,24,[7 1],10,-1,43,-1,19
1,<environment.Job instance at 0x7f2e8694da00>,10,26,[4 8],11,-1,57,-1,31
1,<environment.Job instance at 0x7f2e8fedd050>,25,15,[12  1],26,-1,84,-1,69
1,<environment.Job instance at 0x7f2e874b1c30>,33,1,[ 3 13],34,-1,105,-1,104
1,<environment.Job instance at 0x7f2e863f91e0>,39,18,[ 3 12],40,-1,138,-1,120
1,<environment.Job instance at 0x7f2e87923500>,45,1,[ 5 13],46,-1,140,-1,139
1,<environment.Job instance at 0x7f2e86986870>,54,24,[5 9],55,-1,213,-1,189
1,<environment.Job instance at 0x7f2e873f26e0>,57,26,[8 5],58,-1,216,-1,190
1,<environment.Job instance at 0x7f2e86537550>,63,26,[7 5],64,-1,248,-1,222
1,<environment.Job instance at 0x7f2e877d0f00>,65,2,[13  2],66,-1,224,-1,222
1,<environment.Job instance at 0x7f2e860aee60>,2,18,[4 7],3,-1,21,-1,3
1,<environment.Job instance at 0x7f2e860ae820>,5,17,[9 3],6,-1,27,-1,10
1,<environment.Job instance at 0x7f2e86073c30>,11,12,[10  4],12,-1,24,-1,12
1,<environment.Job instance at 0x7f2e86073aa0>,12,1,[7 3],13,-1,14,-1,13
1,<environment.Job instance at 0x7f2e86073f50>,14,3,[3 9],15,-1,18,-1,15
1,<environment.Job instance at 0x7f2e86073e60>,9,15,[5 5],10,-1,31,-1,16
1,<environment.Job instance at 0x7f2e8702d730>,25,17,[5 9],26,-1,44,-1,27
1,<environment.Job instance at 0x7f2e8702d230>,26,23,[10  4],27,-1,50,-1,27
1,<environment.Job instance at 0x7f2e8702d8c0>,28,17,[4 9],29,-1,47,-1,30
1,<environment.Job instance at 0x7f2e8702dc80>,29,18,[9 5],30,-1,49,-1,31
1,<environment.Job instance at 0x7f2e8702d9b0>,31,17,[8 2],32,-1,50,-1,33
1,<environment.Job instance at 0x7f2e8702df00>,32,18,[10  5],33,-1,51,-1,33
1,<environment.Job instance at 0x7f2e879f8e60>,35,16,[3 8],36,-1,53,-1,37
1,<environment.Job instance at 0x7f2e879f80a0>,39,12,[5 9],40,-1,52,-1,40
1,<environment.Job instance at 0x7f2e879f8190>,41,17,[7 2],42,-1,59,-1,42
1,<environment.Job instance at 0x7f2e879f85f0>,36,14,[4 7],37,-1,57,-1,43
1,<environment.Job instance at 0x7f2e879f8370>,43,16,[3 9],44,-1,60,-1,44
1,<environment.Job instance at 0x7f2e879f8410>,44,13,[10  1],45,-1,59,-1,46
1,<environment.Job instance at 0x7f2e879f80f0>,45,13,[ 3 10],46,-1,59,-1,46
1,<environment.Job instance at 0x7f2e86c3bf50>,51,17,[3 7],52,-1,70,-1,53
1,<environment.Job instance at 0x7f2e86c3b780>,53,18,[2 6],54,-1,72,-1,54
1,<environment.Job instance at 0x7f2e86c3b8c0>,54,18,[8 2],55,-1,73,-1,55
1,<environment.Job instance at 0x7f2e86c3b0f0>,56,17,[1 6],57,-1,74,-1,57
1,<environment.Job instance at 0x7f2e86c3b550>,58,17,[3 5],59,-1,76,-1,59
1,<environment.Job instance at 0x7f2e86c3bcd0>,52,24,[11  1],53,-1,84,-1,60
1,<environment.Job instance at 0x7f2e86c3bdc0>,60,14,[6 3],61,-1,76,-1,62
1,<environment.Job instance at 0x7f2e86c3b230>,61,15,[10  5],62,-1,77,-1,62
1,<environment.Job instance at 0x7f2e86eb3190>,62,18,[10  1],63,-1,83,-1,65
1,<environment.Job instance at 0x7f2e86073cd0>,3,3,[11  3],4,-1,7,-1,4
1,<environment.Job instance at 0x7f2e87428410>,18,16,[ 5 13],19,-1,48,-1,32
1,<environment.Job instance at 0x7f2e87428aa0>,21,15,[14  4],22,-1,51,-1,36
1,<environment.Job instance at 0x7f2e8769fb40>,26,23,[10  4],27,-1,68,-1,45
1,<environment.Job instance at 0x7f2e8736ca50>,49,25,[8 3],50,-1,176,-1,151
1,<environment.Job instance at 0x7f2e86dafa50>,52,24,[11  1],53,-1,175,-1,151
1,<environment.Job instance at 0x7f2e863457d0>,1,18,[7 1],2,-1,22,-1,4
1,<environment.Job instance at 0x7f2e86345a50>,4,1,[5 8],5,-1,6,-1,5
1,<environment.Job instance at 0x7f2e86d339b0>,6,2,[5 5],7,-1,9,-1,7
1,<environment.Job instance at 0x7f2e863450f0>,7,3,[ 1 10],8,-1,11,-1,8
1,<environment.Job instance at 0x7f2e873ba320>,8,12,[10  2],9,-1,21,-1,9
1,<environment.Job instance at 0x7f2e873ba640>,9,2,[10  1],10,-1,12,-1,10
1,<environment.Job instance at 0x7f2e86b42d70>,10,3,[8 2],11,-1,14,-1,11
1,<environment.Job instance at 0x7f2e86b420a0>,11,15,[9 5],12,-1,27,-1,12
1,<environment.Job instance at 0x7f2e86b42280>,12,14,[ 1 10],13,-1,27,-1,13
1,<environment.Job instance at 0x7f2e86e07b40>,13,2,[12  1],14,-1,16,-1,14
1,<environment.Job instance at 0x7f2e86345870>,3,18,[ 3 10],4,-1,33,-1,15
1,<environment.Job instance at 0x7f2e86d33500>,15,15,[10  1],16,-1,32,-1,17
1,<environment.Job instance at 0x7f2e86b2e0a0>,17,15,[ 3 10],18,-1,33,-1,18
1,<environment.Job instance at 0x7f2e86b2e190>,18,28,[8 3],19,-1,47,-1,19
1,<environment.Job instance at 0x7f2e86b2e780>,19,20,[1 9],20,-1,40,-1,20
1,<environment.Job instance at 0x7f2e8623a690>,21,17,[5 6],22,-1,39,-1,22
1,<environment.Job instance at 0x7f2e8623a4b0>,22,16,[10  1],23,-1,39,-1,23
1,<environment.Job instance at 0x7f2e86b41f00>,16,21,[3 7],17,-1,44,-1,23
1,<environment.Job instance at 0x7f2e86b2e910>,23,17,[ 2 10],24,-1,42,-1,25
1,<environment.Job instance at 0x7f2e8621f410>,25,12,[7 2],26,-1,38,-1,26
1,<environment.Job instance at 0x7f2e876a8c80>,26,13,[ 5 11],27,-1,40,-1,27
1,<environment.Job instance at 0x7f2e870f1190>,28,15,[10  2],29,-1,45,-1,30
1,<environment.Job instance at 0x7f2e87736c30>,31,18,[4 6],32,-1,50,-1,32
1,<environment.Job instance at 0x7f2e86808050>,29,18,[3 8],30,-1,50,-1,32
1,<environment.Job instance at 0x7f2e87736eb0>,35,12,[1 9],36,-1,49,-1,37
1,<environment.Job instance at 0x7f2e902a0c30>,37,12,[ 3 10],38,-1,50,-1,38
1,<environment.Job instance at 0x7f2e902a01e0>,38,15,[8 2],39,-1,54,-1,39
1,<environment.Job instance at 0x7f2e902a0af0>,40,2,[2 9],41,-1,43,-1,41
1,<environment.Job instance at 0x7f2e902a08c0>,42,27,[9 1],43,-1,77,-1,50
1,<environment.Job instance at 0x7f2e90443f50>,49,20,[2 8],50,-1,70,-1,50
1,<environment.Job instance at 0x7f2e8ffcffa0>,51,19,[5 5],52,-1,73,-1,54
1,<environment.Job instance at 0x7f2e8760beb0>,54,13,[10  5],55,-1,68,-1,55
1,<environment.Job instance at 0x7f2e900dc3c0>,61,23,[5 9],62,-1,91,-1,68
1,<environment.Job instance at 0x7f2e90443280>,53,18,[8 1],54,-1,86,-1,68
1,<environment.Job instance at 0x7f2e900dc370>,60,18,[5 7],61,-1,86,-1,68
1,<environment.Job instance at 0x7f2e9051a3c0>,65,15,[ 4 12],66,-1,83,-1,68
1,<environment.Job instance at 0x7f2e8695fe60>,13,2,[12  1],14,-1,26,-1,24
1,<environment.Job instance at 0x7f2e8695fbe0>,14,1,[ 5 14],15,-1,25,-1,24
1,<environment.Job instance at 0x7f2e86dafa50>,18,28,[8 3],19,-1,57,-1,29
1,<environment.Job instance at 0x7f2e861eee60>,26,13,[ 5 11],27,-1,72,-1,59
1,<environment.Job instance at 0x7f2e903f48c0>,27,2,[13  1],28,-1,61,-1,59
1,<environment.Job instance at 0x7f2e8ff395f0>,34,1,[11  3],35,-1,102,-1,101
1,<environment.Job instance at 0x7f2e87428370>,41,13,[ 1 13],42,-1,145,-1,132
1,<environment.Job instance at 0x7f2e874286e0>,42,27,[9 1],43,-1,177,-1,150
1,<environment.Job instance at 0x7f2e875bbdc0>,46,21,[12  2],47,-1,173,-1,152
1,<environment.Job instance at 0x7f2e875bb8c0>,48,14,[ 1 14],49,-1,166,-1,152
1,<environment.Job instance at 0x7f2e9010bd20>,50,15,[12  3],51,-1,168,-1,153
1,<environment.Job instance at 0x7f2e866060f0>,56,2,[12  3],57,-1,170,-1,168
1,<environment.Job instance at 0x7f2e8640a230>,61,23,[5 9],62,-1,207,-1,184
1,<environment.Job instance at 0x7f2e8622cd70>,65,15,[ 4 12],66,-1,207,-1,192
1,<environment.Job instance at 0x7fbe19db2e60>,6,15,[2 8],7,-1,23,-1,8
1,<environment.Job instance at 0x7fbe19db2c80>,8,17,[1 8],9,-1,26,-1,9
1,<environment.Job instance at 0x7fbe233a28c0>,7,14,[7 5],8,-1,23,-1,9
1,<environment.Job instance at 0x7fbe19db50a0>,10,22,[8 1],11,-1,34,-1,12
1,<environment.Job instance at 0x7fbe19db5190>,12,23,[6 4],13,-1,36,-1,13
1,<environment.Job instance at 0x7fbe19db5370>,13,18,[5 9],14,-1,32,-1,14
1,<environment.Job instance at 0x7fbe19db5230>,14,21,[8 1],15,-1,38,-1,17
1,<environment.Job instance at 0x7fbe19db5500>,16,18,[7 3],17,-1,35,-1,17
1,<environment.Job instance at 0x7fbe19db5460>,18,26,[7 4],19,-1,45,-1,19
1,<environment.Job instance at 0x7fbe19db57d0>,19,25,[5 9],20,-1,45,-1,20
1,<environment.Job instance at 0x7fbe19db58c0>,21,18,[9 4],22,-1,41,-1,23
1,<environment.Job instance at 0x7fbe19db5910>,23,16,[6 2],24,-1,40,-1,24
1,<environment.Job instance at 0x7fbe19db5aa0>,22,12,[3 8],23,-1,37,-1,25
1,<environment.Job instance at 0x7fbe19db5f00>,27,17,[4 6],28,-1,45,-1,28
1,<environment.Job instance at 0x7fbe19db8230>,32,21,[5 9],33,-1,55,-1,34
1,<environment.Job instance at 0x7fbe19db84b0>,33,26,[3 6],34,-1,60,-1,34
1,<environment.Job instance at 0x7fbe19db85a0>,35,16,[1 9],36,-1,52,-1,36
1,<environment.Job instance at 0x7fbe19db85f0>,37,14,[5 8],38,-1,52,-1,38
1,<environment.Job instance at 0x7fbe19db87d0>,39,14,[9 4],40,-1,55,-1,41
1,<environment.Job instance at 0x7fbe19db8b40>,43,12,[4 5],44,-1,56,-1,44
1,<environment.Job instance at 0x7fbe19db8e10>,45,15,[7 5],46,-1,61,-1,46
1,<environment.Job instance at 0x7fbe19dba140>,47,13,[ 3 10],48,-1,61,-1,48
1,<environment.Job instance at 0x7fbe19dba280>,48,12,[9 2],49,-1,61,-1,49
1,<environment.Job instance at 0x7fbe19dba230>,49,17,[10  2],50,-1,67,-1,50
1,<environment.Job instance at 0x7fbe19dba8c0>,54,18,[7 1],55,-1,73,-1,55
1,<environment.Job instance at 0x7fbe19dba9b0>,55,12,[2 6],56,-1,68,-1,56
1,<environment.Job instance at 0x7fbe19db8a00>,40,26,[ 1 10],41,-1,84,-1,58
1,<environment.Job instance at 0x7fbe19dbe460>,67,16,[1 9],68,-1,94,-1,78
1,<environment.Job instance at 0x7fbe19dc0230>,77,16,[8 1],78,-1,94,-1,78
1,<environment.Job instance at 0x7fbe19dbe550>,12,23,[6 4],13,-1,53,-1,30
1,<environment.Job instance at 0x7fbe19dac3c0>,18,26,[7 4],19,-1,70,-1,44
1,<environment.Job instance at 0x7fbe19e08140>,19,25,[5 9],20,-1,83,-1,58
1,<environment.Job instance at 0x7fbe19da9960>,28,17,[ 1 13],29,-1,87,-1,70
1,<environment.Job instance at 0x7fbe19da95a0>,30,26,[9 4],31,-1,110,-1,84
1,<environment.Job instance at 0x7fbe19da9910>,31,1,[ 2 14],32,-1,85,-1,84
1,<environment.Job instance at 0x7fbe19ea4550>,33,26,[3 6],34,-1,110,-1,84
1,<environment.Job instance at 0x7fbe19efc0a0>,40,26,[ 1 10],41,-1,139,-1,113
1,<environment.Job instance at 0x7fbe19dda690>,57,16,[ 2 11],58,-1,183,-1,167
1,<environment.Job instance at 0x7fbe194f8780>,2,21,[4 8],3,-1,24,-1,3
1,<environment.Job instance at 0x7fbe194f8f50>,3,18,[ 3 10],4,-1,22,-1,4
1,<environment.Job instance at 0x7fbe194f8c80>,5,15,[1 7],6,-1,21,-1,6
1,<environment.Job instance at 0x7fbe194f86e0>,8,16,[4 9],9,-1,25,-1,9
1,<environment.Job instance at 0x7fbe194f0cd0>,13,25,[ 1 10],14,-1,39,-1,14
1,<environment.Job instance at 0x7fbe194d8af0>,16,18,[2 6],17,-1,35,-1,17
1,<environment.Job instance at 0x7fbe194fcc30>,21,15,[2 7],22,-1,37,-1,22
1,<environment.Job instance at 0x7fbe194fc050>,22,13,[9 4],23,-1,36,-1,23
1,<environment.Job instance at 0x7fbe194fccd0>,23,16,[1 9],24,-1,40,-1,24
1,<environment.Job instance at 0x7fbe194fc4b0>,25,16,[7 5],26,-1,42,-1,26
1,<environment.Job instance at 0x7fbe194fa320>,27,18,[5 5],28,-1,46,-1,28
1,<environment.Job instance at 0x7fbe194fa2d0>,29,27,[3 9],30,-1,57,-1,30
1,<environment.Job instance at 0x7fbe194fa7d0>,30,23,[5 1],31,-1,54,-1,31
1,<environment.Job instance at 0x7fbe194fa5a0>,31,17,[6 4],32,-1,49,-1,32
1,<environment.Job instance at 0x7fbe19444e60>,38,16,[5 2],39,-1,55,-1,39
1,<environment.Job instance at 0x7fbe194444b0>,39,28,[7 5],40,-1,68,-1,40
1,<environment.Job instance at 0x7fbe19444b90>,40,19,[ 5 12],41,-1,60,-1,41
1,<environment.Job instance at 0x7fbe194a00a0>,42,18,[7 5],43,-1,61,-1,43
1,<environment.Job instance at 0x7fbe23419f00>,50,17,[9 5],51,-1,68,-1,51
1,<environment.Job instance at 0x7fbe194fd320>,51,13,[3 8],52,-1,65,-1,52
1,<environment.Job instance at 0x7fbe1943a9b0>,52,18,[10  4],53,-1,71,-1,53
1,<environment.Job instance at 0x7fbe193b00f0>,57,28,[ 2 10],58,-1,87,-1,59
1,<environment.Job instance at 0x7fbe19349230>,70,12,[5 1],71,-1,96,-1,84
1,<environment.Job instance at 0x7fbe193473c0>,69,17,[5 7],70,-1,101,-1,84
1,<environment.Job instance at 0x7fbe193492d0>,75,17,[10  4],76,-1,101,-1,84
1,<environment.Job instance at 0x7fbe195afaf0>,9,17,[ 5 14],10,-1,34,-1,17
1,<environment.Job instance at 0x7fbe195b4780>,13,25,[ 1 10],14,-1,61,-1,36
1,<environment.Job instance at 0x7fbe19563fa0>,29,27,[3 9],30,-1,106,-1,79
1,<environment.Job instance at 0x7fbe19563c80>,30,23,[5 1],31,-1,102,-1,79
1,<environment.Job instance at 0x7fbe195c10a0>,37,3,[ 3 13],38,-1,106,-1,103
1,<environment.Job instance at 0x7fbe19567c30>,39,28,[7 5],40,-1,143,-1,115
1,<environment.Job instance at 0x7fbe19567140>,40,19,[ 5 12],41,-1,134,-1,115
1,<environment.Job instance at 0x7fbe19549460>,57,28,[ 2 10],58,-1,208,-1,180
1,<environment.Job instance at 0x7fbe1957f190>,62,15,[ 2 13],63,-1,199,-1,184
1,<environment.Job instance at 0x7fbe1956c910>,64,20,[13  4],65,-1,204,-1,184
1,<environment.Job instance at 0x7fbe19571230>,73,1,[12  5],74,-1,205,-1,204
1,<environment.Job instance at 0x7fbe23510b90>,2,20,[10  5],3,-1,25,-1,5
1,<environment.Job instance at 0x7fbe23510370>,4,14,[10  5],5,-1,19,-1,5
1,<environment.Job instance at 0x7fbe235128c0>,9,14,[ 5 10],10,-1,25,-1,11
1,<environment.Job instance at 0x7fbe23512a00>,13,24,[3 7],14,-1,38,-1,14
1,<environment.Job instance at 0x7fbe23512af0>,14,19,[3 8],15,-1,34,-1,15
1,<environment.Job instance at 0x7fbe19444cd0>,17,16,[8 4],18,-1,34,-1,18
1,<environment.Job instance at 0x7fbe23512370>,10,17,[4 7],11,-1,35,-1,18
1,<environment.Job instance at 0x7fbe19444500>,20,17,[3 5],21,-1,38,-1,21
1,<environment.Job instance at 0x7fbe19444af0>,26,17,[9 1],27,-1,45,-1,28
1,<environment.Job instance at 0x7fbe193cf690>,38,21,[2 7],39,-1,63,-1,42
1,<environment.Job instance at 0x7fbe2a1fd5f0>,30,17,[9 5],31,-1,59,-1,42
1,<environment.Job instance at 0x7fbe193cf190>,40,23,[4 7],41,-1,65,-1,42
1,<environment.Job instance at 0x7fbe23588e10>,43,14,[5 9],44,-1,58,-1,44
1,<environment.Job instance at 0x7fbe2351cc30>,45,19,[ 1 10],46,-1,66,-1,47
1,<environment.Job instance at 0x7fbe193cf820>,34,26,[3 9],35,-1,73,-1,47
1,<environment.Job instance at 0x7fbe193cfe10>,41,14,[ 1 10],42,-1,61,-1,47
1,<environment.Job instance at 0x7fbe193cffa0>,28,27,[ 3 12],29,-1,74,-1,47
1,<environment.Job instance at 0x7fbe2351c500>,46,16,[6 5],47,-1,63,-1,47
1,<environment.Job instance at 0x7fbe2351c3c0>,48,20,[ 2 10],49,-1,69,-1,49
1,<environment.Job instance at 0x7fbe2351c870>,51,17,[3 6],52,-1,69,-1,52
1,<environment.Job instance at 0x7fbe2351c280>,49,15,[5 5],50,-1,68,-1,53
1,<environment.Job instance at 0x7fbe2351b410>,54,16,[5 6],55,-1,71,-1,55
1,<environment.Job instance at 0x7fbe2351b780>,55,21,[1 6],56,-1,86,-1,65
1,<environment.Job instance at 0x7fbe2351bf50>,59,17,[8 5],60,-1,86,-1,69
1,<environment.Job instance at 0x7fbe2351b4b0>,62,15,[8 2],63,-1,89,-1,74
1,<environment.Job instance at 0x7fbe2351b690>,58,23,[1 9],59,-1,97,-1,74
1,<environment.Job instance at 0x7fbe19436c30>,65,17,[12  1],66,-1,91,-1,74
1,<environment.Job instance at 0x7fbe233f6b90>,64,15,[8 5],65,-1,89,-1,74
1,<environment.Job instance at 0x7fbe19436050>,68,19,[4 7],69,-1,93,-1,74
1,<environment.Job instance at 0x7fbe19436f00>,69,13,[4 5],70,-1,87,-1,74
1,<environment.Job instance at 0x7fbe2351bf00>,57,18,[ 1 14],58,-1,92,-1,74
1,<environment.Job instance at 0x7fbe194360a0>,73,22,[9 1],74,-1,96,-1,74
1,<environment.Job instance at 0x7fbe19436190>,70,16,[14  3],71,-1,91,-1,75
1,<environment.Job instance at 0x7fbe19436460>,67,12,[4 8],68,-1,87,-1,75
1,<environment.Job instance at 0x7fbe19436fa0>,75,18,[5 4],76,-1,94,-1,76
1,<environment.Job instance at 0x7fbe235124b0>,0,24,[1 5],1,-1,25,-1,1
1,<environment.Job instance at 0x7fbe23588be0>,6,13,[ 5 14],7,-1,20,-1,7
1,<environment.Job instance at 0x7fbe194365f0>,13,24,[3 7],14,-1,57,-1,33
1,<environment.Job instance at 0x7fbe193599b0>,28,27,[ 3 12],29,-1,95,-1,68
1,<environment.Job instance at 0x7fbe19359cd0>,32,15,[ 2 14],33,-1,85,-1,70
1,<environment.Job instance at 0x7fbe19359190>,34,26,[3 9],35,-1,114,-1,88
1,<environment.Job instance at 0x7fbe233ca410>,40,23,[4 7],41,-1,130,-1,107
1,<environment.Job instance at 0x7fbe233ca190>,50,1,[14  4],51,-1,125,-1,124
1,<environment.Job instance at 0x7fbe1935d1e0>,57,18,[ 1 14],58,-1,173,-1,155
1,<environment.Job instance at 0x7fbe1935d6e0>,58,23,[1 9],59,-1,194,-1,171
1,<environment.Job instance at 0x7fbe1935d3c0>,65,17,[12  1],66,-1,191,-1,174
1,<environment.Job instance at 0x7fbe1935dd20>,70,16,[14  3],71,-1,211,-1,195
1,<environment.Job instance at 0x7fbe23449e60>,77,2,[ 1 12],78,-1,228,-1,226
1,<environment.Job instance at 0x7fbe19ba8960>,1,13,[8 1],2,-1,16,-1,3
1,<environment.Job instance at 0x7fbe194cc820>,3,13,[9 2],4,-1,17,-1,4
1,<environment.Job instance at 0x7fbe194cc5f0>,4,13,[4 5],5,-1,18,-1,5
1,<environment.Job instance at 0x7fbe193a6410>,5,27,[6 1],6,-1,33,-1,6
1,<environment.Job instance at 0x7fbe193a6780>,7,14,[10  3],8,-1,22,-1,8
1,<environment.Job instance at 0x7fbe193a6320>,8,3,[5 1],9,-1,12,-1,9
1,<environment.Job instance at 0x7fbe193a6690>,10,13,[3 5],11,-1,24,-1,11
1,<environment.Job instance at 0x7fbe193a62d0>,11,16,[5 8],12,-1,28,-1,12
1,<environment.Job instance at 0x7fbe193a6050>,12,23,[1 8],13,-1,36,-1,13
1,<environment.Job instance at 0x7fbe19352280>,17,14,[10  5],18,-1,32,-1,18
1,<environment.Job instance at 0x7fbe1a5ffeb0>,2,12,[ 5 10],3,-1,32,-1,20
1,<environment.Job instance at 0x7fbe193522d0>,21,17,[10  2],22,-1,41,-1,24
1,<environment.Job instance at 0x7fbe19352640>,23,26,[5 3],24,-1,50,-1,24
1,<environment.Job instance at 0x7fbe19352500>,25,18,[ 1 10],26,-1,44,-1,26
1,<environment.Job instance at 0x7fbe19352910>,28,17,[1 5],29,-1,46,-1,29
1,<environment.Job instance at 0x7fbe23512690>,29,18,[5 2],30,-1,48,-1,30
1,<environment.Job instance at 0x7fbe23512780>,30,18,[5 8],31,-1,49,-1,31
1,<environment.Job instance at 0x7fbe23512eb0>,32,18,[3 8],33,-1,52,-1,34
1,<environment.Job instance at 0x7fbe23512820>,33,13,[8 3],34,-1,47,-1,34
1,<environment.Job instance at 0x7fbe1935df00>,36,17,[8 4],37,-1,55,-1,38
1,<environment.Job instance at 0x7fbe1935d960>,37,15,[3 6],38,-1,53,-1,38
1,<environment.Job instance at 0x7fbe19dbe820>,41,20,[ 4 10],42,-1,63,-1,43
1,<environment.Job instance at 0x7fbe19dbef00>,42,15,[9 2],43,-1,59,-1,44
1,<environment.Job instance at 0x7fbe19dbe7d0>,44,16,[7 5],45,-1,61,-1,45
1,<environment.Job instance at 0x7fbe19dbe140>,47,27,[9 5],48,-1,75,-1,48
1,<environment.Job instance at 0x7fbe197b0af0>,53,15,[7 2],54,-1,69,-1,54
1,<environment.Job instance at 0x7fbe197b0b90>,54,12,[8 3],55,-1,72,-1,60
1,<environment.Job instance at 0x7fbe1988cd20>,63,17,[7 4],64,-1,81,-1,64
1,<environment.Job instance at 0x7fbe193524b0>,5,27,[6 1],6,-1,41,-1,14
1,<environment.Job instance at 0x7fbe194f6140>,12,23,[1 8],13,-1,51,-1,28
1,<environment.Job instance at 0x7fbe1935de60>,23,26,[5 3],24,-1,75,-1,49
1,<environment.Job instance at 0x7fbe233ca640>,39,26,[2 8],40,-1,139,-1,113
1,<environment.Job instance at 0x7fbe23588be0>,47,27,[9 5],48,-1,174,-1,147
1,<environment.Job instance at 0x7fbe23512dc0>,49,14,[12  2],50,-1,161,-1,147
1,<environment.Job instance at 0x7fbe19996aa0>,61,17,[ 5 14],62,-1,205,-1,188
1,<environment.Job instance at 0x7fbe19996460>,62,25,[ 3 11],63,-1,213,-1,188
1,<environment.Job instance at 0x7fbe19996960>,64,17,[13  5],65,-1,208,-1,191
1,<environment.Job instance at 0x7fbe19996f00>,65,13,[ 5 14],66,-1,204,-1,191
1,<environment.Job instance at 0x7fbe1a2a2280>,0,16,[8 3],1,-1,20,-1,4
1,<environment.Job instance at 0x7fbe1a1ec690>,3,16,[ 4 10],4,-1,21,-1,5
1,<environment.Job instance at 0x7fbe1a1e7190>,5,27,[4 5],6,-1,33,-1,6
1,<environment.Job instance at 0x7fbe1a206690>,12,20,[4 9],13,-1,34,-1,14
1,<environment.Job instance at 0x7fbe1a200b90>,22,17,[5 9],23,-1,40,-1,23
1,<environment.Job instance at 0x7fbe1a1feaf0>,24,21,[4 9],25,-1,55,-1,34
1,<environment.Job instance at 0x7fbe19c17960>,30,14,[2 9],31,-1,48,-1,34
1,<environment.Job instance at 0x7fbe197e2f50>,38,12,[6 4],39,-1,51,-1,39
1,<environment.Job instance at 0x7fbe1a8c5820>,40,26,[8 3],41,-1,67,-1,41
1,<environment.Job instance at 0x7fbe197fb870>,28,12,[14  3],29,-1,53,-1,41
1,<environment.Job instance at 0x7fbe197d5780>,43,3,[4 6],44,-1,47,-1,44
1,<environment.Job instance at 0x7fbe1a8c5f50>,44,14,[3 8],45,-1,59,-1,45
1,<environment.Job instance at 0x7fbe1a8e76e0>,34,16,[5 2],35,-1,62,-1,46
1,<environment.Job instance at 0x7fbe1a8cc140>,46,18,[8 3],47,-1,65,-1,47
1,<environment.Job instance at 0x7fbe1a8c5af0>,45,13,[9 1],46,-1,63,-1,50
1,<environment.Job instance at 0x7fbe1a8cc5a0>,50,12,[3 8],51,-1,63,-1,51
1,<environment.Job instance at 0x7fbe1a8e42d0>,37,14,[3 6],38,-1,66,-1,52
1,<environment.Job instance at 0x7fbe1a8cc8c0>,52,14,[2 8],53,-1,67,-1,53
1,<environment.Job instance at 0x7fbe1a8cc410>,51,18,[5 8],52,-1,71,-1,53
1,<environment.Job instance at 0x7fbe19aa79b0>,60,16,[ 4 10],61,-1,78,-1,62
1,<environment.Job instance at 0x7fbe1a8e4af0>,36,25,[2 8],37,-1,87,-1,62
1,<environment.Job instance at 0x7fbe19aa75a0>,55,15,[1 5],56,-1,78,-1,63
1,<environment.Job instance at 0x7fbe19aa7aa0>,64,17,[6 1],65,-1,82,-1,65
1,<environment.Job instance at 0x7fbe19aa7e10>,65,17,[12  4],66,-1,83,-1,66
1,<environment.Job instance at 0x7fbe19aa7640>,57,13,[ 5 10],58,-1,80,-1,67
1,<environment.Job instance at 0x7fbe19aa7a00>,61,15,[5 7],62,-1,82,-1,67
1,<environment.Job instance at 0x7fbe19aa8140>,69,18,[10  4],70,-1,89,-1,71
1,<environment.Job instance at 0x7fbe19aa7d20>,66,17,[7 4],67,-1,91,-1,74
1,<environment.Job instance at 0x7fbe19aa85a0>,74,18,[10  5],75,-1,93,-1,75
1,<environment.Job instance at 0x7fbe19aa8aa0>,78,15,[10  4],79,-1,94,-1,79
1,<environment.Job instance at 0x7fbe197d7780>,5,27,[4 5],6,-1,34,-1,7
1,<environment.Job instance at 0x7fbe1a2065f0>,7,12,[13  4],8,-1,20,-1,8
1,<environment.Job instance at 0x7fbe19803c30>,8,12,[ 5 12],9,-1,21,-1,9
1,<environment.Job instance at 0x7fbe19996aa0>,27,13,[12  1],28,-1,52,-1,39
1,<environment.Job instance at 0x7fbe19996e60>,28,12,[14  3],29,-1,51,-1,39
1,<environment.Job instance at 0x7fbe19996190>,29,1,[ 4 11],30,-1,40,-1,39
1,<environment.Job instance at 0x7fbe19996230>,36,25,[2 8],37,-1,84,-1,59
1,<environment.Job instance at 0x7fbe19996820>,40,26,[8 3],41,-1,99,-1,73
1,<environment.Job instance at 0x7fbe233ca1e0>,54,2,[11  3],55,-1,112,-1,110
1,<environment.Job instance at 0x7fbe1935db40>,65,17,[12  4],66,-1,171,-1,154
1,<environment.Job instance at 0x7fbe19352960>,77,2,[ 3 11],78,-1,220,-1,218
1,<environment.Job instance at 0x7fbe197d3b40>,0,16,[8 5],1,-1,17,-1,1
1,<environment.Job instance at 0x7fbe197d3e60>,1,16,[4 5],2,-1,18,-1,2
1,<environment.Job instance at 0x7fbe197d35a0>,2,27,[8 3],3,-1,30,-1,3
1,<environment.Job instance at 0x7fbe197d3690>,3,18,[1 6],4,-1,22,-1,4
1,<environment.Job instance at 0x7fbe197d3af0>,4,17,[2 6],5,-1,22,-1,5
1,<environment.Job instance at 0x7fbe197d3780>,6,27,[2 6],7,-1,34,-1,7
1,<environment.Job instance at 0x7fbe197d3280>,7,16,[7 4],8,-1,24,-1,8
1,<environment.Job instance at 0x7fbe197d3410>,8,16,[9 2],9,-1,27,-1,11
1,<environment.Job instance at 0x7fbe197d35f0>,11,16,[4 5],12,-1,28,-1,12
1,<environment.Job instance at 0x7fbe197d3050>,15,14,[6 1],16,-1,30,-1,16
1,<environment.Job instance at 0x7fbe197d3f00>,10,14,[ 4 14],11,-1,34,-1,20
1,<environment.Job instance at 0x7fbe197d34b0>,20,12,[10  5],21,-1,35,-1,23
1,<environment.Job instance at 0x7fbe1a1a2640>,22,16,[6 4],23,-1,39,-1,23
1,<environment.Job instance at 0x7fbe1a1a2690>,26,21,[ 4 10],27,-1,48,-1,27
1,<environment.Job instance at 0x7fbe1a1a2c30>,27,23,[2 8],28,-1,51,-1,28
1,<environment.Job instance at 0x7fbe1a1d40f0>,35,17,[ 5 10],36,-1,53,-1,36
1,<environment.Job instance at 0x7fbe1a1d4870>,36,14,[9 4],37,-1,53,-1,39
1,<environment.Job instance at 0x7fbe1a1d45f0>,40,25,[6 4],41,-1,66,-1,41
1,<environment.Job instance at 0x7fbe1a1d4960>,43,13,[ 4 10],44,-1,57,-1,44
1,<environment.Job instance at 0x7fbe1a1d4640>,44,24,[5 5],45,-1,69,-1,45
1,<environment.Job instance at 0x7fbe1a1b59b0>,47,1,[4 6],48,-1,49,-1,48
1,<environment.Job instance at 0x7fbe1a1b5870>,48,28,[ 5 10],49,-1,77,-1,49
1,<environment.Job instance at 0x7fbe1a1d42d0>,38,14,[8 2],39,-1,63,-1,49
1,<environment.Job instance at 0x7fbe1a1b52d0>,49,15,[9 5],50,-1,65,-1,50
1,<environment.Job instance at 0x7fbe1a1b5460>,51,17,[7 5],52,-1,69,-1,52
1,<environment.Job instance at 0x7fbe1a1b5c80>,55,14,[3 8],56,-1,70,-1,56
1,<environment.Job instance at 0x7fbe1a1b5d70>,58,15,[2 9],59,-1,82,-1,67
1,<environment.Job instance at 0x7fbe1982e5a0>,66,12,[10  2],67,-1,80,-1,68
1,<environment.Job instance at 0x7fbe1982ee10>,68,13,[8 3],69,-1,83,-1,70
1,<environment.Job instance at 0x7fbe1982e320>,70,12,[3 7],71,-1,83,-1,71
1,<environment.Job instance at 0x7fbe1982e4b0>,75,20,[7 5],76,-1,102,-1,82
1,<environment.Job instance at 0x7fbe1a1a2280>,2,27,[8 3],3,-1,44,-1,17
1,<environment.Job instance at 0x7fbe1a1d4d70>,6,27,[2 6],7,-1,44,-1,17
1,<environment.Job instance at 0x7fbe1a1b5960>,10,14,[ 4 14],11,-1,31,-1,17
1,<environment.Job instance at 0x7fbe1a200910>,28,3,[11  1],29,-1,72,-1,69
1,<environment.Job instance at 0x7fbe1a8d0aa0>,29,19,[13  3],30,-1,88,-1,69
1,<environment.Job instance at 0x7fbe1a200af0>,27,23,[2 8],28,-1,92,-1,69
1,<environment.Job instance at 0x7fbe19c413c0>,34,13,[ 4 11],35,-1,96,-1,83
1,<environment.Job instance at 0x7fbe19c41a50>,39,17,[12  4],40,-1,113,-1,96
1,<environment.Job instance at 0x7fbe19c41be0>,40,25,[6 4],41,-1,122,-1,97
1,<environment.Job instance at 0x7fbe19c415f0>,42,3,[14  5],43,-1,100,-1,97
1,<environment.Job instance at 0x7fbe19c41e10>,44,24,[5 5],45,-1,133,-1,109
1,<environment.Job instance at 0x7fbe19c41690>,48,28,[ 5 10],49,-1,153,-1,125
1,<environment.Job instance at 0x7fbe19bba140>,56,12,[ 5 12],57,-1,153,-1,141
1,<environment.Job instance at 0x7fbe198038c0>,59,2,[ 5 14],60,-1,149,-1,147
1,<environment.Job instance at 0x7fbe19803640>,71,16,[ 1 14],72,-1,220,-1,204
1,<environment.Job instance at 0x7fbe19471d70>,7,18,[8 2],8,-1,26,-1,8
1,<environment.Job instance at 0x7fbe19471910>,12,17,[4 5],13,-1,30,-1,13
1,<environment.Job instance at 0x7fbe19483820>,13,14,[9 3],14,-1,30,-1,16
1,<environment.Job instance at 0x7fbe19483500>,16,16,[1 9],17,-1,33,-1,17
1,<environment.Job instance at 0x7fbe19483410>,17,16,[7 2],18,-1,34,-1,18
1,<environment.Job instance at 0x7fbe194490a0>,20,1,[4 8],21,-1,22,-1,21
1,<environment.Job instance at 0x7fbe19483d20>,15,17,[8 2],16,-1,38,-1,21
1,<environment.Job instance at 0x7fbe194491e0>,22,16,[10  4],23,-1,40,-1,24
1,<environment.Job instance at 0x7fbe19449780>,23,16,[6 5],24,-1,40,-1,24
1,<environment.Job instance at 0x7fbe19449230>,24,16,[9 5],25,-1,42,-1,26
1,<environment.Job instance at 0x7fbe19449820>,26,22,[1 8],27,-1,50,-1,28
1,<environment.Job instance at 0x7fbe1a279780>,27,28,[5 9],28,-1,57,-1,29
1,<environment.Job instance at 0x7fbe199525f0>,29,18,[5 8],30,-1,48,-1,30
1,<environment.Job instance at 0x7fbe19bec820>,32,13,[1 5],33,-1,46,-1,33
1,<environment.Job instance at 0x7fbe19bd9e10>,30,18,[ 2 10],31,-1,54,-1,36
1,<environment.Job instance at 0x7fbe1a235690>,36,18,[ 5 10],37,-1,55,-1,37
1,<environment.Job instance at 0x7fbe1944fcd0>,37,28,[9 1],38,-1,66,-1,38
1,<environment.Job instance at 0x7fbe1944f410>,38,13,[9 1],39,-1,55,-1,42
1,<environment.Job instance at 0x7fbe19bd3690>,42,26,[5 8],43,-1,69,-1,43
1,<environment.Job instance at 0x7fbe19be1500>,48,15,[2 8],49,-1,64,-1,49
1,<environment.Job instance at 0x7fbe19be15a0>,49,18,[1 7],50,-1,68,-1,50
1,<environment.Job instance at 0x7fbe1a247a50>,41,14,[9 2],42,-1,65,-1,51
1,<environment.Job instance at 0x7fbe19be1e60>,52,17,[8 1],53,-1,71,-1,54
1,<environment.Job instance at 0x7fbe19be1640>,54,12,[3 9],55,-1,67,-1,55
1,<environment.Job instance at 0x7fbe19be1910>,55,18,[4 6],56,-1,74,-1,56
1,<environment.Job instance at 0x7fbe19be1c80>,53,22,[3 5],54,-1,78,-1,56
1,<environment.Job instance at 0x7fbe196d60f0>,59,18,[3 8],60,-1,79,-1,61
1,<environment.Job instance at 0x7fbe196d6500>,62,21,[5 7],63,-1,84,-1,63
1,<environment.Job instance at 0x7fbe196d6870>,65,16,[4 7],66,-1,82,-1,66
1,<environment.Job instance at 0x7fbe196d6a00>,66,18,[9 3],67,-1,85,-1,67
1,<environment.Job instance at 0x7fbe196d6aa0>,68,16,[1 7],69,-1,85,-1,69
1,<environment.Job instance at 0x7fbe196d6910>,69,18,[8 2],70,-1,88,-1,70
1,<environment.Job instance at 0x7fbe196d6c30>,73,17,[4 7],74,-1,91,-1,74
1,<environment.Job instance at 0x7fbe196e0140>,74,16,[ 5 10],75,-1,91,-1,75
1,<environment.Job instance at 0x7fbe196e00a0>,75,15,[5 9],76,-1,91,-1,76
1,<environment.Job instance at 0x7fbe196d6320>,60,22,[7 1],61,-1,101,-1,79
1,<environment.Job instance at 0x7fbe19be1690>,4,17,[14  5],5,-1,22,-1,5
1,<environment.Job instance at 0x7fbe19803af0>,11,2,[14  5],12,-1,21,-1,19
1,<environment.Job instance at 0x7fbe19aa7550>,27,28,[5 9],28,-1,100,-1,72
1,<environment.Job instance at 0x7fbe19cf3050>,37,28,[9 1],38,-1,145,-1,117
1,<environment.Job instance at 0x7fbe19313fa0>,42,26,[5 8],43,-1,173,-1,147
1,<environment.Job instance at 0x7fbe1982ea50>,46,2,[ 5 13],47,-1,149,-1,147
1,<environment.Job instance at 0x7fbe1982e550>,51,1,[13  4],52,-1,163,-1,162
1,<environment.Job instance at 0x7fbe1a1b5f00>,58,2,[12  3],59,-1,180,-1,178
1,<environment.Job instance at 0x7fbe1a1b52d0>,57,28,[ 5 10],58,-1,257,-1,229
1,<environment.Job instance at 0x7fbe19bfe6e0>,0,26,[3 7],1,-1,27,-1,1
1,<environment.Job instance at 0x7fbe1949cf00>,4,16,[1 5],5,-1,22,-1,6
1,<environment.Job instance at 0x7fbe1949c190>,7,18,[10  5],8,-1,26,-1,8
1,<environment.Job instance at 0x7fbe1949c690>,10,13,[10  1],11,-1,24,-1,11
1,<environment.Job instance at 0x7fbe1949c910>,12,24,[1 9],13,-1,37,-1,13
1,<environment.Job instance at 0x7fbe1949ce10>,14,12,[9 3],15,-1,27,-1,15
1,<environment.Job instance at 0x7fbe1949cc80>,16,12,[10  1],17,-1,29,-1,17
1,<environment.Job instance at 0x7fbe199ec8c0>,20,17,[5 6],21,-1,38,-1,21
1,<environment.Job instance at 0x7fbe199ecb90>,21,27,[7 1],22,-1,49,-1,22
1,<environment.Job instance at 0x7fbe199ec230>,22,26,[ 3 10],23,-1,49,-1,23
1,<environment.Job instance at 0x7fbe199ec050>,25,21,[ 2 10],26,-1,47,-1,26
1,<environment.Job instance at 0x7fbe199eca50>,26,15,[10  2],27,-1,42,-1,27
1,<environment.Job instance at 0x7fbe199ec780>,28,12,[ 2 11],29,-1,41,-1,29
1,<environment.Job instance at 0x7fbe199eceb0>,29,13,[4 7],30,-1,43,-1,30
1,<environment.Job instance at 0x7fbe199ec190>,30,16,[10  1],31,-1,47,-1,31
1,<environment.Job instance at 0x7fbe199ecc80>,31,17,[11  3],32,-1,49,-1,32
1,<environment.Job instance at 0x7fbe195276e0>,39,15,[ 3 10],40,-1,55,-1,40
1,<environment.Job instance at 0x7fbe19527dc0>,40,17,[10  2],41,-1,58,-1,41
1,<environment.Job instance at 0x7fbe195270f0>,43,24,[2 6],44,-1,68,-1,44
1,<environment.Job instance at 0x7fbe195271e0>,44,13,[ 5 12],45,-1,58,-1,45
1,<environment.Job instance at 0x7fbe19527230>,46,14,[8 4],47,-1,61,-1,47
1,<environment.Job instance at 0x7fbe1a1f7190>,47,14,[9 2],48,-1,62,-1,48
1,<environment.Job instance at 0x7fbe1a1f7280>,50,14,[5 8],51,-1,65,-1,51
1,<environment.Job instance at 0x7fbe1a1f7a00>,52,18,[6 2],53,-1,71,-1,53
1,<environment.Job instance at 0x7fbe1a1f7820>,54,18,[6 2],55,-1,73,-1,55
1,<environment.Job instance at 0x7fbe1a1f7e10>,55,19,[6 3],56,-1,75,-1,56
1,<environment.Job instance at 0x7fbe1a1f7550>,61,14,[3 6],62,-1,76,-1,62
1,<environment.Job instance at 0x7fbe19627140>,62,27,[5 7],63,-1,90,-1,63
1,<environment.Job instance at 0x7fbe196270a0>,65,16,[9 2],66,-1,85,-1,69
1,<environment.Job instance at 0x7fbe199ec0a0>,0,26,[3 7],1,-1,27,-1,1
1,<environment.Job instance at 0x7fbe199ec550>,1,18,[11  5],2,-1,20,-1,2
1,<environment.Job instance at 0x7fbe1a1f7af0>,9,1,[12  2],10,-1,16,-1,15
1,<environment.Job instance at 0x7fbe19627550>,12,24,[1 9],13,-1,52,-1,28
1,<environment.Job instance at 0x7fbe1a1b5f50>,21,27,[7 1],22,-1,81,-1,54
1,<environment.Job instance at 0x7fbe1a1b5500>,22,26,[ 3 10],23,-1,80,-1,54
1,<environment.Job instance at 0x7fbe1a1b5960>,23,2,[ 3 13],24,-1,56,-1,54
1,<environment.Job instance at 0x7fbe1982e410>,27,1,[ 3 14],28,-1,56,-1,55
1,<environment.Job instance at 0x7fbe1982edc0>,28,12,[ 2 11],29,-1,67,-1,55
1,<environment.Job instance at 0x7fbe19e5c8c0>,31,17,[11  3],32,-1,82,-1,65
1,<environment.Job instance at 0x7fbe1982eb40>,32,16,[12  1],33,-1,81,-1,65
1,<environment.Job instance at 0x7fbe194f65f0>,33,15,[ 4 13],34,-1,80,-1,65
1,<environment.Job instance at 0x7fbe19be1910>,43,24,[2 6],44,-1,134,-1,110
1,<environment.Job instance at 0x7fbe19be1fa0>,44,13,[ 5 12],45,-1,123,-1,110
1,<environment.Job instance at 0x7fbe19fca640>,45,2,[ 2 11],46,-1,112,-1,110
1,<environment.Job instance at 0x7fbe19b7d140>,62,27,[5 7],63,-1,211,-1,184
1,<environment.Job instance at 0x7fbe19b7ddc0>,64,24,[13  2],65,-1,208,-1,184
1,<environment.Job instance at 0x7fbe19b7dd20>,68,15,[11  4],69,-1,218,-1,203
1,<environment.Job instance at 0x7fbe19b7de60>,71,14,[ 4 13],72,-1,232,-1,218
1,<environment.Job instance at 0x7fbe1910b370>,1,18,[4 9],2,-1,20,-1,2
1,<environment.Job instance at 0x7fbe1910bc80>,6,16,[8 2],7,-1,23,-1,7
1,<environment.Job instance at 0x7fbe1910bc30>,7,14,[11  4],8,-1,22,-1,8
1,<environment.Job instance at 0x7fbe1910bd20>,8,14,[8 5],9,-1,23,-1,9
1,<environment.Job instance at 0x7fbe1910b4b0>,9,16,[7 4],10,-1,26,-1,10
1,<environment.Job instance at 0x7fbe1910b550>,10,18,[ 4 11],11,-1,29,-1,11
1,<environment.Job instance at 0x7fbe1910b2d0>,11,18,[ 3 10],12,-1,30,-1,12
1,<environment.Job instance at 0x7fbe1910b0f0>,13,24,[8 5],14,-1,38,-1,14
1,<environment.Job instance at 0x7fbe1910b190>,14,14,[ 1 10],15,-1,29,-1,15
1,<environment.Job instance at 0x7fbe1910b3c0>,15,13,[5 7],16,-1,29,-1,16
1,<environment.Job instance at 0x7fbe19169410>,21,15,[8 1],22,-1,37,-1,22
1,<environment.Job instance at 0x7fbe191693c0>,22,16,[5 4],23,-1,39,-1,23
1,<environment.Job instance at 0x7fbe191699b0>,23,15,[ 3 10],24,-1,39,-1,24
1,<environment.Job instance at 0x7fbe19169aa0>,25,15,[5 6],26,-1,41,-1,26
1,<environment.Job instance at 0x7fbe191692d0>,27,14,[7 2],28,-1,43,-1,29
1,<environment.Job instance at 0x7fbe19169050>,29,1,[5 5],30,-1,31,-1,30
1,<environment.Job instance at 0x7fbe19169b40>,30,16,[5 4],31,-1,47,-1,31
1,<environment.Job instance at 0x7fbe19169230>,31,17,[ 4 10],32,-1,49,-1,32
1,<environment.Job instance at 0x7fbe19169be0>,33,14,[ 5 13],34,-1,48,-1,34
1,<environment.Job instance at 0x7fbe19169f00>,34,17,[3 5],35,-1,52,-1,35
1,<environment.Job instance at 0x7fbe19169910>,36,14,[6 5],37,-1,51,-1,37
1,<environment.Job instance at 0x7fbe19169870>,37,21,[4 8],38,-1,59,-1,38
1,<environment.Job instance at 0x7fbe1a8e41e0>,38,23,[3 9],39,-1,62,-1,39
1,<environment.Job instance at 0x7fbe1922aeb0>,39,13,[10  5],40,-1,53,-1,40
1,<environment.Job instance at 0x7fbe1922a460>,41,13,[2 5],42,-1,55,-1,42
1,<environment.Job instance at 0x7fbe1922a0f0>,42,14,[2 6],43,-1,57,-1,43
1,<environment.Job instance at 0x7fbe1922ad20>,44,18,[6 4],45,-1,63,-1,45
1,<environment.Job instance at 0x7fbe1922a050>,45,15,[4 7],46,-1,61,-1,46
1,<environment.Job instance at 0x7fbe1922a730>,46,12,[1 7],47,-1,59,-1,47
1,<environment.Job instance at 0x7fbe1922a5a0>,47,17,[8 4],48,-1,65,-1,48
1,<environment.Job instance at 0x7fbe1922a280>,48,16,[1 7],49,-1,65,-1,49
1,<environment.Job instance at 0x7fbe1922aaf0>,49,15,[ 2 10],50,-1,65,-1,50
1,<environment.Job instance at 0x7fbe191691e0>,28,20,[3 9],29,-1,80,-1,60
1,<environment.Job instance at 0x7fbe1920a050>,61,16,[8 4],62,-1,78,-1,62
1,<environment.Job instance at 0x7fbe23447a50>,72,12,[4 7],73,-1,85,-1,73
1,<environment.Job instance at 0x7fbe23447eb0>,73,15,[6 2],74,-1,89,-1,74
1,<environment.Job instance at 0x7fbe23447b40>,75,21,[9 5],76,-1,97,-1,76
1,<environment.Job instance at 0x7fbe199a9d20>,76,18,[10  5],77,-1,95,-1,77
1,<environment.Job instance at 0x7fbe1a16e550>,78,12,[7 5],79,-1,91,-1,79
1,<environment.Job instance at 0x7fbe23447190>,7,14,[11  4],8,-1,22,-1,8
1,<environment.Job instance at 0x7fbe1959b4b0>,10,18,[ 4 11],11,-1,38,-1,20
1,<environment.Job instance at 0x7fbe1a0767d0>,13,24,[8 5],14,-1,55,-1,31
1,<environment.Job instance at 0x7fbe1a182280>,18,13,[12  1],19,-1,60,-1,47
1,<environment.Job instance at 0x7fbe1a0792d0>,26,3,[14  2],27,-1,79,-1,76
1,<environment.Job instance at 0x7fbe1a075280>,33,14,[ 5 13],34,-1,106,-1,92
1,<environment.Job instance at 0x7fbe1a075c30>,38,23,[3 9],39,-1,133,-1,110
1,<environment.Job instance at 0x7fbe19edf780>,50,2,[ 1 11],51,-1,170,-1,168
1,<environment.Job instance at 0x7fbe19ee01e0>,57,12,[ 3 14],58,-1,201,-1,189
1,<environment.Job instance at 0x7fbe1a191500>,68,16,[13  3],69,-1,227,-1,211
1,<environment.Job instance at 0x7fbe19783e10>,1,16,[1 6],2,-1,18,-1,2
1,<environment.Job instance at 0x7fbe19783960>,3,27,[3 5],4,-1,31,-1,4
1,<environment.Job instance at 0x7fbe19783eb0>,7,17,[5 7],8,-1,25,-1,8
1,<environment.Job instance at 0x7fbe194fcf50>,13,12,[9 3],14,-1,26,-1,14
1,<environment.Job instance at 0x7fbe194fc230>,16,12,[6 4],17,-1,29,-1,17
1,<environment.Job instance at 0x7fbe194fc500>,17,17,[2 6],18,-1,35,-1,18
1,<environment.Job instance at 0x7fbe194fcf00>,18,17,[5 4],19,-1,36,-1,19
1,<environment.Job instance at 0x7fbe194fc9b0>,20,16,[9 4],21,-1,37,-1,21
1,<environment.Job instance at 0x7fbe194fc820>,23,13,[5 6],24,-1,37,-1,24
1,<environment.Job instance at 0x7fbe194fcdc0>,25,18,[3 9],26,-1,44,-1,26
1,<environment.Job instance at 0x7fbe194fcc80>,26,27,[10  4],27,-1,54,-1,27
1,<environment.Job instance at 0x7fbe19571cd0>,28,14,[4 5],29,-1,43,-1,29
1,<environment.Job instance at 0x7fbe19571c30>,29,14,[9 4],30,-1,44,-1,30
1,<environment.Job instance at 0x7fbe19571e10>,31,18,[4 8],32,-1,50,-1,32
1,<environment.Job instance at 0x7fbe195712d0>,32,25,[7 3],33,-1,58,-1,33
1,<environment.Job instance at 0x7fbe19571550>,36,17,[2 9],37,-1,54,-1,37
1,<environment.Job instance at 0x7fbe19571fa0>,38,13,[ 3 10],39,-1,52,-1,39
1,<environment.Job instance at 0x7fbe19571410>,39,14,[4 7],40,-1,54,-1,40
1,<environment.Job instance at 0x7fbe19571eb0>,40,16,[10  3],41,-1,58,-1,42
1,<environment.Job instance at 0x7fbe19571b90>,41,17,[10  5],42,-1,59,-1,42
1,<environment.Job instance at 0x7fbe22f67af0>,46,13,[8 5],47,-1,62,-1,49
1,<environment.Job instance at 0x7fbe22f67280>,49,18,[5 2],50,-1,68,-1,50
1,<environment.Job instance at 0x7fbe22f67460>,48,14,[13  2],49,-1,68,-1,54
1,<environment.Job instance at 0x7fbe22f67fa0>,54,12,[3 7],55,-1,68,-1,56
1,<environment.Job instance at 0x7fbe22f673c0>,55,12,[3 7],56,-1,69,-1,57
1,<environment.Job instance at 0x7fbe22f671e0>,57,16,[2 7],58,-1,74,-1,58
1,<environment.Job instance at 0x7fbe1a1a65f0>,58,15,[6 2],59,-1,74,-1,59
1,<environment.Job instance at 0x7fbe1a1a6550>,59,14,[7 2],60,-1,74,-1,60
1,<environment.Job instance at 0x7fbe1a1a66e0>,60,18,[1 7],61,-1,79,-1,61
1,<environment.Job instance at 0x7fbe1a1a6d70>,61,14,[1 7],62,-1,76,-1,62
1,<environment.Job instance at 0x7fbe1a1a6be0>,62,14,[8 5],63,-1,77,-1,63
1,<environment.Job instance at 0x7fbe1a1a6a50>,66,20,[4 8],67,-1,91,-1,71
1,<environment.Job instance at 0x7fbe1a1a6e60>,71,21,[5 5],72,-1,93,-1,72
1,<environment.Job instance at 0x7fbe1a1a64b0>,70,25,[5 4],71,-1,101,-1,76
1,<environment.Job instance at 0x7fbe1a1a6b40>,65,26,[4 8],66,-1,108,-1,82
1,<environment.Job instance at 0x7fbe19507f50>,77,22,[5 8],78,-1,108,-1,86
1,<environment.Job instance at 0x7fbe194fc410>,4,1,[12  4],5,-1,6,-1,5
1,<environment.Job instance at 0x7fbe22f67910>,5,2,[14  1],6,-1,8,-1,6
1,<environment.Job instance at 0x7fbe19571820>,3,27,[3 5],4,-1,40,-1,13
1,<environment.Job instance at 0x7fbe1949bbe0>,26,27,[10  4],27,-1,98,-1,71
1,<environment.Job instance at 0x7fbe19ee0a00>,30,1,[ 5 11],31,-1,73,-1,72
1,<environment.Job instance at 0x7fbe1a06fcd0>,32,25,[7 3],33,-1,127,-1,102
1,<environment.Job instance at 0x7fbe19ee3460>,34,13,[ 3 12],35,-1,115,-1,102
1,<environment.Job instance at 0x7fbe1a075960>,48,14,[13  2],49,-1,177,-1,163
1,<environment.Job instance at 0x7fbe1a182cd0>,65,26,[4 8],66,-1,251,-1,225
1,<environment.Job instance at 0x7fbe1959b500>,70,25,[5 4],71,-1,256,-1,231
1,<environment.Job instance at 0x7fbe23447910>,75,25,[5 7],76,-1,270,-1,245
1,<environment.Job instance at 0x7fbe1a98f550>,3,27,[8 5],4,-1,31,-1,4
1,<environment.Job instance at 0x7fbe1a463c30>,13,24,[3 5],14,-1,38,-1,14
1,<environment.Job instance at 0x7fbe1a463820>,14,14,[4 6],15,-1,29,-1,15
1,<environment.Job instance at 0x7fbe1a463d70>,15,14,[10  1],16,-1,31,-1,17
1,<environment.Job instance at 0x7fbe1a4631e0>,17,17,[2 7],18,-1,35,-1,18
1,<environment.Job instance at 0x7fbe1a463cd0>,18,15,[5 5],19,-1,34,-1,19
1,<environment.Job instance at 0x7fbe1a4630a0>,21,18,[5 9],22,-1,40,-1,22
1,<environment.Job instance at 0x7fbe1a463050>,23,18,[3 7],24,-1,42,-1,24
1,<environment.Job instance at 0x7fbe1a463690>,24,27,[1 8],25,-1,52,-1,25
1,<environment.Job instance at 0x7fbe1a0b4e10>,30,18,[2 7],31,-1,49,-1,31
1,<environment.Job instance at 0x7fbe1a0b48c0>,31,15,[6 3],32,-1,47,-1,32
1,<environment.Job instance at 0x7fbe1a0b4cd0>,33,13,[5 2],34,-1,47,-1,34
1,<environment.Job instance at 0x7fbe1a0b4320>,34,23,[4 5],35,-1,58,-1,35
1,<environment.Job instance at 0x7fbe1a0b4410>,35,13,[8 4],36,-1,49,-1,36
1,<environment.Job instance at 0x7fbe1a0b4eb0>,36,13,[6 5],37,-1,50,-1,37
1,<environment.Job instance at 0x7fbe1a0b40f0>,39,18,[7 4],40,-1,58,-1,40
1,<environment.Job instance at 0x7fbe1a463eb0>,16,15,[3 6],17,-1,58,-1,43
1,<environment.Job instance at 0x7fbe196948c0>,44,18,[3 6],45,-1,63,-1,45
1,<environment.Job instance at 0x7fbe19694190>,46,26,[8 5],47,-1,75,-1,49
1,<environment.Job instance at 0x7fbe19694f50>,48,18,[13  1],49,-1,74,-1,56
1,<environment.Job instance at 0x7fbe19694af0>,50,17,[5 8],51,-1,76,-1,59
1,<environment.Job instance at 0x7fbe19694b90>,56,14,[10  1],57,-1,74,-1,60
1,<environment.Job instance at 0x7fbe1948a550>,59,12,[7 5],60,-1,72,-1,60
1,<environment.Job instance at 0x7fbe1948a820>,60,18,[5 6],61,-1,79,-1,61
1,<environment.Job instance at 0x7fbe196944b0>,53,20,[5 3],54,-1,86,-1,66
1,<environment.Job instance at 0x7fbe1948a3c0>,61,17,[2 9],62,-1,83,-1,66
1,<environment.Job instance at 0x7fbe1948aeb0>,66,13,[9 1],67,-1,80,-1,67
1,<environment.Job instance at 0x7fbe1948ae60>,67,22,[10  1],68,-1,91,-1,69
1,<environment.Job instance at 0x7fbe1a0b4370>,37,13,[12  5],38,-1,85,-1,72
1,<environment.Job instance at 0x7fbe1948a500>,70,20,[3 8],71,-1,94,-1,74
1,<environment.Job instance at 0x7fbe194a2230>,76,26,[9 5],77,-1,103,-1,77
1,<environment.Job instance at 0x7fbe1a0b4c30>,3,27,[8 5],4,-1,32,-1,5
1,<environment.Job instance at 0x7fbe1a0b4a00>,4,12,[ 5 13],5,-1,17,-1,5
1,<environment.Job instance at 0x7fbe1948acd0>,9,1,[12  4],10,-1,11,-1,10
1,<environment.Job instance at 0x7fbe1a98fe10>,13,24,[3 5],14,-1,42,-1,18
1,<environment.Job instance at 0x7fbe1a09e410>,24,27,[1 8],25,-1,92,-1,65
1,<environment.Job instance at 0x7fbe1a07e280>,34,23,[4 5],35,-1,106,-1,83
1,<environment.Job instance at 0x7fbe1a075870>,37,13,[12  5],38,-1,104,-1,91
1,<environment.Job instance at 0x7fbe19f000a0>,43,14,[ 4 11],44,-1,131,-1,117
1,<environment.Job instance at 0x7fbe19edfaa0>,46,26,[8 5],47,-1,154,-1,128
1,<environment.Job instance at 0x7fbe19ee3460>,48,18,[13  1],49,-1,146,-1,128
1,<environment.Job instance at 0x7fbe19783870>,68,16,[13  1],69,-1,211,-1,195
1,<environment.Job instance at 0x7fbe1a1a6780>,71,3,[11  4],72,-1,200,-1,197
1,<environment.Job instance at 0x7fbe22f677d0>,76,26,[9 5],77,-1,249,-1,223
1,<environment.Job instance at 0x7fbe19a4e1e0>,4,17,[1 8],5,-1,22,-1,5
1,<environment.Job instance at 0x7fbe19ead500>,9,22,[7 3],10,-1,32,-1,10
1,<environment.Job instance at 0x7fbe22ee1460>,12,25,[7 5],13,-1,38,-1,13
1,<environment.Job instance at 0x7fbe1999b140>,26,18,[5 8],27,-1,48,-1,30
1,<environment.Job instance at 0x7fbe1999bd70>,33,20,[8 4],34,-1,86,-1,66
1,<environment.Job instance at 0x7fbe196f4730>,37,27,[8 5],38,-1,96,-1,69
1,<environment.Job instance at 0x7fbe1999b5f0>,29,17,[ 2 10],30,-1,86,-1,69
1,<environment.Job instance at 0x7fbe1999b370>,32,15,[3 9],33,-1,84,-1,69
1,<environment.Job instance at 0x7fbe1999b0f0>,31,18,[8 1],32,-1,87,-1,69
1,<environment.Job instance at 0x7fbe196f4140>,42,17,[3 5],43,-1,86,-1,69
1,<environment.Job instance at 0x7fbe196f49b0>,43,16,[5 2],44,-1,87,-1,71
1,<environment.Job instance at 0x7fbe194a62d0>,51,17,[9 4],52,-1,166,-1,149
1,<environment.Job instance at 0x7fbe194a6dc0>,52,24,[4 6],53,-1,174,-1,150
1,<environment.Job instance at 0x7fbe194a6aa0>,61,18,[7 2],62,-1,168,-1,150
1,<environment.Job instance at 0x7fbe194a6c30>,53,15,[ 2 13],54,-1,165,-1,150
1,<environment.Job instance at 0x7fbe194a6230>,62,12,[5 2],63,-1,162,-1,150
1,<environment.Job instance at 0x7fbe194a66e0>,64,12,[7 2],65,-1,162,-1,150
1,<environment.Job instance at 0x7fbe1a418730>,66,15,[11  2],67,-1,166,-1,151
1,<environment.Job instance at 0x7fbe1a38d6e0>,69,18,[ 5 10],70,-1,193,-1,175
1,<environment.Job instance at 0x7fbe194a6280>,57,18,[14  1],58,-1,193,-1,175
1,<environment.Job instance at 0x7fbe1a4b9b40>,71,15,[5 5],72,-1,190,-1,175
1,<environment.Job instance at 0x7fbe19ab2c80>,73,16,[6 1],74,-1,192,-1,176
1,<environment.Job instance at 0x7fbe1a4df820>,74,12,[7 1],75,-1,189,-1,177
1,<environment.Job instance at 0x7fbe19ab2960>,72,19,[2 5],73,-1,196,-1,177
1,<environment.Job instance at 0x7fbe191aea50>,7,1,[ 4 12],8,-1,9,-1,8
1,<environment.Job instance at 0x7fbe1934c640>,10,15,[13  3],11,-1,32,-1,17
1,<environment.Job instance at 0x7fbe1a8f5410>,13,2,[14  5],14,-1,19,-1,17
1,<environment.Job instance at 0x7fbe1a46af50>,14,2,[13  4],15,-1,19,-1,17
1,<environment.Job instance at 0x7fbe235ee050>,16,12,[12  4],17,-1,31,-1,19
1,<environment.Job instance at 0x7fbe199a5dc0>,12,25,[7 5],13,-1,45,-1,20
1,<environment.Job instance at 0x7fbe19923960>,25,15,[ 4 12],26,-1,62,-1,47
1,<environment.Job instance at 0x7fbe19b1dbe0>,37,27,[8 5],38,-1,126,-1,99
1,<environment.Job instance at 0x7fbe192b1870>,49,2,[ 2 12],50,-1,154,-1,152
1,<environment.Job instance at 0x7fbe1a52d410>,52,24,[4 6],53,-1,191,-1,167
1,<environment.Job instance at 0x7fbe1a52d0f0>,53,15,[ 2 13],54,-1,182,-1,167
1,<environment.Job instance at 0x7fbe1a4f73c0>,57,18,[14  1],58,-1,202,-1,184
1,<environment.Job instance at 0x7fbe1a4f0be0>,63,13,[ 3 11],64,-1,216,-1,203
1,<environment.Job instance at 0x7fbe1a5052d0>,66,15,[11  2],67,-1,230,-1,215
1,<environment.Job instance at 0x7fbe196095f0>,70,12,[ 3 12],71,-1,236,-1,224
1,<environment.Job instance at 0x7fbe196749b0>,5,17,[8 5],6,-1,24,-1,7
1,<environment.Job instance at 0x7fbe19662d20>,10,18,[6 4],11,-1,29,-1,11
1,<environment.Job instance at 0x7fbe19662c80>,12,15,[4 9],13,-1,28,-1,13
1,<environment.Job instance at 0x7fbe196622d0>,13,18,[8 3],14,-1,32,-1,14
1,<environment.Job instance at 0x7fbe19662820>,16,16,[7 5],17,-1,33,-1,17
1,<environment.Job instance at 0x7fbe196755a0>,22,18,[8 1],23,-1,41,-1,23
1,<environment.Job instance at 0x7fbe19675f50>,24,14,[5 8],25,-1,39,-1,25
1,<environment.Job instance at 0x7fbe19675460>,26,20,[10  4],27,-1,49,-1,29
1,<environment.Job instance at 0x7fbe196756e0>,28,17,[9 2],29,-1,50,-1,33
1,<environment.Job instance at 0x7fbe19675dc0>,29,14,[7 5],30,-1,47,-1,33
1,<environment.Job instance at 0x7fbe199458c0>,33,27,[1 7],34,-1,61,-1,34
1,<environment.Job instance at 0x7fbe19945910>,34,18,[6 3],35,-1,53,-1,35
1,<environment.Job instance at 0x7fbe19945280>,35,18,[ 3 12],36,-1,55,-1,37
1,<environment.Job instance at 0x7fbe19945dc0>,39,15,[4 7],40,-1,55,-1,40
1,<environment.Job instance at 0x7fbe19945a50>,41,25,[9 1],42,-1,70,-1,45
1,<environment.Job instance at 0x7fbe19945a00>,42,17,[5 9],43,-1,65,-1,48
1,<environment.Job instance at 0x7fbe19945b90>,43,18,[5 5],44,-1,66,-1,48
1,<environment.Job instance at 0x7fbe199454b0>,32,18,[5 3],33,-1,66,-1,48
1,<environment.Job instance at 0x7fbe19675e60>,30,27,[ 3 13],31,-1,77,-1,50
1,<environment.Job instance at 0x7fbe19945e10>,44,15,[8 2],45,-1,65,-1,50
1,<environment.Job instance at 0x7fbe199112d0>,48,18,[ 3 10],49,-1,69,-1,51
1,<environment.Job instance at 0x7fbe199118c0>,49,13,[8 4],50,-1,64,-1,51
1,<environment.Job instance at 0x7fbe19911640>,50,27,[5 4],51,-1,78,-1,51
1,<environment.Job instance at 0x7fbe19911910>,51,28,[7 5],52,-1,80,-1,52
1,<environment.Job instance at 0x7fbe19911f00>,54,16,[2 5],55,-1,71,-1,55
1,<environment.Job instance at 0x7fbe19945870>,45,17,[6 4],46,-1,73,-1,56
1,<environment.Job instance at 0x7fbe19911780>,55,13,[ 5 10],56,-1,74,-1,61
1,<environment.Job instance at 0x7fbe19f4aaf0>,67,18,[2 6],68,-1,86,-1,68
1,<environment.Job instance at 0x7fbe19f4ae10>,69,12,[10  4],70,-1,93,-1,81
1,<environment.Job instance at 0x7fbe19f4a410>,70,13,[7 1],71,-1,94,-1,81
1,<environment.Job instance at 0x7fbe19f4a8c0>,63,16,[7 2],64,-1,97,-1,81
1,<environment.Job instance at 0x7fbe19f4ae60>,68,15,[3 9],69,-1,96,-1,81
1,<environment.Job instance at 0x7fbe19f4a370>,73,19,[7 1],74,-1,100,-1,81
1,<environment.Job instance at 0x7fbe19f4a230>,74,15,[10  1],75,-1,96,-1,81
1,<environment.Job instance at 0x7fbe19f4afa0>,75,18,[7 4],76,-1,99,-1,81
1,<environment.Job instance at 0x7fbe19911320>,53,28,[8 2],54,-1,109,-1,81
1,<environment.Job instance at 0x7fbe19662140>,0,25,[10  4],1,-1,26,-1,1
1,<environment.Job instance at 0x7fbe235ee410>,17,16,[13  1],18,-1,41,-1,25
1,<environment.Job instance at 0x7fbe19ead5f0>,21,2,[13  4],22,-1,55,-1,53
1,<environment.Job instance at 0x7fbe19b250f0>,30,27,[ 3 13],31,-1,103,-1,76
1,<environment.Job instance at 0x7fbe19b25c30>,33,27,[1 7],34,-1,117,-1,90
1,<environment.Job instance at 0x7fbe19b25460>,35,18,[ 3 12],36,-1,118,-1,100
1,<environment.Job instance at 0x7fbe193647d0>,40,1,[12  1],41,-1,125,-1,124
1,<environment.Job instance at 0x7fbe19364730>,41,25,[9 1],42,-1,152,-1,127
1,<environment.Job instance at 0x7fbe193644b0>,50,27,[5 4],51,-1,205,-1,178
1,<environment.Job instance at 0x7fbe19364550>,51,28,[7 5],52,-1,206,-1,178
1,<environment.Job instance at 0x7fbe19364dc0>,53,28,[8 2],54,-1,217,-1,189
1,<environment.Job instance at 0x7fbe19f325a0>,71,1,[ 5 14],72,-1,249,-1,248
1,<environment.Job instance at 0x7fbe19fe4870>,3,27,[5 1],4,-1,31,-1,4
1,<environment.Job instance at 0x7fbe19fe4be0>,11,12,[3 8],12,-1,24,-1,12
1,<environment.Job instance at 0x7fbe19fe41e0>,12,1,[6 5],13,-1,14,-1,13
1,<environment.Job instance at 0x7fbe19fe43c0>,13,18,[6 4],14,-1,32,-1,14
1,<environment.Job instance at 0x7fbe19fe4320>,14,18,[9 1],15,-1,33,-1,15
1,<environment.Job instance at 0x7fbe19fe4550>,16,14,[5 7],17,-1,32,-1,18
1,<environment.Job instance at 0x7fbe19e0f870>,18,16,[1 7],19,-1,35,-1,19
1,<environment.Job instance at 0x7fbe19e0fb90>,20,18,[2 9],21,-1,39,-1,21
1,<environment.Job instance at 0x7fbe19e0f910>,23,18,[5 3],24,-1,42,-1,24
1,<environment.Job instance at 0x7fbe19d5d7d0>,27,26,[3 7],28,-1,54,-1,28
1,<environment.Job instance at 0x7fbe199a25f0>,36,18,[5 4],37,-1,57,-1,39
1,<environment.Job instance at 0x7fbe199a27d0>,41,17,[7 4],42,-1,70,-1,53
1,<environment.Job instance at 0x7fbe199a20f0>,45,18,[8 2],46,-1,82,-1,64
1,<environment.Job instance at 0x7fbe19fe4e60>,17,12,[3 8],18,-1,84,-1,72
1,<environment.Job instance at 0x7fbe199a2460>,56,15,[10  2],57,-1,87,-1,72
1,<environment.Job instance at 0x7fbe199a2b40>,52,13,[9 3],53,-1,87,-1,74
1,<environment.Job instance at 0x7fbe19d5d2d0>,34,17,[5 1],35,-1,91,-1,74
1,<environment.Job instance at 0x7fbe1a5456e0>,60,14,[10  4],61,-1,88,-1,74
1,<environment.Job instance at 0x7fbe19405870>,68,16,[10  1],69,-1,90,-1,74
1,<environment.Job instance at 0x7fbe194055f0>,69,18,[8 2],70,-1,92,-1,74
1,<environment.Job instance at 0x7fbe19405dc0>,70,18,[2 8],71,-1,92,-1,74
1,<environment.Job instance at 0x7fbe1a545e60>,61,15,[7 2],62,-1,89,-1,74
1,<environment.Job instance at 0x7fbe19405b40>,73,14,[5 7],74,-1,88,-1,74
1,<environment.Job instance at 0x7fbe199a2be0>,47,28,[4 9],48,-1,102,-1,74
1,<environment.Job instance at 0x7fbe19d5d730>,0,17,[ 5 13],1,-1,18,-1,1
1,<environment.Job instance at 0x7fbe19d5d5a0>,3,27,[5 1],4,-1,32,-1,5
1,<environment.Job instance at 0x7fbe19405c80>,6,2,[ 5 12],7,-1,9,-1,7
1,<environment.Job instance at 0x7fbe1a2fcdc0>,15,17,[14  4],16,-1,38,-1,21
1,<environment.Job instance at 0x7fbe235ee820>,21,12,[13  5],22,-1,58,-1,46
1,<environment.Job instance at 0x7fbe19fe4190>,27,26,[3 7],28,-1,93,-1,67
1,<environment.Job instance at 0x7fbe19edd550>,37,1,[ 2 11],38,-1,89,-1,88
1,<environment.Job instance at 0x7fbe19edd410>,39,25,[3 8],40,-1,126,-1,101
1,<environment.Job instance at 0x7fbe19eddbe0>,47,28,[4 9],48,-1,158,-1,130
1,<environment.Job instance at 0x7fbe19edd050>,51,18,[13  5],52,-1,149,-1,131
1,<environment.Job instance at 0x7fbe19ee0b40>,55,14,[11  2],56,-1,152,-1,138
1,<environment.Job instance at 0x7fbe19ee0640>,58,1,[14  2],59,-1,150,-1,149
1,<environment.Job instance at 0x7fbe19ee06e0>,59,1,[ 1 11],60,-1,150,-1,149
1,<environment.Job instance at 0x7fbe19033cd0>,4,21,[8 1],5,-1,26,-1,5
1,<environment.Job instance at 0x7fbe1924a730>,9,25,[ 3 10],10,-1,35,-1,10
1,<environment.Job instance at 0x7fbe19093cd0>,14,17,[5 4],15,-1,32,-1,15
1,<environment.Job instance at 0x7fbe190938c0>,15,15,[9 4],16,-1,32,-1,17
1,<environment.Job instance at 0x7fbe1903c410>,17,23,[9 2],18,-1,41,-1,18
1,<environment.Job instance at 0x7fbe19277370>,20,15,[4 8],21,-1,36,-1,21
1,<environment.Job instance at 0x7fbe19087320>,23,17,[7 4],24,-1,41,-1,24
1,<environment.Job instance at 0x7fbe19087690>,25,15,[9 1],26,-1,41,-1,26
1,<environment.Job instance at 0x7fbe19087780>,28,16,[6 5],29,-1,45,-1,29
1,<environment.Job instance at 0x7fbe190878c0>,31,14,[1 5],32,-1,46,-1,32
1,<environment.Job instance at 0x7fbe19087500>,32,18,[ 2 10],33,-1,51,-1,33
1,<environment.Job instance at 0x7fbe19087eb0>,33,14,[4 9],34,-1,48,-1,34
1,<environment.Job instance at 0x7fbe1a8b61e0>,34,12,[9 4],35,-1,47,-1,35
1,<environment.Job instance at 0x7fbe19093460>,16,15,[4 7],17,-1,51,-1,36
1,<environment.Job instance at 0x7fbe19fe63c0>,40,16,[3 7],41,-1,57,-1,41
1,<environment.Job instance at 0x7fbe19fe6780>,41,18,[5 5],42,-1,60,-1,42
1,<environment.Job instance at 0x7fbe1a9a5320>,43,24,[4 7],44,-1,68,-1,44
1,<environment.Job instance at 0x7fbe1a9a5af0>,44,16,[4 7],45,-1,61,-1,45
1,<environment.Job instance at 0x7fbe22f844b0>,56,13,[ 4 12],57,-1,71,-1,58
1,<environment.Job instance at 0x7fbe19f0c460>,57,18,[3 9],58,-1,76,-1,58
1,<environment.Job instance at 0x7fbe1a7b1e10>,62,15,[ 1 10],63,-1,84,-1,69
1,<environment.Job instance at 0x7fbe1a7e12d0>,65,16,[5 5],66,-1,85,-1,69
1,<environment.Job instance at 0x7fbe19fe67d0>,39,18,[14  4],40,-1,90,-1,72
1,<environment.Job instance at 0x7fbe19b88050>,68,17,[10  4],69,-1,89,-1,72
1,<environment.Job instance at 0x7fbe199dd730>,71,17,[4 7],72,-1,91,-1,74
1,<environment.Job instance at 0x7fbe19c10410>,10,18,[ 2 11],11,-1,34,-1,16
1,<environment.Job instance at 0x7fbe19c10910>,9,25,[ 3 10],10,-1,42,-1,17
1,<environment.Job instance at 0x7fbe19717b90>,17,23,[9 2],18,-1,64,-1,41
1,<environment.Job instance at 0x7fbe1a165370>,36,17,[ 1 14],37,-1,109,-1,92
1,<environment.Job instance at 0x7fbe193f4190>,39,18,[14  4],40,-1,112,-1,94
1,<environment.Job instance at 0x7fbe19501690>,43,24,[4 7],44,-1,135,-1,111
1,<environment.Job instance at 0x7fbe194bce60>,48,23,[ 4 10],49,-1,166,-1,143
1,<environment.Job instance at 0x7fbe1949e820>,55,13,[ 3 12],56,-1,160,-1,147
1,<environment.Job instance at 0x7fbe1949e690>,56,13,[ 4 12],57,-1,160,-1,147
1,<environment.Job instance at 0x7fbe1973d410>,63,24,[3 5],64,-1,189,-1,165
1,<environment.Job instance at 0x7fbe1a195e60>,0,26,[4 8],1,-1,27,-1,1
1,<environment.Job instance at 0x7fbe1a195c30>,1,16,[2 7],2,-1,18,-1,2
1,<environment.Job instance at 0x7fbe1a1655a0>,4,15,[3 8],5,-1,20,-1,5
1,<environment.Job instance at 0x7fbe1a1656e0>,8,13,[ 5 10],9,-1,22,-1,9
1,<environment.Job instance at 0x7fbe1a165c80>,10,18,[8 5],11,-1,29,-1,11
1,<environment.Job instance at 0x7fbe1a165050>,12,18,[4 5],13,-1,31,-1,13
1,<environment.Job instance at 0x7fbe19ac39b0>,13,18,[8 1],14,-1,32,-1,14
1,<environment.Job instance at 0x7fbe19ac3a00>,18,17,[10  4],19,-1,36,-1,19
1,<environment.Job instance at 0x7fbe19ac3690>,19,15,[5 9],20,-1,35,-1,20
1,<environment.Job instance at 0x7fbe19ac3280>,22,16,[3 5],23,-1,39,-1,23
1,<environment.Job instance at 0x7fbe19ac31e0>,25,22,[1 9],26,-1,48,-1,26
1,<environment.Job instance at 0x7fbe194bb8c0>,29,18,[ 3 12],30,-1,48,-1,30
1,<environment.Job instance at 0x7fbe194bbcd0>,30,18,[7 3],31,-1,49,-1,31
1,<environment.Job instance at 0x7fbe194bbaa0>,33,17,[10  3],34,-1,51,-1,34
1,<environment.Job instance at 0x7fbe194bb050>,36,12,[4 7],37,-1,49,-1,37
1,<environment.Job instance at 0x7fbe194bbbe0>,37,15,[6 4],38,-1,53,-1,38
1,<environment.Job instance at 0x7fbe1973ec80>,38,17,[3 8],39,-1,56,-1,39
1,<environment.Job instance at 0x7fbe1973e050>,39,15,[ 5 10],40,-1,55,-1,40
1,<environment.Job instance at 0x7fbe1973ef50>,40,19,[5 4],41,-1,60,-1,41
1,<environment.Job instance at 0x7fbe1973ee60>,41,17,[ 2 10],42,-1,59,-1,42
1,<environment.Job instance at 0x7fbe1973e140>,43,18,[9 2],44,-1,62,-1,44
1,<environment.Job instance at 0x7fbe1973e550>,44,24,[5 9],45,-1,69,-1,45
1,<environment.Job instance at 0x7fbe1973e5f0>,45,16,[10  3],46,-1,64,-1,48
1,<environment.Job instance at 0x7fbe1973e410>,47,26,[8 5],48,-1,74,-1,48
1,<environment.Job instance at 0x7fbe1a9050a0>,50,17,[10  1],51,-1,70,-1,53
1,<environment.Job instance at 0x7fbe1a9051e0>,52,13,[9 1],53,-1,66,-1,53
1,<environment.Job instance at 0x7fbe1a905870>,53,26,[7 5],54,-1,80,-1,54
1,<environment.Job instance at 0x7fbe1a9053c0>,54,16,[3 9],55,-1,71,-1,55
1,<environment.Job instance at 0x7fbe1a905050>,56,20,[3 6],57,-1,77,-1,57
1,<environment.Job instance at 0x7fbe1a9050f0>,57,18,[ 3 10],58,-1,76,-1,58
1,<environment.Job instance at 0x7fbe1a905780>,58,16,[3 5],59,-1,76,-1,60
1,<environment.Job instance at 0x7fbe1a905730>,59,16,[8 5],60,-1,76,-1,60
1,<environment.Job instance at 0x7fbe1a905b40>,62,18,[4 7],63,-1,81,-1,63
1,<environment.Job instance at 0x7fbe1a93e5a0>,65,17,[9 3],66,-1,87,-1,70
1,<environment.Job instance at 0x7fbe1a93e730>,71,12,[10  4],72,-1,84,-1,72
1,<environment.Job instance at 0x7fbe1a93e7d0>,69,15,[5 5],70,-1,91,-1,76
1,<environment.Job instance at 0x7fbe19ac3af0>,0,26,[4 8],1,-1,27,-1,1
1,<environment.Job instance at 0x7fbe1948b500>,15,15,[12  1],16,-1,52,-1,37
1,<environment.Job instance at 0x7fbe194bb280>,23,1,[ 3 13],24,-1,74,-1,73
1,<environment.Job instance at 0x7fbe19501eb0>,29,18,[ 3 12],30,-1,104,-1,86
1,<environment.Job instance at 0x7fbe1973e8c0>,35,1,[ 5 13],36,-1,104,-1,103
1,<environment.Job instance at 0x7fbe1a1659b0>,44,24,[5 9],45,-1,176,-1,152
1,<environment.Job instance at 0x7fbe22f84500>,47,26,[8 5],48,-1,196,-1,170
1,<environment.Job instance at 0x7fbe1a7e7af0>,53,26,[7 5],54,-1,215,-1,189
1,<environment.Job instance at 0x7fbe199dd9b0>,55,2,[13  2],56,-1,191,-1,189
1,<environment.Job instance at 0x7fbe19d532d0>,63,3,[11  3],64,-1,226,-1,223
1,<environment.Job instance at 0x7fbe193e9230>,78,16,[ 5 13],79,-1,283,-1,267
1,<environment.Job instance at 0x7fbe1a24ec80>,4,17,[5 9],5,-1,22,-1,5
1,<environment.Job instance at 0x7fbe1a24ef50>,5,17,[5 9],6,-1,23,-1,6
1,<environment.Job instance at 0x7fbe1a24e820>,6,23,[10  4],7,-1,31,-1,8
1,<environment.Job instance at 0x7fbe1a24ed20>,8,17,[4 9],9,-1,26,-1,9
1,<environment.Job instance at 0x7fbe1a24e5a0>,9,18,[9 5],10,-1,28,-1,10
1,<environment.Job instance at 0x7fbe1a24e3c0>,11,17,[8 2],12,-1,29,-1,12
1,<environment.Job instance at 0x7fbe1a24e0f0>,12,18,[10  5],13,-1,31,-1,13
1,<environment.Job instance at 0x7fbe1a24e730>,15,16,[3 8],16,-1,32,-1,16
1,<environment.Job instance at 0x7fbe1a24ee10>,17,18,[5 4],18,-1,36,-1,18
1,<environment.Job instance at 0x7fbe1a25c050>,20,12,[2 9],21,-1,33,-1,21
1,<environment.Job instance at 0x7fbe1a25c8c0>,21,17,[7 2],22,-1,39,-1,22
1,<environment.Job instance at 0x7fbe1a25ccd0>,23,16,[3 9],24,-1,40,-1,24
1,<environment.Job instance at 0x7fbe1a25ce10>,24,13,[10  1],25,-1,38,-1,25
1,<environment.Job instance at 0x7fbe1a25c0f0>,25,13,[ 3 10],26,-1,39,-1,26
1,<environment.Job instance at 0x7fbe1a25c4b0>,29,25,[8 3],30,-1,55,-1,30
1,<environment.Job instance at 0x7fbe1a25c3c0>,31,17,[3 7],32,-1,49,-1,32
1,<environment.Job instance at 0x7fbe1a25c140>,33,18,[2 6],34,-1,52,-1,34
1,<environment.Job instance at 0x7fbe1a25cb40>,34,18,[8 2],35,-1,53,-1,35
1,<environment.Job instance at 0x7fbe1a222050>,36,17,[1 6],37,-1,54,-1,37
1,<environment.Job instance at 0x7fbe1a222190>,37,18,[5 2],38,-1,56,-1,38
1,<environment.Job instance at 0x7fbe1a2220f0>,38,17,[3 5],39,-1,56,-1,39
1,<environment.Job instance at 0x7fbe1a2222d0>,39,13,[4 7],40,-1,53,-1,40
1,<environment.Job instance at 0x7fbe1a222410>,41,15,[10  5],42,-1,57,-1,42
1,<environment.Job instance at 0x7fbe1a2225f0>,42,18,[10  1],43,-1,61,-1,43
1,<environment.Job instance at 0x7fbe1a222fa0>,51,18,[7 1],52,-1,70,-1,52
1,<environment.Job instance at 0x7fbe1a233190>,53,18,[ 3 10],54,-1,72,-1,54
1,<environment.Job instance at 0x7fbe1a7e5dc0>,58,12,[10  2],59,-1,71,-1,59
1,<environment.Job instance at 0x7fbe1a25baf0>,61,15,[9 5],62,-1,77,-1,62
1,<environment.Job instance at 0x7fbe1a25b2d0>,62,14,[ 1 10],63,-1,77,-1,63
1,<environment.Job instance at 0x7fbe1a25b0a0>,65,15,[10  1],66,-1,81,-1,66
1,<environment.Job instance at 0x7fbe19ce8aa0>,66,21,[3 7],67,-1,88,-1,67
1,<environment.Job instance at 0x7fbe19ce8eb0>,67,15,[ 3 10],68,-1,83,-1,68
1,<environment.Job instance at 0x7fbe19ce82d0>,68,28,[8 3],69,-1,97,-1,69
1,<environment.Job instance at 0x7fbe19cf4690>,69,20,[1 9],70,-1,90,-1,70
1,<environment.Job instance at 0x7fbe19e6e050>,71,17,[5 6],72,-1,89,-1,72
1,<environment.Job instance at 0x7fbe197bba50>,72,16,[10  1],73,-1,89,-1,73
1,<environment.Job instance at 0x7fbe197bba00>,73,17,[ 2 10],74,-1,91,-1,74
1,<environment.Job instance at 0x7fbe1980a5a0>,76,13,[ 5 11],77,-1,90,-1,77
1,<environment.Job instance at 0x7fbe19798320>,78,15,[10  2],79,-1,94,-1,79
1,<environment.Job instance at 0x7fbe1a25c230>,1,15,[14  4],2,-1,17,-1,2
1,<environment.Job instance at 0x7fbe1982d5a0>,6,23,[10  4],7,-1,39,-1,16
1,<environment.Job instance at 0x7fbe19d53960>,29,25,[8 3],30,-1,140,-1,115
1,<environment.Job instance at 0x7fbe199ddc80>,32,24,[11  1],33,-1,139,-1,115
1,<environment.Job instance at 0x7fbe194bb280>,63,2,[12  1],64,-1,235,-1,233
1,<environment.Job instance at 0x7fbe194bb230>,64,1,[ 5 14],65,-1,234,-1,233
1,<environment.Job instance at 0x7fbe1949e820>,68,28,[8 3],69,-1,275,-1,247
1,<environment.Job instance at 0x7fbe194a0050>,76,13,[ 5 11],77,-1,293,-1,280
1,<environment.Job instance at 0x7fbe1a195b40>,77,2,[13  1],78,-1,282,-1,280
1,<environment.Job instance at 0x7fbe19795e60>,1,18,[4 6],2,-1,20,-1,2
1,<environment.Job instance at 0x7fbe19e4be60>,6,13,[8 3],7,-1,21,-1,8
1,<environment.Job instance at 0x7fbe193e9690>,7,12,[ 3 10],8,-1,20,-1,8
1,<environment.Job instance at 0x7fbe19e4b460>,8,15,[8 2],9,-1,24,-1,9
1,<environment.Job instance at 0x7fbe1a462410>,13,12,[5 9],14,-1,27,-1,15
1,<environment.Job instance at 0x7fbe1a462460>,19,20,[2 8],20,-1,40,-1,20
1,<environment.Job instance at 0x7fbe19e4b4b0>,14,16,[1 8],15,-1,36,-1,20
1,<environment.Job instance at 0x7fbe1a52d870>,23,18,[8 1],24,-1,43,-1,25
1,<environment.Job instance at 0x7fbe1a52d460>,24,13,[10  5],25,-1,38,-1,25
1,<environment.Job instance at 0x7fbe1a4fa5f0>,31,23,[5 9],32,-1,60,-1,37
1,<environment.Job instance at 0x7fbe1a52d410>,30,18,[5 7],31,-1,59,-1,41
1,<environment.Job instance at 0x7fbe1a711a50>,41,26,[7 2],42,-1,70,-1,44
1,<environment.Job instance at 0x7fbe1a711d20>,44,14,[10  5],45,-1,59,-1,45
1,<environment.Job instance at 0x7fbe1a4a60a0>,51,17,[10  3],52,-1,106,-1,89
1,<environment.Job instance at 0x7fbe1a9b6730>,59,19,[9 1],60,-1,108,-1,89
1,<environment.Job instance at 0x7fbe1a9b65a0>,64,23,[8 3],65,-1,142,-1,119
1,<environment.Job instance at 0x7fbe1a4fab90>,4,1,[11  3],5,-1,6,-1,5
1,<environment.Job instance at 0x7fbe1a53ae10>,11,13,[ 1 13],12,-1,34,-1,21
1,<environment.Job instance at 0x7fbe1a711050>,12,27,[9 1],13,-1,48,-1,21
1,<environment.Job instance at 0x7fbe192bc6e0>,16,21,[12  2],17,-1,55,-1,34
1,<environment.Job instance at 0x7fbe192bce10>,18,14,[ 1 14],19,-1,49,-1,35
1,<environment.Job instance at 0x7fbe194a0b90>,20,15,[12  3],21,-1,50,-1,35
1,<environment.Job instance at 0x7fbe1949d050>,26,2,[12  3],27,-1,52,-1,50
1,<environment.Job instance at 0x7fbe1973e280>,31,23,[5 9],32,-1,89,-1,66
1,<environment.Job instance at 0x7fbe1a905280>,35,15,[ 4 12],36,-1,89,-1,74
1,<environment.Job instance at 0x7fbe1a958690>,39,3,[ 4 11],40,-1,88,-1,85
1,<environment.Job instance at 0x7fbe1a1658c0>,41,26,[7 2],42,-1,119,-1,93
1,<environment.Job instance at 0x7fbe19c10910>,42,2,[ 2 13],43,-1,95,-1,93
1,<environment.Job instance at 0x7fbe19cd1910>,46,12,[11  2],47,-1,109,-1,97
1,<environment.Job instance at 0x7fbe1a7e7d20>,47,1,[14  5],48,-1,98,-1,97
1,<environment.Job instance at 0x7fbe1a7e7b90>,48,19,[ 5 11],49,-1,116,-1,97
1,<environment.Job instance at 0x7fbe19d53370>,58,1,[ 4 13],59,-1,137,-1,136
1,<environment.Job instance at 0x7fbe1982d5a0>,62,2,[ 3 14],63,-1,141,-1,139
1,<environment.Job instance at 0x7fbe193e95f0>,64,23,[8 3],65,-1,170,-1,147
1,<environment.Job instance at 0x7fbe1a222820>,69,1,[11  4],70,-1,149,-1,148
1,<environment.Job instance at 0x7fbe1a25c230>,73,27,[9 4],74,-1,190,-1,163
1,<environment.Job instance at 0x7fbe1a25c550>,74,25,[8 2],75,-1,188,-1,163
1,<environment.Job instance at 0x7fbe18fca370>,2,17,[5 9],3,-1,21,-1,4
1,<environment.Job instance at 0x7fbe1a036500>,3,18,[6 1],4,-1,22,-1,4
1,<environment.Job instance at 0x7fbe1a1eebe0>,7,17,[3 7],8,-1,26,-1,9
1,<environment.Job instance at 0x7fbe19aa75f0>,8,16,[8 5],9,-1,25,-1,9
1,<environment.Job instance at 0x7fbe19ba3050>,15,22,[9 4],16,-1,38,-1,16
1,<environment.Job instance at 0x7fbe19b1eeb0>,19,27,[5 8],20,-1,47,-1,20
1,<environment.Job instance at 0x7fbe19b1e410>,20,13,[5 8],21,-1,34,-1,21
1,<environment.Job instance at 0x7fbe19b4f870>,21,12,[10  5],22,-1,34,-1,22
1,<environment.Job instance at 0x7fbe19b4f550>,22,15,[ 5 10],23,-1,38,-1,23
1,<environment.Job instance at 0x7fbe19b4fc30>,23,16,[5 8],24,-1,40,-1,24
1,<environment.Job instance at 0x7fbe19d5a7d0>,26,22,[3 8],27,-1,49,-1,27
1,<environment.Job instance at 0x7fbe1919b640>,38,17,[3 7],39,-1,56,-1,39
1,<environment.Job instance at 0x7fbe1919b550>,39,12,[ 5 10],40,-1,53,-1,41
1,<environment.Job instance at 0x7fbe1919bbe0>,41,12,[ 4 10],42,-1,54,-1,42
1,<environment.Job instance at 0x7fbe1919b5a0>,42,1,[14  1],43,-1,44,-1,43
1,<environment.Job instance at 0x7fbe1919b910>,43,14,[ 1 10],44,-1,58,-1,44
1,<environment.Job instance at 0x7fbe1919be10>,40,18,[9 4],41,-1,62,-1,44
1,<environment.Job instance at 0x7fbe197627d0>,48,24,[8 2],49,-1,73,-1,49
1,<environment.Job instance at 0x7fbe1919b0f0>,44,17,[14  4],45,-1,75,-1,58
1,<environment.Job instance at 0x7fbe196375f0>,51,15,[10  3],52,-1,76,-1,61
1,<environment.Job instance at 0x7fbe197595f0>,60,14,[5 7],61,-1,75,-1,61
1,<environment.Job instance at 0x7fbe1a917960>,62,18,[4 9],63,-1,82,-1,64
1,<environment.Job instance at 0x7fbe1a62bd70>,64,15,[9 5],65,-1,80,-1,65
1,<environment.Job instance at 0x7fbe197b7780>,66,18,[8 5],67,-1,85,-1,67
1,<environment.Job instance at 0x7fbe1a4e0410>,73,26,[7 3],74,-1,107,-1,81
1,<environment.Job instance at 0x7fbe19e678c0>,56,24,[13  3],57,-1,105,-1,81
1,<environment.Job instance at 0x7fbe1a1ee2d0>,0,12,[ 4 12],1,-1,13,-1,1
1,<environment.Job instance at 0x7fbe19b697d0>,19,27,[5 8],20,-1,81,-1,54
1,<environment.Job instance at 0x7fbe1a072320>,35,15,[13  3],36,-1,101,-1,86
1,<environment.Job instance at 0x7fbe196d5690>,42,1,[14  1],43,-1,105,-1,104
1,<environment.Job instance at 0x7fbe196d5730>,44,17,[14  4],45,-1,135,-1,118
1,<environment.Job instance at 0x7fbe1960d460>,48,24,[8 2],49,-1,157,-1,133
1,<environment.Job instance at 0x7fbe22f37690>,49,27,[ 3 13],50,-1,160,-1,133
1,<environment.Job instance at 0x7fbe22f379b0>,50,18,[ 2 12],51,-1,151,-1,133
1,<environment.Job instance at 0x7fbe22f37820>,56,24,[13  3],57,-1,179,-1,155
1,<environment.Job instance at 0x7fbe1904be10>,73,26,[7 3],74,-1,246,-1,220
1,<environment.Job instance at 0x7fbe1904b370>,77,27,[1 8],78,-1,271,-1,244
1,<environment.Job instance at 0x7fbe1a4f0e10>,1,17,[3 7],2,-1,19,-1,2
1,<environment.Job instance at 0x7fbe19ff4f00>,3,14,[4 6],4,-1,18,-1,4
1,<environment.Job instance at 0x7fbe19ff4690>,4,15,[9 2],5,-1,20,-1,5
1,<environment.Job instance at 0x7fbe191cd730>,6,12,[5 8],7,-1,20,-1,8
1,<environment.Job instance at 0x7fbe191cd640>,9,15,[4 6],10,-1,25,-1,10
1,<environment.Job instance at 0x7fbe1a3cbb90>,12,14,[9 2],13,-1,28,-1,14
1,<environment.Job instance at 0x7fbe19d323c0>,13,14,[9 2],14,-1,28,-1,14
1,<environment.Job instance at 0x7fbe235129b0>,18,12,[9 4],19,-1,32,-1,20
1,<environment.Job instance at 0x7fbe19677c80>,19,17,[12  4],20,-1,37,-1,20
1,<environment.Job instance at 0x7fbe1a8b6960>,20,20,[7 1],21,-1,42,-1,22
1,<environment.Job instance at 0x7fbe1a8b7a00>,22,14,[7 1],23,-1,37,-1,23
1,<environment.Job instance at 0x7fbe1a8b6730>,21,14,[9 4],22,-1,37,-1,23
1,<environment.Job instance at 0x7fbe1a8b6050>,23,17,[3 7],24,-1,42,-1,25
1,<environment.Job instance at 0x7fbe19700b90>,24,21,[6 1],25,-1,46,-1,25
1,<environment.Job instance at 0x7fbe19fe63c0>,31,16,[9 2],32,-1,49,-1,33
1,<environment.Job instance at 0x7fbe199bc8c0>,33,14,[ 4 10],34,-1,48,-1,34
1,<environment.Job instance at 0x7fbe199bc4b0>,35,13,[10  4],36,-1,49,-1,36
1,<environment.Job instance at 0x7fbe198a0b40>,37,17,[9 1],38,-1,55,-1,38
1,<environment.Job instance at 0x7fbe1a6c7f50>,32,16,[6 1],33,-1,57,-1,41
1,<environment.Job instance at 0x7fbe199b4410>,45,24,[7 4],46,-1,71,-1,47
1,<environment.Job instance at 0x7fbe199a0a00>,51,14,[ 2 10],52,-1,66,-1,52
1,<environment.Job instance at 0x7fbe199a0a50>,53,18,[8 3],54,-1,72,-1,54
1,<environment.Job instance at 0x7fbe199a0f00>,54,12,[7 5],55,-1,70,-1,58
1,<environment.Job instance at 0x7fbe19ce2b40>,59,18,[ 1 10],60,-1,78,-1,60
1,<environment.Job instance at 0x7fbe19cc8190>,67,17,[8 3],68,-1,85,-1,68
1,<environment.Job instance at 0x7fbe19cc8370>,66,26,[10  2],67,-1,97,-1,71
1,<environment.Job instance at 0x7fbe19cc8550>,68,14,[9 3],69,-1,88,-1,74
1,<environment.Job instance at 0x7fbe199b4be0>,44,14,[ 1 11],45,-1,90,-1,76
1,<environment.Job instance at 0x7fbe19cc8780>,70,17,[8 5],71,-1,98,-1,81
1,<environment.Job instance at 0x7fbe19cc8730>,72,21,[9 5],73,-1,102,-1,81
1,<environment.Job instance at 0x7fbe19cc6050>,46,14,[9 1],47,-1,95,-1,81
1,<environment.Job instance at 0x7fbe19fe6500>,10,26,[2 8],11,-1,54,-1,28
1,<environment.Job instance at 0x7fbe19cc8960>,19,17,[12  4],20,-1,76,-1,59
1,<environment.Job instance at 0x7fbe1904b6e0>,25,17,[ 1 11],26,-1,91,-1,74
1,<environment.Job instance at 0x7fbe19258b90>,27,13,[12  4],28,-1,87,-1,74
1,<environment.Job instance at 0x7fbe22f37870>,40,24,[ 4 14],41,-1,154,-1,130
1,<environment.Job instance at 0x7fbe1954a550>,44,14,[ 1 11],45,-1,146,-1,132
1,<environment.Job instance at 0x7fbe1954aaf0>,45,24,[7 4],46,-1,171,-1,147
1,<environment.Job instance at 0x7fbe1a072c30>,55,25,[6 2],56,-1,207,-1,182
1,<environment.Job instance at 0x7fbe1a072f00>,56,2,[ 1 13],57,-1,184,-1,182
1,<environment.Job instance at 0x7fbe1973e820>,66,26,[10  2],67,-1,245,-1,219
1,<environment.Job instance at 0x7fbe1a9175a0>,74,1,[12  5],75,-1,251,-1,250
1,<environment.Job instance at 0x7fbe19762eb0>,75,1,[ 2 14],76,-1,251,-1,250
1,<environment.Job instance at 0x7fbe19d60a50>,77,2,[14  3],78,-1,252,-1,250
1,<environment.Job instance at 0x7f3c22f84af0>,2,14,[ 2 10],3,-1,18,-1,4
1,<environment.Job instance at 0x7f3c2c5748c0>,3,22,[2 5],4,-1,26,-1,4
1,<environment.Job instance at 0x7f3c22f84d70>,6,15,[2 8],7,-1,22,-1,7
1,<environment.Job instance at 0x7f3c22f84eb0>,8,17,[1 8],9,-1,26,-1,9
1,<environment.Job instance at 0x7f3c22f870a0>,10,22,[8 1],11,-1,33,-1,11
1,<environment.Job instance at 0x7f3c22f87140>,12,23,[6 4],13,-1,36,-1,13
1,<environment.Job instance at 0x7f3c22f87410>,13,18,[5 9],14,-1,32,-1,14
1,<environment.Job instance at 0x7f3c22f87320>,14,21,[8 1],15,-1,38,-1,17
1,<environment.Job instance at 0x7f3c22f87500>,16,18,[7 3],17,-1,35,-1,17
1,<environment.Job instance at 0x7f3c22f875a0>,18,26,[7 4],19,-1,45,-1,19
1,<environment.Job instance at 0x7f3c22f877d0>,19,25,[5 9],20,-1,45,-1,20
1,<environment.Job instance at 0x7f3c22f878c0>,21,18,[9 4],22,-1,40,-1,22
1,<environment.Job instance at 0x7f3c22f879b0>,23,16,[6 2],24,-1,40,-1,24
1,<environment.Job instance at 0x7f3c22f87e60>,26,12,[8 5],27,-1,39,-1,27
1,<environment.Job instance at 0x7f3c22f87fa0>,27,17,[4 6],28,-1,45,-1,28
1,<environment.Job instance at 0x7f3c22f8a140>,30,26,[9 4],31,-1,57,-1,31
1,<environment.Job instance at 0x7f3c22f8a230>,32,21,[5 9],33,-1,54,-1,33
1,<environment.Job instance at 0x7f3c22f8a370>,33,26,[3 6],34,-1,61,-1,35
1,<environment.Job instance at 0x7f3c22f8a4b0>,34,14,[1 9],35,-1,49,-1,35
1,<environment.Job instance at 0x7f3c22f8a410>,35,16,[1 9],36,-1,54,-1,38
1,<environment.Job instance at 0x7f3c22f8a8c0>,38,2,[6 1],39,-1,41,-1,39
1,<environment.Job instance at 0x7f3c22f8a640>,39,14,[9 4],40,-1,54,-1,40
1,<environment.Job instance at 0x7f3c22f8a6e0>,37,14,[5 8],38,-1,54,-1,40
1,<environment.Job instance at 0x7f3c22f8c320>,48,12,[9 2],49,-1,62,-1,50
1,<environment.Job instance at 0x7f3c22f8c410>,49,17,[10  2],50,-1,67,-1,50
1,<environment.Job instance at 0x7f3c22f8c550>,55,12,[2 6],56,-1,68,-1,56
1,<environment.Job instance at 0x7f3c22f8c960>,57,16,[ 2 11],58,-1,74,-1,58
1,<environment.Job instance at 0x7f3c22f8ccd0>,58,17,[3 7],59,-1,76,-1,59
1,<environment.Job instance at 0x7f3c22f8c9b0>,54,18,[7 1],55,-1,77,-1,59
1,<environment.Job instance at 0x7f3c22f8cd20>,59,19,[1 7],60,-1,79,-1,60
1,<environment.Job instance at 0x7f3c22f8cf00>,62,14,[4 9],63,-1,78,-1,64
1,<environment.Job instance at 0x7f3c22f902d0>,67,16,[1 9],68,-1,84,-1,68
1,<environment.Job instance at 0x7f3c22f905a0>,69,14,[9 4],70,-1,84,-1,70
1,<environment.Job instance at 0x7f3c22f90910>,72,18,[3 5],73,-1,91,-1,73
1,<environment.Job instance at 0x7f3c22f90f00>,76,13,[10  1],77,-1,91,-1,78
1,<environment.Job instance at 0x7f3c22f8e1e0>,81,14,[8 5],82,-1,96,-1,82
1,<environment.Job instance at 0x7f3c22f8e500>,82,21,[4 8],83,-1,104,-1,83
1,<environment.Job instance at 0x7f3c22f8e410>,83,18,[ 3 10],84,-1,102,-1,84
1,<environment.Job instance at 0x7f3c22f8e230>,87,18,[7 1],88,-1,106,-1,88
1,<environment.Job instance at 0x7f3c22f8eaf0>,88,16,[4 9],89,-1,109,-1,93
1,<environment.Job instance at 0x7f3c22f90eb0>,77,16,[8 1],78,-1,484,-1,468
1,<environment.Job instance at 0x7f3c22f7b5f0>,12,23,[6 4],13,-1,53,-1,30
1,<environment.Job instance at 0x7f3c23453a00>,18,26,[7 4],19,-1,70,-1,44
1,<environment.Job instance at 0x7f3c22ff9140>,19,25,[5 9],20,-1,83,-1,58
1,<environment.Job instance at 0x7f3c230156e0>,28,17,[ 1 13],29,-1,87,-1,70
1,<environment.Job instance at 0x7f3c2302e0f0>,30,26,[9 4],31,-1,110,-1,84
1,<environment.Job instance at 0x7f3c23111960>,31,1,[ 2 14],32,-1,85,-1,84
1,<environment.Job instance at 0x7f3c230a33c0>,33,26,[3 6],34,-1,110,-1,84
1,<environment.Job instance at 0x7f3c230a1690>,40,26,[ 1 10],41,-1,139,-1,113
1,<environment.Job instance at 0x7f3c230abeb0>,57,16,[ 2 11],58,-1,183,-1,167
1,<environment.Job instance at 0x7f3c226ca0a0>,1,18,[5 4],2,-1,20,-1,2
1,<environment.Job instance at 0x7f3c226cf730>,6,18,[2 6],7,-1,27,-1,9
1,<environment.Job instance at 0x7f3c226cf050>,12,13,[9 4],13,-1,27,-1,14
1,<environment.Job instance at 0x7f3c226d0460>,15,16,[7 5],16,-1,32,-1,16
1,<environment.Job instance at 0x7f3c226cfb90>,13,16,[1 9],14,-1,33,-1,17
1,<environment.Job instance at 0x7f3c226d0410>,17,18,[5 5],18,-1,36,-1,18
1,<environment.Job instance at 0x7f3c226c91e0>,23,17,[5 1],24,-1,44,-1,27
1,<environment.Job instance at 0x7f3c227ad1e0>,28,16,[5 2],29,-1,45,-1,29
1,<environment.Job instance at 0x7f3c227ad0a0>,29,28,[7 5],30,-1,58,-1,30
1,<environment.Job instance at 0x7f3c227adbe0>,31,3,[1 6],32,-1,36,-1,33
1,<environment.Job instance at 0x7f3c47bfb910>,33,3,[10  1],34,-1,37,-1,34
1,<environment.Job instance at 0x7f3c2253b4b0>,34,1,[6 1],35,-1,36,-1,35
1,<environment.Job instance at 0x7f3c227ad370>,32,18,[7 5],33,-1,53,-1,35
1,<environment.Job instance at 0x7f3c22673cd0>,42,18,[10  4],43,-1,61,-1,43
1,<environment.Job instance at 0x7f3c2259b9b0>,44,12,[5 4],45,-1,58,-1,46
1,<environment.Job instance at 0x7f3c227ad050>,30,19,[ 5 12],31,-1,65,-1,46
1,<environment.Job instance at 0x7f3c22604fa0>,40,17,[9 5],41,-1,63,-1,46
1,<environment.Job instance at 0x7f3c225a1e10>,46,1,[9 5],47,-1,48,-1,47
1,<environment.Job instance at 0x7f3c225a1dc0>,47,28,[ 2 10],48,-1,76,-1,48
1,<environment.Job instance at 0x7f3c2260bb90>,48,3,[4 6],49,-1,52,-1,49
1,<environment.Job instance at 0x7f3c2260bcd0>,49,1,[5 5],50,-1,51,-1,50
1,<environment.Job instance at 0x7f3c2260bf00>,50,2,[7 5],51,-1,53,-1,51
1,<environment.Job instance at 0x7f3c225a1b90>,45,15,[8 3],46,-1,66,-1,51
1,<environment.Job instance at 0x7f3c2259b870>,51,14,[ 3 10],52,-1,66,-1,52
1,<environment.Job instance at 0x7f3c226167d0>,53,1,[2 7],54,-1,56,-1,55
1,<environment.Job instance at 0x7f3c226c9640>,55,3,[9 2],56,-1,59,-1,56
1,<environment.Job instance at 0x7f3c226d00a0>,56,13,[10  5],57,-1,70,-1,57
1,<environment.Job instance at 0x7f3c2270d6e0>,59,17,[5 7],60,-1,77,-1,60
1,<environment.Job instance at 0x7f3c22616500>,54,20,[13  4],55,-1,81,-1,61
1,<environment.Job instance at 0x7f3c2256f820>,61,22,[5 6],62,-1,84,-1,62
1,<environment.Job instance at 0x7f3c226cf3c0>,65,17,[10  4],66,-1,85,-1,68
1,<environment.Job instance at 0x7f3c2251d370>,68,2,[9 1],69,-1,71,-1,69
1,<environment.Job instance at 0x7f3c22716320>,67,21,[10  4],68,-1,90,-1,69
1,<environment.Job instance at 0x7f3c2251d2d0>,72,20,[10  5],73,-1,95,-1,75
1,<environment.Job instance at 0x7f3c2251bc80>,84,19,[3 8],85,-1,104,-1,85
1,<environment.Job instance at 0x7f3c2251b1e0>,80,17,[4 7],81,-1,106,-1,89
1,<environment.Job instance at 0x7f3c2251cd70>,87,16,[8 4],88,-1,105,-1,89
1,<environment.Job instance at 0x7f3c2251b690>,3,25,[ 1 10],4,-1,29,-1,4
1,<environment.Job instance at 0x7f3c2273e140>,19,27,[3 9],20,-1,58,-1,31
1,<environment.Job instance at 0x7f3c2273e0a0>,20,23,[5 1],21,-1,54,-1,31
1,<environment.Job instance at 0x7f3c22780140>,27,3,[ 3 13],28,-1,52,-1,49
1,<environment.Job instance at 0x7f3c22745690>,30,19,[ 5 12],31,-1,75,-1,56
1,<environment.Job instance at 0x7f3c22780cd0>,29,28,[7 5],30,-1,100,-1,72
1,<environment.Job instance at 0x7f3c22735640>,47,28,[ 2 10],48,-1,151,-1,123
1,<environment.Job instance at 0x7f3c22777410>,52,15,[ 2 13],53,-1,144,-1,129
1,<environment.Job instance at 0x7f3c22756320>,54,20,[13  4],55,-1,157,-1,137
1,<environment.Job instance at 0x7f3c226f1eb0>,63,1,[12  5],64,-1,155,-1,154
1,<environment.Job instance at 0x7f3c226f84b0>,70,24,[1 5],71,-1,197,-1,173
1,<environment.Job instance at 0x7f3c227880f0>,76,13,[ 5 14],77,-1,200,-1,187
1,<environment.Job instance at 0x7f3c226fe5a0>,83,24,[3 7],84,-1,243,-1,219
1,<environment.Job instance at 0x7f3c225432d0>,0,17,[3 5],1,-1,19,-1,2
1,<environment.Job instance at 0x7f3c22543dc0>,1,18,[6 2],2,-1,20,-1,2
1,<environment.Job instance at 0x7f3c22543050>,4,19,[6 2],5,-1,24,-1,5
1,<environment.Job instance at 0x7f3c225433c0>,6,17,[9 1],7,-1,25,-1,8
1,<environment.Job instance at 0x7f3c22543410>,7,13,[9 5],8,-1,21,-1,8
1,<environment.Job instance at 0x7f3c2c6ef1e0>,9,1,[5 3],10,-1,11,-1,10
1,<environment.Job instance at 0x7f3c2c6ef230>,10,17,[9 5],11,-1,30,-1,13
1,<environment.Job instance at 0x7f3c225a19b0>,14,26,[3 9],15,-1,41,-1,15
1,<environment.Job instance at 0x7f3c225a1a50>,12,15,[ 2 14],13,-1,33,-1,18
1,<environment.Job instance at 0x7f3c2c6ef320>,18,21,[2 7],19,-1,40,-1,19
1,<environment.Job instance at 0x7f3c225a1b40>,20,23,[4 7],21,-1,44,-1,21
1,<environment.Job instance at 0x7f3c225a1320>,21,14,[ 1 10],22,-1,36,-1,22
1,<environment.Job instance at 0x7f3c225a13c0>,22,3,[8 2],23,-1,27,-1,24
1,<environment.Job instance at 0x7f3c225a1c30>,23,14,[5 9],24,-1,38,-1,24
1,<environment.Job instance at 0x7f3c2252fa50>,25,19,[ 1 10],26,-1,45,-1,26
1,<environment.Job instance at 0x7f3c2252fcd0>,26,16,[6 5],27,-1,43,-1,27
1,<environment.Job instance at 0x7f3c2252ffa0>,27,2,[10  3],28,-1,31,-1,29
1,<environment.Job instance at 0x7f3c2252f0f0>,28,20,[ 2 10],29,-1,49,-1,29
1,<environment.Job instance at 0x7f3c2252fb90>,31,17,[3 6],32,-1,49,-1,32
1,<environment.Job instance at 0x7f3c2252f7d0>,33,1,[4 8],34,-1,36,-1,35
1,<environment.Job instance at 0x7f3c2252f410>,35,21,[1 6],36,-1,57,-1,36
1,<environment.Job instance at 0x7f3c2252fe10>,36,16,[1 8],37,-1,53,-1,37
1,<environment.Job instance at 0x7f3c2252fbe0>,38,23,[1 9],39,-1,62,-1,39
1,<environment.Job instance at 0x7f3c2252f1e0>,39,17,[8 5],40,-1,57,-1,40
1,<environment.Job instance at 0x7f3c2c6ee050>,42,15,[8 2],43,-1,58,-1,43
1,<environment.Job instance at 0x7f3c2c6eedc0>,43,18,[5 1],44,-1,62,-1,44
1,<environment.Job instance at 0x7f3c2c6ee190>,44,15,[8 5],45,-1,60,-1,45
1,<environment.Job instance at 0x7f3c2c6ee280>,47,12,[4 8],48,-1,60,-1,48
1,<environment.Job instance at 0x7f3c2c6ee640>,48,19,[4 7],49,-1,68,-1,49
1,<environment.Job instance at 0x7f3c2c6ee730>,49,13,[4 5],50,-1,63,-1,50
1,<environment.Job instance at 0x7f3c2c6e4e10>,61,13,[8 1],62,-1,75,-1,62
1,<environment.Job instance at 0x7f3c2c6e4280>,62,12,[ 5 10],63,-1,75,-1,63
1,<environment.Job instance at 0x7f3c2260b190>,63,13,[9 2],64,-1,77,-1,64
1,<environment.Job instance at 0x7f3c2260b780>,64,13,[4 5],65,-1,78,-1,65
1,<environment.Job instance at 0x7f3c2260bc30>,65,27,[6 1],66,-1,93,-1,66
1,<environment.Job instance at 0x7f3c2260b5f0>,67,14,[10  3],68,-1,96,-1,82
1,<environment.Job instance at 0x7f3c2252a410>,83,26,[5 3],84,-1,118,-1,92
1,<environment.Job instance at 0x7f3c2252ae60>,85,18,[ 1 10],86,-1,110,-1,92
1,<environment.Job instance at 0x7f3c2252adc0>,86,15,[6 5],87,-1,107,-1,92
1,<environment.Job instance at 0x7f3c2260bb40>,72,23,[1 8],73,-1,116,-1,93
1,<environment.Job instance at 0x7f3c2252aaa0>,88,17,[1 5],89,-1,115,-1,98
1,<environment.Job instance at 0x7f3c2260b870>,8,27,[ 3 12],9,-1,36,-1,9
1,<environment.Job instance at 0x7f3c22543320>,12,15,[ 2 14],13,-1,37,-1,22
1,<environment.Job instance at 0x7f3c22832280>,14,26,[3 9],15,-1,60,-1,34
1,<environment.Job instance at 0x7f3c225a1aa0>,20,23,[4 7],21,-1,65,-1,42
1,<environment.Job instance at 0x7f3c2259bf50>,30,1,[14  4],31,-1,68,-1,67
1,<environment.Job instance at 0x7f3c2259b190>,37,18,[ 1 14],38,-1,108,-1,90
1,<environment.Job instance at 0x7f3c2259b3c0>,38,23,[1 9],39,-1,113,-1,90
1,<environment.Job instance at 0x7f3c2259b410>,45,17,[12  1],46,-1,123,-1,106
1,<environment.Job instance at 0x7f3c2c6e6870>,50,16,[14  3],51,-1,144,-1,128
1,<environment.Job instance at 0x7f3c2c61bb40>,57,2,[ 1 12],58,-1,145,-1,143
1,<environment.Job instance at 0x7f3c2c61b870>,65,27,[6 1],66,-1,213,-1,186
1,<environment.Job instance at 0x7f3c225805f0>,72,23,[1 8],73,-1,233,-1,210
1,<environment.Job instance at 0x7f3c22580b40>,83,26,[5 3],84,-1,258,-1,232
1,<environment.Job instance at 0x7f3c23427730>,0,18,[5 8],1,-1,19,-1,1
1,<environment.Job instance at 0x7f3c23427f50>,2,18,[3 8],3,-1,21,-1,3
1,<environment.Job instance at 0x7f3c23427410>,6,17,[8 4],7,-1,25,-1,8
1,<environment.Job instance at 0x7f3c234273c0>,8,20,[5 2],9,-1,29,-1,9
1,<environment.Job instance at 0x7f3c22989b90>,9,26,[2 8],10,-1,36,-1,10
1,<environment.Job instance at 0x7f3c229897d0>,10,15,[5 8],11,-1,26,-1,11
1,<environment.Job instance at 0x7f3c22989550>,11,20,[ 4 10],12,-1,32,-1,12
1,<environment.Job instance at 0x7f3c22989460>,12,15,[9 2],13,-1,28,-1,13
1,<environment.Job instance at 0x7f3c22989870>,14,16,[7 5],15,-1,31,-1,15
1,<environment.Job instance at 0x7f3c233a6410>,17,27,[9 5],18,-1,45,-1,18
1,<environment.Job instance at 0x7f3c233a6640>,18,13,[8 4],19,-1,32,-1,19
1,<environment.Job instance at 0x7f3c233a65a0>,29,15,[6 5],30,-1,45,-1,30
1,<environment.Job instance at 0x7f3c233cb640>,33,17,[7 4],34,-1,51,-1,34
1,<environment.Job instance at 0x7f3c2333f780>,48,14,[9 4],49,-1,65,-1,51
1,<environment.Job instance at 0x7f3c23669b40>,7,15,[3 6],8,-1,66,-1,51
1,<environment.Job instance at 0x7f3c2333fa00>,49,18,[5 6],50,-1,72,-1,54
1,<environment.Job instance at 0x7f3c2333f500>,55,27,[4 5],56,-1,143,-1,116
1,<environment.Job instance at 0x7f3c2333fd70>,50,16,[8 3],51,-1,133,-1,117
1,<environment.Job instance at 0x7f3c2333f4b0>,62,20,[4 9],63,-1,170,-1,150
1,<environment.Job instance at 0x7f3c233cbc30>,32,25,[ 3 11],33,-1,177,-1,152
1,<environment.Job instance at 0x7f3c2333fe60>,63,12,[2 7],64,-1,164,-1,152
1,<environment.Job instance at 0x7f3c2c59c0a0>,74,21,[4 9],75,-1,173,-1,152
1,<environment.Job instance at 0x7f3c2c59c050>,73,17,[7 1],74,-1,170,-1,153
1,<environment.Job instance at 0x7f3c2c59c410>,77,13,[12  1],78,-1,166,-1,153
1,<environment.Job instance at 0x7f3c2c59c910>,80,14,[2 9],81,-1,167,-1,153
1,<environment.Job instance at 0x7f3c2c59c370>,76,13,[2 5],77,-1,169,-1,156
1,<environment.Job instance at 0x7f3c2c59c820>,86,25,[2 8],87,-1,181,-1,156
1,<environment.Job instance at 0x7f3c2c59c960>,87,14,[3 6],88,-1,170,-1,156
1,<environment.Job instance at 0x7f3c233cb730>,38,14,[7 1],39,-1,170,-1,156
1,<environment.Job instance at 0x7f3c2c59ca50>,88,12,[6 4],89,-1,168,-1,156
1,<environment.Job instance at 0x7f3c2c59ccd0>,72,17,[5 9],73,-1,173,-1,156
1,<environment.Job instance at 0x7f3c2c59c9b0>,84,16,[5 2],85,-1,172,-1,156
1,<environment.Job instance at 0x7f3c2333f7d0>,9,26,[2 8],10,-1,47,-1,21
1,<environment.Job instance at 0x7f3c230760a0>,17,27,[9 5],18,-1,70,-1,43
1,<environment.Job instance at 0x7f3c23076e10>,19,14,[12  2],20,-1,57,-1,43
1,<environment.Job instance at 0x7f3c2267bd70>,31,17,[ 5 14],32,-1,99,-1,82
1,<environment.Job instance at 0x7f3c22c13550>,32,25,[ 3 11],33,-1,107,-1,82
1,<environment.Job instance at 0x7f3c22c13910>,34,17,[13  5],35,-1,100,-1,83
1,<environment.Job instance at 0x7f3c22c137d0>,35,13,[ 5 14],36,-1,96,-1,83
1,<environment.Job instance at 0x7f3c233edf50>,55,27,[4 5],56,-1,194,-1,167
1,<environment.Job instance at 0x7f3c233ed280>,57,12,[13  4],58,-1,179,-1,167
1,<environment.Job instance at 0x7f3c233ed5f0>,58,12,[ 5 12],59,-1,179,-1,167
1,<environment.Job instance at 0x7f3c232bdb90>,77,13,[12  1],78,-1,228,-1,215
1,<environment.Job instance at 0x7f3c232bda00>,78,12,[14  3],79,-1,227,-1,215
1,<environment.Job instance at 0x7f3c232bdf00>,79,1,[ 4 11],80,-1,216,-1,215
1,<environment.Job instance at 0x7f3c2342cf00>,86,25,[2 8],87,-1,271,-1,246
1,<environment.Job instance at 0x7f3c23492b90>,0,26,[8 3],1,-1,27,-1,1
1,<environment.Job instance at 0x7f3c2c61bfa0>,5,13,[9 1],6,-1,20,-1,7
1,<environment.Job instance at 0x7f3c2339a870>,7,3,[10  5],8,-1,11,-1,8
1,<environment.Job instance at 0x7f3c233b14b0>,6,18,[8 3],7,-1,26,-1,8
1,<environment.Job instance at 0x7f3c233dc910>,11,18,[5 8],12,-1,30,-1,12
1,<environment.Job instance at 0x7f3c233dcaf0>,12,14,[2 8],13,-1,27,-1,13
1,<environment.Job instance at 0x7f3c233dc7d0>,17,13,[ 5 10],18,-1,31,-1,18
1,<environment.Job instance at 0x7f3c233ef0f0>,19,18,[5 2],20,-1,38,-1,20
1,<environment.Job instance at 0x7f3c233efe10>,20,16,[ 4 10],21,-1,37,-1,21
1,<environment.Job instance at 0x7f3c2339aeb0>,21,15,[5 7],22,-1,37,-1,22
1,<environment.Job instance at 0x7f3c233bb050>,22,17,[8 2],23,-1,40,-1,23
1,<environment.Job instance at 0x7f3c228f3e60>,25,17,[12  4],26,-1,43,-1,26
1,<environment.Job instance at 0x7f3c228f7b40>,26,17,[7 4],27,-1,44,-1,27
1,<environment.Job instance at 0x7f3c23ab3500>,29,18,[10  4],30,-1,48,-1,30
1,<environment.Job instance at 0x7f3c23ab3a00>,30,15,[1 9],31,-1,46,-1,31
1,<environment.Job instance at 0x7f3c23ab0960>,31,13,[1 7],32,-1,45,-1,32
1,<environment.Job instance at 0x7f3c23ac7eb0>,33,14,[5 6],34,-1,48,-1,34
1,<environment.Job instance at 0x7f3c23aa3c80>,34,18,[10  5],35,-1,53,-1,35
1,<environment.Job instance at 0x7f3c23acff50>,36,16,[2 9],37,-1,53,-1,37
1,<environment.Job instance at 0x7f3c229c4640>,38,15,[10  4],39,-1,56,-1,41
1,<environment.Job instance at 0x7f3c229bfeb0>,41,16,[4 5],42,-1,58,-1,42
1,<environment.Job instance at 0x7f3c22c663c0>,40,16,[8 5],41,-1,58,-1,42
1,<environment.Job instance at 0x7f3c229bf8c0>,42,27,[8 3],43,-1,71,-1,44
1,<environment.Job instance at 0x7f3c23aa5050>,44,17,[2 6],45,-1,62,-1,45
1,<environment.Job instance at 0x7f3c229b6d70>,43,18,[1 6],44,-1,64,-1,46
1,<environment.Job instance at 0x7f3c229b69b0>,46,27,[2 6],47,-1,74,-1,47
1,<environment.Job instance at 0x7f3c23aca190>,47,16,[7 4],48,-1,64,-1,48
1,<environment.Job instance at 0x7f3c23aca0a0>,48,16,[9 2],49,-1,67,-1,51
1,<environment.Job instance at 0x7f3c23aca0f0>,51,16,[4 5],52,-1,68,-1,52
1,<environment.Job instance at 0x7f3c23aca9b0>,54,12,[8 1],55,-1,67,-1,55
1,<environment.Job instance at 0x7f3c22c87c30>,60,12,[10  5],61,-1,73,-1,61
1,<environment.Job instance at 0x7f3c22c87c80>,62,16,[6 4],63,-1,79,-1,63
1,<environment.Job instance at 0x7f3c22c87eb0>,64,14,[3 6],65,-1,79,-1,65
1,<environment.Job instance at 0x7f3c23aca780>,50,14,[ 4 14],51,-1,79,-1,65
1,<environment.Job instance at 0x7f3c22c850a0>,66,21,[ 4 10],67,-1,89,-1,68
1,<environment.Job instance at 0x7f3c22c85140>,68,3,[11  1],69,-1,72,-1,69
1,<environment.Job instance at 0x7f3c22c859b0>,74,13,[ 4 11],75,-1,88,-1,75
1,<environment.Job instance at 0x7f3c22c85910>,75,17,[ 5 10],76,-1,93,-1,76
1,<environment.Job instance at 0x7f3c22c85a00>,76,14,[9 4],77,-1,91,-1,77
1,<environment.Job instance at 0x7f3c22c85c80>,78,14,[8 2],79,-1,93,-1,79
1,<environment.Job instance at 0x7f3c22c85d70>,80,25,[6 4],81,-1,106,-1,81
1,<environment.Job instance at 0x7f3c22c932d0>,84,24,[5 5],85,-1,109,-1,85
1,<environment.Job instance at 0x7f3c22c93230>,85,3,[8 5],86,-1,89,-1,86
1,<environment.Job instance at 0x7f3c22c93370>,86,14,[2 5],87,-1,101,-1,87
1,<environment.Job instance at 0x7f3c22c935a0>,88,28,[ 5 10],89,-1,117,-1,89
1,<environment.Job instance at 0x7f3c22c85370>,67,23,[2 8],68,-1,112,-1,89
1,<environment.Job instance at 0x7f3c233eb910>,0,26,[8 3],1,-1,27,-1,1
1,<environment.Job instance at 0x7f3c22c85050>,14,2,[11  3],15,-1,25,-1,23
1,<environment.Job instance at 0x7f3c232bdd70>,25,17,[12  4],26,-1,86,-1,69
1,<environment.Job instance at 0x7f3c23513230>,37,2,[ 3 11],38,-1,120,-1,118
1,<environment.Job instance at 0x7f3c233ed640>,42,27,[8 3],43,-1,177,-1,150
1,<environment.Job instance at 0x7f3c233ed870>,46,27,[2 6],47,-1,194,-1,167
1,<environment.Job instance at 0x7f3c233ed4b0>,50,14,[ 4 14],51,-1,197,-1,183
1,<environment.Job instance at 0x7f3c2c61be60>,67,23,[2 8],68,-1,258,-1,235
1,<environment.Job instance at 0x7f3c2c61b4b0>,68,3,[11  1],69,-1,238,-1,235
1,<environment.Job instance at 0x7f3c2c61b230>,69,19,[13  3],70,-1,254,-1,235
1,<environment.Job instance at 0x7f3c23427b90>,74,13,[ 4 11],75,-1,266,-1,253
1,<environment.Job instance at 0x7f3c23076b40>,79,17,[12  4],80,-1,285,-1,268
1,<environment.Job instance at 0x7f3c23076460>,80,25,[6 4],81,-1,298,-1,273
1,<environment.Job instance at 0x7f3c23076eb0>,82,3,[14  5],83,-1,276,-1,273
1,<environment.Job instance at 0x7f3c2c59c1e0>,84,24,[5 5],85,-1,306,-1,282
1,<environment.Job instance at 0x7f3c2333f2d0>,88,28,[ 5 10],89,-1,327,-1,299
1,<environment.Job instance at 0x7f3c229c44b0>,1,17,[7 5],2,-1,19,-1,2
1,<environment.Job instance at 0x7f3c23371dc0>,8,15,[2 9],9,-1,26,-1,11
1,<environment.Job instance at 0x7f3c23371a50>,13,15,[6 4],14,-1,29,-1,14
1,<environment.Job instance at 0x7f3c233712d0>,16,12,[10  2],17,-1,29,-1,17
1,<environment.Job instance at 0x7f3c23371370>,17,12,[6 2],18,-1,30,-1,18
1,<environment.Job instance at 0x7f3c23371e60>,18,13,[8 3],19,-1,32,-1,19
1,<environment.Job instance at 0x7f3c2337bd20>,22,14,[5 3],23,-1,38,-1,24
1,<environment.Job instance at 0x7f3c2337b190>,24,22,[7 3],25,-1,47,-1,25
1,<environment.Job instance at 0x7f3c2337b230>,25,20,[7 5],26,-1,46,-1,26
1,<environment.Job instance at 0x7f3c2337b280>,23,12,[2 7],24,-1,39,-1,27
1,<environment.Job instance at 0x7f3c2337b050>,31,15,[7 1],32,-1,47,-1,32
1,<environment.Job instance at 0x7f3c2337b780>,35,12,[4 5],36,-1,48,-1,36
1,<environment.Job instance at 0x7f3c233937d0>,37,18,[8 2],38,-1,56,-1,38
1,<environment.Job instance at 0x7f3c23393320>,40,15,[2 5],41,-1,56,-1,41
1,<environment.Job instance at 0x7f3c23393eb0>,42,17,[4 5],43,-1,60,-1,43
1,<environment.Job instance at 0x7f3c23393370>,43,14,[9 3],44,-1,60,-1,46
1,<environment.Job instance at 0x7f3c23393c30>,46,16,[1 9],47,-1,63,-1,47
1,<environment.Job instance at 0x7f3c23393410>,47,16,[7 2],48,-1,64,-1,48
1,<environment.Job instance at 0x7f3c23393780>,45,17,[8 2],46,-1,66,-1,49
1,<environment.Job instance at 0x7f3c23393230>,52,16,[10  4],53,-1,70,-1,54
1,<environment.Job instance at 0x7f3c2338f0f0>,54,16,[9 5],55,-1,71,-1,55
1,<environment.Job instance at 0x7f3c2338f5f0>,55,2,[9 1],56,-1,58,-1,56
1,<environment.Job instance at 0x7f3c2338f280>,53,16,[6 5],54,-1,72,-1,56
1,<environment.Job instance at 0x7f3c2338f2d0>,56,22,[1 8],57,-1,80,-1,58
1,<environment.Job instance at 0x7f3c2338f690>,57,28,[5 9],58,-1,87,-1,59
1,<environment.Job instance at 0x7f3c2338f320>,59,18,[5 8],60,-1,78,-1,60
1,<environment.Job instance at 0x7f3c2338f370>,60,18,[ 2 10],61,-1,80,-1,62
1,<environment.Job instance at 0x7f3c2338fcd0>,61,15,[8 1],62,-1,77,-1,62
1,<environment.Job instance at 0x7f3c233aa1e0>,66,18,[ 5 10],67,-1,85,-1,67
1,<environment.Job instance at 0x7f3c233aaf00>,72,26,[5 8],73,-1,103,-1,77
1,<environment.Job instance at 0x7f3c233affa0>,80,14,[7 2],81,-1,95,-1,81
1,<environment.Job instance at 0x7f3c233af140>,83,22,[3 5],84,-1,119,-1,97
1,<environment.Job instance at 0x7f3c233af1e0>,85,18,[4 6],86,-1,115,-1,97
1,<environment.Job instance at 0x7f3c23393b40>,6,12,[ 5 12],7,-1,19,-1,7
1,<environment.Job instance at 0x7f3c2338f3c0>,9,2,[ 5 14],10,-1,17,-1,15
1,<environment.Job instance at 0x7f3c230765a0>,21,16,[ 1 14],22,-1,65,-1,49
1,<environment.Job instance at 0x7f3c23a96640>,34,17,[14  5],35,-1,94,-1,77
1,<environment.Job instance at 0x7f3c233dc730>,41,2,[14  5],42,-1,95,-1,93
1,<environment.Job instance at 0x7f3c23083780>,57,28,[5 9],58,-1,193,-1,165
1,<environment.Job instance at 0x7f3c22db0d70>,67,28,[9 1],68,-1,234,-1,206
1,<environment.Job instance at 0x7f3c2306b050>,72,26,[5 8],73,-1,247,-1,221
1,<environment.Job instance at 0x7f3c2306baa0>,76,2,[ 5 13],77,-1,226,-1,224
1,<environment.Job instance at 0x7f3c2306b3c0>,81,1,[13  4],82,-1,241,-1,240
1,<environment.Job instance at 0x7f3c23982140>,88,2,[12  3],89,-1,272,-1,270
1,<environment.Job instance at 0x7f3c2306bc80>,87,28,[ 5 10],88,-1,341,-1,313
1,<environment.Job instance at 0x7f3c23ab3d70>,1,12,[1 6],2,-1,14,-1,2
1,<environment.Job instance at 0x7f3c23076460>,2,21,[5 7],3,-1,24,-1,3
1,<environment.Job instance at 0x7f3c228a4960>,5,16,[4 7],6,-1,22,-1,6
1,<environment.Job instance at 0x7f3c228a4870>,6,18,[9 3],7,-1,25,-1,7
1,<environment.Job instance at 0x7f3c22b2be60>,8,16,[1 7],9,-1,25,-1,9
1,<environment.Job instance at 0x7f3c22b2bbe0>,9,18,[8 2],10,-1,28,-1,10
1,<environment.Job instance at 0x7f3c2344deb0>,13,17,[4 7],14,-1,31,-1,14
1,<environment.Job instance at 0x7f3c22b21aa0>,14,16,[ 5 10],15,-1,31,-1,15
1,<environment.Job instance at 0x7f3c2340caf0>,15,15,[5 9],16,-1,31,-1,16
1,<environment.Job instance at 0x7f3c22b29190>,20,26,[3 7],21,-1,47,-1,21
1,<environment.Job instance at 0x7f3c233fdfa0>,24,16,[1 5],25,-1,42,-1,26
1,<environment.Job instance at 0x7f3c228ab7d0>,25,18,[4 9],26,-1,45,-1,27
1,<environment.Job instance at 0x7f3c22898500>,27,18,[10  5],28,-1,46,-1,28
1,<environment.Job instance at 0x7f3c2341f410>,30,13,[10  1],31,-1,44,-1,31
1,<environment.Job instance at 0x7f3c23461e60>,31,3,[5 1],32,-1,35,-1,32
1,<environment.Job instance at 0x7f3c23a80500>,36,12,[10  1],37,-1,53,-1,41
1,<environment.Job instance at 0x7f3c22b55910>,41,27,[7 1],42,-1,69,-1,42
1,<environment.Job instance at 0x7f3c228d4cd0>,42,26,[ 3 10],43,-1,69,-1,43
1,<environment.Job instance at 0x7f3c22b55a50>,40,17,[5 6],41,-1,62,-1,45
1,<environment.Job instance at 0x7f3c228d4eb0>,45,21,[ 2 10],46,-1,67,-1,46
1,<environment.Job instance at 0x7f3c228bf910>,48,12,[ 2 11],49,-1,61,-1,49
1,<environment.Job instance at 0x7f3c228c8460>,49,13,[4 7],50,-1,63,-1,50
1,<environment.Job instance at 0x7f3c228c8050>,50,16,[10  1],51,-1,67,-1,51
1,<environment.Job instance at 0x7f3c228d4b40>,46,15,[10  2],47,-1,76,-1,61
1,<environment.Job instance at 0x7f3c23768be0>,61,13,[10  2],62,-1,76,-1,63
1,<environment.Job instance at 0x7f3c237689b0>,63,24,[2 6],64,-1,88,-1,64
1,<environment.Job instance at 0x7f3c23768dc0>,66,14,[8 4],67,-1,82,-1,68
1,<environment.Job instance at 0x7f3c23408d70>,34,12,[9 3],35,-1,80,-1,68
1,<environment.Job instance at 0x7f3c23768fa0>,67,14,[9 2],68,-1,82,-1,68
1,<environment.Job instance at 0x7f3c2376a2d0>,70,14,[5 8],71,-1,87,-1,73
1,<environment.Job instance at 0x7f3c2376a500>,74,18,[6 2],75,-1,104,-1,86
1,<environment.Job instance at 0x7f3c2376ac80>,82,27,[5 7],83,-1,113,-1,86
1,<environment.Job instance at 0x7f3c237810f0>,85,16,[9 2],86,-1,102,-1,86
1,<environment.Job instance at 0x7f3c237813c0>,86,15,[10  3],87,-1,102,-1,87
1,<environment.Job instance at 0x7f3c2376abe0>,81,14,[3 6],82,-1,102,-1,88
1,<environment.Job instance at 0x7f3c237810a0>,87,15,[9 1],88,-1,104,-1,89
1,<environment.Job instance at 0x7f3c2306b4b0>,20,26,[3 7],21,-1,89,-1,63
1,<environment.Job instance at 0x7f3c2306b370>,21,18,[11  5],22,-1,81,-1,63
1,<environment.Job instance at 0x7f3c22db0aa0>,29,1,[12  2],30,-1,88,-1,87
1,<environment.Job instance at 0x7f3c23ab9730>,32,24,[1 9],33,-1,127,-1,103
1,<environment.Job instance at 0x7f3c230760f0>,41,27,[7 1],42,-1,160,-1,133
1,<environment.Job instance at 0x7f3c23076550>,43,2,[ 3 13],44,-1,135,-1,133
1,<environment.Job instance at 0x7f3c230764b0>,42,26,[ 3 10],43,-1,170,-1,144
1,<environment.Job instance at 0x7f3c233aa3c0>,47,1,[ 3 14],48,-1,145,-1,144
1,<environment.Job instance at 0x7f3c22893b40>,48,12,[ 2 11],49,-1,156,-1,144
1,<environment.Job instance at 0x7f3c226d9a00>,51,17,[11  3],52,-1,162,-1,145
1,<environment.Job instance at 0x7f3c22cae140>,52,16,[12  1],53,-1,161,-1,145
1,<environment.Job instance at 0x7f3c2338f3c0>,53,15,[ 4 13],54,-1,160,-1,145
1,<environment.Job instance at 0x7f3c23393c30>,63,24,[2 6],64,-1,217,-1,193
1,<environment.Job instance at 0x7f3c23aa3640>,64,13,[ 5 12],65,-1,206,-1,193
1,<environment.Job instance at 0x7f3c23aa3e10>,65,2,[ 2 11],66,-1,195,-1,193
1,<environment.Job instance at 0x7f3c22e59eb0>,82,27,[5 7],83,-1,284,-1,257
1,<environment.Job instance at 0x7f3c22bcc960>,84,24,[13  2],85,-1,281,-1,257
1,<environment.Job instance at 0x7f3c227d59b0>,88,15,[11  4],89,-1,284,-1,269
1,<environment.Job instance at 0x7f3c234b92d0>,9,17,[6 2],10,-1,28,-1,11
1,<environment.Job instance at 0x7f3c234b9cd0>,11,18,[4 9],12,-1,30,-1,12
1,<environment.Job instance at 0x7f3c234b96e0>,13,1,[1 5],14,-1,15,-1,14
1,<environment.Job instance at 0x7f3c234b9be0>,14,1,[2 8],15,-1,16,-1,15
1,<environment.Job instance at 0x7f3c234b9d70>,15,16,[6 2],16,-1,32,-1,16
1,<environment.Job instance at 0x7f3c234b9e60>,16,16,[8 2],17,-1,33,-1,17
1,<environment.Job instance at 0x7f3c23727730>,10,17,[5 2],11,-1,34,-1,17
1,<environment.Job instance at 0x7f3c234b9320>,18,14,[8 5],19,-1,34,-1,20
1,<environment.Job instance at 0x7f3c234b9af0>,20,18,[ 4 11],21,-1,39,-1,21
1,<environment.Job instance at 0x7f3c234b9b90>,21,18,[ 3 10],22,-1,40,-1,22
1,<environment.Job instance at 0x7f3c234b9b40>,23,24,[8 5],24,-1,48,-1,24
1,<environment.Job instance at 0x7f3c234b9690>,24,14,[ 1 10],25,-1,39,-1,25
1,<environment.Job instance at 0x7f3c233eb4b0>,25,13,[5 7],26,-1,39,-1,26
1,<environment.Job instance at 0x7f3c233eb370>,29,15,[1 6],30,-1,45,-1,30
1,<environment.Job instance at 0x7f3c233eb230>,31,15,[8 1],32,-1,47,-1,32
1,<environment.Job instance at 0x7f3c233eb500>,32,16,[5 4],33,-1,49,-1,33
1,<environment.Job instance at 0x7f3c233eb9b0>,33,15,[ 3 10],34,-1,49,-1,34
1,<environment.Job instance at 0x7f3c233eb320>,35,15,[5 6],36,-1,51,-1,36
1,<environment.Job instance at 0x7f3c22686140>,38,20,[3 9],39,-1,59,-1,39
1,<environment.Job instance at 0x7f3c22686280>,40,16,[5 4],41,-1,57,-1,41
1,<environment.Job instance at 0x7f3c226865f0>,41,17,[ 4 10],42,-1,59,-1,42
1,<environment.Job instance at 0x7f3c22686550>,44,17,[3 5],45,-1,62,-1,45
1,<environment.Job instance at 0x7f3c226861e0>,47,21,[4 8],48,-1,69,-1,48
1,<environment.Job instance at 0x7f3c22686a50>,48,23,[3 9],49,-1,72,-1,49
1,<environment.Job instance at 0x7f3c226867d0>,49,13,[10  5],50,-1,63,-1,50
1,<environment.Job instance at 0x7f3c22686fa0>,51,13,[2 5],52,-1,65,-1,52
1,<environment.Job instance at 0x7f3c22686c30>,52,14,[2 6],53,-1,67,-1,53
1,<environment.Job instance at 0x7f3c23293550>,54,18,[6 4],55,-1,73,-1,55
1,<environment.Job instance at 0x7f3c234b9c30>,19,16,[7 4],20,-1,71,-1,55
1,<environment.Job instance at 0x7f3c232936e0>,56,12,[1 7],57,-1,70,-1,58
1,<environment.Job instance at 0x7f3c23293c30>,58,16,[1 7],59,-1,75,-1,59
1,<environment.Job instance at 0x7f3c23293af0>,59,15,[ 2 10],60,-1,75,-1,60
1,<environment.Job instance at 0x7f3c22670e10>,65,13,[6 4],66,-1,79,-1,66
1,<environment.Job instance at 0x7f3c22670a00>,66,3,[ 4 10],67,-1,70,-1,67
1,<environment.Job instance at 0x7f3c22670320>,71,16,[8 4],72,-1,88,-1,72
1,<environment.Job instance at 0x7f3c226702d0>,73,18,[6 4],74,-1,92,-1,74
1,<environment.Job instance at 0x7f3c226860f0>,1,14,[ 4 13],2,-1,16,-1,2
1,<environment.Job instance at 0x7f3c233eb730>,17,14,[11  4],18,-1,45,-1,31
1,<environment.Job instance at 0x7f3c23393c30>,20,18,[ 4 11],21,-1,65,-1,47
1,<environment.Job instance at 0x7f3c233bed70>,23,24,[8 5],24,-1,89,-1,65
1,<environment.Job instance at 0x7f3c2376a820>,28,13,[12  1],29,-1,95,-1,82
1,<environment.Job instance at 0x7f3c22b29410>,36,3,[14  2],37,-1,102,-1,99
1,<environment.Job instance at 0x7f3c236c3eb0>,43,14,[ 5 13],44,-1,140,-1,126
1,<environment.Job instance at 0x7f3c2277d500>,48,23,[3 9],49,-1,169,-1,146
1,<environment.Job instance at 0x7f3c2277dcd0>,60,2,[ 1 11],61,-1,198,-1,196
1,<environment.Job instance at 0x7f3c23b88960>,67,12,[ 3 14],68,-1,232,-1,220
1,<environment.Job instance at 0x7f3c23b88370>,78,16,[13  3],79,-1,257,-1,241
1,<environment.Job instance at 0x7f3c2237f5f0>,1,16,[1 6],2,-1,18,-1,2
1,<environment.Job instance at 0x7f3c2237fe10>,3,27,[3 5],4,-1,31,-1,4
1,<environment.Job instance at 0x7f3c2237fd20>,7,17,[5 7],8,-1,25,-1,8
1,<environment.Job instance at 0x7f3c2234fbe0>,13,12,[9 3],14,-1,26,-1,14
1,<environment.Job instance at 0x7f3c2234f2d0>,15,14,[5 2],16,-1,30,-1,16
1,<environment.Job instance at 0x7f3c2234f0a0>,17,17,[2 6],18,-1,35,-1,18
1,<environment.Job instance at 0x7f3c2234ffa0>,18,17,[5 4],19,-1,36,-1,19
1,<environment.Job instance at 0x7f3c2234f820>,20,16,[9 4],21,-1,37,-1,21
1,<environment.Job instance at 0x7f3c2234fb90>,22,12,[8 3],23,-1,35,-1,23
1,<environment.Job instance at 0x7f3c2234ff50>,23,13,[5 6],24,-1,37,-1,24
1,<environment.Job instance at 0x7f3c2234f460>,25,18,[3 9],26,-1,44,-1,26
1,<environment.Job instance at 0x7f3c22338960>,26,27,[10  4],27,-1,54,-1,27
1,<environment.Job instance at 0x7f3c22338a50>,28,14,[4 5],29,-1,43,-1,29
1,<environment.Job instance at 0x7f3c22338140>,29,14,[9 4],30,-1,44,-1,30
1,<environment.Job instance at 0x7f3c22338280>,31,18,[4 8],32,-1,50,-1,32
1,<environment.Job instance at 0x7f3c223388c0>,32,25,[7 3],33,-1,58,-1,33
1,<environment.Job instance at 0x7f3c22338640>,36,17,[2 9],37,-1,55,-1,38
1,<environment.Job instance at 0x7f3c22338b90>,38,13,[ 3 10],39,-1,52,-1,39
1,<environment.Job instance at 0x7f3c22338460>,39,14,[4 7],40,-1,54,-1,40
1,<environment.Job instance at 0x7f3c22338d20>,40,16,[10  3],41,-1,57,-1,41
1,<environment.Job instance at 0x7f3c22338550>,41,17,[10  5],42,-1,59,-1,42
1,<environment.Job instance at 0x7f3c22338910>,43,17,[6 1],44,-1,61,-1,44
1,<environment.Job instance at 0x7f3c22378820>,46,13,[8 5],47,-1,60,-1,47
1,<environment.Job instance at 0x7f3c22378cd0>,49,18,[5 2],50,-1,68,-1,50
1,<environment.Job instance at 0x7f3c223784b0>,54,12,[3 7],55,-1,67,-1,55
1,<environment.Job instance at 0x7f3c22378c80>,55,12,[3 7],56,-1,68,-1,56
1,<environment.Job instance at 0x7f3c22378410>,57,16,[2 7],58,-1,74,-1,58
1,<environment.Job instance at 0x7f3c22378870>,58,15,[6 2],59,-1,74,-1,59
1,<environment.Job instance at 0x7f3c223786e0>,59,14,[7 2],60,-1,74,-1,60
1,<environment.Job instance at 0x7f3c22397dc0>,60,18,[1 7],61,-1,79,-1,61
1,<environment.Job instance at 0x7f3c22397f50>,61,14,[1 7],62,-1,76,-1,62
1,<environment.Job instance at 0x7f3c223dffa0>,62,14,[8 5],63,-1,77,-1,63
1,<environment.Job instance at 0x7f3c235ea370>,65,26,[4 8],66,-1,92,-1,66
1,<environment.Job instance at 0x7f3c235eaaa0>,66,20,[4 8],67,-1,87,-1,67
1,<environment.Job instance at 0x7f3c235eab90>,68,16,[8 4],69,-1,85,-1,69
1,<environment.Job instance at 0x7f3c2355f3c0>,70,25,[5 4],71,-1,96,-1,71
1,<environment.Job instance at 0x7f3c2355fd20>,71,21,[5 5],72,-1,93,-1,72
1,<environment.Job instance at 0x7f3c2355f6e0>,73,18,[ 2 10],74,-1,92,-1,74
1,<environment.Job instance at 0x7f3c2355f1e0>,74,13,[7 3],75,-1,88,-1,75
1,<environment.Job instance at 0x7f3c2355f410>,75,25,[5 7],76,-1,101,-1,76
1,<environment.Job instance at 0x7f3c2355fc30>,76,12,[5 9],77,-1,89,-1,77
1,<environment.Job instance at 0x7f3c222f05a0>,77,22,[5 8],78,-1,100,-1,78
1,<environment.Job instance at 0x7f3c235ea730>,80,15,[3 8],81,-1,96,-1,81
1,<environment.Job instance at 0x7f3c233568c0>,81,12,[3 9],82,-1,94,-1,82
1,<environment.Job instance at 0x7f3c22569050>,83,27,[8 5],84,-1,111,-1,84
1,<environment.Job instance at 0x7f3c2234f640>,4,1,[12  4],5,-1,6,-1,5
1,<environment.Job instance at 0x7f3c2237f320>,5,2,[14  1],6,-1,8,-1,6
1,<environment.Job instance at 0x7f3c222f0a50>,3,27,[3 5],4,-1,40,-1,13
1,<environment.Job instance at 0x7f3c2c7f1320>,26,27,[10  4],27,-1,98,-1,71
1,<environment.Job instance at 0x7f3c236670a0>,30,1,[ 5 11],31,-1,73,-1,72
1,<environment.Job instance at 0x7f3c22f34a50>,32,25,[7 3],33,-1,127,-1,102
1,<environment.Job instance at 0x7f3c22a1e500>,34,13,[ 3 12],35,-1,115,-1,102
1,<environment.Job instance at 0x7f3c22e4d0f0>,48,14,[13  2],49,-1,177,-1,163
1,<environment.Job instance at 0x7f3c232541e0>,65,26,[4 8],66,-1,251,-1,225
1,<environment.Job instance at 0x7f3c22a49190>,70,25,[5 4],71,-1,256,-1,231
1,<environment.Job instance at 0x7f3c22a3e870>,75,25,[5 7],76,-1,270,-1,245
1,<environment.Job instance at 0x7f3c23239be0>,79,3,[11  3],80,-1,260,-1,257
1,<environment.Job instance at 0x7f3c23239cd0>,83,27,[8 5],84,-1,301,-1,274
1,<environment.Job instance at 0x7f3c23239aa0>,84,12,[ 5 13],85,-1,286,-1,274
1,<environment.Job instance at 0x7f3c2251ca50>,5,14,[10  1],6,-1,22,-1,8
1,<environment.Job instance at 0x7f3c2251cc30>,8,15,[5 5],9,-1,24,-1,9
1,<environment.Job instance at 0x7f3c2251c1e0>,10,15,[6 3],11,-1,26,-1,11
1,<environment.Job instance at 0x7f3c2251c780>,11,18,[5 9],12,-1,30,-1,12
1,<environment.Job instance at 0x7f3c23b0a7d0>,13,18,[3 7],14,-1,32,-1,14
1,<environment.Job instance at 0x7f3c23b0a140>,14,27,[1 8],15,-1,42,-1,15
1,<environment.Job instance at 0x7f3c2251caf0>,7,17,[2 7],8,-1,35,-1,18
1,<environment.Job instance at 0x7f3c23b0a280>,20,18,[2 7],21,-1,39,-1,21
1,<environment.Job instance at 0x7f3c23b0a500>,23,13,[5 2],24,-1,38,-1,25
1,<environment.Job instance at 0x7f3c23397640>,25,13,[8 4],26,-1,39,-1,26
1,<environment.Job instance at 0x7f3c23397280>,26,13,[6 5],27,-1,40,-1,27
1,<environment.Job instance at 0x7f3c23397820>,27,13,[12  5],28,-1,41,-1,28
1,<environment.Job instance at 0x7f3c23b0a9b0>,24,23,[4 5],25,-1,51,-1,28
1,<environment.Job instance at 0x7f3c23397a50>,29,18,[7 4],30,-1,48,-1,30
1,<environment.Job instance at 0x7f3c23397f50>,34,18,[3 6],35,-1,53,-1,35
1,<environment.Job instance at 0x7f3c2266b410>,39,20,[6 3],40,-1,61,-1,41
1,<environment.Job instance at 0x7f3c2266bcd0>,46,14,[10  1],47,-1,61,-1,47
1,<environment.Job instance at 0x7f3c2266bf00>,43,20,[5 3],44,-1,68,-1,48
1,<environment.Job instance at 0x7f3c2266b190>,48,2,[2 5],49,-1,51,-1,49
1,<environment.Job instance at 0x7f3c2266b320>,49,12,[7 5],50,-1,62,-1,50
1,<environment.Job instance at 0x7f3c2266b640>,50,18,[5 6],51,-1,69,-1,51
1,<environment.Job instance at 0x7f3c2266baa0>,51,17,[2 9],52,-1,69,-1,52
1,<environment.Job instance at 0x7f3c2266b5a0>,54,12,[10  2],55,-1,70,-1,58
1,<environment.Job instance at 0x7f3c2355bb40>,60,20,[3 8],61,-1,81,-1,61
1,<environment.Job instance at 0x7f3c23397370>,36,26,[8 5],37,-1,88,-1,62
1,<environment.Job instance at 0x7f3c23397b40>,40,17,[5 8],41,-1,80,-1,63
1,<environment.Job instance at 0x7f3c22e414b0>,74,17,[1 8],75,-1,97,-1,80
1,<environment.Job instance at 0x7f3c22e41dc0>,79,22,[7 3],80,-1,106,-1,84
1,<environment.Job instance at 0x7f3c22e41b40>,81,12,[7 1],82,-1,96,-1,84
1,<environment.Job instance at 0x7f3c22e411e0>,82,25,[7 5],83,-1,109,-1,84
1,<environment.Job instance at 0x7f3c2355ba50>,66,26,[9 5],67,-1,110,-1,84
1,<environment.Job instance at 0x7f3c2266b820>,3,24,[3 5],4,-1,28,-1,4
1,<environment.Job instance at 0x7f3c2251ce60>,14,27,[1 8],15,-1,58,-1,31
1,<environment.Job instance at 0x7f3c22a3e870>,24,23,[4 5],25,-1,86,-1,63
1,<environment.Job instance at 0x7f3c23231820>,27,13,[12  5],28,-1,79,-1,66
1,<environment.Job instance at 0x7f3c22a49e60>,33,14,[ 4 11],34,-1,111,-1,97
1,<environment.Job instance at 0x7f3c23254be0>,36,26,[8 5],37,-1,127,-1,101
1,<environment.Job instance at 0x7f3c23254b40>,38,18,[13  1],39,-1,119,-1,101
1,<environment.Job instance at 0x7f3c228fb1e0>,58,16,[13  1],59,-1,187,-1,171
1,<environment.Job instance at 0x7f3c22a1e500>,61,3,[11  4],62,-1,176,-1,173
1,<environment.Job instance at 0x7f3c23388f50>,66,26,[9 5],67,-1,216,-1,190
1,<environment.Job instance at 0x7f3c22fdb730>,77,1,[ 4 12],78,-1,222,-1,221
1,<environment.Job instance at 0x7f3c22fdb460>,80,15,[13  3],81,-1,238,-1,223
1,<environment.Job instance at 0x7f3c22fdbe10>,82,25,[7 5],83,-1,251,-1,226
1,<environment.Job instance at 0x7f3c22fdb550>,83,2,[14  5],84,-1,228,-1,226
1,<environment.Job instance at 0x7f3c22fdb410>,84,2,[13  4],85,-1,228,-1,226
1,<environment.Job instance at 0x7f3c22fdbc80>,86,12,[12  4],87,-1,238,-1,226
1,<environment.Job instance at 0x7f3c236677d0>,0,16,[ 2 10],1,-1,20,-1,4
1,<environment.Job instance at 0x7f3c233fd780>,3,15,[4 8],4,-1,19,-1,4
1,<environment.Job instance at 0x7f3c23a58140>,6,18,[5 8],7,-1,26,-1,8
1,<environment.Job instance at 0x7f3c23a58230>,9,17,[ 2 10],10,-1,27,-1,10
1,<environment.Job instance at 0x7f3c23a58f50>,11,18,[8 1],12,-1,30,-1,12
1,<environment.Job instance at 0x7f3c23a58050>,12,15,[3 9],13,-1,28,-1,13
1,<environment.Job instance at 0x7f3c23a58460>,13,20,[8 4],14,-1,34,-1,14
1,<environment.Job instance at 0x7f3c23a58190>,17,27,[8 5],18,-1,45,-1,18
1,<environment.Job instance at 0x7f3c22690230>,19,17,[1 5],20,-1,37,-1,20
1,<environment.Job instance at 0x7f3c22690500>,20,13,[3 8],21,-1,34,-1,21
1,<environment.Job instance at 0x7f3c22690140>,21,15,[2 7],22,-1,37,-1,22
1,<environment.Job instance at 0x7f3c226906e0>,22,17,[3 5],23,-1,40,-1,23
1,<environment.Job instance at 0x7f3c22690370>,25,13,[10  5],26,-1,39,-1,26
1,<environment.Job instance at 0x7f3c22690c80>,26,17,[7 3],27,-1,44,-1,27
1,<environment.Job instance at 0x7f3c22690b90>,31,17,[9 4],32,-1,49,-1,32
1,<environment.Job instance at 0x7f3c23a80a00>,32,24,[4 6],33,-1,57,-1,33
1,<environment.Job instance at 0x7f3c23a80140>,34,18,[5 2],35,-1,53,-1,35
1,<environment.Job instance at 0x7f3c23a80780>,35,14,[10  1],36,-1,50,-1,36
1,<environment.Job instance at 0x7f3c23a58f00>,7,13,[5 8],8,-1,49,-1,36
1,<environment.Job instance at 0x7f3c23a80500>,40,16,[5 4],41,-1,57,-1,41
1,<environment.Job instance at 0x7f3c23a80280>,41,18,[7 2],42,-1,61,-1,43
1,<environment.Job instance at 0x7f3c228db8c0>,50,12,[ 3 12],51,-1,66,-1,54
1,<environment.Job instance at 0x7f3c228db4b0>,49,18,[ 5 10],50,-1,72,-1,54
1,<environment.Job instance at 0x7f3c228db6e0>,56,13,[8 4],57,-1,70,-1,57
1,<environment.Job instance at 0x7f3c228db190>,51,15,[5 5],52,-1,73,-1,58
1,<environment.Job instance at 0x7f3c228dbfa0>,57,17,[6 2],58,-1,75,-1,58
1,<environment.Job instance at 0x7f3c228dbd20>,58,16,[6 5],59,-1,75,-1,59
1,<environment.Job instance at 0x7f3c22e21960>,5,15,[ 4 12],6,-1,21,-1,6
1,<environment.Job instance at 0x7f3c23388320>,17,27,[8 5],18,-1,86,-1,59
1,<environment.Job instance at 0x7f3c22a1e5a0>,29,2,[ 2 12],30,-1,93,-1,91
1,<environment.Job instance at 0x7f3c228fb1e0>,32,24,[4 6],33,-1,131,-1,107
1,<environment.Job instance at 0x7f3c22a3d460>,33,15,[ 2 13],34,-1,122,-1,107
1,<environment.Job instance at 0x7f3c22e4f6e0>,37,18,[14  1],38,-1,126,-1,108
1,<environment.Job instance at 0x7f3c22e4dfa0>,43,13,[ 3 11],44,-1,151,-1,138
1,<environment.Job instance at 0x7f3c22e34e60>,46,15,[11  2],47,-1,157,-1,142
1,<environment.Job instance at 0x7f3c23254b40>,50,12,[ 3 12],51,-1,171,-1,159
1,<environment.Job instance at 0x7f3c23231910>,60,25,[10  4],61,-1,251,-1,226
1,<environment.Job instance at 0x7f3c23b0ad70>,77,16,[13  1],78,-1,284,-1,268
1,<environment.Job instance at 0x7f3c2266bbe0>,81,2,[13  4],82,-1,292,-1,290
1,<environment.Job instance at 0x7f3c238f8410>,3,27,[1 7],4,-1,31,-1,4
1,<environment.Job instance at 0x7f3c238f8eb0>,4,18,[6 3],5,-1,23,-1,5
1,<environment.Job instance at 0x7f3c238f8a00>,9,15,[4 7],10,-1,25,-1,10
1,<environment.Job instance at 0x7f3c238f3910>,12,17,[5 9],13,-1,30,-1,13
1,<environment.Job instance at 0x7f3c238f3280>,13,18,[5 5],14,-1,32,-1,14
1,<environment.Job instance at 0x7f3c238f3140>,14,15,[8 2],15,-1,31,-1,16
1,<environment.Job instance at 0x7f3c238f3730>,16,17,[1 6],17,-1,34,-1,17
1,<environment.Job instance at 0x7f3c238f3190>,17,18,[5 5],18,-1,36,-1,18
1,<environment.Job instance at 0x7f3c238f8fa0>,15,17,[6 4],16,-1,35,-1,18
1,<environment.Job instance at 0x7f3c238f3820>,18,18,[ 3 10],19,-1,38,-1,20
1,<environment.Job instance at 0x7f3c22d5baa0>,20,27,[5 4],21,-1,48,-1,21
1,<environment.Job instance at 0x7f3c22d5ba50>,21,28,[7 5],22,-1,50,-1,22
1,<environment.Job instance at 0x7f3c22d5bbe0>,23,28,[8 2],24,-1,52,-1,24
1,<environment.Job instance at 0x7f3c22d5b3c0>,24,16,[2 5],25,-1,41,-1,25
1,<environment.Job instance at 0x7f3c22d5b280>,25,13,[ 5 10],26,-1,39,-1,26
1,<environment.Job instance at 0x7f3c22d5b960>,28,17,[5 3],29,-1,46,-1,29
1,<environment.Job instance at 0x7f3c23a8a4b0>,38,15,[3 9],39,-1,54,-1,39
1,<environment.Job instance at 0x7f3c23a8a500>,43,19,[7 1],44,-1,69,-1,50
1,<environment.Job instance at 0x7f3c23a8a1e0>,39,12,[10  4],40,-1,62,-1,50
1,<environment.Job instance at 0x7f3c23a8a050>,44,15,[10  1],45,-1,65,-1,50
1,<environment.Job instance at 0x7f3c23a8a730>,37,18,[2 6],38,-1,68,-1,50
1,<environment.Job instance at 0x7f3c23a8ae60>,45,18,[7 4],46,-1,68,-1,50
1,<environment.Job instance at 0x7f3c237f97d0>,50,17,[ 5 13],51,-1,68,-1,51
1,<environment.Job instance at 0x7f3c238f38c0>,11,25,[9 1],12,-1,86,-1,61
1,<environment.Job instance at 0x7f3c237f9410>,53,27,[5 1],54,-1,88,-1,61
1,<environment.Job instance at 0x7f3c237f9dc0>,54,15,[5 5],55,-1,85,-1,70
1,<environment.Job instance at 0x7f3c2c5747d0>,61,12,[3 8],62,-1,88,-1,76
1,<environment.Job instance at 0x7f3c2c5740f0>,63,18,[6 4],64,-1,94,-1,76
1,<environment.Job instance at 0x7f3c2c5740a0>,64,18,[9 1],65,-1,94,-1,76
1,<environment.Job instance at 0x7f3c2c574780>,65,17,[14  4],66,-1,93,-1,76
1,<environment.Job instance at 0x7f3c237f9a50>,55,14,[5 9],56,-1,90,-1,76
1,<environment.Job instance at 0x7f3c2c574550>,66,14,[5 7],67,-1,90,-1,76
1,<environment.Job instance at 0x7f3c2c605e60>,68,16,[1 7],69,-1,92,-1,76
1,<environment.Job instance at 0x7f3c223e73c0>,70,18,[2 9],71,-1,94,-1,76
1,<environment.Job instance at 0x7f3c23a8a140>,48,18,[ 2 10],49,-1,94,-1,76
1,<environment.Job instance at 0x7f3c236b95a0>,71,12,[13  5],72,-1,88,-1,76
1,<environment.Job instance at 0x7f3c2258c050>,73,18,[5 3],74,-1,94,-1,76
1,<environment.Job instance at 0x7f3c2258c190>,74,3,[3 5],75,-1,79,-1,76
1,<environment.Job instance at 0x7f3c2258c0a0>,75,2,[8 3],76,-1,79,-1,77
1,<environment.Job instance at 0x7f3c22a0d550>,76,13,[7 1],77,-1,90,-1,77
1,<environment.Job instance at 0x7f3c22d00f00>,78,13,[2 9],79,-1,96,-1,83
1,<environment.Job instance at 0x7f3c223ff820>,86,18,[5 4],87,-1,109,-1,91
1,<environment.Job instance at 0x7f3c22d5b5f0>,0,27,[ 3 13],1,-1,28,-1,1
1,<environment.Job instance at 0x7f3c23a8acd0>,3,27,[1 7],4,-1,31,-1,4
1,<environment.Job instance at 0x7f3c2c574870>,5,18,[ 3 12],6,-1,24,-1,6
1,<environment.Job instance at 0x7f3c22673fa0>,10,1,[12  1],11,-1,12,-1,11
1,<environment.Job instance at 0x7f3c23008af0>,11,25,[9 1],12,-1,62,-1,37
1,<environment.Job instance at 0x7f3c22ff30a0>,20,27,[5 4],21,-1,82,-1,55
1,<environment.Job instance at 0x7f3c22ff3eb0>,21,28,[7 5],22,-1,83,-1,55
1,<environment.Job instance at 0x7f3c22ff31e0>,23,28,[8 2],24,-1,96,-1,68
1,<environment.Job instance at 0x7f3c2321a5a0>,41,1,[ 5 14],42,-1,124,-1,123
1,<environment.Job instance at 0x7f3c23221140>,50,17,[ 5 13],51,-1,166,-1,149
1,<environment.Job instance at 0x7f3c23221af0>,53,27,[5 1],54,-1,197,-1,170
1,<environment.Job instance at 0x7f3c23221b90>,56,2,[ 5 12],57,-1,174,-1,172
1,<environment.Job instance at 0x7f3c239832d0>,65,17,[14  4],66,-1,218,-1,201
1,<environment.Job instance at 0x7f3c2320e910>,71,12,[13  5],72,-1,245,-1,233
1,<environment.Job instance at 0x7f3c2268dbe0>,77,26,[3 7],78,-1,298,-1,272
1,<environment.Job instance at 0x7f3c2266e4b0>,87,1,[ 2 11],88,-1,278,-1,277
1,<environment.Job instance at 0x7f3c22cf1320>,0,17,[7 1],1,-1,19,-1,2
1,<environment.Job instance at 0x7f3c22d0df50>,1,17,[7 4],2,-1,19,-1,2
1,<environment.Job instance at 0x7f3c22d03460>,5,18,[8 2],6,-1,24,-1,6
1,<environment.Job instance at 0x7f3c22d03320>,7,28,[4 9],8,-1,36,-1,8
1,<environment.Job instance at 0x7f3c22d035a0>,15,14,[11  2],16,-1,31,-1,17
1,<environment.Job instance at 0x7f3c22cf1e60>,16,15,[10  2],17,-1,32,-1,17
1,<environment.Job instance at 0x7f3c22cebb90>,20,14,[10  4],21,-1,36,-1,22
1,<environment.Job instance at 0x7f3c22d09b90>,28,16,[10  1],29,-1,45,-1,29
1,<environment.Job instance at 0x7f3c22d09230>,29,18,[8 2],30,-1,48,-1,30
1,<environment.Job instance at 0x7f3c22d09be0>,30,18,[2 8],31,-1,49,-1,31
1,<environment.Job instance at 0x7f3c22d090f0>,33,14,[5 7],34,-1,48,-1,34
1,<environment.Job instance at 0x7f3c22d09730>,35,18,[9 1],36,-1,54,-1,36
1,<environment.Job instance at 0x7f3c22d09cd0>,37,12,[9 1],38,-1,50,-1,38
1,<environment.Job instance at 0x7f3c22cebb40>,21,15,[7 2],22,-1,53,-1,38
1,<environment.Job instance at 0x7f3c22cf8820>,44,21,[8 1],45,-1,67,-1,46
1,<environment.Job instance at 0x7f3c235b40f0>,49,25,[ 3 10],50,-1,75,-1,50
1,<environment.Job instance at 0x7f3c235b4fa0>,50,18,[ 2 11],51,-1,69,-1,51
1,<environment.Job instance at 0x7f3c235abf50>,56,15,[4 7],57,-1,72,-1,57
1,<environment.Job instance at 0x7f3c235abaa0>,57,23,[9 2],58,-1,81,-1,58
1,<environment.Job instance at 0x7f3c22cf89b0>,45,13,[2 6],46,-1,71,-1,58
1,<environment.Job instance at 0x7f3c235ab640>,60,15,[4 8],61,-1,77,-1,62
1,<environment.Job instance at 0x7f3c235ab2d0>,63,17,[7 4],64,-1,81,-1,64
1,<environment.Job instance at 0x7f3c235ab730>,55,15,[9 4],56,-1,84,-1,69
1,<environment.Job instance at 0x7f3c235aba50>,65,15,[9 1],66,-1,84,-1,69
1,<environment.Job instance at 0x7f3c235a46e0>,68,16,[6 5],69,-1,85,-1,69
1,<environment.Job instance at 0x7f3c235a4910>,72,18,[ 2 10],73,-1,101,-1,83
1,<environment.Job instance at 0x7f3c2359e6e0>,81,18,[5 5],82,-1,101,-1,83
1,<environment.Job instance at 0x7f3c2359ef00>,80,16,[3 7],81,-1,99,-1,83
1,<environment.Job instance at 0x7f3c2359ea00>,83,24,[4 7],84,-1,108,-1,84
1,<environment.Job instance at 0x7f3c22d092d0>,7,28,[4 9],8,-1,46,-1,18
1,<environment.Job instance at 0x7f3c235b4eb0>,11,18,[13  5],12,-1,37,-1,19
1,<environment.Job instance at 0x7f3c235abf00>,15,14,[11  2],16,-1,49,-1,35
1,<environment.Job instance at 0x7f3c2359ed70>,18,1,[14  2],19,-1,38,-1,37
1,<environment.Job instance at 0x7f3c235732d0>,19,1,[ 1 11],20,-1,38,-1,37
1,<environment.Job instance at 0x7f3c2358a0f0>,50,18,[ 2 11],51,-1,151,-1,133
1,<environment.Job instance at 0x7f3c2358a910>,49,25,[ 3 10],50,-1,172,-1,147
1,<environment.Job instance at 0x7f3c2358bf50>,57,23,[9 2],58,-1,189,-1,166
1,<environment.Job instance at 0x7f3c22a15dc0>,76,17,[ 1 14],77,-1,247,-1,230
1,<environment.Job instance at 0x7f3c22a15eb0>,79,18,[14  4],80,-1,254,-1,236
1,<environment.Job instance at 0x7f3c22a158c0>,83,24,[4 7],84,-1,289,-1,265
1,<environment.Job instance at 0x7f3c22a15910>,88,23,[ 4 10],89,-1,312,-1,289
1,<environment.Job instance at 0x7f3c22a3edc0>,7,18,[3 9],8,-1,28,-1,10
1,<environment.Job instance at 0x7f3c22a3e140>,12,15,[ 1 10],13,-1,28,-1,13
1,<environment.Job instance at 0x7f3c22a3e500>,13,24,[3 5],14,-1,38,-1,14
1,<environment.Job instance at 0x7f3c22a3e8c0>,15,16,[5 5],16,-1,32,-1,16
1,<environment.Job instance at 0x7f3c23754c30>,18,17,[10  4],19,-1,39,-1,22
1,<environment.Job instance at 0x7f3c222c8dc0>,22,15,[2 7],23,-1,38,-1,23
1,<environment.Job instance at 0x7f3c222c8c80>,23,17,[4 9],24,-1,41,-1,24
1,<environment.Job instance at 0x7f3c222c8640>,28,16,[9 2],29,-1,45,-1,29
1,<environment.Job instance at 0x7f3c222c88c0>,29,24,[7 1],30,-1,54,-1,30
1,<environment.Job instance at 0x7f3c222c8910>,30,26,[4 8],31,-1,57,-1,31
1,<environment.Job instance at 0x7f3c2353af50>,31,16,[2 7],32,-1,48,-1,32
1,<environment.Job instance at 0x7f3c2353ad70>,34,15,[3 8],35,-1,50,-1,35
1,<environment.Job instance at 0x7f3c2353adc0>,35,18,[6 2],36,-1,54,-1,36
1,<environment.Job instance at 0x7f3c2353a3c0>,37,13,[ 5 10],38,-1,51,-1,38
1,<environment.Job instance at 0x7f3c2353aaf0>,38,13,[ 5 10],39,-1,52,-1,39
1,<environment.Job instance at 0x7f3c2353a5f0>,40,18,[8 5],41,-1,59,-1,41
1,<environment.Job instance at 0x7f3c2353acd0>,42,18,[4 5],43,-1,61,-1,43
1,<environment.Job instance at 0x7f3c2353a460>,43,18,[8 1],44,-1,62,-1,44
1,<environment.Job instance at 0x7f3c2353a780>,46,13,[5 6],47,-1,60,-1,47
1,<environment.Job instance at 0x7f3c2353ae60>,48,17,[10  4],49,-1,66,-1,49
1,<environment.Job instance at 0x7f3c2325baf0>,49,15,[5 9],50,-1,65,-1,50
1,<environment.Job instance at 0x7f3c2325b0f0>,52,16,[3 5],53,-1,69,-1,53
1,<environment.Job instance at 0x7f3c2325b5f0>,55,22,[1 9],56,-1,78,-1,56
1,<environment.Job instance at 0x7f3c2325b500>,60,18,[7 3],61,-1,79,-1,61
1,<environment.Job instance at 0x7f3c2325bcd0>,61,2,[1 5],62,-1,64,-1,62
1,<environment.Job instance at 0x7f3c222c8b90>,21,17,[4 7],22,-1,79,-1,62
1,<environment.Job instance at 0x7f3c229e5f50>,73,18,[9 2],74,-1,98,-1,80
1,<environment.Job instance at 0x7f3c229e5500>,74,24,[5 9],75,-1,104,-1,80
1,<environment.Job instance at 0x7f3c229e5780>,77,26,[8 5],78,-1,107,-1,81
1,<environment.Job instance at 0x7f3c229e5280>,79,15,[6 5],80,-1,96,-1,81
1,<environment.Job instance at 0x7f3c229e5640>,69,15,[ 5 10],70,-1,96,-1,81
1,<environment.Job instance at 0x7f3c2317ef50>,80,17,[10  1],81,-1,98,-1,81
1,<environment.Job instance at 0x7f3c229e5d70>,71,17,[ 2 10],72,-1,100,-1,83
1,<environment.Job instance at 0x7f3c229e5410>,75,16,[10  3],76,-1,106,-1,90
1,<environment.Job instance at 0x7f3c2353ac80>,5,13,[ 3 12],6,-1,19,-1,6
1,<environment.Job instance at 0x7f3c222c8eb0>,6,13,[ 4 12],7,-1,20,-1,7
1,<environment.Job instance at 0x7f3c229e5f00>,13,24,[3 5],14,-1,42,-1,18
1,<environment.Job instance at 0x7f3c2358ac80>,29,24,[7 1],30,-1,93,-1,69
1,<environment.Job instance at 0x7f3c2358ad20>,30,26,[4 8],31,-1,110,-1,84
1,<environment.Job instance at 0x7f3c238f8320>,45,15,[12  1],46,-1,162,-1,147
1,<environment.Job instance at 0x7f3c235ab3c0>,53,1,[ 3 13],54,-1,191,-1,190
1,<environment.Job instance at 0x7f3c235b4f50>,59,18,[ 3 12],60,-1,233,-1,215
1,<environment.Job instance at 0x7f3c22d09320>,65,1,[ 5 13],66,-1,223,-1,222
1,<environment.Job instance at 0x7f3c22e1d1e0>,74,24,[5 9],75,-1,281,-1,257
1,<environment.Job instance at 0x7f3c22e1d4b0>,77,26,[8 5],78,-1,300,-1,274
1,<environment.Job instance at 0x7f3c22e1da00>,83,26,[7 5],84,-1,332,-1,306
1,<environment.Job instance at 0x7f3c22e1daa0>,85,2,[13  2],86,-1,308,-1,306
1,<environment.Job instance at 0x7f3c2341d3c0>,2,18,[4 7],3,-1,21,-1,3
1,<environment.Job instance at 0x7f3c2244a500>,5,17,[9 3],6,-1,27,-1,10
1,<environment.Job instance at 0x7f3c22425230>,11,12,[10  4],12,-1,24,-1,12
1,<environment.Job instance at 0x7f3c224251e0>,12,1,[7 3],13,-1,14,-1,13
1,<environment.Job instance at 0x7f3c2244a280>,9,15,[5 5],10,-1,30,-1,15
1,<environment.Job instance at 0x7f3c22750eb0>,25,17,[5 9],26,-1,44,-1,27
1,<environment.Job instance at 0x7f3c22750960>,26,23,[10  4],27,-1,50,-1,27
1,<environment.Job instance at 0x7f3c22750910>,28,17,[4 9],29,-1,46,-1,29
1,<environment.Job instance at 0x7f3c227509b0>,29,18,[9 5],30,-1,50,-1,32
1,<environment.Job instance at 0x7f3c236ddcd0>,32,18,[10  5],33,-1,51,-1,33
1,<environment.Job instance at 0x7f3c236dd0f0>,31,17,[8 2],32,-1,51,-1,34
1,<environment.Job instance at 0x7f3c234208c0>,36,14,[4 7],37,-1,52,-1,38
1,<environment.Job instance at 0x7f3c23420f00>,39,12,[5 9],40,-1,52,-1,40
1,<environment.Job instance at 0x7f3c23420190>,40,12,[2 9],41,-1,53,-1,41
1,<environment.Job instance at 0x7f3c23420780>,41,17,[7 2],42,-1,59,-1,42
1,<environment.Job instance at 0x7f3c23420820>,43,16,[3 9],44,-1,60,-1,44
1,<environment.Job instance at 0x7f3c234204b0>,44,13,[10  1],45,-1,58,-1,45
1,<environment.Job instance at 0x7f3c234205a0>,45,13,[ 3 10],46,-1,59,-1,46
1,<environment.Job instance at 0x7f3c23413f50>,49,25,[8 3],50,-1,75,-1,50
1,<environment.Job instance at 0x7f3c23413730>,51,17,[3 7],52,-1,69,-1,52
1,<environment.Job instance at 0x7f3c234201e0>,37,18,[5 4],38,-1,71,-1,53
1,<environment.Job instance at 0x7f3c23413a00>,53,18,[2 6],54,-1,73,-1,55
1,<environment.Job instance at 0x7f3c23413d20>,54,18,[8 2],55,-1,73,-1,55
1,<environment.Job instance at 0x7f3c22c612d0>,56,17,[1 6],57,-1,75,-1,58
1,<environment.Job instance at 0x7f3c233654b0>,57,18,[5 2],58,-1,76,-1,58
1,<environment.Job instance at 0x7f3c22275960>,61,15,[10  5],62,-1,78,-1,63
1,<environment.Job instance at 0x7f3c22f7d6e0>,62,18,[10  1],63,-1,81,-1,63
1,<environment.Job instance at 0x7f3c22268a50>,71,18,[7 1],72,-1,90,-1,72
1,<environment.Job instance at 0x7f3c22268640>,73,18,[ 3 10],74,-1,93,-1,75
1,<environment.Job instance at 0x7f3c23905410>,78,12,[10  2],79,-1,94,-1,82
1,<environment.Job instance at 0x7f3c22c87550>,81,15,[9 5],82,-1,97,-1,82
1,<environment.Job instance at 0x7f3c22c87f50>,82,14,[ 1 10],83,-1,100,-1,86
1,<environment.Job instance at 0x7f3c22920690>,85,15,[10  1],86,-1,101,-1,86
1,<environment.Job instance at 0x7f3c22920780>,86,21,[3 7],87,-1,109,-1,88
1,<environment.Job instance at 0x7f3c2292b5f0>,88,28,[8 3],89,-1,117,-1,89
1,<environment.Job instance at 0x7f3c229205a0>,87,15,[ 3 10],88,-1,110,-1,95
1,<environment.Job instance at 0x7f3c227505f0>,3,3,[11  3],4,-1,7,-1,4
1,<environment.Job instance at 0x7f3c236971e0>,18,16,[ 5 13],19,-1,48,-1,32
1,<environment.Job instance at 0x7f3c23b26f00>,21,15,[14  4],22,-1,51,-1,36
1,<environment.Job instance at 0x7f3c23b4ac80>,26,23,[10  4],27,-1,68,-1,45
1,<environment.Job instance at 0x7f3c23ae39b0>,49,25,[8 3],50,-1,176,-1,151
1,<environment.Job instance at 0x7f3c23ada8c0>,52,24,[11  1],53,-1,175,-1,151
1,<environment.Job instance at 0x7f3c22c23460>,83,2,[12  1],84,-1,278,-1,276
1,<environment.Job instance at 0x7f3c236966e0>,84,1,[ 5 14],85,-1,277,-1,276
1,<environment.Job instance at 0x7f3c228c0230>,88,28,[8 3],89,-1,322,-1,294
1,<environment.Job instance at 0x7f3c2392b050>,1,17,[5 6],2,-1,19,-1,2
1,<environment.Job instance at 0x7f3c236e37d0>,2,16,[10  1],3,-1,20,-1,4
1,<environment.Job instance at 0x7f3c236cb190>,4,12,[4 9],5,-1,17,-1,5
1,<environment.Job instance at 0x7f3c236cb640>,5,12,[7 2],6,-1,18,-1,6
1,<environment.Job instance at 0x7f3c236cbe10>,6,13,[ 5 11],7,-1,20,-1,7
1,<environment.Job instance at 0x7f3c2374c0a0>,3,17,[ 2 10],4,-1,24,-1,7
1,<environment.Job instance at 0x7f3c236cb500>,8,15,[10  2],9,-1,25,-1,10
1,<environment.Job instance at 0x7f3c236cb3c0>,10,2,[4 9],11,-1,13,-1,11
1,<environment.Job instance at 0x7f3c236cbbe0>,11,18,[4 6],12,-1,30,-1,12
1,<environment.Job instance at 0x7f3c2293bd70>,12,15,[1 7],13,-1,28,-1,13
1,<environment.Job instance at 0x7f3c236cb6e0>,9,18,[3 8],10,-1,31,-1,13
1,<environment.Job instance at 0x7f3c236dc2d0>,16,13,[8 3],17,-1,30,-1,17
1,<environment.Job instance at 0x7f3c2291f3c0>,18,15,[8 2],19,-1,34,-1,19
1,<environment.Job instance at 0x7f3c22ba14b0>,22,27,[9 1],23,-1,50,-1,23
1,<environment.Job instance at 0x7f3c22954a50>,23,12,[5 9],24,-1,37,-1,25
1,<environment.Job instance at 0x7f3c22c8e730>,24,16,[1 8],25,-1,41,-1,25
1,<environment.Job instance at 0x7f3c23420aa0>,29,20,[2 8],30,-1,51,-1,31
1,<environment.Job instance at 0x7f3c23978320>,31,19,[5 5],32,-1,51,-1,32
1,<environment.Job instance at 0x7f3c228a6050>,30,15,[12  3],31,-1,47,-1,32
1,<environment.Job instance at 0x7f3c22c88cd0>,33,18,[8 1],34,-1,53,-1,35
1,<environment.Job instance at 0x7f3c22c865a0>,35,12,[10  3],36,-1,48,-1,36
1,<environment.Job instance at 0x7f3c228d0d70>,39,12,[7 1],40,-1,52,-1,40
1,<environment.Job instance at 0x7f3c228d0b90>,40,18,[5 7],41,-1,59,-1,41
1,<environment.Job instance at 0x7f3c228d09b0>,41,23,[5 9],42,-1,65,-1,42
1,<environment.Job instance at 0x7f3c228acd20>,51,26,[7 2],52,-1,78,-1,52
1,<environment.Job instance at 0x7f3c228b42d0>,53,16,[ 3 10],54,-1,70,-1,54
1,<environment.Job instance at 0x7f3c228b4140>,54,14,[10  5],55,-1,69,-1,55
1,<environment.Job instance at 0x7f3c233c0a00>,58,19,[ 5 11],59,-1,79,-1,60
1,<environment.Job instance at 0x7f3c23967c30>,61,17,[10  3],62,-1,80,-1,63
1,<environment.Job instance at 0x7f3c228c3780>,63,12,[9 4],64,-1,78,-1,66
1,<environment.Job instance at 0x7f3c22c97050>,69,19,[9 1],70,-1,107,-1,88
1,<environment.Job instance at 0x7f3c228b40f0>,6,13,[ 5 11],7,-1,20,-1,7
1,<environment.Job instance at 0x7f3c228ac640>,7,2,[13  1],8,-1,10,-1,8
1,<environment.Job instance at 0x7f3c228c06e0>,14,1,[11  3],15,-1,34,-1,33
1,<environment.Job instance at 0x7f3c22e40370>,21,13,[ 1 13],22,-1,82,-1,69
1,<environment.Job instance at 0x7f3c2240b1e0>,22,27,[9 1],23,-1,104,-1,77
1,<environment.Job instance at 0x7f3c229201e0>,26,21,[12  2],27,-1,104,-1,83
1,<environment.Job instance at 0x7f3c234202d0>,28,14,[ 1 14],29,-1,106,-1,92
1,<environment.Job instance at 0x7f3c22425320>,30,15,[12  3],31,-1,108,-1,93
1,<environment.Job instance at 0x7f3c228c59b0>,36,2,[12  3],37,-1,100,-1,98
1,<environment.Job instance at 0x7f3c228c5910>,41,23,[5 9],42,-1,153,-1,130
1,<environment.Job instance at 0x7f3c22c36690>,45,15,[ 4 12],46,-1,147,-1,132
1,<environment.Job instance at 0x7f3c22c366e0>,49,3,[ 4 11],50,-1,147,-1,144
1,<environment.Job instance at 0x7f3c22c36af0>,51,26,[7 2],52,-1,173,-1,147
1,<environment.Job instance at 0x7f3c22c36050>,52,2,[ 2 13],53,-1,149,-1,147
1,<environment.Job instance at 0x7f3c22c362d0>,56,12,[11  2],57,-1,177,-1,165
1,<environment.Job instance at 0x7f3c22c361e0>,57,1,[14  5],58,-1,166,-1,165
1,<environment.Job instance at 0x7f3c22c36eb0>,58,19,[ 5 11],59,-1,184,-1,165
1,<environment.Job instance at 0x7f3c22c23320>,68,1,[ 4 13],69,-1,191,-1,190
1,<environment.Job instance at 0x7f3c22c23fa0>,72,2,[ 3 14],73,-1,193,-1,191
1,<environment.Job instance at 0x7f3c22c23eb0>,74,23,[8 3],75,-1,222,-1,199
1,<environment.Job instance at 0x7f3c22c1ce10>,79,1,[11  4],80,-1,209,-1,208
1,<environment.Job instance at 0x7f3c22c1c550>,83,27,[9 4],84,-1,242,-1,215
1,<environment.Job instance at 0x7f3c22c1c2d0>,84,25,[8 2],85,-1,240,-1,215
1,<environment.Job instance at 0x7f3c22ca8c80>,2,17,[5 9],3,-1,21,-1,4
1,<environment.Job instance at 0x7f3c228c0190>,3,18,[6 1],4,-1,22,-1,4
1,<environment.Job instance at 0x7f3c22cb91e0>,7,17,[3 7],8,-1,26,-1,9
1,<environment.Job instance at 0x7f3c22ca8fa0>,8,16,[8 5],9,-1,25,-1,9
1,<environment.Job instance at 0x7f3c22cb9820>,15,22,[9 4],16,-1,38,-1,16
1,<environment.Job instance at 0x7f3c22cb9cd0>,19,27,[5 8],20,-1,47,-1,20
1,<environment.Job instance at 0x7f3c22cb9e10>,20,13,[5 8],21,-1,34,-1,21
1,<environment.Job instance at 0x7f3c22cb9d20>,21,12,[10  5],22,-1,35,-1,23
1,<environment.Job instance at 0x7f3c22cb9f50>,23,16,[5 8],24,-1,40,-1,24
1,<environment.Job instance at 0x7f3c22cc3050>,24,2,[7 4],25,-1,27,-1,25
1,<environment.Job instance at 0x7f3c22cc30f0>,25,12,[3 5],26,-1,38,-1,26
1,<environment.Job instance at 0x7f3c22cb9b90>,22,15,[ 5 10],23,-1,41,-1,26
1,<environment.Job instance at 0x7f3c22cb9eb0>,26,22,[3 8],27,-1,50,-1,28
1,<environment.Job instance at 0x7f3c22cc3190>,27,14,[6 2],28,-1,49,-1,35
1,<environment.Job instance at 0x7f3c22cc3fa0>,39,12,[ 5 10],40,-1,52,-1,40
1,<environment.Job instance at 0x7f3c22ca5190>,40,18,[9 4],41,-1,59,-1,41
1,<environment.Job instance at 0x7f3c22ca50a0>,41,12,[ 4 10],42,-1,54,-1,42
1,<environment.Job instance at 0x7f3c22cca690>,43,14,[ 1 10],44,-1,58,-1,44
1,<environment.Job instance at 0x7f3c22cb0820>,49,27,[ 3 13],50,-1,85,-1,58
1,<environment.Job instance at 0x7f3c22cb0a50>,52,18,[1 9],53,-1,76,-1,58
1,<environment.Job instance at 0x7f3c22cb0550>,53,17,[6 3],54,-1,75,-1,58
1,<environment.Job instance at 0x7f3c22cb0500>,56,24,[13  3],57,-1,82,-1,58
1,<environment.Job instance at 0x7f3c23207aa0>,44,17,[14  4],45,-1,77,-1,60
1,<environment.Job instance at 0x7f3c22cb0910>,51,15,[10  3],52,-1,75,-1,60
1,<environment.Job instance at 0x7f3c23b7a5f0>,62,18,[4 9],63,-1,86,-1,68
1,<environment.Job instance at 0x7f3c2343be10>,64,15,[9 5],65,-1,84,-1,69
1,<environment.Job instance at 0x7f3c22d92b90>,66,18,[8 5],67,-1,92,-1,74
1,<environment.Job instance at 0x7f3c23947be0>,70,15,[9 2],71,-1,90,-1,75
1,<environment.Job instance at 0x7f3c23947d70>,73,26,[7 3],74,-1,102,-1,76
1,<environment.Job instance at 0x7f3c22cb0b40>,48,24,[8 2],49,-1,100,-1,76
1,<environment.Job instance at 0x7f3c2354f5a0>,60,14,[5 7],61,-1,90,-1,76
1,<environment.Job instance at 0x7f3c233d2c30>,76,17,[1 8],77,-1,94,-1,77
1,<environment.Job instance at 0x7f3c233d4c80>,79,13,[9 5],80,-1,97,-1,84
1,<environment.Job instance at 0x7f3c233b2820>,75,12,[9 2],76,-1,114,-1,102
1,<environment.Job instance at 0x7f3c22cb9050>,0,12,[ 4 12],1,-1,13,-1,1
1,<environment.Job instance at 0x7f3c22c1c910>,19,27,[5 8],20,-1,81,-1,54
1,<environment.Job instance at 0x7f3c22c232d0>,35,15,[13  3],36,-1,101,-1,86
1,<environment.Job instance at 0x7f3c22c36050>,42,1,[14  1],43,-1,105,-1,104
1,<environment.Job instance at 0x7f3c22c366e0>,44,17,[14  4],45,-1,135,-1,118
1,<environment.Job instance at 0x7f3c22c36730>,48,24,[8 2],49,-1,157,-1,133
1,<environment.Job instance at 0x7f3c22c36dc0>,49,27,[ 3 13],50,-1,160,-1,133
1,<environment.Job instance at 0x7f3c22c36960>,50,18,[ 2 12],51,-1,151,-1,133
1,<environment.Job instance at 0x7f3c228c50f0>,56,24,[13  3],57,-1,179,-1,155
1,<environment.Job instance at 0x7f3c228a5f00>,73,26,[7 3],74,-1,246,-1,220
1,<environment.Job instance at 0x7f3c228c0780>,77,27,[1 8],78,-1,271,-1,244
1,<environment.Job instance at 0x7f3c22969f00>,2,14,[9 2],3,-1,18,-1,4
1,<environment.Job instance at 0x7f3c22c1c140>,3,14,[9 2],4,-1,19,-1,5
1,<environment.Job instance at 0x7f3c22969460>,8,12,[9 4],9,-1,22,-1,10
1,<environment.Job instance at 0x7f3c22969280>,9,17,[12  4],10,-1,27,-1,10
1,<environment.Job instance at 0x7f3c229698c0>,10,20,[7 1],11,-1,32,-1,12
1,<environment.Job instance at 0x7f3c22969640>,11,14,[9 4],12,-1,26,-1,12
1,<environment.Job instance at 0x7f3c22f89dc0>,13,17,[3 7],14,-1,31,-1,14
1,<environment.Job instance at 0x7f3c23b050a0>,21,16,[9 2],22,-1,39,-1,23
1,<environment.Job instance at 0x7f3c23b05820>,23,14,[ 4 10],24,-1,38,-1,24
1,<environment.Job instance at 0x7f3c23b056e0>,25,13,[10  4],26,-1,39,-1,26
1,<environment.Job instance at 0x7f3c23b050f0>,27,17,[9 1],28,-1,45,-1,28
1,<environment.Job instance at 0x7f3c229f3af0>,32,13,[ 4 10],33,-1,46,-1,33
1,<environment.Job instance at 0x7f3c229f30f0>,33,17,[7 2],34,-1,53,-1,36
1,<environment.Job instance at 0x7f3c229f3b90>,36,14,[9 1],37,-1,51,-1,37
1,<environment.Job instance at 0x7f3c229f39b0>,37,15,[2 5],38,-1,53,-1,38
1,<environment.Job instance at 0x7f3c23b05c80>,22,16,[6 1],23,-1,56,-1,40
1,<environment.Job instance at 0x7f3c225c4140>,44,12,[7 5],45,-1,65,-1,53
1,<environment.Job instance at 0x7f3c229f3500>,35,24,[7 4],36,-1,80,-1,56
1,<environment.Job instance at 0x7f3c225c4730>,49,18,[ 1 10],50,-1,74,-1,56
1,<environment.Job instance at 0x7f3c22f671e0>,71,18,[5 5],72,-1,199,-1,181
1,<environment.Job instance at 0x7f3c22f672d0>,75,18,[10  4],76,-1,199,-1,181
1,<environment.Job instance at 0x7f3c233187d0>,60,17,[8 5],61,-1,198,-1,181
1,<environment.Job instance at 0x7f3c22f673c0>,77,15,[5 9],78,-1,196,-1,181
1,<environment.Job instance at 0x7f3c22f675f0>,76,17,[3 5],77,-1,199,-1,182
1,<environment.Job instance at 0x7f3c22f67370>,78,28,[ 2 11],79,-1,210,-1,182
1,<environment.Job instance at 0x7f3c22f67c30>,80,15,[10  5],81,-1,197,-1,182
1,<environment.Job instance at 0x7f3c22f67dc0>,81,17,[8 2],82,-1,207,-1,190
1,<environment.Job instance at 0x7f3c22f67e10>,84,18,[8 4],85,-1,208,-1,190
1,<environment.Job instance at 0x7f3c22b4fbe0>,86,15,[ 2 12],87,-1,205,-1,190
1,<environment.Job instance at 0x7f3c22b4f6e0>,87,17,[2 7],88,-1,207,-1,190
1,<environment.Job instance at 0x7f3c23318730>,62,21,[9 5],63,-1,211,-1,190
1,<environment.Job instance at 0x7f3c22b4f9b0>,85,12,[5 2],86,-1,202,-1,190
1,<environment.Job instance at 0x7f3c23318f00>,57,17,[8 3],58,-1,207,-1,190
1,<environment.Job instance at 0x7f3c229697d0>,0,26,[2 8],1,-1,27,-1,1
1,<environment.Job instance at 0x7f3c225c4780>,9,17,[12  4],10,-1,34,-1,17
1,<environment.Job instance at 0x7f3c22b4fc80>,15,17,[ 1 11],16,-1,48,-1,31
1,<environment.Job instance at 0x7f3c22b4fc30>,17,13,[12  4],18,-1,44,-1,31
1,<environment.Job instance at 0x7f3c236971e0>,30,24,[ 4 14],31,-1,104,-1,80
1,<environment.Job instance at 0x7f3c22425320>,34,14,[ 1 11],35,-1,96,-1,82
1,<environment.Job instance at 0x7f3c22425c80>,35,24,[7 4],36,-1,120,-1,96
1,<environment.Job instance at 0x7f3c22c36960>,45,25,[6 2],46,-1,162,-1,137
1,<environment.Job instance at 0x7f3c22c36aa0>,46,2,[ 1 13],47,-1,139,-1,137
1,<environment.Job instance at 0x7f3c22c36eb0>,56,26,[10  2],57,-1,198,-1,172
1,<environment.Job instance at 0x7f3c22c23730>,64,1,[12  5],65,-1,204,-1,203
1,<environment.Job instance at 0x7f3c22c237d0>,65,1,[ 2 14],66,-1,204,-1,203
1,<environment.Job instance at 0x7f3c22c23f00>,67,2,[14  3],68,-1,205,-1,203
1,<environment.Job instance at 0x7f3c22c1c050>,78,28,[ 2 11],79,-1,267,-1,239
1,<environment.Job instance at 0x7f3c22cb9b40>,86,15,[ 2 12],87,-1,297,-1,282
1,<environment.Job instance at 0x7f3c2219cd70>,4,18,[3 9],5,-1,24,-1,6
1,<environment.Job instance at 0x7f3c22531500>,10,17,[1 5],11,-1,28,-1,11
1,<environment.Job instance at 0x7f3c22531820>,11,17,[10  2],12,-1,30,-1,13
1,<environment.Job instance at 0x7f3c225319b0>,13,13,[4 6],14,-1,27,-1,14
1,<environment.Job instance at 0x7f3c23acc820>,17,18,[7 5],18,-1,36,-1,18
1,<environment.Job instance at 0x7f3c230037d0>,19,16,[6 3],20,-1,36,-1,20
1,<environment.Job instance at 0x7f3c22fa6500>,20,17,[11  3],21,-1,38,-1,21
1,<environment.Job instance at 0x7f3c22fa66e0>,21,17,[5 3],22,-1,39,-1,22
1,<environment.Job instance at 0x7f3c22fa67d0>,22,16,[6 5],23,-1,39,-1,23
1,<environment.Job instance at 0x7f3c22fa6b90>,23,12,[5 7],24,-1,36,-1,24
1,<environment.Job instance at 0x7f3c228db960>,26,14,[8 4],27,-1,41,-1,27
1,<environment.Job instance at 0x7f3c23ab3e60>,31,16,[3 9],32,-1,48,-1,32
1,<environment.Job instance at 0x7f3c23003870>,34,16,[7 2],35,-1,51,-1,35
1,<environment.Job instance at 0x7f3c23213be0>,35,14,[6 4],36,-1,50,-1,36
1,<environment.Job instance at 0x7f3c23213e10>,37,24,[8 1],38,-1,62,-1,38
1,<environment.Job instance at 0x7f3c2312d690>,40,16,[8 2],41,-1,57,-1,41
1,<environment.Job instance at 0x7f3c226e59b0>,41,28,[5 9],42,-1,70,-1,42
1,<environment.Job instance at 0x7f3c226e5c80>,42,14,[7 1],43,-1,57,-1,43
1,<environment.Job instance at 0x7f3c226e52d0>,43,28,[6 1],44,-1,72,-1,44
1,<environment.Job instance at 0x7f3c222904b0>,46,18,[9 2],47,-1,65,-1,47
1,<environment.Job instance at 0x7f3c23b2b870>,47,16,[10  4],48,-1,64,-1,48
1,<environment.Job instance at 0x7f3c23b2b2d0>,49,17,[4 5],50,-1,67,-1,50
1,<environment.Job instance at 0x7f3c22d0fd70>,50,12,[1 9],51,-1,65,-1,53
1,<environment.Job instance at 0x7f3c23998cd0>,53,18,[ 5 11],54,-1,72,-1,54
1,<environment.Job instance at 0x7f3c2c1cdbe0>,62,18,[6 5],63,-1,81,-1,63
1,<environment.Job instance at 0x7f3c23b08780>,66,22,[3 7],67,-1,90,-1,68
1,<environment.Job instance at 0x7f3c221ad050>,70,17,[9 5],71,-1,88,-1,71
1,<environment.Job instance at 0x7f3c221addc0>,71,14,[9 4],72,-1,86,-1,72
1,<environment.Job instance at 0x7f3c237242d0>,52,14,[4 6],53,-1,88,-1,74
1,<environment.Job instance at 0x7f3c2c0ab370>,74,18,[6 5],75,-1,93,-1,75
1,<environment.Job instance at 0x7f3c236d35a0>,67,21,[5 3],68,-1,100,-1,79
1,<environment.Job instance at 0x7f3c222fe460>,78,18,[1 8],79,-1,98,-1,80
1,<environment.Job instance at 0x7f3c23b2b820>,48,23,[ 3 10],49,-1,104,-1,81
1,<environment.Job instance at 0x7f3c22c97730>,0,12,[ 1 11],1,-1,13,-1,1
1,<environment.Job instance at 0x7f3c23003f00>,3,15,[ 5 12],4,-1,19,-1,4
1,<environment.Job instance at 0x7f3c2359da50>,20,17,[11  3],21,-1,61,-1,44
1,<environment.Job instance at 0x7f3c228c5050>,37,24,[8 1],38,-1,135,-1,111
1,<environment.Job instance at 0x7f3c228a58c0>,41,28,[5 9],42,-1,146,-1,118
1,<environment.Job instance at 0x7f3c228a5f00>,43,28,[6 1],44,-1,155,-1,127
1,<environment.Job instance at 0x7f3c22b4f820>,48,23,[ 3 10],49,-1,169,-1,146
1,<environment.Job instance at 0x7f3c23ae7f50>,53,18,[ 5 11],54,-1,181,-1,163
1,<environment.Job instance at 0x7f3c22472a50>,63,1,[13  4],64,-1,186,-1,185
1,<environment.Job instance at 0x7f3c22472af0>,64,17,[12  2],65,-1,202,-1,185
1,<environment.Job instance at 0x7f3c22fae370>,76,28,[7 3],77,-1,268,-1,240
1,<environment.Job instance at 0x7f3c22fae960>,85,16,[ 4 14],86,-1,274,-1,258
1,<environment.Job instance at 0x7f3c22426f50>,2,20,[1 9],3,-1,23,-1,3
1,<environment.Job instance at 0x7f3c22395a00>,3,18,[3 7],4,-1,22,-1,4
1,<environment.Job instance at 0x7f3c224d1320>,6,18,[3 6],7,-1,25,-1,7
1,<environment.Job instance at 0x7f3c224d1910>,8,17,[2 5],9,-1,26,-1,9
1,<environment.Job instance at 0x7f3c23a87d20>,10,2,[10  3],11,-1,13,-1,11
1,<environment.Job instance at 0x7f3c224d1460>,9,1,[ 3 12],10,-1,12,-1,11
1,<environment.Job instance at 0x7f3c223636e0>,14,18,[2 9],15,-1,34,-1,16
1,<environment.Job instance at 0x7f3c22363050>,15,26,[5 5],16,-1,42,-1,16
1,<environment.Job instance at 0x7f3c235b0370>,17,15,[8 4],18,-1,34,-1,19
1,<environment.Job instance at 0x7f3c23188320>,18,22,[10  5],19,-1,41,-1,19
1,<environment.Job instance at 0x7f3c235b0b40>,20,17,[2 7],21,-1,41,-1,24
1,<environment.Job instance at 0x7f3c23bc4fa0>,23,12,[10  3],24,-1,36,-1,24
1,<environment.Job instance at 0x7f3c23ae4320>,30,25,[9 5],31,-1,56,-1,31
1,<environment.Job instance at 0x7f3c233f8f00>,34,17,[6 3],35,-1,53,-1,36
1,<environment.Job instance at 0x7f3c237da050>,35,22,[6 4],36,-1,58,-1,36
1,<environment.Job instance at 0x7f3c23418050>,40,26,[10  1],41,-1,68,-1,42
1,<environment.Job instance at 0x7f3c23418d20>,42,22,[2 7],43,-1,65,-1,43
1,<environment.Job instance at 0x7f3c234e7a50>,45,16,[10  3],46,-1,62,-1,46
1,<environment.Job instance at 0x7f3c23bc4e10>,24,25,[9 4],25,-1,71,-1,46
1,<environment.Job instance at 0x7f3c23418aa0>,46,18,[8 3],47,-1,66,-1,48
1,<environment.Job instance at 0x7f3c23419d70>,49,17,[1 9],50,-1,67,-1,50
1,<environment.Job instance at 0x7f3c2342b0a0>,54,18,[6 4],55,-1,76,-1,58
1,<environment.Job instance at 0x7f3c23419870>,52,17,[9 5],53,-1,75,-1,58
1,<environment.Job instance at 0x7f3c2342b320>,55,27,[5 8],56,-1,86,-1,59
1,<environment.Job instance at 0x7f3c2342b4b0>,57,25,[6 4],58,-1,84,-1,59
1,<environment.Job instance at 0x7f3c23419af0>,50,15,[9 4],51,-1,76,-1,61
1,<environment.Job instance at 0x7f3c225ce500>,63,18,[10  5],64,-1,82,-1,64
1,<environment.Job instance at 0x7f3c225ce4b0>,65,12,[9 4],66,-1,78,-1,66
1,<environment.Job instance at 0x7f3c225ce9b0>,68,16,[8 2],69,-1,85,-1,69
1,<environment.Job instance at 0x7f3c2342b140>,56,16,[6 4],57,-1,87,-1,71
1,<environment.Job instance at 0x7f3c2342b5a0>,59,25,[10  1],60,-1,103,-1,78
1,<environment.Job instance at 0x7f3c225cecd0>,71,21,[4 7],72,-1,100,-1,79
1,<environment.Job instance at 0x7f3c225ce1e0>,60,14,[ 1 14],61,-1,95,-1,81
1,<environment.Job instance at 0x7f3c225a55f0>,80,18,[7 3],81,-1,102,-1,84
1,<environment.Job instance at 0x7f3c225a5780>,81,26,[5 4],82,-1,110,-1,84
1,<environment.Job instance at 0x7f3c2342ea50>,39,14,[ 1 10],40,-1,99,-1,85
1,<environment.Job instance at 0x7f3c225a5c30>,86,17,[5 2],87,-1,106,-1,89
1,<environment.Job instance at 0x7f3c225a5cd0>,87,18,[1 7],88,-1,108,-1,90
1,<environment.Job instance at 0x7f3c234e7f00>,7,26,[ 2 12],8,-1,39,-1,13
1,<environment.Job instance at 0x7f3c23419730>,9,1,[ 3 12],10,-1,14,-1,13
1,<environment.Job instance at 0x7f3c23419fa0>,12,3,[11  1],13,-1,19,-1,16
1,<environment.Job instance at 0x7f3c225cec30>,15,26,[5 5],16,-1,56,-1,30
1,<environment.Job instance at 0x7f3c22fae3c0>,24,25,[9 4],25,-1,74,-1,49
1,<environment.Job instance at 0x7f3c22fae500>,31,3,[11  1],32,-1,62,-1,59
1,<environment.Job instance at 0x7f3c224720a0>,32,3,[12  5],33,-1,62,-1,59
1,<environment.Job instance at 0x7f3c22fae5a0>,30,25,[9 5],31,-1,90,-1,65
1,<environment.Job instance at 0x7f3c229d2640>,40,26,[10  1],41,-1,131,-1,105
1,<environment.Job instance at 0x7f3c22b4f410>,55,27,[5 8],56,-1,200,-1,173
1,<environment.Job instance at 0x7f3c228a5f50>,57,25,[6 4],58,-1,199,-1,174
1,<environment.Job instance at 0x7f3c228a5410>,60,14,[ 1 14],61,-1,188,-1,174
1,<environment.Job instance at 0x7f3c228a50f0>,59,25,[10  1],60,-1,201,-1,176
1,<environment.Job instance at 0x7f3c2359da50>,81,26,[5 4],82,-1,269,-1,243
1,<environment.Job instance at 0x7f3c23ab3730>,88,26,[ 3 10],89,-1,286,-1,260
1,<environment.Job instance at 0x7fe9197f2af0>,2,14,[ 2 10],3,-1,18,-1,4
1,<environment.Job instance at 0x7fe922de28c0>,3,22,[2 5],4,-1,26,-1,4
1,<environment.Job instance at 0x7fe9197f2e60>,7,14,[7 5],8,-1,23,-1,9
1,<environment.Job instance at 0x7fe9197f2f00>,9,12,[8 2],10,-1,22,-1,10
1,<environment.Job instance at 0x7fe9197f2e10>,8,17,[1 8],9,-1,27,-1,10
1,<environment.Job instance at 0x7fe9197f2eb0>,10,22,[8 1],11,-1,33,-1,11
1,<environment.Job instance at 0x7fe9197f51e0>,12,23,[6 4],13,-1,36,-1,13
1,<environment.Job instance at 0x7fe9197f5320>,13,18,[5 9],14,-1,32,-1,14
1,<environment.Job instance at 0x7fe9197f5230>,14,21,[8 1],15,-1,38,-1,17
1,<environment.Job instance at 0x7fe9197f54b0>,16,18,[7 3],17,-1,35,-1,17
1,<environment.Job instance at 0x7fe9197f5550>,18,26,[7 4],19,-1,45,-1,19
1,<environment.Job instance at 0x7fe9197f5780>,19,25,[5 9],20,-1,45,-1,20
1,<environment.Job instance at 0x7fe9197f5870>,21,18,[9 4],22,-1,40,-1,22
1,<environment.Job instance at 0x7fe9197f5960>,23,16,[6 2],24,-1,40,-1,24
1,<environment.Job instance at 0x7fe9197f5f00>,27,17,[4 6],28,-1,45,-1,28
1,<environment.Job instance at 0x7fe9197f8140>,30,26,[9 4],31,-1,58,-1,32
1,<environment.Job instance at 0x7fe9197f8230>,32,21,[5 9],33,-1,54,-1,33
1,<environment.Job instance at 0x7fe9197f8320>,31,1,[ 2 14],32,-1,34,-1,33
1,<environment.Job instance at 0x7fe9197f8280>,33,26,[3 6],34,-1,61,-1,35
1,<environment.Job instance at 0x7fe9197f83c0>,34,14,[1 9],35,-1,49,-1,35
1,<environment.Job instance at 0x7fe9197f8460>,35,16,[1 9],36,-1,52,-1,36
1,<environment.Job instance at 0x7fe9197f8500>,37,14,[5 8],38,-1,52,-1,38
1,<environment.Job instance at 0x7fe9197f86e0>,38,2,[6 1],39,-1,41,-1,39
1,<environment.Job instance at 0x7fe9197f8780>,39,14,[9 4],40,-1,54,-1,40
1,<environment.Job instance at 0x7fe9197f8820>,40,26,[ 1 10],41,-1,67,-1,41
1,<environment.Job instance at 0x7fe9197f88c0>,41,1,[7 1],42,-1,45,-1,44
1,<environment.Job instance at 0x7fe9197f8f50>,47,13,[ 3 10],48,-1,61,-1,48
1,<environment.Job instance at 0x7fe9197fa0f0>,49,17,[10  2],50,-1,72,-1,55
1,<environment.Job instance at 0x7fe9197fa780>,54,18,[7 1],55,-1,75,-1,57
1,<environment.Job instance at 0x7fe9197fab90>,58,17,[3 7],59,-1,77,-1,60
1,<environment.Job instance at 0x7fe9197fae10>,63,12,[5 3],64,-1,76,-1,64
1,<environment.Job instance at 0x7fe9197fd140>,64,2,[2 8],65,-1,67,-1,65
1,<environment.Job instance at 0x7fe9197fd320>,67,16,[1 9],68,-1,84,-1,68
1,<environment.Job instance at 0x7fe9197fd5a0>,68,14,[6 4],69,-1,83,-1,69
1,<environment.Job instance at 0x7fe9197fd4b0>,69,14,[9 4],70,-1,84,-1,70
1,<environment.Job instance at 0x7fe9197fd780>,72,18,[3 5],73,-1,91,-1,73
1,<environment.Job instance at 0x7fe9197fdd20>,76,13,[10  1],77,-1,90,-1,77
1,<environment.Job instance at 0x7fe9197fde10>,77,16,[8 1],78,-1,94,-1,78
1,<environment.Job instance at 0x7fe9197fdf00>,79,19,[10  3],80,-1,99,-1,80
1,<environment.Job instance at 0x7fe919800140>,81,14,[8 5],82,-1,96,-1,82
1,<environment.Job instance at 0x7fe919800280>,82,21,[4 8],83,-1,104,-1,83
1,<environment.Job instance at 0x7fe9198001e0>,83,18,[ 3 10],84,-1,102,-1,84
1,<environment.Job instance at 0x7fe919800730>,87,18,[7 1],88,-1,106,-1,88
1,<environment.Job instance at 0x7fe919800870>,88,16,[4 9],89,-1,105,-1,89
1,<environment.Job instance at 0x7fe919800cd0>,93,25,[ 1 10],94,-1,119,-1,94
1,<environment.Job instance at 0x7fe91984aeb0>,96,18,[2 6],97,-1,115,-1,97
1,<environment.Job instance at 0x7fe91983eb40>,12,23,[6 4],13,-1,53,-1,30
1,<environment.Job instance at 0x7fe9197f2c80>,18,26,[7 4],19,-1,70,-1,44
1,<environment.Job instance at 0x7fe9197f2910>,19,25,[5 9],20,-1,83,-1,58
1,<environment.Job instance at 0x7fe919913690>,28,17,[ 1 13],29,-1,87,-1,70
1,<environment.Job instance at 0x7fe919cc1a00>,30,26,[9 4],31,-1,110,-1,84
1,<environment.Job instance at 0x7fe91999ae10>,31,1,[ 2 14],32,-1,85,-1,84
1,<environment.Job instance at 0x7fe9198602d0>,33,26,[3 6],34,-1,110,-1,84
1,<environment.Job instance at 0x7fe91989ce60>,40,26,[ 1 10],41,-1,139,-1,113
1,<environment.Job instance at 0x7fe919915b40>,57,16,[ 2 11],58,-1,183,-1,167
1,<environment.Job instance at 0x7fe9198a1410>,89,17,[ 5 14],90,-1,289,-1,272
1,<environment.Job instance at 0x7fe9198a1d70>,93,25,[ 1 10],94,-1,320,-1,295
1,<environment.Job instance at 0x7fe918f3e370>,2,13,[9 4],3,-1,17,-1,4
1,<environment.Job instance at 0x7fe918f3e0f0>,5,16,[7 5],6,-1,22,-1,6
1,<environment.Job instance at 0x7fe918f3bc30>,7,18,[5 5],8,-1,26,-1,8
1,<environment.Job instance at 0x7fe918f3baa0>,9,27,[3 9],10,-1,37,-1,10
1,<environment.Job instance at 0x7fe918f3b640>,10,23,[5 1],11,-1,34,-1,11
1,<environment.Job instance at 0x7fe918f3bfa0>,11,17,[6 4],12,-1,29,-1,12
1,<environment.Job instance at 0x7fe918f3b780>,12,12,[1 6],13,-1,25,-1,13
1,<environment.Job instance at 0x7fe918f3b5f0>,13,17,[5 1],14,-1,31,-1,14
1,<environment.Job instance at 0x7fe918f3e230>,3,16,[1 9],4,-1,31,-1,15
1,<environment.Job instance at 0x7fe918f3d460>,19,28,[7 5],20,-1,48,-1,20
1,<environment.Job instance at 0x7fe918f3da50>,22,18,[7 5],23,-1,41,-1,23
1,<environment.Job instance at 0x7fe918f3c0a0>,30,17,[9 5],31,-1,48,-1,31
1,<environment.Job instance at 0x7fe918f39b90>,32,18,[10  4],33,-1,51,-1,33
1,<environment.Job instance at 0x7fe922e82730>,34,12,[5 4],35,-1,47,-1,35
1,<environment.Job instance at 0x7fe918db08c0>,35,15,[8 3],36,-1,51,-1,36
1,<environment.Job instance at 0x7fe918ed2aa0>,46,13,[10  5],47,-1,69,-1,56
1,<environment.Job instance at 0x7fe918e12370>,37,28,[ 2 10],38,-1,86,-1,58
1,<environment.Job instance at 0x7fe918f3d320>,57,21,[10  4],58,-1,80,-1,59
1,<environment.Job instance at 0x7fe918e7a410>,44,20,[13  4],45,-1,83,-1,63
1,<environment.Job instance at 0x7fe918de5a00>,55,17,[10  4],56,-1,80,-1,63
1,<environment.Job instance at 0x7fe918de20a0>,60,24,[1 5],61,-1,87,-1,63
1,<environment.Job instance at 0x7fe918df2730>,61,12,[5 4],62,-1,75,-1,63
1,<environment.Job instance at 0x7fe918df25f0>,62,20,[10  5],63,-1,83,-1,63
1,<environment.Job instance at 0x7fe918f3b2d0>,64,14,[10  5],65,-1,79,-1,65
1,<environment.Job instance at 0x7fe918d8c9b0>,69,14,[ 5 10],70,-1,84,-1,70
1,<environment.Job instance at 0x7fe918d8ccd0>,70,17,[4 7],71,-1,88,-1,71
1,<environment.Job instance at 0x7fe918d8c5f0>,71,13,[5 7],72,-1,87,-1,74
1,<environment.Job instance at 0x7fe93e5b4d20>,51,22,[5 6],52,-1,97,-1,75
1,<environment.Job instance at 0x7fe918d8c050>,74,19,[3 8],75,-1,94,-1,75
1,<environment.Job instance at 0x7fe918d8caf0>,75,17,[5 1],76,-1,93,-1,76
1,<environment.Job instance at 0x7fe918f3e280>,77,16,[8 4],78,-1,95,-1,79
1,<environment.Job instance at 0x7fe918d884b0>,79,2,[10  2],80,-1,82,-1,80
1,<environment.Job instance at 0x7fe918d8c730>,73,24,[3 7],74,-1,104,-1,80
1,<environment.Job instance at 0x7fe918d8c410>,80,17,[3 5],81,-1,99,-1,82
1,<environment.Job instance at 0x7fe918deeaa0>,86,17,[9 1],87,-1,104,-1,87
1,<environment.Job instance at 0x7fe918d88fa0>,87,13,[9 5],88,-1,101,-1,88
1,<environment.Job instance at 0x7fe918d8a8c0>,90,17,[9 5],91,-1,108,-1,91
1,<environment.Job instance at 0x7fe918f3deb0>,20,19,[ 5 12],21,-1,123,-1,104
1,<environment.Job instance at 0x7fe918d8d230>,66,13,[ 5 14],67,-1,126,-1,113
1,<environment.Job instance at 0x7fe918d87550>,9,27,[3 9],10,-1,45,-1,18
1,<environment.Job instance at 0x7fe9197fa3c0>,10,23,[5 1],11,-1,41,-1,18
1,<environment.Job instance at 0x7fe918f93910>,17,3,[ 3 13],18,-1,26,-1,23
1,<environment.Job instance at 0x7fe918f935a0>,19,28,[7 5],20,-1,63,-1,35
1,<environment.Job instance at 0x7fe918f96aa0>,20,19,[ 5 12],21,-1,54,-1,35
1,<environment.Job instance at 0x7fe918fb5870>,37,28,[ 2 10],38,-1,129,-1,101
1,<environment.Job instance at 0x7fe918fb3d70>,42,15,[ 2 13],43,-1,122,-1,107
1,<environment.Job instance at 0x7fe918fbe9b0>,44,20,[13  4],45,-1,133,-1,113
1,<environment.Job instance at 0x7fe918fcb280>,53,1,[12  5],54,-1,131,-1,130
1,<environment.Job instance at 0x7fe918fafc80>,60,24,[1 5],61,-1,173,-1,149
1,<environment.Job instance at 0x7fe91913c910>,66,13,[ 5 14],67,-1,176,-1,163
1,<environment.Job instance at 0x7fe918ff9aa0>,73,24,[3 7],74,-1,219,-1,195
1,<environment.Job instance at 0x7fe918f8e370>,88,27,[ 3 12],89,-1,259,-1,232
1,<environment.Job instance at 0x7fe918f8edc0>,92,15,[ 2 14],93,-1,263,-1,248
1,<environment.Job instance at 0x7fe918f8ee10>,94,26,[3 9],95,-1,286,-1,260
1,<environment.Job instance at 0x7fe922fc8dc0>,0,23,[4 7],1,-1,24,-1,1
1,<environment.Job instance at 0x7fe918da0eb0>,3,14,[5 9],4,-1,18,-1,4
1,<environment.Job instance at 0x7fe918da0e10>,5,19,[ 1 10],6,-1,25,-1,6
1,<environment.Job instance at 0x7fe918da0820>,6,16,[6 5],7,-1,23,-1,7
1,<environment.Job instance at 0x7fe918da0e60>,8,20,[ 2 10],9,-1,30,-1,10
1,<environment.Job instance at 0x7fe918da0320>,10,1,[14  4],11,-1,12,-1,11
1,<environment.Job instance at 0x7fe918da0050>,11,17,[3 6],12,-1,29,-1,12
1,<environment.Job instance at 0x7fe918da07d0>,12,13,[2 5],13,-1,26,-1,13
1,<environment.Job instance at 0x7fe918da0dc0>,15,21,[1 6],16,-1,37,-1,16
1,<environment.Job instance at 0x7fe918da00a0>,16,16,[1 8],17,-1,35,-1,19
1,<environment.Job instance at 0x7fe918da0230>,19,17,[8 5],20,-1,38,-1,21
1,<environment.Job instance at 0x7fe918da0fa0>,17,18,[ 1 14],18,-1,41,-1,23
1,<environment.Job instance at 0x7fe918da0b90>,22,15,[8 2],23,-1,39,-1,24
1,<environment.Job instance at 0x7fe918e7a730>,24,15,[8 5],25,-1,41,-1,26
1,<environment.Job instance at 0x7fe918e7a190>,28,19,[4 7],29,-1,48,-1,29
1,<environment.Job instance at 0x7fe918e7aaa0>,30,16,[14  3],31,-1,47,-1,31
1,<environment.Job instance at 0x7fe918e7a550>,33,22,[9 1],34,-1,59,-1,37
1,<environment.Job instance at 0x7fe918da01e0>,18,23,[1 9],19,-1,61,-1,38
1,<environment.Job instance at 0x7fe922f52370>,38,13,[2 7],39,-1,52,-1,39
1,<environment.Job instance at 0x7fe922f52820>,40,13,[5 9],41,-1,54,-1,41
1,<environment.Job instance at 0x7fe918e7aa50>,35,18,[5 4],36,-1,60,-1,42
1,<environment.Job instance at 0x7fe922f525a0>,43,13,[9 2],44,-1,59,-1,46
1,<environment.Job instance at 0x7fe918e82cd0>,47,14,[10  3],48,-1,62,-1,48
1,<environment.Job instance at 0x7fe918e82d20>,45,27,[6 1],46,-1,87,-1,60
1,<environment.Job instance at 0x7fe918e82370>,51,16,[5 8],52,-1,76,-1,60
1,<environment.Job instance at 0x7fe918e82960>,57,14,[10  5],58,-1,74,-1,60
1,<environment.Job instance at 0x7fe918e0d910>,61,17,[10  2],62,-1,79,-1,62
1,<environment.Job instance at 0x7fe918e0d6e0>,63,26,[5 3],64,-1,90,-1,64
1,<environment.Job instance at 0x7fe918e0d960>,65,18,[ 1 10],66,-1,84,-1,66
1,<environment.Job instance at 0x7fe922f52140>,44,13,[4 5],45,-1,80,-1,67
1,<environment.Job instance at 0x7fe918e82910>,52,23,[1 8],53,-1,98,-1,75
1,<environment.Job instance at 0x7fe922f4d0a0>,70,18,[5 8],71,-1,102,-1,84
1,<environment.Job instance at 0x7fe922f4db90>,72,18,[3 8],73,-1,102,-1,84
1,<environment.Job instance at 0x7fe922f4deb0>,76,17,[8 4],77,-1,101,-1,84
1,<environment.Job instance at 0x7fe922e247d0>,78,20,[5 2],79,-1,105,-1,85
1,<environment.Job instance at 0x7fe922e24820>,79,26,[2 8],80,-1,112,-1,86
1,<environment.Job instance at 0x7fe918df08c0>,80,15,[5 8],81,-1,102,-1,87
1,<environment.Job instance at 0x7fe918df0820>,81,20,[ 4 10],82,-1,107,-1,87
1,<environment.Job instance at 0x7fe918da0aa0>,14,16,[5 6],15,-1,103,-1,87
1,<environment.Job instance at 0x7fe922e24a50>,77,15,[3 6],78,-1,102,-1,87
1,<environment.Job instance at 0x7fe922f4d780>,71,3,[5 9],72,-1,90,-1,87
1,<environment.Job instance at 0x7fe918df0c30>,84,16,[7 5],85,-1,103,-1,87
1,<environment.Job instance at 0x7fe918df0410>,87,27,[9 5],88,-1,115,-1,88
1,<environment.Job instance at 0x7fe918df03c0>,88,13,[8 4],89,-1,102,-1,89
1,<environment.Job instance at 0x7fe918df0b90>,82,15,[9 2],83,-1,115,-1,100
1,<environment.Job instance at 0x7fe918da0640>,0,23,[4 7],1,-1,24,-1,1
1,<environment.Job instance at 0x7fe918e0d460>,10,1,[14  4],11,-1,17,-1,16
1,<environment.Job instance at 0x7fe919099dc0>,17,18,[ 1 14],18,-1,51,-1,33
1,<environment.Job instance at 0x7fe918d9c1e0>,18,23,[1 9],19,-1,57,-1,34
1,<environment.Job instance at 0x7fe918d88fa0>,25,17,[12  1],26,-1,68,-1,51
1,<environment.Job instance at 0x7fe918dfd5f0>,30,16,[14  3],31,-1,88,-1,72
1,<environment.Job instance at 0x7fe918df2b40>,37,2,[ 1 12],38,-1,87,-1,85
1,<environment.Job instance at 0x7fe918df2dc0>,45,27,[6 1],46,-1,141,-1,114
1,<environment.Job instance at 0x7fe919837410>,52,23,[1 8],53,-1,163,-1,140
1,<environment.Job instance at 0x7fe918e76dc0>,63,26,[5 3],64,-1,182,-1,156
1,<environment.Job instance at 0x7fe918e3b7d0>,79,26,[2 8],80,-1,259,-1,233
1,<environment.Job instance at 0x7fe918de8d20>,87,27,[9 5],88,-1,299,-1,272
1,<environment.Job instance at 0x7fe918e28910>,89,14,[12  2],90,-1,286,-1,272
1,<environment.Job instance at 0x7fe919d3d140>,3,17,[7 4],4,-1,22,-1,5
1,<environment.Job instance at 0x7fe919bada50>,4,17,[13  5],5,-1,22,-1,5
1,<environment.Job instance at 0x7fe919d3d050>,13,16,[4 5],14,-1,31,-1,15
1,<environment.Job instance at 0x7fe919d3d550>,15,16,[7 5],16,-1,32,-1,16
1,<environment.Job instance at 0x7fe919d3d5a0>,18,14,[9 4],19,-1,33,-1,19
1,<environment.Job instance at 0x7fe919d3d320>,19,18,[5 6],20,-1,38,-1,20
1,<environment.Job instance at 0x7fe919d3d8c0>,20,16,[8 3],21,-1,38,-1,22
1,<environment.Job instance at 0x7fe918f90230>,23,16,[ 4 10],24,-1,44,-1,28
1,<environment.Job instance at 0x7fe9192a7fa0>,32,20,[4 9],33,-1,62,-1,42
1,<environment.Job instance at 0x7fe919d3d410>,5,13,[ 5 14],6,-1,56,-1,43
1,<environment.Job instance at 0x7fe91964d9b0>,42,17,[5 9],43,-1,62,-1,45
1,<environment.Job instance at 0x7fe91964d5a0>,43,17,[7 1],44,-1,62,-1,45
1,<environment.Job instance at 0x7fe91964d960>,44,21,[4 9],45,-1,66,-1,45
1,<environment.Job instance at 0x7fe9192cf230>,89,18,[10  4],90,-1,220,-1,202
1,<environment.Job instance at 0x7fe918f90460>,25,27,[4 5],26,-1,229,-1,202
1,<environment.Job instance at 0x7fe9192cfe10>,86,17,[7 4],87,-1,219,-1,202
1,<environment.Job instance at 0x7fe9192cfc30>,93,14,[5 6],94,-1,217,-1,203
1,<environment.Job instance at 0x7fe922f4e690>,94,18,[10  5],95,-1,221,-1,203
1,<environment.Job instance at 0x7fe922f4ee60>,96,16,[2 9],97,-1,219,-1,203
1,<environment.Job instance at 0x7fe922f4e730>,98,15,[10  4],99,-1,219,-1,204
1,<environment.Job instance at 0x7fe9192ed6e0>,56,25,[2 8],57,-1,229,-1,204
1,<environment.Job instance at 0x7fe9192cfb40>,85,17,[12  4],86,-1,221,-1,204
1,<environment.Job instance at 0x7fe9192ed460>,60,26,[8 3],61,-1,230,-1,204
1,<environment.Job instance at 0x7fe919d3d230>,1,17,[ 5 14],2,-1,19,-1,2
1,<environment.Job instance at 0x7fe919d3dc30>,2,25,[ 3 11],3,-1,28,-1,3
1,<environment.Job instance at 0x7fe919d3dbe0>,4,17,[13  5],5,-1,22,-1,5
1,<environment.Job instance at 0x7fe91929e9b0>,5,13,[ 5 14],6,-1,19,-1,6
1,<environment.Job instance at 0x7fe919fc6be0>,25,27,[4 5],26,-1,86,-1,59
1,<environment.Job instance at 0x7fe919860e60>,27,12,[13  4],28,-1,71,-1,59
1,<environment.Job instance at 0x7fe919952dc0>,28,12,[ 5 12],29,-1,71,-1,59
1,<environment.Job instance at 0x7fe9198f48c0>,47,13,[12  1],48,-1,120,-1,107
1,<environment.Job instance at 0x7fe9198f4d70>,48,12,[14  3],49,-1,119,-1,107
1,<environment.Job instance at 0x7fe9198f4f00>,49,1,[ 4 11],50,-1,108,-1,107
1,<environment.Job instance at 0x7fe919949f50>,56,25,[2 8],57,-1,153,-1,128
1,<environment.Job instance at 0x7fe91997cd20>,60,26,[8 3],61,-1,168,-1,142
1,<environment.Job instance at 0x7fe9197e9640>,74,2,[11  3],75,-1,175,-1,173
1,<environment.Job instance at 0x7fe91990b2d0>,85,17,[12  4],86,-1,252,-1,235
1,<environment.Job instance at 0x7fe9198c4af0>,97,2,[ 3 11],98,-1,286,-1,284
1,<environment.Job instance at 0x7fe918dd8370>,0,16,[8 5],1,-1,17,-1,1
1,<environment.Job instance at 0x7fe918e12410>,1,16,[4 5],2,-1,18,-1,2
1,<environment.Job instance at 0x7fe9194e1870>,2,27,[8 3],3,-1,30,-1,3
1,<environment.Job instance at 0x7fe9194e14b0>,3,18,[1 6],4,-1,22,-1,4
1,<environment.Job instance at 0x7fe9194e1370>,4,17,[2 6],5,-1,22,-1,5
1,<environment.Job instance at 0x7fe9194dbe60>,6,27,[2 6],7,-1,34,-1,7
1,<environment.Job instance at 0x7fe9194db8c0>,8,16,[9 2],9,-1,27,-1,11
1,<environment.Job instance at 0x7fe9194db460>,11,16,[4 5],12,-1,28,-1,12
1,<environment.Job instance at 0x7fe9194d4730>,15,14,[6 1],16,-1,30,-1,16
1,<environment.Job instance at 0x7fe9194c9e10>,20,12,[10  5],21,-1,33,-1,21
1,<environment.Job instance at 0x7fe9194c91e0>,22,16,[6 4],23,-1,39,-1,23
1,<environment.Job instance at 0x7fe91a32b7d0>,24,14,[3 6],25,-1,39,-1,25
1,<environment.Job instance at 0x7fe9194dbdc0>,25,13,[7 4],26,-1,39,-1,26
1,<environment.Job instance at 0x7fe91a31b5a0>,26,21,[ 4 10],27,-1,48,-1,27
1,<environment.Job instance at 0x7fe91a31b550>,27,23,[2 8],28,-1,51,-1,28
1,<environment.Job instance at 0x7fe919225640>,38,14,[8 2],39,-1,59,-1,45
1,<environment.Job instance at 0x7fe919424d20>,35,17,[ 5 10],36,-1,65,-1,48
1,<environment.Job instance at 0x7fe919223c80>,40,25,[6 4],41,-1,73,-1,48
1,<environment.Job instance at 0x7fe9192254b0>,39,17,[12  4],40,-1,65,-1,48
1,<environment.Job instance at 0x7fe9194dbb40>,10,14,[ 4 14],11,-1,66,-1,52
1,<environment.Job instance at 0x7fe919228910>,48,28,[ 5 10],49,-1,80,-1,52
1,<environment.Job instance at 0x7fe919228b40>,50,13,[5 5],51,-1,68,-1,55
1,<environment.Job instance at 0x7fe919230320>,44,24,[5 5],45,-1,80,-1,56
1,<environment.Job instance at 0x7fe9192288c0>,51,17,[7 5],52,-1,74,-1,57
1,<environment.Job instance at 0x7fe919228aa0>,49,15,[9 5],50,-1,77,-1,62
1,<environment.Job instance at 0x7fe919224f50>,57,13,[3 7],58,-1,75,-1,62
1,<environment.Job instance at 0x7fe91920f190>,55,14,[3 8],56,-1,76,-1,62
1,<environment.Job instance at 0x7fe919c2d640>,63,15,[6 4],64,-1,84,-1,69
1,<environment.Job instance at 0x7fe9194248c0>,36,14,[9 4],37,-1,83,-1,69
1,<environment.Job instance at 0x7fe919c2d7d0>,66,12,[10  2],67,-1,81,-1,69
1,<environment.Job instance at 0x7fe919c2d780>,65,13,[6 3],66,-1,82,-1,69
1,<environment.Job instance at 0x7fe91920f230>,56,12,[ 5 12],57,-1,83,-1,71
1,<environment.Job instance at 0x7fe919c2d910>,68,13,[8 3],69,-1,84,-1,71
1,<environment.Job instance at 0x7fe919c2dc30>,70,12,[3 7],71,-1,84,-1,72
1,<environment.Job instance at 0x7fe919c2dc80>,73,12,[2 7],74,-1,86,-1,74
1,<environment.Job instance at 0x7fe919c2df00>,74,22,[7 3],75,-1,97,-1,75
1,<environment.Job instance at 0x7fe919c2da50>,72,14,[5 3],73,-1,90,-1,76
1,<environment.Job instance at 0x7fe919c2dfa0>,75,20,[7 5],76,-1,96,-1,76
1,<environment.Job instance at 0x7fe919c24460>,80,13,[5 5],81,-1,95,-1,82
1,<environment.Job instance at 0x7fe919c24b40>,85,12,[4 5],86,-1,99,-1,87
1,<environment.Job instance at 0x7fe919c24a50>,87,18,[8 2],88,-1,106,-1,88
1,<environment.Job instance at 0x7fe91920f550>,58,15,[2 9],59,-1,108,-1,93
1,<environment.Job instance at 0x7fe919c24f50>,90,15,[2 5],91,-1,108,-1,93
1,<environment.Job instance at 0x7fe919c5a1e0>,93,14,[9 3],94,-1,108,-1,94
1,<environment.Job instance at 0x7fe919c5a140>,92,17,[4 5],93,-1,112,-1,95
1,<environment.Job instance at 0x7fe919c5a320>,95,17,[8 2],96,-1,114,-1,97
1,<environment.Job instance at 0x7fe919c2d870>,67,12,[6 2],68,-1,109,-1,97
1,<environment.Job instance at 0x7fe919c5a3c0>,96,16,[1 9],97,-1,113,-1,97
1,<environment.Job instance at 0x7fe9194c9eb0>,2,27,[8 3],3,-1,44,-1,17
1,<environment.Job instance at 0x7fe919235e10>,6,27,[2 6],7,-1,44,-1,17
1,<environment.Job instance at 0x7fe919c3d6e0>,10,14,[ 4 14],11,-1,31,-1,17
1,<environment.Job instance at 0x7fe91990baf0>,28,3,[11  1],29,-1,72,-1,69
1,<environment.Job instance at 0x7fe91990b6e0>,29,19,[13  3],30,-1,88,-1,69
1,<environment.Job instance at 0x7fe91990b1e0>,27,23,[2 8],28,-1,92,-1,69
1,<environment.Job instance at 0x7fe91a34f6e0>,34,13,[ 4 11],35,-1,96,-1,83
1,<environment.Job instance at 0x7fe919ec6910>,39,17,[12  4],40,-1,113,-1,96
1,<environment.Job instance at 0x7fe919bae370>,40,25,[6 4],41,-1,122,-1,97
1,<environment.Job instance at 0x7fe91a377b90>,42,3,[14  5],43,-1,100,-1,97
1,<environment.Job instance at 0x7fe919855230>,44,24,[5 5],45,-1,133,-1,109
1,<environment.Job instance at 0x7fe919ab9fa0>,48,28,[ 5 10],49,-1,153,-1,125
1,<environment.Job instance at 0x7fe9199495a0>,56,12,[ 5 12],57,-1,153,-1,141
1,<environment.Job instance at 0x7fe9198f4500>,59,2,[ 5 14],60,-1,149,-1,147
1,<environment.Job instance at 0x7fe91982fc80>,71,16,[ 1 14],72,-1,220,-1,204
1,<environment.Job instance at 0x7fe9192cf320>,84,17,[14  5],85,-1,248,-1,231
1,<environment.Job instance at 0x7fe9192ed2d0>,91,2,[14  5],92,-1,249,-1,247
1,<environment.Job instance at 0x7fe9195d5190>,2,16,[10  4],3,-1,20,-1,4
1,<environment.Job instance at 0x7fe919c5ca50>,3,16,[6 5],4,-1,20,-1,4
1,<environment.Job instance at 0x7fe9195d52d0>,4,16,[9 5],5,-1,21,-1,5
1,<environment.Job instance at 0x7fe9195d5280>,6,22,[1 8],7,-1,30,-1,8
1,<environment.Job instance at 0x7fe9195d5a50>,8,1,[9 2],9,-1,10,-1,9
1,<environment.Job instance at 0x7fe9195d5aa0>,9,18,[5 8],10,-1,28,-1,10
1,<environment.Job instance at 0x7fe9195d5cd0>,10,18,[ 2 10],11,-1,29,-1,11
1,<environment.Job instance at 0x7fe9195d5dc0>,11,15,[8 1],12,-1,27,-1,12
1,<environment.Job instance at 0x7fe9195d5960>,12,13,[1 5],13,-1,26,-1,13
1,<environment.Job instance at 0x7fe9195d5e60>,13,2,[5 9],14,-1,16,-1,14
1,<environment.Job instance at 0x7fe9195d5eb0>,14,16,[6 1],15,-1,31,-1,15
1,<environment.Job instance at 0x7fe9195d5af0>,15,3,[4 6],16,-1,19,-1,16
1,<environment.Job instance at 0x7fe9195d57d0>,16,18,[ 5 10],17,-1,35,-1,17
1,<environment.Job instance at 0x7fe9195d5820>,7,28,[5 9],8,-1,45,-1,17
1,<environment.Job instance at 0x7fe9195d50f0>,18,13,[9 1],19,-1,35,-1,22
1,<environment.Job instance at 0x7fe9195d5370>,21,14,[9 2],22,-1,36,-1,22
1,<environment.Job instance at 0x7fe91a31c910>,29,18,[1 7],30,-1,48,-1,30
1,<environment.Job instance at 0x7fe91a31ceb0>,32,17,[8 1],33,-1,51,-1,34
1,<environment.Job instance at 0x7fe91941d780>,35,18,[4 6],36,-1,54,-1,36
1,<environment.Job instance at 0x7fe91941df50>,37,28,[ 5 10],38,-1,66,-1,38
1,<environment.Job instance at 0x7fe91941de60>,39,18,[3 8],40,-1,58,-1,40
1,<environment.Job instance at 0x7fe91941dbe0>,40,22,[7 1],41,-1,63,-1,41
1,<environment.Job instance at 0x7fe91941d320>,42,21,[5 7],43,-1,64,-1,43
1,<environment.Job instance at 0x7fe91941d640>,45,16,[4 7],46,-1,62,-1,46
1,<environment.Job instance at 0x7fe91941d730>,46,18,[9 3],47,-1,65,-1,47
1,<environment.Job instance at 0x7fe91916db40>,48,16,[1 7],49,-1,65,-1,49
1,<environment.Job instance at 0x7fe919bff8c0>,49,18,[8 2],50,-1,68,-1,50
1,<environment.Job instance at 0x7fe919bff780>,53,17,[4 7],54,-1,71,-1,54
1,<environment.Job instance at 0x7fe919bff6e0>,54,16,[ 5 10],55,-1,71,-1,55
1,<environment.Job instance at 0x7fe919bff910>,55,15,[5 9],56,-1,71,-1,56
1,<environment.Job instance at 0x7fe919443050>,60,26,[3 7],61,-1,87,-1,61
1,<environment.Job instance at 0x7fe919443280>,61,18,[11  5],62,-1,80,-1,62
1,<environment.Job instance at 0x7fe91a31ca00>,33,22,[3 5],34,-1,86,-1,64
1,<environment.Job instance at 0x7fe9194431e0>,64,16,[1 5],65,-1,82,-1,66
1,<environment.Job instance at 0x7fe919443d70>,67,18,[10  5],68,-1,86,-1,68
1,<environment.Job instance at 0x7fe91940f5a0>,68,13,[5 5],69,-1,82,-1,69
1,<environment.Job instance at 0x7fe91940fe10>,70,13,[10  1],71,-1,84,-1,71
1,<environment.Job instance at 0x7fe91940fa00>,72,24,[1 9],73,-1,97,-1,73
1,<environment.Job instance at 0x7fe91940f8c0>,73,14,[6 5],74,-1,88,-1,74
1,<environment.Job instance at 0x7fe919443fa0>,65,18,[4 9],66,-1,92,-1,74
1,<environment.Job instance at 0x7fe91940f230>,76,12,[10  1],77,-1,93,-1,81
1,<environment.Job instance at 0x7fe91940ff50>,80,17,[5 6],81,-1,98,-1,81
1,<environment.Job instance at 0x7fe91942e0a0>,86,15,[10  2],87,-1,102,-1,87
1,<environment.Job instance at 0x7fe91940fdc0>,84,1,[3 5],85,-1,89,-1,88
1,<environment.Job instance at 0x7fe91942ecd0>,88,12,[ 2 11],89,-1,101,-1,89
1,<environment.Job instance at 0x7fe91942e410>,90,16,[10  1],91,-1,107,-1,91
1,<environment.Job instance at 0x7fe91942e5f0>,91,17,[11  3],92,-1,109,-1,92
1,<environment.Job instance at 0x7fe91941dd20>,7,28,[5 9],8,-1,66,-1,38
1,<environment.Job instance at 0x7fe919203870>,17,28,[9 1],18,-1,82,-1,54
1,<environment.Job instance at 0x7fe919c24320>,22,26,[5 8],23,-1,89,-1,63
1,<environment.Job instance at 0x7fe9192084b0>,26,2,[ 5 13],27,-1,74,-1,72
1,<environment.Job instance at 0x7fe9192286e0>,31,1,[13  4],32,-1,85,-1,84
1,<environment.Job instance at 0x7fe919235e10>,37,28,[ 5 10],38,-1,142,-1,114
1,<environment.Job instance at 0x7fe91a335230>,38,2,[12  3],39,-1,116,-1,114
1,<environment.Job instance at 0x7fe919bef9b0>,60,26,[3 7],61,-1,226,-1,200
1,<environment.Job instance at 0x7fe919befe10>,61,18,[11  5],62,-1,218,-1,200
1,<environment.Job instance at 0x7fe919165fa0>,69,1,[12  2],70,-1,231,-1,230
1,<environment.Job instance at 0x7fe919165370>,72,24,[1 9],73,-1,270,-1,246
1,<environment.Job instance at 0x7fe91941fc80>,81,27,[7 1],82,-1,305,-1,278
1,<environment.Job instance at 0x7fe91941f5f0>,83,2,[ 3 13],84,-1,280,-1,278
1,<environment.Job instance at 0x7fe91941f4b0>,82,26,[ 3 10],83,-1,310,-1,284
1,<environment.Job instance at 0x7fe91941f190>,87,1,[ 3 14],88,-1,285,-1,284
1,<environment.Job instance at 0x7fe91941fb40>,88,12,[ 2 11],89,-1,296,-1,284
1,<environment.Job instance at 0x7fe91941feb0>,91,17,[11  3],92,-1,309,-1,292
1,<environment.Job instance at 0x7fe91941f8c0>,92,16,[12  1],93,-1,308,-1,292
1,<environment.Job instance at 0x7fe91941fa50>,93,15,[ 4 13],94,-1,307,-1,292
1,<environment.Job instance at 0x7fe919dea7d0>,0,17,[10  2],1,-1,19,-1,2
1,<environment.Job instance at 0x7fe91964d690>,1,13,[10  2],2,-1,15,-1,2
1,<environment.Job instance at 0x7fe919368870>,3,24,[2 6],4,-1,28,-1,4
1,<environment.Job instance at 0x7fe91953b280>,12,18,[6 2],13,-1,31,-1,13
1,<environment.Job instance at 0x7fe91953be60>,14,18,[6 2],15,-1,33,-1,15
1,<environment.Job instance at 0x7fe91953bc80>,15,19,[6 3],16,-1,35,-1,16
1,<environment.Job instance at 0x7fe91953b730>,17,15,[6 1],18,-1,34,-1,19
1,<environment.Job instance at 0x7fe919130f50>,21,14,[3 6],22,-1,36,-1,22
1,<environment.Job instance at 0x7fe9191304b0>,22,27,[5 7],23,-1,50,-1,23
1,<environment.Job instance at 0x7fe919125910>,25,16,[9 2],26,-1,42,-1,26
1,<environment.Job instance at 0x7fe919125f00>,26,15,[10  3],27,-1,43,-1,28
1,<environment.Job instance at 0x7fe91916adc0>,28,15,[11  4],29,-1,44,-1,29
1,<environment.Job instance at 0x7fe919907140>,27,15,[9 1],28,-1,44,-1,29
1,<environment.Job instance at 0x7fe9198f2280>,29,17,[5 2],30,-1,48,-1,31
1,<environment.Job instance at 0x7fe919167aa0>,39,17,[6 2],40,-1,57,-1,40
1,<environment.Job instance at 0x7fe9198e7a00>,40,17,[5 2],41,-1,58,-1,41
1,<environment.Job instance at 0x7fe9198e7320>,41,18,[4 9],42,-1,60,-1,42
1,<environment.Job instance at 0x7fe9198f1910>,50,18,[ 4 11],51,-1,69,-1,51
1,<environment.Job instance at 0x7fe91950f320>,31,14,[ 4 13],32,-1,65,-1,51
1,<environment.Job instance at 0x7fe9198f1b90>,51,18,[ 3 10],52,-1,71,-1,53
1,<environment.Job instance at 0x7fe9198f17d0>,52,12,[7 2],53,-1,65,-1,53
1,<environment.Job instance at 0x7fe9198f1f50>,53,24,[8 5],54,-1,81,-1,57
1,<environment.Job instance at 0x7fe9198f1280>,49,16,[7 4],50,-1,73,-1,57
1,<environment.Job instance at 0x7fe9198e2c80>,55,13,[5 7],56,-1,70,-1,57
1,<environment.Job instance at 0x7fe9198daaa0>,61,15,[8 1],62,-1,80,-1,65
1,<environment.Job instance at 0x7fe9198daf00>,62,16,[5 4],63,-1,84,-1,68
1,<environment.Job instance at 0x7fe919442190>,63,15,[ 3 10],64,-1,83,-1,68
1,<environment.Job instance at 0x7fe9198f1870>,46,16,[8 2],47,-1,85,-1,69
1,<environment.Job instance at 0x7fe9198f1c80>,54,14,[ 1 10],55,-1,84,-1,70
1,<environment.Job instance at 0x7fe9198e20a0>,58,13,[12  1],59,-1,83,-1,70
1,<environment.Job instance at 0x7fe919442460>,65,15,[5 6],66,-1,85,-1,70
1,<environment.Job instance at 0x7fe919442500>,68,20,[3 9],69,-1,91,-1,71
1,<environment.Job instance at 0x7fe9194428c0>,70,16,[5 4],71,-1,87,-1,71
1,<environment.Job instance at 0x7fe919442910>,71,17,[ 4 10],72,-1,89,-1,72
1,<environment.Job instance at 0x7fe919442d70>,77,21,[4 8],78,-1,103,-1,82
1,<environment.Job instance at 0x7fe919442cd0>,76,14,[6 5],77,-1,96,-1,82
1,<environment.Job instance at 0x7fe919442f00>,79,13,[10  5],80,-1,95,-1,82
1,<environment.Job instance at 0x7fe919442e10>,78,23,[3 9],79,-1,108,-1,85
1,<environment.Job instance at 0x7fe919434320>,82,14,[2 6],83,-1,100,-1,86
1,<environment.Job instance at 0x7fe919434550>,84,18,[6 4],85,-1,104,-1,86
1,<environment.Job instance at 0x7fe919434460>,85,15,[4 7],86,-1,101,-1,86
1,<environment.Job instance at 0x7fe919434780>,87,17,[8 4],88,-1,106,-1,89
1,<environment.Job instance at 0x7fe9198f1320>,47,14,[11  4],48,-1,103,-1,89
1,<environment.Job instance at 0x7fe9194348c0>,88,16,[1 7],89,-1,105,-1,89
1,<environment.Job instance at 0x7fe919434730>,89,15,[ 2 10],90,-1,105,-1,90
1,<environment.Job instance at 0x7fe919434f50>,95,13,[6 4],96,-1,109,-1,96
1,<environment.Job instance at 0x7fe919180690>,4,13,[ 5 12],5,-1,18,-1,5
1,<environment.Job instance at 0x7fe9194420a0>,5,2,[ 2 11],6,-1,8,-1,6
1,<environment.Job instance at 0x7fe9198f1e60>,3,24,[2 6],4,-1,41,-1,17
1,<environment.Job instance at 0x7fe91941f7d0>,22,27,[5 7],23,-1,76,-1,49
1,<environment.Job instance at 0x7fe91941fdc0>,24,24,[13  2],25,-1,73,-1,49
1,<environment.Job instance at 0x7fe919165910>,28,15,[11  4],29,-1,73,-1,58
1,<environment.Job instance at 0x7fe9191656e0>,31,14,[ 4 13],32,-1,90,-1,76
1,<environment.Job instance at 0x7fe919bef050>,47,14,[11  4],48,-1,154,-1,140
1,<environment.Job instance at 0x7fe919bef460>,50,18,[ 4 11],51,-1,170,-1,152
1,<environment.Job instance at 0x7fe919bef5a0>,53,24,[8 5],54,-1,198,-1,174
1,<environment.Job instance at 0x7fe919c240a0>,58,13,[12  1],59,-1,201,-1,188
1,<environment.Job instance at 0x7fe91a31cd20>,66,3,[14  2],67,-1,214,-1,211
1,<environment.Job instance at 0x7fe919773910>,73,14,[ 5 13],74,-1,252,-1,238
1,<environment.Job instance at 0x7fe919d2c960>,78,23,[3 9],79,-1,291,-1,268
1,<environment.Job instance at 0x7fe918d474b0>,90,2,[ 1 11],91,-1,302,-1,300
1,<environment.Job instance at 0x7fe918d5dcd0>,97,12,[ 3 14],98,-1,340,-1,328
1,<environment.Job instance at 0x7fe919557960>,1,16,[8 4],2,-1,18,-1,2
1,<environment.Job instance at 0x7fe919557500>,3,18,[6 4],4,-1,22,-1,4
1,<environment.Job instance at 0x7fe9190f5320>,15,21,[9 5],16,-1,37,-1,16
1,<environment.Job instance at 0x7fe9190f5640>,16,18,[10  5],17,-1,35,-1,17
1,<environment.Job instance at 0x7fe9190f56e0>,17,14,[1 9],18,-1,32,-1,18
1,<environment.Job instance at 0x7fe9190f5a00>,21,16,[1 6],22,-1,38,-1,22
1,<environment.Job instance at 0x7fe9190f5870>,23,27,[3 5],24,-1,51,-1,24
1,<environment.Job instance at 0x7fe9190f54b0>,27,17,[5 7],28,-1,45,-1,28
1,<environment.Job instance at 0x7fe9190f5370>,28,12,[7 5],29,-1,41,-1,29
1,<environment.Job instance at 0x7fe9196337d0>,29,12,[1 9],30,-1,42,-1,30
1,<environment.Job instance at 0x7fe919633410>,33,12,[9 3],34,-1,46,-1,34
1,<environment.Job instance at 0x7fe919633a00>,34,12,[1 5],35,-1,47,-1,35
1,<environment.Job instance at 0x7fe919633b90>,35,14,[5 2],36,-1,50,-1,36
1,<environment.Job instance at 0x7fe919633e60>,37,17,[2 6],38,-1,55,-1,38
1,<environment.Job instance at 0x7fe919633c80>,38,17,[5 4],39,-1,56,-1,39
1,<environment.Job instance at 0x7fe919633960>,40,16,[9 4],41,-1,57,-1,41
1,<environment.Job instance at 0x7fe919633870>,43,13,[5 6],44,-1,57,-1,44
1,<environment.Job instance at 0x7fe9191f4be0>,45,18,[3 9],46,-1,64,-1,46
1,<environment.Job instance at 0x7fe9191f4190>,46,27,[10  4],47,-1,74,-1,47
1,<environment.Job instance at 0x7fe9191f4690>,48,14,[4 5],49,-1,63,-1,49
1,<environment.Job instance at 0x7fe9191f4640>,49,14,[9 4],50,-1,64,-1,50
1,<environment.Job instance at 0x7fe9191f4960>,51,18,[4 8],52,-1,70,-1,52
1,<environment.Job instance at 0x7fe9191f41e0>,52,25,[7 3],53,-1,78,-1,53
1,<environment.Job instance at 0x7fe9191f45a0>,56,17,[2 9],57,-1,75,-1,58
1,<environment.Job instance at 0x7fe9191f4eb0>,57,13,[4 7],58,-1,72,-1,59
1,<environment.Job instance at 0x7fe9191f4d70>,59,14,[4 7],60,-1,75,-1,61
1,<environment.Job instance at 0x7fe919630cd0>,61,17,[10  5],62,-1,79,-1,62
1,<environment.Job instance at 0x7fe919630a50>,63,17,[6 1],64,-1,81,-1,64
1,<environment.Job instance at 0x7fe9191f4a00>,60,16,[10  3],61,-1,81,-1,65
1,<environment.Job instance at 0x7fe919630a00>,69,18,[5 2],70,-1,88,-1,70
1,<environment.Job instance at 0x7fe919630c30>,74,12,[3 7],75,-1,88,-1,76
1,<environment.Job instance at 0x7fe9194e10a0>,77,16,[2 7],78,-1,94,-1,78
1,<environment.Job instance at 0x7fe9194e1af0>,78,15,[6 2],79,-1,94,-1,79
1,<environment.Job instance at 0x7fe919630190>,75,12,[3 7],76,-1,96,-1,84
1,<environment.Job instance at 0x7fe9194e1d20>,80,18,[1 7],81,-1,106,-1,88
1,<environment.Job instance at 0x7fe9194e1410>,82,14,[8 5],83,-1,102,-1,88
1,<environment.Job instance at 0x7fe9194e1eb0>,86,20,[4 8],87,-1,108,-1,88
1,<environment.Job instance at 0x7fe919172050>,88,16,[8 4],89,-1,105,-1,89
1,<environment.Job instance at 0x7fe9191723c0>,90,25,[5 4],91,-1,116,-1,91
1,<environment.Job instance at 0x7fe919172f00>,91,21,[5 5],92,-1,113,-1,92
1,<environment.Job instance at 0x7fe919172410>,93,18,[ 2 10],94,-1,112,-1,94
1,<environment.Job instance at 0x7fe9191726e0>,95,25,[5 7],96,-1,121,-1,96
1,<environment.Job instance at 0x7fe919c7f140>,97,22,[5 8],98,-1,120,-1,98
1,<environment.Job instance at 0x7fe9191f4730>,8,16,[13  3],9,-1,25,-1,9
1,<environment.Job instance at 0x7fe919beff00>,23,27,[3 5],24,-1,66,-1,39
1,<environment.Job instance at 0x7fe919bef500>,24,1,[12  4],25,-1,40,-1,39
1,<environment.Job instance at 0x7fe91a31c140>,25,2,[14  1],26,-1,41,-1,39
1,<environment.Job instance at 0x7fe919541960>,50,1,[ 5 11],51,-1,148,-1,147
1,<environment.Job instance at 0x7fe9191ee0a0>,52,25,[7 3],53,-1,186,-1,161
1,<environment.Job instance at 0x7fe919da40f0>,46,27,[10  4],47,-1,188,-1,161
1,<environment.Job instance at 0x7fe9191ee1e0>,54,13,[ 3 12],55,-1,174,-1,161
1,<environment.Job instance at 0x7fe91a30aa50>,68,14,[13  2],69,-1,239,-1,225
1,<environment.Job instance at 0x7fe9191bb460>,85,26,[4 8],86,-1,313,-1,287
1,<environment.Job instance at 0x7fe91920a9b0>,90,25,[5 4],91,-1,318,-1,293
1,<environment.Job instance at 0x7fe919f68050>,95,25,[5 7],96,-1,332,-1,307
1,<environment.Job instance at 0x7fe918e95f00>,3,27,[8 5],4,-1,31,-1,4
1,<environment.Job instance at 0x7fe918c702d0>,12,1,[5 5],13,-1,14,-1,13
1,<environment.Job instance at 0x7fe918c70a00>,13,24,[3 5],14,-1,38,-1,14
1,<environment.Job instance at 0x7fe918c704b0>,14,14,[4 6],15,-1,29,-1,15
1,<environment.Job instance at 0x7fe918c705f0>,15,14,[10  1],16,-1,30,-1,16
1,<environment.Job instance at 0x7fe918c709b0>,16,15,[3 6],17,-1,32,-1,17
1,<environment.Job instance at 0x7fe918c70fa0>,17,17,[2 7],18,-1,35,-1,18
1,<environment.Job instance at 0x7fe918c70500>,18,15,[5 5],19,-1,34,-1,19
1,<environment.Job instance at 0x7fe918c70e10>,21,18,[5 9],22,-1,40,-1,22
1,<environment.Job instance at 0x7fe918c70960>,23,18,[3 7],24,-1,42,-1,24
1,<environment.Job instance at 0x7fe918c2ba00>,30,18,[2 7],31,-1,49,-1,31
1,<environment.Job instance at 0x7fe918c2b410>,33,13,[5 2],34,-1,47,-1,34
1,<environment.Job instance at 0x7fe918c2b460>,34,23,[4 5],35,-1,58,-1,35
1,<environment.Job instance at 0x7fe918c2b2d0>,35,13,[8 4],36,-1,49,-1,36
1,<environment.Job instance at 0x7fe918c2bb40>,36,13,[6 5],37,-1,51,-1,38
1,<environment.Job instance at 0x7fe918c2bbe0>,37,13,[12  5],38,-1,51,-1,38
1,<environment.Job instance at 0x7fe918c2b820>,38,12,[5 5],39,-1,52,-1,40
1,<environment.Job instance at 0x7fe918c2bd70>,39,18,[7 4],40,-1,58,-1,40
1,<environment.Job instance at 0x7fe918c2b500>,43,14,[ 4 11],44,-1,59,-1,45
1,<environment.Job instance at 0x7fe918b62320>,46,26,[8 5],47,-1,73,-1,47
1,<environment.Job instance at 0x7fe918b62dc0>,49,20,[6 3],50,-1,70,-1,50
1,<environment.Job instance at 0x7fe918b62e60>,50,17,[5 8],51,-1,68,-1,51
1,<environment.Job instance at 0x7fe918c2b370>,44,18,[3 6],45,-1,69,-1,51
1,<environment.Job instance at 0x7fe918b62550>,53,20,[5 3],54,-1,75,-1,55
1,<environment.Job instance at 0x7fe918b623c0>,55,17,[6 3],56,-1,73,-1,56
1,<environment.Job instance at 0x7fe918b62370>,56,14,[10  1],57,-1,71,-1,57
1,<environment.Job instance at 0x7fe918b62b40>,59,12,[7 5],60,-1,72,-1,60
1,<environment.Job instance at 0x7fe918b62960>,54,16,[2 7],55,-1,76,-1,60
1,<environment.Job instance at 0x7fe919747320>,60,18,[5 6],61,-1,80,-1,62
1,<environment.Job instance at 0x7fe91991bb90>,61,17,[2 9],62,-1,79,-1,62
1,<environment.Job instance at 0x7fe91991b820>,67,22,[10  1],68,-1,90,-1,68
1,<environment.Job instance at 0x7fe922e40190>,79,13,[8 5],80,-1,93,-1,80
1,<environment.Job instance at 0x7fe919090370>,70,20,[3 8],71,-1,103,-1,83
1,<environment.Job instance at 0x7fe919e298c0>,83,16,[6 3],84,-1,100,-1,84
1,<environment.Job instance at 0x7fe919e29af0>,82,13,[ 3 10],83,-1,97,-1,84
1,<environment.Job instance at 0x7fe91a3a0550>,85,13,[4 7],86,-1,99,-1,86
1,<environment.Job instance at 0x7fe918e24410>,84,17,[1 8],85,-1,104,-1,87
1,<environment.Job instance at 0x7fe9199005f0>,92,25,[7 5],93,-1,126,-1,101
1,<environment.Job instance at 0x7fe91974a5a0>,94,2,[13  4],95,-1,103,-1,101
1,<environment.Job instance at 0x7fe918b84960>,90,15,[13  3],91,-1,117,-1,102
1,<environment.Job instance at 0x7fe91974aeb0>,96,12,[12  4],97,-1,114,-1,102
1,<environment.Job instance at 0x7fe918b62730>,48,18,[13  1],49,-1,121,-1,103
1,<environment.Job instance at 0x7fe91a14f550>,97,13,[5 3],98,-1,116,-1,103
1,<environment.Job instance at 0x7fe918e0df00>,3,27,[8 5],4,-1,32,-1,5
1,<environment.Job instance at 0x7fe91974a8c0>,4,12,[ 5 13],5,-1,17,-1,5
1,<environment.Job instance at 0x7fe918e952d0>,9,1,[12  4],10,-1,11,-1,10
1,<environment.Job instance at 0x7fe918e95960>,13,24,[3 5],14,-1,42,-1,18
1,<environment.Job instance at 0x7fe91999fd70>,24,27,[1 8],25,-1,92,-1,65
1,<environment.Job instance at 0x7fe919a56fa0>,34,23,[4 5],35,-1,106,-1,83
1,<environment.Job instance at 0x7fe919a566e0>,37,13,[12  5],38,-1,104,-1,91
1,<environment.Job instance at 0x7fe919a4a5f0>,43,14,[ 4 11],44,-1,131,-1,117
1,<environment.Job instance at 0x7fe919a44050>,46,26,[8 5],47,-1,154,-1,128
1,<environment.Job instance at 0x7fe919a44f00>,48,18,[13  1],49,-1,146,-1,128
1,<environment.Job instance at 0x7fe919a2d960>,68,16,[13  1],69,-1,211,-1,195
1,<environment.Job instance at 0x7fe919a2d4b0>,71,3,[11  4],72,-1,200,-1,197
1,<environment.Job instance at 0x7fe919c08a00>,76,26,[9 5],77,-1,249,-1,223
1,<environment.Job instance at 0x7fe919be1f00>,87,1,[ 4 12],88,-1,243,-1,242
1,<environment.Job instance at 0x7fe919f644b0>,90,15,[13  3],91,-1,259,-1,244
1,<environment.Job instance at 0x7fe91a252780>,92,25,[7 5],93,-1,279,-1,254
1,<environment.Job instance at 0x7fe919c33640>,93,2,[14  5],94,-1,256,-1,254
1,<environment.Job instance at 0x7fe919719050>,94,2,[13  4],95,-1,256,-1,254
1,<environment.Job instance at 0x7fe91a257370>,96,12,[12  4],97,-1,266,-1,254
1,<environment.Job instance at 0x7fe919c554b0>,0,16,[ 2 10],1,-1,20,-1,4
1,<environment.Job instance at 0x7fe919aba8c0>,3,15,[4 8],4,-1,19,-1,4
1,<environment.Job instance at 0x7fe919aba910>,6,18,[5 8],7,-1,26,-1,8
1,<environment.Job instance at 0x7fe919aba5f0>,9,17,[ 2 10],10,-1,27,-1,10
1,<environment.Job instance at 0x7fe919aba690>,11,18,[8 1],12,-1,30,-1,12
1,<environment.Job instance at 0x7fe919abaf00>,12,15,[3 9],13,-1,28,-1,13
1,<environment.Job instance at 0x7fe919abab40>,13,20,[8 4],14,-1,34,-1,14
1,<environment.Job instance at 0x7fe919abae60>,17,27,[8 5],18,-1,45,-1,18
1,<environment.Job instance at 0x7fe922d13410>,19,17,[1 5],20,-1,37,-1,20
1,<environment.Job instance at 0x7fe922d13780>,20,13,[3 8],21,-1,34,-1,21
1,<environment.Job instance at 0x7fe91a28ad20>,21,15,[2 7],22,-1,37,-1,22
1,<environment.Job instance at 0x7fe91a28ab40>,22,17,[3 5],23,-1,40,-1,23
1,<environment.Job instance at 0x7fe91a28aaf0>,25,13,[10  5],26,-1,39,-1,26
1,<environment.Job instance at 0x7fe91a28af50>,26,17,[7 3],27,-1,44,-1,27
1,<environment.Job instance at 0x7fe91a28a780>,30,13,[1 9],31,-1,44,-1,31
1,<environment.Job instance at 0x7fe91a28a460>,31,17,[9 4],32,-1,49,-1,32
1,<environment.Job instance at 0x7fe91a28af00>,32,24,[4 6],33,-1,57,-1,33
1,<environment.Job instance at 0x7fe91a28a370>,34,18,[5 2],35,-1,53,-1,35
1,<environment.Job instance at 0x7fe91a28ab90>,35,14,[10  1],36,-1,50,-1,36
1,<environment.Job instance at 0x7fe92294e910>,36,12,[9 5],37,-1,49,-1,37
1,<environment.Job instance at 0x7fe92294e820>,40,16,[5 4],41,-1,57,-1,41
1,<environment.Job instance at 0x7fe92294ed70>,41,18,[7 2],42,-1,60,-1,42
1,<environment.Job instance at 0x7fe92294eeb0>,43,13,[ 3 11],44,-1,57,-1,44
1,<environment.Job instance at 0x7fe92294e370>,44,12,[7 2],45,-1,57,-1,45
1,<environment.Job instance at 0x7fe92294ef00>,49,18,[ 5 10],50,-1,68,-1,50
1,<environment.Job instance at 0x7fe91a0cf0a0>,58,16,[6 5],59,-1,75,-1,59
1,<environment.Job instance at 0x7fe91a0cf820>,60,25,[10  4],61,-1,87,-1,62
1,<environment.Job instance at 0x7fe91a0cf190>,56,13,[8 4],57,-1,78,-1,65
1,<environment.Job instance at 0x7fe91a0cffa0>,65,17,[8 5],66,-1,83,-1,66
1,<environment.Job instance at 0x7fe91a0cf9b0>,66,14,[5 7],67,-1,81,-1,67
1,<environment.Job instance at 0x7fe91a0cf0f0>,64,13,[5 7],65,-1,83,-1,70
1,<environment.Job instance at 0x7fe9198fab90>,70,18,[6 4],71,-1,90,-1,72
1,<environment.Job instance at 0x7fe92294eaf0>,37,18,[14  1],38,-1,92,-1,74
1,<environment.Job instance at 0x7fe9198fa410>,72,15,[4 9],73,-1,91,-1,76
1,<environment.Job instance at 0x7fe91a0cfb40>,57,17,[6 2],58,-1,93,-1,76
1,<environment.Job instance at 0x7fe9198fa140>,73,18,[8 3],74,-1,94,-1,76
1,<environment.Job instance at 0x7fe9198fa7d0>,76,16,[7 5],77,-1,93,-1,77
1,<environment.Job instance at 0x7fe9198faf00>,78,13,[7 1],79,-1,93,-1,80
1,<environment.Job instance at 0x7fe9198fa5a0>,79,14,[5 3],80,-1,94,-1,80
1,<environment.Job instance at 0x7fe9198fa780>,82,18,[8 1],83,-1,103,-1,85
1,<environment.Job instance at 0x7fe91989c230>,86,20,[10  4],87,-1,107,-1,87
1,<environment.Job instance at 0x7fe91989c1e0>,88,17,[9 2],89,-1,107,-1,90
1,<environment.Job instance at 0x7fe92294ec80>,50,12,[ 3 12],51,-1,115,-1,103
1,<environment.Job instance at 0x7fe91989ce10>,95,18,[ 3 12],96,-1,121,-1,103
1,<environment.Job instance at 0x7fe91a0cf5f0>,5,15,[ 4 12],6,-1,21,-1,6
1,<environment.Job instance at 0x7fe919c33be0>,17,27,[8 5],18,-1,86,-1,59
1,<environment.Job instance at 0x7fe919be6230>,29,2,[ 2 12],30,-1,93,-1,91
1,<environment.Job instance at 0x7fe919c089b0>,32,24,[4 6],33,-1,131,-1,107
1,<environment.Job instance at 0x7fe919a325a0>,33,15,[ 2 13],34,-1,122,-1,107
1,<environment.Job instance at 0x7fe919a2d460>,37,18,[14  1],38,-1,126,-1,108
1,<environment.Job instance at 0x7fe919bf1730>,43,13,[ 3 11],44,-1,151,-1,138
1,<environment.Job instance at 0x7fe919c19960>,46,15,[11  2],47,-1,157,-1,142
1,<environment.Job instance at 0x7fe919c19780>,50,12,[ 3 12],51,-1,171,-1,159
1,<environment.Job instance at 0x7fe919a4a500>,60,25,[10  4],61,-1,251,-1,226
1,<environment.Job instance at 0x7fe9197148c0>,77,16,[13  1],78,-1,284,-1,268
1,<environment.Job instance at 0x7fe9198fa1e0>,81,2,[13  4],82,-1,292,-1,290
1,<environment.Job instance at 0x7fe918c2bc80>,90,27,[ 3 13],91,-1,345,-1,318
1,<environment.Job instance at 0x7fe919966be0>,93,27,[1 7],94,-1,359,-1,332
1,<environment.Job instance at 0x7fe919966eb0>,95,18,[ 3 12],96,-1,359,-1,341
1,<environment.Job instance at 0x7fe9198fc0f0>,2,17,[5 9],3,-1,20,-1,3
1,<environment.Job instance at 0x7fe9198fc0a0>,3,18,[5 5],4,-1,22,-1,4
1,<environment.Job instance at 0x7fe9198fc5f0>,5,17,[6 4],6,-1,23,-1,6
1,<environment.Job instance at 0x7fe9198fc550>,6,17,[1 6],7,-1,24,-1,7
1,<environment.Job instance at 0x7fe9198fcc80>,7,18,[5 5],8,-1,26,-1,8
1,<environment.Job instance at 0x7fe9198fc690>,8,18,[ 3 10],9,-1,27,-1,9
1,<environment.Job instance at 0x7fe9198fcf50>,10,27,[5 4],11,-1,38,-1,11
1,<environment.Job instance at 0x7fe919c33640>,11,28,[7 5],12,-1,40,-1,12
1,<environment.Job instance at 0x7fe91979ab90>,13,28,[8 2],14,-1,42,-1,14
1,<environment.Job instance at 0x7fe91979a730>,18,17,[5 3],19,-1,36,-1,19
1,<environment.Job instance at 0x7fe91979a640>,19,13,[7 1],20,-1,33,-1,20
1,<environment.Job instance at 0x7fe91979aaf0>,22,14,[3 8],23,-1,37,-1,23
1,<environment.Job instance at 0x7fe91979a370>,23,16,[7 2],24,-1,40,-1,24
1,<environment.Job instance at 0x7fe91979a190>,24,12,[9 3],25,-1,37,-1,25
1,<environment.Job instance at 0x7fe9198fc910>,17,3,[5 6],18,-1,30,-1,27
1,<environment.Job instance at 0x7fe919237460>,27,18,[2 6],28,-1,46,-1,28
1,<environment.Job instance at 0x7fe918fa62d0>,28,15,[3 9],29,-1,44,-1,29
1,<environment.Job instance at 0x7fe918fa6e10>,29,12,[10  4],30,-1,43,-1,31
1,<environment.Job instance at 0x7fe9192375a0>,30,13,[7 1],31,-1,44,-1,31
1,<environment.Job instance at 0x7fe918fa63c0>,34,15,[10  1],35,-1,50,-1,35
1,<environment.Job instance at 0x7fe918fa6fa0>,35,18,[7 4],36,-1,54,-1,36
1,<environment.Job instance at 0x7fe918fa65f0>,38,18,[ 2 10],39,-1,57,-1,39
1,<environment.Job instance at 0x7fe919b573c0>,39,13,[5 8],40,-1,53,-1,40
1,<environment.Job instance at 0x7fe919b57730>,42,14,[4 6],43,-1,57,-1,43
1,<environment.Job instance at 0x7fe919b57c30>,43,27,[5 1],44,-1,71,-1,44
1,<environment.Job instance at 0x7fe919b57820>,44,15,[5 5],45,-1,61,-1,46
1,<environment.Job instance at 0x7fe9199ffaa0>,50,13,[7 3],51,-1,64,-1,51
1,<environment.Job instance at 0x7fe9199ff500>,51,12,[3 8],52,-1,64,-1,52
1,<environment.Job instance at 0x7fe9199ff9b0>,53,18,[6 4],54,-1,72,-1,54
1,<environment.Job instance at 0x7fe9199ff8c0>,54,18,[9 1],55,-1,73,-1,55
1,<environment.Job instance at 0x7fe922f5d230>,56,14,[5 7],57,-1,71,-1,57
1,<environment.Job instance at 0x7fe922f5d460>,57,12,[3 8],58,-1,70,-1,58
1,<environment.Job instance at 0x7fe922f5d320>,58,16,[1 7],59,-1,75,-1,59
1,<environment.Job instance at 0x7fe922991eb0>,60,18,[2 9],61,-1,79,-1,61
1,<environment.Job instance at 0x7fe922991b90>,63,18,[5 3],64,-1,82,-1,64
1,<environment.Job instance at 0x7fe922991c30>,67,26,[3 7],68,-1,94,-1,68
1,<environment.Job instance at 0x7fe922991e60>,70,13,[1 6],71,-1,84,-1,71
1,<environment.Job instance at 0x7fe9198a7c30>,74,17,[5 1],75,-1,92,-1,75
1,<environment.Job instance at 0x7fe9198a7b40>,76,18,[5 4],77,-1,95,-1,77
1,<environment.Job instance at 0x7fe9198a7500>,78,12,[5 5],79,-1,91,-1,79
1,<environment.Job instance at 0x7fe9198a7d20>,79,25,[3 8],80,-1,105,-1,80
1,<environment.Job instance at 0x7fe9198a71e0>,80,17,[7 1],81,-1,98,-1,81
1,<environment.Job instance at 0x7fe9198a7050>,81,17,[7 4],82,-1,99,-1,82
1,<environment.Job instance at 0x7fe9198a73c0>,82,15,[3 6],83,-1,98,-1,83
1,<environment.Job instance at 0x7fe919937320>,85,18,[8 2],86,-1,104,-1,86
1,<environment.Job instance at 0x7fe91979a910>,0,1,[12  1],1,-1,2,-1,1
1,<environment.Job instance at 0x7fe91979af00>,1,25,[9 1],2,-1,27,-1,2
1,<environment.Job instance at 0x7fe922991a50>,10,27,[5 4],11,-1,49,-1,22
1,<environment.Job instance at 0x7fe9198a7d70>,11,28,[7 5],12,-1,63,-1,35
1,<environment.Job instance at 0x7fe9198a7af0>,13,28,[8 2],14,-1,63,-1,35
1,<environment.Job instance at 0x7fe919a3f9b0>,31,1,[ 5 14],32,-1,95,-1,94
1,<environment.Job instance at 0x7fe919a44050>,40,17,[ 5 13],41,-1,137,-1,120
1,<environment.Job instance at 0x7fe919bf9af0>,43,27,[5 1],44,-1,167,-1,140
1,<environment.Job instance at 0x7fe919c10b90>,46,2,[ 5 12],47,-1,143,-1,141
1,<environment.Job instance at 0x7fe919a32140>,55,17,[14  4],56,-1,187,-1,170
1,<environment.Job instance at 0x7fe919be15a0>,61,12,[13  5],62,-1,214,-1,202
1,<environment.Job instance at 0x7fe919be1f50>,67,26,[3 7],68,-1,264,-1,238
1,<environment.Job instance at 0x7fe919aba410>,77,1,[ 2 11],78,-1,254,-1,253
1,<environment.Job instance at 0x7fe91989c140>,79,25,[3 8],80,-1,280,-1,255
1,<environment.Job instance at 0x7fe92294ea50>,87,28,[4 9],88,-1,312,-1,284
1,<environment.Job instance at 0x7fe9195f1c30>,91,18,[13  5],92,-1,303,-1,285
1,<environment.Job instance at 0x7fe919d11c80>,95,14,[11  2],96,-1,317,-1,303
1,<environment.Job instance at 0x7fe91912a5a0>,98,1,[14  2],99,-1,307,-1,306
1,<environment.Job instance at 0x7fe9192b1230>,0,14,[10  4],1,-1,16,-1,2
1,<environment.Job instance at 0x7fe9192b1500>,1,15,[7 2],2,-1,17,-1,2
1,<environment.Job instance at 0x7fe919645d20>,8,16,[10  1],9,-1,26,-1,10
1,<environment.Job instance at 0x7fe9192b1a50>,9,18,[8 2],10,-1,28,-1,10
1,<environment.Job instance at 0x7fe919645dc0>,10,18,[2 8],11,-1,29,-1,11
1,<environment.Job instance at 0x7fe918c52910>,15,18,[9 1],16,-1,34,-1,16
1,<environment.Job instance at 0x7fe918c520f0>,17,12,[9 1],18,-1,33,-1,21
1,<environment.Job instance at 0x7fe918bcbc80>,21,2,[4 7],22,-1,24,-1,22
1,<environment.Job instance at 0x7fe918bcb4b0>,22,12,[5 5],23,-1,35,-1,23
1,<environment.Job instance at 0x7fe918bcbcd0>,23,1,[9 5],24,-1,25,-1,24
1,<environment.Job instance at 0x7fe918bcb5f0>,24,21,[8 1],25,-1,46,-1,25
1,<environment.Job instance at 0x7fe918bcba00>,25,13,[2 6],26,-1,39,-1,26
1,<environment.Job instance at 0x7fe918bcbe10>,26,2,[7 3],27,-1,29,-1,27
1,<environment.Job instance at 0x7fe918bcbc30>,27,1,[1 7],28,-1,29,-1,28
1,<environment.Job instance at 0x7fe918bcb230>,28,3,[1 5],29,-1,32,-1,29
1,<environment.Job instance at 0x7fe918c527d0>,20,15,[5 8],21,-1,44,-1,29
1,<environment.Job instance at 0x7fe918bcb780>,34,17,[5 4],35,-1,52,-1,35
1,<environment.Job instance at 0x7fe922e84550>,35,15,[9 4],36,-1,52,-1,37
1,<environment.Job instance at 0x7fe922e84c30>,37,23,[9 2],38,-1,61,-1,38
1,<environment.Job instance at 0x7fe922e848c0>,40,15,[4 8],41,-1,56,-1,41
1,<environment.Job instance at 0x7fe922e84e60>,43,17,[7 4],44,-1,61,-1,44
1,<environment.Job instance at 0x7fe922e84cd0>,45,15,[9 1],46,-1,61,-1,46
1,<environment.Job instance at 0x7fe91a2d05a0>,48,16,[6 5],49,-1,65,-1,49
1,<environment.Job instance at 0x7fe91a2d0e60>,50,15,[7 2],51,-1,66,-1,51
1,<environment.Job instance at 0x7fe918de25a0>,51,14,[1 5],52,-1,66,-1,52
1,<environment.Job instance at 0x7fe918de2af0>,52,18,[ 2 10],53,-1,71,-1,53
1,<environment.Job instance at 0x7fe918de2320>,53,14,[4 9],54,-1,68,-1,54
1,<environment.Job instance at 0x7fe918de22d0>,54,12,[9 4],55,-1,67,-1,55
1,<environment.Job instance at 0x7fe918de2550>,57,15,[1 6],58,-1,73,-1,58
1,<environment.Job instance at 0x7fe918de2370>,60,16,[3 7],61,-1,77,-1,61
1,<environment.Job instance at 0x7fe918de2d70>,61,18,[5 5],62,-1,80,-1,62
1,<environment.Job instance at 0x7fe91997fa50>,63,24,[4 7],64,-1,88,-1,64
1,<environment.Job instance at 0x7fe918de2280>,64,16,[4 7],65,-1,81,-1,65
1,<environment.Job instance at 0x7fe9196211e0>,75,13,[ 3 12],76,-1,92,-1,79
1,<environment.Job instance at 0x7fe919aafa00>,79,14,[5 4],80,-1,94,-1,80
1,<environment.Job instance at 0x7fe91954adc0>,80,15,[5 3],81,-1,96,-1,81
1,<environment.Job instance at 0x7fe91957be60>,82,15,[ 1 10],83,-1,98,-1,83
1,<environment.Job instance at 0x7fe91917e4b0>,83,24,[3 5],84,-1,108,-1,84
1,<environment.Job instance at 0x7fe918d5ac30>,88,17,[10  4],89,-1,108,-1,91
1,<environment.Job instance at 0x7fe918c278c0>,91,17,[4 7],92,-1,109,-1,92
1,<environment.Job instance at 0x7fe919e0eb40>,30,18,[ 2 11],31,-1,96,-1,78
1,<environment.Job instance at 0x7fe919e0ee10>,29,25,[ 3 10],30,-1,123,-1,98
1,<environment.Job instance at 0x7fe919fc37d0>,37,23,[9 2],38,-1,136,-1,113
1,<environment.Job instance at 0x7fe919fdc7d0>,56,17,[ 1 14],57,-1,186,-1,169
1,<environment.Job instance at 0x7fe919fedc80>,59,18,[14  4],60,-1,194,-1,176
1,<environment.Job instance at 0x7fe919667a00>,63,24,[4 7],64,-1,222,-1,198
1,<environment.Job instance at 0x7fe91965e5f0>,68,23,[ 4 10],69,-1,246,-1,223
1,<environment.Job instance at 0x7fe918cce320>,75,13,[ 3 12],76,-1,236,-1,223
1,<environment.Job instance at 0x7fe918cf9690>,76,13,[ 4 12],77,-1,236,-1,223
1,<environment.Job instance at 0x7fe91966fb40>,83,24,[3 5],84,-1,276,-1,252
1,<environment.Job instance at 0x7fe91944b370>,0,26,[4 8],1,-1,27,-1,1
1,<environment.Job instance at 0x7fe91944b280>,1,16,[2 7],2,-1,18,-1,2
1,<environment.Job instance at 0x7fe9194e4190>,7,13,[ 5 10],8,-1,21,-1,8
1,<environment.Job instance at 0x7fe9194e4f50>,8,13,[ 5 10],9,-1,22,-1,9
1,<environment.Job instance at 0x7fe9194e4140>,10,18,[8 5],11,-1,29,-1,11
1,<environment.Job instance at 0x7fe9194e4fa0>,12,18,[4 5],13,-1,31,-1,13
1,<environment.Job instance at 0x7fe9194e4280>,13,18,[8 1],14,-1,32,-1,14
1,<environment.Job instance at 0x7fe9194e49b0>,18,17,[10  4],19,-1,36,-1,19
1,<environment.Job instance at 0x7fe9194cc550>,19,15,[5 9],20,-1,35,-1,20
1,<environment.Job instance at 0x7fe9194ccf50>,22,16,[3 5],23,-1,39,-1,23
1,<environment.Job instance at 0x7fe9194ccbe0>,25,22,[1 9],26,-1,48,-1,26
1,<environment.Job instance at 0x7fe919504910>,29,18,[ 3 12],30,-1,48,-1,30
1,<environment.Job instance at 0x7fe919504870>,30,18,[7 3],31,-1,49,-1,31
1,<environment.Job instance at 0x7fe919504140>,33,17,[10  3],34,-1,51,-1,34
1,<environment.Job instance at 0x7fe919504a00>,36,12,[4 7],37,-1,50,-1,38
1,<environment.Job instance at 0x7fe9195048c0>,38,17,[3 8],39,-1,56,-1,39
1,<environment.Job instance at 0x7fe919504b40>,37,15,[6 4],38,-1,54,-1,39
1,<environment.Job instance at 0x7fe919504f00>,39,15,[ 5 10],40,-1,55,-1,40
1,<environment.Job instance at 0x7fe9194d3500>,40,19,[5 4],41,-1,61,-1,42
1,<environment.Job instance at 0x7fe9194d3410>,43,18,[9 2],44,-1,62,-1,44
1,<environment.Job instance at 0x7fe9194d3280>,44,24,[5 9],45,-1,69,-1,45
1,<environment.Job instance at 0x7fe9194d35a0>,41,17,[ 2 10],42,-1,62,-1,45
1,<environment.Job instance at 0x7fe9194d3230>,45,16,[10  3],46,-1,64,-1,48
1,<environment.Job instance at 0x7fe9194d3640>,47,26,[8 5],48,-1,74,-1,48
1,<environment.Job instance at 0x7fe9194d3690>,50,17,[10  1],51,-1,70,-1,53
1,<environment.Job instance at 0x7fe9194fd8c0>,53,26,[7 5],54,-1,80,-1,54
1,<environment.Job instance at 0x7fe9194fdaa0>,54,16,[3 9],55,-1,71,-1,55
1,<environment.Job instance at 0x7fe9194fd280>,57,18,[ 3 10],58,-1,76,-1,58
1,<environment.Job instance at 0x7fe9194fd910>,58,16,[3 5],59,-1,75,-1,59
1,<environment.Job instance at 0x7fe9194fd320>,59,16,[8 5],60,-1,76,-1,60
1,<environment.Job instance at 0x7fe9194fd0a0>,62,18,[4 7],63,-1,81,-1,63
1,<environment.Job instance at 0x7fe918cf8690>,65,17,[9 3],66,-1,87,-1,70
1,<environment.Job instance at 0x7fe918cf8230>,71,12,[10  4],72,-1,91,-1,79
1,<environment.Job instance at 0x7fe918db47d0>,81,15,[14  4],82,-1,97,-1,82
1,<environment.Job instance at 0x7fe918db4960>,82,13,[7 3],83,-1,96,-1,83
1,<environment.Job instance at 0x7fe918db4410>,78,16,[ 5 13],79,-1,113,-1,97
1,<environment.Job instance at 0x7fe918db4f50>,86,23,[10  4],87,-1,120,-1,97
1,<environment.Job instance at 0x7fe919e5ca50>,88,17,[4 9],89,-1,114,-1,97
1,<environment.Job instance at 0x7fe919e5cf50>,87,15,[5 5],88,-1,112,-1,97
1,<environment.Job instance at 0x7fe919e5ceb0>,89,18,[9 5],90,-1,121,-1,103
1,<environment.Job instance at 0x7fe918db45f0>,84,17,[5 9],85,-1,122,-1,105
1,<environment.Job instance at 0x7fe919e5c5a0>,91,17,[8 2],92,-1,124,-1,107
1,<environment.Job instance at 0x7fe919e5c690>,96,14,[4 7],97,-1,121,-1,107
1,<environment.Job instance at 0x7fe919e5c140>,97,18,[5 4],98,-1,125,-1,107
1,<environment.Job instance at 0x7fe9194e4a50>,0,26,[4 8],1,-1,27,-1,1
1,<environment.Job instance at 0x7fe918db4190>,15,15,[12  1],16,-1,52,-1,37
1,<environment.Job instance at 0x7fe918da5690>,23,1,[ 3 13],24,-1,74,-1,73
1,<environment.Job instance at 0x7fe922e847d0>,29,18,[ 3 12],30,-1,104,-1,86
1,<environment.Job instance at 0x7fe919e5cc30>,35,1,[ 5 13],36,-1,104,-1,103
1,<environment.Job instance at 0x7fe918ccc9b0>,44,24,[5 9],45,-1,176,-1,152
1,<environment.Job instance at 0x7fe918cccc80>,47,26,[8 5],48,-1,196,-1,170
1,<environment.Job instance at 0x7fe918ccc1e0>,53,26,[7 5],54,-1,215,-1,189
1,<environment.Job instance at 0x7fe918ccc5f0>,55,2,[13  2],56,-1,191,-1,189
1,<environment.Job instance at 0x7fe919595960>,63,3,[11  3],64,-1,226,-1,223
1,<environment.Job instance at 0x7fe9194ce320>,78,16,[ 5 13],79,-1,283,-1,267
1,<environment.Job instance at 0x7fe9194cefa0>,81,15,[14  4],82,-1,285,-1,270
1,<environment.Job instance at 0x7fe9194ce780>,86,23,[10  4],87,-1,315,-1,292
1,<environment.Job instance at 0x7fe918a5e2d0>,3,16,[3 9],4,-1,20,-1,4
1,<environment.Job instance at 0x7fe91984ad20>,4,13,[10  1],5,-1,19,-1,6
1,<environment.Job instance at 0x7fe91984a9b0>,6,14,[1 5],7,-1,21,-1,7
1,<environment.Job instance at 0x7fe91984aa50>,9,25,[8 3],10,-1,35,-1,10
1,<environment.Job instance at 0x7fe91984a050>,11,17,[3 7],12,-1,29,-1,12
1,<environment.Job instance at 0x7fe918a5ef00>,5,13,[ 3 10],6,-1,25,-1,12
1,<environment.Job instance at 0x7fe91984a140>,14,18,[8 2],15,-1,33,-1,15
1,<environment.Job instance at 0x7fe91984a0a0>,18,17,[3 5],19,-1,37,-1,20
1,<environment.Job instance at 0x7fe91984a780>,21,15,[10  5],22,-1,37,-1,22
1,<environment.Job instance at 0x7fe919a25c30>,22,18,[10  1],23,-1,41,-1,23
1,<environment.Job instance at 0x7fe91984afa0>,19,13,[4 7],20,-1,39,-1,26
1,<environment.Job instance at 0x7fe919a251e0>,31,18,[7 1],32,-1,52,-1,34
1,<environment.Job instance at 0x7fe922d26050>,38,12,[10  2],39,-1,51,-1,39
1,<environment.Job instance at 0x7fe918a6da00>,41,15,[9 5],42,-1,57,-1,42
1,<environment.Job instance at 0x7fe919a25780>,33,18,[ 3 10],34,-1,61,-1,43
1,<environment.Job instance at 0x7fe918a6deb0>,45,15,[10  1],46,-1,62,-1,47
1,<environment.Job instance at 0x7fe918a6da50>,46,21,[3 7],47,-1,68,-1,47
1,<environment.Job instance at 0x7fe918a6d7d0>,47,15,[ 3 10],48,-1,63,-1,48
1,<environment.Job instance at 0x7fe918a6d280>,49,20,[1 9],50,-1,70,-1,50
1,<environment.Job instance at 0x7fe918a6d410>,51,17,[5 6],52,-1,69,-1,52
1,<environment.Job instance at 0x7fe918a6d690>,52,16,[10  1],53,-1,70,-1,54
1,<environment.Job instance at 0x7fe918a6df50>,54,12,[4 9],55,-1,67,-1,55
1,<environment.Job instance at 0x7fe922cd4370>,56,13,[ 5 11],57,-1,70,-1,57
1,<environment.Job instance at 0x7fe922cd4960>,58,15,[10  2],59,-1,74,-1,59
1,<environment.Job instance at 0x7fe922cd45f0>,59,18,[3 8],60,-1,78,-1,60
1,<environment.Job instance at 0x7fe922d0f2d0>,61,18,[4 6],62,-1,80,-1,62
1,<environment.Job instance at 0x7fe922d0f460>,63,17,[6 1],64,-1,81,-1,64
1,<environment.Job instance at 0x7fe918dbefa0>,67,12,[ 3 10],68,-1,84,-1,72
1,<environment.Job instance at 0x7fe918a6df00>,53,17,[ 2 10],54,-1,89,-1,72
1,<environment.Job instance at 0x7fe918dbe3c0>,68,15,[8 2],69,-1,89,-1,74
1,<environment.Job instance at 0x7fe918dbe410>,72,27,[9 1],73,-1,101,-1,74
1,<environment.Job instance at 0x7fe918dbe5f0>,73,12,[5 9],74,-1,86,-1,74
1,<environment.Job instance at 0x7fe918dbef00>,71,13,[ 1 13],72,-1,88,-1,75
1,<environment.Job instance at 0x7fe919cad730>,76,21,[12  2],77,-1,98,-1,77
1,<environment.Job instance at 0x7fe918dbebe0>,74,16,[1 8],75,-1,96,-1,80
1,<environment.Job instance at 0x7fe919c210f0>,78,14,[ 1 14],79,-1,99,-1,85
1,<environment.Job instance at 0x7fe919c218c0>,79,20,[2 8],80,-1,105,-1,85
1,<environment.Job instance at 0x7fe919c216e0>,83,18,[8 1],84,-1,103,-1,85
1,<environment.Job instance at 0x7fe919c21910>,84,13,[10  5],85,-1,98,-1,85
1,<environment.Job instance at 0x7fe919c21f50>,81,19,[5 5],82,-1,104,-1,85
1,<environment.Job instance at 0x7fe919c21780>,85,12,[10  3],86,-1,103,-1,91
1,<environment.Job instance at 0x7fe91a30d870>,91,23,[5 9],92,-1,115,-1,92
1,<environment.Job instance at 0x7fe91a30d460>,89,12,[7 1],90,-1,106,-1,94
1,<environment.Job instance at 0x7fe91a30d820>,90,18,[5 7],91,-1,113,-1,95
1,<environment.Job instance at 0x7fe91a30da50>,93,14,[5 6],94,-1,109,-1,95
1,<environment.Job instance at 0x7fe91a30dd70>,94,15,[6 4],95,-1,112,-1,97
1,<environment.Job instance at 0x7fe922cd4320>,9,25,[8 3],10,-1,44,-1,19
1,<environment.Job instance at 0x7fe918a6d5f0>,12,24,[11  1],13,-1,45,-1,21
1,<environment.Job instance at 0x7fe919504eb0>,43,2,[12  1],44,-1,134,-1,132
1,<environment.Job instance at 0x7fe919504230>,44,1,[ 5 14],45,-1,133,-1,132
1,<environment.Job instance at 0x7fe918da5690>,48,28,[8 3],49,-1,175,-1,147
1,<environment.Job instance at 0x7fe918da5140>,56,13,[ 5 11],57,-1,192,-1,179
1,<environment.Job instance at 0x7fe918da5fa0>,57,2,[13  1],58,-1,181,-1,179
1,<environment.Job instance at 0x7fe919dc13c0>,64,1,[11  3],65,-1,216,-1,215
1,<environment.Job instance at 0x7fe91a044460>,71,13,[ 1 13],72,-1,264,-1,251
1,<environment.Job instance at 0x7fe919fae820>,72,27,[9 1],73,-1,280,-1,253
1,<environment.Job instance at 0x7fe922f4a3c0>,76,21,[12  2],77,-1,286,-1,265
1,<environment.Job instance at 0x7fe919baa690>,78,14,[ 1 14],79,-1,282,-1,268
1,<environment.Job instance at 0x7fe9196a7fa0>,80,15,[12  3],81,-1,284,-1,269
1,<environment.Job instance at 0x7fe919e25820>,86,2,[12  3],87,-1,282,-1,280
1,<environment.Job instance at 0x7fe93e7f6c30>,91,23,[5 9],92,-1,335,-1,312
1,<environment.Job instance at 0x7fe919c52820>,95,15,[ 4 12],96,-1,327,-1,312
1,<environment.Job instance at 0x7fe9194acc30>,1,26,[7 2],2,-1,28,-1,2
1,<environment.Job instance at 0x7fe919db76e0>,3,16,[ 3 10],4,-1,22,-1,6
1,<environment.Job instance at 0x7fe9194ac8c0>,4,14,[10  5],5,-1,20,-1,6
1,<environment.Job instance at 0x7fe919db7370>,9,14,[8 2],10,-1,26,-1,12
1,<environment.Job instance at 0x7fe919aba140>,12,13,[5 2],13,-1,26,-1,13
1,<environment.Job instance at 0x7fe919abab40>,13,12,[9 4],14,-1,26,-1,14
1,<environment.Job instance at 0x7fe919abae10>,14,18,[5 3],15,-1,33,-1,15
1,<environment.Job instance at 0x7fe919aba820>,11,17,[10  3],12,-1,32,-1,15
1,<environment.Job instance at 0x7fe919aba5f0>,19,19,[9 1],20,-1,44,-1,25
1,<environment.Job instance at 0x7fe918bec1e0>,26,17,[2 7],27,-1,44,-1,27
1,<environment.Job instance at 0x7fe918bec370>,29,1,[11  4],30,-1,31,-1,30
1,<environment.Job instance at 0x7fe918beca00>,24,23,[8 3],25,-1,53,-1,30
1,<environment.Job instance at 0x7fe918bec690>,31,15,[10  1],32,-1,49,-1,34
1,<environment.Job instance at 0x7fe918bec460>,33,27,[9 4],34,-1,61,-1,34
1,<environment.Job instance at 0x7fe919ed6af0>,40,12,[ 4 12],41,-1,63,-1,51
1,<environment.Job instance at 0x7fe919ed6910>,39,18,[5 1],40,-1,72,-1,54
1,<environment.Job instance at 0x7fe919ed6410>,42,17,[5 9],43,-1,71,-1,54
1,<environment.Job instance at 0x7fe91a289c80>,8,19,[ 5 11],9,-1,73,-1,54
1,<environment.Job instance at 0x7fe91a28b0a0>,49,16,[5 1],50,-1,70,-1,54
1,<environment.Job instance at 0x7fe919de0910>,51,12,[4 8],52,-1,66,-1,54
1,<environment.Job instance at 0x7fe919fc8d20>,47,17,[3 7],48,-1,71,-1,54
1,<environment.Job instance at 0x7fe919f5caa0>,55,22,[9 4],56,-1,78,-1,56
1,<environment.Job instance at 0x7fe9193e7cd0>,58,14,[3 7],59,-1,74,-1,60
1,<environment.Job instance at 0x7fe9197bf5f0>,60,13,[5 8],61,-1,74,-1,61
1,<environment.Job instance at 0x7fe919420910>,61,12,[10  5],62,-1,74,-1,62
1,<environment.Job instance at 0x7fe91979e6e0>,62,15,[ 5 10],63,-1,78,-1,63
1,<environment.Job instance at 0x7fe919d39140>,63,16,[5 8],64,-1,83,-1,67
1,<environment.Job instance at 0x7fe919d39aa0>,66,22,[3 8],67,-1,89,-1,67
1,<environment.Job instance at 0x7fe919eab050>,59,27,[5 8],60,-1,94,-1,67
1,<environment.Job instance at 0x7fe91a1e5cd0>,78,17,[3 7],79,-1,96,-1,79
1,<environment.Job instance at 0x7fe91a1e5eb0>,79,12,[ 5 10],80,-1,93,-1,81
1,<environment.Job instance at 0x7fe91a1e5690>,80,18,[9 4],81,-1,99,-1,81
1,<environment.Job instance at 0x7fe91a1e5e10>,81,12,[ 4 10],82,-1,97,-1,85
1,<environment.Job instance at 0x7fe91a1dae10>,86,13,[2 9],87,-1,100,-1,87
1,<environment.Job instance at 0x7fe91a1da280>,88,24,[8 2],89,-1,113,-1,89
1,<environment.Job instance at 0x7fe91a1da910>,90,18,[ 2 12],91,-1,114,-1,96
1,<environment.Job instance at 0x7fe91a1dac30>,92,18,[1 9],93,-1,119,-1,101
1,<environment.Job instance at 0x7fe91a1dae60>,94,17,[7 1],95,-1,118,-1,101
1,<environment.Job instance at 0x7fe918bec3c0>,1,26,[7 2],2,-1,28,-1,2
1,<environment.Job instance at 0x7fe918bec550>,2,2,[ 2 13],3,-1,5,-1,3
1,<environment.Job instance at 0x7fe91a1b6230>,6,12,[11  2],7,-1,19,-1,7
1,<environment.Job instance at 0x7fe919ed60f0>,7,1,[14  5],8,-1,9,-1,8
1,<environment.Job instance at 0x7fe91a1e5910>,8,19,[ 5 11],9,-1,28,-1,9
1,<environment.Job instance at 0x7fe9194aca00>,18,1,[ 4 13],19,-1,26,-1,25
1,<environment.Job instance at 0x7fe918ba9140>,22,2,[ 3 14],23,-1,34,-1,32
1,<environment.Job instance at 0x7fe9191eae60>,24,23,[8 3],25,-1,57,-1,34
1,<environment.Job instance at 0x7fe919f2b280>,29,1,[11  4],30,-1,36,-1,35
1,<environment.Job instance at 0x7fe9198b6eb0>,33,27,[9 4],34,-1,83,-1,56
1,<environment.Job instance at 0x7fe919eab410>,34,25,[8 2],35,-1,81,-1,56
1,<environment.Job instance at 0x7fe919f04050>,40,12,[ 4 12],41,-1,71,-1,59
1,<environment.Job instance at 0x7fe918ea2e10>,59,27,[5 8],60,-1,160,-1,133
1,<environment.Job instance at 0x7fe91910a410>,75,15,[13  3],76,-1,194,-1,179
1,<environment.Job instance at 0x7fe91911f870>,82,1,[14  1],83,-1,199,-1,198
1,<environment.Job instance at 0x7fe91911fa00>,84,17,[14  4],85,-1,231,-1,214
1,<environment.Job instance at 0x7fe919137cd0>,88,24,[8 2],89,-1,256,-1,232
1,<environment.Job instance at 0x7fe9191371e0>,89,27,[ 3 13],90,-1,259,-1,232
1,<environment.Job instance at 0x7fe919137410>,90,18,[ 2 12],91,-1,250,-1,232
1,<environment.Job instance at 0x7fe919120a00>,96,24,[13  3],97,-1,272,-1,248
1,<environment.Job instance at 0x7fe9191d68c0>,2,18,[4 9],3,-1,21,-1,3
1,<environment.Job instance at 0x7fe9191d6460>,4,15,[9 5],5,-1,20,-1,5
1,<environment.Job instance at 0x7fe9191d6640>,6,18,[8 5],7,-1,25,-1,7
1,<environment.Job instance at 0x7fe9191d6690>,10,15,[9 2],11,-1,27,-1,12
1,<environment.Job instance at 0x7fe9191d6730>,13,26,[7 3],14,-1,40,-1,14
1,<environment.Job instance at 0x7fe9191d62d0>,14,13,[1 9],15,-1,28,-1,15
1,<environment.Job instance at 0x7fe919ebca00>,15,12,[9 2],16,-1,28,-1,16
1,<environment.Job instance at 0x7fe919ebcd70>,16,17,[1 8],17,-1,34,-1,17
1,<environment.Job instance at 0x7fe919ebce10>,17,27,[1 8],18,-1,45,-1,18
1,<environment.Job instance at 0x7fe919863500>,11,12,[7 1],12,-1,31,-1,19
1,<environment.Job instance at 0x7fe9191d6d20>,19,13,[9 5],20,-1,34,-1,21
1,<environment.Job instance at 0x7fe919ebc2d0>,21,17,[3 7],22,-1,39,-1,22
1,<environment.Job instance at 0x7fe919ebcaf0>,22,14,[1 9],23,-1,37,-1,23
1,<environment.Job instance at 0x7fe919ebcb90>,23,14,[4 6],24,-1,38,-1,24
1,<environment.Job instance at 0x7fe919ebcc30>,24,15,[9 2],25,-1,40,-1,25
1,<environment.Job instance at 0x7fe919ebcc80>,26,12,[5 8],27,-1,39,-1,27
1,<environment.Job instance at 0x7fe919ebc550>,29,15,[4 6],30,-1,45,-1,30
1,<environment.Job instance at 0x7fe919ebc5a0>,30,26,[2 8],31,-1,57,-1,31
1,<environment.Job instance at 0x7fe9198aec30>,31,13,[5 2],32,-1,45,-1,32
1,<environment.Job instance at 0x7fe9198ae500>,32,14,[9 2],33,-1,47,-1,33
1,<environment.Job instance at 0x7fe9198ae460>,33,14,[9 2],34,-1,48,-1,34
1,<environment.Job instance at 0x7fe9198ae370>,35,16,[5 1],36,-1,52,-1,36
1,<environment.Job instance at 0x7fe919ebc140>,20,15,[2 8],21,-1,53,-1,38
1,<environment.Job instance at 0x7fe9198aee60>,40,20,[7 1],41,-1,62,-1,42
1,<environment.Job instance at 0x7fe9198ae410>,42,14,[7 1],43,-1,57,-1,43
1,<environment.Job instance at 0x7fe9198aedc0>,43,17,[3 7],44,-1,61,-1,44
1,<environment.Job instance at 0x7fe9198ae050>,41,14,[9 4],42,-1,58,-1,44
1,<environment.Job instance at 0x7fe918ddfc80>,51,16,[9 2],52,-1,69,-1,53
1,<environment.Job instance at 0x7fe918ddf3c0>,53,14,[ 4 10],54,-1,68,-1,54
1,<environment.Job instance at 0x7fe918ddfbe0>,55,13,[10  4],56,-1,69,-1,56
1,<environment.Job instance at 0x7fe918ddf280>,57,17,[9 1],58,-1,75,-1,58
1,<environment.Job instance at 0x7fe918ddf730>,62,13,[ 4 10],63,-1,76,-1,63
1,<environment.Job instance at 0x7fe918ddfaa0>,64,14,[ 1 11],65,-1,79,-1,65
1,<environment.Job instance at 0x7fe918bc1230>,65,24,[7 4],66,-1,90,-1,66
1,<environment.Job instance at 0x7fe918bc1a50>,66,14,[9 1],67,-1,81,-1,67
1,<environment.Job instance at 0x7fe918bc1410>,71,14,[ 2 10],72,-1,86,-1,72
1,<environment.Job instance at 0x7fe918bc1be0>,73,18,[8 3],74,-1,92,-1,74
1,<environment.Job instance at 0x7fe918bc1280>,74,12,[7 5],75,-1,87,-1,75
1,<environment.Job instance at 0x7fe918bc1e60>,75,25,[6 2],76,-1,101,-1,76
1,<environment.Job instance at 0x7fe919f04780>,79,18,[ 1 10],80,-1,98,-1,80
1,<environment.Job instance at 0x7fe919f04d70>,82,15,[4 5],83,-1,98,-1,83
1,<environment.Job instance at 0x7fe919f040f0>,85,18,[4 5],86,-1,104,-1,86
1,<environment.Job instance at 0x7fe9191d6780>,13,26,[7 3],14,-1,48,-1,22
1,<environment.Job instance at 0x7fe918de4640>,17,27,[1 8],18,-1,65,-1,38
1,<environment.Job instance at 0x7fe91a1da870>,30,26,[2 8],31,-1,134,-1,108
1,<environment.Job instance at 0x7fe919f00640>,39,17,[12  4],40,-1,153,-1,136
1,<environment.Job instance at 0x7fe918c2c370>,45,17,[ 1 11],46,-1,181,-1,164
1,<environment.Job instance at 0x7fe919f002d0>,47,13,[12  4],48,-1,177,-1,164
1,<environment.Job instance at 0x7fe918efd320>,60,24,[ 4 14],61,-1,244,-1,220
1,<environment.Job instance at 0x7fe919d211e0>,64,14,[ 1 11],65,-1,236,-1,222
1,<environment.Job instance at 0x7fe919d210f0>,65,24,[7 4],66,-1,262,-1,238
1,<environment.Job instance at 0x7fe9197b9780>,75,25,[6 2],76,-1,298,-1,273
1,<environment.Job instance at 0x7fe918bcf5a0>,76,2,[ 1 13],77,-1,275,-1,273
1,<environment.Job instance at 0x7fe919a63af0>,86,26,[10  2],87,-1,337,-1,311
1,<environment.Job instance at 0x7fe919d53280>,94,1,[12  5],95,-1,341,-1,340
1,<environment.Job instance at 0x7fe91940a3c0>,95,1,[ 2 14],96,-1,341,-1,340
1,<environment.Job instance at 0x7fe919d2b640>,97,2,[14  3],98,-1,344,-1,342
1,<environment.Job instance at 0x7fe9195e2cd0>,1,18,[5 5],2,-1,20,-1,2
1,<environment.Job instance at 0x7fe91a21baf0>,4,18,[9 2],5,-1,24,-1,6
1,<environment.Job instance at 0x7fe91a21beb0>,5,18,[10  4],6,-1,24,-1,6
1,<environment.Job instance at 0x7fe91a21b140>,6,17,[3 5],7,-1,24,-1,7
1,<environment.Job instance at 0x7fe91a21b730>,7,15,[5 9],8,-1,23,-1,8
1,<environment.Job instance at 0x7fe91a21bc30>,10,15,[10  5],11,-1,27,-1,12
1,<environment.Job instance at 0x7fe91a21b9b0>,11,17,[8 2],12,-1,29,-1,12
1,<environment.Job instance at 0x7fe91a21b410>,14,18,[8 4],15,-1,34,-1,16
1,<environment.Job instance at 0x7fe91a21b3c0>,17,17,[2 7],18,-1,37,-1,20
1,<environment.Job instance at 0x7fe91a21bd70>,21,13,[ 5 10],22,-1,35,-1,22
1,<environment.Job instance at 0x7fe91a2242d0>,24,18,[3 9],25,-1,53,-1,35
1,<environment.Job instance at 0x7fe91a223370>,40,17,[11  3],41,-1,67,-1,50
1,<environment.Job instance at 0x7fe91a224aa0>,37,18,[7 5],38,-1,71,-1,53
1,<environment.Job instance at 0x7fe91a224550>,31,17,[10  2],32,-1,73,-1,56
1,<environment.Job instance at 0x7fe91a223280>,41,17,[5 3],42,-1,73,-1,56
1,<environment.Job instance at 0x7fe91a2236e0>,46,14,[8 4],47,-1,70,-1,56
1,<environment.Job instance at 0x7fe91a21b910>,16,15,[ 2 12],17,-1,71,-1,56
1,<environment.Job instance at 0x7fe91a223140>,39,16,[6 3],40,-1,72,-1,56
1,<environment.Job instance at 0x7fe91a223460>,42,16,[6 5],43,-1,72,-1,56
1,<environment.Job instance at 0x7fe91a223aa0>,51,16,[3 9],52,-1,72,-1,56
1,<environment.Job instance at 0x7fe91a223960>,50,3,[1 5],51,-1,59,-1,56
1,<environment.Job instance at 0x7fe91a223b90>,53,3,[ 3 10],54,-1,59,-1,56
1,<environment.Job instance at 0x7fe91a2231e0>,54,16,[7 2],55,-1,72,-1,56
1,<environment.Job instance at 0x7fe91a223c30>,55,14,[6 4],56,-1,70,-1,56
1,<environment.Job instance at 0x7fe91a20b1e0>,57,24,[8 1],58,-1,83,-1,59
1,<environment.Job instance at 0x7fe91a20b4b0>,60,16,[8 2],61,-1,77,-1,61
1,<environment.Job instance at 0x7fe91a20f870>,61,28,[5 9],62,-1,90,-1,62
1,<environment.Job instance at 0x7fe91a20f410>,62,14,[7 1],63,-1,87,-1,73
1,<environment.Job instance at 0x7fe918c3f410>,67,16,[10  4],68,-1,89,-1,73
1,<environment.Job instance at 0x7fe918c3fbe0>,68,23,[ 3 10],69,-1,96,-1,73
1,<environment.Job instance at 0x7fe918c17be0>,69,17,[4 5],70,-1,90,-1,73
1,<environment.Job instance at 0x7fe91a2240f0>,23,15,[ 5 12],24,-1,88,-1,73
1,<environment.Job instance at 0x7fe91976a370>,77,19,[6 3],78,-1,108,-1,89
1,<environment.Job instance at 0x7fe918c1b690>,73,18,[ 5 11],74,-1,110,-1,92
1,<environment.Job instance at 0x7fe919775fa0>,80,18,[7 1],81,-1,110,-1,92
1,<environment.Job instance at 0x7fe9197756e0>,82,18,[6 5],83,-1,111,-1,93
1,<environment.Job instance at 0x7fe91a1dcf00>,86,22,[3 7],87,-1,117,-1,95
1,<environment.Job instance at 0x7fe91a1dce10>,87,21,[5 3],88,-1,116,-1,95
1,<environment.Job instance at 0x7fe918c3f4b0>,66,18,[9 2],67,-1,113,-1,95
1,<environment.Job instance at 0x7fe918c37c80>,91,14,[9 4],92,-1,109,-1,95
1,<environment.Job instance at 0x7fe918c10b40>,8,28,[ 2 11],9,-1,46,-1,18
1,<environment.Job instance at 0x7fe91a1c20a0>,16,15,[ 2 12],17,-1,53,-1,38
1,<environment.Job instance at 0x7fe919d2bd70>,20,12,[ 1 11],21,-1,64,-1,52
1,<environment.Job instance at 0x7fe919d535a0>,23,15,[ 5 12],24,-1,84,-1,69
1,<environment.Job instance at 0x7fe9197b9050>,40,17,[11  3],41,-1,148,-1,131
1,<environment.Job instance at 0x7fe919d2c910>,57,24,[8 1],58,-1,229,-1,205
1,<environment.Job instance at 0x7fe9197bfcd0>,61,28,[5 9],62,-1,238,-1,210
1,<environment.Job instance at 0x7fe918f4a6e0>,63,28,[6 1],64,-1,252,-1,224
1,<environment.Job instance at 0x7fe9193d1140>,68,23,[ 3 10],69,-1,262,-1,239
1,<environment.Job instance at 0x7fe919f00500>,73,18,[ 5 11],74,-1,275,-1,257
1,<environment.Job instance at 0x7fe91a1dae60>,83,1,[13  4],84,-1,292,-1,291
1,<environment.Job instance at 0x7fe91a1da500>,84,17,[12  2],85,-1,308,-1,291
1,<environment.Job instance at 0x7fe9191d6320>,96,28,[7 3],97,-1,358,-1,330
1,<environment.Job instance at 0x7fe91a1ef780>,0,15,[4 9],1,-1,16,-1,1
1,<environment.Job instance at 0x7fe919dce550>,7,16,[2 6],8,-1,25,-1,9
1,<environment.Job instance at 0x7fe91940a3c0>,8,17,[7 4],9,-1,27,-1,10
1,<environment.Job instance at 0x7fe919dce870>,12,20,[1 9],13,-1,33,-1,13
1,<environment.Job instance at 0x7fe9193aa500>,13,18,[3 7],14,-1,32,-1,14
1,<environment.Job instance at 0x7fe9193aaa00>,16,18,[3 6],17,-1,35,-1,17
1,<environment.Job instance at 0x7fe9193aa820>,24,18,[2 9],25,-1,43,-1,25
1,<environment.Job instance at 0x7fe9193aaf00>,25,26,[5 5],26,-1,52,-1,26
1,<environment.Job instance at 0x7fe9193aadc0>,27,15,[8 4],28,-1,43,-1,28
1,<environment.Job instance at 0x7fe918f9a5f0>,28,22,[10  5],29,-1,52,-1,30
1,<environment.Job instance at 0x7fe918f9a960>,30,17,[2 7],31,-1,48,-1,31
1,<environment.Job instance at 0x7fe918f9af50>,33,12,[10  3],34,-1,50,-1,38
1,<environment.Job instance at 0x7fe919e08780>,44,17,[6 3],45,-1,63,-1,46
1,<environment.Job instance at 0x7fe919e08e10>,46,15,[7 3],47,-1,62,-1,47
1,<environment.Job instance at 0x7fe919e084b0>,47,15,[5 4],48,-1,63,-1,48
1,<environment.Job instance at 0x7fe9196a8a50>,50,26,[10  1],51,-1,78,-1,52
1,<environment.Job instance at 0x7fe919e08230>,40,25,[9 5],41,-1,77,-1,52
1,<environment.Job instance at 0x7fe9196a8500>,51,16,[ 2 10],52,-1,68,-1,52
1,<environment.Job instance at 0x7fe9196a8dc0>,52,22,[2 7],53,-1,75,-1,53
1,<environment.Job instance at 0x7fe919e08140>,45,22,[6 4],46,-1,77,-1,55
1,<environment.Job instance at 0x7fe918f9aaf0>,34,25,[9 4],35,-1,82,-1,57
1,<environment.Job instance at 0x7fe9196a8c30>,55,16,[10  3],56,-1,73,-1,57
1,<environment.Job instance at 0x7fe9196a8af0>,54,12,[1 9],55,-1,69,-1,57
1,<environment.Job instance at 0x7fe9196a8910>,59,17,[1 9],60,-1,77,-1,60
1,<environment.Job instance at 0x7fe9196a87d0>,60,15,[9 4],61,-1,76,-1,61
1,<environment.Job instance at 0x7fe9196a82d0>,56,18,[8 3],57,-1,81,-1,63
1,<environment.Job instance at 0x7fe9196a83c0>,61,14,[8 1],62,-1,77,-1,63
1,<environment.Job instance at 0x7fe9196a8960>,62,17,[9 5],63,-1,80,-1,63
1,<environment.Job instance at 0x7fe9196a8140>,64,18,[6 4],65,-1,84,-1,66
1,<environment.Job instance at 0x7fe9196a8aa0>,65,27,[5 8],66,-1,94,-1,67
1,<environment.Job instance at 0x7fe919aaf230>,66,16,[6 4],67,-1,84,-1,68
1,<environment.Job instance at 0x7fe919aaf0f0>,73,18,[10  5],74,-1,92,-1,74
1,<environment.Job instance at 0x7fe919aaffa0>,75,12,[9 4],76,-1,88,-1,76
1,<environment.Job instance at 0x7fe919aaf550>,67,25,[6 4],68,-1,105,-1,80
1,<environment.Job instance at 0x7fe919d11280>,81,21,[4 7],82,-1,107,-1,86
1,<environment.Job instance at 0x7fe919d11370>,85,17,[4 6],86,-1,108,-1,91
1,<environment.Job instance at 0x7fe91965e7d0>,95,17,[2 7],96,-1,114,-1,97
1,<environment.Job instance at 0x7fe91965ea00>,90,18,[7 3],91,-1,116,-1,98
1,<environment.Job instance at 0x7fe91965e0f0>,96,17,[5 2],97,-1,117,-1,100
1,<environment.Job instance at 0x7fe91965eaa0>,91,26,[5 4],92,-1,126,-1,100
1,<environment.Job instance at 0x7fe919aaf3c0>,69,25,[10  1],70,-1,125,-1,100
1,<environment.Job instance at 0x7fe9193aaaf0>,5,16,[ 4 14],6,-1,22,-1,6
1,<environment.Job instance at 0x7fe919d116e0>,17,26,[ 2 12],18,-1,64,-1,38
1,<environment.Job instance at 0x7fe919dcef00>,19,1,[ 3 12],20,-1,42,-1,41
1,<environment.Job instance at 0x7fe919dceeb0>,22,3,[11  1],23,-1,45,-1,42
1,<environment.Job instance at 0x7fe918bc1f50>,25,26,[5 5],26,-1,82,-1,56
1,<environment.Job instance at 0x7fe919336230>,34,25,[9 4],35,-1,105,-1,80
1,<environment.Job instance at 0x7fe91953ce10>,41,3,[11  1],42,-1,97,-1,94
1,<environment.Job instance at 0x7fe919d30960>,42,3,[12  5],43,-1,97,-1,94
1,<environment.Job instance at 0x7fe919413050>,40,25,[9 5],41,-1,121,-1,96
1,<environment.Job instance at 0x7fe919d21d20>,50,26,[10  1],51,-1,157,-1,131
1,<environment.Job instance at 0x7fe91a1c20a0>,65,27,[5 8],66,-1,218,-1,191
1,<environment.Job instance at 0x7fe91a1ce5a0>,67,25,[6 4],68,-1,232,-1,207
1,<environment.Job instance at 0x7fe918c10b40>,69,25,[10  1],70,-1,234,-1,209
1,<environment.Job instance at 0x7fe918c37870>,70,14,[ 1 14],71,-1,223,-1,209
1,<environment.Job instance at 0x7fe9194afa50>,91,26,[5 4],92,-1,305,-1,279
1,<environment.Job instance at 0x7fe919de41e0>,98,26,[ 3 10],99,-1,353,-1,327
1,<environment.Job instance at 0x7fe918c49f00>,0,22,[ 3 10],1,-1,24,-1,2
1,<environment.Job instance at 0x7fe919285af0>,7,15,[6 1],8,-1,23,-1,8
1,<environment.Job instance at 0x7fe918f164b0>,11,16,[5 4],12,-1,28,-1,12
1,<environment.Job instance at 0x7fe918f16820>,12,18,[2 9],13,-1,31,-1,13
1,<environment.Job instance at 0x7fe918f16690>,13,14,[3 7],14,-1,28,-1,14
1,<environment.Job instance at 0x7fe918e47280>,19,13,[3 8],20,-1,33,-1,20
1,<environment.Job instance at 0x7fe918e5b870>,23,18,[5 5],24,-1,42,-1,24
1,<environment.Job instance at 0x7fe918e5ba50>,24,16,[10  2],25,-1,42,-1,26
1,<environment.Job instance at 0x7fe918e5b730>,26,16,[5 6],27,-1,43,-1,27
1,<environment.Job instance at 0x7fe918a205a0>,32,15,[5 5],33,-1,48,-1,33
1,<environment.Job instance at 0x7fe918a200f0>,33,12,[9 5],34,-1,46,-1,34
1,<environment.Job instance at 0x7fe918a20460>,34,18,[ 3 10],35,-1,53,-1,35
1,<environment.Job instance at 0x7fe918a20730>,35,14,[5 8],36,-1,50,-1,36
1,<environment.Job instance at 0x7fe918a20410>,36,14,[5 5],37,-1,51,-1,37
1,<environment.Job instance at 0x7fe91918c500>,37,17,[3 7],38,-1,55,-1,38
1,<environment.Job instance at 0x7fe91918c460>,38,16,[7 5],39,-1,55,-1,39
1,<environment.Job instance at 0x7fe91918ca50>,39,20,[5 5],40,-1,60,-1,40
1,<environment.Job instance at 0x7fe91918a5a0>,46,18,[1 8],47,-1,65,-1,47
1,<environment.Job instance at 0x7fe919ae2410>,51,14,[10  5],52,-1,66,-1,52
1,<environment.Job instance at 0x7fe91a24b280>,53,13,[7 4],54,-1,67,-1,54
1,<environment.Job instance at 0x7fe919ea2190>,55,15,[7 2],56,-1,71,-1,56
1,<environment.Job instance at 0x7fe9196920a0>,57,28,[8 2],58,-1,86,-1,58
1,<environment.Job instance at 0x7fe919692be0>,58,15,[8 5],59,-1,74,-1,59
1,<environment.Job instance at 0x7fe919bc7af0>,78,18,[8 4],79,-1,104,-1,86
1,<environment.Job instance at 0x7fe9197ca190>,17,3,[ 5 11],18,-1,45,-1,42
1,<environment.Job instance at 0x7fe918acdcd0>,21,18,[ 3 14],22,-1,67,-1,49
1,<environment.Job instance at 0x7fe918c10b40>,28,13,[14  3],29,-1,92,-1,79
1,<environment.Job instance at 0x7fe9193aaa50>,47,2,[13  4],48,-1,156,-1,154
1,<environment.Job instance at 0x7fe9198c91e0>,56,13,[13  5],57,-1,199,-1,186
1,<environment.Job instance at 0x7fe918f547d0>,60,17,[14  5],61,-1,218,-1,201
1,<environment.Job instance at 0x7fe918f54640>,61,14,[13  2],62,-1,215,-1,201
1,<environment.Job instance at 0x7fe918f54190>,57,28,[8 2],58,-1,230,-1,202
1,<environment.Job instance at 0x7fe918f8e3c0>,72,27,[8 4],73,-1,254,-1,227
1,<environment.Job instance at 0x7fe9193ffbe0>,82,1,[ 1 13],83,-1,249,-1,248
1,<environment.Job instance at 0x7fe919175190>,85,17,[11  2],86,-1,280,-1,263
1,<environment.Job instance at 0x7fe919175410>,89,21,[14  3],90,-1,287,-1,266
1,<environment.Job instance at 0x7fe9193ff1e0>,83,25,[ 4 10],84,-1,307,-1,282
1,<environment.Job instance at 0x7fe9199e1e60>,5,16,[5 5],6,-1,22,-1,6
1,<environment.Job instance at 0x7fe9192fe2d0>,6,20,[5 3],7,-1,27,-1,7
1,<environment.Job instance at 0x7fe9192fef50>,8,12,[9 1],9,-1,23,-1,11
1,<environment.Job instance at 0x7fe91941fe10>,10,21,[5 4],11,-1,32,-1,11
1,<environment.Job instance at 0x7fe91941f370>,12,18,[9 2],13,-1,31,-1,13
1,<environment.Job instance at 0x7fe922cd8b90>,16,16,[5 8],17,-1,33,-1,17
1,<environment.Job instance at 0x7fe919ed12d0>,20,17,[10  5],21,-1,38,-1,21
1,<environment.Job instance at 0x7fe922f55550>,23,14,[8 3],24,-1,38,-1,24
1,<environment.Job instance at 0x7fe91a3f63c0>,24,13,[10  2],25,-1,38,-1,25
1,<environment.Job instance at 0x7fe91a3f62d0>,25,17,[9 4],26,-1,43,-1,26
1,<environment.Job instance at 0x7fe918c29fa0>,26,16,[10  4],27,-1,43,-1,27
1,<environment.Job instance at 0x7fe919aba5a0>,28,14,[10  3],29,-1,43,-1,29
1,<environment.Job instance at 0x7fe919aba460>,30,12,[1 9],31,-1,43,-1,31
1,<environment.Job instance at 0x7fe91a295f00>,32,18,[3 6],33,-1,51,-1,33
1,<environment.Job instance at 0x7fe91a295c80>,33,16,[5 8],34,-1,50,-1,34
1,<environment.Job instance at 0x7fe918c0a730>,38,18,[2 8],39,-1,57,-1,39
1,<environment.Job instance at 0x7fe918d7c780>,41,18,[8 4],42,-1,62,-1,44
1,<environment.Job instance at 0x7fe918d7ce60>,40,15,[5 9],41,-1,59,-1,44
1,<environment.Job instance at 0x7fe918d82e10>,44,12,[13  3],45,-1,57,-1,45
1,<environment.Job instance at 0x7fe918c45230>,42,17,[5 3],43,-1,63,-1,46
1,<environment.Job instance at 0x7fe918d78640>,46,16,[7 4],47,-1,66,-1,50
1,<environment.Job instance at 0x7fe918d782d0>,49,14,[ 5 10],50,-1,64,-1,50
1,<environment.Job instance at 0x7fe918d78be0>,50,16,[7 5],51,-1,72,-1,56
1,<environment.Job instance at 0x7fe918d77870>,56,15,[6 4],57,-1,72,-1,57
1,<environment.Job instance at 0x7fe918d788c0>,55,28,[5 5],56,-1,86,-1,58
1,<environment.Job instance at 0x7fe918d77e60>,63,16,[10  5],64,-1,80,-1,64
1,<environment.Job instance at 0x7fe918d77be0>,61,21,[4 8],62,-1,91,-1,70
1,<environment.Job instance at 0x7fe918d49140>,66,17,[7 1],67,-1,87,-1,70
1,<environment.Job instance at 0x7fe918d495f0>,70,21,[6 2],71,-1,92,-1,71
1,<environment.Job instance at 0x7fe918d498c0>,73,13,[10  4],74,-1,87,-1,74
1,<environment.Job instance at 0x7fe918d49e10>,77,12,[8 1],78,-1,90,-1,78
1,<environment.Job instance at 0x7fe918d49dc0>,78,22,[4 8],79,-1,101,-1,79
1,<environment.Job instance at 0x7fe918d49f50>,80,28,[4 7],81,-1,109,-1,81
1,<environment.Job instance at 0x7fe9190890a0>,79,16,[ 4 11],80,-1,98,-1,82
1,<environment.Job instance at 0x7fe9190892d0>,83,14,[ 3 11],84,-1,99,-1,85
1,<environment.Job instance at 0x7fe919089190>,81,15,[ 5 14],82,-1,101,-1,86
1,<environment.Job instance at 0x7fe9190894b0>,84,14,[ 1 10],85,-1,103,-1,89
1,<environment.Job instance at 0x7fe919089910>,89,12,[7 5],90,-1,102,-1,90
1,<environment.Job instance at 0x7fe9190897d0>,88,2,[6 5],89,-1,94,-1,92
1,<environment.Job instance at 0x7fe919089960>,92,16,[10  5],93,-1,109,-1,93
1,<environment.Job instance at 0x7fe919089c80>,95,15,[10  3],96,-1,111,-1,96
1,<environment.Job instance at 0x7fe9190898c0>,91,15,[4 5],92,-1,113,-1,98
1,<environment.Job instance at 0x7fe919089f50>,97,17,[ 4 14],98,-1,115,-1,98
1,<environment.Job instance at 0x7fe9190b7050>,98,18,[2 9],99,-1,119,-1,101
1,<environment.Job instance at 0x7fe9192fe0a0>,7,1,[ 2 11],8,-1,9,-1,8
1,<environment.Job instance at 0x7fe918d780f0>,14,17,[11  1],15,-1,37,-1,20
1,<environment.Job instance at 0x7fe919175d20>,27,3,[ 5 11],28,-1,79,-1,76
1,<environment.Job instance at 0x7fe918f8e6e0>,44,12,[13  3],45,-1,175,-1,163
1,<environment.Job instance at 0x7fe918f54500>,55,28,[5 5],56,-1,232,-1,204
1,<environment.Job instance at 0x7fe9198c95f0>,60,12,[ 4 14],61,-1,230,-1,218
1,<environment.Job instance at 0x7fe918f9a6e0>,68,1,[ 1 11],69,-1,249,-1,248
1,<environment.Job instance at 0x7fe919d2fc80>,79,16,[ 4 11],80,-1,293,-1,277
1,<environment.Job instance at 0x7fe918c10b40>,80,28,[4 7],81,-1,305,-1,277
1,<environment.Job instance at 0x7fe918b63f50>,81,15,[ 5 14],82,-1,292,-1,277
1,<environment.Job instance at 0x7fe91a1c20a0>,83,14,[ 3 11],84,-1,291,-1,277
1,<environment.Job instance at 0x7fe9197ca5a0>,97,17,[ 4 14],98,-1,338,-1,321
1,<environment.Job instance at 0x7fb2ed898af0>,2,14,[ 2 10],3,-1,18,-1,4
1,<environment.Job instance at 0x7fb2f6e888c0>,3,22,[2 5],4,-1,26,-1,4
1,<environment.Job instance at 0x7fb2ed89b190>,12,23,[6 4],13,-1,44,-1,21
1,<environment.Job instance at 0x7fb2ed898eb0>,8,17,[1 8],9,-1,38,-1,21
1,<environment.Job instance at 0x7fb2ed89b2d0>,14,21,[8 1],15,-1,42,-1,21
1,<environment.Job instance at 0x7fb2ed89b410>,16,18,[7 3],17,-1,40,-1,22
1,<environment.Job instance at 0x7fb2ed89b050>,10,22,[8 1],11,-1,44,-1,22
1,<environment.Job instance at 0x7fb2ed89b5f0>,19,25,[5 9],20,-1,47,-1,22
1,<environment.Job instance at 0x7fb2ed89b550>,18,26,[7 4],19,-1,48,-1,22
1,<environment.Job instance at 0x7fb2ed898fa0>,9,12,[8 2],10,-1,34,-1,22
1,<environment.Job instance at 0x7fb2ed89b820>,22,12,[3 8],23,-1,35,-1,23
1,<environment.Job instance at 0x7fb2ed89b230>,13,18,[5 9],14,-1,42,-1,24
1,<environment.Job instance at 0x7fb2ed89b4b0>,17,12,[5 1],18,-1,36,-1,24
1,<environment.Job instance at 0x7fb2ed89bd20>,26,12,[8 5],27,-1,39,-1,27
1,<environment.Job instance at 0x7fb2ed89ba00>,23,16,[6 2],24,-1,43,-1,27
1,<environment.Job instance at 0x7fb2ed89bd70>,27,17,[4 6],28,-1,45,-1,28
1,<environment.Job instance at 0x7fb2ed89f1e0>,32,21,[5 9],33,-1,54,-1,33
1,<environment.Job instance at 0x7fb2ed89f140>,33,26,[3 6],34,-1,60,-1,34
1,<environment.Job instance at 0x7fb2ed89f2d0>,34,14,[1 9],35,-1,49,-1,35
1,<environment.Job instance at 0x7fb2ed89f460>,35,16,[1 9],36,-1,52,-1,36
1,<environment.Job instance at 0x7fb2ed89f5a0>,37,14,[5 8],38,-1,52,-1,38
1,<environment.Job instance at 0x7fb2ed89be60>,30,26,[9 4],31,-1,64,-1,38
1,<environment.Job instance at 0x7fb2ed89f820>,40,26,[ 1 10],41,-1,67,-1,41
1,<environment.Job instance at 0x7fb2ed89fb90>,43,12,[4 5],44,-1,58,-1,46
1,<environment.Job instance at 0x7fb2ed8a00f0>,49,17,[10  2],50,-1,69,-1,52
1,<environment.Job instance at 0x7fb2ed8a0af0>,57,16,[ 2 11],58,-1,74,-1,58
1,<environment.Job instance at 0x7fb2ed8a0780>,54,18,[7 1],55,-1,78,-1,60
1,<environment.Job instance at 0x7fb2ed8a01e0>,48,12,[9 2],49,-1,72,-1,60
1,<environment.Job instance at 0x7fb2ed8a0c80>,59,19,[1 7],60,-1,79,-1,60
1,<environment.Job instance at 0x7fb2ed8a0c30>,58,17,[3 7],59,-1,81,-1,64
1,<environment.Job instance at 0x7fb2ed8a42d0>,67,16,[1 9],68,-1,84,-1,68
1,<environment.Job instance at 0x7fb2ed8a46e0>,68,14,[6 4],69,-1,84,-1,70
1,<environment.Job instance at 0x7fb2ed8a49b0>,72,18,[3 5],73,-1,92,-1,74
1,<environment.Job instance at 0x7fb2ed89b730>,21,18,[9 4],22,-1,95,-1,77
1,<environment.Job instance at 0x7fb2ed8a4e60>,76,13,[10  1],77,-1,91,-1,78
1,<environment.Job instance at 0x7fb2ed8a60a0>,79,19,[10  3],80,-1,99,-1,80
1,<environment.Job instance at 0x7fb2ed8a6190>,81,14,[8 5],82,-1,96,-1,82
1,<environment.Job instance at 0x7fb2ed8a6320>,82,21,[4 8],83,-1,105,-1,84
1,<environment.Job instance at 0x7fb2ed8a6410>,83,18,[ 3 10],84,-1,102,-1,84
1,<environment.Job instance at 0x7fb2ed8a6960>,87,18,[7 1],88,-1,106,-1,88
1,<environment.Job instance at 0x7fb2ed8a65a0>,85,15,[1 7],86,-1,104,-1,89
1,<environment.Job instance at 0x7fb2ed8a6af0>,88,16,[4 9],89,-1,107,-1,91
1,<environment.Job instance at 0x7fb2ed8a6aa0>,91,18,[5 4],92,-1,111,-1,93
1,<environment.Job instance at 0x7fb2ed8a6be0>,93,25,[ 1 10],94,-1,119,-1,94
1,<environment.Job instance at 0x7fb2ed88fcd0>,96,18,[2 6],97,-1,115,-1,97
1,<environment.Job instance at 0x7fb2ed88f550>,101,15,[2 7],102,-1,117,-1,102
1,<environment.Job instance at 0x7fb2eda3f0a0>,103,16,[1 9],104,-1,120,-1,104
1,<environment.Job instance at 0x7fb2ed88faa0>,102,13,[9 4],103,-1,119,-1,106
1,<environment.Job instance at 0x7fb2ed9be410>,105,16,[7 5],106,-1,122,-1,106
1,<environment.Job instance at 0x7fb2ed8a4e10>,12,23,[6 4],13,-1,53,-1,30
1,<environment.Job instance at 0x7fb2ed9bfaf0>,18,26,[7 4],19,-1,70,-1,44
1,<environment.Job instance at 0x7fb2ed88f6e0>,19,25,[5 9],20,-1,83,-1,58
1,<environment.Job instance at 0x7fb2eda250f0>,28,17,[ 1 13],29,-1,87,-1,70
1,<environment.Job instance at 0x7fb2ed94a460>,30,26,[9 4],31,-1,110,-1,84
1,<environment.Job instance at 0x7fb2ed9b1960>,31,1,[ 2 14],32,-1,85,-1,84
1,<environment.Job instance at 0x7fb2ed94a870>,33,26,[3 6],34,-1,110,-1,84
1,<environment.Job instance at 0x7fb2ed8c02d0>,40,26,[ 1 10],41,-1,139,-1,113
1,<environment.Job instance at 0x7fb2ed9a35a0>,57,16,[ 2 11],58,-1,183,-1,167
1,<environment.Job instance at 0x7fb2ed8d1c30>,89,17,[ 5 14],90,-1,289,-1,272
1,<environment.Job instance at 0x7fb2ed8d3370>,93,25,[ 1 10],94,-1,320,-1,295
1,<environment.Job instance at 0x7fb2ecfe60f0>,0,23,[5 1],1,-1,24,-1,1
1,<environment.Job instance at 0x7fb2ecfe5370>,8,16,[5 2],9,-1,25,-1,9
1,<environment.Job instance at 0x7fb2ecfe52d0>,9,28,[7 5],10,-1,38,-1,10
1,<environment.Job instance at 0x7fb2ecfe3320>,12,18,[7 5],13,-1,31,-1,13
1,<environment.Job instance at 0x7fb2ecfdacd0>,20,17,[9 5],21,-1,38,-1,21
1,<environment.Job instance at 0x7fb2ecfdac30>,21,13,[3 8],22,-1,35,-1,22
1,<environment.Job instance at 0x7fb2ecfda410>,22,18,[10  4],23,-1,41,-1,23
1,<environment.Job instance at 0x7fb2ecfda7d0>,25,15,[8 3],26,-1,41,-1,26
1,<environment.Job instance at 0x7fb2ecfdff50>,27,28,[ 2 10],28,-1,56,-1,28
1,<environment.Job instance at 0x7fb2ed20f190>,31,14,[ 3 10],32,-1,46,-1,32
1,<environment.Job instance at 0x7fb2ece656e0>,36,13,[10  5],37,-1,50,-1,37
1,<environment.Job instance at 0x7fb2ece535f0>,39,17,[5 7],40,-1,57,-1,40
1,<environment.Job instance at 0x7fb2ecf1baf0>,41,22,[5 6],42,-1,64,-1,42
1,<environment.Job instance at 0x7fb2ecfe3b90>,19,13,[5 5],20,-1,56,-1,43
1,<environment.Job instance at 0x7fb2eceac140>,45,17,[10  4],46,-1,64,-1,47
1,<environment.Job instance at 0x7fb2ecf8af00>,47,21,[10  4],48,-1,69,-1,48
1,<environment.Job instance at 0x7fb2ecfc1140>,50,24,[1 5],51,-1,75,-1,51
1,<environment.Job instance at 0x7fb2ecf8acd0>,52,20,[10  5],53,-1,73,-1,53
1,<environment.Job instance at 0x7fb2ecfe61e0>,54,14,[10  5],55,-1,69,-1,55
1,<environment.Job instance at 0x7fb2ececf640>,59,14,[ 5 10],60,-1,74,-1,60
1,<environment.Job instance at 0x7fb2ece33b90>,60,17,[4 7],61,-1,78,-1,61
1,<environment.Job instance at 0x7fb2ece33230>,63,24,[3 7],64,-1,88,-1,64
1,<environment.Job instance at 0x7fb2ece33eb0>,64,19,[3 8],65,-1,84,-1,65
1,<environment.Job instance at 0x7fb2ece335f0>,65,17,[5 1],66,-1,83,-1,66
1,<environment.Job instance at 0x7fb2ece33690>,67,16,[8 4],68,-1,84,-1,68
1,<environment.Job instance at 0x7fb2ecfe0f50>,70,17,[3 5],71,-1,88,-1,71
1,<environment.Job instance at 0x7fb2ecfe05f0>,71,18,[6 2],72,-1,91,-1,73
1,<environment.Job instance at 0x7fb2ece32730>,74,19,[6 2],75,-1,94,-1,75
1,<environment.Job instance at 0x7fb2ece32140>,76,17,[9 1],77,-1,95,-1,78
1,<environment.Job instance at 0x7fb2ece41c80>,80,17,[9 5],81,-1,98,-1,81
1,<environment.Job instance at 0x7fb2ece47cd0>,84,26,[3 9],85,-1,182,-1,156
1,<environment.Job instance at 0x7fb2ece47230>,85,15,[5 3],86,-1,171,-1,156
1,<environment.Job instance at 0x7fb2eceacf50>,0,23,[5 1],1,-1,24,-1,1
1,<environment.Job instance at 0x7fb2ece32370>,7,3,[ 3 13],8,-1,11,-1,8
1,<environment.Job instance at 0x7fb2eceb3140>,10,19,[ 5 12],11,-1,34,-1,15
1,<environment.Job instance at 0x7fb2ece2eb90>,9,28,[7 5],10,-1,47,-1,19
1,<environment.Job instance at 0x7fb2ed03a870>,27,28,[ 2 10],28,-1,86,-1,58
1,<environment.Job instance at 0x7fb2ed040050>,32,15,[ 2 13],33,-1,76,-1,61
1,<environment.Job instance at 0x7fb2ed13dc30>,34,20,[13  4],35,-1,82,-1,62
1,<environment.Job instance at 0x7fb2ed04f460>,43,1,[12  5],44,-1,98,-1,97
1,<environment.Job instance at 0x7fb2ed05b3c0>,50,24,[1 5],51,-1,140,-1,116
1,<environment.Job instance at 0x7fb2ed0625a0>,56,13,[ 5 14],57,-1,133,-1,120
1,<environment.Job instance at 0x7fb2ed0a0b90>,63,24,[3 7],64,-1,178,-1,154
1,<environment.Job instance at 0x7fb2ed1b7a00>,78,27,[ 3 12],79,-1,227,-1,200
1,<environment.Job instance at 0x7fb2ed0951e0>,82,15,[ 2 14],83,-1,230,-1,215
1,<environment.Job instance at 0x7fb2ed0e6870>,84,26,[3 9],85,-1,253,-1,227
1,<environment.Job instance at 0x7fb2ecfef460>,90,23,[4 7],91,-1,265,-1,242
1,<environment.Job instance at 0x7fb2ed00b6e0>,100,1,[14  4],101,-1,284,-1,283
1,<environment.Job instance at 0x7fb2ed010140>,107,18,[ 1 14],108,-1,333,-1,315
1,<environment.Job instance at 0x7fb2ed010190>,108,23,[1 9],109,-1,354,-1,331
1,<environment.Job instance at 0x7fb2ece47a00>,2,15,[8 2],3,-1,19,-1,4
1,<environment.Job instance at 0x7fb2ece474b0>,4,15,[8 5],5,-1,20,-1,5
1,<environment.Job instance at 0x7fb2ecfe6140>,3,18,[5 1],4,-1,23,-1,5
1,<environment.Job instance at 0x7fb2ece47a50>,8,19,[4 7],9,-1,28,-1,9
1,<environment.Job instance at 0x7fb2ece47f00>,13,22,[9 1],14,-1,38,-1,16
1,<environment.Job instance at 0x7fb2ecf21e10>,20,13,[5 9],21,-1,34,-1,21
1,<environment.Job instance at 0x7fb2ecf21780>,22,12,[ 5 10],23,-1,35,-1,23
1,<environment.Job instance at 0x7fb2ecf21370>,23,13,[9 2],24,-1,37,-1,24
1,<environment.Job instance at 0x7fb2ecf212d0>,24,13,[4 5],25,-1,38,-1,25
1,<environment.Job instance at 0x7fb2ecf21f00>,25,27,[6 1],26,-1,53,-1,26
1,<environment.Job instance at 0x7fb2ecf21c30>,27,14,[10  3],28,-1,42,-1,28
1,<environment.Job instance at 0x7fb2ecfa36e0>,31,16,[5 8],32,-1,48,-1,32
1,<environment.Job instance at 0x7fb2ecfa35f0>,32,23,[1 8],33,-1,56,-1,33
1,<environment.Job instance at 0x7fb2ecfa3820>,37,14,[10  5],38,-1,52,-1,38
1,<environment.Job instance at 0x7fb2ecfa3910>,41,17,[10  2],42,-1,59,-1,42
1,<environment.Job instance at 0x7fb2ecfa38c0>,43,26,[5 3],44,-1,70,-1,44
1,<environment.Job instance at 0x7fb2f6f19050>,45,18,[ 1 10],46,-1,64,-1,46
1,<environment.Job instance at 0x7fb2eceac320>,48,17,[1 5],49,-1,66,-1,49
1,<environment.Job instance at 0x7fb2eceac640>,49,18,[5 2],50,-1,68,-1,50
1,<environment.Job instance at 0x7fb2eceac370>,50,18,[5 8],51,-1,69,-1,51
1,<environment.Job instance at 0x7fb2eceac6e0>,52,18,[3 8],53,-1,71,-1,53
1,<environment.Job instance at 0x7fb2eceaccd0>,56,17,[8 4],57,-1,74,-1,57
1,<environment.Job instance at 0x7fb2eceacb40>,57,15,[3 6],58,-1,73,-1,58
1,<environment.Job instance at 0x7fb2eceac9b0>,58,20,[5 2],59,-1,79,-1,59
1,<environment.Job instance at 0x7fb2eceaca00>,59,26,[2 8],60,-1,86,-1,60
1,<environment.Job instance at 0x7fb2ece3afa0>,60,15,[5 8],61,-1,76,-1,61
1,<environment.Job instance at 0x7fb2ece3a2d0>,61,20,[ 4 10],62,-1,82,-1,62
1,<environment.Job instance at 0x7fb2ece3a910>,62,15,[9 2],63,-1,78,-1,63
1,<environment.Job instance at 0x7fb2ece3a5f0>,64,16,[7 5],65,-1,81,-1,65
1,<environment.Job instance at 0x7fb2ece3adc0>,67,27,[9 5],68,-1,95,-1,68
1,<environment.Job instance at 0x7fb2ece3ad20>,73,15,[7 2],74,-1,89,-1,74
1,<environment.Job instance at 0x7fb2eceb8f50>,76,13,[8 2],77,-1,90,-1,77
1,<environment.Job instance at 0x7fb2eceb8f00>,79,15,[6 5],80,-1,95,-1,80
1,<environment.Job instance at 0x7fb2eceb8fa0>,81,17,[ 5 14],82,-1,110,-1,93
1,<environment.Job instance at 0x7fb2eceb8e60>,89,12,[6 3],90,-1,108,-1,96
1,<environment.Job instance at 0x7fb2f7001a50>,91,3,[9 4],92,-1,99,-1,96
1,<environment.Job instance at 0x7fb2f7001fa0>,92,2,[6 5],93,-1,98,-1,96
1,<environment.Job instance at 0x7fb2eceb89b0>,84,17,[13  5],85,-1,113,-1,96
1,<environment.Job instance at 0x7fb2f7001730>,93,16,[4 5],94,-1,117,-1,101
1,<environment.Job instance at 0x7fb2f6edcb40>,15,18,[5 4],16,-1,120,-1,102
1,<environment.Job instance at 0x7fb2f70018c0>,95,16,[7 5],96,-1,118,-1,102
1,<environment.Job instance at 0x7fb2f7001e10>,94,15,[2 6],95,-1,117,-1,102
1,<environment.Job instance at 0x7fb2f7001910>,98,14,[9 4],99,-1,116,-1,102
1,<environment.Job instance at 0x7fb2ece3ae60>,69,14,[12  2],70,-1,122,-1,108
1,<environment.Job instance at 0x7fb2f7001dc0>,99,18,[5 6],100,-1,127,-1,109
1,<environment.Job instance at 0x7fb2ece46050>,103,16,[ 4 10],104,-1,125,-1,109
1,<environment.Job instance at 0x7fb2ece46190>,105,27,[4 5],106,-1,136,-1,109
1,<environment.Job instance at 0x7fb2f7001960>,100,16,[8 3],101,-1,125,-1,109
1,<environment.Job instance at 0x7fb2eceac2d0>,5,17,[12  1],6,-1,23,-1,6
1,<environment.Job instance at 0x7fb2ece3a690>,10,16,[14  3],11,-1,35,-1,19
1,<environment.Job instance at 0x7fb2ee182870>,17,2,[ 1 12],18,-1,25,-1,23
1,<environment.Job instance at 0x7fb2f6a1ca50>,25,27,[6 1],26,-1,88,-1,61
1,<environment.Job instance at 0x7fb2ed340cd0>,32,23,[1 8],33,-1,101,-1,78
1,<environment.Job instance at 0x7fb2ecfe75a0>,43,26,[5 3],44,-1,123,-1,97
1,<environment.Job instance at 0x7fb2ed0af870>,59,26,[2 8],60,-1,191,-1,165
1,<environment.Job instance at 0x7fb2ed1a6c30>,67,27,[9 5],68,-1,225,-1,198
1,<environment.Job instance at 0x7fb2ed1a6dc0>,69,14,[12  2],70,-1,212,-1,198
1,<environment.Job instance at 0x7fb2ed2defa0>,81,17,[ 5 14],82,-1,249,-1,232
1,<environment.Job instance at 0x7fb2ed2dec30>,82,25,[ 3 11],83,-1,257,-1,232
1,<environment.Job instance at 0x7fb2ed2deb40>,84,17,[13  5],85,-1,250,-1,233
1,<environment.Job instance at 0x7fb2ed2de8c0>,85,13,[ 5 14],86,-1,246,-1,233
1,<environment.Job instance at 0x7fb2ed2d6dc0>,105,27,[4 5],106,-1,346,-1,319
1,<environment.Job instance at 0x7fb2ed07baa0>,107,12,[13  4],108,-1,331,-1,319
1,<environment.Job instance at 0x7fb2ed07b1e0>,108,12,[ 5 12],109,-1,331,-1,319
1,<environment.Job instance at 0x7fb2edd01cd0>,2,20,[4 9],3,-1,24,-1,4
1,<environment.Job instance at 0x7fb2edd019b0>,9,15,[ 2 10],10,-1,25,-1,10
1,<environment.Job instance at 0x7fb2edde7cd0>,12,17,[5 9],13,-1,30,-1,13
1,<environment.Job instance at 0x7fb2edde76e0>,13,17,[7 1],14,-1,32,-1,15
1,<environment.Job instance at 0x7fb2edde7c30>,15,3,[5 2],16,-1,19,-1,16
1,<environment.Job instance at 0x7fb2edde7820>,16,13,[2 5],17,-1,30,-1,17
1,<environment.Job instance at 0x7fb2ed91d4b0>,26,25,[2 8],27,-1,52,-1,27
1,<environment.Job instance at 0x7fb2ed91d5f0>,27,14,[3 6],28,-1,42,-1,28
1,<environment.Job instance at 0x7fb2ed91daa0>,30,26,[8 3],31,-1,57,-1,31
1,<environment.Job instance at 0x7fb2edd24460>,35,13,[9 1],36,-1,49,-1,36
1,<environment.Job instance at 0x7fb2edd24140>,36,18,[8 3],37,-1,55,-1,37
1,<environment.Job instance at 0x7fb2edd24c80>,38,16,[5 2],39,-1,55,-1,39
1,<environment.Job instance at 0x7fb2edd24eb0>,41,18,[5 8],42,-1,60,-1,42
1,<environment.Job instance at 0x7fb2edd24e60>,42,14,[2 8],43,-1,57,-1,43
1,<environment.Job instance at 0x7fb2edd24320>,45,15,[1 5],46,-1,61,-1,46
1,<environment.Job instance at 0x7fb2edc55a00>,47,13,[ 5 10],48,-1,61,-1,48
1,<environment.Job instance at 0x7fb2edc556e0>,49,18,[5 2],50,-1,68,-1,50
1,<environment.Job instance at 0x7fb2edc55870>,50,16,[ 4 10],51,-1,67,-1,51
1,<environment.Job instance at 0x7fb2edc55320>,51,15,[5 7],52,-1,67,-1,52
1,<environment.Job instance at 0x7fb2edc55a50>,52,17,[8 2],53,-1,70,-1,53
1,<environment.Job instance at 0x7fb2edc55960>,56,17,[7 4],57,-1,74,-1,57
1,<environment.Job instance at 0x7fb2edc557d0>,59,18,[10  4],60,-1,78,-1,60
1,<environment.Job instance at 0x7fb2edc55190>,60,15,[1 9],61,-1,76,-1,61
1,<environment.Job instance at 0x7fb2edc55af0>,61,13,[1 7],62,-1,75,-1,62
1,<environment.Job instance at 0x7fb2edc550f0>,63,14,[5 6],64,-1,78,-1,64
1,<environment.Job instance at 0x7fb2edce0410>,64,18,[10  5],65,-1,83,-1,65
1,<environment.Job instance at 0x7fb2edce00f0>,66,16,[2 9],67,-1,83,-1,67
1,<environment.Job instance at 0x7fb2edce0af0>,68,15,[10  4],69,-1,84,-1,69
1,<environment.Job instance at 0x7fb2edce0690>,70,16,[8 5],71,-1,87,-1,71
1,<environment.Job instance at 0x7fb2edce0fa0>,71,16,[4 5],72,-1,88,-1,72
1,<environment.Job instance at 0x7fb2edce0e60>,72,27,[8 3],73,-1,100,-1,73
1,<environment.Job instance at 0x7fb2edce04b0>,73,18,[1 6],74,-1,92,-1,74
1,<environment.Job instance at 0x7fb2edce06e0>,74,17,[2 6],75,-1,92,-1,75
1,<environment.Job instance at 0x7fb2edce07d0>,76,27,[2 6],77,-1,104,-1,77
1,<environment.Job instance at 0x7fb2edce0a00>,77,16,[7 4],78,-1,94,-1,78
1,<environment.Job instance at 0x7fb2edce0a50>,78,16,[9 2],79,-1,95,-1,79
1,<environment.Job instance at 0x7fb2edd3f370>,81,16,[4 5],82,-1,98,-1,82
1,<environment.Job instance at 0x7fb2edd3f0a0>,92,16,[6 4],93,-1,109,-1,93
1,<environment.Job instance at 0x7fb2edf77230>,94,14,[3 6],95,-1,109,-1,95
1,<environment.Job instance at 0x7fb2ed98fd20>,96,21,[ 4 10],97,-1,118,-1,97
1,<environment.Job instance at 0x7fb2edd2ac30>,97,23,[2 8],98,-1,121,-1,98
1,<environment.Job instance at 0x7fb2edd01280>,17,13,[12  1],18,-1,34,-1,21
1,<environment.Job instance at 0x7fb2ed32d370>,18,12,[14  3],19,-1,33,-1,21
1,<environment.Job instance at 0x7fb2ed1d6fa0>,19,1,[ 4 11],20,-1,22,-1,21
1,<environment.Job instance at 0x7fb2ed2defa0>,26,25,[2 8],27,-1,74,-1,49
1,<environment.Job instance at 0x7fb2ed1b4460>,30,26,[8 3],31,-1,78,-1,52
1,<environment.Job instance at 0x7fb2ed225f00>,44,2,[11  3],45,-1,98,-1,96
1,<environment.Job instance at 0x7fb2f6d80550>,55,17,[12  4],56,-1,168,-1,151
1,<environment.Job instance at 0x7fb2ecfc2230>,67,2,[ 3 11],68,-1,205,-1,203
1,<environment.Job instance at 0x7fb2ed92a4b0>,72,27,[8 3],73,-1,263,-1,236
1,<environment.Job instance at 0x7fb2ee38c780>,76,27,[2 6],77,-1,280,-1,253
1,<environment.Job instance at 0x7fb2ed9317d0>,80,14,[ 4 14],81,-1,283,-1,269
1,<environment.Job instance at 0x7fb2ed99a280>,97,23,[2 8],98,-1,342,-1,319
1,<environment.Job instance at 0x7fb2ed98adc0>,98,3,[11  1],99,-1,322,-1,319
1,<environment.Job instance at 0x7fb2ed98a500>,99,19,[13  3],100,-1,338,-1,319
1,<environment.Job instance at 0x7fb2ed98aeb0>,104,13,[ 4 11],105,-1,344,-1,331
1,<environment.Job instance at 0x7fb2ed9dc2d0>,0,25,[6 4],1,-1,26,-1,1
1,<environment.Job instance at 0x7fb2edcaa910>,4,24,[5 5],5,-1,29,-1,5
1,<environment.Job instance at 0x7fb2edcacaf0>,8,28,[ 5 10],9,-1,37,-1,9
1,<environment.Job instance at 0x7fb2edcac730>,9,15,[9 5],10,-1,26,-1,11
1,<environment.Job instance at 0x7fb2edcacb90>,11,17,[7 5],12,-1,29,-1,12
1,<environment.Job instance at 0x7fb2edcaceb0>,12,1,[4 8],13,-1,14,-1,13
1,<environment.Job instance at 0x7fb2edcaccd0>,14,1,[ 3 10],15,-1,16,-1,15
1,<environment.Job instance at 0x7fb2edcac500>,15,14,[3 8],16,-1,30,-1,16
1,<environment.Job instance at 0x7fb2edcb51e0>,18,15,[2 9],19,-1,34,-1,19
1,<environment.Job instance at 0x7fb2ed1f8050>,23,15,[6 4],24,-1,39,-1,24
1,<environment.Job instance at 0x7fb2edca3960>,25,13,[6 3],26,-1,39,-1,26
1,<environment.Job instance at 0x7fb2edcf4cd0>,26,12,[10  2],27,-1,39,-1,27
1,<environment.Job instance at 0x7fb2edcee5a0>,28,13,[8 3],29,-1,42,-1,29
1,<environment.Job instance at 0x7fb2ed2e25f0>,32,14,[5 3],33,-1,47,-1,33
1,<environment.Job instance at 0x7fb2ed2e2960>,33,12,[2 7],34,-1,46,-1,34
1,<environment.Job instance at 0x7fb2ed653fa0>,34,22,[7 3],35,-1,57,-1,35
1,<environment.Job instance at 0x7fb2ee3d2c80>,35,20,[7 5],36,-1,56,-1,36
1,<environment.Job instance at 0x7fb2ed2b8b40>,40,13,[5 5],41,-1,54,-1,41
1,<environment.Job instance at 0x7fb2ed59caa0>,41,15,[7 1],42,-1,57,-1,42
1,<environment.Job instance at 0x7fb2ed2d1e10>,45,12,[4 5],46,-1,58,-1,46
1,<environment.Job instance at 0x7fb2ee3cb190>,47,18,[8 2],48,-1,66,-1,48
1,<environment.Job instance at 0x7fb2ed2c0370>,50,15,[2 5],51,-1,66,-1,51
1,<environment.Job instance at 0x7fb2ed2c0460>,52,17,[4 5],53,-1,70,-1,53
1,<environment.Job instance at 0x7fb2ed2c0910>,53,14,[9 3],54,-1,68,-1,54
1,<environment.Job instance at 0x7fb2ed2c0870>,55,17,[8 2],56,-1,73,-1,56
1,<environment.Job instance at 0x7fb2ed2c0e10>,56,16,[1 9],57,-1,73,-1,57
1,<environment.Job instance at 0x7fb2ed2c0cd0>,57,16,[7 2],58,-1,74,-1,58
1,<environment.Job instance at 0x7fb2ed56d870>,62,16,[10  4],63,-1,79,-1,63
1,<environment.Job instance at 0x7fb2ed56dbe0>,63,16,[6 5],64,-1,80,-1,64
1,<environment.Job instance at 0x7fb2ed56db90>,64,16,[9 5],65,-1,81,-1,65
1,<environment.Job instance at 0x7fb2ed56de60>,66,22,[1 8],67,-1,89,-1,67
1,<environment.Job instance at 0x7fb2ed56df00>,67,28,[5 9],68,-1,96,-1,68
1,<environment.Job instance at 0x7fb2ed591140>,69,18,[5 8],70,-1,88,-1,70
1,<environment.Job instance at 0x7fb2ed591280>,70,18,[ 2 10],71,-1,89,-1,71
1,<environment.Job instance at 0x7fb2ed5911e0>,71,15,[8 1],72,-1,87,-1,72
1,<environment.Job instance at 0x7fb2ed5913c0>,72,13,[1 5],73,-1,86,-1,73
1,<environment.Job instance at 0x7fb2ed591500>,74,16,[6 1],75,-1,91,-1,75
1,<environment.Job instance at 0x7fb2ed5915a0>,76,18,[ 5 10],77,-1,95,-1,77
1,<environment.Job instance at 0x7fb2ed591d70>,82,26,[5 8],83,-1,151,-1,125
1,<environment.Job instance at 0x7fb2ed5801e0>,90,14,[7 2],91,-1,144,-1,130
1,<environment.Job instance at 0x7fb2ed580460>,94,12,[3 9],95,-1,143,-1,131
1,<environment.Job instance at 0x7fb2ed580870>,99,18,[3 8],100,-1,149,-1,131
1,<environment.Job instance at 0x7fb2ed580a00>,102,21,[5 7],103,-1,170,-1,149
1,<environment.Job instance at 0x7fb2ed5806e0>,97,28,[ 5 10],98,-1,177,-1,149
1,<environment.Job instance at 0x7fb2ed580be0>,105,16,[4 7],106,-1,165,-1,149
1,<environment.Job instance at 0x7fb2edcaac30>,0,25,[6 4],1,-1,26,-1,1
1,<environment.Job instance at 0x7fb2edcac190>,2,3,[14  5],3,-1,6,-1,3
1,<environment.Job instance at 0x7fb2ee3a4370>,4,24,[5 5],5,-1,29,-1,5
1,<environment.Job instance at 0x7fb2ee3cbf00>,8,28,[ 5 10],9,-1,45,-1,17
1,<environment.Job instance at 0x7fb2ed591b40>,16,12,[ 5 12],17,-1,32,-1,20
1,<environment.Job instance at 0x7fb2ed98a320>,19,2,[ 5 14],20,-1,25,-1,23
1,<environment.Job instance at 0x7fb2ee41f730>,31,16,[ 1 14],32,-1,91,-1,75
1,<environment.Job instance at 0x7fb2f6a574b0>,44,17,[14  5],45,-1,119,-1,102
1,<environment.Job instance at 0x7fb2ed9e1500>,51,2,[14  5],52,-1,114,-1,112
1,<environment.Job instance at 0x7fb2edd24550>,67,28,[5 9],68,-1,215,-1,187
1,<environment.Job instance at 0x7fb2edd3a3c0>,77,28,[9 1],78,-1,270,-1,242
1,<environment.Job instance at 0x7fb2ed233f00>,82,26,[5 8],83,-1,285,-1,259
1,<environment.Job instance at 0x7fb2ed1b45a0>,86,2,[ 5 13],87,-1,264,-1,262
1,<environment.Job instance at 0x7fb2ed0fc8c0>,91,1,[13  4],92,-1,273,-1,272
1,<environment.Job instance at 0x7fb2edd010f0>,98,2,[12  3],99,-1,296,-1,294
1,<environment.Job instance at 0x7fb2edd013c0>,97,28,[ 5 10],98,-1,368,-1,340
1,<environment.Job instance at 0x7fb2edcef7d0>,3,17,[4 7],4,-1,21,-1,4
1,<environment.Job instance at 0x7fb2edcef2d0>,4,16,[ 5 10],5,-1,21,-1,5
1,<environment.Job instance at 0x7fb2edcef460>,5,15,[5 9],6,-1,21,-1,6
1,<environment.Job instance at 0x7fb2edcef140>,10,26,[3 7],11,-1,37,-1,11
1,<environment.Job instance at 0x7fb2ed6615a0>,15,18,[4 9],16,-1,34,-1,16
1,<environment.Job instance at 0x7fb2ed6611e0>,17,18,[10  5],18,-1,37,-1,19
1,<environment.Job instance at 0x7fb2ed661320>,20,13,[10  1],21,-1,34,-1,21
1,<environment.Job instance at 0x7fb2ed661d70>,22,24,[1 9],23,-1,47,-1,23
1,<environment.Job instance at 0x7fb2ee3cbb90>,26,12,[10  1],27,-1,43,-1,31
1,<environment.Job instance at 0x7fb2ee3cbaf0>,31,27,[7 1],32,-1,59,-1,32
1,<environment.Job instance at 0x7fb2ee3cb7d0>,32,26,[ 3 10],33,-1,59,-1,33
1,<environment.Job instance at 0x7fb2ee3cb2d0>,30,17,[5 6],31,-1,52,-1,35
1,<environment.Job instance at 0x7fb2ee3cb230>,35,21,[ 2 10],36,-1,58,-1,37
1,<environment.Job instance at 0x7fb2ee3cb780>,36,15,[10  2],37,-1,52,-1,37
1,<environment.Job instance at 0x7fb2ed221690>,41,17,[11  3],42,-1,59,-1,42
1,<environment.Job instance at 0x7fb2ed638460>,49,15,[ 3 10],50,-1,66,-1,51
1,<environment.Job instance at 0x7fb2ed6385f0>,51,13,[10  2],52,-1,68,-1,55
1,<environment.Job instance at 0x7fb2ed221f00>,40,16,[10  1],41,-1,74,-1,58
1,<environment.Job instance at 0x7fb2ed638050>,57,14,[9 2],58,-1,72,-1,58
1,<environment.Job instance at 0x7fb2ed638aa0>,53,24,[2 6],54,-1,83,-1,59
1,<environment.Job instance at 0x7fb2ed633280>,59,3,[3 7],60,-1,64,-1,61
1,<environment.Job instance at 0x7fb2ed633410>,60,14,[5 8],61,-1,75,-1,61
1,<environment.Job instance at 0x7fb2ed633be0>,62,18,[6 2],63,-1,83,-1,65
1,<environment.Job instance at 0x7fb2ed633eb0>,65,19,[6 3],66,-1,85,-1,66
1,<environment.Job instance at 0x7fb2ed633780>,67,15,[6 1],68,-1,83,-1,68
1,<environment.Job instance at 0x7fb2ed638190>,52,14,[5 1],53,-1,84,-1,70
1,<environment.Job instance at 0x7fb2ed6336e0>,68,13,[1 5],69,-1,83,-1,70
1,<environment.Job instance at 0x7fb2ed633690>,71,14,[3 6],72,-1,86,-1,72
1,<environment.Job instance at 0x7fb2ed633190>,72,27,[5 7],73,-1,100,-1,73
1,<environment.Job instance at 0x7fb2ed2f4dc0>,10,26,[3 7],11,-1,38,-1,12
1,<environment.Job instance at 0x7fb2edc8fbe0>,11,18,[11  5],12,-1,30,-1,12
1,<environment.Job instance at 0x7fb2ed2fc820>,19,1,[12  2],20,-1,40,-1,39
1,<environment.Job instance at 0x7fb2edd47140>,22,24,[1 9],23,-1,79,-1,55
1,<environment.Job instance at 0x7fb2ed56dc30>,31,27,[7 1],32,-1,126,-1,99
1,<environment.Job instance at 0x7fb2ed2c0190>,33,2,[ 3 13],34,-1,101,-1,99
1,<environment.Job instance at 0x7fb2edc9faa0>,37,1,[ 3 14],38,-1,103,-1,102
1,<environment.Job instance at 0x7fb2edcb5be0>,38,12,[ 2 11],39,-1,114,-1,102
1,<environment.Job instance at 0x7fb2ed56deb0>,32,26,[ 3 10],33,-1,131,-1,105
1,<environment.Job instance at 0x7fb2ee3cbf00>,41,17,[11  3],42,-1,122,-1,105
1,<environment.Job instance at 0x7fb2edcaae60>,42,16,[12  1],43,-1,121,-1,105
1,<environment.Job instance at 0x7fb2edcaac30>,43,15,[ 4 13],44,-1,120,-1,105
1,<environment.Job instance at 0x7fb2ed8d10f0>,53,24,[2 6],54,-1,172,-1,148
1,<environment.Job instance at 0x7fb2ee4378c0>,54,13,[ 5 12],55,-1,161,-1,148
1,<environment.Job instance at 0x7fb2edd2d4b0>,55,2,[ 2 11],56,-1,150,-1,148
1,<environment.Job instance at 0x7fb2edd24fa0>,72,27,[5 7],73,-1,235,-1,208
1,<environment.Job instance at 0x7fb2edd24320>,74,24,[13  2],75,-1,232,-1,208
1,<environment.Job instance at 0x7fb2ee3ae820>,78,15,[11  4],79,-1,237,-1,222
1,<environment.Job instance at 0x7fb2ee2d3c30>,81,14,[ 4 13],82,-1,241,-1,227
1,<environment.Job instance at 0x7fb2edd210f0>,97,14,[11  4],98,-1,311,-1,297
1,<environment.Job instance at 0x7fb2edd21b40>,100,18,[ 4 11],101,-1,327,-1,309
1,<environment.Job instance at 0x7fb2edce0fa0>,103,24,[8 5],104,-1,354,-1,330
1,<environment.Job instance at 0x7fb2ece2ab90>,108,13,[12  1],109,-1,360,-1,347
1,<environment.Job instance at 0x7fb2ee3d2550>,1,15,[8 1],2,-1,18,-1,3
1,<environment.Job instance at 0x7fb2ed583550>,3,15,[ 3 10],4,-1,19,-1,4
1,<environment.Job instance at 0x7fb2ed583960>,4,2,[2 7],5,-1,7,-1,5
1,<environment.Job instance at 0x7fb2ed545b90>,5,15,[5 6],6,-1,21,-1,6
1,<environment.Job instance at 0x7fb2ed1c2050>,2,16,[5 4],3,-1,23,-1,7
1,<environment.Job instance at 0x7fb2ed545780>,8,20,[3 9],9,-1,29,-1,9
1,<environment.Job instance at 0x7fb2ed544d20>,10,16,[5 4],11,-1,27,-1,11
1,<environment.Job instance at 0x7fb2ed1daa50>,11,17,[ 4 10],12,-1,29,-1,12
1,<environment.Job instance at 0x7fb2ed1e0050>,17,21,[4 8],18,-1,39,-1,18
1,<environment.Job instance at 0x7fb2ed1e00f0>,18,23,[3 9],19,-1,42,-1,19
1,<environment.Job instance at 0x7fb2ed1e0be0>,19,13,[10  5],20,-1,33,-1,20
1,<environment.Job instance at 0x7fb2ed1da7d0>,24,18,[6 4],25,-1,43,-1,25
1,<environment.Job instance at 0x7fb2ed506460>,25,15,[4 7],26,-1,41,-1,26
1,<environment.Job instance at 0x7fb2ed506a50>,26,12,[1 7],27,-1,40,-1,28
1,<environment.Job instance at 0x7fb2edcfaaf0>,28,16,[1 7],29,-1,45,-1,29
1,<environment.Job instance at 0x7fb2edcfac30>,29,15,[ 2 10],30,-1,45,-1,30
1,<environment.Job instance at 0x7fb2ed1e07d0>,27,17,[8 4],28,-1,47,-1,30
1,<environment.Job instance at 0x7fb2ed1d38c0>,41,16,[8 4],42,-1,58,-1,42
1,<environment.Job instance at 0x7fb2ed1b2960>,43,18,[6 4],44,-1,62,-1,44
1,<environment.Job instance at 0x7fb2edcda960>,55,21,[9 5],56,-1,77,-1,56
1,<environment.Job instance at 0x7fb2edcda370>,56,18,[10  5],57,-1,76,-1,58
1,<environment.Job instance at 0x7fb2edcc6870>,61,16,[1 6],62,-1,86,-1,70
1,<environment.Job instance at 0x7fb2edcc6aa0>,63,27,[3 5],64,-1,97,-1,70
1,<environment.Job instance at 0x7fb2edcda6e0>,53,15,[6 2],54,-1,85,-1,70
1,<environment.Job instance at 0x7fb2edcc6500>,67,17,[5 7],68,-1,87,-1,70
1,<environment.Job instance at 0x7fb2edcc6dc0>,68,12,[7 5],69,-1,82,-1,70
1,<environment.Job instance at 0x7fb2edcda780>,57,14,[1 9],58,-1,84,-1,70
1,<environment.Job instance at 0x7fb2edcc6d20>,69,12,[1 9],70,-1,123,-1,111
1,<environment.Job instance at 0x7fb2edccd500>,73,12,[9 3],74,-1,123,-1,111
1,<environment.Job instance at 0x7fb2edccd9b0>,81,3,[5 4],82,-1,114,-1,111
1,<environment.Job instance at 0x7fb2edccd910>,80,16,[9 4],81,-1,127,-1,111
1,<environment.Job instance at 0x7fb2edccdcd0>,85,18,[3 9],86,-1,129,-1,111
1,<environment.Job instance at 0x7fb2edccdd70>,86,27,[10  4],87,-1,138,-1,111
1,<environment.Job instance at 0x7fb2edccdaf0>,82,12,[8 3],83,-1,123,-1,111
1,<environment.Job instance at 0x7fb2edccdc80>,83,13,[5 6],84,-1,124,-1,111
1,<environment.Job instance at 0x7fb2edccdf50>,89,14,[9 4],90,-1,125,-1,111
1,<environment.Job instance at 0x7fb2edce3050>,91,18,[4 8],92,-1,129,-1,111
1,<environment.Job instance at 0x7fb2edce30f0>,92,25,[7 3],93,-1,136,-1,111
1,<environment.Job instance at 0x7fb2edce3870>,101,17,[10  5],102,-1,176,-1,159
1,<environment.Job instance at 0x7fb2edce3d20>,106,13,[8 5],107,-1,172,-1,159
1,<environment.Job instance at 0x7fb2edccd050>,6,3,[14  2],7,-1,10,-1,7
1,<environment.Job instance at 0x7fb2ed1a62d0>,13,14,[ 5 13],14,-1,32,-1,18
1,<environment.Job instance at 0x7fb2ee2d3730>,18,23,[3 9],19,-1,60,-1,37
1,<environment.Job instance at 0x7fb2ed667a50>,30,2,[ 1 11],31,-1,87,-1,85
1,<environment.Job instance at 0x7fb2ee49c9b0>,37,12,[ 3 14],38,-1,118,-1,106
1,<environment.Job instance at 0x7fb2ed591730>,48,16,[13  3],49,-1,144,-1,128
1,<environment.Job instance at 0x7fb2ee062960>,63,27,[3 5],64,-1,205,-1,178
1,<environment.Job instance at 0x7fb2ee062b90>,64,1,[12  4],65,-1,179,-1,178
1,<environment.Job instance at 0x7fb2edcaa5a0>,65,2,[14  1],66,-1,180,-1,178
1,<environment.Job instance at 0x7fb2edd21c30>,86,27,[10  4],87,-1,308,-1,281
1,<environment.Job instance at 0x7fb2ed196870>,90,1,[ 5 11],91,-1,294,-1,293
1,<environment.Job instance at 0x7fb2eda9faa0>,92,25,[7 3],93,-1,333,-1,308
1,<environment.Job instance at 0x7fb2edfe4870>,94,13,[ 3 12],95,-1,321,-1,308
1,<environment.Job instance at 0x7fb2ee3de8c0>,108,14,[13  2],109,-1,380,-1,366
1,<environment.Job instance at 0x7fb2ee3bfc80>,7,16,[2 7],8,-1,24,-1,8
1,<environment.Job instance at 0x7fb2ee3bf6e0>,9,14,[7 2],10,-1,24,-1,10
1,<environment.Job instance at 0x7fb2ee3bfc30>,10,18,[1 7],11,-1,29,-1,11
1,<environment.Job instance at 0x7fb2ee3bf460>,11,14,[1 7],12,-1,26,-1,12
1,<environment.Job instance at 0x7fb2ee3bf0a0>,12,14,[8 5],13,-1,27,-1,13
1,<environment.Job instance at 0x7fb2ee3bf140>,15,26,[4 8],16,-1,42,-1,16
1,<environment.Job instance at 0x7fb2ed654460>,16,20,[4 8],17,-1,37,-1,17
1,<environment.Job instance at 0x7fb2ed654870>,18,16,[8 4],19,-1,35,-1,19
1,<environment.Job instance at 0x7fb2ed654a50>,20,25,[5 4],21,-1,46,-1,21
1,<environment.Job instance at 0x7fb2ed654190>,21,21,[5 5],22,-1,43,-1,22
1,<environment.Job instance at 0x7fb2ed654320>,23,18,[ 2 10],24,-1,43,-1,25
1,<environment.Job instance at 0x7fb2ed654910>,25,25,[5 7],26,-1,51,-1,26
1,<environment.Job instance at 0x7fb2ed654e10>,26,12,[5 9],27,-1,39,-1,27
1,<environment.Job instance at 0x7fb2ed654230>,27,22,[5 8],28,-1,50,-1,28
1,<environment.Job instance at 0x7fb2ed654820>,24,13,[7 3],25,-1,41,-1,28
1,<environment.Job instance at 0x7fb2ed654aa0>,30,15,[3 8],31,-1,46,-1,31
1,<environment.Job instance at 0x7fb2ed638730>,33,27,[8 5],34,-1,61,-1,34
1,<environment.Job instance at 0x7fb2ed6389b0>,43,24,[3 5],44,-1,68,-1,44
1,<environment.Job instance at 0x7fb2ed2f11e0>,45,14,[10  1],46,-1,61,-1,47
1,<environment.Job instance at 0x7fb2ed2f1230>,47,17,[2 7],48,-1,65,-1,48
1,<environment.Job instance at 0x7fb2ed2f1a50>,48,15,[5 5],49,-1,64,-1,49
1,<environment.Job instance at 0x7fb2ed2f1960>,49,1,[6 2],50,-1,51,-1,50
1,<environment.Job instance at 0x7fb2ed2f15a0>,50,15,[6 3],51,-1,66,-1,51
1,<environment.Job instance at 0x7fb2ed2f1fa0>,51,18,[5 9],52,-1,70,-1,52
1,<environment.Job instance at 0x7fb2ed2f1cd0>,53,18,[3 7],54,-1,72,-1,54
1,<environment.Job instance at 0x7fb2ed2f17d0>,54,27,[1 8],55,-1,82,-1,55
1,<environment.Job instance at 0x7fb2ed4d5780>,58,12,[1 8],59,-1,71,-1,59
1,<environment.Job instance at 0x7fb2ed4d54b0>,60,18,[2 7],61,-1,79,-1,61
1,<environment.Job instance at 0x7fb2ed4d5460>,61,15,[6 3],62,-1,77,-1,62
1,<environment.Job instance at 0x7fb2ed2f18c0>,46,15,[3 6],47,-1,78,-1,63
1,<environment.Job instance at 0x7fb2ed4d5d20>,64,23,[4 5],65,-1,88,-1,65
1,<environment.Job instance at 0x7fb2ed4d5190>,66,13,[6 5],67,-1,80,-1,67
1,<environment.Job instance at 0x7fb2ed4d5640>,67,13,[12  5],68,-1,81,-1,68
1,<environment.Job instance at 0x7fb2ed4d5960>,68,12,[5 5],69,-1,81,-1,69
1,<environment.Job instance at 0x7fb2ed4d55a0>,69,18,[7 4],70,-1,88,-1,70
1,<environment.Job instance at 0x7fb2ed4d5f50>,70,1,[1 7],71,-1,72,-1,71
1,<environment.Job instance at 0x7fb2ed4d5550>,73,14,[ 4 11],74,-1,88,-1,74
1,<environment.Job instance at 0x7fb2ed4d56e0>,74,18,[3 6],75,-1,93,-1,75
1,<environment.Job instance at 0x7fb2ed1d7320>,76,26,[8 5],77,-1,103,-1,77
1,<environment.Job instance at 0x7fb2ed1d7e60>,79,20,[6 3],80,-1,101,-1,81
1,<environment.Job instance at 0x7fb2ed1d7cd0>,83,20,[5 3],84,-1,104,-1,84
1,<environment.Job instance at 0x7fb2ed1d7a00>,84,16,[2 7],85,-1,101,-1,85
1,<environment.Job instance at 0x7fb2ed1d7370>,85,17,[6 3],86,-1,103,-1,86
1,<environment.Job instance at 0x7fb2ed1d7050>,86,14,[10  1],87,-1,101,-1,87
1,<environment.Job instance at 0x7fb2ed6b5730>,89,12,[7 5],90,-1,102,-1,90
1,<environment.Job instance at 0x7fb2ed6b50f0>,90,18,[5 6],91,-1,109,-1,91
1,<environment.Job instance at 0x7fb2ed6b51e0>,91,17,[2 9],92,-1,109,-1,92
1,<environment.Job instance at 0x7fb2ed1d7640>,80,17,[5 8],81,-1,110,-1,93
1,<environment.Job instance at 0x7fb2ed6b5050>,94,12,[10  2],95,-1,107,-1,95
1,<environment.Job instance at 0x7fb2ed6b5140>,97,22,[10  1],98,-1,121,-1,99
1,<environment.Job instance at 0x7fb2ed6b5280>,98,16,[13  1],99,-1,116,-1,100
1,<environment.Job instance at 0x7fb2ed377460>,100,20,[3 8],101,-1,123,-1,103
1,<environment.Job instance at 0x7fb2edd203c0>,106,26,[9 5],107,-1,133,-1,107
1,<environment.Job instance at 0x7fb2edd20cd0>,102,13,[9 2],103,-1,127,-1,114
1,<environment.Job instance at 0x7fb2ede02dc0>,15,26,[4 8],16,-1,62,-1,36
1,<environment.Job instance at 0x7fb2ed661410>,20,25,[5 4],21,-1,66,-1,41
1,<environment.Job instance at 0x7fb2ed638b40>,25,25,[5 7],26,-1,81,-1,56
1,<environment.Job instance at 0x7fb2ed638960>,29,3,[11  3],30,-1,59,-1,56
1,<environment.Job instance at 0x7fb2ed219d20>,33,27,[8 5],34,-1,108,-1,81
1,<environment.Job instance at 0x7fb2ee35a640>,34,12,[ 5 13],35,-1,93,-1,81
1,<environment.Job instance at 0x7fb2ee2d3c30>,39,1,[12  4],40,-1,85,-1,84
1,<environment.Job instance at 0x7fb2edce3be0>,43,24,[3 5],44,-1,113,-1,89
1,<environment.Job instance at 0x7fb2f6a46af0>,54,27,[1 8],55,-1,177,-1,150
1,<environment.Job instance at 0x7fb2ee285be0>,64,23,[4 5],65,-1,195,-1,172
1,<environment.Job instance at 0x7fb2ed2fda00>,67,13,[12  5],68,-1,185,-1,172
1,<environment.Job instance at 0x7fb2ed379c80>,73,14,[ 4 11],74,-1,215,-1,201
1,<environment.Job instance at 0x7fb2ed93b690>,76,26,[8 5],77,-1,232,-1,206
1,<environment.Job instance at 0x7fb2ed886910>,78,18,[13  1],79,-1,224,-1,206
1,<environment.Job instance at 0x7fb2ed8c5eb0>,98,16,[13  1],99,-1,294,-1,278
1,<environment.Job instance at 0x7fb2edc795f0>,101,3,[11  4],102,-1,294,-1,291
1,<environment.Job instance at 0x7fb2f6a1d1e0>,106,26,[9 5],107,-1,365,-1,339
1,<environment.Job instance at 0x7fb2ecce7140>,4,17,[1 8],5,-1,22,-1,5
1,<environment.Job instance at 0x7fb2ecd17960>,9,22,[7 3],10,-1,32,-1,10
1,<environment.Job instance at 0x7fb2ecd17eb0>,12,25,[7 5],13,-1,38,-1,13
1,<environment.Job instance at 0x7fb2eccb6e60>,29,17,[ 2 10],30,-1,79,-1,62
1,<environment.Job instance at 0x7fb2ece319b0>,90,18,[6 4],91,-1,367,-1,349
1,<environment.Job instance at 0x7fb2ecbae2d0>,80,25,[10  4],81,-1,374,-1,349
1,<environment.Job instance at 0x7fb2ed8dd820>,73,16,[6 1],74,-1,365,-1,349
1,<environment.Job instance at 0x7fb2ed462b40>,7,1,[ 4 12],8,-1,9,-1,8
1,<environment.Job instance at 0x7fb2ece9b370>,10,15,[13  3],11,-1,32,-1,17
1,<environment.Job instance at 0x7fb2ee4680f0>,13,2,[14  5],14,-1,19,-1,17
1,<environment.Job instance at 0x7fb2ee468fa0>,14,2,[13  4],15,-1,19,-1,17
1,<environment.Job instance at 0x7fb2ee468dc0>,16,12,[12  4],17,-1,31,-1,19
1,<environment.Job instance at 0x7fb2ee468190>,12,25,[7 5],13,-1,45,-1,20
1,<environment.Job instance at 0x7fb2ee10dfa0>,25,15,[ 4 12],26,-1,62,-1,47
1,<environment.Job instance at 0x7fb2ecce74b0>,37,27,[8 5],38,-1,126,-1,99
1,<environment.Job instance at 0x7fb2ed11fc80>,49,2,[ 2 12],50,-1,154,-1,152
1,<environment.Job instance at 0x7fb2ee288410>,52,24,[4 6],53,-1,191,-1,167
1,<environment.Job instance at 0x7fb2ee288500>,53,15,[ 2 13],54,-1,182,-1,167
1,<environment.Job instance at 0x7fb2ed125a50>,57,18,[14  1],58,-1,202,-1,184
1,<environment.Job instance at 0x7fb2ee27b780>,63,13,[ 3 11],64,-1,216,-1,203
1,<environment.Job instance at 0x7fb2ee28afa0>,66,15,[11  2],67,-1,230,-1,215
1,<environment.Job instance at 0x7fb2ee255320>,70,12,[ 3 12],71,-1,236,-1,224
1,<environment.Job instance at 0x7fb2ee2705a0>,80,25,[10  4],81,-1,319,-1,294
1,<environment.Job instance at 0x7fb2ee27fd20>,97,16,[13  1],98,-1,355,-1,339
1,<environment.Job instance at 0x7fb2ed4605f0>,101,2,[13  4],102,-1,362,-1,360
1,<environment.Job instance at 0x7fb2ee475d70>,3,27,[1 7],4,-1,31,-1,4
1,<environment.Job instance at 0x7fb2ee10a0f0>,4,18,[6 3],5,-1,23,-1,5
1,<environment.Job instance at 0x7fb2ee10ae60>,12,17,[5 9],13,-1,31,-1,14
1,<environment.Job instance at 0x7fb2ee10a280>,14,15,[8 2],15,-1,30,-1,15
1,<environment.Job instance at 0x7fb2ee10a9b0>,15,17,[6 4],16,-1,33,-1,16
1,<environment.Job instance at 0x7fb2ee10a460>,16,17,[1 6],17,-1,34,-1,17
1,<environment.Job instance at 0x7fb2ee10afa0>,17,18,[5 5],18,-1,36,-1,18
1,<environment.Job instance at 0x7fb2ee10aaa0>,18,18,[ 3 10],19,-1,37,-1,19
1,<environment.Job instance at 0x7fb2ee10a8c0>,19,13,[8 4],20,-1,33,-1,20
1,<environment.Job instance at 0x7fb2ee10af00>,20,27,[5 4],21,-1,48,-1,21
1,<environment.Job instance at 0x7fb2ee10ab90>,21,28,[7 5],22,-1,50,-1,22
1,<environment.Job instance at 0x7fb2ee1119b0>,23,28,[8 2],24,-1,52,-1,24
1,<environment.Job instance at 0x7fb2ee111aa0>,24,16,[2 5],25,-1,41,-1,25
1,<environment.Job instance at 0x7fb2ee111730>,25,13,[ 5 10],26,-1,39,-1,26
1,<environment.Job instance at 0x7fb2ee111f50>,28,17,[5 3],29,-1,46,-1,29
1,<environment.Job instance at 0x7fb2ee111be0>,29,13,[7 1],30,-1,43,-1,30
1,<environment.Job instance at 0x7fb2ee1117d0>,32,14,[3 8],33,-1,47,-1,33
1,<environment.Job instance at 0x7fb2ee111e10>,33,16,[7 2],34,-1,50,-1,34
1,<environment.Job instance at 0x7fb2ee111c80>,34,12,[9 3],35,-1,47,-1,35
1,<environment.Job instance at 0x7fb2ee475500>,13,18,[5 5],14,-1,54,-1,36
1,<environment.Job instance at 0x7fb2ee111cd0>,37,18,[2 6],38,-1,57,-1,39
1,<environment.Job instance at 0x7fb2ee111dc0>,39,12,[10  4],40,-1,53,-1,41
1,<environment.Job instance at 0x7fb2ee0e5910>,43,19,[7 1],44,-1,63,-1,44
1,<environment.Job instance at 0x7fb2ed7e3640>,53,27,[5 1],54,-1,91,-1,64
1,<environment.Job instance at 0x7fb2ee0e5c30>,48,18,[ 2 10],49,-1,86,-1,68
1,<environment.Job instance at 0x7fb2ed7e37d0>,54,15,[5 5],55,-1,83,-1,68
1,<environment.Job instance at 0x7fb2ed7e32d0>,64,18,[9 1],65,-1,99,-1,81
1,<environment.Job instance at 0x7fb2ee10a640>,11,25,[9 1],12,-1,207,-1,182
1,<environment.Job instance at 0x7fb2ee26aa50>,88,12,[5 5],89,-1,196,-1,184
1,<environment.Job instance at 0x7fb2ee3f4140>,77,26,[3 7],78,-1,210,-1,184
1,<environment.Job instance at 0x7fb2ee26a370>,89,25,[3 8],90,-1,209,-1,184
1,<environment.Job instance at 0x7fb2ee26ab90>,91,17,[7 4],92,-1,201,-1,184
1,<environment.Job instance at 0x7fb2ed7e3e10>,63,18,[6 4],64,-1,202,-1,184
1,<environment.Job instance at 0x7fb2ee26a140>,92,15,[3 6],93,-1,199,-1,184
1,<environment.Job instance at 0x7fb2ee26a960>,86,18,[5 4],87,-1,202,-1,184
1,<environment.Job instance at 0x7fb2edf46b40>,98,1,[3 8],99,-1,188,-1,187
1,<environment.Job instance at 0x7fb2edf460f0>,95,18,[8 2],96,-1,205,-1,187
1,<environment.Job instance at 0x7fb2edf46aa0>,101,18,[13  5],102,-1,205,-1,187
1,<environment.Job instance at 0x7fb2ee26acd0>,94,12,[1 5],95,-1,199,-1,187
1,<environment.Job instance at 0x7fb2ee26ae10>,90,17,[7 1],91,-1,205,-1,188
1,<environment.Job instance at 0x7fb2edf469b0>,105,14,[11  2],106,-1,202,-1,188
1,<environment.Job instance at 0x7fb2edf466e0>,104,13,[5 5],105,-1,201,-1,188
1,<environment.Job instance at 0x7fb2ee111960>,0,27,[ 3 13],1,-1,28,-1,1
1,<environment.Job instance at 0x7fb2ee0e5370>,3,27,[1 7],4,-1,31,-1,4
1,<environment.Job instance at 0x7fb2ee0e5cd0>,5,18,[ 3 12],6,-1,24,-1,6
1,<environment.Job instance at 0x7fb2ee3f4960>,10,1,[12  1],11,-1,12,-1,11
1,<environment.Job instance at 0x7fb2edf46cd0>,11,25,[9 1],12,-1,62,-1,37
1,<environment.Job instance at 0x7fb2ee280320>,20,27,[5 4],21,-1,82,-1,55
1,<environment.Job instance at 0x7fb2ed061c30>,21,28,[7 5],22,-1,83,-1,55
1,<environment.Job instance at 0x7fb2ee481b40>,23,28,[8 2],24,-1,96,-1,68
1,<environment.Job instance at 0x7fb2ecc726e0>,41,1,[ 5 14],42,-1,124,-1,123
1,<environment.Job instance at 0x7fb2edc558c0>,50,17,[ 5 13],51,-1,166,-1,149
1,<environment.Job instance at 0x7fb2ed1a6410>,53,27,[5 1],54,-1,197,-1,170
1,<environment.Job instance at 0x7fb2edf3f5a0>,56,2,[ 5 12],57,-1,174,-1,172
1,<environment.Job instance at 0x7fb2ed460be0>,65,17,[14  4],66,-1,218,-1,201
1,<environment.Job instance at 0x7fb2ed9c30f0>,71,12,[13  5],72,-1,245,-1,233
1,<environment.Job instance at 0x7fb2ee255fa0>,77,26,[3 7],78,-1,298,-1,272
1,<environment.Job instance at 0x7fb2ed11fb40>,87,1,[ 2 11],88,-1,278,-1,277
1,<environment.Job instance at 0x7fb2ed11fd70>,89,25,[3 8],90,-1,315,-1,290
1,<environment.Job instance at 0x7fb2ed125fa0>,101,18,[13  5],102,-1,340,-1,322
1,<environment.Job instance at 0x7fb2ee272410>,97,28,[4 9],98,-1,352,-1,324
1,<environment.Job instance at 0x7fb2ecd7fc30>,105,14,[11  2],106,-1,340,-1,326
1,<environment.Job instance at 0x7fb2ee27f2d0>,108,1,[14  2],109,-1,337,-1,336
1,<environment.Job instance at 0x7fb2edce1fa0>,0,14,[10  4],1,-1,16,-1,2
1,<environment.Job instance at 0x7fb2edbdb050>,1,15,[7 2],2,-1,19,-1,4
1,<environment.Job instance at 0x7fb2edce1190>,8,16,[10  1],9,-1,26,-1,10
1,<environment.Job instance at 0x7fb2edce1e60>,9,18,[8 2],10,-1,28,-1,10
1,<environment.Job instance at 0x7fb2edce1a50>,10,18,[2 8],11,-1,29,-1,11
1,<environment.Job instance at 0x7fb2edca9730>,15,18,[9 1],16,-1,34,-1,16
1,<environment.Job instance at 0x7fb2edbf3a00>,17,12,[9 1],18,-1,33,-1,21
1,<environment.Job instance at 0x7fb2edbf30f0>,21,2,[4 7],22,-1,24,-1,22
1,<environment.Job instance at 0x7fb2edbf3870>,22,12,[5 5],23,-1,35,-1,23
1,<environment.Job instance at 0x7fb2edbf3910>,20,15,[5 8],21,-1,38,-1,23
1,<environment.Job instance at 0x7fb2edbf3050>,24,21,[8 1],25,-1,47,-1,26
1,<environment.Job instance at 0x7fb2edbf3af0>,29,25,[ 3 10],30,-1,55,-1,30
1,<environment.Job instance at 0x7fb2edbf35f0>,30,18,[ 2 11],31,-1,49,-1,31
1,<environment.Job instance at 0x7fb2edbf3e10>,31,12,[ 1 10],32,-1,44,-1,32
1,<environment.Job instance at 0x7fb2edaad820>,34,17,[5 4],35,-1,52,-1,35
1,<environment.Job instance at 0x7fb2edaadaa0>,35,15,[9 4],36,-1,51,-1,36
1,<environment.Job instance at 0x7fb2edaad730>,36,15,[4 7],37,-1,52,-1,37
1,<environment.Job instance at 0x7fb2edaad410>,37,23,[9 2],38,-1,61,-1,38
1,<environment.Job instance at 0x7fb2edaadb90>,40,15,[4 8],41,-1,56,-1,41
1,<environment.Job instance at 0x7fb2edaad500>,43,17,[7 4],44,-1,61,-1,44
1,<environment.Job instance at 0x7fb2edaade60>,45,15,[9 1],46,-1,61,-1,46
1,<environment.Job instance at 0x7fb2edaadc80>,48,16,[6 5],49,-1,65,-1,49
1,<environment.Job instance at 0x7fb2ed014500>,50,15,[7 2],51,-1,66,-1,51
1,<environment.Job instance at 0x7fb2ed014140>,51,14,[1 5],52,-1,66,-1,52
1,<environment.Job instance at 0x7fb2ed0142d0>,52,18,[ 2 10],53,-1,71,-1,53
1,<environment.Job instance at 0x7fb2ed0140a0>,53,14,[4 9],54,-1,68,-1,54
1,<environment.Job instance at 0x7fb2ed014eb0>,54,12,[9 4],55,-1,67,-1,55
1,<environment.Job instance at 0x7fb2ed0145a0>,57,15,[1 6],58,-1,73,-1,58
1,<environment.Job instance at 0x7fb2ed014fa0>,60,16,[3 7],61,-1,77,-1,61
1,<environment.Job instance at 0x7fb2ed0149b0>,61,18,[5 5],62,-1,80,-1,62
1,<environment.Job instance at 0x7fb2ed014c30>,63,24,[4 7],64,-1,88,-1,64
1,<environment.Job instance at 0x7fb2ed014370>,64,16,[4 7],65,-1,81,-1,65
1,<environment.Job instance at 0x7fb2ee3bfd20>,77,18,[3 9],78,-1,96,-1,78
1,<environment.Job instance at 0x7fb2ee3bf500>,79,14,[5 4],80,-1,94,-1,80
1,<environment.Job instance at 0x7fb2ee3bf640>,80,15,[5 3],81,-1,96,-1,81
1,<environment.Job instance at 0x7fb2ee3bf460>,81,3,[5 5],82,-1,85,-1,82
1,<environment.Job instance at 0x7fb2ee3bfcd0>,82,15,[ 1 10],83,-1,98,-1,83
1,<environment.Job instance at 0x7fb2ee3bff00>,83,24,[3 5],84,-1,108,-1,84
1,<environment.Job instance at 0x7fb2ee3bf1e0>,90,14,[2 8],91,-1,109,-1,95
1,<environment.Job instance at 0x7fb2ee3bfa50>,91,17,[4 7],92,-1,114,-1,97
1,<environment.Job instance at 0x7fb2ee39c410>,93,17,[4 9],94,-1,114,-1,97
1,<environment.Job instance at 0x7fb2ee3bf0a0>,92,15,[2 7],93,-1,112,-1,97
1,<environment.Job instance at 0x7fb2edc8fe10>,98,16,[9 2],99,-1,115,-1,99
1,<environment.Job instance at 0x7fb2ecf4e4b0>,68,23,[ 4 10],69,-1,124,-1,101
1,<environment.Job instance at 0x7fb2ede5e870>,100,26,[4 8],101,-1,127,-1,101
1,<environment.Job instance at 0x7fb2ededce60>,99,24,[7 1],100,-1,134,-1,110
1,<environment.Job instance at 0x7fb2f6e122d0>,105,18,[6 2],106,-1,128,-1,110
1,<environment.Job instance at 0x7fb2f6e120f0>,107,13,[ 5 10],108,-1,123,-1,110
1,<environment.Job instance at 0x7fb2ee0e1460>,108,13,[ 5 10],109,-1,123,-1,110
1,<environment.Job instance at 0x7fb2ee272dc0>,30,18,[ 2 11],31,-1,96,-1,78
1,<environment.Job instance at 0x7fb2ee272690>,29,25,[ 3 10],30,-1,123,-1,98
1,<environment.Job instance at 0x7fb2ed11f7d0>,37,23,[9 2],38,-1,136,-1,113
1,<environment.Job instance at 0x7fb2ed0c0780>,56,17,[ 1 14],57,-1,186,-1,169
1,<environment.Job instance at 0x7fb2edaff500>,59,18,[14  4],60,-1,194,-1,176
1,<environment.Job instance at 0x7fb2ee1fd4b0>,63,24,[4 7],64,-1,222,-1,198
1,<environment.Job instance at 0x7fb2ecb5f5f0>,68,23,[ 4 10],69,-1,246,-1,223
1,<environment.Job instance at 0x7fb2ee3b0a50>,75,13,[ 3 12],76,-1,236,-1,223
1,<environment.Job instance at 0x7fb2ed120320>,76,13,[ 4 12],77,-1,236,-1,223
1,<environment.Job instance at 0x7fb2ed2ad230>,83,24,[3 5],84,-1,276,-1,252
1,<environment.Job instance at 0x7fb2ee0e54b0>,99,24,[7 1],100,-1,334,-1,310
1,<environment.Job instance at 0x7fb2ed371fa0>,100,26,[4 8],101,-1,351,-1,325
1,<environment.Job instance at 0x7fb2edc6feb0>,0,18,[8 5],1,-1,19,-1,1
1,<environment.Job instance at 0x7fb2ed1cbc80>,2,18,[4 5],3,-1,21,-1,3
1,<environment.Job instance at 0x7fb2ed1cb5a0>,3,18,[8 1],4,-1,23,-1,5
1,<environment.Job instance at 0x7fb2ed1cb500>,8,17,[10  4],9,-1,26,-1,9
1,<environment.Job instance at 0x7fb2ed1cb9b0>,9,15,[5 9],10,-1,25,-1,10
1,<environment.Job instance at 0x7fb2ed1cb820>,12,16,[3 5],13,-1,29,-1,13
1,<environment.Job instance at 0x7fb2ed1cb460>,15,22,[1 9],16,-1,38,-1,16
1,<environment.Job instance at 0x7fb2ecbbc690>,19,18,[ 3 12],20,-1,38,-1,20
1,<environment.Job instance at 0x7fb2ed1cbf00>,20,18,[7 3],21,-1,39,-1,21
1,<environment.Job instance at 0x7fb2f69d1690>,23,17,[10  3],24,-1,44,-1,27
1,<environment.Job instance at 0x7fb2ed9bbaf0>,27,15,[6 4],28,-1,43,-1,28
1,<environment.Job instance at 0x7fb2ed9bbc30>,28,17,[3 8],29,-1,46,-1,29
1,<environment.Job instance at 0x7fb2ed9bb5f0>,29,15,[ 5 10],30,-1,45,-1,30
1,<environment.Job instance at 0x7fb2ed9bb410>,30,19,[5 4],31,-1,50,-1,31
1,<environment.Job instance at 0x7fb2ed9bbeb0>,31,17,[ 2 10],32,-1,49,-1,32
1,<environment.Job instance at 0x7fb2ed9bb550>,33,18,[9 2],34,-1,52,-1,34
1,<environment.Job instance at 0x7fb2ed9bb2d0>,34,24,[5 9],35,-1,59,-1,35
1,<environment.Job instance at 0x7fb2ed9bb910>,35,16,[10  3],36,-1,52,-1,36
1,<environment.Job instance at 0x7fb2ed9bb1e0>,37,26,[8 5],38,-1,64,-1,38
1,<environment.Job instance at 0x7fb2ed9bb280>,40,17,[10  1],41,-1,58,-1,41
1,<environment.Job instance at 0x7fb2ed9bbfa0>,42,13,[9 1],43,-1,57,-1,44
1,<environment.Job instance at 0x7fb2ed9bbaa0>,43,26,[7 5],44,-1,70,-1,44
1,<environment.Job instance at 0x7fb2ed9bb050>,44,16,[3 9],45,-1,61,-1,45
1,<environment.Job instance at 0x7fb2ecbb29b0>,46,20,[3 6],47,-1,67,-1,47
1,<environment.Job instance at 0x7fb2ecbb2820>,47,18,[ 3 10],48,-1,66,-1,48
1,<environment.Job instance at 0x7fb2ecbb2e10>,48,16,[3 5],49,-1,65,-1,49
1,<environment.Job instance at 0x7fb2ecbb2910>,49,16,[8 5],50,-1,66,-1,50
1,<environment.Job instance at 0x7fb2ecbb2fa0>,52,18,[4 7],53,-1,71,-1,53
1,<environment.Job instance at 0x7fb2ecbb2870>,55,17,[9 3],56,-1,77,-1,60
1,<environment.Job instance at 0x7fb2ee348a00>,61,12,[10  4],62,-1,74,-1,62
1,<environment.Job instance at 0x7fb2ee348190>,59,15,[5 5],60,-1,82,-1,67
1,<environment.Job instance at 0x7fb2ed60a280>,74,17,[5 9],75,-1,92,-1,75
1,<environment.Job instance at 0x7fb2edf0b870>,75,17,[5 9],76,-1,93,-1,76
1,<environment.Job instance at 0x7fb2edf0b370>,76,23,[10  4],77,-1,101,-1,78
1,<environment.Job instance at 0x7fb2ee041c30>,78,17,[4 9],79,-1,96,-1,79
1,<environment.Job instance at 0x7fb2edda8e10>,79,18,[9 5],80,-1,98,-1,80
1,<environment.Job instance at 0x7fb2eddd0dc0>,81,17,[8 2],82,-1,99,-1,82
1,<environment.Job instance at 0x7fb2eccf7e10>,82,18,[10  5],83,-1,101,-1,83
1,<environment.Job instance at 0x7fb2ee3adc30>,85,16,[3 8],86,-1,102,-1,86
1,<environment.Job instance at 0x7fb2ecc966e0>,86,14,[4 7],87,-1,101,-1,87
1,<environment.Job instance at 0x7fb2ecc96c30>,87,18,[5 4],88,-1,106,-1,88
1,<environment.Job instance at 0x7fb2ecc96aa0>,88,12,[6 1],89,-1,101,-1,89
1,<environment.Job instance at 0x7fb2ed187a00>,89,12,[5 9],90,-1,102,-1,90
1,<environment.Job instance at 0x7fb2edc8ad70>,90,12,[2 9],91,-1,103,-1,91
1,<environment.Job instance at 0x7fb2edc8a910>,91,17,[7 2],92,-1,109,-1,92
1,<environment.Job instance at 0x7fb2ed159cd0>,93,16,[3 9],94,-1,110,-1,94
1,<environment.Job instance at 0x7fb2ecc22eb0>,94,13,[10  1],95,-1,108,-1,95
1,<environment.Job instance at 0x7fb2f6db9780>,95,13,[ 3 10],96,-1,109,-1,96
1,<environment.Job instance at 0x7fb2ee3ac820>,96,14,[1 5],97,-1,111,-1,97
1,<environment.Job instance at 0x7fb2f706ec30>,99,25,[8 3],100,-1,125,-1,100
1,<environment.Job instance at 0x7fb2ed5c8a00>,101,17,[3 7],102,-1,119,-1,102
1,<environment.Job instance at 0x7fb2ed7519b0>,103,18,[2 6],104,-1,122,-1,104
1,<environment.Job instance at 0x7fb2ed751b40>,104,18,[8 2],105,-1,123,-1,105
1,<environment.Job instance at 0x7fb2f6ffb320>,106,17,[1 6],107,-1,124,-1,107
1,<environment.Job instance at 0x7fb2f6ffb3c0>,107,18,[5 2],108,-1,126,-1,108
1,<environment.Job instance at 0x7fb2f6ffb640>,108,17,[3 5],109,-1,126,-1,109
1,<environment.Job instance at 0x7fb2edd6a820>,5,15,[12  1],6,-1,21,-1,6
1,<environment.Job instance at 0x7fb2ed7e6e60>,13,1,[ 3 13],14,-1,38,-1,37
1,<environment.Job instance at 0x7fb2ed39a190>,19,18,[ 3 12],20,-1,57,-1,39
1,<environment.Job instance at 0x7fb2eda231e0>,25,1,[ 5 13],26,-1,57,-1,56
1,<environment.Job instance at 0x7fb2ed493690>,34,24,[5 9],35,-1,127,-1,103
1,<environment.Job instance at 0x7fb2eda2d230>,37,26,[8 5],38,-1,150,-1,124
1,<environment.Job instance at 0x7fb2ed46f1e0>,43,26,[7 5],44,-1,166,-1,140
1,<environment.Job instance at 0x7fb2ed46f320>,45,2,[13  2],46,-1,142,-1,140
1,<environment.Job instance at 0x7fb2ed46c5f0>,53,3,[11  3],54,-1,177,-1,174
1,<environment.Job instance at 0x7fb2eda34fa0>,68,16,[ 5 13],69,-1,226,-1,210
1,<environment.Job instance at 0x7fb2edd5f8c0>,71,15,[14  4],72,-1,225,-1,210
1,<environment.Job instance at 0x7fb2eda25050>,76,23,[10  4],77,-1,264,-1,241
1,<environment.Job instance at 0x7fb2ed190a00>,99,25,[8 3],100,-1,380,-1,355
1,<environment.Job instance at 0x7fb2eda3d460>,102,24,[11  1],103,-1,379,-1,355
1,<environment.Job instance at 0x7fb2ed3cfc30>,1,15,[10  5],2,-1,17,-1,2
1,<environment.Job instance at 0x7fb2ed3cfe10>,2,18,[10  1],3,-1,24,-1,6
1,<environment.Job instance at 0x7fb2eddd3c30>,5,12,[5 9],6,-1,20,-1,8
1,<environment.Job instance at 0x7fb2eddd3e60>,11,18,[7 1],12,-1,32,-1,14
1,<environment.Job instance at 0x7fb2eddd3500>,13,18,[ 3 10],14,-1,32,-1,14
1,<environment.Job instance at 0x7fb2ecfcd820>,21,15,[9 5],22,-1,38,-1,23
1,<environment.Job instance at 0x7fb2ecfcd550>,26,21,[3 7],27,-1,56,-1,35
1,<environment.Job instance at 0x7fb2ecfcdc80>,22,14,[ 1 10],23,-1,50,-1,36
1,<environment.Job instance at 0x7fb2ecfcd1e0>,28,28,[8 3],29,-1,64,-1,36
1,<environment.Job instance at 0x7fb2ecfcd410>,32,16,[10  1],33,-1,56,-1,40
1,<environment.Job instance at 0x7fb2ecfcd0a0>,29,20,[1 9],30,-1,60,-1,40
1,<environment.Job instance at 0x7fb2ecfcd6e0>,27,15,[ 3 10],28,-1,55,-1,40
1,<environment.Job instance at 0x7fb2ecfcd0f0>,31,17,[5 6],32,-1,57,-1,40
1,<environment.Job instance at 0x7fb2ecfcd190>,36,13,[ 5 11],37,-1,53,-1,40
1,<environment.Job instance at 0x7fb2ecfcd4b0>,33,17,[ 2 10],34,-1,57,-1,40
1,<environment.Job instance at 0x7fb2ed3d20f0>,38,15,[10  2],39,-1,55,-1,40
1,<environment.Job instance at 0x7fb2ed3d2fa0>,39,18,[3 8],40,-1,58,-1,40
1,<environment.Job instance at 0x7fb2ed3d2500>,41,18,[4 6],42,-1,61,-1,43
1,<environment.Job instance at 0x7fb2ed3d22d0>,43,17,[6 1],44,-1,61,-1,44
1,<environment.Job instance at 0x7fb2ed3d2d70>,42,15,[1 7],43,-1,61,-1,46
1,<environment.Job instance at 0x7fb2ed3d24b0>,47,12,[ 3 10],48,-1,61,-1,49
1,<environment.Job instance at 0x7fb2ed3d28c0>,48,15,[8 2],49,-1,65,-1,50
1,<environment.Job instance at 0x7fb2ed5ad6e0>,54,16,[1 8],55,-1,71,-1,55
1,<environment.Job instance at 0x7fb2ed5ad690>,53,12,[5 9],54,-1,69,-1,57
1,<environment.Job instance at 0x7fb2ed5ad4b0>,59,20,[2 8],60,-1,80,-1,60
1,<environment.Job instance at 0x7fb2ed5adf50>,64,13,[10  5],65,-1,97,-1,84
1,<environment.Job instance at 0x7fb2ed5adb40>,56,21,[12  2],57,-1,105,-1,84
1,<environment.Job instance at 0x7fb2ed5b91e0>,69,12,[7 1],70,-1,97,-1,85
1,<environment.Job instance at 0x7fb2ed5b95f0>,71,23,[5 9],72,-1,108,-1,85
1,<environment.Job instance at 0x7fb2ed5b93c0>,76,18,[1 5],77,-1,103,-1,85
1,<environment.Job instance at 0x7fb2ed5b9a50>,81,26,[7 2],82,-1,113,-1,87
1,<environment.Job instance at 0x7fb2ed5b9af0>,83,16,[ 3 10],84,-1,106,-1,90
1,<environment.Job instance at 0x7fb2ed5add20>,52,27,[9 1],53,-1,117,-1,90
1,<environment.Job instance at 0x7fb2ed5b9f50>,74,15,[6 4],75,-1,105,-1,90
1,<environment.Job instance at 0x7fb2eddd6460>,84,14,[10  5],85,-1,104,-1,90
1,<environment.Job instance at 0x7fb2eddd65a0>,86,12,[11  2],87,-1,102,-1,90
1,<environment.Job instance at 0x7fb2ed5b90a0>,73,14,[5 6],74,-1,104,-1,90
1,<environment.Job instance at 0x7fb2eddd62d0>,88,19,[ 5 11],89,-1,109,-1,90
1,<environment.Job instance at 0x7fb2ed5ad3c0>,60,15,[12  3],61,-1,105,-1,90
1,<environment.Job instance at 0x7fb2ed5b9640>,75,15,[ 4 12],76,-1,105,-1,90
1,<environment.Job instance at 0x7fb2eddd6c80>,89,14,[8 2],90,-1,104,-1,90
1,<environment.Job instance at 0x7fb2eddd66e0>,91,17,[10  3],92,-1,109,-1,92
1,<environment.Job instance at 0x7fb2eddd6690>,92,13,[5 2],93,-1,107,-1,94
1,<environment.Job instance at 0x7fb2eddd68c0>,93,12,[9 4],94,-1,106,-1,94
1,<environment.Job instance at 0x7fb2eddd6be0>,94,18,[5 3],95,-1,113,-1,95
1,<environment.Job instance at 0x7fb2ed5dc320>,99,19,[9 1],100,-1,119,-1,100
1,<environment.Job instance at 0x7fb2ed3e5f50>,104,23,[8 3],105,-1,128,-1,105
1,<environment.Job instance at 0x7fb2ed3e5dc0>,106,17,[2 7],107,-1,124,-1,107
1,<environment.Job instance at 0x7fb2edb034b0>,23,2,[12  1],24,-1,51,-1,49
1,<environment.Job instance at 0x7fb2ee275d20>,24,1,[ 5 14],25,-1,50,-1,49
1,<environment.Job instance at 0x7fb2eddaac30>,28,28,[8 3],29,-1,91,-1,63
1,<environment.Job instance at 0x7fb2ed681410>,36,13,[ 5 11],37,-1,109,-1,96
1,<environment.Job instance at 0x7fb2ed19b6e0>,37,2,[13  1],38,-1,98,-1,96
1,<environment.Job instance at 0x7fb2ed41cc80>,44,1,[11  3],45,-1,124,-1,123
1,<environment.Job instance at 0x7fb2ede9a780>,51,13,[ 1 13],52,-1,181,-1,168
1,<environment.Job instance at 0x7fb2ede9ab90>,52,27,[9 1],53,-1,205,-1,178
1,<environment.Job instance at 0x7fb2ed39a190>,56,21,[12  2],57,-1,199,-1,178
1,<environment.Job instance at 0x7fb2ed7d49b0>,58,14,[ 1 14],59,-1,193,-1,179
1,<environment.Job instance at 0x7fb2ed36c5f0>,60,15,[12  3],61,-1,196,-1,181
1,<environment.Job instance at 0x7fb2ee067cd0>,66,2,[12  3],67,-1,199,-1,197
1,<environment.Job instance at 0x7fb2edeaadc0>,71,23,[5 9],72,-1,243,-1,220
1,<environment.Job instance at 0x7fb2edd77690>,75,15,[ 4 12],76,-1,238,-1,223
1,<environment.Job instance at 0x7fb2ee1ad500>,79,3,[ 4 11],80,-1,241,-1,238
1,<environment.Job instance at 0x7fb2edd20140>,81,26,[7 2],82,-1,277,-1,251
1,<environment.Job instance at 0x7fb2ee0e1c30>,82,2,[ 2 13],83,-1,253,-1,251
1,<environment.Job instance at 0x7fb2f6a63b40>,86,12,[11  2],87,-1,268,-1,256
1,<environment.Job instance at 0x7fb2f6a635f0>,87,1,[14  5],88,-1,257,-1,256
1,<environment.Job instance at 0x7fb2f6d7ef00>,88,19,[ 5 11],89,-1,275,-1,256
1,<environment.Job instance at 0x7fb2edaf2f00>,98,1,[ 4 13],99,-1,288,-1,287
1,<environment.Job instance at 0x7fb2ed1fb640>,102,2,[ 3 14],103,-1,294,-1,292
1,<environment.Job instance at 0x7fb2edda7e10>,104,23,[8 3],105,-1,317,-1,294
1,<environment.Job instance at 0x7fb2ecb83960>,1,15,[10  1],2,-1,20,-1,5
1,<environment.Job instance at 0x7fb2ecb837d0>,6,18,[7 2],7,-1,25,-1,7
1,<environment.Job instance at 0x7fb2ecb83e10>,7,13,[3 5],8,-1,21,-1,8
1,<environment.Job instance at 0x7fb2ecb83d70>,3,27,[9 4],4,-1,37,-1,10
1,<environment.Job instance at 0x7fb2ecb839b0>,9,18,[5 1],10,-1,31,-1,13
1,<environment.Job instance at 0x7fb2ede3f5a0>,13,18,[6 1],14,-1,32,-1,14
1,<environment.Job instance at 0x7fb2ede3f550>,15,15,[4 9],16,-1,31,-1,16
1,<environment.Job instance at 0x7fb2ecb83b90>,12,17,[5 9],13,-1,35,-1,18
1,<environment.Job instance at 0x7fb2ece6fdc0>,17,17,[3 7],18,-1,35,-1,18
1,<environment.Job instance at 0x7fb2ecb835f0>,4,25,[8 2],5,-1,44,-1,19
1,<environment.Job instance at 0x7fb2ece6f370>,18,16,[8 5],19,-1,35,-1,19
1,<environment.Job instance at 0x7fb2ece6f4b0>,19,16,[5 1],20,-1,36,-1,20
1,<environment.Job instance at 0x7fb2ece6faa0>,21,12,[4 8],22,-1,34,-1,22
1,<environment.Job instance at 0x7fb2ece6fe10>,25,22,[9 4],26,-1,48,-1,26
1,<environment.Job instance at 0x7fb2edd58640>,28,14,[3 7],29,-1,43,-1,29
1,<environment.Job instance at 0x7fb2edd58d70>,29,27,[5 8],30,-1,57,-1,30
1,<environment.Job instance at 0x7fb2edd58370>,30,13,[5 8],31,-1,44,-1,31
1,<environment.Job instance at 0x7fb2edd58230>,31,12,[10  5],32,-1,44,-1,32
1,<environment.Job instance at 0x7fb2edd58870>,32,15,[ 5 10],33,-1,48,-1,33
1,<environment.Job instance at 0x7fb2edd58f50>,33,16,[5 8],34,-1,50,-1,34
1,<environment.Job instance at 0x7fb2edd58500>,35,12,[3 5],36,-1,48,-1,36
1,<environment.Job instance at 0x7fb2edd585a0>,36,22,[3 8],37,-1,59,-1,37
1,<environment.Job instance at 0x7fb2edd58eb0>,37,14,[6 2],38,-1,52,-1,38
1,<environment.Job instance at 0x7fb2ed527640>,48,17,[3 7],49,-1,66,-1,49
1,<environment.Job instance at 0x7fb2ed527af0>,50,18,[9 4],51,-1,69,-1,51
1,<environment.Job instance at 0x7fb2ed5275a0>,54,17,[14  4],55,-1,75,-1,58
1,<environment.Job instance at 0x7fb2ed5270a0>,55,2,[1 6],56,-1,60,-1,58
1,<environment.Job instance at 0x7fb2ecb83050>,10,12,[ 4 12],11,-1,70,-1,58
1,<environment.Job instance at 0x7fb2ed5273c0>,58,24,[8 2],59,-1,83,-1,59
1,<environment.Job instance at 0x7fb2edeb1910>,61,15,[10  3],62,-1,78,-1,63
1,<environment.Job instance at 0x7fb2ed527820>,62,18,[1 9],63,-1,81,-1,63
1,<environment.Job instance at 0x7fb2edeb1b90>,63,17,[6 3],64,-1,82,-1,65
1,<environment.Job instance at 0x7fb2ed8bb370>,70,14,[5 7],71,-1,87,-1,73
1,<environment.Job instance at 0x7fb2edeb10f0>,60,18,[ 2 12],61,-1,91,-1,73
1,<environment.Job instance at 0x7fb2ed8bb140>,72,18,[4 9],73,-1,91,-1,73
1,<environment.Job instance at 0x7fb2ed8bb5a0>,74,15,[9 5],75,-1,92,-1,77
1,<environment.Job instance at 0x7fb2ed8bbeb0>,76,18,[8 5],77,-1,102,-1,84
1,<environment.Job instance at 0x7fb2f6aaf280>,80,15,[9 2],81,-1,99,-1,84
1,<environment.Job instance at 0x7fb2f6aaf690>,83,26,[7 3],84,-1,111,-1,85
1,<environment.Job instance at 0x7fb2f6aafaf0>,85,12,[9 2],86,-1,98,-1,86
1,<environment.Job instance at 0x7fb2f6aaf410>,86,17,[1 8],87,-1,104,-1,87
1,<environment.Job instance at 0x7fb2edacb3c0>,89,13,[9 5],90,-1,104,-1,91
1,<environment.Job instance at 0x7fb2edacbd70>,91,17,[3 7],92,-1,109,-1,92
1,<environment.Job instance at 0x7fb2edacb190>,90,15,[2 8],91,-1,109,-1,94
1,<environment.Job instance at 0x7fb2ed5275f0>,3,27,[9 4],4,-1,44,-1,17
1,<environment.Job instance at 0x7fb2ed8bbcd0>,4,25,[8 2],5,-1,42,-1,17
1,<environment.Job instance at 0x7fb2f6aaf460>,10,12,[ 4 12],11,-1,29,-1,17
1,<environment.Job instance at 0x7fb2ee0e1460>,29,27,[5 8],30,-1,98,-1,71
1,<environment.Job instance at 0x7fb2edd58050>,45,15,[13  3],46,-1,127,-1,112
1,<environment.Job instance at 0x7fb2ed300f50>,52,1,[14  1],53,-1,135,-1,134
1,<environment.Job instance at 0x7fb2eddaa870>,54,17,[14  4],55,-1,157,-1,140
1,<environment.Job instance at 0x7fb2eddaafa0>,58,24,[8 2],59,-1,179,-1,155
1,<environment.Job instance at 0x7fb2ece6ffa0>,59,27,[ 3 13],60,-1,182,-1,155
1,<environment.Job instance at 0x7fb2ed0e4f00>,60,18,[ 2 12],61,-1,173,-1,155
1,<environment.Job instance at 0x7fb2ece6f780>,66,24,[13  3],67,-1,203,-1,179
1,<environment.Job instance at 0x7fb2ecb56190>,83,26,[7 3],84,-1,274,-1,248
1,<environment.Job instance at 0x7fb2eddefc30>,87,27,[1 8],88,-1,305,-1,278
1,<environment.Job instance at 0x7fb2edb38dc0>,100,26,[2 8],101,-1,352,-1,326
1,<environment.Job instance at 0x7fb2ecbc7320>,0,20,[7 1],1,-1,22,-1,2
1,<environment.Job instance at 0x7fb2ecbc72d0>,1,14,[9 4],2,-1,16,-1,2
1,<environment.Job instance at 0x7fb2ecbc70f0>,3,17,[3 7],4,-1,21,-1,4
1,<environment.Job instance at 0x7fb2ecc304b0>,11,16,[9 2],12,-1,30,-1,14
1,<environment.Job instance at 0x7fb2ee41d4b0>,23,17,[7 2],24,-1,53,-1,36
1,<environment.Job instance at 0x7fb2ee41da00>,26,14,[9 1],27,-1,50,-1,36
1,<environment.Job instance at 0x7fb2ecc30af0>,17,17,[9 1],18,-1,53,-1,36
1,<environment.Job instance at 0x7fb2ee41d0f0>,27,15,[2 5],28,-1,51,-1,36
1,<environment.Job instance at 0x7fb2f6a05f00>,31,14,[ 2 10],32,-1,51,-1,37
1,<environment.Job instance at 0x7fb2f69c7410>,33,18,[8 3],34,-1,55,-1,37
1,<environment.Job instance at 0x7fb2f69c7320>,35,25,[6 2],36,-1,72,-1,47
1,<environment.Job instance at 0x7fb2ee3f9b40>,30,12,[8 4],31,-1,59,-1,47
1,<environment.Job instance at 0x7fb2ee41db40>,25,24,[7 4],26,-1,71,-1,47
1,<environment.Job instance at 0x7fb2f69c7460>,40,2,[5 2],41,-1,49,-1,47
1,<environment.Job instance at 0x7fb2f69c77d0>,42,15,[4 5],43,-1,62,-1,47
1,<environment.Job instance at 0x7fb2ee39daf0>,46,26,[10  2],47,-1,74,-1,48
1,<environment.Job instance at 0x7fb2ee3f4a50>,47,17,[8 3],48,-1,69,-1,52
1,<environment.Job instance at 0x7fb2ee3f4c30>,48,14,[9 3],49,-1,66,-1,52
1,<environment.Job instance at 0x7fb2ee3f4d70>,50,17,[8 5],51,-1,72,-1,55
1,<environment.Job instance at 0x7fb2ee3f40f0>,51,15,[3 7],52,-1,71,-1,56
1,<environment.Job instance at 0x7fb2ecbb00f0>,52,21,[9 5],53,-1,77,-1,56
1,<environment.Job instance at 0x7fb2ed05e050>,62,15,[ 1 10],63,-1,102,-1,87
1,<environment.Job instance at 0x7fb2ee2bfa00>,65,18,[10  4],66,-1,105,-1,87
1,<environment.Job instance at 0x7fb2ee07b640>,61,18,[5 5],62,-1,107,-1,89
1,<environment.Job instance at 0x7fb2f6a36d70>,20,24,[ 4 14],21,-1,113,-1,89
1,<environment.Job instance at 0x7fb2ee2aa410>,66,17,[3 5],67,-1,109,-1,92
1,<environment.Job instance at 0x7fb2ed2f3140>,70,15,[10  5],71,-1,107,-1,92
1,<environment.Job instance at 0x7fb2ed321780>,71,17,[8 2],72,-1,109,-1,92
1,<environment.Job instance at 0x7fb2ee088af0>,68,28,[ 2 11],69,-1,120,-1,92
1,<environment.Job instance at 0x7fb2ed6a0cd0>,67,15,[5 9],68,-1,107,-1,92
1,<environment.Job instance at 0x7fb2ed084640>,64,18,[9 2],65,-1,115,-1,97
1,<environment.Job instance at 0x7fb2ed078050>,77,17,[2 7],78,-1,114,-1,97
1,<environment.Job instance at 0x7fb2ecce9aa0>,5,17,[ 1 11],6,-1,23,-1,6
1,<environment.Job instance at 0x7fb2edd9e640>,7,13,[12  4],8,-1,21,-1,8
1,<environment.Job instance at 0x7fb2ed592e60>,20,24,[ 4 14],21,-1,78,-1,54
1,<environment.Job instance at 0x7fb2ed67aa00>,24,14,[ 1 11],25,-1,76,-1,62
1,<environment.Job instance at 0x7fb2ed67ad70>,25,24,[7 4],26,-1,88,-1,64
1,<environment.Job instance at 0x7fb2eddbd1e0>,35,25,[6 2],36,-1,135,-1,110
1,<environment.Job instance at 0x7fb2ed699e60>,36,2,[ 1 13],37,-1,112,-1,110
1,<environment.Job instance at 0x7fb2ed1eb410>,46,26,[10  2],47,-1,170,-1,144
1,<environment.Job instance at 0x7fb2ed64eaa0>,54,1,[12  5],55,-1,176,-1,175
1,<environment.Job instance at 0x7fb2ed6628c0>,55,1,[ 2 14],56,-1,176,-1,175
1,<environment.Job instance at 0x7fb2ed1bee60>,57,2,[14  3],58,-1,177,-1,175
1,<environment.Job instance at 0x7fb2edce1c80>,68,28,[ 2 11],69,-1,239,-1,211
1,<environment.Job instance at 0x7fb2ed6a0c80>,76,15,[ 2 12],77,-1,269,-1,254
1,<environment.Job instance at 0x7fb2ed6a5230>,80,12,[ 1 11],81,-1,277,-1,265
1,<environment.Job instance at 0x7fb2edcdd5f0>,83,15,[ 5 12],84,-1,294,-1,279
1,<environment.Job instance at 0x7fb2ed676dc0>,100,17,[11  3],101,-1,374,-1,357
1,<environment.Job instance at 0x7fb2ecf449b0>,1,16,[3 9],2,-1,18,-1,2
1,<environment.Job instance at 0x7fb2ed588910>,4,16,[7 2],5,-1,22,-1,6
1,<environment.Job instance at 0x7fb2ed5888c0>,6,3,[ 2 10],7,-1,10,-1,7
1,<environment.Job instance at 0x7fb2ecf44af0>,5,14,[6 4],6,-1,21,-1,7
1,<environment.Job instance at 0x7fb2edd9e140>,11,28,[5 9],12,-1,40,-1,12
1,<environment.Job instance at 0x7fb2edd9e280>,13,28,[6 1],14,-1,42,-1,14
1,<environment.Job instance at 0x7fb2edd9ef50>,16,18,[9 2],17,-1,35,-1,17
1,<environment.Job instance at 0x7fb2edd9ec80>,17,16,[10  4],18,-1,35,-1,19
1,<environment.Job instance at 0x7fb2ed588c30>,18,23,[ 3 10],19,-1,42,-1,19
1,<environment.Job instance at 0x7fb2edd9e730>,19,17,[4 5],20,-1,37,-1,20
1,<environment.Job instance at 0x7fb2edd9e230>,22,14,[4 6],23,-1,37,-1,23
1,<environment.Job instance at 0x7fb2edd9e460>,23,18,[ 5 11],24,-1,42,-1,24
1,<environment.Job instance at 0x7fb2ecfa0640>,27,19,[6 3],28,-1,47,-1,28
1,<environment.Job instance at 0x7fb2ecfa0e60>,32,18,[6 5],33,-1,51,-1,33
1,<environment.Job instance at 0x7fb2ecfa0460>,36,22,[3 7],37,-1,59,-1,37
1,<environment.Job instance at 0x7fb2ecfa0aa0>,37,21,[5 3],38,-1,62,-1,41
1,<environment.Job instance at 0x7fb2ece295a0>,41,14,[9 4],42,-1,56,-1,42
1,<environment.Job instance at 0x7fb2ece29dc0>,40,17,[9 5],41,-1,61,-1,44
1,<environment.Job instance at 0x7fb2ece298c0>,44,18,[6 5],45,-1,63,-1,45
1,<environment.Job instance at 0x7fb2ece296e0>,48,18,[1 8],49,-1,68,-1,50
1,<environment.Job instance at 0x7fb2ece29a00>,50,15,[4 9],51,-1,66,-1,51
1,<environment.Job instance at 0x7fb2ece292d0>,54,13,[3 8],55,-1,68,-1,55
1,<environment.Job instance at 0x7fb2ed930910>,57,16,[2 6],58,-1,74,-1,58
1,<environment.Job instance at 0x7fb2ed930a00>,58,17,[7 4],59,-1,76,-1,59
1,<environment.Job instance at 0x7fb2ed930690>,60,12,[4 8],61,-1,74,-1,62
1,<environment.Job instance at 0x7fb2edda54b0>,62,20,[1 9],63,-1,83,-1,63
1,<environment.Job instance at 0x7fb2edda5640>,63,18,[3 7],64,-1,82,-1,64
1,<environment.Job instance at 0x7fb2edda5b40>,66,18,[3 6],67,-1,85,-1,67
1,<environment.Job instance at 0x7fb2edda5280>,68,17,[2 5],69,-1,86,-1,69
1,<environment.Job instance at 0x7fb2edda5500>,74,18,[2 9],75,-1,93,-1,75
1,<environment.Job instance at 0x7fb2ee0710f0>,75,26,[5 5],76,-1,102,-1,76
1,<environment.Job instance at 0x7fb2ee0713c0>,77,15,[8 4],78,-1,103,-1,88
1,<environment.Job instance at 0x7fb2ed69ad70>,101,16,[ 2 10],102,-1,227,-1,211
1,<environment.Job instance at 0x7fb2ee071f00>,84,25,[9 4],85,-1,237,-1,212
1,<environment.Job instance at 0x7fb2ed69a910>,105,16,[10  3],106,-1,231,-1,215
1,<environment.Job instance at 0x7fb2ed69af50>,102,22,[2 7],103,-1,237,-1,215
1,<environment.Job instance at 0x7fb2ed69a370>,106,18,[8 3],107,-1,236,-1,218
1,<environment.Job instance at 0x7fb2ece29d20>,7,24,[8 1],8,-1,40,-1,16
1,<environment.Job instance at 0x7fb2edda5780>,11,28,[5 9],12,-1,51,-1,23
1,<environment.Job instance at 0x7fb2edcf6e60>,13,28,[6 1],14,-1,54,-1,26
1,<environment.Job instance at 0x7fb2ee06cd70>,18,23,[ 3 10],19,-1,55,-1,32
1,<environment.Job instance at 0x7fb2ecf44d20>,23,18,[ 5 11],24,-1,65,-1,47
1,<environment.Job instance at 0x7fb2edd9e5a0>,33,1,[13  4],34,-1,80,-1,79
1,<environment.Job instance at 0x7fb2edd9e2d0>,34,17,[12  2],35,-1,96,-1,79
1,<environment.Job instance at 0x7fb2ecb1e0f0>,46,28,[7 3],47,-1,145,-1,117
1,<environment.Job instance at 0x7fb2edd397d0>,55,16,[ 4 14],56,-1,156,-1,140
1,<environment.Job instance at 0x7fb2ed3146e0>,67,26,[ 2 12],68,-1,213,-1,187
1,<environment.Job instance at 0x7fb2ece87d70>,69,1,[ 3 12],70,-1,191,-1,190
1,<environment.Job instance at 0x7fb2edf6e6e0>,72,3,[11  1],73,-1,210,-1,207
1,<environment.Job instance at 0x7fb2ed316fa0>,75,26,[5 5],76,-1,236,-1,210
1,<environment.Job instance at 0x7fb2ed6ccaa0>,84,25,[9 4],85,-1,289,-1,264
1,<environment.Job instance at 0x7fb2ed6ccd70>,90,25,[9 5],91,-1,292,-1,267
1,<environment.Job instance at 0x7fb2ed6db230>,91,3,[11  1],92,-1,270,-1,267
1,<environment.Job instance at 0x7fb2ed6db910>,92,3,[12  5],93,-1,270,-1,267
1,<environment.Job instance at 0x7fb2ed281460>,100,26,[10  1],101,-1,324,-1,298
1,<environment.Job instance at 0x7fb2ed938730>,0,15,[9 4],1,-1,17,-1,2
1,<environment.Job instance at 0x7fb2ee071a50>,1,14,[8 1],2,-1,16,-1,2
1,<environment.Job instance at 0x7fb2ed938410>,2,17,[9 5],3,-1,20,-1,3
1,<environment.Job instance at 0x7fb2ed3be910>,4,18,[6 4],5,-1,23,-1,5
1,<environment.Job instance at 0x7fb2edae1320>,7,25,[6 4],8,-1,33,-1,8
1,<environment.Job instance at 0x7fb2edae15a0>,9,25,[10  1],10,-1,35,-1,10
1,<environment.Job instance at 0x7fb2ed882410>,13,18,[10  5],14,-1,32,-1,14
1,<environment.Job instance at 0x7fb2ed882870>,18,16,[8 2],19,-1,35,-1,19
1,<environment.Job instance at 0x7fb2ed882a50>,21,21,[4 7],22,-1,43,-1,22
1,<environment.Job instance at 0x7fb2ed882d20>,25,17,[4 6],26,-1,43,-1,26
1,<environment.Job instance at 0x7fb2ed88f050>,27,13,[ 2 10],28,-1,41,-1,28
1,<environment.Job instance at 0x7fb2ed88f550>,30,18,[7 3],31,-1,49,-1,31
1,<environment.Job instance at 0x7fb2ed88f640>,31,26,[5 4],32,-1,58,-1,32
1,<environment.Job instance at 0x7fb2ed882140>,10,14,[ 1 14],11,-1,47,-1,33
1,<environment.Job instance at 0x7fb2ed88f460>,32,1,[10  4],33,-1,34,-1,33
1,<environment.Job instance at 0x7fb2ed88f730>,34,15,[6 1],35,-1,50,-1,35
1,<environment.Job instance at 0x7fb2ed88f690>,33,1,[6 5],34,-1,36,-1,35
1,<environment.Job instance at 0x7fb2ed88f7d0>,35,17,[2 7],36,-1,53,-1,36
1,<environment.Job instance at 0x7fb2ed88f910>,36,17,[5 2],37,-1,55,-1,38
1,<environment.Job instance at 0x7fb2ed88f870>,37,18,[1 7],38,-1,56,-1,38
1,<environment.Job instance at 0x7fb2ed88fb90>,40,22,[ 3 10],41,-1,66,-1,44
1,<environment.Job instance at 0x7fb2ed8a3870>,51,16,[5 4],52,-1,68,-1,52
1,<environment.Job instance at 0x7fb2ed8a39b0>,52,18,[2 9],53,-1,71,-1,53
1,<environment.Job instance at 0x7fb2ed8a3780>,53,14,[3 7],54,-1,68,-1,54
1,<environment.Job instance at 0x7fb2ed8890a0>,59,13,[3 8],60,-1,73,-1,60
1,<environment.Job instance at 0x7fb2ecbc7410>,63,18,[5 5],64,-1,82,-1,64
1,<environment.Job instance at 0x7fb2ed3be870>,64,16,[10  2],65,-1,82,-1,66
1,<environment.Job instance at 0x7fb2ed89e960>,66,16,[5 6],67,-1,83,-1,67
1,<environment.Job instance at 0x7fb2ed3ce280>,72,15,[5 5],73,-1,88,-1,73
1,<environment.Job instance at 0x7fb2ed3cea00>,73,12,[9 5],74,-1,86,-1,74
1,<environment.Job instance at 0x7fb2ed3cecd0>,74,18,[ 3 10],75,-1,93,-1,75
1,<environment.Job instance at 0x7fb2ed3ce6e0>,75,14,[5 8],76,-1,90,-1,76
1,<environment.Job instance at 0x7fb2edfad410>,77,17,[3 7],78,-1,95,-1,78
1,<environment.Job instance at 0x7fb2edfad4b0>,78,16,[7 5],79,-1,95,-1,79
1,<environment.Job instance at 0x7fb2ed4c92d0>,79,20,[5 5],80,-1,100,-1,80
1,<environment.Job instance at 0x7fb2ed2cdeb0>,85,15,[1 9],86,-1,101,-1,86
1,<environment.Job instance at 0x7fb2ed5c5a00>,86,18,[1 8],87,-1,105,-1,87
1,<environment.Job instance at 0x7fb2ed2c7fa0>,91,14,[10  5],92,-1,107,-1,93
1,<environment.Job instance at 0x7fb2eccd24b0>,93,13,[7 4],94,-1,107,-1,94
1,<environment.Job instance at 0x7fb2eccd2190>,94,3,[3 5],95,-1,98,-1,95
1,<environment.Job instance at 0x7fb2eccc4690>,95,15,[7 2],96,-1,111,-1,96
1,<environment.Job instance at 0x7fb2ed8a35f0>,5,27,[5 8],6,-1,43,-1,16
1,<environment.Job instance at 0x7fb2ed8a30a0>,7,25,[6 4],8,-1,41,-1,16
1,<environment.Job instance at 0x7fb2ed8a3e10>,10,14,[ 1 14],11,-1,31,-1,17
1,<environment.Job instance at 0x7fb2ed5db870>,9,25,[10  1],10,-1,68,-1,43
1,<environment.Job instance at 0x7fb2ed0da8c0>,31,26,[5 4],32,-1,97,-1,71
1,<environment.Job instance at 0x7fb2eccb75f0>,38,26,[ 3 10],39,-1,128,-1,102
1,<environment.Job instance at 0x7fb2ecdfce60>,57,3,[ 5 11],58,-1,147,-1,144
1,<environment.Job instance at 0x7fb2ed4fa500>,61,18,[ 3 14],62,-1,176,-1,158
1,<environment.Job instance at 0x7fb2ed93bd20>,68,13,[14  3],69,-1,198,-1,185
1,<environment.Job instance at 0x7fb2ecf36c80>,87,2,[13  4],88,-1,261,-1,259
1,<environment.Job instance at 0x7fb2ee3893c0>,96,13,[13  5],97,-1,304,-1,291
1,<environment.Job instance at 0x7fb2ee3895f0>,97,28,[8 2],98,-1,334,-1,306
1,<environment.Job instance at 0x7fb2ee38f0f0>,100,17,[14  5],101,-1,323,-1,306
1,<environment.Job instance at 0x7fb2ed6a41e0>,101,14,[13  2],102,-1,320,-1,306
1,<environment.Job instance at 0x7fb2ee3324b0>,0,22,[9 5],1,-1,23,-1,1
1,<environment.Job instance at 0x7fb2edc959b0>,2,27,[8 4],3,-1,30,-1,3
1,<environment.Job instance at 0x7fb2edc95dc0>,6,14,[8 5],7,-1,22,-1,8
1,<environment.Job instance at 0x7fb2ee2ca820>,7,17,[1 5],8,-1,25,-1,8
1,<environment.Job instance at 0x7fb2edc95a00>,8,18,[8 4],9,-1,27,-1,9
1,<environment.Job instance at 0x7fb2ecece500>,13,25,[ 4 10],14,-1,39,-1,14
1,<environment.Job instance at 0x7fb2ecece5a0>,22,17,[4 5],23,-1,40,-1,23
1,<environment.Job instance at 0x7fb2ecece8c0>,23,19,[8 5],24,-1,43,-1,24
1,<environment.Job instance at 0x7fb2ee3e6dc0>,29,22,[3 7],30,-1,52,-1,30
1,<environment.Job instance at 0x7fb2ee3e62d0>,30,16,[6 4],31,-1,47,-1,31
1,<environment.Job instance at 0x7fb2ee3e65f0>,35,16,[5 5],36,-1,52,-1,36
1,<environment.Job instance at 0x7fb2ee3e6fa0>,36,20,[5 3],37,-1,57,-1,37
1,<environment.Job instance at 0x7fb2ede814b0>,40,21,[5 4],41,-1,62,-1,41
1,<environment.Job instance at 0x7fb2ede813c0>,42,18,[9 2],43,-1,61,-1,43
1,<environment.Job instance at 0x7fb2ede81640>,46,16,[5 8],47,-1,63,-1,47
1,<environment.Job instance at 0x7fb2ede81e10>,48,16,[6 3],49,-1,65,-1,49
1,<environment.Job instance at 0x7fb2ede81050>,50,17,[10  5],51,-1,68,-1,51
1,<environment.Job instance at 0x7fb2ede815a0>,53,14,[8 3],54,-1,70,-1,56
1,<environment.Job instance at 0x7fb2edf46fa0>,56,16,[10  4],57,-1,73,-1,57
1,<environment.Job instance at 0x7fb2edf46e60>,58,14,[10  3],59,-1,73,-1,59
1,<environment.Job instance at 0x7fb2ede81320>,55,17,[9 4],56,-1,76,-1,59
1,<environment.Job instance at 0x7fb2edf46f00>,62,18,[3 6],63,-1,81,-1,63
1,<environment.Job instance at 0x7fb2edf465a0>,63,16,[5 8],64,-1,80,-1,64
1,<environment.Job instance at 0x7fb2edf460a0>,68,18,[2 8],69,-1,87,-1,69
1,<environment.Job instance at 0x7fb2eded52d0>,70,15,[5 9],71,-1,86,-1,71
1,<environment.Job instance at 0x7fb2eded53c0>,71,18,[8 4],72,-1,90,-1,72
1,<environment.Job instance at 0x7fb2eded5500>,72,17,[5 3],73,-1,90,-1,73
1,<environment.Job instance at 0x7fb2eded5550>,73,18,[4 6],74,-1,92,-1,74
1,<environment.Job instance at 0x7fb2eded5c30>,80,16,[7 5],81,-1,102,-1,86
1,<environment.Job instance at 0x7fb2ecbd2140>,85,28,[5 5],86,-1,115,-1,87
1,<environment.Job instance at 0x7fb2ecbd2410>,86,15,[6 4],87,-1,104,-1,89
1,<environment.Job instance at 0x7fb2ecbd2c80>,89,18,[1 5],90,-1,108,-1,90
1,<environment.Job instance at 0x7fb2ede81730>,54,13,[10  2],55,-1,103,-1,90
1,<environment.Job instance at 0x7fb2ecbd2d20>,91,21,[4 8],92,-1,115,-1,94
1,<environment.Job instance at 0x7fb2ed911c30>,93,16,[10  5],94,-1,110,-1,94
1,<environment.Job instance at 0x7fb2ececee60>,2,27,[8 4],3,-1,50,-1,23
1,<environment.Job instance at 0x7fb2ede81b40>,12,1,[ 1 13],13,-1,24,-1,23
1,<environment.Job instance at 0x7fb2edf46820>,15,17,[11  2],16,-1,54,-1,37
1,<environment.Job instance at 0x7fb2edf46b90>,13,25,[ 4 10],14,-1,65,-1,40
1,<environment.Job instance at 0x7fb2ee3997d0>,19,21,[14  3],20,-1,61,-1,40
1,<environment.Job instance at 0x7fb2ee3893c0>,37,1,[ 2 11],38,-1,77,-1,76
1,<environment.Job instance at 0x7fb2ecf36f50>,44,17,[11  1],45,-1,109,-1,92
1,<environment.Job instance at 0x7fb2ecb834b0>,57,3,[ 5 11],58,-1,159,-1,156
1,<environment.Job instance at 0x7fb2edcf60a0>,74,12,[13  3],75,-1,263,-1,251
1,<environment.Job instance at 0x7fb2f6ff48c0>,85,28,[5 5],86,-1,321,-1,293
1,<environment.Job instance at 0x7fb2ed4c9c30>,90,12,[ 4 14],91,-1,319,-1,307
1,<environment.Job instance at 0x7fb2ed882230>,98,1,[ 1 11],99,-1,338,-1,337
1,<environment.Job instance at 0x7fb2ede94190>,0,28,[4 7],1,-1,29,-1,1
1,<environment.Job instance at 0x7fb2ecdfd9b0>,11,15,[4 5],12,-1,28,-1,13
1,<environment.Job instance at 0x7fb2f6f2dd20>,12,16,[10  5],13,-1,29,-1,13
1,<environment.Job instance at 0x7fb2ecdfd500>,14,13,[6 3],15,-1,29,-1,16
1,<environment.Job instance at 0x7fb2ecdfd280>,16,12,[3 9],17,-1,29,-1,17
1,<environment.Job instance at 0x7fb2ecdfd190>,18,18,[2 9],19,-1,37,-1,19
1,<environment.Job instance at 0x7fb2ecdfdfa0>,15,15,[10  3],16,-1,34,-1,19
1,<environment.Job instance at 0x7fb2ecdfd960>,19,17,[6 4],20,-1,37,-1,20
1,<environment.Job instance at 0x7fb2ece16a00>,21,16,[ 4 10],22,-1,38,-1,22
1,<environment.Job instance at 0x7fb2ed911780>,26,16,[7 1],27,-1,44,-1,28
1,<environment.Job instance at 0x7fb2ed33a5f0>,28,17,[ 1 10],29,-1,46,-1,29
1,<environment.Job instance at 0x7fb2edd04dc0>,29,15,[7 2],30,-1,45,-1,30
1,<environment.Job instance at 0x7fb2ee34e640>,35,16,[5 2],36,-1,52,-1,36
1,<environment.Job instance at 0x7fb2eddbd140>,40,14,[3 8],41,-1,55,-1,41
1,<environment.Job instance at 0x7fb2eddbd500>,41,16,[6 5],42,-1,58,-1,42
1,<environment.Job instance at 0x7fb2ece057d0>,44,17,[4 9],45,-1,62,-1,45
1,<environment.Job instance at 0x7fb2f6d7edc0>,45,17,[ 5 10],46,-1,63,-1,46
1,<environment.Job instance at 0x7fb2f6d7e370>,46,13,[7 5],47,-1,60,-1,47
1,<environment.Job instance at 0x7fb2edbe21e0>,49,18,[9 4],50,-1,68,-1,50
1,<environment.Job instance at 0x7fb2edf69be0>,59,16,[4 9],60,-1,77,-1,61
1,<environment.Job instance at 0x7fb2eda22500>,63,17,[9 1],64,-1,84,-1,67
1,<environment.Job instance at 0x7fb2ed38eb90>,67,18,[7 5],68,-1,86,-1,68
1,<environment.Job instance at 0x7fb2ed38eaa0>,69,18,[ 3 10],70,-1,88,-1,70
1,<environment.Job instance at 0x7fb2ed38e910>,71,18,[5 9],72,-1,90,-1,72
1,<environment.Job instance at 0x7fb2edaad280>,73,17,[8 4],74,-1,92,-1,75
1,<environment.Job instance at 0x7fb2ed38ed70>,72,14,[9 2],73,-1,89,-1,75
1,<environment.Job instance at 0x7fb2ecc4b5f0>,75,18,[9 4],76,-1,94,-1,76
1,<environment.Job instance at 0x7fb2ed077d70>,76,25,[6 2],77,-1,103,-1,78
1,<environment.Job instance at 0x7fb2ed38e320>,74,24,[8 1],75,-1,104,-1,80
1,<environment.Job instance at 0x7fb2ecef5c80>,79,17,[7 1],80,-1,100,-1,83
1,<environment.Job instance at 0x7fb2edb3f730>,83,15,[3 8],84,-1,99,-1,84
1,<environment.Job instance at 0x7fb2ed612aa0>,85,18,[3 6],86,-1,104,-1,86
1,<environment.Job instance at 0x7fb2ecf1bcd0>,86,12,[10  1],87,-1,104,-1,92
1,<environment.Job instance at 0x7fb2ecdfd5f0>,0,28,[4 7],1,-1,29,-1,1
1,<environment.Job instance at 0x7fb2ecdfd820>,1,15,[ 5 14],2,-1,17,-1,2
1,<environment.Job instance at 0x7fb2ecdfdb40>,3,14,[ 3 11],4,-1,18,-1,4
1,<environment.Job instance at 0x7fb2ececb0a0>,17,17,[ 4 14],18,-1,52,-1,35
1,<environment.Job instance at 0x7fb2eded5b90>,51,16,[14  3],52,-1,168,-1,152
1,<environment.Job instance at 0x7fb2eded5be0>,52,3,[ 1 14],53,-1,155,-1,152
1,<environment.Job instance at 0x7fb2ecee9f00>,66,3,[ 5 11],67,-1,199,-1,196
1,<environment.Job instance at 0x7fb2ed329a50>,74,24,[8 1],75,-1,270,-1,246
1,<environment.Job instance at 0x7fb2ecc6d320>,76,25,[6 2],77,-1,271,-1,246
1,<environment.Job instance at 0x7fb2ecc6d820>,92,24,[8 2],93,-1,351,-1,327
1,<environment.Job instance at 0x7fb2ecc6dc80>,97,12,[13  5],98,-1,341,-1,329
1,<environment.Job instance at 0x7fb2ecfe0f00>,102,2,[ 1 12],103,-1,345,-1,343
1,<environment.Job instance at 0x7fb2ecd18320>,1,16,[5 9],2,-1,18,-1,2
1,<environment.Job instance at 0x7fb2ed41fa50>,2,17,[7 4],3,-1,20,-1,3
1,<environment.Job instance at 0x7fb2ed41fd20>,6,17,[10  4],7,-1,24,-1,7
1,<environment.Job instance at 0x7fb2ed41fb90>,8,14,[ 5 11],9,-1,23,-1,9
1,<environment.Job instance at 0x7fb2ed41ffa0>,9,17,[1 7],10,-1,27,-1,10
1,<environment.Job instance at 0x7fb2ed41ff00>,10,14,[2 6],11,-1,25,-1,11
1,<environment.Job instance at 0x7fb2ed412140>,12,18,[ 1 10],13,-1,31,-1,13
1,<environment.Job instance at 0x7fb2ed412320>,13,15,[1 5],14,-1,29,-1,14
1,<environment.Job instance at 0x7fb2ed412230>,14,12,[9 4],15,-1,27,-1,15
1,<environment.Job instance at 0x7fb2ed412370>,15,18,[6 1],16,-1,34,-1,16
1,<environment.Job instance at 0x7fb2ed412410>,16,15,[4 7],17,-1,32,-1,17
1,<environment.Job instance at 0x7fb2ed412550>,18,17,[9 3],19,-1,38,-1,21
1,<environment.Job instance at 0x7fb2ed412640>,20,14,[10  1],21,-1,35,-1,21
1,<environment.Job instance at 0x7fb2ed412870>,22,18,[10  1],23,-1,42,-1,24
1,<environment.Job instance at 0x7fb2ed412820>,24,27,[1 7],25,-1,52,-1,25
1,<environment.Job instance at 0x7fb2ed412aa0>,25,1,[10  2],26,-1,27,-1,26
1,<environment.Job instance at 0x7fb2ed412b40>,26,13,[4 6],27,-1,40,-1,27
1,<environment.Job instance at 0x7fb2ed412960>,23,15,[7 2],24,-1,42,-1,27
1,<environment.Job instance at 0x7fb2ed412c80>,28,17,[3 6],29,-1,46,-1,29
1,<environment.Job instance at 0x7fb2ed428140>,32,15,[4 7],33,-1,48,-1,33
1,<environment.Job instance at 0x7fb2ed4282d0>,33,14,[9 2],34,-1,48,-1,34
1,<environment.Job instance at 0x7fb2ed4285a0>,36,16,[1 9],37,-1,54,-1,38
1,<environment.Job instance at 0x7fb2ed428aa0>,40,13,[4 7],41,-1,54,-1,41
1,<environment.Job instance at 0x7fb2ed428af0>,41,18,[4 6],42,-1,60,-1,42
1,<environment.Job instance at 0x7fb2ed428eb0>,45,13,[10  4],46,-1,59,-1,46
1,<environment.Job instance at 0x7fb2ed428b40>,46,19,[5 4],47,-1,66,-1,47
1,<environment.Job instance at 0x7fb2ed41d0a0>,47,17,[1 8],48,-1,65,-1,48
1,<environment.Job instance at 0x7fb2ed41d140>,48,18,[4 6],49,-1,67,-1,49
1,<environment.Job instance at 0x7fb2ed41d1e0>,49,13,[8 2],50,-1,63,-1,50
1,<environment.Job instance at 0x7fb2ed41d460>,52,14,[5 6],53,-1,67,-1,53
1,<environment.Job instance at 0x7fb2ed41d5f0>,53,18,[10  1],54,-1,72,-1,54
1,<environment.Job instance at 0x7fb2ed41d370>,54,15,[9 3],55,-1,71,-1,56
1,<environment.Job instance at 0x7fb2ed41d780>,56,17,[ 2 10],57,-1,74,-1,57
1,<environment.Job instance at 0x7fb2ed41d820>,57,3,[9 2],58,-1,61,-1,58
1,<environment.Job instance at 0x7fb2ed41d8c0>,58,3,[9 1],59,-1,62,-1,59
1,<environment.Job instance at 0x7fb2ed41d960>,59,16,[ 1 13],60,-1,76,-1,60
1,<environment.Job instance at 0x7fb2ed41daa0>,61,16,[9 3],62,-1,78,-1,62
1,<environment.Job instance at 0x7fb2ed41dc80>,62,15,[ 2 12],63,-1,78,-1,63
1,<environment.Job instance at 0x7fb2ed41db40>,63,3,[3 7],64,-1,67,-1,64
1,<environment.Job instance at 0x7fb2ed41dd20>,64,14,[5 8],65,-1,79,-1,65
1,<environment.Job instance at 0x7fb2ed41d640>,55,16,[ 5 13],56,-1,81,-1,65
1,<environment.Job instance at 0x7fb2ed4131e0>,69,23,[9 3],70,-1,95,-1,72
1,<environment.Job instance at 0x7fb2ed413550>,72,16,[7 2],73,-1,89,-1,73
1,<environment.Job instance at 0x7fb2ed4137d0>,75,14,[ 2 10],76,-1,90,-1,76
1,<environment.Job instance at 0x7fb2ed4132d0>,71,15,[7 4],72,-1,91,-1,76
1,<environment.Job instance at 0x7fb2ed4135a0>,77,18,[2 7],78,-1,96,-1,78
1,<environment.Job instance at 0x7fb2ed413be0>,80,22,[9 3],81,-1,104,-1,82
1,<environment.Job instance at 0x7fb2ed413f00>,84,15,[7 5],85,-1,100,-1,85
1,<environment.Job instance at 0x7fb2ed404280>,87,22,[7 3],88,-1,110,-1,88
1,<environment.Job instance at 0x7fb2ed404820>,93,15,[3 8],94,-1,110,-1,95
1,<environment.Job instance at 0x7fb2ed404be0>,98,14,[5 9],99,-1,113,-1,99
1,<environment.Job instance at 0x7fb2ed404d70>,99,18,[5 9],100,-1,119,-1,101
1,<environment.Job instance at 0x7fb2ed412f00>,8,14,[ 5 11],9,-1,32,-1,18
1,<environment.Job instance at 0x7fb2f6bb29b0>,24,27,[1 7],25,-1,124,-1,97
1,<environment.Job instance at 0x7fb2ecee9370>,55,16,[ 5 13],56,-1,243,-1,227
1,<environment.Job instance at 0x7fb2ecee9b40>,59,16,[ 1 13],60,-1,261,-1,245
1,<environment.Job instance at 0x7fb2ecece0a0>,62,15,[ 2 12],63,-1,263,-1,248
1,<environment.Job instance at 0x7fb2ee3e6370>,66,17,[11  2],67,-1,281,-1,264
1,<environment.Job instance at 0x7fb2eded5870>,69,23,[9 3],70,-1,305,-1,282
1,<environment.Job instance at 0x7fb2f6c587d0>,78,12,[ 1 13],79,-1,315,-1,303
1,<environment.Job instance at 0x7fb2f6c58280>,82,12,[ 4 14],83,-1,333,-1,321
1,<environment.Job instance at 0x7fb2ee182a50>,81,28,[1 5],82,-1,349,-1,321
1,<environment.Job instance at 0x7fb2ece297d0>,86,14,[11  1],87,-1,335,-1,321
1,<environment.Job instance at 0x7fb2ed1a0dc0>,94,2,[14  4],95,-1,355,-1,353
1,<environment.Job instance at 0x7fb2ee0e5500>,95,3,[14  3],96,-1,356,-1,353
1,<environment.Job instance at 0x7fb2ecb70230>,96,18,[12  4],97,-1,371,-1,353
1,<environment.Job instance at 0x7fb2ee44b6e0>,97,3,[ 4 13],98,-1,356,-1,353
1,<environment.Job instance at 0x7fb2ed612820>,101,27,[6 5],102,-1,409,-1,382
1,<environment.Job instance at 0x7fb2ed9111e0>,103,3,[ 1 13],104,-1,385,-1,382
1,<environment.Job instance at 0x7fb2edbe2d20>,106,16,[ 1 12],107,-1,399,-1,383
1,<environment.Job instance at 0x7fb2ece05dc0>,108,25,[10  1],109,-1,440,-1,415
1,<environment.Job instance at 0x7f458bdeaaf0>,2,14,[ 2 10],3,-1,18,-1,4
1,<environment.Job instance at 0x7f458bdea9b0>,4,13,[3 6],5,-1,18,-1,5
1,<environment.Job instance at 0x7f458bdeacd0>,6,15,[2 8],7,-1,22,-1,7
1,<environment.Job instance at 0x7f458bdeae10>,7,14,[7 5],8,-1,22,-1,8
1,<environment.Job instance at 0x7f458bdeae60>,8,17,[1 8],9,-1,26,-1,9
1,<environment.Job instance at 0x7f45953da8c0>,3,22,[2 5],4,-1,31,-1,9
1,<environment.Job instance at 0x7f458bdeafa0>,10,22,[8 1],11,-1,33,-1,11
1,<environment.Job instance at 0x7f458bded0a0>,12,23,[6 4],13,-1,36,-1,13
1,<environment.Job instance at 0x7f458bded370>,13,18,[5 9],14,-1,32,-1,14
1,<environment.Job instance at 0x7f458bded280>,14,21,[8 1],15,-1,38,-1,17
1,<environment.Job instance at 0x7f458bded460>,16,18,[7 3],17,-1,35,-1,17
1,<environment.Job instance at 0x7f458bded500>,18,26,[7 4],19,-1,45,-1,19
1,<environment.Job instance at 0x7f458bded730>,19,25,[5 9],20,-1,45,-1,20
1,<environment.Job instance at 0x7f458bded820>,21,18,[9 4],22,-1,40,-1,22
1,<environment.Job instance at 0x7f458bded870>,23,16,[6 2],24,-1,40,-1,24
1,<environment.Job instance at 0x7f458bdede60>,27,17,[4 6],28,-1,45,-1,28
1,<environment.Job instance at 0x7f458bdf00a0>,30,26,[9 4],31,-1,61,-1,35
1,<environment.Job instance at 0x7f458bdf01e0>,32,21,[5 9],33,-1,60,-1,39
1,<environment.Job instance at 0x7f458bdf04b0>,35,16,[1 9],36,-1,55,-1,39
1,<environment.Job instance at 0x7f458bdf0640>,39,14,[9 4],40,-1,54,-1,40
1,<environment.Job instance at 0x7f458bdf0f50>,45,15,[7 5],46,-1,61,-1,46
1,<environment.Job instance at 0x7f458bdf3140>,47,13,[ 3 10],48,-1,61,-1,48
1,<environment.Job instance at 0x7f458bdf3280>,48,12,[9 2],49,-1,61,-1,49
1,<environment.Job instance at 0x7f458bdf3230>,49,17,[10  2],50,-1,67,-1,50
1,<environment.Job instance at 0x7f458bdf3460>,51,2,[5 3],52,-1,54,-1,52
1,<environment.Job instance at 0x7f458bdf3820>,54,18,[7 1],55,-1,73,-1,55
1,<environment.Job instance at 0x7f458bdf0780>,37,14,[5 8],38,-1,70,-1,56
1,<environment.Job instance at 0x7f458bdf3af0>,57,16,[ 2 11],58,-1,75,-1,59
1,<environment.Job instance at 0x7f458bdf3730>,59,19,[1 7],60,-1,79,-1,60
1,<environment.Job instance at 0x7f458bdf3c80>,58,17,[3 7],59,-1,77,-1,60
1,<environment.Job instance at 0x7f458bdf3fa0>,62,14,[4 9],63,-1,78,-1,64
1,<environment.Job instance at 0x7f458bdf6370>,67,16,[1 9],68,-1,84,-1,68
1,<environment.Job instance at 0x7f458bdf6500>,69,14,[9 4],70,-1,84,-1,70
1,<environment.Job instance at 0x7f458bdf6730>,72,18,[3 5],73,-1,91,-1,73
1,<environment.Job instance at 0x7f458bdf6f00>,76,13,[10  1],77,-1,91,-1,78
1,<environment.Job instance at 0x7f458bdf4140>,79,19,[10  3],80,-1,99,-1,80
1,<environment.Job instance at 0x7f458bdf6eb0>,77,16,[8 1],78,-1,97,-1,81
1,<environment.Job instance at 0x7f458bdf44b0>,81,14,[8 5],82,-1,97,-1,83
1,<environment.Job instance at 0x7f458bdf4230>,82,21,[4 8],83,-1,104,-1,83
1,<environment.Job instance at 0x7f458bdf4370>,83,18,[ 3 10],84,-1,102,-1,84
1,<environment.Job instance at 0x7f458bdf4910>,87,18,[7 1],88,-1,107,-1,89
1,<environment.Job instance at 0x7f458bdf4aa0>,88,16,[4 9],89,-1,105,-1,89
1,<environment.Job instance at 0x7f458bdf4be0>,91,18,[5 4],92,-1,111,-1,93
1,<environment.Job instance at 0x7f458bdf4e60>,93,25,[ 1 10],94,-1,122,-1,97
1,<environment.Job instance at 0x7f458bde43c0>,96,18,[2 6],97,-1,120,-1,102
1,<environment.Job instance at 0x7f458bf79820>,101,15,[2 7],102,-1,118,-1,103
1,<environment.Job instance at 0x7f458bdd86e0>,103,16,[1 9],104,-1,120,-1,104
1,<environment.Job instance at 0x7f458bdf0190>,33,26,[3 6],34,-1,130,-1,104
1,<environment.Job instance at 0x7f458be5f780>,102,13,[9 4],103,-1,117,-1,104
1,<environment.Job instance at 0x7f458bf10640>,105,16,[7 5],106,-1,122,-1,106
1,<environment.Job instance at 0x7f458bde1c30>,107,18,[5 5],108,-1,126,-1,108
1,<environment.Job instance at 0x7f458bde1a50>,110,23,[5 1],111,-1,134,-1,111
1,<environment.Job instance at 0x7f458bdf6410>,12,23,[6 4],13,-1,53,-1,30
1,<environment.Job instance at 0x7f458bef5780>,18,26,[7 4],19,-1,70,-1,44
1,<environment.Job instance at 0x7f458bf0f820>,19,25,[5 9],20,-1,83,-1,58
1,<environment.Job instance at 0x7f458bf0de60>,28,17,[ 1 13],29,-1,87,-1,70
1,<environment.Job instance at 0x7f458bf0df00>,30,26,[9 4],31,-1,110,-1,84
1,<environment.Job instance at 0x7f458bf0d5f0>,31,1,[ 2 14],32,-1,85,-1,84
1,<environment.Job instance at 0x7f458be12410>,33,26,[3 6],34,-1,110,-1,84
1,<environment.Job instance at 0x7f458be12960>,40,26,[ 1 10],41,-1,139,-1,113
1,<environment.Job instance at 0x7f458be9a6e0>,57,16,[ 2 11],58,-1,183,-1,167
1,<environment.Job instance at 0x7f458bdc74b0>,89,17,[ 5 14],90,-1,289,-1,272
1,<environment.Job instance at 0x7f458bdcddc0>,93,25,[ 1 10],94,-1,320,-1,295
1,<environment.Job instance at 0x7f458bdd53c0>,109,27,[3 9],110,-1,371,-1,344
1,<environment.Job instance at 0x7f458bdd5230>,110,23,[5 1],111,-1,367,-1,344
1,<environment.Job instance at 0x7f458bdd2c80>,117,3,[ 3 13],118,-1,367,-1,364
1,<environment.Job instance at 0x7f458b5140f0>,2,18,[7 5],3,-1,26,-1,8
1,<environment.Job instance at 0x7f458b533230>,10,17,[9 5],11,-1,28,-1,11
1,<environment.Job instance at 0x7f458b517730>,12,18,[10  4],13,-1,33,-1,15
1,<environment.Job instance at 0x7f458b539320>,15,15,[8 3],16,-1,31,-1,16
1,<environment.Job instance at 0x7f458b5387d0>,26,13,[10  5],27,-1,50,-1,37
1,<environment.Job instance at 0x7f458b3ab5f0>,37,21,[10  4],38,-1,59,-1,38
1,<environment.Job instance at 0x7f458b40d050>,36,12,[1 6],37,-1,53,-1,41
1,<environment.Job instance at 0x7f458b403190>,41,12,[5 4],42,-1,54,-1,42
1,<environment.Job instance at 0x7f458b403960>,42,20,[10  5],43,-1,63,-1,43
1,<environment.Job instance at 0x7f458b3ba3c0>,35,17,[10  4],36,-1,71,-1,54
1,<environment.Job instance at 0x7f458b4130a0>,50,17,[4 7],51,-1,71,-1,54
1,<environment.Job instance at 0x7f458b4dcd20>,57,16,[8 4],58,-1,99,-1,83
1,<environment.Job instance at 0x7f458b3edfa0>,58,2,[5 7],59,-1,85,-1,83
1,<environment.Job instance at 0x7f458b502500>,54,19,[3 8],55,-1,104,-1,85
1,<environment.Job instance at 0x7f458b386d70>,67,13,[9 5],68,-1,117,-1,104
1,<environment.Job instance at 0x7f458b386c30>,70,17,[9 5],71,-1,125,-1,108
1,<environment.Job instance at 0x7f458b3865f0>,68,27,[ 3 12],69,-1,135,-1,108
1,<environment.Job instance at 0x7f458b386b90>,73,12,[1 9],74,-1,120,-1,108
1,<environment.Job instance at 0x7f458b386690>,74,26,[3 9],75,-1,134,-1,108
1,<environment.Job instance at 0x7f458b386370>,75,15,[5 3],76,-1,124,-1,109
1,<environment.Job instance at 0x7f458b386550>,66,17,[9 1],67,-1,126,-1,109
1,<environment.Job instance at 0x7f4595451050>,53,24,[3 7],54,-1,164,-1,140
1,<environment.Job instance at 0x7f458b5351e0>,80,23,[4 7],81,-1,197,-1,174
1,<environment.Job instance at 0x7f458b385a50>,98,23,[1 9],99,-1,271,-1,248
1,<environment.Job instance at 0x7f458b40d500>,46,13,[ 5 14],47,-1,261,-1,248
1,<environment.Job instance at 0x7f458b391c80>,104,15,[8 5],105,-1,263,-1,248
1,<environment.Job instance at 0x7f458b3918c0>,105,17,[12  1],106,-1,270,-1,253
1,<environment.Job instance at 0x7f458b3821e0>,97,18,[ 1 14],98,-1,308,-1,290
1,<environment.Job instance at 0x7f458b533690>,0,19,[ 5 12],1,-1,20,-1,1
1,<environment.Job instance at 0x7f458b384f50>,17,28,[ 2 10],18,-1,65,-1,37
1,<environment.Job instance at 0x7f458b699780>,22,15,[ 2 13],23,-1,55,-1,40
1,<environment.Job instance at 0x7f458b5bf500>,24,20,[13  4],25,-1,61,-1,41
1,<environment.Job instance at 0x7f458b5f1be0>,33,1,[12  5],34,-1,73,-1,72
1,<environment.Job instance at 0x7f458b57edc0>,40,24,[1 5],41,-1,114,-1,90
1,<environment.Job instance at 0x7f458b5aff50>,46,13,[ 5 14],47,-1,122,-1,109
1,<environment.Job instance at 0x7f458b5aeaf0>,53,24,[3 7],54,-1,151,-1,127
1,<environment.Job instance at 0x7f458b5b4d70>,68,27,[ 3 12],69,-1,196,-1,169
1,<environment.Job instance at 0x7f458b5abcd0>,72,15,[ 2 14],73,-1,199,-1,184
1,<environment.Job instance at 0x7f458b5b9aa0>,74,26,[3 9],75,-1,228,-1,202
1,<environment.Job instance at 0x7f458b786550>,80,23,[4 7],81,-1,231,-1,208
1,<environment.Job instance at 0x7f458b58be60>,90,1,[14  4],91,-1,250,-1,249
1,<environment.Job instance at 0x7f458b58b140>,97,18,[ 1 14],98,-1,299,-1,281
1,<environment.Job instance at 0x7f458b6c12d0>,98,23,[1 9],99,-1,320,-1,297
1,<environment.Job instance at 0x7f458b5c3a00>,105,17,[12  1],106,-1,330,-1,313
1,<environment.Job instance at 0x7f458b5616e0>,110,16,[14  3],111,-1,359,-1,343
1,<environment.Job instance at 0x7f458b5fb8c0>,117,2,[ 1 12],118,-1,363,-1,361
1,<environment.Job instance at 0x7f4595545a00>,3,13,[9 2],4,-1,17,-1,4
1,<environment.Job instance at 0x7f45955459b0>,4,13,[4 5],5,-1,18,-1,5
1,<environment.Job instance at 0x7f4595545b90>,5,27,[6 1],6,-1,33,-1,6
1,<environment.Job instance at 0x7f458b403230>,7,14,[10  3],8,-1,22,-1,8
1,<environment.Job instance at 0x7f458b403e10>,11,16,[5 8],12,-1,28,-1,12
1,<environment.Job instance at 0x7f458b403460>,12,23,[1 8],13,-1,36,-1,13
1,<environment.Job instance at 0x7f458b403870>,17,14,[10  5],18,-1,32,-1,18
1,<environment.Job instance at 0x7f458b37f500>,21,17,[10  2],22,-1,41,-1,24
1,<environment.Job instance at 0x7f458b37f730>,23,26,[5 3],24,-1,50,-1,24
1,<environment.Job instance at 0x7f458b37faf0>,25,18,[ 1 10],26,-1,45,-1,27
1,<environment.Job instance at 0x7f458b37feb0>,26,15,[6 5],27,-1,42,-1,27
1,<environment.Job instance at 0x7f458b37fdc0>,29,18,[5 2],30,-1,48,-1,30
1,<environment.Job instance at 0x7f458b37f190>,30,18,[5 8],31,-1,49,-1,31
1,<environment.Job instance at 0x7f458b37f320>,32,18,[3 8],33,-1,51,-1,33
1,<environment.Job instance at 0x7f4595543500>,36,17,[8 4],37,-1,54,-1,37
1,<environment.Job instance at 0x7f4595543a00>,37,15,[3 6],38,-1,53,-1,38
1,<environment.Job instance at 0x7f4595543870>,38,20,[5 2],39,-1,59,-1,39
1,<environment.Job instance at 0x7f458b39bb40>,39,26,[2 8],40,-1,66,-1,40
1,<environment.Job instance at 0x7f458b39b730>,40,15,[5 8],41,-1,56,-1,41
1,<environment.Job instance at 0x7f458b39b230>,41,20,[ 4 10],42,-1,62,-1,42
1,<environment.Job instance at 0x7f458b39bc30>,42,15,[9 2],43,-1,58,-1,43
1,<environment.Job instance at 0x7f458b39b460>,44,16,[7 5],45,-1,61,-1,45
1,<environment.Job instance at 0x7f458b39baa0>,47,27,[9 5],48,-1,75,-1,48
1,<environment.Job instance at 0x7f458b39b140>,53,15,[7 2],54,-1,75,-1,60
1,<environment.Job instance at 0x7f458b3ec230>,63,17,[7 4],64,-1,81,-1,64
1,<environment.Job instance at 0x7f458b3edd20>,78,14,[9 4],79,-1,99,-1,85
1,<environment.Job instance at 0x7f459554caf0>,59,15,[6 5],60,-1,103,-1,88
1,<environment.Job instance at 0x7f458b3edf00>,80,16,[8 3],81,-1,104,-1,88
1,<environment.Job instance at 0x7f45954040f0>,83,16,[ 4 10],84,-1,104,-1,88
1,<environment.Job instance at 0x7f458b3edb90>,79,18,[5 6],80,-1,108,-1,90
1,<environment.Job instance at 0x7f45955458c0>,5,27,[6 1],6,-1,41,-1,14
1,<environment.Job instance at 0x7f4595404050>,12,23,[1 8],13,-1,51,-1,28
1,<environment.Job instance at 0x7f458bc3a7d0>,23,26,[5 3],24,-1,75,-1,49
1,<environment.Job instance at 0x7f458b7e7f00>,39,26,[2 8],40,-1,139,-1,113
1,<environment.Job instance at 0x7f4595403c80>,47,27,[9 5],48,-1,174,-1,147
1,<environment.Job instance at 0x7f458b652640>,49,14,[12  2],50,-1,161,-1,147
1,<environment.Job instance at 0x7f458b6087d0>,61,17,[ 5 14],62,-1,205,-1,188
1,<environment.Job instance at 0x7f458b608a50>,62,25,[ 3 11],63,-1,213,-1,188
1,<environment.Job instance at 0x7f458b6085f0>,64,17,[13  5],65,-1,208,-1,191
1,<environment.Job instance at 0x7f458b832a50>,65,13,[ 5 14],66,-1,204,-1,191
1,<environment.Job instance at 0x7f458b6e5e60>,85,27,[4 5],86,-1,300,-1,273
1,<environment.Job instance at 0x7f458b660640>,87,12,[13  4],88,-1,285,-1,273
1,<environment.Job instance at 0x7f458b66d870>,88,12,[ 5 12],89,-1,285,-1,273
1,<environment.Job instance at 0x7f458b8334b0>,107,13,[12  1],108,-1,335,-1,322
1,<environment.Job instance at 0x7f458b833d20>,108,12,[14  3],109,-1,334,-1,322
1,<environment.Job instance at 0x7f458c46ceb0>,109,1,[ 4 11],110,-1,323,-1,322
1,<environment.Job instance at 0x7f458b424820>,116,25,[2 8],117,-1,364,-1,339
1,<environment.Job instance at 0x7f458c291cd0>,0,26,[8 3],1,-1,27,-1,1
1,<environment.Job instance at 0x7f458c291820>,5,13,[9 1],6,-1,20,-1,7
1,<environment.Job instance at 0x7f458b384c80>,6,18,[8 3],7,-1,25,-1,7
1,<environment.Job instance at 0x7f458c291140>,11,18,[5 8],12,-1,30,-1,12
1,<environment.Job instance at 0x7f458c379230>,12,14,[2 8],13,-1,27,-1,13
1,<environment.Job instance at 0x7f458c3795a0>,15,15,[1 5],16,-1,31,-1,16
1,<environment.Job instance at 0x7f458c379550>,17,13,[ 5 10],18,-1,31,-1,18
1,<environment.Job instance at 0x7f459554f730>,19,18,[5 2],20,-1,38,-1,20
1,<environment.Job instance at 0x7f459554f140>,20,16,[ 4 10],21,-1,37,-1,21
1,<environment.Job instance at 0x7f459554f5a0>,21,15,[5 7],22,-1,37,-1,22
1,<environment.Job instance at 0x7f458c28cfa0>,22,17,[8 2],23,-1,40,-1,23
1,<environment.Job instance at 0x7f458c28ca00>,26,17,[7 4],27,-1,45,-1,28
1,<environment.Job instance at 0x7f458c28caa0>,29,18,[10  4],30,-1,49,-1,31
1,<environment.Job instance at 0x7f458c28c0f0>,34,18,[10  5],35,-1,53,-1,35
1,<environment.Job instance at 0x7f458c28c0a0>,36,16,[2 9],37,-1,53,-1,37
1,<environment.Job instance at 0x7f458bec82d0>,38,15,[10  4],39,-1,54,-1,39
1,<environment.Job instance at 0x7f458bec8320>,40,16,[8 5],41,-1,57,-1,41
1,<environment.Job instance at 0x7f458bec8460>,41,16,[4 5],42,-1,58,-1,42
1,<environment.Job instance at 0x7f458bec8410>,42,27,[8 3],43,-1,70,-1,43
1,<environment.Job instance at 0x7f458bec8960>,43,18,[1 6],44,-1,62,-1,44
1,<environment.Job instance at 0x7f458bec8af0>,44,17,[2 6],45,-1,62,-1,45
1,<environment.Job instance at 0x7f458bec8690>,46,27,[2 6],47,-1,74,-1,47
1,<environment.Job instance at 0x7f458c1ffbe0>,47,16,[7 4],48,-1,64,-1,48
1,<environment.Job instance at 0x7f458c1ff690>,48,16,[9 2],49,-1,65,-1,49
1,<environment.Job instance at 0x7f458c1ff550>,60,12,[10  5],61,-1,73,-1,61
1,<environment.Job instance at 0x7f458b7821e0>,62,16,[6 4],63,-1,79,-1,63
1,<environment.Job instance at 0x7f458b782c30>,65,13,[7 4],66,-1,79,-1,66
1,<environment.Job instance at 0x7f458b782eb0>,66,21,[ 4 10],67,-1,88,-1,67
1,<environment.Job instance at 0x7f458b782d70>,67,23,[2 8],68,-1,91,-1,68
1,<environment.Job instance at 0x7f458c28ceb0>,30,15,[1 9],31,-1,85,-1,70
1,<environment.Job instance at 0x7f458baac960>,72,12,[7 5],73,-1,85,-1,73
1,<environment.Job instance at 0x7f458ba60410>,75,17,[ 5 10],76,-1,93,-1,76
1,<environment.Job instance at 0x7f458ba60f00>,76,14,[9 4],77,-1,91,-1,77
1,<environment.Job instance at 0x7f458ba60780>,80,25,[6 4],81,-1,112,-1,87
1,<environment.Job instance at 0x7f458c28c550>,0,26,[8 3],1,-1,27,-1,1
1,<environment.Job instance at 0x7f458bee1730>,14,2,[11  3],15,-1,25,-1,23
1,<environment.Job instance at 0x7f458c291a00>,25,17,[12  4],26,-1,86,-1,69
1,<environment.Job instance at 0x7f458b832c30>,37,2,[ 3 11],38,-1,120,-1,118
1,<environment.Job instance at 0x7f458b7e9d70>,42,27,[8 3],43,-1,177,-1,150
1,<environment.Job instance at 0x7f458ba4bbe0>,46,27,[2 6],47,-1,194,-1,167
1,<environment.Job instance at 0x7f458b88c500>,50,14,[ 4 14],51,-1,197,-1,183
1,<environment.Job instance at 0x7f458bf0ba50>,67,23,[2 8],68,-1,258,-1,235
1,<environment.Job instance at 0x7f458bedb410>,68,3,[11  1],69,-1,238,-1,235
1,<environment.Job instance at 0x7f458bedb1e0>,69,19,[13  3],70,-1,254,-1,235
1,<environment.Job instance at 0x7f458bedb500>,74,13,[ 4 11],75,-1,266,-1,253
1,<environment.Job instance at 0x7f458c8cc5a0>,79,17,[12  4],80,-1,285,-1,268
1,<environment.Job instance at 0x7f458c10b460>,80,25,[6 4],81,-1,298,-1,273
1,<environment.Job instance at 0x7f458bf14f50>,82,3,[14  5],83,-1,276,-1,273
1,<environment.Job instance at 0x7f458c09e820>,84,24,[5 5],85,-1,306,-1,282
1,<environment.Job instance at 0x7f458be25280>,88,28,[ 5 10],89,-1,327,-1,299
1,<environment.Job instance at 0x7f458c3e8820>,96,12,[ 5 12],97,-1,331,-1,319
1,<environment.Job instance at 0x7f458c3e8cd0>,99,2,[ 5 14],100,-1,333,-1,331
1,<environment.Job instance at 0x7f458be73e10>,111,16,[ 1 14],112,-1,392,-1,376
1,<environment.Job instance at 0x7f458bac5820>,7,18,[8 2],8,-1,29,-1,11
1,<environment.Job instance at 0x7f458c223870>,12,17,[4 5],13,-1,30,-1,13
1,<environment.Job instance at 0x7f458c2231e0>,13,14,[9 3],14,-1,28,-1,14
1,<environment.Job instance at 0x7f458c223820>,15,17,[8 2],16,-1,33,-1,16
1,<environment.Job instance at 0x7f458c2420a0>,16,16,[1 9],17,-1,33,-1,17
1,<environment.Job instance at 0x7f458c2422d0>,17,16,[7 2],18,-1,34,-1,18
1,<environment.Job instance at 0x7f458b854eb0>,22,16,[10  4],23,-1,40,-1,24
1,<environment.Job instance at 0x7f458baeb410>,24,16,[9 5],25,-1,41,-1,25
1,<environment.Job instance at 0x7f458b743050>,23,16,[6 5],24,-1,42,-1,26
1,<environment.Job instance at 0x7f458b8178c0>,27,28,[5 9],28,-1,56,-1,28
1,<environment.Job instance at 0x7f458b81caa0>,28,1,[9 2],29,-1,30,-1,29
1,<environment.Job instance at 0x7f458b755780>,29,18,[5 8],30,-1,48,-1,30
1,<environment.Job instance at 0x7f458b841a50>,30,18,[ 2 10],31,-1,49,-1,31
1,<environment.Job instance at 0x7f458b812a00>,31,15,[8 1],32,-1,47,-1,32
1,<environment.Job instance at 0x7f458babe6e0>,32,13,[1 5],33,-1,46,-1,33
1,<environment.Job instance at 0x7f458b807c80>,36,18,[ 5 10],37,-1,55,-1,37
1,<environment.Job instance at 0x7f458b828910>,38,13,[9 1],39,-1,52,-1,39
1,<environment.Job instance at 0x7f458b809230>,41,14,[9 2],42,-1,56,-1,42
1,<environment.Job instance at 0x7f458b838cd0>,48,15,[2 8],49,-1,70,-1,55
1,<environment.Job instance at 0x7f458b80e140>,55,18,[4 6],56,-1,74,-1,56
1,<environment.Job instance at 0x7f458bac0640>,57,28,[ 5 10],58,-1,86,-1,58
1,<environment.Job instance at 0x7f458bac0e60>,59,18,[3 8],60,-1,78,-1,60
1,<environment.Job instance at 0x7f458bace190>,60,22,[7 1],61,-1,83,-1,61
1,<environment.Job instance at 0x7f458b80e320>,54,12,[3 9],55,-1,76,-1,64
1,<environment.Job instance at 0x7f458bace1e0>,62,21,[5 7],63,-1,88,-1,67
1,<environment.Job instance at 0x7f458bace370>,66,18,[9 3],67,-1,85,-1,67
1,<environment.Job instance at 0x7f458bace820>,68,16,[1 7],69,-1,85,-1,69
1,<environment.Job instance at 0x7f458b80e050>,53,22,[3 5],54,-1,92,-1,70
1,<environment.Job instance at 0x7f458bace8c0>,69,18,[8 2],70,-1,88,-1,70
1,<environment.Job instance at 0x7f458b8096e0>,42,26,[5 8],43,-1,100,-1,74
1,<environment.Job instance at 0x7f458bacef00>,74,16,[ 5 10],75,-1,91,-1,75
1,<environment.Job instance at 0x7f458baced70>,73,17,[4 7],74,-1,92,-1,75
1,<environment.Job instance at 0x7f458baceeb0>,75,15,[5 9],76,-1,91,-1,76
1,<environment.Job instance at 0x7f458badd370>,80,26,[3 7],81,-1,107,-1,81
1,<environment.Job instance at 0x7f458badd640>,81,18,[11  5],82,-1,100,-1,82
1,<environment.Job instance at 0x7f458badd870>,84,16,[1 5],85,-1,101,-1,85
1,<environment.Job instance at 0x7f458badd9b0>,85,18,[4 9],86,-1,106,-1,88
1,<environment.Job instance at 0x7f458badd910>,87,18,[10  5],88,-1,106,-1,88
1,<environment.Job instance at 0x7f458baddaa0>,88,13,[5 5],89,-1,102,-1,89
1,<environment.Job instance at 0x7f458baddd70>,92,24,[1 9],93,-1,126,-1,102
1,<environment.Job instance at 0x7f458b838280>,50,14,[7 2],51,-1,117,-1,103
1,<environment.Job instance at 0x7f458baddeb0>,93,14,[6 5],94,-1,117,-1,103
1,<environment.Job instance at 0x7f458baddf50>,94,12,[9 3],95,-1,115,-1,103
1,<environment.Job instance at 0x7f458bae25a0>,100,17,[5 6],101,-1,120,-1,103
1,<environment.Job instance at 0x7f458bae26e0>,102,26,[ 3 10],103,-1,131,-1,105
1,<environment.Job instance at 0x7f458bae2050>,96,12,[10  1],97,-1,117,-1,105
1,<environment.Job instance at 0x7f458bae2b90>,105,21,[ 2 10],106,-1,127,-1,106
1,<environment.Job instance at 0x7f458bae2b40>,106,15,[10  2],107,-1,122,-1,107
1,<environment.Job instance at 0x7f458bae2e60>,110,16,[10  1],111,-1,128,-1,112
1,<environment.Job instance at 0x7f458baeb190>,4,17,[14  5],5,-1,22,-1,5
1,<environment.Job instance at 0x7f458b809780>,11,2,[14  5],12,-1,21,-1,19
1,<environment.Job instance at 0x7f458beacfa0>,27,28,[5 9],28,-1,100,-1,72
1,<environment.Job instance at 0x7f458c3e8410>,37,28,[9 1],38,-1,145,-1,117
1,<environment.Job instance at 0x7f458c3e89b0>,42,26,[5 8],43,-1,173,-1,147
1,<environment.Job instance at 0x7f458c3e83c0>,46,2,[ 5 13],47,-1,149,-1,147
1,<environment.Job instance at 0x7f458be255a0>,51,1,[13  4],52,-1,163,-1,162
1,<environment.Job instance at 0x7f458bf14910>,58,2,[12  3],59,-1,180,-1,178
1,<environment.Job instance at 0x7f458c09e820>,57,28,[ 5 10],58,-1,257,-1,229
1,<environment.Job instance at 0x7f458b82c0a0>,80,26,[3 7],81,-1,293,-1,267
1,<environment.Job instance at 0x7f458b82c280>,81,18,[11  5],82,-1,285,-1,267
1,<environment.Job instance at 0x7f458c651a50>,89,1,[12  2],90,-1,287,-1,286
1,<environment.Job instance at 0x7f458c335e10>,92,24,[1 9],93,-1,325,-1,301
1,<environment.Job instance at 0x7f458b788d70>,101,27,[7 1],102,-1,361,-1,334
1,<environment.Job instance at 0x7f458c2914b0>,103,2,[ 3 13],104,-1,336,-1,334
1,<environment.Job instance at 0x7f458c2915a0>,102,26,[ 3 10],103,-1,370,-1,344
1,<environment.Job instance at 0x7f458b507fa0>,107,1,[ 3 14],108,-1,345,-1,344
1,<environment.Job instance at 0x7f458c291640>,108,12,[ 2 11],109,-1,356,-1,344
1,<environment.Job instance at 0x7f458c300c80>,111,17,[11  3],112,-1,363,-1,346
1,<environment.Job instance at 0x7f458c300d20>,112,16,[12  1],113,-1,362,-1,346
1,<environment.Job instance at 0x7f458be9f5f0>,113,15,[ 4 13],114,-1,361,-1,346
1,<environment.Job instance at 0x7f458b8588c0>,0,17,[10  2],1,-1,19,-1,2
1,<environment.Job instance at 0x7f458b858aa0>,2,14,[5 1],3,-1,17,-1,3
1,<environment.Job instance at 0x7f458b858a00>,1,13,[10  2],2,-1,16,-1,3
1,<environment.Job instance at 0x7f458b858780>,6,14,[8 4],7,-1,22,-1,8
1,<environment.Job instance at 0x7f458c931aa0>,12,18,[6 2],13,-1,31,-1,13
1,<environment.Job instance at 0x7f458c931c80>,15,19,[6 3],16,-1,35,-1,16
1,<environment.Job instance at 0x7f458b76e2d0>,21,14,[3 6],22,-1,36,-1,22
1,<environment.Job instance at 0x7f458b76e410>,22,27,[5 7],23,-1,50,-1,23
1,<environment.Job instance at 0x7f458b76e6e0>,25,16,[9 2],26,-1,42,-1,26
1,<environment.Job instance at 0x7f458b76ef00>,26,15,[10  3],27,-1,42,-1,27
1,<environment.Job instance at 0x7f458b76e9b0>,27,15,[9 1],28,-1,43,-1,28
1,<environment.Job instance at 0x7f458b76e230>,30,13,[5 4],31,-1,44,-1,31
1,<environment.Job instance at 0x7f458c91d8c0>,47,14,[11  4],48,-1,79,-1,65
1,<environment.Job instance at 0x7f458c1e7820>,40,17,[5 2],41,-1,82,-1,65
1,<environment.Job instance at 0x7f458c91d500>,50,18,[ 4 11],51,-1,88,-1,70
1,<environment.Job instance at 0x7f458c91d3c0>,49,16,[7 4],50,-1,86,-1,70
1,<environment.Job instance at 0x7f458b858500>,7,14,[9 2],8,-1,84,-1,70
1,<environment.Job instance at 0x7f458c91d230>,53,24,[8 5],54,-1,99,-1,75
1,<environment.Job instance at 0x7f458c91d7d0>,51,18,[ 3 10],52,-1,94,-1,76
1,<environment.Job instance at 0x7f458c91d0a0>,52,12,[7 2],53,-1,105,-1,93
1,<environment.Job instance at 0x7f458b7ffaa0>,61,15,[8 1],62,-1,108,-1,93
1,<environment.Job instance at 0x7f458b7ff140>,57,2,[1 6],58,-1,95,-1,93
1,<environment.Job instance at 0x7f458b7ffcd0>,62,16,[5 4],63,-1,109,-1,93
1,<environment.Job instance at 0x7f458b7ff910>,63,15,[ 3 10],64,-1,108,-1,93
1,<environment.Job instance at 0x7f458c1e7f00>,4,13,[ 5 12],5,-1,18,-1,5
1,<environment.Job instance at 0x7f458c1e7e60>,5,2,[ 2 11],6,-1,8,-1,6
1,<environment.Job instance at 0x7f458c1e7460>,3,24,[2 6],4,-1,41,-1,17
1,<environment.Job instance at 0x7f458b8224b0>,22,27,[5 7],23,-1,76,-1,49
1,<environment.Job instance at 0x7f458bace3c0>,24,24,[13  2],25,-1,73,-1,49
1,<environment.Job instance at 0x7f458bac5690>,28,15,[11  4],29,-1,73,-1,58
1,<environment.Job instance at 0x7f458b80eb40>,31,14,[ 4 13],32,-1,90,-1,76
1,<environment.Job instance at 0x7f458bba75f0>,47,14,[11  4],48,-1,154,-1,140
1,<environment.Job instance at 0x7f458b84c230>,50,18,[ 4 11],51,-1,170,-1,152
1,<environment.Job instance at 0x7f458b73eaa0>,53,24,[8 5],54,-1,198,-1,174
1,<environment.Job instance at 0x7f458bc736e0>,58,13,[12  1],59,-1,201,-1,188
1,<environment.Job instance at 0x7f458c17ab40>,66,3,[14  2],67,-1,214,-1,211
1,<environment.Job instance at 0x7f458c4974b0>,73,14,[ 5 13],74,-1,252,-1,238
1,<environment.Job instance at 0x7f458b619460>,78,23,[3 9],79,-1,291,-1,268
1,<environment.Job instance at 0x7f458b848d70>,90,2,[ 1 11],91,-1,302,-1,300
1,<environment.Job instance at 0x7f458c4cfd70>,97,12,[ 3 14],98,-1,340,-1,328
1,<environment.Job instance at 0x7f458bc2c320>,108,16,[13  3],109,-1,374,-1,358
1,<environment.Job instance at 0x7f458c1f32d0>,1,16,[1 6],2,-1,18,-1,2
1,<environment.Job instance at 0x7f458bef6dc0>,3,27,[3 5],4,-1,31,-1,4
1,<environment.Job instance at 0x7f458bef6af0>,7,17,[5 7],8,-1,25,-1,8
1,<environment.Job instance at 0x7f458beffaa0>,13,12,[9 3],14,-1,26,-1,14
1,<environment.Job instance at 0x7f458beff0a0>,15,14,[5 2],16,-1,30,-1,16
1,<environment.Job instance at 0x7f458beff640>,16,12,[6 4],17,-1,29,-1,17
1,<environment.Job instance at 0x7f458beff690>,17,17,[2 6],18,-1,35,-1,18
1,<environment.Job instance at 0x7f458b9b3550>,18,17,[5 4],19,-1,36,-1,19
1,<environment.Job instance at 0x7f458bf01370>,20,16,[9 4],21,-1,37,-1,21
1,<environment.Job instance at 0x7f458b437870>,22,12,[8 3],23,-1,36,-1,24
1,<environment.Job instance at 0x7f4594fae870>,25,18,[3 9],26,-1,44,-1,26
1,<environment.Job instance at 0x7f4594faebe0>,26,27,[10  4],27,-1,54,-1,27
1,<environment.Job instance at 0x7f458c87d410>,28,14,[4 5],29,-1,43,-1,29
1,<environment.Job instance at 0x7f458b7656e0>,29,14,[9 4],30,-1,44,-1,30
1,<environment.Job instance at 0x7f458b91dc30>,30,1,[ 5 11],31,-1,32,-1,31
1,<environment.Job instance at 0x7f458b91d550>,31,18,[4 8],32,-1,50,-1,32
1,<environment.Job instance at 0x7f458c888c30>,32,25,[7 3],33,-1,58,-1,33
1,<environment.Job instance at 0x7f4594fa0640>,33,3,[ 1 10],34,-1,37,-1,34
1,<environment.Job instance at 0x7f4594fa0280>,34,13,[ 3 12],35,-1,48,-1,35
1,<environment.Job instance at 0x7f4594fa0aa0>,36,17,[2 9],37,-1,54,-1,37
1,<environment.Job instance at 0x7f458b9096e0>,37,13,[4 7],38,-1,51,-1,38
1,<environment.Job instance at 0x7f458b909f00>,38,13,[ 3 10],39,-1,52,-1,39
1,<environment.Job instance at 0x7f458b75e870>,39,14,[4 7],40,-1,54,-1,40
1,<environment.Job instance at 0x7f458c8920a0>,40,16,[10  3],41,-1,57,-1,41
1,<environment.Job instance at 0x7f458b91a1e0>,41,17,[10  5],42,-1,59,-1,42
1,<environment.Job instance at 0x7f458b905320>,43,17,[6 1],44,-1,61,-1,44
1,<environment.Job instance at 0x7f458b9344b0>,46,13,[8 5],47,-1,60,-1,47
1,<environment.Job instance at 0x7f458b902d70>,49,18,[5 2],50,-1,68,-1,50
1,<environment.Job instance at 0x7f458b911c80>,55,12,[3 7],56,-1,68,-1,56
1,<environment.Job instance at 0x7f458b911d70>,57,16,[2 7],58,-1,74,-1,58
1,<environment.Job instance at 0x7f458b911c30>,59,14,[7 2],60,-1,74,-1,60
1,<environment.Job instance at 0x7f458b90ca50>,60,18,[1 7],61,-1,79,-1,61
1,<environment.Job instance at 0x7f458b90c780>,61,14,[1 7],62,-1,76,-1,62
1,<environment.Job instance at 0x7f458b90cb40>,62,14,[8 5],63,-1,77,-1,63
1,<environment.Job instance at 0x7f458b90cdc0>,65,26,[4 8],66,-1,92,-1,66
1,<environment.Job instance at 0x7f458b90cfa0>,66,20,[4 8],67,-1,87,-1,67
1,<environment.Job instance at 0x7f458b8420a0>,68,16,[8 4],69,-1,85,-1,69
1,<environment.Job instance at 0x7f458b842140>,70,25,[5 4],71,-1,96,-1,71
1,<environment.Job instance at 0x7f458b842370>,71,21,[5 5],72,-1,93,-1,72
1,<environment.Job instance at 0x7f458b842500>,73,18,[ 2 10],74,-1,92,-1,74
1,<environment.Job instance at 0x7f458b8425a0>,75,25,[5 7],76,-1,101,-1,76
1,<environment.Job instance at 0x7f458b842690>,76,12,[5 9],77,-1,89,-1,77
1,<environment.Job instance at 0x7f458b842780>,77,22,[5 8],78,-1,100,-1,78
1,<environment.Job instance at 0x7f458b842af0>,80,15,[3 8],81,-1,96,-1,81
1,<environment.Job instance at 0x7f458b842cd0>,81,12,[3 9],82,-1,94,-1,82
1,<environment.Job instance at 0x7f458b842dc0>,83,27,[8 5],84,-1,111,-1,84
1,<environment.Job instance at 0x7f458b842e60>,85,14,[7 3],86,-1,100,-1,86
1,<environment.Job instance at 0x7f458b87a960>,93,24,[3 5],94,-1,118,-1,94
1,<environment.Job instance at 0x7f458b87a9b0>,95,14,[10  1],96,-1,110,-1,96
1,<environment.Job instance at 0x7f458b87ac80>,96,15,[3 6],97,-1,112,-1,97
1,<environment.Job instance at 0x7f458b87aa50>,97,17,[2 7],98,-1,115,-1,98
1,<environment.Job instance at 0x7f458b87ad20>,98,15,[5 5],99,-1,114,-1,99
1,<environment.Job instance at 0x7f458b87ae60>,100,15,[6 3],101,-1,116,-1,101
1,<environment.Job instance at 0x7f458b87af00>,101,18,[5 9],102,-1,120,-1,102
1,<environment.Job instance at 0x7f458b86d140>,103,18,[3 7],104,-1,122,-1,104
1,<environment.Job instance at 0x7f458b86d910>,110,18,[2 7],111,-1,129,-1,111
1,<environment.Job instance at 0x7f458b86d2d0>,111,15,[6 3],112,-1,127,-1,112
1,<environment.Job instance at 0x7f458b86dcd0>,114,23,[4 5],115,-1,138,-1,115
1,<environment.Job instance at 0x7f458b86dbe0>,115,13,[8 4],116,-1,129,-1,116
1,<environment.Job instance at 0x7f458b86da50>,116,13,[6 5],117,-1,130,-1,117
1,<environment.Job instance at 0x7f458b911870>,4,1,[12  4],5,-1,6,-1,5
1,<environment.Job instance at 0x7f458bb5aaf0>,5,2,[14  1],6,-1,8,-1,6
1,<environment.Job instance at 0x7f458b9119b0>,3,27,[3 5],4,-1,40,-1,13
1,<environment.Job instance at 0x7f458c4cfd20>,26,27,[10  4],27,-1,98,-1,71
1,<environment.Job instance at 0x7f458bc35af0>,30,1,[ 5 11],31,-1,73,-1,72
1,<environment.Job instance at 0x7f458bbd64b0>,32,25,[7 3],33,-1,127,-1,102
1,<environment.Job instance at 0x7f458baeb230>,34,13,[ 3 12],35,-1,115,-1,102
1,<environment.Job instance at 0x7f458b7090f0>,48,14,[13  2],49,-1,177,-1,163
1,<environment.Job instance at 0x7f458c9c7fa0>,65,26,[4 8],66,-1,251,-1,225
1,<environment.Job instance at 0x7f458c223320>,70,25,[5 4],71,-1,256,-1,231
1,<environment.Job instance at 0x7f458b7bba00>,75,25,[5 7],76,-1,270,-1,245
1,<environment.Job instance at 0x7f458c4980f0>,79,3,[11  3],80,-1,260,-1,257
1,<environment.Job instance at 0x7f458c5dc460>,83,27,[8 5],84,-1,301,-1,274
1,<environment.Job instance at 0x7f458c5dcaa0>,84,12,[ 5 13],85,-1,286,-1,274
1,<environment.Job instance at 0x7f458c49d4b0>,89,1,[12  4],90,-1,287,-1,286
1,<environment.Job instance at 0x7f458b34abe0>,93,24,[3 5],94,-1,314,-1,290
1,<environment.Job instance at 0x7f458b9da9b0>,104,27,[1 8],105,-1,380,-1,353
1,<environment.Job instance at 0x7f458b8584b0>,114,23,[4 5],115,-1,406,-1,383
1,<environment.Job instance at 0x7f458b91b780>,117,13,[12  5],118,-1,406,-1,393
1,<environment.Job instance at 0x7f458c66cdc0>,10,17,[5 8],11,-1,28,-1,11
1,<environment.Job instance at 0x7f458c66ceb0>,13,20,[5 3],14,-1,35,-1,15
1,<environment.Job instance at 0x7f458c66c6e0>,15,17,[6 3],16,-1,33,-1,16
1,<environment.Job instance at 0x7f458c66cfa0>,16,14,[10  1],17,-1,31,-1,17
1,<environment.Job instance at 0x7f458c66c500>,20,18,[5 6],21,-1,39,-1,21
1,<environment.Job instance at 0x7f458c66c9b0>,21,17,[2 9],22,-1,39,-1,22
1,<environment.Job instance at 0x7f458b4d14b0>,26,13,[9 1],27,-1,40,-1,27
1,<environment.Job instance at 0x7f458b4d1910>,27,22,[10  1],28,-1,62,-1,40
1,<environment.Job instance at 0x7f458b4d1550>,36,26,[9 5],37,-1,66,-1,40
1,<environment.Job instance at 0x7f458b4d15a0>,39,13,[8 5],40,-1,53,-1,40
1,<environment.Job instance at 0x7f458b4d1370>,32,13,[9 2],33,-1,53,-1,40
1,<environment.Job instance at 0x7f458c739e10>,42,13,[ 3 10],43,-1,56,-1,43
1,<environment.Job instance at 0x7f458c739140>,43,16,[6 3],44,-1,60,-1,44
1,<environment.Job instance at 0x7f458c739370>,44,17,[1 8],45,-1,62,-1,45
1,<environment.Job instance at 0x7f458b4d1320>,28,16,[13  1],29,-1,62,-1,46
1,<environment.Job instance at 0x7f458c739870>,45,13,[4 7],46,-1,63,-1,50
1,<environment.Job instance at 0x7f458c739f00>,52,25,[7 5],53,-1,78,-1,53
1,<environment.Job instance at 0x7f458b6f8370>,59,13,[ 1 10],60,-1,80,-1,67
1,<environment.Job instance at 0x7f458b6f8e10>,63,15,[4 8],64,-1,82,-1,67
1,<environment.Job instance at 0x7f458c739050>,49,22,[7 3],50,-1,117,-1,95
1,<environment.Job instance at 0x7f458b6f8c80>,66,18,[5 8],67,-1,113,-1,95
1,<environment.Job instance at 0x7f458bc5e2d0>,73,20,[8 4],74,-1,115,-1,95
1,<environment.Job instance at 0x7f458b6f88c0>,58,12,[10  2],59,-1,107,-1,95
1,<environment.Job instance at 0x7f458bc5e820>,71,18,[8 1],72,-1,114,-1,96
1,<environment.Job instance at 0x7f458bc5eaa0>,77,27,[8 5],78,-1,123,-1,96
1,<environment.Job instance at 0x7f458bc5e140>,79,17,[1 5],80,-1,113,-1,96
1,<environment.Job instance at 0x7f458bc5efa0>,82,17,[3 5],83,-1,204,-1,187
1,<environment.Job instance at 0x7f458b4d1d20>,3,14,[ 4 11],4,-1,18,-1,4
1,<environment.Job instance at 0x7f458c739230>,6,26,[8 5],7,-1,34,-1,8
1,<environment.Job instance at 0x7f458c739e60>,8,18,[13  1],9,-1,27,-1,9
1,<environment.Job instance at 0x7f458bedb730>,28,16,[13  1],29,-1,82,-1,66
1,<environment.Job instance at 0x7f458bf34140>,31,3,[11  4],32,-1,72,-1,69
1,<environment.Job instance at 0x7f458b84c230>,36,26,[9 5],37,-1,121,-1,95
1,<environment.Job instance at 0x7f458baeb190>,47,1,[ 4 12],48,-1,115,-1,114
1,<environment.Job instance at 0x7f458bbd6f50>,50,15,[13  3],51,-1,131,-1,116
1,<environment.Job instance at 0x7f458bbda5a0>,52,25,[7 5],53,-1,150,-1,125
1,<environment.Job instance at 0x7f458b729c80>,53,2,[14  5],54,-1,127,-1,125
1,<environment.Job instance at 0x7f458b7296e0>,54,2,[13  4],55,-1,127,-1,125
1,<environment.Job instance at 0x7f458c2a5730>,56,12,[12  4],57,-1,137,-1,125
1,<environment.Job instance at 0x7f458b87aeb0>,65,15,[ 4 12],66,-1,174,-1,159
1,<environment.Job instance at 0x7f458bd60a00>,77,27,[8 5],78,-1,247,-1,220
1,<environment.Job instance at 0x7f458b561cd0>,89,2,[ 2 12],90,-1,265,-1,263
1,<environment.Job instance at 0x7f458b561820>,92,24,[4 6],93,-1,303,-1,279
1,<environment.Job instance at 0x7f458c91d140>,93,15,[ 2 13],94,-1,294,-1,279
1,<environment.Job instance at 0x7f458b6aa6e0>,97,18,[14  1],98,-1,314,-1,296
1,<environment.Job instance at 0x7f458b745d20>,103,13,[ 3 11],104,-1,328,-1,315
1,<environment.Job instance at 0x7f458b745d70>,106,15,[11  2],107,-1,342,-1,327
1,<environment.Job instance at 0x7f458b7454b0>,110,12,[ 3 12],111,-1,349,-1,337
1,<environment.Job instance at 0x7f458b12b320>,0,25,[10  4],1,-1,26,-1,1
1,<environment.Job instance at 0x7f458b12b910>,5,17,[8 5],6,-1,23,-1,6
1,<environment.Job instance at 0x7f458b1e22d0>,10,18,[6 4],11,-1,29,-1,11
1,<environment.Job instance at 0x7f458b1e28c0>,12,15,[4 9],13,-1,28,-1,13
1,<environment.Job instance at 0x7f458b1e20a0>,13,18,[8 3],14,-1,32,-1,14
1,<environment.Job instance at 0x7f458b1e2960>,16,16,[7 5],17,-1,33,-1,17
1,<environment.Job instance at 0x7f458b1e2a50>,19,14,[5 3],20,-1,34,-1,20
1,<environment.Job instance at 0x7f458b1e2f00>,22,18,[8 1],23,-1,41,-1,23
1,<environment.Job instance at 0x7f458b147f00>,24,14,[5 8],25,-1,40,-1,26
1,<environment.Job instance at 0x7f458b1472d0>,26,20,[10  4],27,-1,47,-1,27
1,<environment.Job instance at 0x7f458b147a50>,28,17,[9 2],29,-1,46,-1,29
1,<environment.Job instance at 0x7f458b147910>,29,14,[7 5],30,-1,45,-1,31
1,<environment.Job instance at 0x7f458b147eb0>,32,18,[5 3],33,-1,51,-1,33
1,<environment.Job instance at 0x7f458b1471e0>,33,27,[1 7],34,-1,61,-1,34
1,<environment.Job instance at 0x7f458b147e60>,34,18,[6 3],35,-1,53,-1,35
1,<environment.Job instance at 0x7f458b1474b0>,35,18,[ 3 12],36,-1,54,-1,36
1,<environment.Job instance at 0x7f458b147f50>,30,27,[ 3 13],31,-1,65,-1,38
1,<environment.Job instance at 0x7f458b19af00>,39,15,[4 7],40,-1,55,-1,40
1,<environment.Job instance at 0x7f458b19acd0>,42,17,[5 9],43,-1,60,-1,43
1,<environment.Job instance at 0x7f458b19a6e0>,43,18,[5 5],44,-1,63,-1,45
1,<environment.Job instance at 0x7f458b19aa00>,45,17,[6 4],46,-1,63,-1,46
1,<environment.Job instance at 0x7f458b19a7d0>,46,17,[1 6],47,-1,64,-1,47
1,<environment.Job instance at 0x7f458b19a910>,47,18,[5 5],48,-1,66,-1,48
1,<environment.Job instance at 0x7f458b19a2d0>,48,18,[ 3 10],49,-1,67,-1,49
1,<environment.Job instance at 0x7f458b19a1e0>,50,27,[5 4],51,-1,78,-1,51
1,<environment.Job instance at 0x7f458b19a4b0>,51,28,[7 5],52,-1,80,-1,52
1,<environment.Job instance at 0x7f458b19a190>,53,28,[8 2],54,-1,82,-1,54
1,<environment.Job instance at 0x7f458b19a0f0>,54,16,[2 5],55,-1,71,-1,55
1,<environment.Job instance at 0x7f458b19aeb0>,55,13,[ 5 10],56,-1,69,-1,56
1,<environment.Job instance at 0x7f458b1ca3c0>,58,17,[5 3],59,-1,76,-1,59
1,<environment.Job instance at 0x7f458b903a50>,62,14,[3 8],63,-1,77,-1,63
1,<environment.Job instance at 0x7f458b903aa0>,63,16,[7 2],64,-1,80,-1,64
1,<environment.Job instance at 0x7f458b903f50>,64,12,[9 3],65,-1,77,-1,65
1,<environment.Job instance at 0x7f458b9efa00>,67,18,[2 6],68,-1,86,-1,68
1,<environment.Job instance at 0x7f458c03d7d0>,68,15,[3 9],69,-1,84,-1,69
1,<environment.Job instance at 0x7f458c03d320>,69,12,[10  4],70,-1,82,-1,70
1,<environment.Job instance at 0x7f458b947640>,73,19,[7 1],74,-1,93,-1,74
1,<environment.Job instance at 0x7f458c5927d0>,74,15,[10  1],75,-1,90,-1,75
1,<environment.Job instance at 0x7f458ba020a0>,75,18,[7 4],76,-1,94,-1,76
1,<environment.Job instance at 0x7f458b947d70>,78,18,[ 2 10],79,-1,97,-1,79
1,<environment.Job instance at 0x7f458b2d5b40>,79,13,[5 8],80,-1,93,-1,80
1,<environment.Job instance at 0x7f458b106140>,82,14,[4 6],83,-1,97,-1,83
1,<environment.Job instance at 0x7f458bf07820>,83,27,[5 1],84,-1,111,-1,84
1,<environment.Job instance at 0x7f458be9ecd0>,84,15,[5 5],85,-1,100,-1,85
1,<environment.Job instance at 0x7f458c65cdc0>,85,14,[5 9],86,-1,100,-1,86
1,<environment.Job instance at 0x7f458c3e2460>,93,18,[6 4],94,-1,112,-1,94
1,<environment.Job instance at 0x7f458b707b90>,94,18,[9 1],95,-1,113,-1,95
1,<environment.Job instance at 0x7f458b26b190>,100,18,[2 9],101,-1,119,-1,101
1,<environment.Job instance at 0x7f458bbbd1e0>,103,18,[5 3],104,-1,123,-1,105
1,<environment.Job instance at 0x7f458b268af0>,114,17,[5 1],115,-1,133,-1,116
1,<environment.Job instance at 0x7f458b1010f0>,116,18,[5 4],117,-1,135,-1,117
1,<environment.Job instance at 0x7f458b1e2140>,0,25,[10  4],1,-1,26,-1,1
1,<environment.Job instance at 0x7f458b561550>,17,16,[13  1],18,-1,41,-1,25
1,<environment.Job instance at 0x7f458c3318c0>,21,2,[13  4],22,-1,55,-1,53
1,<environment.Job instance at 0x7f458b29eb90>,30,27,[ 3 13],31,-1,103,-1,76
1,<environment.Job instance at 0x7f458b29e910>,33,27,[1 7],34,-1,117,-1,90
1,<environment.Job instance at 0x7f458c5cce10>,35,18,[ 3 12],36,-1,118,-1,100
1,<environment.Job instance at 0x7f458bebd050>,40,1,[12  1],41,-1,125,-1,124
1,<environment.Job instance at 0x7f458bebda50>,41,25,[9 1],42,-1,152,-1,127
1,<environment.Job instance at 0x7f458be95370>,50,27,[5 4],51,-1,205,-1,178
1,<environment.Job instance at 0x7f458be95a00>,51,28,[7 5],52,-1,206,-1,178
1,<environment.Job instance at 0x7f458bbb51e0>,53,28,[8 2],54,-1,217,-1,189
1,<environment.Job instance at 0x7f458c303820>,71,1,[ 5 14],72,-1,249,-1,248
1,<environment.Job instance at 0x7f458c30b230>,80,17,[ 5 13],81,-1,297,-1,280
1,<environment.Job instance at 0x7f458c2db690>,83,27,[5 1],84,-1,313,-1,286
1,<environment.Job instance at 0x7f458c2e45f0>,86,2,[ 5 12],87,-1,302,-1,300
1,<environment.Job instance at 0x7f458b37a370>,95,17,[14  4],96,-1,344,-1,327
1,<environment.Job instance at 0x7f458c9e8820>,101,12,[13  5],102,-1,375,-1,363
1,<environment.Job instance at 0x7f458bea0050>,107,26,[3 7],108,-1,428,-1,402
1,<environment.Job instance at 0x7f458c14fc80>,117,1,[ 2 11],118,-1,410,-1,409
1,<environment.Job instance at 0x7f458b8266e0>,1,17,[7 4],2,-1,19,-1,2
1,<environment.Job instance at 0x7f458c59d320>,5,18,[8 2],6,-1,24,-1,6
1,<environment.Job instance at 0x7f458c59d780>,7,28,[4 9],8,-1,36,-1,8
1,<environment.Job instance at 0x7f458c9495f0>,16,15,[10  2],17,-1,36,-1,21
1,<environment.Job instance at 0x7f458c9499b0>,21,15,[7 2],22,-1,37,-1,22
1,<environment.Job instance at 0x7f458b982e60>,28,16,[10  1],29,-1,45,-1,29
1,<environment.Job instance at 0x7f458b982c80>,29,18,[8 2],30,-1,48,-1,30
1,<environment.Job instance at 0x7f458b9825f0>,30,18,[2 8],31,-1,49,-1,31
1,<environment.Job instance at 0x7f458b982d20>,33,14,[5 7],34,-1,48,-1,34
1,<environment.Job instance at 0x7f458b982780>,35,18,[9 1],36,-1,54,-1,36
1,<environment.Job instance at 0x7f458c22c0f0>,40,15,[5 8],41,-1,56,-1,41
1,<environment.Job instance at 0x7f458c22c280>,44,21,[8 1],45,-1,66,-1,45
1,<environment.Job instance at 0x7f458c22cbe0>,49,25,[ 3 10],50,-1,75,-1,50
1,<environment.Job instance at 0x7f458baddd20>,54,17,[5 4],55,-1,73,-1,56
1,<environment.Job instance at 0x7f458baddaa0>,55,15,[9 4],56,-1,71,-1,56
1,<environment.Job instance at 0x7f458badd820>,56,15,[4 7],57,-1,73,-1,58
1,<environment.Job instance at 0x7f458badd280>,57,23,[9 2],58,-1,82,-1,59
1,<environment.Job instance at 0x7f458badd0a0>,60,15,[4 8],61,-1,76,-1,61
1,<environment.Job instance at 0x7f458baddd70>,63,17,[7 4],64,-1,81,-1,64
1,<environment.Job instance at 0x7f458badd0f0>,65,15,[9 1],66,-1,82,-1,67
1,<environment.Job instance at 0x7f458bc9ef00>,68,16,[6 5],69,-1,85,-1,69
1,<environment.Job instance at 0x7f458bc9ee60>,71,14,[1 5],72,-1,86,-1,72
1,<environment.Job instance at 0x7f458bc9e140>,72,18,[ 2 10],73,-1,91,-1,73
1,<environment.Job instance at 0x7f458bc9ea50>,73,14,[4 9],74,-1,88,-1,74
1,<environment.Job instance at 0x7f458bc9e730>,74,12,[9 4],75,-1,88,-1,76
1,<environment.Job instance at 0x7f458bc9ec80>,83,24,[4 7],84,-1,109,-1,85
1,<environment.Job instance at 0x7f458b82c910>,92,14,[4 9],93,-1,110,-1,96
1,<environment.Job instance at 0x7f458bb8fc30>,118,16,[9 2],119,-1,234,-1,218
1,<environment.Job instance at 0x7f458b982f50>,7,28,[4 9],8,-1,46,-1,18
1,<environment.Job instance at 0x7f458c22c320>,11,18,[13  5],12,-1,37,-1,19
1,<environment.Job instance at 0x7f458badde60>,15,14,[11  2],16,-1,49,-1,35
1,<environment.Job instance at 0x7f458bc9e230>,18,1,[14  2],19,-1,38,-1,37
1,<environment.Job instance at 0x7f458b9fad20>,19,1,[ 1 11],20,-1,38,-1,37
1,<environment.Job instance at 0x7f458b0bcd70>,50,18,[ 2 11],51,-1,151,-1,133
1,<environment.Job instance at 0x7f458bebd0a0>,49,25,[ 3 10],50,-1,172,-1,147
1,<environment.Job instance at 0x7f458beb8d70>,57,23,[9 2],58,-1,189,-1,166
1,<environment.Job instance at 0x7f458be8c320>,76,17,[ 1 14],77,-1,247,-1,230
1,<environment.Job instance at 0x7f458b959550>,79,18,[14  4],80,-1,254,-1,236
1,<environment.Job instance at 0x7f458bdf31e0>,83,24,[4 7],84,-1,289,-1,265
1,<environment.Job instance at 0x7f4594f62690>,88,23,[ 4 10],89,-1,302,-1,279
1,<environment.Job instance at 0x7f458bec9e60>,95,13,[ 3 12],96,-1,293,-1,280
1,<environment.Job instance at 0x7f458bec93c0>,96,13,[ 4 12],97,-1,293,-1,280
1,<environment.Job instance at 0x7f458ba58460>,103,24,[3 5],104,-1,333,-1,309
1,<environment.Job instance at 0x7f458bbc70f0>,0,26,[4 8],1,-1,27,-1,1
1,<environment.Job instance at 0x7f458bbc7780>,1,16,[2 7],2,-1,19,-1,3
1,<environment.Job instance at 0x7f458b3e0f50>,7,13,[ 5 10],8,-1,21,-1,8
1,<environment.Job instance at 0x7f458b3e0960>,8,13,[ 5 10],9,-1,22,-1,9
1,<environment.Job instance at 0x7f458b3e04b0>,10,18,[8 5],11,-1,29,-1,11
1,<environment.Job instance at 0x7f458b3e02d0>,12,18,[4 5],13,-1,31,-1,13
1,<environment.Job instance at 0x7f458b3e0eb0>,13,18,[8 1],14,-1,32,-1,14
1,<environment.Job instance at 0x7f458c10f500>,17,3,[1 6],18,-1,21,-1,18
1,<environment.Job instance at 0x7f458c10f050>,18,17,[10  4],19,-1,36,-1,19
1,<environment.Job instance at 0x7f458c10f0a0>,19,15,[5 9],20,-1,35,-1,20
1,<environment.Job instance at 0x7f458c289050>,22,16,[3 5],23,-1,39,-1,23
1,<environment.Job instance at 0x7f458c289910>,25,22,[1 9],26,-1,48,-1,26
1,<environment.Job instance at 0x7f458c289280>,29,18,[ 3 12],30,-1,48,-1,30
1,<environment.Job instance at 0x7f458c289a50>,30,18,[7 3],31,-1,49,-1,31
1,<environment.Job instance at 0x7f458c289be0>,33,17,[10  3],34,-1,51,-1,34
1,<environment.Job instance at 0x7f458c5438c0>,37,15,[6 4],38,-1,53,-1,38
1,<environment.Job instance at 0x7f458c543780>,38,17,[3 8],39,-1,56,-1,39
1,<environment.Job instance at 0x7f458c543a50>,39,15,[ 5 10],40,-1,55,-1,40
1,<environment.Job instance at 0x7f458c543550>,40,19,[5 4],41,-1,60,-1,41
1,<environment.Job instance at 0x7f458c543d70>,41,17,[ 2 10],42,-1,59,-1,42
1,<environment.Job instance at 0x7f458c543aa0>,43,18,[9 2],44,-1,62,-1,44
1,<environment.Job instance at 0x7f458bcff8c0>,44,24,[5 9],45,-1,69,-1,45
1,<environment.Job instance at 0x7f458bcffe10>,45,16,[10  3],46,-1,64,-1,48
1,<environment.Job instance at 0x7f458bcff140>,47,26,[8 5],48,-1,74,-1,48
1,<environment.Job instance at 0x7f458bcff280>,50,17,[10  1],51,-1,68,-1,51
1,<environment.Job instance at 0x7f458bcff820>,52,13,[9 1],53,-1,66,-1,53
1,<environment.Job instance at 0x7f458bcffc30>,53,26,[7 5],54,-1,80,-1,54
1,<environment.Job instance at 0x7f458bcff370>,54,16,[3 9],55,-1,71,-1,55
1,<environment.Job instance at 0x7f458bcff1e0>,56,20,[3 6],57,-1,77,-1,57
1,<environment.Job instance at 0x7f458c7454b0>,57,18,[ 3 10],58,-1,76,-1,58
1,<environment.Job instance at 0x7f458c745d20>,58,16,[3 5],59,-1,75,-1,59
1,<environment.Job instance at 0x7f458c745730>,59,16,[8 5],60,-1,76,-1,60
1,<environment.Job instance at 0x7f458c745d70>,62,18,[4 7],63,-1,81,-1,63
1,<environment.Job instance at 0x7f458c745410>,65,17,[9 3],66,-1,86,-1,69
1,<environment.Job instance at 0x7f458c421780>,71,12,[10  4],72,-1,84,-1,72
1,<environment.Job instance at 0x7f458c108e60>,84,17,[5 9],85,-1,102,-1,85
1,<environment.Job instance at 0x7f458c108960>,85,17,[5 9],86,-1,103,-1,86
1,<environment.Job instance at 0x7f458c108cd0>,86,23,[10  4],87,-1,110,-1,87
1,<environment.Job instance at 0x7f458c1089b0>,87,15,[5 5],88,-1,103,-1,88
1,<environment.Job instance at 0x7f458c108d20>,88,17,[4 9],89,-1,106,-1,89
1,<environment.Job instance at 0x7f458c108460>,89,18,[9 5],90,-1,108,-1,90
1,<environment.Job instance at 0x7f458c1084b0>,91,17,[8 2],92,-1,109,-1,92
1,<environment.Job instance at 0x7f458c108c80>,92,18,[10  5],93,-1,114,-1,96
1,<environment.Job instance at 0x7f458bcec5f0>,96,14,[4 7],97,-1,111,-1,97
1,<environment.Job instance at 0x7f458bcecdc0>,97,18,[5 4],98,-1,116,-1,98
1,<environment.Job instance at 0x7f458b826550>,95,16,[3 8],96,-1,115,-1,99
1,<environment.Job instance at 0x7f458c1ce4b0>,101,17,[7 2],102,-1,119,-1,102
1,<environment.Job instance at 0x7f458bd63820>,103,16,[3 9],104,-1,120,-1,104
1,<environment.Job instance at 0x7f458bcb0a00>,104,13,[10  1],105,-1,119,-1,106
1,<environment.Job instance at 0x7f458bd55910>,106,14,[1 5],107,-1,121,-1,107
1,<environment.Job instance at 0x7f458c5be410>,109,25,[8 3],110,-1,135,-1,110
1,<environment.Job instance at 0x7f458c989730>,111,17,[3 7],112,-1,129,-1,112
1,<environment.Job instance at 0x7f458bd555f0>,113,18,[2 6],114,-1,132,-1,114
1,<environment.Job instance at 0x7f458bec60a0>,114,18,[8 2],115,-1,133,-1,115
1,<environment.Job instance at 0x7f458bb8f140>,116,17,[1 6],117,-1,134,-1,117
1,<environment.Job instance at 0x7f458ba58410>,117,18,[5 2],118,-1,136,-1,118
1,<environment.Job instance at 0x7f458b17faa0>,118,17,[3 5],119,-1,136,-1,119
1,<environment.Job instance at 0x7f458b3e0be0>,0,26,[4 8],1,-1,27,-1,1
1,<environment.Job instance at 0x7f458bcdc780>,15,15,[12  1],16,-1,52,-1,37
1,<environment.Job instance at 0x7f458bbb98c0>,23,1,[ 3 13],24,-1,74,-1,73
1,<environment.Job instance at 0x7f458bec9320>,29,18,[ 3 12],30,-1,104,-1,86
1,<environment.Job instance at 0x7f458c6d4960>,35,1,[ 5 13],36,-1,104,-1,103
1,<environment.Job instance at 0x7f458ba636e0>,44,24,[5 9],45,-1,176,-1,152
1,<environment.Job instance at 0x7f458b959f50>,47,26,[8 5],48,-1,196,-1,170
1,<environment.Job instance at 0x7f458be8c690>,53,26,[7 5],54,-1,215,-1,189
1,<environment.Job instance at 0x7f458be8cb90>,55,2,[13  2],56,-1,191,-1,189
1,<environment.Job instance at 0x7f458bcc4820>,63,3,[11  3],64,-1,226,-1,223
1,<environment.Job instance at 0x7f458c5b28c0>,78,16,[ 5 13],79,-1,283,-1,267
1,<environment.Job instance at 0x7f458c2db5f0>,81,15,[14  4],82,-1,285,-1,270
1,<environment.Job instance at 0x7f458bbb5f00>,86,23,[10  4],87,-1,315,-1,292
1,<environment.Job instance at 0x7f458b0bf690>,109,25,[8 3],110,-1,430,-1,405
1,<environment.Job instance at 0x7f458bebd820>,112,24,[11  1],113,-1,429,-1,405
1,<environment.Job instance at 0x7f458c6c20a0>,1,15,[10  5],2,-1,17,-1,2
1,<environment.Job instance at 0x7f458c6c22d0>,2,18,[10  1],3,-1,24,-1,6
1,<environment.Job instance at 0x7f458b81ffa0>,11,18,[7 1],12,-1,30,-1,12
1,<environment.Job instance at 0x7f458c6c2370>,5,12,[5 9],6,-1,25,-1,13
1,<environment.Job instance at 0x7f458c6c2be0>,13,18,[ 3 10],14,-1,34,-1,16
1,<environment.Job instance at 0x7f458c1f3910>,18,12,[10  2],19,-1,34,-1,22
1,<environment.Job instance at 0x7f458c1f3640>,22,14,[ 1 10],23,-1,37,-1,23
1,<environment.Job instance at 0x7f458c1f3d70>,21,15,[9 5],22,-1,39,-1,24
1,<environment.Job instance at 0x7f458c1cb3c0>,25,15,[10  1],26,-1,42,-1,27
1,<environment.Job instance at 0x7f458c1cbc80>,26,21,[3 7],27,-1,48,-1,27
1,<environment.Job instance at 0x7f458c1cb7d0>,27,15,[ 3 10],28,-1,43,-1,28
1,<environment.Job instance at 0x7f458c1cbd70>,33,17,[ 2 10],34,-1,53,-1,36
1,<environment.Job instance at 0x7f458c1cbaa0>,31,17,[5 6],32,-1,56,-1,39
1,<environment.Job instance at 0x7f458c1cba50>,32,16,[10  1],33,-1,56,-1,40
1,<environment.Job instance at 0x7f458c1cb280>,39,18,[3 8],40,-1,60,-1,42
1,<environment.Job instance at 0x7f458c1cbb90>,41,18,[4 6],42,-1,62,-1,44
1,<environment.Job instance at 0x7f458c1cb5f0>,42,15,[1 7],43,-1,59,-1,44
1,<environment.Job instance at 0x7f458c1cb690>,43,17,[6 1],44,-1,61,-1,44
1,<environment.Job instance at 0x7f458c1cb320>,38,15,[10  2],39,-1,64,-1,49
1,<environment.Job instance at 0x7f458bcc4730>,47,12,[ 3 10],48,-1,61,-1,49
1,<environment.Job instance at 0x7f458bcc4960>,51,13,[ 1 13],52,-1,66,-1,53
1,<environment.Job instance at 0x7f458bcc45a0>,52,27,[9 1],53,-1,81,-1,54
1,<environment.Job instance at 0x7f458bcc4140>,53,12,[5 9],54,-1,66,-1,54
1,<environment.Job instance at 0x7f458bcc45f0>,46,13,[8 3],47,-1,71,-1,58
1,<environment.Job instance at 0x7f458bcc42d0>,56,21,[12  2],57,-1,80,-1,59
1,<environment.Job instance at 0x7f458bcc4190>,58,14,[ 1 14],59,-1,74,-1,60
1,<environment.Job instance at 0x7f458bcc4f00>,48,15,[8 2],49,-1,76,-1,61
1,<environment.Job instance at 0x7f458bcc4050>,59,20,[2 8],60,-1,82,-1,62
1,<environment.Job instance at 0x7f458c1cb640>,35,12,[7 2],36,-1,75,-1,63
1,<environment.Job instance at 0x7f458bcc40a0>,54,16,[1 8],55,-1,79,-1,63
1,<environment.Job instance at 0x7f458b227320>,63,18,[8 1],64,-1,82,-1,64
1,<environment.Job instance at 0x7f458c96a500>,64,13,[10  5],65,-1,79,-1,66
1,<environment.Job instance at 0x7f458be7f5a0>,65,12,[10  3],66,-1,83,-1,71
1,<environment.Job instance at 0x7f458b5648c0>,70,18,[5 7],71,-1,89,-1,71
1,<environment.Job instance at 0x7f458ba34320>,71,23,[5 9],72,-1,95,-1,72
1,<environment.Job instance at 0x7f458b2278c0>,61,19,[5 5],62,-1,91,-1,72
1,<environment.Job instance at 0x7f458c803550>,73,14,[5 6],74,-1,88,-1,74
1,<environment.Job instance at 0x7f458c79b9b0>,74,15,[6 4],75,-1,90,-1,75
1,<environment.Job instance at 0x7f458c663870>,75,15,[ 4 12],76,-1,92,-1,77
1,<environment.Job instance at 0x7f458c40dbe0>,76,18,[1 5],77,-1,95,-1,77
1,<environment.Job instance at 0x7f458b227be0>,60,15,[12  3],61,-1,98,-1,83
1,<environment.Job instance at 0x7f458b38e6e0>,83,16,[ 3 10],84,-1,100,-1,84
1,<environment.Job instance at 0x7f458c987f00>,81,26,[7 2],82,-1,110,-1,84
1,<environment.Job instance at 0x7f458c5445f0>,84,14,[10  5],85,-1,99,-1,85
1,<environment.Job instance at 0x7f458b559280>,85,2,[1 8],86,-1,88,-1,86
1,<environment.Job instance at 0x7f458c41f140>,86,12,[11  2],87,-1,99,-1,87
1,<environment.Job instance at 0x7f458c663f00>,78,1,[8 4],79,-1,89,-1,88
1,<environment.Job instance at 0x7f458c9af5f0>,88,19,[ 5 11],89,-1,108,-1,89
1,<environment.Job instance at 0x7f458c41f370>,87,1,[14  5],88,-1,91,-1,90
1,<environment.Job instance at 0x7f458b7e98c0>,89,14,[8 2],90,-1,105,-1,91
1,<environment.Job instance at 0x7f4594f230a0>,91,17,[10  3],92,-1,110,-1,93
1,<environment.Job instance at 0x7f4594f23820>,92,13,[5 2],93,-1,106,-1,93
1,<environment.Job instance at 0x7f458c8a1230>,93,12,[9 4],94,-1,106,-1,94
1,<environment.Job instance at 0x7f458ba3b5a0>,94,18,[5 3],95,-1,113,-1,95
1,<environment.Job instance at 0x7f458c99f6e0>,95,2,[1 8],96,-1,99,-1,97
1,<environment.Job instance at 0x7f458ba3be60>,96,3,[8 4],97,-1,100,-1,97
1,<environment.Job instance at 0x7f458b7f4280>,104,23,[8 3],105,-1,132,-1,109
1,<environment.Job instance at 0x7f458c6c7fa0>,106,17,[2 7],107,-1,126,-1,109
1,<environment.Job instance at 0x7f458b1ee640>,109,1,[11  4],110,-1,112,-1,111
1,<environment.Job instance at 0x7f458b1ee780>,111,15,[10  1],112,-1,127,-1,112
1,<environment.Job instance at 0x7f458b24b6e0>,113,27,[9 4],114,-1,141,-1,114
1,<environment.Job instance at 0x7f458b24bf00>,114,25,[8 2],115,-1,140,-1,115
1,<environment.Job instance at 0x7f458b24b370>,116,18,[7 2],117,-1,135,-1,117
1,<environment.Job instance at 0x7f458b1eeb40>,110,3,[4 8],111,-1,132,-1,129
1,<environment.Job instance at 0x7f458c2108c0>,23,2,[12  1],24,-1,51,-1,49
1,<environment.Job instance at 0x7f458c1c0f00>,24,1,[ 5 14],25,-1,50,-1,49
1,<environment.Job instance at 0x7f458b80a320>,28,28,[8 3],29,-1,91,-1,63
1,<environment.Job instance at 0x7f458b3a8960>,36,13,[ 5 11],37,-1,109,-1,96
1,<environment.Job instance at 0x7f458b3a81e0>,37,2,[13  1],38,-1,98,-1,96
1,<environment.Job instance at 0x7f458b3bd0a0>,44,1,[11  3],45,-1,124,-1,123
1,<environment.Job instance at 0x7f458b385910>,51,13,[ 1 13],52,-1,181,-1,168
1,<environment.Job instance at 0x7f458b385cd0>,52,27,[9 1],53,-1,205,-1,178
1,<environment.Job instance at 0x7f458b814190>,56,21,[12  2],57,-1,199,-1,178
1,<environment.Job instance at 0x7f458c1b2eb0>,58,14,[ 1 14],59,-1,193,-1,179
1,<environment.Job instance at 0x7f458b253410>,60,15,[12  3],61,-1,196,-1,181
1,<environment.Job instance at 0x7f458b396280>,66,2,[12  3],67,-1,199,-1,197
1,<environment.Job instance at 0x7f458b2674b0>,71,23,[5 9],72,-1,243,-1,220
1,<environment.Job instance at 0x7f458b267280>,75,15,[ 4 12],76,-1,238,-1,223
1,<environment.Job instance at 0x7f458b264dc0>,79,3,[ 4 11],80,-1,241,-1,238
1,<environment.Job instance at 0x7f458b5d5fa0>,81,26,[7 2],82,-1,277,-1,251
1,<environment.Job instance at 0x7f458b55d870>,82,2,[ 2 13],83,-1,253,-1,251
1,<environment.Job instance at 0x7f458b251410>,86,12,[11  2],87,-1,268,-1,256
1,<environment.Job instance at 0x7f458b251870>,87,1,[14  5],88,-1,257,-1,256
1,<environment.Job instance at 0x7f458b25eeb0>,88,19,[ 5 11],89,-1,275,-1,256
1,<environment.Job instance at 0x7f458b576370>,98,1,[ 4 13],99,-1,288,-1,287
1,<environment.Job instance at 0x7f458b38a410>,102,2,[ 3 14],103,-1,294,-1,292
1,<environment.Job instance at 0x7f458b566960>,104,23,[8 3],105,-1,317,-1,294
1,<environment.Job instance at 0x7f458b55b7d0>,109,1,[11  4],110,-1,302,-1,301
1,<environment.Job instance at 0x7f458b38e1e0>,114,25,[8 2],115,-1,357,-1,332
1,<environment.Job instance at 0x7f458bde1410>,113,27,[9 4],114,-1,359,-1,332
1,<environment.Job instance at 0x7f458c980d70>,2,17,[5 9],3,-1,21,-1,4
1,<environment.Job instance at 0x7f458c980af0>,3,18,[6 1],4,-1,22,-1,4
1,<environment.Job instance at 0x7f458b7fc500>,7,17,[3 7],8,-1,26,-1,9
1,<environment.Job instance at 0x7f458b7fcb90>,9,16,[5 1],10,-1,26,-1,10
1,<environment.Job instance at 0x7f458c980730>,8,16,[8 5],9,-1,26,-1,10
1,<environment.Job instance at 0x7f458b7fc5f0>,15,22,[9 4],16,-1,41,-1,19
1,<environment.Job instance at 0x7f458c98b500>,19,27,[5 8],20,-1,47,-1,20
1,<environment.Job instance at 0x7f458c98bd70>,21,12,[10  5],22,-1,34,-1,22
1,<environment.Job instance at 0x7f458c98b0a0>,22,15,[ 5 10],23,-1,38,-1,23
1,<environment.Job instance at 0x7f458c98be10>,23,16,[5 8],24,-1,40,-1,24
1,<environment.Job instance at 0x7f458c98bcd0>,25,12,[3 5],26,-1,38,-1,26
1,<environment.Job instance at 0x7f458c98baf0>,26,22,[3 8],27,-1,49,-1,27
1,<environment.Job instance at 0x7f458c98bb90>,27,14,[6 2],28,-1,42,-1,28
1,<environment.Job instance at 0x7f458c100be0>,38,17,[3 7],39,-1,56,-1,39
1,<environment.Job instance at 0x7f458c100140>,40,18,[9 4],41,-1,68,-1,50
1,<environment.Job instance at 0x7f458c0edf50>,43,14,[ 1 10],44,-1,64,-1,50
1,<environment.Job instance at 0x7f458c0ed5f0>,48,24,[8 2],49,-1,74,-1,50
1,<environment.Job instance at 0x7f458c1005f0>,41,12,[ 4 10],42,-1,62,-1,50
1,<environment.Job instance at 0x7f458c0ed500>,46,13,[2 9],47,-1,63,-1,50
1,<environment.Job instance at 0x7f458c0ed550>,50,18,[ 2 12],51,-1,69,-1,51
1,<environment.Job instance at 0x7f458c0ed870>,51,15,[10  3],52,-1,67,-1,52
1,<environment.Job instance at 0x7f458c0ed410>,52,18,[1 9],53,-1,71,-1,53
1,<environment.Job instance at 0x7f458c0ed4b0>,53,17,[6 3],54,-1,71,-1,54
1,<environment.Job instance at 0x7f458c113e10>,54,17,[7 1],55,-1,72,-1,55
1,<environment.Job instance at 0x7f458c98beb0>,18,14,[3 7],19,-1,71,-1,57
1,<environment.Job instance at 0x7f458c0ed370>,49,27,[ 3 13],50,-1,85,-1,58
1,<environment.Job instance at 0x7f458c113140>,55,3,[5 4],56,-1,61,-1,58
1,<environment.Job instance at 0x7f458c113050>,57,13,[ 2 10],58,-1,72,-1,59
1,<environment.Job instance at 0x7f458c0ed0f0>,44,17,[14  4],45,-1,78,-1,61
1,<environment.Job instance at 0x7f458c113b90>,62,18,[4 9],63,-1,81,-1,63
1,<environment.Job instance at 0x7f458c113af0>,63,1,[10  4],64,-1,65,-1,64
1,<environment.Job instance at 0x7f458c113aa0>,64,15,[9 5],65,-1,80,-1,65
1,<environment.Job instance at 0x7f458c1137d0>,66,18,[8 5],67,-1,85,-1,67
1,<environment.Job instance at 0x7f458c113320>,60,14,[5 7],61,-1,81,-1,67
1,<environment.Job instance at 0x7f458c0f4f00>,73,26,[7 3],74,-1,100,-1,74
1,<environment.Job instance at 0x7f458c0f4c80>,71,12,[7 1],72,-1,87,-1,75
1,<environment.Job instance at 0x7f458c0f4320>,74,13,[1 9],75,-1,88,-1,75
1,<environment.Job instance at 0x7f458c0f4be0>,75,12,[9 2],76,-1,89,-1,77
1,<environment.Job instance at 0x7f458c0f4550>,77,27,[1 8],78,-1,105,-1,78
1,<environment.Job instance at 0x7f458c0edc80>,56,24,[13  3],57,-1,102,-1,78
1,<environment.Job instance at 0x7f458c0d73c0>,80,15,[2 8],81,-1,96,-1,81
1,<environment.Job instance at 0x7f458c0d7230>,81,17,[3 7],82,-1,99,-1,82
1,<environment.Job instance at 0x7f458c0d70f0>,84,15,[9 2],85,-1,100,-1,85
1,<environment.Job instance at 0x7f458c0d7c30>,86,12,[5 8],87,-1,99,-1,87
1,<environment.Job instance at 0x7f458c0dc4b0>,89,15,[4 6],90,-1,105,-1,90
1,<environment.Job instance at 0x7f458c0dcaa0>,90,26,[2 8],91,-1,117,-1,91
1,<environment.Job instance at 0x7f458c0dc050>,91,13,[5 2],92,-1,105,-1,92
1,<environment.Job instance at 0x7f458c0dcdc0>,92,14,[9 2],93,-1,107,-1,93
1,<environment.Job instance at 0x7f458c0dcc30>,93,14,[9 2],94,-1,108,-1,94
1,<environment.Job instance at 0x7f458c0dcf50>,95,16,[5 1],96,-1,112,-1,96
1,<environment.Job instance at 0x7f458c0dc780>,98,12,[9 4],99,-1,111,-1,99
1,<environment.Job instance at 0x7f458c0dc6e0>,100,20,[7 1],101,-1,121,-1,101
1,<environment.Job instance at 0x7f458c106140>,101,14,[9 4],102,-1,116,-1,102
1,<environment.Job instance at 0x7f458c106f00>,103,17,[3 7],104,-1,121,-1,104
1,<environment.Job instance at 0x7f458c1062d0>,104,21,[6 1],105,-1,126,-1,105
1,<environment.Job instance at 0x7f458b7fccd0>,0,12,[ 4 12],1,-1,13,-1,1
1,<environment.Job instance at 0x7f458b57cbe0>,19,27,[5 8],20,-1,81,-1,54
1,<environment.Job instance at 0x7f458c09bbe0>,35,15,[13  3],36,-1,101,-1,86
1,<environment.Job instance at 0x7f458c1cf960>,42,1,[14  1],43,-1,105,-1,104
1,<environment.Job instance at 0x7f4594faedc0>,44,17,[14  4],45,-1,135,-1,118
1,<environment.Job instance at 0x7f458c975730>,48,24,[8 2],49,-1,157,-1,133
1,<environment.Job instance at 0x7f458c975960>,49,27,[ 3 13],50,-1,160,-1,133
1,<environment.Job instance at 0x7f458bdfc2d0>,50,18,[ 2 12],51,-1,151,-1,133
1,<environment.Job instance at 0x7f458be26410>,56,24,[13  3],57,-1,179,-1,155
1,<environment.Job instance at 0x7f458b351c30>,73,26,[7 3],74,-1,246,-1,220
1,<environment.Job instance at 0x7f458c7ed2d0>,77,27,[1 8],78,-1,271,-1,244
1,<environment.Job instance at 0x7f458bdfb910>,90,26,[2 8],91,-1,325,-1,299
1,<environment.Job instance at 0x7f4594f505a0>,99,17,[12  4],100,-1,345,-1,328
1,<environment.Job instance at 0x7f458b552780>,105,17,[ 1 11],106,-1,357,-1,340
1,<environment.Job instance at 0x7f458c346b90>,107,13,[12  4],108,-1,367,-1,354
1,<environment.Job instance at 0x7f458bafd050>,5,24,[7 4],6,-1,30,-1,6
1,<environment.Job instance at 0x7f458bafdaf0>,6,14,[9 1],7,-1,25,-1,11
1,<environment.Job instance at 0x7f458bafde10>,11,14,[ 2 10],12,-1,26,-1,12
1,<environment.Job instance at 0x7f458bafd4b0>,13,18,[8 3],14,-1,32,-1,14
1,<environment.Job instance at 0x7f458bafd1e0>,14,12,[7 5],15,-1,27,-1,15
1,<environment.Job instance at 0x7f458bafd640>,15,25,[6 2],16,-1,41,-1,16
1,<environment.Job instance at 0x7f458b29e050>,19,18,[ 1 10],20,-1,38,-1,20
1,<environment.Job instance at 0x7f458b29e0f0>,22,15,[4 5],23,-1,38,-1,23
1,<environment.Job instance at 0x7f458b29ec30>,25,18,[4 5],26,-1,44,-1,26
1,<environment.Job instance at 0x7f458b29ebe0>,27,17,[8 3],28,-1,45,-1,28
1,<environment.Job instance at 0x7f458b29e190>,28,14,[9 3],29,-1,43,-1,29
1,<environment.Job instance at 0x7f4594f2a050>,30,17,[8 5],31,-1,48,-1,31
1,<environment.Job instance at 0x7f4594f2a1e0>,31,15,[3 7],32,-1,47,-1,32
1,<environment.Job instance at 0x7f4594f2a7d0>,32,21,[9 5],33,-1,54,-1,33
1,<environment.Job instance at 0x7f4595553e60>,46,17,[3 5],47,-1,64,-1,47
1,<environment.Job instance at 0x7f4595553f00>,44,18,[9 2],45,-1,66,-1,48
1,<environment.Job instance at 0x7f45955536e0>,42,15,[ 1 10],43,-1,63,-1,48
1,<environment.Job instance at 0x7f458b29ee60>,0,24,[ 4 14],1,-1,25,-1,1
1,<environment.Job instance at 0x7f458b683190>,4,14,[ 1 11],5,-1,19,-1,5
1,<environment.Job instance at 0x7f458bafd0a0>,5,24,[7 4],6,-1,40,-1,16
1,<environment.Job instance at 0x7f4595481230>,15,25,[6 2],16,-1,56,-1,31
1,<environment.Job instance at 0x7f458babaaf0>,16,2,[ 1 13],17,-1,33,-1,31
1,<environment.Job instance at 0x7f458beff9b0>,26,26,[10  2],27,-1,78,-1,52
1,<environment.Job instance at 0x7f4594fae820>,34,1,[12  5],35,-1,82,-1,81
1,<environment.Job instance at 0x7f458c09bbe0>,35,1,[ 2 14],36,-1,82,-1,81
1,<environment.Job instance at 0x7f458c9479b0>,37,2,[14  3],38,-1,87,-1,85
1,<environment.Job instance at 0x7f458bac5e10>,48,28,[ 2 11],49,-1,164,-1,136
1,<environment.Job instance at 0x7f4595553690>,56,15,[ 2 12],57,-1,185,-1,170
1,<environment.Job instance at 0x7f458c113d70>,60,12,[ 1 11],61,-1,194,-1,182
1,<environment.Job instance at 0x7f458b7fcc80>,63,15,[ 5 12],64,-1,211,-1,196
1,<environment.Job instance at 0x7f458b58c5a0>,80,17,[11  3],81,-1,281,-1,264
1,<environment.Job instance at 0x7f458c4b7870>,97,24,[8 1],98,-1,367,-1,343
1,<environment.Job instance at 0x7f458b8cc230>,101,28,[5 9],102,-1,377,-1,349
1,<environment.Job instance at 0x7f458c97a780>,103,28,[6 1],104,-1,377,-1,349
1,<environment.Job instance at 0x7f458c402960>,108,23,[ 3 10],109,-1,396,-1,373
1,<environment.Job instance at 0x7f458bffb2d0>,113,18,[ 5 11],114,-1,403,-1,385
1,<environment.Job instance at 0x7f458c2dc2d0>,2,18,[6 5],3,-1,21,-1,3
1,<environment.Job instance at 0x7f458c2dc820>,6,22,[3 7],7,-1,30,-1,8
1,<environment.Job instance at 0x7f458b152500>,9,14,[3 7],10,-1,24,-1,10
1,<environment.Job instance at 0x7f458b152410>,10,17,[9 5],11,-1,28,-1,11
1,<environment.Job instance at 0x7f458b152af0>,11,14,[9 4],12,-1,26,-1,12
1,<environment.Job instance at 0x7f458b152370>,13,12,[2 8],14,-1,26,-1,14
1,<environment.Job instance at 0x7f458b1523c0>,14,18,[6 5],15,-1,33,-1,15
1,<environment.Job instance at 0x7f458b152be0>,16,28,[7 3],17,-1,45,-1,17
1,<environment.Job instance at 0x7f458b751370>,18,18,[1 8],19,-1,37,-1,19
1,<environment.Job instance at 0x7f458c2dc730>,7,21,[5 3],8,-1,40,-1,19
1,<environment.Job instance at 0x7f458b152730>,19,21,[10  5],20,-1,42,-1,21
1,<environment.Job instance at 0x7f458b743140>,27,16,[2 6],28,-1,44,-1,28
1,<environment.Job instance at 0x7f458b743410>,28,17,[7 4],29,-1,46,-1,29
1,<environment.Job instance at 0x7f458b743cd0>,30,12,[4 8],31,-1,43,-1,31
1,<environment.Job instance at 0x7f458b6f1230>,31,16,[6 2],32,-1,48,-1,32
1,<environment.Job instance at 0x7f458b6f1d70>,32,20,[1 9],33,-1,53,-1,33
1,<environment.Job instance at 0x7f458b6f14b0>,33,18,[3 7],34,-1,52,-1,34
1,<environment.Job instance at 0x7f459554d0f0>,36,18,[3 6],37,-1,55,-1,37
1,<environment.Job instance at 0x7f458c7c55a0>,38,17,[2 5],39,-1,56,-1,39
1,<environment.Job instance at 0x7f458b742230>,44,18,[2 9],45,-1,63,-1,45
1,<environment.Job instance at 0x7f458b742be0>,45,26,[5 5],46,-1,72,-1,46
1,<environment.Job instance at 0x7f458b742640>,47,15,[8 4],48,-1,63,-1,48
1,<environment.Job instance at 0x7f458b7420a0>,48,22,[10  5],49,-1,76,-1,54
1,<environment.Job instance at 0x7f458b99a640>,54,25,[9 4],55,-1,80,-1,55
1,<environment.Job instance at 0x7f458bd7ccd0>,50,17,[2 7],51,-1,72,-1,55
1,<environment.Job instance at 0x7f458b3d99b0>,60,25,[9 5],61,-1,86,-1,61
1,<environment.Job instance at 0x7f458bb61a50>,57,14,[4 5],58,-1,79,-1,65
1,<environment.Job instance at 0x7f458b366b40>,65,22,[6 4],66,-1,88,-1,66
1,<environment.Job instance at 0x7f458b3c1370>,66,15,[7 3],67,-1,83,-1,68
1,<environment.Job instance at 0x7f458b70cbe0>,71,16,[ 2 10],72,-1,89,-1,73
1,<environment.Job instance at 0x7f458b70cf50>,75,16,[10  3],76,-1,93,-1,77
1,<environment.Job instance at 0x7f458b70c960>,76,18,[8 3],77,-1,95,-1,77
1,<environment.Job instance at 0x7f458b3e5370>,72,22,[2 7],73,-1,102,-1,80
1,<environment.Job instance at 0x7f458b6d3cd0>,64,17,[6 3],65,-1,99,-1,82
1,<environment.Job instance at 0x7f458b73c4b0>,80,15,[9 4],81,-1,97,-1,82
1,<environment.Job instance at 0x7f458b73c0f0>,81,14,[8 1],82,-1,96,-1,82
1,<environment.Job instance at 0x7f458b73c960>,82,17,[9 5],83,-1,102,-1,85
1,<environment.Job instance at 0x7f458b73caa0>,86,16,[6 4],87,-1,103,-1,87
1,<environment.Job instance at 0x7f458c524460>,87,25,[6 4],88,-1,113,-1,88
1,<environment.Job instance at 0x7f458b72f8c0>,101,21,[4 7],102,-1,869,-1,848
1,<environment.Job instance at 0x7f458c7c5690>,37,26,[ 2 12],38,-1,880,-1,854
1,<environment.Job instance at 0x7f458b3639b0>,93,18,[10  5],94,-1,873,-1,855
1,<environment.Job instance at 0x7f458b36afa0>,107,13,[ 2 10],108,-1,872,-1,859
1,<environment.Job instance at 0x7f458b705550>,110,18,[7 3],111,-1,878,-1,860
1,<environment.Job instance at 0x7f458b36a870>,105,17,[4 6],106,-1,878,-1,861
1,<environment.Job instance at 0x7f458b7058c0>,111,26,[5 4],112,-1,890,-1,864
1,<environment.Job instance at 0x7f458b705fa0>,116,17,[5 2],117,-1,881,-1,864
1,<environment.Job instance at 0x7f458b705a50>,118,26,[ 3 10],119,-1,890,-1,864
1,<environment.Job instance at 0x7f458b72fdc0>,98,16,[8 2],99,-1,880,-1,864
1,<environment.Job instance at 0x7f458b73c550>,85,27,[5 8],86,-1,891,-1,864
1,<environment.Job instance at 0x7f458b70ce10>,3,1,[13  4],4,-1,5,-1,4
1,<environment.Job instance at 0x7f458b743a00>,4,17,[12  2],5,-1,22,-1,5
1,<environment.Job instance at 0x7f458c470a00>,16,28,[7 3],17,-1,65,-1,37
1,<environment.Job instance at 0x7f458b9ca6e0>,25,16,[ 4 14],26,-1,71,-1,55
1,<environment.Job instance at 0x7f458c1e8cd0>,37,26,[ 2 12],38,-1,128,-1,102
1,<environment.Job instance at 0x7f458b9c9cd0>,39,1,[ 3 12],40,-1,103,-1,102
1,<environment.Job instance at 0x7f458b589230>,42,3,[11  1],43,-1,109,-1,106
1,<environment.Job instance at 0x7f458ba685f0>,45,26,[5 5],46,-1,150,-1,124
1,<environment.Job instance at 0x7f458c0ca370>,54,25,[9 4],55,-1,180,-1,155
1,<environment.Job instance at 0x7f458ba97f50>,60,25,[9 5],61,-1,189,-1,164
1,<environment.Job instance at 0x7f458baa80f0>,61,3,[11  1],62,-1,167,-1,164
1,<environment.Job instance at 0x7f458baa87d0>,62,3,[12  5],63,-1,167,-1,164
1,<environment.Job instance at 0x7f458c3a3190>,70,26,[10  1],71,-1,251,-1,225
1,<environment.Job instance at 0x7f458c467be0>,85,27,[5 8],86,-1,304,-1,277
1,<environment.Job instance at 0x7f458c467aa0>,87,25,[6 4],88,-1,314,-1,289
1,<environment.Job instance at 0x7f458c467eb0>,89,25,[10  1],90,-1,318,-1,293
1,<environment.Job instance at 0x7f458c467d70>,90,14,[ 1 14],91,-1,307,-1,293
1,<environment.Job instance at 0x7f458c3aea00>,111,26,[5 4],112,-1,389,-1,363
1,<environment.Job instance at 0x7f458c3a5780>,118,26,[ 3 10],119,-1,411,-1,385
1,<environment.Job instance at 0x7f458b5a86e0>,11,16,[5 4],12,-1,28,-1,12
1,<environment.Job instance at 0x7f458b5a8320>,12,18,[2 9],13,-1,31,-1,13
1,<environment.Job instance at 0x7f458b5a8640>,13,14,[3 7],14,-1,28,-1,14
1,<environment.Job instance at 0x7f458b5a8c80>,19,13,[3 8],20,-1,33,-1,20
1,<environment.Job instance at 0x7f458b5a8e60>,23,18,[5 5],24,-1,43,-1,25
1,<environment.Job instance at 0x7f458b5a8cd0>,24,16,[10  2],25,-1,41,-1,25
1,<environment.Job instance at 0x7f458b59b690>,25,13,[4 8],26,-1,40,-1,27
1,<environment.Job instance at 0x7f458b59b780>,29,13,[4 7],30,-1,43,-1,30
1,<environment.Job instance at 0x7f458b59b640>,32,15,[5 5],33,-1,48,-1,33
1,<environment.Job instance at 0x7f458b59b1e0>,33,12,[9 5],34,-1,46,-1,34
1,<environment.Job instance at 0x7f458b59bd70>,34,18,[ 3 10],35,-1,53,-1,35
1,<environment.Job instance at 0x7f458b59b370>,35,14,[5 8],36,-1,50,-1,36
1,<environment.Job instance at 0x7f458b59b0a0>,36,14,[5 5],37,-1,51,-1,37
1,<environment.Job instance at 0x7f458b59b280>,37,17,[3 7],38,-1,55,-1,38
1,<environment.Job instance at 0x7f458b59b960>,38,16,[7 5],39,-1,55,-1,39
1,<environment.Job instance at 0x7f458b59bc30>,39,20,[5 5],40,-1,60,-1,40
1,<environment.Job instance at 0x7f458b587b40>,45,15,[1 9],46,-1,61,-1,46
1,<environment.Job instance at 0x7f458b587d70>,46,18,[1 8],47,-1,65,-1,47
1,<environment.Job instance at 0x7f458b587370>,53,13,[7 4],54,-1,70,-1,57
1,<environment.Job instance at 0x7f458ba41230>,57,28,[8 2],58,-1,86,-1,58
1,<environment.Job instance at 0x7f458ba414b0>,58,15,[8 5],59,-1,74,-1,59
1,<environment.Job instance at 0x7f458ba41190>,60,17,[14  5],61,-1,79,-1,62
1,<environment.Job instance at 0x7f458ba416e0>,61,14,[13  2],62,-1,77,-1,63
1,<environment.Job instance at 0x7f458ba412d0>,62,16,[5 6],63,-1,80,-1,64
1,<environment.Job instance at 0x7f458b8c30f0>,66,15,[3 6],67,-1,82,-1,67
1,<environment.Job instance at 0x7f458b8c3820>,70,22,[9 5],71,-1,93,-1,71
1,<environment.Job instance at 0x7f458b8c3f50>,72,27,[8 4],73,-1,100,-1,73
1,<environment.Job instance at 0x7f458b8c3c80>,71,17,[6 1],72,-1,94,-1,77
1,<environment.Job instance at 0x7f458b59ddc0>,77,17,[1 5],78,-1,95,-1,78
1,<environment.Job instance at 0x7f458b59d3c0>,78,18,[8 4],79,-1,101,-1,83
1,<environment.Job instance at 0x7f458b59d410>,80,16,[5 2],81,-1,99,-1,83
1,<environment.Job instance at 0x7f458b59d7d0>,83,25,[ 4 10],84,-1,109,-1,84
1,<environment.Job instance at 0x7f458b587a50>,51,14,[10  5],52,-1,111,-1,97
1,<environment.Job instance at 0x7f458ba428c0>,92,17,[4 5],93,-1,114,-1,97
1,<environment.Job instance at 0x7f458b59d6e0>,85,17,[11  2],86,-1,114,-1,97
1,<environment.Job instance at 0x7f458ba42050>,93,19,[8 5],94,-1,117,-1,98
1,<environment.Job instance at 0x7f458ba46370>,99,22,[3 7],100,-1,123,-1,101
1,<environment.Job instance at 0x7f458ba46a50>,100,16,[6 4],101,-1,118,-1,102
1,<environment.Job instance at 0x7f458b6cd730>,102,12,[ 4 10],103,-1,118,-1,106
1,<environment.Job instance at 0x7f458ba31fa0>,106,20,[5 3],107,-1,127,-1,107
1,<environment.Job instance at 0x7f458ba11320>,112,18,[9 2],113,-1,136,-1,118
1,<environment.Job instance at 0x7f458c3a3af0>,17,3,[ 5 11],18,-1,45,-1,42
1,<environment.Job instance at 0x7f458b8c33c0>,21,18,[ 3 14],22,-1,67,-1,49
1,<environment.Job instance at 0x7f458c0cabe0>,28,13,[14  3],29,-1,92,-1,79
1,<environment.Job instance at 0x7f458b9c9f00>,47,2,[13  4],48,-1,156,-1,154
1,<environment.Job instance at 0x7f458b649320>,56,13,[13  5],57,-1,199,-1,186
1,<environment.Job instance at 0x7f458b33f870>,60,17,[14  5],61,-1,218,-1,201
1,<environment.Job instance at 0x7f458b33f8c0>,61,14,[13  2],62,-1,215,-1,201
1,<environment.Job instance at 0x7f458b33f7d0>,57,28,[8 2],58,-1,230,-1,202
1,<environment.Job instance at 0x7f458ba039b0>,72,27,[8 4],73,-1,254,-1,227
1,<environment.Job instance at 0x7f458bc45140>,82,1,[ 1 13],83,-1,249,-1,248
1,<environment.Job instance at 0x7f458bb5fb90>,85,17,[11  2],86,-1,280,-1,263
1,<environment.Job instance at 0x7f458bb5fc80>,89,21,[14  3],90,-1,287,-1,266
1,<environment.Job instance at 0x7f458c8c8e60>,83,25,[ 4 10],84,-1,307,-1,282
1,<environment.Job instance at 0x7f458b646fa0>,107,1,[ 2 11],108,-1,305,-1,304
1,<environment.Job instance at 0x7f458c478370>,114,17,[11  1],115,-1,346,-1,329
1,<environment.Job instance at 0x7f458c0c30f0>,0,17,[10  5],1,-1,19,-1,2
1,<environment.Job instance at 0x7f458c0c35f0>,3,14,[8 3],4,-1,19,-1,5
1,<environment.Job instance at 0x7f458b529c30>,4,13,[10  2],5,-1,18,-1,5
1,<environment.Job instance at 0x7f458b529cd0>,5,17,[9 4],6,-1,23,-1,6
1,<environment.Job instance at 0x7f458b529eb0>,6,16,[10  4],7,-1,25,-1,9
1,<environment.Job instance at 0x7f458b523050>,8,14,[10  3],9,-1,23,-1,9
1,<environment.Job instance at 0x7f458b523410>,12,18,[3 6],13,-1,31,-1,13
1,<environment.Job instance at 0x7f458b523500>,13,16,[5 8],14,-1,30,-1,14
1,<environment.Job instance at 0x7f458b523910>,18,18,[2 8],19,-1,37,-1,19
1,<environment.Job instance at 0x7f458b523960>,20,15,[5 9],21,-1,36,-1,21
1,<environment.Job instance at 0x7f458b523c30>,21,18,[8 4],22,-1,40,-1,22
1,<environment.Job instance at 0x7f458b523d20>,23,18,[4 6],24,-1,42,-1,24
1,<environment.Job instance at 0x7f458b53b320>,30,16,[7 5],31,-1,47,-1,31
1,<environment.Job instance at 0x7f458b53bb40>,35,28,[5 5],36,-1,64,-1,36
1,<environment.Job instance at 0x7f458b53bb90>,36,15,[6 4],37,-1,52,-1,37
1,<environment.Job instance at 0x7f458b53bd20>,38,14,[3 7],39,-1,53,-1,39
1,<environment.Job instance at 0x7f458b53beb0>,39,18,[1 5],40,-1,58,-1,40
1,<environment.Job instance at 0x7f458b53bfa0>,41,21,[4 8],42,-1,63,-1,42
1,<environment.Job instance at 0x7f458b5100a0>,42,14,[1 7],43,-1,58,-1,44
1,<environment.Job instance at 0x7f458b53bf00>,43,16,[10  5],44,-1,60,-1,44
1,<environment.Job instance at 0x7f458b510cd0>,53,13,[10  4],54,-1,71,-1,58
1,<environment.Job instance at 0x7f458b530c80>,58,22,[4 8],59,-1,81,-1,59
1,<environment.Job instance at 0x7f458b530280>,59,16,[ 4 11],60,-1,76,-1,60
1,<environment.Job instance at 0x7f458b530eb0>,60,28,[4 7],61,-1,89,-1,61
1,<environment.Job instance at 0x7f458b5309b0>,65,14,[4 5],66,-1,80,-1,66
1,<environment.Job instance at 0x7f458b7bbaa0>,71,15,[4 5],72,-1,87,-1,72
1,<environment.Job instance at 0x7f458b536730>,72,16,[10  5],73,-1,89,-1,73
1,<environment.Job instance at 0x7f458b536370>,57,12,[8 1],58,-1,88,-1,76
1,<environment.Job instance at 0x7f458b2fb460>,76,12,[3 9],77,-1,89,-1,77
1,<environment.Job instance at 0x7f458b2fb190>,77,17,[ 4 14],78,-1,95,-1,78
1,<environment.Job instance at 0x7f458bc06140>,78,18,[2 9],79,-1,97,-1,79
1,<environment.Job instance at 0x7f458b07cc80>,79,17,[6 4],80,-1,97,-1,80
1,<environment.Job instance at 0x7f458b2f7cd0>,80,14,[3 9],81,-1,95,-1,81
1,<environment.Job instance at 0x7f458b2f70a0>,81,16,[ 4 10],82,-1,98,-1,82
1,<environment.Job instance at 0x7f458b2d4870>,86,16,[7 1],87,-1,104,-1,88
1,<environment.Job instance at 0x7f458b2d4960>,88,17,[ 1 10],89,-1,106,-1,89
1,<environment.Job instance at 0x7f458b2f9370>,89,15,[7 2],90,-1,110,-1,95
1,<environment.Job instance at 0x7f458b2c2cd0>,95,16,[5 2],96,-1,112,-1,96
1,<environment.Job instance at 0x7f458b79d6e0>,100,14,[3 8],101,-1,116,-1,102
1,<environment.Job instance at 0x7f458b2f3aa0>,104,17,[4 9],105,-1,122,-1,105
1,<environment.Job instance at 0x7f458b2f35a0>,105,17,[ 5 10],106,-1,124,-1,107
1,<environment.Job instance at 0x7f458b2f3be0>,109,18,[9 4],110,-1,128,-1,110
1,<environment.Job instance at 0x7f458b53b0a0>,7,3,[ 5 11],8,-1,21,-1,18
1,<environment.Job instance at 0x7f458c478c30>,24,12,[13  3],25,-1,108,-1,96
1,<environment.Job instance at 0x7f458bb539b0>,35,28,[5 5],36,-1,163,-1,135
1,<environment.Job instance at 0x7f458b3e5190>,40,12,[ 4 14],41,-1,161,-1,149
1,<environment.Job instance at 0x7f458bb5faa0>,48,1,[ 1 11],49,-1,180,-1,179
1,<environment.Job instance at 0x7f458ba03320>,59,16,[ 4 11],60,-1,216,-1,200
1,<environment.Job instance at 0x7f458ba03690>,60,28,[4 7],61,-1,229,-1,201
1,<environment.Job instance at 0x7f458ba03140>,61,15,[ 5 14],62,-1,216,-1,201
1,<environment.Job instance at 0x7f458ba03b90>,63,14,[ 3 11],64,-1,215,-1,201
1,<environment.Job instance at 0x7f458b9c91e0>,77,17,[ 4 14],78,-1,275,-1,258
1,<environment.Job instance at 0x7f458c3a37d0>,111,16,[14  3],112,-1,394,-1,378
1,<environment.Job instance at 0x7f458bc65140>,112,3,[ 1 14],113,-1,381,-1,378
1,<environment.Job instance at 0x7f458bec6aa0>,3,17,[9 1],4,-1,22,-1,5
1,<environment.Job instance at 0x7f458bec6d70>,5,14,[3 5],6,-1,20,-1,6
1,<environment.Job instance at 0x7f458c4620a0>,4,13,[10  1],5,-1,19,-1,6
1,<environment.Job instance at 0x7f458bec64b0>,7,18,[7 5],8,-1,26,-1,8
1,<environment.Job instance at 0x7f458c648a50>,9,18,[ 3 10],10,-1,29,-1,11
1,<environment.Job instance at 0x7f458c648a00>,11,18,[5 9],12,-1,30,-1,12
1,<environment.Job instance at 0x7f458c6485f0>,12,14,[9 2],13,-1,28,-1,14
1,<environment.Job instance at 0x7f458c648280>,13,17,[8 4],14,-1,31,-1,14
1,<environment.Job instance at 0x7f458c648730>,15,18,[9 4],16,-1,35,-1,17
1,<environment.Job instance at 0x7f458c648eb0>,16,25,[6 2],17,-1,42,-1,17
1,<environment.Job instance at 0x7f458c648cd0>,19,17,[7 1],20,-1,38,-1,21
1,<environment.Job instance at 0x7f458c648be0>,20,15,[8 3],21,-1,37,-1,22
1,<environment.Job instance at 0x7f458be62410>,25,18,[3 6],26,-1,44,-1,26
1,<environment.Job instance at 0x7f458be624b0>,29,16,[10  3],30,-1,46,-1,30
1,<environment.Job instance at 0x7f458be62fa0>,31,20,[5 3],32,-1,52,-1,32
1,<environment.Job instance at 0x7f458b2515f0>,32,24,[8 2],33,-1,57,-1,33
1,<environment.Job instance at 0x7f458b251c80>,34,15,[4 9],35,-1,50,-1,35
1,<environment.Job instance at 0x7f458b251640>,36,14,[5 9],37,-1,51,-1,37
1,<environment.Job instance at 0x7f458b5ddb90>,45,12,[8 3],46,-1,59,-1,47
1,<environment.Job instance at 0x7f458b5ddf50>,47,12,[7 5],48,-1,60,-1,48
1,<environment.Job instance at 0x7f458c28e1e0>,49,25,[1 7],50,-1,75,-1,50
1,<environment.Job instance at 0x7f458b5cedc0>,51,16,[5 9],52,-1,68,-1,52
1,<environment.Job instance at 0x7f458b5cec30>,52,17,[7 4],53,-1,70,-1,53
1,<environment.Job instance at 0x7f458b5ce640>,55,13,[1 5],56,-1,69,-1,56
1,<environment.Job instance at 0x7f458b5ce870>,56,17,[10  4],57,-1,74,-1,57
1,<environment.Job instance at 0x7f458b5cea00>,57,14,[7 2],58,-1,72,-1,58
1,<environment.Job instance at 0x7f458b5cef50>,58,14,[ 5 11],59,-1,73,-1,59
1,<environment.Job instance at 0x7f458b5ce230>,59,17,[1 7],60,-1,77,-1,60
1,<environment.Job instance at 0x7f458b5cecd0>,60,14,[2 6],61,-1,75,-1,61
1,<environment.Job instance at 0x7f458b5cebe0>,62,18,[ 1 10],63,-1,81,-1,63
1,<environment.Job instance at 0x7f458b5cef00>,63,15,[1 5],64,-1,79,-1,64
1,<environment.Job instance at 0x7f458b5ce0f0>,64,12,[9 4],65,-1,77,-1,65
1,<environment.Job instance at 0x7f458b5ce0a0>,65,18,[6 1],66,-1,84,-1,66
1,<environment.Job instance at 0x7f458b5ce6e0>,66,15,[4 7],67,-1,82,-1,67
1,<environment.Job instance at 0x7f458bf679b0>,68,17,[9 3],69,-1,86,-1,69
1,<environment.Job instance at 0x7f458bf67fa0>,70,14,[10  1],71,-1,85,-1,71
1,<environment.Job instance at 0x7f458bf67b40>,72,18,[10  1],73,-1,91,-1,73
1,<environment.Job instance at 0x7f458bf67500>,73,15,[7 2],74,-1,89,-1,74
1,<environment.Job instance at 0x7f458bf67190>,74,27,[1 7],75,-1,102,-1,75
1,<environment.Job instance at 0x7f45951bbeb0>,76,13,[4 6],77,-1,91,-1,78
1,<environment.Job instance at 0x7f45951bb0f0>,78,17,[3 6],79,-1,96,-1,79
1,<environment.Job instance at 0x7f458c849190>,82,15,[4 7],83,-1,98,-1,83
1,<environment.Job instance at 0x7f458c849b40>,83,14,[9 2],84,-1,98,-1,84
1,<environment.Job instance at 0x7f458c849730>,86,16,[1 9],87,-1,103,-1,87
1,<environment.Job instance at 0x7f458c849640>,91,18,[4 6],92,-1,110,-1,92
1,<environment.Job instance at 0x7f458c8494b0>,93,12,[5 5],94,-1,106,-1,94
1,<environment.Job instance at 0x7f458c562aa0>,94,14,[1 7],95,-1,109,-1,95
1,<environment.Job instance at 0x7f458c562f00>,95,13,[10  4],96,-1,109,-1,96
1,<environment.Job instance at 0x7f458c562460>,96,19,[5 4],97,-1,116,-1,97
1,<environment.Job instance at 0x7f458c5624b0>,97,17,[1 8],98,-1,115,-1,98
1,<environment.Job instance at 0x7f458c562690>,98,18,[4 6],99,-1,117,-1,99
1,<environment.Job instance at 0x7f458c5621e0>,102,14,[5 6],103,-1,117,-1,103
1,<environment.Job instance at 0x7f458b39a050>,103,18,[10  1],104,-1,122,-1,104
1,<environment.Job instance at 0x7f458b39a320>,104,15,[9 3],105,-1,120,-1,105
1,<environment.Job instance at 0x7f458c40d780>,106,17,[ 2 10],107,-1,124,-1,107
1,<environment.Job instance at 0x7f458c3c7960>,111,16,[9 3],112,-1,128,-1,112
1,<environment.Job instance at 0x7f458b810280>,112,15,[ 2 12],113,-1,128,-1,113
1,<environment.Job instance at 0x7f458b72f5a0>,6,3,[ 5 11],7,-1,10,-1,7
1,<environment.Job instance at 0x7f45951bbaf0>,14,24,[8 1],15,-1,64,-1,40
1,<environment.Job instance at 0x7f458c562280>,16,25,[6 2],17,-1,70,-1,45
1,<environment.Job instance at 0x7f458c0bf4b0>,32,24,[8 2],33,-1,138,-1,114
1,<environment.Job instance at 0x7f458b59d500>,37,12,[13  5],38,-1,128,-1,116
1,<environment.Job instance at 0x7f458b587280>,42,2,[ 1 12],43,-1,133,-1,131
1,<environment.Job instance at 0x7f458bdf3af0>,49,25,[1 7],50,-1,183,-1,158
1,<environment.Job instance at 0x7f458ba03140>,58,14,[ 5 11],59,-1,212,-1,198
1,<environment.Job instance at 0x7f458bb5faa0>,74,27,[1 7],75,-1,320,-1,293
1,<environment.Job instance at 0x7f458c0b65f0>,105,16,[ 5 13],106,-1,446,-1,430
1,<environment.Job instance at 0x7f458c90ebe0>,109,16,[ 1 13],110,-1,472,-1,456
1,<environment.Job instance at 0x7f458c4dc2d0>,112,15,[ 2 12],113,-1,476,-1,461
1,<environment.Job instance at 0x7f458c4dc820>,116,17,[11  2],117,-1,482,-1,465
1,<environment.Job instance at 0x7f458bb1c190>,5,14,[ 2 10],6,-1,20,-1,6
1,<environment.Job instance at 0x7f458bb1cf50>,7,18,[2 7],8,-1,26,-1,8
1,<environment.Job instance at 0x7f458bb32730>,10,22,[9 3],11,-1,33,-1,11
1,<environment.Job instance at 0x7f458bb32b90>,11,28,[1 5],12,-1,40,-1,12
1,<environment.Job instance at 0x7f458bb32f00>,15,14,[7 4],16,-1,30,-1,16
1,<environment.Job instance at 0x7f458b027190>,17,22,[7 3],18,-1,40,-1,18
1,<environment.Job instance at 0x7f458b027050>,19,14,[6 4],20,-1,34,-1,20
1,<environment.Job instance at 0x7f458b027b90>,20,18,[1 7],21,-1,39,-1,21
1,<environment.Job instance at 0x7f458b45cc30>,23,15,[3 8],24,-1,39,-1,24
1,<environment.Job instance at 0x7f458b45cf00>,26,18,[12  4],27,-1,1642,-1,1624
1,<environment.Job instance at 0x7f458b019be0>,51,28,[6 2],52,-1,1652,-1,1624
1,<environment.Job instance at 0x7f458ba41b90>,60,12,[4 9],61,-1,1724,-1,1712
1,<environment.Job instance at 0x7f458c187c80>,87,18,[5 9],88,-1,1731,-1,1713
1,<environment.Job instance at 0x7f458c187a00>,88,25,[3 6],89,-1,1741,-1,1716
1,<environment.Job instance at 0x7f458b01daf0>,47,25,[1 9],48,-1,1745,-1,1720
1,<environment.Job instance at 0x7f458bb318c0>,90,17,[8 5],91,-1,1743,-1,1726
1,<environment.Job instance at 0x7f458bf73050>,92,13,[3 8],93,-1,1739,-1,1726
1,<environment.Job instance at 0x7f458bb31910>,89,13,[3 8],90,-1,1739,-1,1726
1,<environment.Job instance at 0x7f458b45c730>,29,18,[5 9],30,-1,1744,-1,1726
1,<environment.Job instance at 0x7f458bf73be0>,93,12,[5 7],94,-1,1738,-1,1726
1,<environment.Job instance at 0x7f458be72370>,98,15,[5 5],99,-1,1742,-1,1727
1,<environment.Job instance at 0x7f458bcaa500>,97,16,[2 5],98,-1,1743,-1,1727
1,<environment.Job instance at 0x7f458be72820>,103,17,[10  4],104,-1,1748,-1,1731
1,<environment.Job instance at 0x7f458be725a0>,106,21,[10  4],107,-1,1754,-1,1733
1,<environment.Job instance at 0x7f458be723c0>,107,15,[3 8],108,-1,1748,-1,1733
1,<environment.Job instance at 0x7f458b45c910>,31,27,[6 5],32,-1,1761,-1,1734
1,<environment.Job instance at 0x7f458c19f050>,110,16,[10  1],111,-1,1750,-1,1734
1,<environment.Job instance at 0x7f458c9dec80>,117,24,[9 5],118,-1,1771,-1,1747
1,<environment.Job instance at 0x7f458c9dea50>,111,18,[3 7],112,-1,1765,-1,1747
1,<environment.Job instance at 0x7f458b45ce60>,25,3,[14  3],26,-1,1750,-1,1747
1,<environment.Job instance at 0x7f458b027870>,16,14,[11  1],17,-1,1761,-1,1747
1,<environment.Job instance at 0x7f458bb1c230>,8,12,[ 1 13],9,-1,21,-1,9
1,<environment.Job instance at 0x7f458c8ec9b0>,12,12,[ 4 14],13,-1,32,-1,20
1,<environment.Job instance at 0x7f458c9c2050>,11,28,[1 5],12,-1,48,-1,20
1,<environment.Job instance at 0x7f458be7d690>,16,14,[11  1],17,-1,34,-1,20
1,<environment.Job instance at 0x7f458bf6d4b0>,24,2,[14  4],25,-1,54,-1,52
1,<environment.Job instance at 0x7f458bf6dcd0>,25,3,[14  3],26,-1,55,-1,52
1,<environment.Job instance at 0x7f458bf6d230>,26,18,[12  4],27,-1,70,-1,52
1,<environment.Job instance at 0x7f458bf6d690>,27,3,[ 4 13],28,-1,55,-1,52
1,<environment.Job instance at 0x7f458ba075a0>,31,27,[6 5],32,-1,107,-1,80
1,<environment.Job instance at 0x7f458ba076e0>,33,3,[ 1 13],34,-1,83,-1,80
1,<environment.Job instance at 0x7f458ba078c0>,36,16,[ 1 12],37,-1,98,-1,82
1,<environment.Job instance at 0x7f458b530690>,38,25,[10  1],39,-1,138,-1,113
1,<environment.Job instance at 0x7f458b5307d0>,39,23,[4 9],40,-1,142,-1,119
1,<environment.Job instance at 0x7f458b251410>,47,25,[1 9],48,-1,150,-1,125
1,<environment.Job instance at 0x7f458c648f00>,49,27,[9 3],50,-1,153,-1,126
1,<environment.Job instance at 0x7f458b0f40a0>,51,28,[6 2],52,-1,154,-1,126
1,<environment.Job instance at 0x7f458bd89410>,73,1,[ 4 14],74,-1,179,-1,178
1,<environment.Job instance at 0x7f458bd89870>,83,12,[ 1 14],84,-1,209,-1,197
1,<environment.Job instance at 0x7f458b6ebeb0>,88,25,[3 6],89,-1,242,-1,217
1,<environment.Job instance at 0x7f458b1ad410>,101,13,[ 4 11],102,-1,286,-1,273
1,<environment.Job instance at 0x7f458c92e0a0>,109,15,[14  4],110,-1,295,-1,280
1,<environment.Job instance at 0x7f458bee1e10>,117,24,[9 5],118,-1,339,-1,315
1,<environment.Job instance at 0x7f458b811230>,4,17,[7 2],5,-1,22,-1,5
1,<environment.Job instance at 0x7f458b12c640>,7,14,[3 8],8,-1,22,-1,8
1,<environment.Job instance at 0x7f458be0d190>,11,12,[ 5 10],12,-1,25,-1,13
1,<environment.Job instance at 0x7f458b12c050>,12,15,[9 5],13,-1,29,-1,14
1,<environment.Job instance at 0x7f458c633370>,21,20,[5 5],22,-1,42,-1,22
1,<environment.Job instance at 0x7f458c46ea00>,23,22,[2 8],24,-1,46,-1,24
1,<environment.Job instance at 0x7f458c46eb40>,24,14,[2 5],25,-1,39,-1,25
1,<environment.Job instance at 0x7f458bb3d2d0>,27,18,[3 6],28,-1,46,-1,28
1,<environment.Job instance at 0x7f45952d0a00>,30,13,[1 5],31,-1,44,-1,31
1,<environment.Job instance at 0x7f458c4a4320>,32,20,[ 1 10],33,-1,53,-1,33
1,<environment.Job instance at 0x7f458c4c29b0>,36,16,[ 2 10],37,-1,53,-1,37
1,<environment.Job instance at 0x7f458c4e1820>,40,12,[9 1],41,-1,55,-1,43
1,<environment.Job instance at 0x7f458c4e1f50>,44,18,[2 6],45,-1,63,-1,45
1,<environment.Job instance at 0x7f458c4c7230>,46,17,[3 9],47,-1,77,-1,60
1,<environment.Job instance at 0x7f458c4e1e60>,42,21,[9 2],43,-1,81,-1,60
1,<environment.Job instance at 0x7f458b78c960>,55,16,[4 8],56,-1,76,-1,60
1,<environment.Job instance at 0x7f458b7ba050>,65,13,[4 8],66,-1,81,-1,68
1,<environment.Job instance at 0x7f458b7ba820>,70,16,[ 4 10],71,-1,87,-1,71
1,<environment.Job instance at 0x7f458b7ba500>,67,16,[8 2],68,-1,90,-1,74
1,<environment.Job instance at 0x7f458b7ba4b0>,71,13,[8 5],72,-1,87,-1,74
1,<environment.Job instance at 0x7f458b7ba960>,72,18,[ 5 10],73,-1,92,-1,74
1,<environment.Job instance at 0x7f458b7baeb0>,77,13,[12  4],78,-1,94,-1,81
1,<environment.Job instance at 0x7f458b7a74b0>,81,16,[ 5 10],82,-1,98,-1,82
1,<environment.Job instance at 0x7f458b7a7f50>,97,22,[7 5],98,-1,218,-1,196
1,<environment.Job instance at 0x7f458b7b01e0>,98,18,[7 1],99,-1,256,-1,238
1,<environment.Job instance at 0x7f458b7b0d70>,113,18,[12  1],114,-1,259,-1,241
1,<environment.Job instance at 0x7f458b7b0e10>,114,18,[ 3 10],115,-1,259,-1,241
1,<environment.Job instance at 0x7f458b7b0a00>,118,16,[10  5],119,-1,257,-1,241
1,<environment.Job instance at 0x7f458b12c960>,6,1,[12  5],7,-1,8,-1,7
1,<environment.Job instance at 0x7f458beae780>,9,16,[13  2],10,-1,30,-1,14
1,<environment.Job instance at 0x7f458b794cd0>,35,13,[13  1],36,-1,87,-1,74
1,<environment.Job instance at 0x7f458bee11e0>,38,17,[ 3 13],39,-1,94,-1,77
1,<environment.Job instance at 0x7f458c92e910>,45,13,[ 4 14],46,-1,105,-1,92
1,<environment.Job instance at 0x7f458b1ad690>,52,25,[3 6],53,-1,136,-1,111
1,<environment.Job instance at 0x7f458b6eb7d0>,58,3,[ 1 13],59,-1,136,-1,133
1,<environment.Job instance at 0x7f458bd89370>,73,17,[13  3],74,-1,181,-1,164
1,<environment.Job instance at 0x7f458bd89dc0>,77,13,[12  4],78,-1,181,-1,168
1,<environment.Job instance at 0x7f458b0f4cd0>,87,18,[ 3 12],88,-1,234,-1,216
1,<environment.Job instance at 0x7f458b4f9780>,101,16,[ 1 11],102,-1,288,-1,272
1,<environment.Job instance at 0x7f458ba07820>,113,18,[12  1],114,-1,342,-1,324
1,<environment.Job instance at 0x7f3a69abbaf0>,2,14,[ 2 10],3,-1,18,-1,4
1,<environment.Job instance at 0x7f3a69abb9b0>,4,13,[3 6],5,-1,18,-1,5
1,<environment.Job instance at 0x7f3a730ab8c0>,3,22,[2 5],4,-1,28,-1,6
1,<environment.Job instance at 0x7f3a69abbe10>,7,14,[7 5],8,-1,22,-1,8
1,<environment.Job instance at 0x7f3a69abbf00>,8,17,[1 8],9,-1,26,-1,9
1,<environment.Job instance at 0x7f3a69abe050>,10,22,[8 1],11,-1,33,-1,11
1,<environment.Job instance at 0x7f3a69abe0f0>,12,23,[6 4],13,-1,36,-1,13
1,<environment.Job instance at 0x7f3a69abe3c0>,13,18,[5 9],14,-1,32,-1,14
1,<environment.Job instance at 0x7f3a69abe2d0>,14,21,[8 1],15,-1,36,-1,15
1,<environment.Job instance at 0x7f3a69abe4b0>,16,18,[7 3],17,-1,35,-1,17
1,<environment.Job instance at 0x7f3a69abe5a0>,18,26,[7 4],19,-1,45,-1,19
1,<environment.Job instance at 0x7f3a69abe7d0>,19,25,[5 9],20,-1,45,-1,20
1,<environment.Job instance at 0x7f3a69abe870>,21,18,[9 4],22,-1,40,-1,22
1,<environment.Job instance at 0x7f3a69abea50>,22,12,[3 8],23,-1,35,-1,23
1,<environment.Job instance at 0x7f3a69abe960>,23,16,[6 2],24,-1,40,-1,24
1,<environment.Job instance at 0x7f3a69abee60>,27,17,[4 6],28,-1,45,-1,28
1,<environment.Job instance at 0x7f3a69ac1aa0>,39,14,[9 4],40,-1,57,-1,43
1,<environment.Job instance at 0x7f3a69ac11e0>,32,21,[5 9],33,-1,64,-1,43
1,<environment.Job instance at 0x7f3a69ac1550>,37,14,[5 8],38,-1,57,-1,43
1,<environment.Job instance at 0x7f3a69ac13c0>,34,14,[1 9],35,-1,62,-1,48
1,<environment.Job instance at 0x7f3a69ac1f00>,45,15,[7 5],46,-1,64,-1,49
1,<environment.Job instance at 0x7f3a69ac42d0>,49,17,[10  2],50,-1,67,-1,50
1,<environment.Job instance at 0x7f3a69ac18c0>,40,26,[ 1 10],41,-1,81,-1,55
1,<environment.Job instance at 0x7f3a69ac4aa0>,55,12,[2 6],56,-1,68,-1,56
1,<environment.Job instance at 0x7f3a69ac4910>,57,16,[ 2 11],58,-1,74,-1,58
1,<environment.Job instance at 0x7f3a69ac49b0>,58,17,[3 7],59,-1,76,-1,59
1,<environment.Job instance at 0x7f3a69ac4e60>,59,19,[1 7],60,-1,79,-1,60
1,<environment.Job instance at 0x7f3a69ac6050>,62,14,[4 9],63,-1,77,-1,63
1,<environment.Job instance at 0x7f3a69ac46e0>,54,18,[7 1],55,-1,84,-1,66
1,<environment.Job instance at 0x7f3a69ac6370>,67,16,[1 9],68,-1,85,-1,69
1,<environment.Job instance at 0x7f3a69ac68c0>,69,14,[9 4],70,-1,84,-1,70
1,<environment.Job instance at 0x7f3a69ac6870>,72,18,[3 5],73,-1,91,-1,73
1,<environment.Job instance at 0x7f3a69ac70a0>,77,16,[8 1],78,-1,94,-1,78
1,<environment.Job instance at 0x7f3a69ac7500>,82,21,[4 8],83,-1,118,-1,97
1,<environment.Job instance at 0x7f3a69ac73c0>,80,1,[5 5],81,-1,101,-1,100
1,<environment.Job instance at 0x7f3a69ac1190>,33,26,[3 6],34,-1,150,-1,124
1,<environment.Job instance at 0x7f3a69ac7640>,84,1,[5 5],85,-1,125,-1,124
1,<environment.Job instance at 0x7f3a69ac6dc0>,76,13,[10  1],77,-1,137,-1,124
1,<environment.Job instance at 0x7f3a69ac72d0>,91,18,[5 4],92,-1,142,-1,124
1,<environment.Job instance at 0x7f3a69ac78c0>,88,16,[4 9],89,-1,140,-1,124
1,<environment.Job instance at 0x7f3a69ac7c80>,93,25,[ 1 10],94,-1,149,-1,124
1,<environment.Job instance at 0x7f3a69ac7dc0>,96,18,[2 6],97,-1,144,-1,126
1,<environment.Job instance at 0x7f3a69ac7320>,79,19,[10  3],80,-1,148,-1,129
1,<environment.Job instance at 0x7f3a69ac7a00>,90,3,[6 1],91,-1,133,-1,130
1,<environment.Job instance at 0x7f3a69af8460>,101,15,[2 7],102,-1,145,-1,130
1,<environment.Job instance at 0x7f3a69ac7960>,89,17,[ 5 14],90,-1,147,-1,130
1,<environment.Job instance at 0x7f3a69ac7140>,92,12,[5 5],93,-1,142,-1,130
1,<environment.Job instance at 0x7f3a69ab2730>,107,18,[5 5],108,-1,148,-1,130
1,<environment.Job instance at 0x7f3a69ab2f50>,109,27,[3 9],110,-1,157,-1,130
1,<environment.Job instance at 0x7f3a69ab2820>,110,23,[5 1],111,-1,153,-1,130
1,<environment.Job instance at 0x7f3a69b1cf00>,102,13,[9 4],103,-1,143,-1,130
1,<environment.Job instance at 0x7f3a69ab2af0>,111,17,[6 4],112,-1,147,-1,130
1,<environment.Job instance at 0x7f3a69bbd230>,103,16,[1 9],104,-1,146,-1,130
1,<environment.Job instance at 0x7f3a69f8ab40>,116,12,[8 4],117,-1,144,-1,132
1,<environment.Job instance at 0x7f3a69ab2a50>,113,17,[5 1],114,-1,151,-1,134
1,<environment.Job instance at 0x7f3a69bc8aa0>,119,28,[7 5],120,-1,162,-1,134
1,<environment.Job instance at 0x7f3a69bc85f0>,120,19,[ 5 12],121,-1,153,-1,134
1,<environment.Job instance at 0x7f3a69b653c0>,122,18,[7 5],123,-1,153,-1,135
1,<environment.Job instance at 0x7f3a69c46230>,127,14,[7 2],128,-1,149,-1,135
1,<environment.Job instance at 0x7f3a69b4e050>,128,1,[7 1],129,-1,136,-1,135
1,<environment.Job instance at 0x7f3a69ac6140>,12,23,[6 4],13,-1,53,-1,30
1,<environment.Job instance at 0x7f3a69ac6eb0>,18,26,[7 4],19,-1,70,-1,44
1,<environment.Job instance at 0x7f3a69b5ee60>,19,25,[5 9],20,-1,83,-1,58
1,<environment.Job instance at 0x7f3a69abb870>,28,17,[ 1 13],29,-1,87,-1,70
1,<environment.Job instance at 0x7f3a69ae3910>,30,26,[9 4],31,-1,110,-1,84
1,<environment.Job instance at 0x7f3a69ae3870>,31,1,[ 2 14],32,-1,85,-1,84
1,<environment.Job instance at 0x7f3a69bde550>,33,26,[3 6],34,-1,110,-1,84
1,<environment.Job instance at 0x7f3a69b6b5a0>,40,26,[ 1 10],41,-1,139,-1,113
1,<environment.Job instance at 0x7f3a69b6a9b0>,57,16,[ 2 11],58,-1,183,-1,167
1,<environment.Job instance at 0x7f3a69a923c0>,89,17,[ 5 14],90,-1,289,-1,272
1,<environment.Job instance at 0x7f3a69aa98c0>,93,25,[ 1 10],94,-1,320,-1,295
1,<environment.Job instance at 0x7f3a69aafcd0>,109,27,[3 9],110,-1,371,-1,344
1,<environment.Job instance at 0x7f3a69aaf410>,110,23,[5 1],111,-1,367,-1,344
1,<environment.Job instance at 0x7f3a69aaf2d0>,117,3,[ 3 13],118,-1,367,-1,364
1,<environment.Job instance at 0x7f3a69aab8c0>,119,28,[7 5],120,-1,406,-1,378
1,<environment.Job instance at 0x7f3a69aab960>,120,19,[ 5 12],121,-1,397,-1,378
1,<environment.Job instance at 0x7f3a69459a50>,0,17,[9 5],1,-1,18,-1,1
1,<environment.Job instance at 0x7f3a69494370>,2,18,[10  4],3,-1,21,-1,3
1,<environment.Job instance at 0x7f3a69494690>,5,15,[8 3],6,-1,21,-1,6
1,<environment.Job instance at 0x7f3a69494b90>,11,14,[ 3 10],12,-1,27,-1,13
1,<environment.Job instance at 0x7f3a69524190>,12,15,[ 2 13],13,-1,29,-1,14
1,<environment.Job instance at 0x7f3a69524dc0>,19,17,[5 7],20,-1,45,-1,28
1,<environment.Job instance at 0x7f3a6952e690>,32,20,[10  5],33,-1,53,-1,33
1,<environment.Job instance at 0x7f3a6952e870>,34,14,[10  5],35,-1,49,-1,35
1,<environment.Job instance at 0x7f3a69578870>,57,13,[9 5],58,-1,2624,-1,2611
1,<environment.Job instance at 0x7f3a69578460>,60,17,[9 5],61,-1,2629,-1,2612
1,<environment.Job instance at 0x7f3a69578230>,64,26,[3 9],65,-1,2643,-1,2617
1,<environment.Job instance at 0x7f3a695789b0>,58,27,[ 3 12],59,-1,2644,-1,2617
1,<environment.Job instance at 0x7f3a695781e0>,65,15,[5 3],66,-1,2632,-1,2617
1,<environment.Job instance at 0x7f3a695780a0>,68,21,[2 7],69,-1,2638,-1,2617
1,<environment.Job instance at 0x7f3a6945ecd0>,70,23,[4 7],71,-1,2644,-1,2621
1,<environment.Job instance at 0x7f3a695787d0>,63,12,[1 9],64,-1,2633,-1,2621
1,<environment.Job instance at 0x7f3a695285f0>,27,21,[10  4],28,-1,2642,-1,2621
1,<environment.Job instance at 0x7f3a6933b280>,78,20,[ 2 10],79,-1,2647,-1,2627
1,<environment.Job instance at 0x7f3a6933b0a0>,79,15,[5 5],80,-1,2643,-1,2628
1,<environment.Job instance at 0x7f3a6945b190>,76,16,[6 5],77,-1,2645,-1,2629
1,<environment.Job instance at 0x7f3a6913c190>,84,16,[5 6],85,-1,2656,-1,2640
1,<environment.Job instance at 0x7f3a6933b1e0>,81,17,[3 6],82,-1,2657,-1,2640
1,<environment.Job instance at 0x7f3a69528500>,25,17,[10  4],26,-1,2695,-1,2678
1,<environment.Job instance at 0x7f3a730ed230>,86,16,[1 8],87,-1,2694,-1,2678
1,<environment.Job instance at 0x7f3a691bf2d0>,92,15,[8 2],93,-1,2693,-1,2678
1,<environment.Job instance at 0x7f3a69190910>,88,23,[1 9],89,-1,2701,-1,2678
1,<environment.Job instance at 0x7f3a69277e10>,93,18,[5 1],94,-1,2696,-1,2678
1,<environment.Job instance at 0x7f3a7314bf00>,89,17,[8 5],90,-1,2695,-1,2678
1,<environment.Job instance at 0x7f3a69067960>,7,28,[ 2 10],8,-1,45,-1,17
1,<environment.Job instance at 0x7f3a69067500>,12,15,[ 2 13],13,-1,35,-1,20
1,<environment.Job instance at 0x7f3a69067aa0>,14,20,[13  4],15,-1,41,-1,21
1,<environment.Job instance at 0x7f3a6906ac30>,23,1,[12  5],24,-1,40,-1,39
1,<environment.Job instance at 0x7f3a6927dc80>,30,24,[1 5],31,-1,85,-1,61
1,<environment.Job instance at 0x7f3a69463be0>,36,13,[ 5 14],37,-1,86,-1,73
1,<environment.Job instance at 0x7f3a692b44b0>,43,24,[3 7],44,-1,130,-1,106
1,<environment.Job instance at 0x7f3a69388050>,58,27,[ 3 12],59,-1,167,-1,140
1,<environment.Job instance at 0x7f3a69219690>,62,15,[ 2 14],63,-1,165,-1,150
1,<environment.Job instance at 0x7f3a69219460>,64,26,[3 9],65,-1,194,-1,168
1,<environment.Job instance at 0x7f3a69268b90>,70,23,[4 7],71,-1,207,-1,184
1,<environment.Job instance at 0x7f3a69223960>,80,1,[14  4],81,-1,221,-1,220
1,<environment.Job instance at 0x7f3a6927a960>,87,18,[ 1 14],88,-1,272,-1,254
1,<environment.Job instance at 0x7f3a6927a640>,88,23,[1 9],89,-1,293,-1,270
1,<environment.Job instance at 0x7f3a6922e910>,95,17,[12  1],96,-1,304,-1,287
1,<environment.Job instance at 0x7f3a6926c140>,100,16,[14  3],101,-1,330,-1,314
1,<environment.Job instance at 0x7f3a69240460>,107,2,[ 1 12],108,-1,334,-1,332
1,<environment.Job instance at 0x7f3a69245820>,115,27,[6 1],116,-1,402,-1,375
1,<environment.Job instance at 0x7f3a6925f730>,122,23,[1 8],123,-1,412,-1,389
1,<environment.Job instance at 0x7f3a6930ca50>,1,17,[10  2],2,-1,21,-1,4
1,<environment.Job instance at 0x7f3a6930ca00>,3,26,[5 3],4,-1,30,-1,4
1,<environment.Job instance at 0x7f3a6930cc30>,5,18,[ 1 10],6,-1,24,-1,6
1,<environment.Job instance at 0x7f3a691e0e10>,9,18,[5 2],10,-1,28,-1,10
1,<environment.Job instance at 0x7f3a691e05a0>,10,18,[5 8],11,-1,29,-1,11
1,<environment.Job instance at 0x7f3a691e0e60>,12,18,[3 8],13,-1,31,-1,13
1,<environment.Job instance at 0x7f3a691e03c0>,13,13,[8 3],14,-1,27,-1,14
1,<environment.Job instance at 0x7f3a691e0460>,16,17,[8 4],17,-1,35,-1,18
1,<environment.Job instance at 0x7f3a691e0410>,18,20,[5 2],19,-1,39,-1,19
1,<environment.Job instance at 0x7f3a691e06e0>,19,26,[2 8],20,-1,46,-1,20
1,<environment.Job instance at 0x7f3a691e05f0>,20,15,[5 8],21,-1,36,-1,21
1,<environment.Job instance at 0x7f3a691dcc80>,21,20,[ 4 10],22,-1,42,-1,22
1,<environment.Job instance at 0x7f3a6930c7d0>,17,15,[3 6],18,-1,37,-1,22
1,<environment.Job instance at 0x7f3a691e04b0>,22,15,[9 2],23,-1,40,-1,25
1,<environment.Job instance at 0x7f3a691dcaa0>,24,16,[7 5],25,-1,41,-1,25
1,<environment.Job instance at 0x7f3a691dc280>,27,27,[9 5],28,-1,55,-1,28
1,<environment.Job instance at 0x7f3a691ef3c0>,34,12,[8 3],35,-1,47,-1,35
1,<environment.Job instance at 0x7f3a691efb90>,38,12,[5 5],39,-1,52,-1,40
1,<environment.Job instance at 0x7f3a691ef0f0>,40,1,[7 2],41,-1,42,-1,41
1,<environment.Job instance at 0x7f3a691ebf00>,43,17,[7 4],44,-1,61,-1,44
1,<environment.Job instance at 0x7f3a691e7690>,55,16,[7 5],56,-1,72,-1,56
1,<environment.Job instance at 0x7f3a691e7460>,63,16,[ 4 10],64,-1,90,-1,74
1,<environment.Job instance at 0x7f3a691e70a0>,58,14,[9 4],59,-1,92,-1,78
1,<environment.Job instance at 0x7f3a691e7230>,65,27,[4 5],66,-1,106,-1,79
1,<environment.Job instance at 0x7f3a691ef7d0>,39,15,[6 5],40,-1,101,-1,86
1,<environment.Job instance at 0x7f3a691e2af0>,72,20,[4 9],73,-1,115,-1,95
1,<environment.Job instance at 0x7f3a691d8aa0>,79,15,[ 2 10],80,-1,111,-1,96
1,<environment.Job instance at 0x7f3a691eb870>,42,25,[ 3 11],43,-1,121,-1,96
1,<environment.Job instance at 0x7f3a691d8e10>,83,17,[7 1],84,-1,118,-1,101
1,<environment.Job instance at 0x7f3a691d8e60>,82,17,[5 9],83,-1,118,-1,101
1,<environment.Job instance at 0x7f3a691e2960>,73,12,[2 7],74,-1,113,-1,101
1,<environment.Job instance at 0x7f3a691d8550>,87,13,[12  1],88,-1,114,-1,101
1,<environment.Job instance at 0x7f3a691d85f0>,88,12,[14  3],89,-1,113,-1,101
1,<environment.Job instance at 0x7f3a691d4c30>,96,25,[2 8],97,-1,162,-1,137
1,<environment.Job instance at 0x7f3a691e2eb0>,67,12,[13  4],68,-1,150,-1,138
1,<environment.Job instance at 0x7f3a691d0e60>,100,26,[8 3],101,-1,164,-1,138
1,<environment.Job instance at 0x7f3a691d4910>,98,12,[6 4],99,-1,166,-1,154
1,<environment.Job instance at 0x7f3a692ed780>,106,18,[8 3],107,-1,172,-1,154
1,<environment.Job instance at 0x7f3a692ed5f0>,108,16,[5 2],109,-1,173,-1,157
1,<environment.Job instance at 0x7f3a690a09b0>,111,18,[5 8],112,-1,175,-1,157
1,<environment.Job instance at 0x7f3a692edcd0>,112,14,[2 8],113,-1,171,-1,157
1,<environment.Job instance at 0x7f3a696af320>,121,15,[5 7],122,-1,194,-1,179
1,<environment.Job instance at 0x7f3a6906ba00>,122,17,[8 2],123,-1,198,-1,181
1,<environment.Job instance at 0x7f3a69c34410>,120,16,[ 4 10],121,-1,197,-1,181
1,<environment.Job instance at 0x7f3a697276e0>,126,17,[7 4],127,-1,198,-1,181
1,<environment.Job instance at 0x7f3a690bc870>,117,13,[ 5 10],118,-1,194,-1,181
1,<environment.Job instance at 0x7f3a73216230>,124,17,[6 1],125,-1,198,-1,181
1,<environment.Job instance at 0x7f3a691ef550>,3,26,[5 3],4,-1,30,-1,4
1,<environment.Job instance at 0x7f3a6a0697d0>,19,26,[2 8],20,-1,80,-1,54
1,<environment.Job instance at 0x7f3a691f66e0>,27,27,[9 5],28,-1,115,-1,88
1,<environment.Job instance at 0x7f3a69833320>,29,14,[12  2],30,-1,102,-1,88
1,<environment.Job instance at 0x7f3a690e58c0>,41,17,[ 5 14],42,-1,142,-1,125
1,<environment.Job instance at 0x7f3a6906acd0>,42,25,[ 3 11],43,-1,150,-1,125
1,<environment.Job instance at 0x7f3a69065b90>,44,17,[13  5],45,-1,145,-1,128
1,<environment.Job instance at 0x7f3a69065910>,45,13,[ 5 14],46,-1,141,-1,128
1,<environment.Job instance at 0x7f3a69067c80>,65,27,[4 5],66,-1,234,-1,207
1,<environment.Job instance at 0x7f3a69067780>,67,12,[13  4],68,-1,219,-1,207
1,<environment.Job instance at 0x7f3a69067500>,68,12,[ 5 12],69,-1,219,-1,207
1,<environment.Job instance at 0x7f3a69c2ec80>,87,13,[12  1],88,-1,272,-1,259
1,<environment.Job instance at 0x7f3a69d07fa0>,88,12,[14  3],89,-1,271,-1,259
1,<environment.Job instance at 0x7f3a69d07d70>,89,1,[ 4 11],90,-1,260,-1,259
1,<environment.Job instance at 0x7f3a69348e10>,96,25,[2 8],97,-1,305,-1,280
1,<environment.Job instance at 0x7f3a692d4b90>,100,26,[8 3],101,-1,320,-1,294
1,<environment.Job instance at 0x7f3a69197820>,114,2,[11  3],115,-1,327,-1,325
1,<environment.Job instance at 0x7f3a690bfc30>,125,17,[12  4],126,-1,404,-1,387
1,<environment.Job instance at 0x7f3a69025f00>,4,18,[10  5],5,-1,23,-1,5
1,<environment.Job instance at 0x7f3a69025be0>,6,16,[2 9],7,-1,23,-1,7
1,<environment.Job instance at 0x7f3a690290f0>,8,15,[10  4],9,-1,26,-1,11
1,<environment.Job instance at 0x7f3a69029460>,11,16,[4 5],12,-1,28,-1,12
1,<environment.Job instance at 0x7f3a690294b0>,12,27,[8 3],13,-1,40,-1,13
1,<environment.Job instance at 0x7f3a690290a0>,10,16,[8 5],11,-1,29,-1,13
1,<environment.Job instance at 0x7f3a69029280>,13,18,[1 6],14,-1,32,-1,14
1,<environment.Job instance at 0x7f3a690295f0>,14,17,[2 6],15,-1,32,-1,15
1,<environment.Job instance at 0x7f3a69029870>,17,16,[7 4],18,-1,35,-1,19
1,<environment.Job instance at 0x7f3a69029550>,18,16,[9 2],19,-1,35,-1,19
1,<environment.Job instance at 0x7f3a69029b40>,21,16,[4 5],22,-1,41,-1,25
1,<environment.Job instance at 0x7f3a6902a500>,30,12,[10  5],31,-1,45,-1,33
1,<environment.Job instance at 0x7f3a6902a8c0>,33,1,[7 1],34,-1,35,-1,34
1,<environment.Job instance at 0x7f3a6902a6e0>,34,14,[3 6],35,-1,49,-1,35
1,<environment.Job instance at 0x7f3a6902a9b0>,35,13,[7 4],36,-1,49,-1,36
1,<environment.Job instance at 0x7f3a6902aa50>,36,21,[ 4 10],37,-1,58,-1,37
1,<environment.Job instance at 0x7f3a6902aaf0>,37,23,[2 8],38,-1,61,-1,38
1,<environment.Job instance at 0x7f3a6902adc0>,40,13,[6 2],41,-1,54,-1,41
1,<environment.Job instance at 0x7f3a6902a780>,32,16,[6 4],33,-1,58,-1,42
1,<environment.Job instance at 0x7f3a6902e0f0>,45,17,[ 5 10],46,-1,64,-1,47
1,<environment.Job instance at 0x7f3a6902e320>,46,14,[9 4],47,-1,61,-1,47
1,<environment.Job instance at 0x7f3a6943cc30>,107,16,[7 2],108,-1,430,-1,414
1,<environment.Job instance at 0x7f3a6942ea00>,120,18,[ 2 10],121,-1,432,-1,414
1,<environment.Job instance at 0x7f3a697c3af0>,7,2,[ 3 11],8,-1,10,-1,8
1,<environment.Job instance at 0x7f3a697ca910>,12,27,[8 3],13,-1,62,-1,35
1,<environment.Job instance at 0x7f3a69414780>,16,27,[2 6],17,-1,76,-1,49
1,<environment.Job instance at 0x7f3a694145f0>,20,14,[ 4 14],21,-1,79,-1,65
1,<environment.Job instance at 0x7f3a694368c0>,37,23,[2 8],38,-1,136,-1,113
1,<environment.Job instance at 0x7f3a69025d70>,38,3,[11  1],39,-1,116,-1,113
1,<environment.Job instance at 0x7f3a69025e60>,39,19,[13  3],40,-1,132,-1,113
1,<environment.Job instance at 0x7f3a691baa00>,44,13,[ 4 11],45,-1,139,-1,126
1,<environment.Job instance at 0x7f3a691f82d0>,49,17,[12  4],50,-1,158,-1,141
1,<environment.Job instance at 0x7f3a69197c80>,50,25,[6 4],51,-1,167,-1,142
1,<environment.Job instance at 0x7f3a69053370>,52,3,[14  5],53,-1,145,-1,142
1,<environment.Job instance at 0x7f3a691970f0>,54,24,[5 5],55,-1,179,-1,155
1,<environment.Job instance at 0x7f3a69198780>,58,28,[ 5 10],59,-1,198,-1,170
1,<environment.Job instance at 0x7f3a69348e10>,66,12,[ 5 12],67,-1,200,-1,188
1,<environment.Job instance at 0x7f3a698119b0>,69,2,[ 5 14],70,-1,204,-1,202
1,<environment.Job instance at 0x7f3a699001e0>,81,16,[ 1 14],82,-1,262,-1,246
1,<environment.Job instance at 0x7f3a69816370>,94,17,[14  5],95,-1,302,-1,285
1,<environment.Job instance at 0x7f3a6906c190>,101,2,[14  5],102,-1,295,-1,293
1,<environment.Job instance at 0x7f3a690ed0f0>,117,28,[5 9],118,-1,401,-1,373
1,<environment.Job instance at 0x7f3a690685f0>,127,28,[9 1],128,-1,440,-1,412
1,<environment.Job instance at 0x7f3a69e065a0>,1,14,[9 2],2,-1,17,-1,3
1,<environment.Job instance at 0x7f3a69e06690>,3,2,[7 2],4,-1,6,-1,4
1,<environment.Job instance at 0x7f3a69e06910>,4,3,[ 5 10],5,-1,8,-1,5
1,<environment.Job instance at 0x7f3a69f17aa0>,2,26,[5 8],3,-1,32,-1,6
1,<environment.Job instance at 0x7f3a69c04460>,9,18,[1 7],10,-1,28,-1,10
1,<environment.Job instance at 0x7f3a69c04b40>,12,17,[8 1],13,-1,30,-1,13
1,<environment.Job instance at 0x7f3a69c04370>,13,22,[3 5],14,-1,36,-1,14
1,<environment.Job instance at 0x7f3a69c048c0>,15,18,[4 6],16,-1,34,-1,16
1,<environment.Job instance at 0x7f3a69c04690>,17,28,[ 5 10],18,-1,46,-1,18
1,<environment.Job instance at 0x7f3a69c04410>,19,18,[3 8],20,-1,38,-1,20
1,<environment.Job instance at 0x7f3a69c045f0>,20,22,[7 1],21,-1,43,-1,21
1,<environment.Job instance at 0x7f3a69c04c80>,22,21,[5 7],23,-1,44,-1,23
1,<environment.Job instance at 0x7f3a69be5730>,25,16,[4 7],26,-1,42,-1,26
1,<environment.Job instance at 0x7f3a69be56e0>,26,18,[9 3],27,-1,45,-1,27
1,<environment.Job instance at 0x7f3a69be54b0>,28,16,[1 7],29,-1,45,-1,29
1,<environment.Job instance at 0x7f3a69be58c0>,29,18,[8 2],30,-1,49,-1,31
1,<environment.Job instance at 0x7f3a69be5aa0>,33,17,[4 7],34,-1,51,-1,34
1,<environment.Job instance at 0x7f3a69be5820>,34,16,[ 5 10],35,-1,51,-1,35
1,<environment.Job instance at 0x7f3a69be5c80>,35,15,[5 9],36,-1,51,-1,36
1,<environment.Job instance at 0x7f3a69bb9af0>,40,26,[3 7],41,-1,67,-1,41
1,<environment.Job instance at 0x7f3a69bb9730>,41,18,[11  5],42,-1,60,-1,42
1,<environment.Job instance at 0x7f3a69bb9690>,44,16,[1 5],45,-1,61,-1,45
1,<environment.Job instance at 0x7f3a69bb9370>,45,18,[4 9],46,-1,64,-1,46
1,<environment.Job instance at 0x7f3a69bb9fa0>,47,18,[10  5],48,-1,66,-1,48
1,<environment.Job instance at 0x7f3a69bb9f50>,49,1,[12  2],50,-1,51,-1,50
1,<environment.Job instance at 0x7f3a69bb91e0>,50,13,[10  1],51,-1,64,-1,51
1,<environment.Job instance at 0x7f3a69c46410>,52,24,[1 9],53,-1,77,-1,53
1,<environment.Job instance at 0x7f3a69c468c0>,53,14,[6 5],54,-1,68,-1,54
1,<environment.Job instance at 0x7f3a69c46aa0>,54,12,[9 3],55,-1,67,-1,55
1,<environment.Job instance at 0x7f3a69c46960>,56,12,[10  1],57,-1,69,-1,57
1,<environment.Job instance at 0x7f3a69bc6960>,60,17,[5 6],61,-1,78,-1,61
1,<environment.Job instance at 0x7f3a69bc6280>,61,27,[7 1],62,-1,89,-1,62
1,<environment.Job instance at 0x7f3a69bc6690>,65,21,[ 2 10],66,-1,88,-1,67
1,<environment.Job instance at 0x7f3a69bc60a0>,66,15,[10  2],67,-1,83,-1,68
1,<environment.Job instance at 0x7f3a69bc6e10>,70,16,[10  1],71,-1,88,-1,72
1,<environment.Job instance at 0x7f3a69bc6aa0>,71,17,[11  3],72,-1,89,-1,72
1,<environment.Job instance at 0x7f3a69814be0>,79,15,[ 3 10],80,-1,124,-1,109
1,<environment.Job instance at 0x7f3a698142d0>,92,18,[6 2],93,-1,127,-1,109
1,<environment.Job instance at 0x7f3a6a0f2c30>,94,18,[6 2],95,-1,127,-1,109
1,<environment.Job instance at 0x7f3a6a0f2460>,95,19,[6 3],96,-1,128,-1,109
1,<environment.Job instance at 0x7f3a698145f0>,80,17,[10  2],81,-1,126,-1,109
1,<environment.Job instance at 0x7f3a6a0f26e0>,102,27,[5 7],103,-1,185,-1,158
1,<environment.Job instance at 0x7f3a69d9bdc0>,109,17,[5 2],110,-1,175,-1,158
1,<environment.Job instance at 0x7f3a6a0f2aa0>,104,24,[13  2],105,-1,190,-1,166
1,<environment.Job instance at 0x7f3a69be55f0>,2,26,[5 8],3,-1,30,-1,4
1,<environment.Job instance at 0x7f3a69be5a50>,6,2,[ 5 13],7,-1,9,-1,7
1,<environment.Job instance at 0x7f3a69bc6d20>,11,1,[13  4],12,-1,13,-1,12
1,<environment.Job instance at 0x7f3a69b70730>,18,2,[12  3],19,-1,34,-1,32
1,<environment.Job instance at 0x7f3a69d9bb40>,17,28,[ 5 10],18,-1,103,-1,75
1,<environment.Job instance at 0x7f3a69065910>,40,26,[3 7],41,-1,139,-1,113
1,<environment.Job instance at 0x7f3a69065b90>,41,18,[11  5],42,-1,131,-1,113
1,<environment.Job instance at 0x7f3a6906c640>,49,1,[12  2],50,-1,137,-1,136
1,<environment.Job instance at 0x7f3a6906cb40>,52,24,[1 9],53,-1,173,-1,149
1,<environment.Job instance at 0x7f3a690678c0>,61,27,[7 1],62,-1,206,-1,179
1,<environment.Job instance at 0x7f3a69831280>,63,2,[ 3 13],64,-1,181,-1,179
1,<environment.Job instance at 0x7f3a699001e0>,67,1,[ 3 14],68,-1,195,-1,194
1,<environment.Job instance at 0x7f3a699006e0>,68,12,[ 2 11],69,-1,206,-1,194
1,<environment.Job instance at 0x7f3a69831230>,62,26,[ 3 10],63,-1,220,-1,194
1,<environment.Job instance at 0x7f3a69d07fa0>,71,17,[11  3],72,-1,211,-1,194
1,<environment.Job instance at 0x7f3a69fa5e10>,72,16,[12  1],73,-1,210,-1,194
1,<environment.Job instance at 0x7f3a69d1e910>,73,15,[ 4 13],74,-1,209,-1,194
1,<environment.Job instance at 0x7f3a691f7870>,83,24,[2 6],84,-1,267,-1,243
1,<environment.Job instance at 0x7f3a691f7f50>,84,13,[ 5 12],85,-1,256,-1,243
1,<environment.Job instance at 0x7f3a691f7730>,85,2,[ 2 11],86,-1,245,-1,243
1,<environment.Job instance at 0x7f3a69414730>,102,27,[5 7],103,-1,323,-1,296
1,<environment.Job instance at 0x7f3a69414780>,104,24,[13  2],105,-1,320,-1,296
1,<environment.Job instance at 0x7f3a69414500>,108,15,[11  4],109,-1,327,-1,312
1,<environment.Job instance at 0x7f3a697ca500>,111,14,[ 4 13],112,-1,341,-1,327
1,<environment.Job instance at 0x7f3a69ae8e60>,127,14,[11  4],128,-1,412,-1,398
1,<environment.Job instance at 0x7f3a6a26e280>,0,18,[ 4 11],1,-1,19,-1,1
1,<environment.Job instance at 0x7f3a69f52b40>,1,18,[ 3 10],2,-1,20,-1,2
1,<environment.Job instance at 0x7f3a69caa0a0>,3,24,[8 5],4,-1,28,-1,4
1,<environment.Job instance at 0x7f3a68cdb7d0>,9,15,[1 6],10,-1,25,-1,10
1,<environment.Job instance at 0x7f3a68cdb910>,10,12,[2 9],11,-1,24,-1,12
1,<environment.Job instance at 0x7f3a69c9c8c0>,12,16,[5 4],13,-1,29,-1,13
1,<environment.Job instance at 0x7f3a69c9c0f0>,13,15,[ 3 10],14,-1,29,-1,14
1,<environment.Job instance at 0x7f3a6a56f6e0>,11,15,[8 1],12,-1,29,-1,14
1,<environment.Job instance at 0x7f3a69c9c4b0>,15,15,[5 6],16,-1,31,-1,16
1,<environment.Job instance at 0x7f3a69cc5870>,17,14,[7 2],18,-1,33,-1,19
1,<environment.Job instance at 0x7f3a6a599550>,20,16,[5 4],21,-1,37,-1,21
1,<environment.Job instance at 0x7f3a6a599050>,21,17,[ 4 10],22,-1,39,-1,22
1,<environment.Job instance at 0x7f3a6a5990f0>,23,14,[ 5 13],24,-1,38,-1,24
1,<environment.Job instance at 0x7f3a6a599cd0>,24,17,[3 5],25,-1,42,-1,25
1,<environment.Job instance at 0x7f3a6a599230>,26,14,[6 5],27,-1,41,-1,27
1,<environment.Job instance at 0x7f3a6a599870>,27,21,[4 8],28,-1,49,-1,28
1,<environment.Job instance at 0x7f3a6a5996e0>,28,23,[3 9],29,-1,52,-1,29
1,<environment.Job instance at 0x7f3a6a522050>,29,13,[10  5],30,-1,43,-1,30
1,<environment.Job instance at 0x7f3a69cc5230>,18,20,[3 9],19,-1,52,-1,32
1,<environment.Job instance at 0x7f3a69d037d0>,35,15,[4 7],36,-1,51,-1,36
1,<environment.Job instance at 0x7f3a6984d820>,36,12,[1 7],37,-1,49,-1,37
1,<environment.Job instance at 0x7f3a6984d4b0>,37,17,[8 4],38,-1,55,-1,38
1,<environment.Job instance at 0x7f3a6984d370>,38,16,[1 7],39,-1,55,-1,39
1,<environment.Job instance at 0x7f3a6984d2d0>,39,15,[ 2 10],40,-1,55,-1,40
1,<environment.Job instance at 0x7f3a6a63db40>,50,2,[2 7],51,-1,53,-1,51
1,<environment.Job instance at 0x7f3a69cd84b0>,51,16,[8 4],52,-1,68,-1,52
1,<environment.Job instance at 0x7f3a6a617dc0>,53,18,[6 4],54,-1,72,-1,54
1,<environment.Job instance at 0x7f3a69528be0>,62,12,[4 7],63,-1,75,-1,63
1,<environment.Job instance at 0x7f3a69df4eb0>,63,15,[6 2],64,-1,79,-1,64
1,<environment.Job instance at 0x7f3a69df4cd0>,65,21,[9 5],66,-1,87,-1,66
1,<environment.Job instance at 0x7f3a6a5c04b0>,66,18,[10  5],67,-1,85,-1,67
1,<environment.Job instance at 0x7f3a6a228140>,67,14,[1 9],68,-1,82,-1,68
1,<environment.Job instance at 0x7f3a696531e0>,78,12,[7 5],79,-1,91,-1,79
1,<environment.Job instance at 0x7f3a69491eb0>,76,12,[4 8],77,-1,91,-1,79
1,<environment.Job instance at 0x7f3a6a6201e0>,58,16,[13  3],59,-1,95,-1,79
1,<environment.Job instance at 0x7f3a6a1765a0>,71,16,[1 6],72,-1,96,-1,80
1,<environment.Job instance at 0x7f3a695a4460>,77,17,[5 7],78,-1,98,-1,81
1,<environment.Job instance at 0x7f3a69dac820>,83,12,[9 3],84,-1,103,-1,91
1,<environment.Job instance at 0x7f3a69dac230>,87,17,[2 6],88,-1,109,-1,92
1,<environment.Job instance at 0x7f3a69dacdc0>,88,17,[5 4],89,-1,110,-1,93
1,<environment.Job instance at 0x7f3a69dac730>,90,16,[9 4],91,-1,109,-1,93
1,<environment.Job instance at 0x7f3a69670fa0>,92,12,[8 3],93,-1,106,-1,94
1,<environment.Job instance at 0x7f3a69dac370>,85,14,[5 2],86,-1,109,-1,95
1,<environment.Job instance at 0x7f3a69dac0a0>,86,12,[6 4],87,-1,107,-1,95
1,<environment.Job instance at 0x7f3a696b1dc0>,96,27,[10  4],97,-1,124,-1,97
1,<environment.Job instance at 0x7f3a696b13c0>,95,18,[3 9],96,-1,115,-1,97
1,<environment.Job instance at 0x7f3a6a273190>,98,14,[4 5],99,-1,113,-1,99
1,<environment.Job instance at 0x7f3a6a0b7af0>,99,14,[9 4],100,-1,114,-1,100
1,<environment.Job instance at 0x7f3a6a0b76e0>,101,18,[4 8],102,-1,120,-1,102
1,<environment.Job instance at 0x7f3a69f477d0>,105,2,[ 2 10],106,-1,109,-1,107
1,<environment.Job instance at 0x7f3a69f47be0>,107,13,[4 7],108,-1,121,-1,108
1,<environment.Job instance at 0x7f3a69f47230>,108,13,[ 3 10],109,-1,122,-1,109
1,<environment.Job instance at 0x7f3a69f47f00>,109,14,[4 7],110,-1,124,-1,110
1,<environment.Job instance at 0x7f3a69f473c0>,111,17,[10  5],112,-1,131,-1,114
1,<environment.Job instance at 0x7f3a69f47e10>,110,16,[10  3],111,-1,130,-1,114
1,<environment.Job instance at 0x7f3a69f478c0>,106,17,[2 9],107,-1,144,-1,127
1,<environment.Job instance at 0x7f3a69f476e0>,102,25,[7 3],103,-1,152,-1,127
1,<environment.Job instance at 0x7f3a6974a280>,118,14,[13  2],119,-1,141,-1,127
1,<environment.Job instance at 0x7f3a6974a8c0>,120,3,[ 1 10],121,-1,133,-1,130
1,<environment.Job instance at 0x7f3a69881eb0>,128,15,[6 2],129,-1,147,-1,132
1,<environment.Job instance at 0x7f3a68fdb190>,0,18,[ 4 11],1,-1,19,-1,1
1,<environment.Job instance at 0x7f3a6a522640>,3,24,[8 5],4,-1,39,-1,15
1,<environment.Job instance at 0x7f3a6a63de10>,8,13,[12  1],9,-1,28,-1,15
1,<environment.Job instance at 0x7f3a695abf50>,16,3,[14  2],17,-1,40,-1,37
1,<environment.Job instance at 0x7f3a68cde2d0>,23,14,[ 5 13],24,-1,77,-1,63
1,<environment.Job instance at 0x7f3a694361e0>,28,23,[3 9],29,-1,105,-1,82
1,<environment.Job instance at 0x7f3a69bc6d70>,40,2,[ 1 11],41,-1,130,-1,128
1,<environment.Job instance at 0x7f3a69be55f0>,47,12,[ 3 14],48,-1,166,-1,154
1,<environment.Job instance at 0x7f3a69e771e0>,58,16,[13  3],59,-1,202,-1,186
1,<environment.Job instance at 0x7f3a69e77910>,73,27,[3 5],74,-1,249,-1,222
1,<environment.Job instance at 0x7f3a69e77460>,74,1,[12  4],75,-1,223,-1,222
1,<environment.Job instance at 0x7f3a69e77140>,75,2,[14  1],76,-1,224,-1,222
1,<environment.Job instance at 0x7f3a69d799b0>,96,27,[10  4],97,-1,351,-1,324
1,<environment.Job instance at 0x7f3a69f659b0>,100,1,[ 5 11],101,-1,335,-1,334
1,<environment.Job instance at 0x7f3a69f650f0>,102,25,[7 3],103,-1,374,-1,349
1,<environment.Job instance at 0x7f3a69f650a0>,104,13,[ 3 12],105,-1,362,-1,349
1,<environment.Job instance at 0x7f3a6987b230>,118,14,[13  2],119,-1,422,-1,408
1,<environment.Job instance at 0x7f3a69cc53c0>,0,18,[1 7],1,-1,19,-1,1
1,<environment.Job instance at 0x7f3a69b5a0f0>,2,14,[8 5],3,-1,17,-1,3
1,<environment.Job instance at 0x7f3a69b4f910>,5,26,[4 8],6,-1,32,-1,6
1,<environment.Job instance at 0x7f3a69b4fb40>,6,20,[4 8],7,-1,27,-1,7
1,<environment.Job instance at 0x7f3a6a2a1e60>,8,16,[8 4],9,-1,27,-1,11
1,<environment.Job instance at 0x7f3a6a2a1820>,10,25,[5 4],11,-1,36,-1,11
1,<environment.Job instance at 0x7f3a6a0e0410>,11,21,[5 5],12,-1,33,-1,12
1,<environment.Job instance at 0x7f3a693d0280>,13,18,[ 2 10],14,-1,33,-1,15
1,<environment.Job instance at 0x7f3a693d0cd0>,15,25,[5 7],16,-1,41,-1,16
1,<environment.Job instance at 0x7f3a693d0320>,16,12,[5 9],17,-1,29,-1,17
1,<environment.Job instance at 0x7f3a6a2a1b90>,14,13,[7 3],15,-1,30,-1,17
1,<environment.Job instance at 0x7f3a693d0dc0>,17,22,[5 8],18,-1,40,-1,18
1,<environment.Job instance at 0x7f3a69866230>,23,27,[8 5],24,-1,51,-1,24
1,<environment.Job instance at 0x7f3a6a62daf0>,33,24,[3 5],34,-1,58,-1,34
1,<environment.Job instance at 0x7f3a6a62de60>,35,14,[10  1],36,-1,50,-1,36
1,<environment.Job instance at 0x7f3a69451190>,36,15,[3 6],37,-1,52,-1,37
1,<environment.Job instance at 0x7f3a6945c820>,37,17,[2 7],38,-1,55,-1,38
1,<environment.Job instance at 0x7f3a6945e820>,38,15,[5 5],39,-1,54,-1,39
1,<environment.Job instance at 0x7f3a6945ecd0>,41,18,[5 9],42,-1,60,-1,42
1,<environment.Job instance at 0x7f3a69456050>,43,18,[3 7],44,-1,62,-1,44
1,<environment.Job instance at 0x7f3a694548c0>,46,15,[5 1],47,-1,62,-1,47
1,<environment.Job instance at 0x7f3a69486140>,50,18,[2 7],51,-1,69,-1,51
1,<environment.Job instance at 0x7f3a694862d0>,51,15,[6 3],52,-1,67,-1,52
1,<environment.Job instance at 0x7f3a694866e0>,53,13,[5 2],54,-1,67,-1,54
1,<environment.Job instance at 0x7f3a69486820>,54,23,[4 5],55,-1,78,-1,55
1,<environment.Job instance at 0x7f3a69486410>,56,13,[6 5],57,-1,71,-1,58
1,<environment.Job instance at 0x7f3a69464320>,58,12,[5 5],59,-1,71,-1,59
1,<environment.Job instance at 0x7f3a694861e0>,57,13,[12  5],58,-1,72,-1,59
1,<environment.Job instance at 0x7f3a69464410>,59,18,[7 4],60,-1,78,-1,60
1,<environment.Job instance at 0x7f3a69464a50>,64,18,[3 6],65,-1,85,-1,67
1,<environment.Job instance at 0x7f3a69464af0>,66,26,[8 5],67,-1,93,-1,67
1,<environment.Job instance at 0x7f3a69464eb0>,69,20,[6 3],70,-1,91,-1,71
1,<environment.Job instance at 0x7f3a69464d20>,70,17,[5 8],71,-1,90,-1,73
1,<environment.Job instance at 0x7f3a69473280>,73,20,[5 3],74,-1,101,-1,81
1,<environment.Job instance at 0x7f3a694734b0>,81,17,[2 9],82,-1,99,-1,82
1,<environment.Job instance at 0x7f3a69473c30>,84,12,[10  2],85,-1,97,-1,85
1,<environment.Job instance at 0x7f3a69473870>,80,18,[5 6],81,-1,104,-1,86
1,<environment.Job instance at 0x7f3a69473f50>,87,22,[10  1],88,-1,110,-1,88
1,<environment.Job instance at 0x7f3a69476050>,88,16,[13  1],89,-1,106,-1,90
1,<environment.Job instance at 0x7f3a69473d20>,86,13,[9 1],87,-1,104,-1,91
1,<environment.Job instance at 0x7f3a69476230>,90,20,[3 8],91,-1,111,-1,91
1,<environment.Job instance at 0x7f3a694760f0>,92,13,[9 2],93,-1,110,-1,97
1,<environment.Job instance at 0x7f3a69476d20>,102,13,[ 3 10],103,-1,116,-1,103
1,<environment.Job instance at 0x7f3a694766e0>,96,26,[9 5],97,-1,130,-1,104
1,<environment.Job instance at 0x7f3a69476eb0>,104,17,[1 8],105,-1,122,-1,105
1,<environment.Job instance at 0x7f3a69476f50>,103,16,[6 3],104,-1,122,-1,106
1,<environment.Job instance at 0x7f3a694f15f0>,110,15,[13  3],111,-1,127,-1,112
1,<environment.Job instance at 0x7f3a694f1910>,112,25,[7 5],113,-1,140,-1,115
1,<environment.Job instance at 0x7f3a694f1320>,109,22,[7 3],110,-1,144,-1,122
1,<environment.Job instance at 0x7f3a69476a50>,99,13,[8 5],100,-1,135,-1,122
1,<environment.Job instance at 0x7f3a694f1d20>,118,12,[10  2],119,-1,134,-1,122
1,<environment.Job instance at 0x7f3a694f1a50>,116,12,[12  4],117,-1,134,-1,122
1,<environment.Job instance at 0x7f3a694644b0>,63,14,[ 4 11],64,-1,136,-1,122
1,<environment.Job instance at 0x7f3a694f1c30>,120,16,[ 2 10],121,-1,138,-1,122
1,<environment.Job instance at 0x7f3a694d71e0>,123,15,[4 8],124,-1,141,-1,126
1,<environment.Job instance at 0x7f3a694d7820>,126,18,[5 8],127,-1,145,-1,127
1,<environment.Job instance at 0x7f3a694d7500>,125,15,[ 4 12],126,-1,142,-1,127
1,<environment.Job instance at 0x7f3a694d7640>,127,13,[5 8],128,-1,142,-1,129
1,<environment.Job instance at 0x7f3a6a62df50>,5,26,[4 8],6,-1,42,-1,16
1,<environment.Job instance at 0x7f3a69281500>,10,25,[5 4],11,-1,42,-1,17
1,<environment.Job instance at 0x7f3a694648c0>,15,25,[5 7],16,-1,45,-1,20
1,<environment.Job instance at 0x7f3a694765f0>,19,3,[11  3],20,-1,35,-1,32
1,<environment.Job instance at 0x7f3a69473dc0>,23,27,[8 5],24,-1,64,-1,37
1,<environment.Job instance at 0x7f3a69be69b0>,24,12,[ 5 13],25,-1,49,-1,37
1,<environment.Job instance at 0x7f3a6987b870>,29,1,[12  4],30,-1,49,-1,48
1,<environment.Job instance at 0x7f3a6987b780>,33,24,[3 5],34,-1,77,-1,53
1,<environment.Job instance at 0x7f3a69f65fa0>,44,27,[1 8],45,-1,140,-1,113
1,<environment.Job instance at 0x7f3a69193690>,54,23,[4 5],55,-1,170,-1,147
1,<environment.Job instance at 0x7f3a69193870>,57,13,[12  5],58,-1,160,-1,147
1,<environment.Job instance at 0x7f3a69193730>,63,14,[ 4 11],64,-1,187,-1,173
1,<environment.Job instance at 0x7f3a69193be0>,66,26,[8 5],67,-1,206,-1,180
1,<environment.Job instance at 0x7f3a69193d70>,68,18,[13  1],69,-1,198,-1,180
1,<environment.Job instance at 0x7f3a69881550>,88,16,[13  1],89,-1,261,-1,245
1,<environment.Job instance at 0x7f3a69881aa0>,91,3,[11  4],92,-1,262,-1,259
1,<environment.Job instance at 0x7f3a69be5e60>,96,26,[9 5],97,-1,304,-1,278
1,<environment.Job instance at 0x7f3a6906a4b0>,107,1,[ 4 12],108,-1,317,-1,316
1,<environment.Job instance at 0x7f3a690ce640>,110,15,[13  3],111,-1,333,-1,318
1,<environment.Job instance at 0x7f3a694368c0>,113,2,[14  5],114,-1,326,-1,324
1,<environment.Job instance at 0x7f3a69436140>,114,2,[13  4],115,-1,326,-1,324
1,<environment.Job instance at 0x7f3a69436910>,112,25,[7 5],113,-1,359,-1,334
1,<environment.Job instance at 0x7f3a69f47050>,116,12,[12  4],117,-1,346,-1,334
1,<environment.Job instance at 0x7f3a69df4f50>,125,15,[ 4 12],126,-1,372,-1,357
1,<environment.Job instance at 0x7f3a694d6410>,1,18,[8 1],2,-1,21,-1,3
1,<environment.Job instance at 0x7f3a697ca500>,2,15,[3 9],3,-1,18,-1,3
1,<environment.Job instance at 0x7f3a693a0460>,3,20,[8 4],4,-1,24,-1,4
1,<environment.Job instance at 0x7f3a693a0230>,7,27,[8 5],8,-1,35,-1,8
1,<environment.Job instance at 0x7f3a693a0140>,9,17,[1 5],10,-1,27,-1,10
1,<environment.Job instance at 0x7f3a693a04b0>,12,17,[3 5],13,-1,30,-1,13
1,<environment.Job instance at 0x7f3a693a0f50>,15,13,[10  5],16,-1,30,-1,17
1,<environment.Job instance at 0x7f3a69353eb0>,17,3,[10  5],18,-1,21,-1,18
1,<environment.Job instance at 0x7f3a69353f50>,18,13,[8 3],19,-1,32,-1,19
1,<environment.Job instance at 0x7f3a693a0af0>,16,17,[7 3],17,-1,36,-1,19
1,<environment.Job instance at 0x7f3a69353c80>,21,17,[9 4],22,-1,39,-1,22
1,<environment.Job instance at 0x7f3a69353280>,22,24,[4 6],23,-1,47,-1,23
1,<environment.Job instance at 0x7f3a693534b0>,25,14,[10  1],26,-1,42,-1,28
1,<environment.Job instance at 0x7f3a693538c0>,27,18,[14  1],28,-1,46,-1,28
1,<environment.Job instance at 0x7f3a69353820>,28,1,[1 9],29,-1,30,-1,29
1,<environment.Job instance at 0x7f3a69353140>,26,12,[9 5],27,-1,41,-1,29
1,<environment.Job instance at 0x7f3a693532d0>,31,18,[7 2],32,-1,50,-1,32
1,<environment.Job instance at 0x7f3a6937c280>,34,12,[7 2],35,-1,49,-1,37
1,<environment.Job instance at 0x7f3a6937ca00>,37,12,[7 2],38,-1,51,-1,39
1,<environment.Job instance at 0x7f3a6937ca50>,36,15,[11  2],37,-1,54,-1,39
1,<environment.Job instance at 0x7f3a6937c2d0>,39,18,[ 5 10],40,-1,58,-1,40
1,<environment.Job instance at 0x7f3a6937c190>,42,19,[2 5],43,-1,62,-1,43
1,<environment.Job instance at 0x7f3a6937c0a0>,50,25,[10  4],51,-1,80,-1,55
1,<environment.Job instance at 0x7f3a69864140>,54,13,[5 7],55,-1,68,-1,55
1,<environment.Job instance at 0x7f3a69864640>,55,17,[8 5],56,-1,75,-1,58
1,<environment.Job instance at 0x7f3a69864730>,56,14,[5 7],57,-1,72,-1,58
1,<environment.Job instance at 0x7f3a6937c780>,48,16,[6 5],49,-1,84,-1,68
1,<environment.Job instance at 0x7f3a69864aa0>,59,12,[1 6],60,-1,80,-1,68
1,<environment.Job instance at 0x7f3a69864910>,57,1,[5 4],58,-1,69,-1,68
1,<environment.Job instance at 0x7f3a6a65a550>,60,18,[6 4],61,-1,87,-1,69
1,<environment.Job instance at 0x7f3a6a65a690>,63,18,[8 3],64,-1,87,-1,69
1,<environment.Job instance at 0x7f3a6a65ae60>,62,15,[4 9],63,-1,86,-1,71
1,<environment.Job instance at 0x7f3a6937c3c0>,47,17,[6 2],48,-1,88,-1,71
1,<environment.Job instance at 0x7f3a6a65ac80>,65,15,[7 1],66,-1,86,-1,71
1,<environment.Job instance at 0x7f3a6a65a500>,64,2,[8 1],65,-1,73,-1,71
1,<environment.Job instance at 0x7f3a6a65a910>,67,16,[13  1],68,-1,87,-1,71
1,<environment.Job instance at 0x7f3a69e5c4b0>,69,14,[5 3],70,-1,85,-1,71
1,<environment.Job instance at 0x7f3a69e5c050>,70,3,[9 1],71,-1,74,-1,71
1,<environment.Job instance at 0x7f3a69477d20>,72,18,[8 1],73,-1,92,-1,74
1,<environment.Job instance at 0x7f3a69d76b90>,76,20,[10  4],77,-1,97,-1,77
1,<environment.Job instance at 0x7f3a69477af0>,78,17,[9 2],79,-1,97,-1,80
1,<environment.Job instance at 0x7f3a693d7780>,79,14,[7 5],80,-1,94,-1,80
1,<environment.Job instance at 0x7f3a6a2a95f0>,80,27,[ 3 13],81,-1,108,-1,81
1,<environment.Job instance at 0x7f3a69477b40>,74,14,[5 8],75,-1,96,-1,82
1,<environment.Job instance at 0x7f3a69598280>,82,18,[5 3],83,-1,101,-1,83
1,<environment.Job instance at 0x7f3a6a65af50>,66,16,[7 5],67,-1,102,-1,86
1,<environment.Job instance at 0x7f3a6a6439b0>,85,18,[ 3 12],86,-1,104,-1,86
1,<environment.Job instance at 0x7f3a694226e0>,84,18,[6 3],85,-1,107,-1,89
1,<environment.Job instance at 0x7f3a6946c3c0>,89,15,[4 7],90,-1,105,-1,90
1,<environment.Job instance at 0x7f3a6946c1e0>,92,17,[5 9],93,-1,110,-1,93
1,<environment.Job instance at 0x7f3a699116e0>,93,18,[5 5],94,-1,112,-1,94
1,<environment.Job instance at 0x7f3a6942c500>,98,18,[ 3 10],99,-1,121,-1,103
1,<environment.Job instance at 0x7f3a6a68bf50>,100,27,[5 4],101,-1,132,-1,105
1,<environment.Job instance at 0x7f3a69499910>,101,28,[7 5],102,-1,133,-1,105
1,<environment.Job instance at 0x7f3a6942c8c0>,96,17,[1 6],97,-1,123,-1,106
1,<environment.Job instance at 0x7f3a6964b2d0>,103,28,[8 2],104,-1,135,-1,107
1,<environment.Job instance at 0x7f3a6942caa0>,97,18,[5 5],98,-1,125,-1,107
1,<environment.Job instance at 0x7f3a6942c5a0>,94,15,[8 2],95,-1,125,-1,110
1,<environment.Job instance at 0x7f3a6a3a5730>,105,13,[ 5 10],106,-1,123,-1,110
1,<environment.Job instance at 0x7f3a69bb9af0>,91,25,[9 1],92,-1,136,-1,111
1,<environment.Job instance at 0x7f3a6943c820>,83,27,[1 7],84,-1,140,-1,113
1,<environment.Job instance at 0x7f3a696ef0a0>,108,17,[5 3],109,-1,130,-1,113
1,<environment.Job instance at 0x7f3a696ef050>,112,14,[3 8],113,-1,127,-1,113
1,<environment.Job instance at 0x7f3a69690280>,114,12,[9 3],115,-1,129,-1,117
1,<environment.Job instance at 0x7f3a696901e0>,113,16,[7 2],114,-1,134,-1,118
1,<environment.Job instance at 0x7f3a696ef2d0>,109,13,[7 1],110,-1,132,-1,119
1,<environment.Job instance at 0x7f3a6a59c690>,117,18,[2 6],118,-1,138,-1,120
1,<environment.Job instance at 0x7f3a696cb730>,119,12,[10  4],120,-1,132,-1,120
1,<environment.Job instance at 0x7f3a696cb190>,118,15,[3 9],119,-1,139,-1,124
1,<environment.Job instance at 0x7f3a696cb280>,125,18,[7 4],126,-1,144,-1,126
1,<environment.Job instance at 0x7f3a730f1d20>,124,15,[10  1],125,-1,143,-1,128
1,<environment.Job instance at 0x7f3a730f1370>,123,19,[7 1],124,-1,148,-1,129
1,<environment.Job instance at 0x7f3a698bc7d0>,128,18,[ 2 10],129,-1,147,-1,129
1,<environment.Job instance at 0x7f3a6a49f3c0>,7,27,[8 5],8,-1,48,-1,21
1,<environment.Job instance at 0x7f3a695907d0>,19,2,[ 2 12],20,-1,49,-1,47
1,<environment.Job instance at 0x7f3a695abf50>,22,24,[4 6],23,-1,87,-1,63
1,<environment.Job instance at 0x7f3a69dacd20>,23,15,[ 2 13],24,-1,78,-1,63
1,<environment.Job instance at 0x7f3a69f470f0>,27,18,[14  1],28,-1,98,-1,80
1,<environment.Job instance at 0x7f3a69436870>,33,13,[ 3 11],34,-1,105,-1,92
1,<environment.Job instance at 0x7f3a698119b0>,36,15,[11  2],37,-1,121,-1,106
1,<environment.Job instance at 0x7f3a698144b0>,40,12,[ 3 12],41,-1,133,-1,121
1,<environment.Job instance at 0x7f3a69e77c80>,50,25,[10  4],51,-1,210,-1,185
1,<environment.Job instance at 0x7f3a69193d70>,67,16,[13  1],68,-1,247,-1,231
1,<environment.Job instance at 0x7f3a69193b40>,71,2,[13  4],72,-1,255,-1,253
1,<environment.Job instance at 0x7f3a69d79460>,80,27,[ 3 13],81,-1,320,-1,293
1,<environment.Job instance at 0x7f3a69f65690>,83,27,[1 7],84,-1,322,-1,295
1,<environment.Job instance at 0x7f3a69f650f0>,85,18,[ 3 12],86,-1,326,-1,308
1,<environment.Job instance at 0x7f3a69f65410>,90,1,[12  1],91,-1,328,-1,327
1,<environment.Job instance at 0x7f3a69f655f0>,91,25,[9 1],92,-1,354,-1,329
1,<environment.Job instance at 0x7f3a6987b230>,100,27,[5 4],101,-1,407,-1,380
1,<environment.Job instance at 0x7f3a6987b550>,101,28,[7 5],102,-1,408,-1,380
1,<environment.Job instance at 0x7f3a6987bf00>,103,28,[8 2],104,-1,419,-1,391
1,<environment.Job instance at 0x7f3a69281500>,121,1,[ 5 14],122,-1,456,-1,455
1,<environment.Job instance at 0x7f3a68dc0e10>,3,27,[5 1],4,-1,31,-1,4
1,<environment.Job instance at 0x7f3a68da8d20>,11,12,[3 8],12,-1,24,-1,12
1,<environment.Job instance at 0x7f3a68da8be0>,12,1,[6 5],13,-1,14,-1,13
1,<environment.Job instance at 0x7f3a68da8320>,13,18,[6 4],14,-1,32,-1,14
1,<environment.Job instance at 0x7f3a68da8e60>,14,18,[9 1],15,-1,33,-1,15
1,<environment.Job instance at 0x7f3a68da88c0>,16,14,[5 7],17,-1,32,-1,18
1,<environment.Job instance at 0x7f3a68da8f50>,18,16,[1 7],19,-1,35,-1,19
1,<environment.Job instance at 0x7f3a68da85a0>,20,18,[2 9],21,-1,39,-1,21
1,<environment.Job instance at 0x7f3a68da8050>,23,18,[5 3],24,-1,43,-1,25
1,<environment.Job instance at 0x7f3a68d9eaf0>,27,26,[3 7],28,-1,54,-1,28
1,<environment.Job instance at 0x7f3a68d9ee60>,28,13,[2 9],29,-1,42,-1,29
1,<environment.Job instance at 0x7f3a68d9eaa0>,30,13,[1 6],31,-1,44,-1,31
1,<environment.Job instance at 0x7f3a68d9ea50>,36,18,[5 4],37,-1,55,-1,37
1,<environment.Job instance at 0x7f3a68d8f230>,39,25,[3 8],40,-1,65,-1,40
1,<environment.Job instance at 0x7f3a68d8fbe0>,40,17,[7 1],41,-1,58,-1,41
1,<environment.Job instance at 0x7f3a68d8fe10>,41,17,[7 4],42,-1,59,-1,42
1,<environment.Job instance at 0x7f3a68d8f0f0>,42,15,[3 6],43,-1,58,-1,43
1,<environment.Job instance at 0x7f3a68d8f370>,45,18,[8 2],46,-1,64,-1,46
1,<environment.Job instance at 0x7f3a696f6460>,69,18,[8 2],70,-1,126,-1,108
1,<environment.Job instance at 0x7f3a696f6500>,75,18,[9 1],76,-1,133,-1,115
1,<environment.Job instance at 0x7f3a696f6050>,60,14,[10  4],61,-1,129,-1,115
1,<environment.Job instance at 0x7f3a696f6b40>,77,12,[9 1],78,-1,127,-1,115
1,<environment.Job instance at 0x7f3a6909a690>,80,15,[5 8],81,-1,130,-1,115
1,<environment.Job instance at 0x7f3a6909aa50>,82,12,[5 5],83,-1,127,-1,115
1,<environment.Job instance at 0x7f3a6909a870>,84,21,[8 1],85,-1,136,-1,115
1,<environment.Job instance at 0x7f3a6909a7d0>,85,13,[2 6],86,-1,128,-1,115
1,<environment.Job instance at 0x7f3a6909a410>,87,1,[1 7],88,-1,116,-1,115
1,<environment.Job instance at 0x7f3a6909a6e0>,88,3,[1 5],89,-1,118,-1,115
1,<environment.Job instance at 0x7f3a6909a140>,89,25,[ 3 10],90,-1,141,-1,116
1,<environment.Job instance at 0x7f3a6909a730>,90,18,[ 2 11],91,-1,134,-1,116
1,<environment.Job instance at 0x7f3a6909ae60>,91,12,[ 1 10],92,-1,128,-1,116
1,<environment.Job instance at 0x7f3a68e06c80>,94,17,[5 4],95,-1,135,-1,118
1,<environment.Job instance at 0x7f3a68e06cd0>,95,15,[9 4],96,-1,133,-1,118
1,<environment.Job instance at 0x7f3a68e066e0>,96,15,[4 7],97,-1,133,-1,118
1,<environment.Job instance at 0x7f3a68e06550>,97,23,[9 2],98,-1,141,-1,118
1,<environment.Job instance at 0x7f3a68e06a00>,100,15,[4 8],101,-1,136,-1,121
1,<environment.Job instance at 0x7f3a68e06500>,103,17,[7 4],104,-1,139,-1,122
1,<environment.Job instance at 0x7f3a68e06820>,105,15,[9 1],106,-1,137,-1,122
1,<environment.Job instance at 0x7f3a68d9ee10>,0,17,[ 5 13],1,-1,18,-1,1
1,<environment.Job instance at 0x7f3a68d9ec80>,3,27,[5 1],4,-1,32,-1,5
1,<environment.Job instance at 0x7f3a68dca0f0>,6,2,[ 5 12],7,-1,9,-1,7
1,<environment.Job instance at 0x7f3a691ca410>,15,17,[14  4],16,-1,38,-1,21
1,<environment.Job instance at 0x7f3a72c31230>,21,12,[13  5],22,-1,58,-1,46
1,<environment.Job instance at 0x7f3a73122e60>,27,26,[3 7],28,-1,93,-1,67
1,<environment.Job instance at 0x7f3a69aa6410>,37,1,[ 2 11],38,-1,89,-1,88
1,<environment.Job instance at 0x7f3a72c7a2d0>,39,25,[3 8],40,-1,126,-1,101
1,<environment.Job instance at 0x7f3a6a097a50>,47,28,[4 9],48,-1,158,-1,130
1,<environment.Job instance at 0x7f3a69dff780>,51,18,[13  5],52,-1,149,-1,131
1,<environment.Job instance at 0x7f3a6a641aa0>,55,14,[11  2],56,-1,152,-1,138
1,<environment.Job instance at 0x7f3a6a6204b0>,58,1,[14  2],59,-1,150,-1,149
1,<environment.Job instance at 0x7f3a6a620550>,59,1,[ 1 11],60,-1,150,-1,149
1,<environment.Job instance at 0x7f3a68cd8550>,90,18,[ 2 11],91,-1,274,-1,256
1,<environment.Job instance at 0x7f3a6a5530a0>,89,25,[ 3 10],90,-1,286,-1,261
1,<environment.Job instance at 0x7f3a6a619aa0>,97,23,[9 2],98,-1,312,-1,289
1,<environment.Job instance at 0x7f3a69f5a870>,116,17,[ 1 14],117,-1,371,-1,354
1,<environment.Job instance at 0x7f3a69533370>,119,18,[14  4],120,-1,378,-1,360
1,<environment.Job instance at 0x7f3a6953ca00>,123,24,[4 7],124,-1,415,-1,391
1,<environment.Job instance at 0x7f3a6a0aaa00>,128,23,[ 4 10],129,-1,429,-1,406
1,<environment.Job instance at 0x7f3a6a285230>,7,18,[3 9],8,-1,28,-1,10
1,<environment.Job instance at 0x7f3a693fbd70>,12,15,[ 1 10],13,-1,28,-1,13
1,<environment.Job instance at 0x7f3a693fbc80>,13,24,[3 5],14,-1,38,-1,14
1,<environment.Job instance at 0x7f3a693fbfa0>,15,16,[5 5],16,-1,32,-1,16
1,<environment.Job instance at 0x7f3a693fbf00>,18,17,[10  4],19,-1,39,-1,22
1,<environment.Job instance at 0x7f3a693fb050>,22,15,[2 7],23,-1,38,-1,23
1,<environment.Job instance at 0x7f3a693fb910>,23,17,[4 9],24,-1,41,-1,24
1,<environment.Job instance at 0x7f3a6a289140>,25,14,[5 1],26,-1,40,-1,26
1,<environment.Job instance at 0x7f3a6a2892d0>,28,16,[9 2],29,-1,45,-1,29
1,<environment.Job instance at 0x7f3a6a289960>,29,24,[7 1],30,-1,54,-1,30
1,<environment.Job instance at 0x7f3a6a289b90>,30,26,[4 8],31,-1,57,-1,31
1,<environment.Job instance at 0x7f3a6a289b40>,31,16,[2 7],32,-1,48,-1,32
1,<environment.Job instance at 0x7f3a6a2897d0>,34,15,[3 8],35,-1,50,-1,35
1,<environment.Job instance at 0x7f3a6a289d20>,35,18,[6 2],36,-1,54,-1,36
1,<environment.Job instance at 0x7f3a68e66140>,37,13,[ 5 10],38,-1,51,-1,38
1,<environment.Job instance at 0x7f3a68e669b0>,38,13,[ 5 10],39,-1,52,-1,39
1,<environment.Job instance at 0x7f3a68e66e10>,40,18,[8 5],41,-1,59,-1,41
1,<environment.Job instance at 0x7f3a68e66eb0>,42,18,[4 5],43,-1,61,-1,43
1,<environment.Job instance at 0x7f3a68e66a50>,43,18,[8 1],44,-1,62,-1,44
1,<environment.Job instance at 0x7f3a68e66a00>,44,13,[4 6],45,-1,58,-1,45
1,<environment.Job instance at 0x7f3a68e66820>,46,13,[5 6],47,-1,60,-1,47
1,<environment.Job instance at 0x7f3a68e66050>,48,17,[10  4],49,-1,66,-1,49
1,<environment.Job instance at 0x7f3a68e66910>,49,15,[5 9],50,-1,65,-1,50
1,<environment.Job instance at 0x7f3a68e66500>,52,16,[3 5],53,-1,69,-1,53
1,<environment.Job instance at 0x7f3a6a58ac80>,55,22,[1 9],56,-1,78,-1,56
1,<environment.Job instance at 0x7f3a691086e0>,60,18,[7 3],61,-1,79,-1,61
1,<environment.Job instance at 0x7f3a693fb370>,21,17,[4 7],22,-1,79,-1,62
1,<environment.Job instance at 0x7f3a691080a0>,73,18,[9 2],74,-1,94,-1,76
1,<environment.Job instance at 0x7f3a69108910>,75,16,[10  3],76,-1,97,-1,81
1,<environment.Job instance at 0x7f3a68e66d70>,45,15,[12  1],46,-1,96,-1,81
1,<environment.Job instance at 0x7f3a69108640>,74,24,[5 9],75,-1,105,-1,81
1,<environment.Job instance at 0x7f3a69d5d0a0>,77,26,[8 5],78,-1,108,-1,82
1,<environment.Job instance at 0x7f3a69d5dd70>,79,15,[6 5],80,-1,97,-1,82
1,<environment.Job instance at 0x7f3a69d5d190>,80,17,[10  1],81,-1,99,-1,82
1,<environment.Job instance at 0x7f3a691087d0>,66,12,[4 7],67,-1,94,-1,82
1,<environment.Job instance at 0x7f3a69d5d640>,82,13,[9 1],83,-1,98,-1,85
1,<environment.Job instance at 0x7f3a69d5daa0>,83,26,[7 5],84,-1,116,-1,90
1,<environment.Job instance at 0x7f3a69108870>,63,17,[10  3],64,-1,107,-1,90
1,<environment.Job instance at 0x7f3a69d5dfa0>,86,20,[3 6],87,-1,110,-1,90
1,<environment.Job instance at 0x7f3a69d5da00>,84,16,[3 9],85,-1,106,-1,90
1,<environment.Job instance at 0x7f3a69d5d4b0>,88,16,[3 5],89,-1,106,-1,90
1,<environment.Job instance at 0x7f3a69d5d320>,89,16,[8 5],90,-1,109,-1,93
1,<environment.Job instance at 0x7f3a6a6eda00>,95,17,[9 3],96,-1,113,-1,96
1,<environment.Job instance at 0x7f3a69d5dcd0>,87,18,[ 3 10],88,-1,140,-1,122
1,<environment.Job instance at 0x7f3a69108dc0>,70,19,[5 4],71,-1,141,-1,122
1,<environment.Job instance at 0x7f3a69cbf410>,108,16,[ 5 13],109,-1,140,-1,124
1,<environment.Job instance at 0x7f3a69d5d5a0>,92,18,[4 7],93,-1,142,-1,124
1,<environment.Job instance at 0x7f3a72c79190>,116,23,[10  4],117,-1,147,-1,124
1,<environment.Job instance at 0x7f3a691f7b90>,111,15,[14  4],112,-1,139,-1,124
1,<environment.Job instance at 0x7f3a72c797d0>,114,17,[5 9],115,-1,141,-1,124
1,<environment.Job instance at 0x7f3a6a5afaa0>,119,18,[9 5],120,-1,142,-1,124
1,<environment.Job instance at 0x7f3a6a098960>,122,18,[10  5],123,-1,142,-1,124
1,<environment.Job instance at 0x7f3a69006870>,118,17,[4 9],119,-1,142,-1,125
1,<environment.Job instance at 0x7f3a69a475a0>,125,16,[3 8],126,-1,145,-1,129
1,<environment.Job instance at 0x7f3a6a098230>,121,17,[8 2],122,-1,149,-1,132
1,<environment.Job instance at 0x7f3a695dc6e0>,127,18,[5 4],128,-1,150,-1,132
1,<environment.Job instance at 0x7f3a6a289c80>,5,13,[ 3 12],6,-1,19,-1,6
1,<environment.Job instance at 0x7f3a68e664b0>,6,13,[ 4 12],7,-1,20,-1,7
1,<environment.Job instance at 0x7f3a693770f0>,13,24,[3 5],14,-1,42,-1,18
1,<environment.Job instance at 0x7f3a69d5de10>,29,24,[7 1],30,-1,93,-1,69
1,<environment.Job instance at 0x7f3a68cdba00>,30,26,[4 8],31,-1,110,-1,84
1,<environment.Job instance at 0x7f3a6a6198c0>,45,15,[12  1],46,-1,162,-1,147
1,<environment.Job instance at 0x7f3a6a1a1870>,53,1,[ 3 13],54,-1,191,-1,190
1,<environment.Job instance at 0x7f3a693456e0>,59,18,[ 3 12],60,-1,233,-1,215
1,<environment.Job instance at 0x7f3a72fe7140>,65,1,[ 5 13],66,-1,223,-1,222
1,<environment.Job instance at 0x7f3a73277140>,74,24,[5 9],75,-1,281,-1,257
1,<environment.Job instance at 0x7f3a68d47690>,77,26,[8 5],78,-1,300,-1,274
1,<environment.Job instance at 0x7f3a69519aa0>,83,26,[7 5],84,-1,332,-1,306
1,<environment.Job instance at 0x7f3a6909a230>,85,2,[13  2],86,-1,308,-1,306
1,<environment.Job instance at 0x7f3a69f6e1e0>,93,3,[11  3],94,-1,342,-1,339
1,<environment.Job instance at 0x7f3a69e8c320>,108,16,[ 5 13],109,-1,398,-1,382
1,<environment.Job instance at 0x7f3a69e8cf50>,111,15,[14  4],112,-1,398,-1,383
1,<environment.Job instance at 0x7f3a69cd37d0>,116,23,[10  4],117,-1,424,-1,401
1,<environment.Job instance at 0x7f3a6a39e960>,1,17,[7 2],2,-1,20,-1,3
1,<environment.Job instance at 0x7f3a68fb31e0>,3,16,[3 9],4,-1,20,-1,4
1,<environment.Job instance at 0x7f3a68fb3780>,4,13,[10  1],5,-1,19,-1,6
1,<environment.Job instance at 0x7f3a697babe0>,6,14,[1 5],7,-1,21,-1,7
1,<environment.Job instance at 0x7f3a697ccaa0>,9,25,[8 3],10,-1,35,-1,10
1,<environment.Job instance at 0x7f3a697ccb40>,11,17,[3 7],12,-1,29,-1,12
1,<environment.Job instance at 0x7f3a697cceb0>,13,18,[2 6],14,-1,32,-1,14
1,<environment.Job instance at 0x7f3a697cc370>,14,18,[8 2],15,-1,33,-1,15
1,<environment.Job instance at 0x7f3a6a4c10f0>,16,17,[1 6],17,-1,34,-1,17
1,<environment.Job instance at 0x7f3a6a4c12d0>,17,18,[5 2],18,-1,36,-1,18
1,<environment.Job instance at 0x7f3a6a4c1050>,18,17,[3 5],19,-1,36,-1,19
1,<environment.Job instance at 0x7f3a6a4c15a0>,21,15,[10  5],22,-1,37,-1,22
1,<environment.Job instance at 0x7f3a6a4c1640>,22,18,[10  1],23,-1,41,-1,23
1,<environment.Job instance at 0x7f3a6a4c1870>,25,12,[5 9],26,-1,38,-1,26
1,<environment.Job instance at 0x7f3a6a4c1e60>,31,18,[7 1],32,-1,50,-1,32
1,<environment.Job instance at 0x7f3a697b6050>,33,18,[ 3 10],34,-1,52,-1,34
1,<environment.Job instance at 0x7f3a697b6730>,38,12,[10  2],39,-1,51,-1,39
1,<environment.Job instance at 0x7f3a697b6a50>,41,15,[9 5],42,-1,57,-1,42
1,<environment.Job instance at 0x7f3a697b6b40>,42,14,[ 1 10],43,-1,57,-1,43
1,<environment.Job instance at 0x7f3a697b6e10>,45,15,[10  1],46,-1,61,-1,46
1,<environment.Job instance at 0x7f3a697b6dc0>,46,21,[3 7],47,-1,68,-1,47
1,<environment.Job instance at 0x7f3a697b6d20>,47,15,[ 3 10],48,-1,63,-1,48
1,<environment.Job instance at 0x7f3a69794050>,48,28,[8 3],49,-1,77,-1,49
1,<environment.Job instance at 0x7f3a697940f0>,49,20,[1 9],50,-1,70,-1,50
1,<environment.Job instance at 0x7f3a69794230>,51,17,[5 6],52,-1,69,-1,52
1,<environment.Job instance at 0x7f3a69794370>,52,16,[10  1],53,-1,72,-1,56
1,<environment.Job instance at 0x7f3a697943c0>,53,17,[ 2 10],54,-1,82,-1,65
1,<environment.Job instance at 0x7f3a69794870>,58,15,[10  2],59,-1,80,-1,65
1,<environment.Job instance at 0x7f3a69794b40>,61,18,[4 6],62,-1,83,-1,65
1,<environment.Job instance at 0x7f3a697945a0>,55,12,[7 2],56,-1,77,-1,65
1,<environment.Job instance at 0x7f3a69794c80>,63,17,[6 1],64,-1,84,-1,67
1,<environment.Job instance at 0x7f3a69794e60>,65,12,[1 9],66,-1,79,-1,67
1,<environment.Job instance at 0x7f3a69794d20>,64,1,[11  3],65,-1,68,-1,67
1,<environment.Job instance at 0x7f3a69794a00>,59,18,[3 8],60,-1,86,-1,68
1,<environment.Job instance at 0x7f3a69794eb0>,67,12,[ 3 10],68,-1,80,-1,68
1,<environment.Job instance at 0x7f3a69794a50>,68,15,[8 2],69,-1,84,-1,69
1,<environment.Job instance at 0x7f3a69798500>,72,27,[9 1],73,-1,100,-1,73
1,<environment.Job instance at 0x7f3a69798460>,74,16,[1 8],75,-1,91,-1,75
1,<environment.Job instance at 0x7f3a69798550>,73,12,[5 9],74,-1,87,-1,75
1,<environment.Job instance at 0x7f3a697b3a00>,79,20,[2 8],80,-1,101,-1,81
1,<environment.Job instance at 0x7f3a697b3550>,81,19,[5 5],82,-1,101,-1,82
1,<environment.Job instance at 0x7f3a697b3af0>,83,18,[8 1],84,-1,102,-1,84
1,<environment.Job instance at 0x7f3a697b34b0>,84,13,[10  5],85,-1,98,-1,85
1,<environment.Job instance at 0x7f3a69df0e10>,80,15,[12  3],81,-1,104,-1,89
1,<environment.Job instance at 0x7f3a6a44edc0>,89,12,[7 1],90,-1,103,-1,91
1,<environment.Job instance at 0x7f3a6a4ed5a0>,90,18,[5 7],91,-1,109,-1,91
1,<environment.Job instance at 0x7f3a6a623f00>,91,23,[5 9],92,-1,116,-1,93
1,<environment.Job instance at 0x7f3a69a43e10>,93,14,[5 6],94,-1,108,-1,94
1,<environment.Job instance at 0x7f3a69984690>,94,15,[6 4],95,-1,110,-1,95
1,<environment.Job instance at 0x7f3a69303d20>,96,18,[1 5],97,-1,120,-1,102
1,<environment.Job instance at 0x7f3a6a00a690>,101,26,[7 2],102,-1,128,-1,102
1,<environment.Job instance at 0x7f3a6996bd20>,103,16,[ 3 10],104,-1,121,-1,105
1,<environment.Job instance at 0x7f3a6996bb90>,104,14,[10  5],105,-1,119,-1,105
1,<environment.Job instance at 0x7f3a6a454c80>,109,14,[8 2],110,-1,128,-1,114
1,<environment.Job instance at 0x7f3a6a469960>,114,18,[5 3],115,-1,133,-1,115
1,<environment.Job instance at 0x7f3a6a45bb90>,124,23,[8 3],125,-1,148,-1,125
1,<environment.Job instance at 0x7f3a6a454e60>,111,17,[10  3],112,-1,145,-1,128
1,<environment.Job instance at 0x7f3a69798730>,76,21,[12  2],77,-1,149,-1,128
1,<environment.Job instance at 0x7f3a697942d0>,9,25,[8 3],10,-1,44,-1,19
1,<environment.Job instance at 0x7f3a6a4ed6e0>,12,24,[11  1],13,-1,45,-1,21
1,<environment.Job instance at 0x7f3a68dd9b90>,43,2,[12  1],44,-1,134,-1,132
1,<environment.Job instance at 0x7f3a6927cf00>,44,1,[ 5 14],45,-1,133,-1,132
1,<environment.Job instance at 0x7f3a68ed76e0>,48,28,[8 3],49,-1,175,-1,147
1,<environment.Job instance at 0x7f3a6a419cd0>,56,13,[ 5 11],57,-1,192,-1,179
1,<environment.Job instance at 0x7f3a69e27910>,57,2,[13  1],58,-1,181,-1,179
1,<environment.Job instance at 0x7f3a69830f50>,64,1,[11  3],65,-1,216,-1,215
1,<environment.Job instance at 0x7f3a69cfd370>,71,13,[ 1 13],72,-1,264,-1,251
1,<environment.Job instance at 0x7f3a69f5a870>,72,27,[9 1],73,-1,280,-1,253
1,<environment.Job instance at 0x7f3a68cd3550>,76,21,[12  2],77,-1,286,-1,265
1,<environment.Job instance at 0x7f3a695dcd70>,78,14,[ 1 14],79,-1,282,-1,268
1,<environment.Job instance at 0x7f3a68fe65f0>,80,15,[12  3],81,-1,284,-1,269
1,<environment.Job instance at 0x7f3a6a58a140>,86,2,[12  3],87,-1,282,-1,280
1,<environment.Job instance at 0x7f3a698981e0>,91,23,[5 9],92,-1,335,-1,312
1,<environment.Job instance at 0x7f3a6a3fea50>,95,15,[ 4 12],96,-1,327,-1,312
1,<environment.Job instance at 0x7f3a6a03ddc0>,99,3,[ 4 11],100,-1,329,-1,326
1,<environment.Job instance at 0x7f3a6a60c5a0>,101,26,[7 2],102,-1,354,-1,328
1,<environment.Job instance at 0x7f3a6a60cf50>,102,2,[ 2 13],103,-1,330,-1,328
1,<environment.Job instance at 0x7f3a69639a00>,106,12,[11  2],107,-1,358,-1,346
1,<environment.Job instance at 0x7f3a69639eb0>,107,1,[14  5],108,-1,347,-1,346
1,<environment.Job instance at 0x7f3a69639f00>,108,19,[ 5 11],109,-1,365,-1,346
1,<environment.Job instance at 0x7f3a6a615dc0>,118,1,[ 4 13],119,-1,384,-1,383
1,<environment.Job instance at 0x7f3a6a646b40>,122,2,[ 3 14],123,-1,388,-1,386
1,<environment.Job instance at 0x7f3a69714280>,124,23,[8 3],125,-1,411,-1,388
1,<environment.Job instance at 0x7f3a68df7b90>,1,15,[10  1],2,-1,20,-1,5
1,<environment.Job instance at 0x7f3a68df7e60>,6,18,[7 2],7,-1,29,-1,11
1,<environment.Job instance at 0x7f3a68df74b0>,4,25,[8 2],5,-1,36,-1,11
1,<environment.Job instance at 0x7f3a68df7730>,3,27,[9 4],4,-1,38,-1,11
1,<environment.Job instance at 0x7f3a68df7460>,12,17,[5 9],13,-1,35,-1,18
1,<environment.Job instance at 0x7f3a68df76e0>,10,12,[ 4 12],11,-1,32,-1,20
1,<environment.Job instance at 0x7f3a68df7e10>,13,18,[6 1],14,-1,38,-1,20
1,<environment.Job instance at 0x7f3a6905c1e0>,15,15,[4 9],16,-1,35,-1,20
1,<environment.Job instance at 0x7f3a6a4f6690>,25,22,[9 4],26,-1,48,-1,26
1,<environment.Job instance at 0x7f3a6905c3c0>,18,16,[8 5],19,-1,50,-1,34
1,<environment.Job instance at 0x7f3a6a4f6e10>,29,27,[5 8],30,-1,65,-1,38
1,<environment.Job instance at 0x7f3a6905cc30>,19,16,[5 1],20,-1,54,-1,38
1,<environment.Job instance at 0x7f3a6905c640>,17,17,[3 7],18,-1,62,-1,45
1,<environment.Job instance at 0x7f3a6a4f65f0>,32,15,[ 5 10],33,-1,60,-1,45
1,<environment.Job instance at 0x7f3a6a4f6fa0>,30,13,[5 8],31,-1,58,-1,45
1,<environment.Job instance at 0x7f3a6a64f190>,35,12,[3 5],36,-1,58,-1,46
1,<environment.Job instance at 0x7f3a6a64f500>,33,16,[5 8],34,-1,62,-1,46
1,<environment.Job instance at 0x7f3a6a64f7d0>,36,22,[3 8],37,-1,70,-1,48
1,<environment.Job instance at 0x7f3a6a68b0f0>,45,15,[13  3],46,-1,63,-1,48
1,<environment.Job instance at 0x7f3a695cb550>,48,17,[3 7],49,-1,66,-1,49
1,<environment.Job instance at 0x7f3a695cb4b0>,50,18,[9 4],51,-1,69,-1,51
1,<environment.Job instance at 0x7f3a695dc410>,58,24,[8 2],59,-1,90,-1,66
1,<environment.Job instance at 0x7f3a695dc280>,61,15,[10  3],62,-1,93,-1,78
1,<environment.Job instance at 0x7f3a695dc6e0>,62,18,[1 9],63,-1,96,-1,78
1,<environment.Job instance at 0x7f3a695dcf50>,66,24,[13  3],67,-1,114,-1,90
1,<environment.Job instance at 0x7f3a695dc140>,70,14,[5 7],71,-1,104,-1,90
1,<environment.Job instance at 0x7f3a695cbbe0>,53,14,[ 1 10],54,-1,104,-1,90
1,<environment.Job instance at 0x7f3a695dc320>,74,15,[9 5],75,-1,105,-1,90
1,<environment.Job instance at 0x7f3a695dc9b0>,72,18,[4 9],73,-1,111,-1,93
1,<environment.Job instance at 0x7f3a695dcf00>,76,18,[8 5],77,-1,111,-1,93
1,<environment.Job instance at 0x7f3a695cbe10>,46,12,[3 8],47,-1,105,-1,93
1,<environment.Job instance at 0x7f3a6929f7d0>,81,12,[7 1],82,-1,105,-1,93
1,<environment.Job instance at 0x7f3a6929fc30>,80,15,[9 2],81,-1,108,-1,93
1,<environment.Job instance at 0x7f3a6929fb40>,83,26,[7 3],84,-1,119,-1,93
1,<environment.Job instance at 0x7f3a6929f140>,84,13,[1 9],85,-1,106,-1,93
1,<environment.Job instance at 0x7f3a6a4f6640>,31,12,[10  5],32,-1,105,-1,93
1,<environment.Job instance at 0x7f3a6929ff00>,85,12,[9 2],86,-1,105,-1,93
1,<environment.Job instance at 0x7f3a6929f230>,87,27,[1 8],88,-1,120,-1,93
1,<environment.Job instance at 0x7f3a6929f870>,89,13,[9 5],90,-1,108,-1,95
1,<environment.Job instance at 0x7f3a6929f410>,90,15,[2 8],91,-1,112,-1,97
1,<environment.Job instance at 0x7f3a6929fc80>,91,17,[3 7],92,-1,114,-1,97
1,<environment.Job instance at 0x7f3a68e59b90>,93,14,[4 6],94,-1,112,-1,98
1,<environment.Job instance at 0x7f3a68e59b40>,92,14,[1 9],93,-1,112,-1,98
1,<environment.Job instance at 0x7f3a68e59140>,94,15,[9 2],95,-1,113,-1,98
1,<environment.Job instance at 0x7f3a695dc500>,60,18,[ 2 12],61,-1,116,-1,98
1,<environment.Job instance at 0x7f3a68e59320>,96,12,[5 8],97,-1,110,-1,98
1,<environment.Job instance at 0x7f3a690676e0>,99,15,[4 6],100,-1,115,-1,100
1,<environment.Job instance at 0x7f3a68f5fb40>,100,26,[2 8],101,-1,128,-1,102
1,<environment.Job instance at 0x7f3a6929f780>,82,2,[7 2],83,-1,105,-1,103
1,<environment.Job instance at 0x7f3a6a282eb0>,102,14,[9 2],103,-1,117,-1,103
1,<environment.Job instance at 0x7f3a69c2e320>,101,13,[5 2],102,-1,116,-1,103
1,<environment.Job instance at 0x7f3a6a282050>,103,14,[9 2],104,-1,119,-1,105
1,<environment.Job instance at 0x7f3a69da4140>,105,16,[5 1],106,-1,122,-1,106
1,<environment.Job instance at 0x7f3a697f2c80>,109,17,[12  4],110,-1,127,-1,110
1,<environment.Job instance at 0x7f3a69a87fa0>,108,12,[9 4],109,-1,122,-1,110
1,<environment.Job instance at 0x7f3a6a40ab90>,110,20,[7 1],111,-1,132,-1,112
1,<environment.Job instance at 0x7f3a69db2230>,112,14,[7 1],113,-1,127,-1,113
1,<environment.Job instance at 0x7f3a695cf4b0>,113,17,[3 7],114,-1,131,-1,114
1,<environment.Job instance at 0x7f3a695cffa0>,114,21,[6 1],115,-1,136,-1,115
1,<environment.Job instance at 0x7f3a6932a6e0>,122,16,[6 1],123,-1,143,-1,127
1,<environment.Job instance at 0x7f3a69639aa0>,123,14,[ 4 10],124,-1,144,-1,130
1,<environment.Job instance at 0x7f3a6a0250a0>,117,13,[12  4],118,-1,143,-1,130
1,<environment.Job instance at 0x7f3a692ed870>,121,16,[9 2],122,-1,147,-1,131
1,<environment.Job instance at 0x7f3a697c3280>,127,17,[9 1],128,-1,148,-1,131
1,<environment.Job instance at 0x7f3a69e735f0>,3,27,[9 4],4,-1,44,-1,17
1,<environment.Job instance at 0x7f3a69e73aa0>,4,25,[8 2],5,-1,42,-1,17
1,<environment.Job instance at 0x7f3a69ae3a00>,10,12,[ 4 12],11,-1,29,-1,17
1,<environment.Job instance at 0x7f3a6a4edbe0>,29,27,[5 8],30,-1,98,-1,71
1,<environment.Job instance at 0x7f3a692bfd70>,45,15,[13  3],46,-1,127,-1,112
1,<environment.Job instance at 0x7f3a692a8820>,52,1,[14  1],53,-1,135,-1,134
1,<environment.Job instance at 0x7f3a692a89b0>,54,17,[14  4],55,-1,157,-1,140
1,<environment.Job instance at 0x7f3a69a76230>,58,24,[8 2],59,-1,179,-1,155
1,<environment.Job instance at 0x7f3a6a282af0>,59,27,[ 3 13],60,-1,182,-1,155
1,<environment.Job instance at 0x7f3a69a76e10>,60,18,[ 2 12],61,-1,173,-1,155
1,<environment.Job instance at 0x7f3a6a6a9e10>,66,24,[13  3],67,-1,203,-1,179
1,<environment.Job instance at 0x7f3a690299b0>,83,26,[7 3],84,-1,274,-1,248
1,<environment.Job instance at 0x7f3a69c34f50>,87,27,[1 8],88,-1,305,-1,278
1,<environment.Job instance at 0x7f3a6922e5a0>,100,26,[2 8],101,-1,352,-1,326
1,<environment.Job instance at 0x7f3a69006500>,109,17,[12  4],110,-1,373,-1,356
1,<environment.Job instance at 0x7f3a69257b40>,115,17,[ 1 11],116,-1,398,-1,381
1,<environment.Job instance at 0x7f3a692575a0>,117,13,[12  4],118,-1,394,-1,381
1,<environment.Job instance at 0x7f3a69c63d70>,5,24,[7 4],6,-1,30,-1,6
1,<environment.Job instance at 0x7f3a69c638c0>,6,14,[9 1],7,-1,25,-1,11
1,<environment.Job instance at 0x7f3a6a68f6e0>,11,14,[ 2 10],12,-1,26,-1,12
1,<environment.Job instance at 0x7f3a6a68fd20>,13,18,[8 3],14,-1,32,-1,14
1,<environment.Job instance at 0x7f3a6a68f8c0>,15,25,[6 2],16,-1,41,-1,16
1,<environment.Job instance at 0x7f3a6a68fe60>,19,18,[ 1 10],20,-1,38,-1,20
1,<environment.Job instance at 0x7f3a6a4b9aa0>,22,15,[4 5],23,-1,38,-1,23
1,<environment.Job instance at 0x7f3a6a4b9e60>,25,18,[4 5],26,-1,44,-1,26
1,<environment.Job instance at 0x7f3a6a4b9960>,27,17,[8 3],28,-1,45,-1,28
1,<environment.Job instance at 0x7f3a6a4b92d0>,28,14,[9 3],29,-1,43,-1,29
1,<environment.Job instance at 0x7f3a6a4b9690>,30,17,[8 5],31,-1,48,-1,31
1,<environment.Job instance at 0x7f3a6a4b9410>,31,15,[3 7],32,-1,47,-1,32
1,<environment.Job instance at 0x7f3a6a4b95a0>,32,21,[9 5],33,-1,54,-1,33
1,<environment.Job instance at 0x7f3a6a0adc80>,36,15,[3 5],37,-1,52,-1,37
1,<environment.Job instance at 0x7f3a691ac690>,46,17,[3 5],47,-1,65,-1,48
1,<environment.Job instance at 0x7f3a691ac0f0>,47,15,[5 9],48,-1,63,-1,48
1,<environment.Job instance at 0x7f3a6a0ad460>,42,15,[ 1 10],43,-1,63,-1,48
1,<environment.Job instance at 0x7f3a6a68ff00>,0,24,[ 4 14],1,-1,25,-1,1
1,<environment.Job instance at 0x7f3a6a4b9f00>,4,14,[ 1 11],5,-1,19,-1,5
1,<environment.Job instance at 0x7f3a69c63dc0>,5,24,[7 4],6,-1,40,-1,16
1,<environment.Job instance at 0x7f3a6922efa0>,15,25,[6 2],16,-1,56,-1,31
1,<environment.Job instance at 0x7f3a6925b640>,16,2,[ 1 13],17,-1,33,-1,31
1,<environment.Job instance at 0x7f3a68f5f820>,26,26,[10  2],27,-1,78,-1,52
1,<environment.Job instance at 0x7f3a69a76960>,34,1,[12  5],35,-1,82,-1,81
1,<environment.Job instance at 0x7f3a6a2826e0>,35,1,[ 2 14],36,-1,82,-1,81
1,<environment.Job instance at 0x7f3a692a8280>,37,2,[14  3],38,-1,87,-1,85
1,<environment.Job instance at 0x7f3a6917ce10>,48,28,[ 2 11],49,-1,164,-1,136
1,<environment.Job instance at 0x7f3a69830af0>,56,15,[ 2 12],57,-1,185,-1,170
1,<environment.Job instance at 0x7f3a69ae3a00>,60,12,[ 1 11],61,-1,194,-1,182
1,<environment.Job instance at 0x7f3a69108cd0>,63,15,[ 5 12],64,-1,211,-1,196
1,<environment.Job instance at 0x7f3a6930da50>,80,17,[11  3],81,-1,281,-1,264
1,<environment.Job instance at 0x7f3a6a304fa0>,97,24,[8 1],98,-1,367,-1,343
1,<environment.Job instance at 0x7f3a6a304960>,101,28,[5 9],102,-1,377,-1,349
1,<environment.Job instance at 0x7f3a6a3be320>,103,28,[6 1],104,-1,377,-1,349
1,<environment.Job instance at 0x7f3a69d07690>,108,23,[ 3 10],109,-1,396,-1,373
1,<environment.Job instance at 0x7f3a69d07870>,113,18,[ 5 11],114,-1,403,-1,385
1,<environment.Job instance at 0x7f3a6a5df9b0>,123,1,[13  4],124,-1,408,-1,407
1,<environment.Job instance at 0x7f3a6a5dfc30>,124,17,[12  2],125,-1,424,-1,407
1,<environment.Job instance at 0x7f3a7321e320>,0,17,[9 5],1,-1,18,-1,1
1,<environment.Job instance at 0x7f3a7321e370>,1,14,[9 4],2,-1,18,-1,4
1,<environment.Job instance at 0x7f3a6a288cd0>,4,18,[6 5],5,-1,23,-1,5
1,<environment.Job instance at 0x7f3a6a288dc0>,6,28,[7 3],7,-1,35,-1,7
1,<environment.Job instance at 0x7f3a6a288c80>,8,18,[1 8],9,-1,27,-1,9
1,<environment.Job instance at 0x7f3a68f4f140>,9,21,[10  5],10,-1,31,-1,10
1,<environment.Job instance at 0x7f3a68f4f0f0>,10,15,[4 9],11,-1,26,-1,11
1,<environment.Job instance at 0x7f3a68f4f550>,14,13,[3 8],15,-1,28,-1,15
1,<environment.Job instance at 0x7f3a68f4f690>,17,16,[2 6],18,-1,34,-1,18
1,<environment.Job instance at 0x7f3a68f4f870>,18,17,[7 4],19,-1,36,-1,19
1,<environment.Job instance at 0x7f3a68f4fb40>,22,20,[1 9],23,-1,43,-1,23
1,<environment.Job instance at 0x7f3a68f4fbe0>,23,18,[3 7],24,-1,42,-1,24
1,<environment.Job instance at 0x7f3a68f4fe10>,26,18,[3 6],27,-1,45,-1,27
1,<environment.Job instance at 0x7f3a68f7cd70>,28,17,[2 5],29,-1,46,-1,29
1,<environment.Job instance at 0x7f3a68f7cf00>,34,18,[2 9],35,-1,53,-1,35
1,<environment.Job instance at 0x7f3a68f7c4b0>,35,26,[5 5],36,-1,62,-1,36
1,<environment.Job instance at 0x7f3a68f7c5f0>,37,15,[8 4],38,-1,53,-1,38
1,<environment.Job instance at 0x7f3a68f7c500>,38,22,[10  5],39,-1,62,-1,40
1,<environment.Job instance at 0x7f3a68f7c9b0>,40,17,[2 7],41,-1,58,-1,41
1,<environment.Job instance at 0x7f3a68f7ca00>,43,12,[10  3],44,-1,63,-1,51
1,<environment.Job instance at 0x7f3a68f55050>,54,17,[6 3],55,-1,72,-1,55
1,<environment.Job instance at 0x7f3a68f55140>,55,22,[6 4],56,-1,78,-1,56
1,<environment.Job instance at 0x7f3a68f55780>,56,15,[7 3],57,-1,72,-1,57
1,<environment.Job instance at 0x7f3a68f55320>,57,15,[5 4],58,-1,73,-1,58
1,<environment.Job instance at 0x7f3a68f55e60>,59,14,[ 1 10],60,-1,74,-1,60
1,<environment.Job instance at 0x7f3a68f7dfa0>,61,16,[ 2 10],62,-1,78,-1,62
1,<environment.Job instance at 0x7f3a68f7d550>,62,22,[2 7],63,-1,85,-1,63
1,<environment.Job instance at 0x7f3a68f550f0>,50,25,[9 5],51,-1,91,-1,66
1,<environment.Job instance at 0x7f3a68f7d190>,66,18,[8 3],67,-1,85,-1,67
1,<environment.Job instance at 0x7f3a68f7daf0>,69,17,[1 9],70,-1,87,-1,70
1,<environment.Job instance at 0x7f3a68f7d6e0>,70,15,[9 4],71,-1,87,-1,72
1,<environment.Job instance at 0x7f3a68f7da50>,72,17,[9 5],73,-1,90,-1,73
1,<environment.Job instance at 0x7f3a68f7d140>,74,18,[6 4],75,-1,93,-1,75
1,<environment.Job instance at 0x7f3a68f7c640>,44,25,[9 4],45,-1,106,-1,81
1,<environment.Job instance at 0x7f3a68f7d730>,77,25,[6 4],78,-1,106,-1,81
1,<environment.Job instance at 0x7f3a68f73190>,79,25,[10  1],80,-1,109,-1,84
1,<environment.Job instance at 0x7f3a68f735a0>,83,18,[10  5],84,-1,102,-1,84
1,<environment.Job instance at 0x7f3a68f73c30>,91,21,[4 7],92,-1,123,-1,102
1,<environment.Job instance at 0x7f3a68f73eb0>,95,17,[4 6],96,-1,131,-1,114
1,<environment.Job instance at 0x7f3a68f84230>,100,18,[7 3],101,-1,150,-1,132
1,<environment.Job instance at 0x7f3a68f84500>,101,26,[5 4],102,-1,158,-1,132
1,<environment.Job instance at 0x7f3a68f84910>,105,17,[2 7],106,-1,149,-1,132
1,<environment.Job instance at 0x7f3a68f7d9b0>,71,14,[8 1],72,-1,146,-1,132
1,<environment.Job instance at 0x7f3a68f849b0>,106,17,[5 2],107,-1,149,-1,132
1,<environment.Job instance at 0x7f3a68f84af0>,108,26,[ 3 10],109,-1,158,-1,132
1,<environment.Job instance at 0x7f3a68f84c30>,110,22,[ 3 10],111,-1,156,-1,134
1,<environment.Job instance at 0x7f3a68f84d70>,112,13,[3 9],113,-1,147,-1,134
1,<environment.Job instance at 0x7f3a6a28e870>,122,18,[2 9],123,-1,174,-1,156
1,<environment.Job instance at 0x7f3a68f84a50>,107,18,[1 7],108,-1,174,-1,156
1,<environment.Job instance at 0x7f3a6a28e500>,123,14,[3 7],124,-1,172,-1,158
1,<environment.Job instance at 0x7f3a68f7ce60>,6,28,[7 3],7,-1,46,-1,18
1,<environment.Job instance at 0x7f3a6a2a09b0>,15,16,[ 4 14],16,-1,40,-1,24
1,<environment.Job instance at 0x7f3a6a5dfc30>,27,26,[ 2 12],28,-1,97,-1,71
1,<environment.Job instance at 0x7f3a6a5df500>,29,1,[ 3 12],30,-1,75,-1,74
1,<environment.Job instance at 0x7f3a6a5df5a0>,32,3,[11  1],33,-1,86,-1,83
1,<environment.Job instance at 0x7f3a6a5df960>,35,26,[5 5],36,-1,118,-1,92
1,<environment.Job instance at 0x7f3a69d07280>,44,25,[9 4],45,-1,152,-1,127
1,<environment.Job instance at 0x7f3a6a3044b0>,51,3,[11  1],52,-1,137,-1,134
1,<environment.Job instance at 0x7f3a6a304410>,52,3,[12  5],53,-1,137,-1,134
1,<environment.Job instance at 0x7f3a6a3be3c0>,50,25,[9 5],51,-1,166,-1,141
1,<environment.Job instance at 0x7f3a6a1a1410>,60,26,[10  1],61,-1,202,-1,176
1,<environment.Job instance at 0x7f3a6930d460>,75,27,[5 8],76,-1,263,-1,236
1,<environment.Job instance at 0x7f3a6930d410>,77,25,[6 4],78,-1,277,-1,252
1,<environment.Job instance at 0x7f3a6a4f6730>,79,25,[10  1],80,-1,279,-1,254
1,<environment.Job instance at 0x7f3a690ce960>,80,14,[ 1 14],81,-1,268,-1,254
1,<environment.Job instance at 0x7f3a6a19a910>,101,26,[5 4],102,-1,355,-1,329
1,<environment.Job instance at 0x7f3a69a76e10>,108,26,[ 3 10],109,-1,385,-1,359
1,<environment.Job instance at 0x7f3a69315aa0>,127,3,[ 5 11],128,-1,419,-1,416
1,<environment.Job instance at 0x7f3a695fef50>,4,16,[10  2],5,-1,22,-1,6
1,<environment.Job instance at 0x7f3a695fe640>,6,16,[5 6],7,-1,23,-1,7
1,<environment.Job instance at 0x7f3a695eeb90>,12,15,[5 5],13,-1,28,-1,13
1,<environment.Job instance at 0x7f3a695eedc0>,13,12,[9 5],14,-1,26,-1,14
1,<environment.Job instance at 0x7f3a695eea00>,14,18,[ 3 10],15,-1,33,-1,15
1,<environment.Job instance at 0x7f3a695ee190>,15,14,[5 8],16,-1,30,-1,16
1,<environment.Job instance at 0x7f3a695eeb40>,17,17,[3 7],18,-1,35,-1,18
1,<environment.Job instance at 0x7f3a695eec30>,18,16,[7 5],19,-1,35,-1,19
1,<environment.Job instance at 0x7f3a695ee320>,19,20,[5 5],20,-1,40,-1,20
1,<environment.Job instance at 0x7f3a69835d70>,25,15,[1 9],26,-1,41,-1,26
1,<environment.Job instance at 0x7f3a68ea0e10>,26,18,[1 8],27,-1,45,-1,27
1,<environment.Job instance at 0x7f3a69ab64b0>,31,14,[10  5],32,-1,46,-1,32
1,<environment.Job instance at 0x7f3a6a393460>,37,28,[8 2],38,-1,66,-1,38
1,<environment.Job instance at 0x7f3a6a3934b0>,38,15,[8 5],39,-1,54,-1,39
1,<environment.Job instance at 0x7f3a68f548c0>,5,13,[4 8],6,-1,55,-1,42
1,<environment.Job instance at 0x7f3a6a3936e0>,42,16,[5 6],43,-1,61,-1,45
1,<environment.Job instance at 0x7f3a6a102640>,46,15,[3 6],47,-1,64,-1,49
1,<environment.Job instance at 0x7f3a72c1d5a0>,50,22,[9 5],51,-1,73,-1,51
1,<environment.Job instance at 0x7f3a72c1d3c0>,51,17,[6 1],52,-1,69,-1,52
1,<environment.Job instance at 0x7f3a72c1d910>,52,27,[8 4],53,-1,80,-1,53
1,<environment.Job instance at 0x7f3a68d187d0>,36,13,[13  5],37,-1,72,-1,59
1,<environment.Job instance at 0x7f3a69605460>,58,18,[8 4],59,-1,77,-1,59
1,<environment.Job instance at 0x7f3a6a393280>,40,17,[14  5],41,-1,78,-1,61
1,<environment.Job instance at 0x7f3a6a3a13c0>,60,16,[5 2],61,-1,77,-1,61
1,<environment.Job instance at 0x7f3a6a3a1d70>,59,18,[2 5],60,-1,79,-1,61
1,<environment.Job instance at 0x7f3a69ae5730>,63,25,[ 4 10],64,-1,89,-1,64
1,<environment.Job instance at 0x7f3a6a044550>,71,12,[9 4],72,-1,85,-1,73
1,<environment.Job instance at 0x7f3a6a044910>,73,19,[8 5],74,-1,93,-1,74
1,<environment.Job instance at 0x7f3a690de9b0>,79,22,[3 7],80,-1,102,-1,80
1,<environment.Job instance at 0x7f3a690de870>,80,16,[6 4],81,-1,97,-1,81
1,<environment.Job instance at 0x7f3a6a4f3fa0>,85,16,[5 5],86,-1,104,-1,88
1,<environment.Job instance at 0x7f3a69ae5960>,65,17,[11  2],66,-1,105,-1,88
1,<environment.Job instance at 0x7f3a6a044460>,72,17,[4 5],73,-1,105,-1,88
1,<environment.Job instance at 0x7f3a69832b90>,90,21,[5 4],91,-1,113,-1,92
1,<environment.Job instance at 0x7f3a69aaf6e0>,92,18,[9 2],93,-1,111,-1,93
1,<environment.Job instance at 0x7f3a69aaf4b0>,94,17,[11  1],95,-1,121,-1,104
1,<environment.Job instance at 0x7f3a68f3a320>,98,16,[6 3],99,-1,120,-1,104
1,<environment.Job instance at 0x7f3a695e7d70>,100,17,[10  5],101,-1,121,-1,104
1,<environment.Job instance at 0x7f3a695e7dc0>,101,3,[5 8],102,-1,107,-1,104
1,<environment.Job instance at 0x7f3a695e7370>,103,14,[8 3],104,-1,119,-1,105
1,<environment.Job instance at 0x7f3a695f69b0>,105,17,[9 4],106,-1,123,-1,106
1,<environment.Job instance at 0x7f3a695f6230>,104,13,[10  2],105,-1,120,-1,107
1,<environment.Job instance at 0x7f3a695f6fa0>,106,16,[10  4],107,-1,125,-1,109
1,<environment.Job instance at 0x7f3a69aafeb0>,96,16,[5 8],97,-1,131,-1,115
1,<environment.Job instance at 0x7f3a69f60f00>,108,14,[10  3],109,-1,129,-1,115
1,<environment.Job instance at 0x7f3a6978d550>,118,18,[2 8],119,-1,137,-1,119
1,<environment.Job instance at 0x7f3a68e62eb0>,120,15,[5 9],121,-1,136,-1,121
1,<environment.Job instance at 0x7f3a68e62370>,121,18,[8 4],122,-1,140,-1,122
1,<environment.Job instance at 0x7f3a6978d730>,123,18,[4 6],124,-1,151,-1,133
1,<environment.Job instance at 0x7f3a6a3a1460>,1,18,[ 3 14],2,-1,20,-1,2
1,<environment.Job instance at 0x7f3a69a38b40>,8,13,[14  3],9,-1,22,-1,9
1,<environment.Job instance at 0x7f3a68f7dcd0>,27,2,[13  4],28,-1,81,-1,79
1,<environment.Job instance at 0x7f3a68ff3f00>,36,13,[13  5],37,-1,117,-1,104
1,<environment.Job instance at 0x7f3a69dd46e0>,40,17,[14  5],41,-1,134,-1,117
1,<environment.Job instance at 0x7f3a6a081b40>,41,14,[13  2],42,-1,131,-1,117
1,<environment.Job instance at 0x7f3a68ff3be0>,37,28,[8 2],38,-1,147,-1,119
1,<environment.Job instance at 0x7f3a6a168c80>,52,27,[8 4],53,-1,180,-1,153
1,<environment.Job instance at 0x7f3a6a4fb2d0>,62,1,[ 1 13],63,-1,171,-1,170
1,<environment.Job instance at 0x7f3a6a61b780>,65,17,[11  2],66,-1,193,-1,176
1,<environment.Job instance at 0x7f3a69f57c30>,69,21,[14  3],70,-1,207,-1,186
1,<environment.Job instance at 0x7f3a6a4fb3c0>,63,25,[ 4 10],64,-1,216,-1,191
1,<environment.Job instance at 0x7f3a69496960>,87,1,[ 2 11],88,-1,224,-1,223
1,<environment.Job instance at 0x7f3a695e8b90>,94,17,[11  1],95,-1,265,-1,248
1,<environment.Job instance at 0x7f3a68daa7d0>,107,3,[ 5 11],108,-1,309,-1,306
1,<environment.Job instance at 0x7f3a6a16a4b0>,124,12,[13  3],125,-1,412,-1,400
1,<environment.Job instance at 0x7f3a68e79820>,0,16,[7 5],1,-1,17,-1,1
1,<environment.Job instance at 0x7f3a68e790a0>,5,28,[5 5],6,-1,34,-1,6
1,<environment.Job instance at 0x7f3a69234190>,9,18,[1 5],10,-1,28,-1,10
1,<environment.Job instance at 0x7f3a692343c0>,11,21,[4 8],12,-1,33,-1,12
1,<environment.Job instance at 0x7f3a692345a0>,13,16,[10  5],14,-1,30,-1,14
1,<environment.Job instance at 0x7f3a69234460>,16,17,[7 1],17,-1,34,-1,17
1,<environment.Job instance at 0x7f3a69dfb280>,20,21,[6 2],21,-1,45,-1,24
1,<environment.Job instance at 0x7f3a69dfb6e0>,23,13,[10  4],24,-1,37,-1,24
1,<environment.Job instance at 0x7f3a72c68550>,28,22,[4 8],29,-1,51,-1,29
1,<environment.Job instance at 0x7f3a6957bb40>,39,12,[7 5],40,-1,61,-1,49
1,<environment.Job instance at 0x7f3a6a4a0370>,35,14,[4 5],36,-1,63,-1,49
1,<environment.Job instance at 0x7f3a68e95aa0>,47,17,[ 4 14],48,-1,66,-1,49
1,<environment.Job instance at 0x7f3a6957b7d0>,45,15,[10  3],46,-1,64,-1,49
1,<environment.Job instance at 0x7f3a68e95cd0>,48,18,[2 9],49,-1,67,-1,49
1,<environment.Job instance at 0x7f3a6a568c30>,49,17,[6 4],50,-1,67,-1,50
1,<environment.Job instance at 0x7f3a6a568410>,51,16,[ 4 10],52,-1,74,-1,58
1,<environment.Job instance at 0x7f3a68e95f00>,46,12,[3 9],47,-1,70,-1,58
1,<environment.Job instance at 0x7f3a6a568960>,50,14,[3 9],51,-1,72,-1,58
1,<environment.Job instance at 0x7f3a6a58a870>,33,14,[ 3 11],34,-1,72,-1,58
1,<environment.Job instance at 0x7f3a6a568eb0>,56,16,[7 1],57,-1,74,-1,58
1,<environment.Job instance at 0x7f3a72c680a0>,30,28,[4 7],31,-1,88,-1,60
1,<environment.Job instance at 0x7f3a696ef8c0>,58,17,[ 1 10],59,-1,77,-1,60
1,<environment.Job instance at 0x7f3a6a568050>,52,2,[1 7],53,-1,73,-1,71
1,<environment.Job instance at 0x7f3a68fded20>,57,13,[5 5],58,-1,84,-1,71
1,<environment.Job instance at 0x7f3a6a3a5870>,59,15,[7 2],60,-1,87,-1,72
1,<environment.Job instance at 0x7f3a69ca05f0>,71,16,[6 5],72,-1,90,-1,74
1,<environment.Job instance at 0x7f3a69ca0c80>,74,17,[4 9],75,-1,92,-1,75
1,<environment.Job instance at 0x7f3a69ca06e0>,75,17,[ 5 10],76,-1,93,-1,76
1,<environment.Job instance at 0x7f3a69e97190>,79,18,[9 4],80,-1,98,-1,80
1,<environment.Job instance at 0x7f3a68e62230>,84,17,[5 2],85,-1,102,-1,85
1,<environment.Job instance at 0x7f3a6a61d910>,89,16,[4 9],90,-1,106,-1,90
1,<environment.Job instance at 0x7f3a69616320>,94,13,[10  1],95,-1,110,-1,97
1,<environment.Job instance at 0x7f3a69616a00>,95,14,[3 5],96,-1,114,-1,100
1,<environment.Job instance at 0x7f3a696166e0>,97,18,[7 5],98,-1,119,-1,101
1,<environment.Job instance at 0x7f3a69fb4f50>,99,18,[ 3 10],100,-1,120,-1,102
1,<environment.Job instance at 0x7f3a68e62190>,81,16,[14  3],82,-1,118,-1,102
1,<environment.Job instance at 0x7f3a6a0c7a00>,101,18,[5 9],102,-1,120,-1,102
1,<environment.Job instance at 0x7f3a696160f0>,102,14,[9 2],103,-1,118,-1,104
1,<environment.Job instance at 0x7f3a6a2178c0>,104,24,[8 1],105,-1,129,-1,105
1,<environment.Job instance at 0x7f3a6a3d0eb0>,106,25,[6 2],107,-1,136,-1,111
1,<environment.Job instance at 0x7f3a6a49df50>,105,18,[9 4],106,-1,129,-1,111
1,<environment.Job instance at 0x7f3a6900edc0>,103,17,[8 4],104,-1,129,-1,112
1,<environment.Job instance at 0x7f3a68ffa2d0>,110,15,[8 3],111,-1,128,-1,113
1,<environment.Job instance at 0x7f3a69af59b0>,113,15,[3 8],114,-1,130,-1,115
1,<environment.Job instance at 0x7f3a69653280>,107,17,[8 2],108,-1,133,-1,116
1,<environment.Job instance at 0x7f3a69af5690>,115,18,[3 6],116,-1,134,-1,116
1,<environment.Job instance at 0x7f3a69af5a50>,116,12,[10  1],117,-1,132,-1,120
1,<environment.Job instance at 0x7f3a691b9140>,119,16,[10  3],120,-1,138,-1,122
1,<environment.Job instance at 0x7f3a68e91c30>,121,20,[5 3],122,-1,143,-1,123
1,<environment.Job instance at 0x7f3a69e20d70>,126,14,[5 9],127,-1,141,-1,127
1,<environment.Job instance at 0x7f3a69ca0f50>,5,28,[5 5],6,-1,34,-1,6
1,<environment.Job instance at 0x7f3a68e796e0>,10,12,[ 4 14],11,-1,23,-1,11
1,<environment.Job instance at 0x7f3a6a61b280>,18,1,[ 1 11],19,-1,26,-1,25
1,<environment.Job instance at 0x7f3a6a3be410>,29,16,[ 4 11],30,-1,62,-1,46
1,<environment.Job instance at 0x7f3a72dd5460>,31,15,[ 5 14],32,-1,62,-1,47
1,<environment.Job instance at 0x7f3a69e20280>,30,28,[4 7],31,-1,75,-1,47
1,<environment.Job instance at 0x7f3a72dd5a50>,33,14,[ 3 11],34,-1,61,-1,47
1,<environment.Job instance at 0x7f3a699353c0>,47,17,[ 4 14],48,-1,106,-1,89
1,<environment.Job instance at 0x7f3a6a5a9e10>,81,16,[14  3],82,-1,228,-1,212
1,<environment.Job instance at 0x7f3a6a5a9f50>,82,3,[ 1 14],83,-1,215,-1,212
1,<environment.Job instance at 0x7f3a6a640d20>,96,3,[ 5 11],97,-1,259,-1,256
1,<environment.Job instance at 0x7f3a69423b40>,104,24,[8 1],105,-1,344,-1,320
1,<environment.Job instance at 0x7f3a693789b0>,106,25,[6 2],107,-1,345,-1,320
1,<environment.Job instance at 0x7f3a694ebeb0>,122,24,[8 2],123,-1,398,-1,374
1,<environment.Job instance at 0x7f3a694eb910>,127,12,[13  5],128,-1,402,-1,390
1,<environment.Job instance at 0x7f3a69dbfa50>,7,12,[7 5],8,-1,20,-1,8
1,<environment.Job instance at 0x7f3a69b8f500>,9,25,[1 7],10,-1,35,-1,10
1,<environment.Job instance at 0x7f3a6a0ba190>,11,16,[5 9],12,-1,28,-1,12
1,<environment.Job instance at 0x7f3a6a0ba870>,12,17,[7 4],13,-1,30,-1,13
1,<environment.Job instance at 0x7f3a6a0bafa0>,13,14,[2 7],14,-1,28,-1,14
1,<environment.Job instance at 0x7f3a6a0ba640>,14,12,[4 7],15,-1,27,-1,15
1,<environment.Job instance at 0x7f3a69447e60>,16,17,[10  4],17,-1,34,-1,17
1,<environment.Job instance at 0x7f3a69f30460>,17,14,[7 2],18,-1,32,-1,18
1,<environment.Job instance at 0x7f3a69f305f0>,19,17,[1 7],20,-1,37,-1,20
1,<environment.Job instance at 0x7f3a7a2151e0>,22,18,[ 1 10],23,-1,42,-1,24
1,<environment.Job instance at 0x7f3a6a0c7640>,24,12,[9 4],25,-1,41,-1,29
1,<environment.Job instance at 0x7f3a6a13c7d0>,28,17,[9 3],29,-1,50,-1,33
1,<environment.Job instance at 0x7f3a68d492d0>,32,18,[10  1],33,-1,52,-1,34
1,<environment.Job instance at 0x7f3a69826f00>,33,15,[7 2],34,-1,50,-1,35
1,<environment.Job instance at 0x7f3a69234be0>,34,27,[1 7],35,-1,62,-1,35
1,<environment.Job instance at 0x7f3a698263c0>,30,14,[10  1],31,-1,51,-1,37
1,<environment.Job instance at 0x7f3a69234aa0>,37,18,[6 1],38,-1,56,-1,38
1,<environment.Job instance at 0x7f3a69234780>,38,17,[3 6],39,-1,56,-1,39
1,<environment.Job instance at 0x7f3a69230050>,44,2,[10  4],45,-1,49,-1,47
1,<environment.Job instance at 0x7f3a69234af0>,36,13,[4 6],37,-1,66,-1,53
1,<environment.Job instance at 0x7f3a6a4f30f0>,46,16,[1 9],47,-1,69,-1,53
1,<environment.Job instance at 0x7f3a6a102550>,51,18,[4 6],52,-1,74,-1,56
1,<environment.Job instance at 0x7f3a6a417be0>,55,13,[10  4],56,-1,70,-1,57
1,<environment.Job instance at 0x7f3a6a1027d0>,50,13,[4 7],51,-1,70,-1,57
1,<environment.Job instance at 0x7f3a6a4170f0>,56,19,[5 4],57,-1,79,-1,60
1,<environment.Job instance at 0x7f3a6a3a15f0>,26,15,[4 7],27,-1,76,-1,61
1,<environment.Job instance at 0x7f3a69029b90>,57,17,[1 8],58,-1,79,-1,62
1,<environment.Job instance at 0x7f3a69029dc0>,58,18,[4 6],59,-1,80,-1,62
1,<environment.Job instance at 0x7f3a68d18460>,63,18,[10  1],64,-1,82,-1,64
1,<environment.Job instance at 0x7f3a6a530e10>,64,15,[9 3],65,-1,80,-1,65
1,<environment.Job instance at 0x7f3a69d028c0>,65,16,[ 5 13],66,-1,82,-1,66
1,<environment.Job instance at 0x7f3a69d02b40>,69,16,[ 1 13],70,-1,88,-1,72
1,<environment.Job instance at 0x7f3a6a6a9c80>,66,17,[ 2 10],67,-1,89,-1,72
1,<environment.Job instance at 0x7f3a6a0bee10>,71,16,[9 3],72,-1,88,-1,72
1,<environment.Job instance at 0x7f3a6a0be6e0>,72,15,[ 2 12],73,-1,91,-1,76
1,<environment.Job instance at 0x7f3a6a0beaa0>,74,14,[5 8],75,-1,90,-1,76
1,<environment.Job instance at 0x7f3a6a0bec80>,76,17,[11  2],77,-1,94,-1,77
1,<environment.Job instance at 0x7f3a68f7bb90>,79,23,[9 3],80,-1,108,-1,85
1,<environment.Job instance at 0x7f3a69230640>,42,15,[4 7],43,-1,101,-1,86
1,<environment.Job instance at 0x7f3a68f7baa0>,81,15,[7 4],82,-1,101,-1,86
1,<environment.Job instance at 0x7f3a68f612d0>,85,14,[ 2 10],86,-1,110,-1,96
1,<environment.Job instance at 0x7f3a68f61af0>,88,12,[ 1 13],89,-1,108,-1,96
1,<environment.Job instance at 0x7f3a68f85280>,89,15,[8 5],90,-1,113,-1,98
1,<environment.Job instance at 0x7f3a68f85640>,90,22,[9 3],91,-1,122,-1,100
1,<environment.Job instance at 0x7f3a68f85fa0>,92,12,[ 4 14],93,-1,113,-1,101
1,<environment.Job instance at 0x7f3a68f61c30>,87,18,[2 7],88,-1,122,-1,104
1,<environment.Job instance at 0x7f3a68f85dc0>,96,14,[11  1],97,-1,119,-1,105
1,<environment.Job instance at 0x7f3a68f85550>,97,22,[7 3],98,-1,128,-1,106
1,<environment.Job instance at 0x7f3a68f85500>,99,14,[6 4],100,-1,122,-1,108
1,<environment.Job instance at 0x7f3a6a2a08c0>,100,18,[1 7],101,-1,129,-1,111
1,<environment.Job instance at 0x7f3a6a2a0e60>,101,14,[5 5],102,-1,125,-1,111
1,<environment.Job instance at 0x7f3a6942d2d0>,59,13,[8 2],60,-1,125,-1,112
1,<environment.Job instance at 0x7f3a6a2a0b40>,103,15,[3 8],104,-1,127,-1,112
1,<environment.Job instance at 0x7f3a690e3b40>,110,18,[4 5],111,-1,136,-1,118
1,<environment.Job instance at 0x7f3a690e3be0>,111,27,[6 5],112,-1,145,-1,118
1,<environment.Job instance at 0x7f3a68f85eb0>,94,15,[7 5],95,-1,133,-1,118
1,<environment.Job instance at 0x7f3a694e9c80>,119,23,[4 9],120,-1,160,-1,137
1,<environment.Job instance at 0x7f3a694e9230>,117,16,[6 5],118,-1,167,-1,151
1,<environment.Job instance at 0x7f3a694e96e0>,121,15,[10  3],122,-1,166,-1,151
1,<environment.Job instance at 0x7f3a72c1de60>,127,25,[1 9],128,-1,176,-1,151
1,<environment.Job instance at 0x7f3a72c1d960>,128,3,[ 4 10],129,-1,154,-1,151
1,<environment.Job instance at 0x7f3a72c1d9b0>,125,16,[1 9],126,-1,167,-1,151
1,<environment.Job instance at 0x7f3a69350140>,2,2,[ 1 12],3,-1,5,-1,3
1,<environment.Job instance at 0x7f3a69d79730>,9,25,[1 7],10,-1,39,-1,14
1,<environment.Job instance at 0x7f3a6a2a0820>,18,14,[ 5 11],19,-1,55,-1,41
1,<environment.Job instance at 0x7f3a694ebd70>,34,27,[1 7],35,-1,149,-1,122
1,<environment.Job instance at 0x7f3a69d0a050>,65,16,[ 5 13],66,-1,273,-1,257
1,<environment.Job instance at 0x7f3a6a169d70>,69,16,[ 1 13],70,-1,291,-1,275
1,<environment.Job instance at 0x7f3a695d3410>,72,15,[ 2 12],73,-1,293,-1,278
1,<environment.Job instance at 0x7f3a6a102c80>,76,17,[11  2],77,-1,311,-1,294
1,<environment.Job instance at 0x7f3a68d930f0>,79,23,[9 3],80,-1,333,-1,310
1,<environment.Job instance at 0x7f3a68e59aa0>,88,12,[ 1 13],89,-1,343,-1,331
1,<environment.Job instance at 0x7f3a6a417460>,92,12,[ 4 14],93,-1,361,-1,349
1,<environment.Job instance at 0x7f3a6a417140>,91,28,[1 5],92,-1,377,-1,349
1,<environment.Job instance at 0x7f3a69234eb0>,96,14,[11  1],97,-1,363,-1,349
1,<environment.Job instance at 0x7f3a68f8caa0>,104,2,[14  4],105,-1,383,-1,381
1,<environment.Job instance at 0x7f3a68f8c820>,105,3,[14  3],106,-1,384,-1,381
1,<environment.Job instance at 0x7f3a69dfb5f0>,106,18,[12  4],107,-1,399,-1,381
1,<environment.Job instance at 0x7f3a68f8cc80>,107,3,[ 4 13],108,-1,384,-1,381
1,<environment.Job instance at 0x7f3a68f3a960>,113,3,[ 1 13],114,-1,413,-1,410
1,<environment.Job instance at 0x7f3a68f3a460>,111,27,[6 5],112,-1,455,-1,428
1,<environment.Job instance at 0x7f3a68f3a690>,116,16,[ 1 12],117,-1,444,-1,428
1,<environment.Job instance at 0x7f3a68f3abe0>,119,23,[4 9],120,-1,455,-1,432
1,<environment.Job instance at 0x7f3a72e04fa0>,118,25,[10  1],119,-1,480,-1,455
1,<environment.Job instance at 0x7f3a69f60960>,127,25,[1 9],128,-1,495,-1,470
1,<environment.Job instance at 0x7f3a68f7e910>,1,28,[6 2],2,-1,30,-1,2
1,<environment.Job instance at 0x7f3a69443c30>,9,15,[8 4],10,-1,25,-1,10
1,<environment.Job instance at 0x7f3a6944ce60>,17,13,[7 4],18,-1,31,-1,18
1,<environment.Job instance at 0x7f3a6944c320>,20,13,[8 5],21,-1,34,-1,21
1,<environment.Job instance at 0x7f3a68d96f50>,28,12,[9 4],29,-1,41,-1,29
1,<environment.Job instance at 0x7f3a69daef00>,34,15,[2 8],35,-1,52,-1,37
1,<environment.Job instance at 0x7f3a69dbc9b0>,37,18,[5 9],38,-1,56,-1,38
1,<environment.Job instance at 0x7f3a69dae230>,36,15,[9 4],37,-1,53,-1,38
1,<environment.Job instance at 0x7f3a69dbca50>,38,25,[3 6],39,-1,64,-1,39
1,<environment.Job instance at 0x7f3a69dc10f0>,40,17,[8 5],41,-1,58,-1,41
1,<environment.Job instance at 0x7f3a69dd2e10>,42,13,[3 8],43,-1,56,-1,43
1,<environment.Job instance at 0x7f3a6994b370>,44,12,[6 3],45,-1,58,-1,46
1,<environment.Job instance at 0x7f3a6993c960>,48,15,[5 5],49,-1,64,-1,49
1,<environment.Job instance at 0x7f3a6993c8c0>,52,20,[3 6],53,-1,73,-1,53
1,<environment.Job instance at 0x7f3a69443960>,53,17,[10  4],54,-1,71,-1,54
1,<environment.Job instance at 0x7f3a699158c0>,56,21,[10  4],57,-1,79,-1,58
1,<environment.Job instance at 0x7f3a69915280>,57,15,[3 8],58,-1,75,-1,60
1,<environment.Job instance at 0x7f3a699153c0>,60,16,[10  1],61,-1,78,-1,62
1,<environment.Job instance at 0x7f3a699337d0>,63,13,[5 5],64,-1,77,-1,64
1,<environment.Job instance at 0x7f3a69915140>,61,18,[3 7],62,-1,84,-1,66
1,<environment.Job instance at 0x7f3a69933460>,68,17,[7 2],69,-1,89,-1,72
1,<environment.Job instance at 0x7f3a699336e0>,69,15,[8 4],70,-1,93,-1,78
1,<environment.Job instance at 0x7f3a69915640>,59,15,[14  4],60,-1,93,-1,78
1,<environment.Job instance at 0x7f3a68cf3280>,82,15,[9 5],83,-1,108,-1,93
1,<environment.Job instance at 0x7f3a69924460>,87,17,[3 5],88,-1,112,-1,95
1,<environment.Job instance at 0x7f3a69914aa0>,79,16,[13  2],80,-1,111,-1,95
1,<environment.Job instance at 0x7f3a69a3d960>,91,20,[5 5],92,-1,115,-1,95
1,<environment.Job instance at 0x7f3a69dc34b0>,71,15,[5 5],72,-1,111,-1,96
1,<environment.Job instance at 0x7f3a68ce2500>,93,22,[2 8],94,-1,118,-1,96
1,<environment.Job instance at 0x7f3a69912eb0>,90,13,[4 7],91,-1,111,-1,98
1,<environment.Job instance at 0x7f3a68d01640>,97,18,[3 6],98,-1,119,-1,101
1,<environment.Job instance at 0x7f3a692b4320>,106,16,[ 2 10],107,-1,134,-1,118
1,<environment.Job instance at 0x7f3a692b41e0>,105,13,[13  1],106,-1,135,-1,122
1,<environment.Job instance at 0x7f3a68cd27d0>,113,2,[5 4],114,-1,124,-1,122
1,<environment.Job instance at 0x7f3a68cd2cd0>,114,18,[2 6],115,-1,142,-1,124
1,<environment.Job instance at 0x7f3a68cd2b90>,115,13,[ 4 14],116,-1,137,-1,124
1,<environment.Job instance at 0x7f3a68cd25f0>,112,21,[9 2],113,-1,146,-1,125
1,<environment.Job instance at 0x7f3a692b4050>,110,12,[9 1],111,-1,137,-1,125
1,<environment.Job instance at 0x7f3a6944c460>,118,17,[2 8],119,-1,147,-1,130
1,<environment.Job instance at 0x7f3a69e0b280>,121,19,[6 5],122,-1,150,-1,131
1,<environment.Job instance at 0x7f3a69915500>,1,28,[6 2],2,-1,30,-1,2
1,<environment.Job instance at 0x7f3a68f71cd0>,23,1,[ 4 14],24,-1,41,-1,40
1,<environment.Job instance at 0x7f3a68f62280>,33,12,[ 1 14],34,-1,63,-1,51
1,<environment.Job instance at 0x7f3a68f628c0>,38,25,[3 6],39,-1,96,-1,71
1,<environment.Job instance at 0x7f3a68f60be0>,51,13,[ 4 11],52,-1,127,-1,114
1,<environment.Job instance at 0x7f3a68e4ff50>,59,15,[14  4],60,-1,157,-1,142
1,<environment.Job instance at 0x7f3a68e8e050>,67,24,[9 5],68,-1,194,-1,170
1,<environment.Job instance at 0x7f3a69954a00>,76,1,[12  5],77,-1,203,-1,202
1,<environment.Job instance at 0x7f3a691af190>,79,16,[13  2],80,-1,228,-1,212
1,<environment.Job instance at 0x7f3a68e61370>,105,13,[13  1],106,-1,287,-1,274
1,<environment.Job instance at 0x7f3a69afc0f0>,108,17,[ 3 13],109,-1,305,-1,288
1,<environment.Job instance at 0x7f3a691ce370>,115,13,[ 4 14],116,-1,320,-1,307
1,<environment.Job instance at 0x7f3a691ce550>,122,25,[3 6],123,-1,354,-1,329
1,<environment.Job instance at 0x7f3a69aee280>,128,3,[ 1 13],129,-1,367,-1,364
1,<environment.Job instance at 0x7f3a68d96050>,7,16,[8 2],8,-1,27,-1,11
1,<environment.Job instance at 0x7f3a68d96230>,11,13,[8 5],12,-1,25,-1,12
1,<environment.Job instance at 0x7f3a68d96690>,12,18,[ 5 10],13,-1,31,-1,13
1,<environment.Job instance at 0x7f3a68cd2320>,21,16,[ 5 10],22,-1,38,-1,22
1,<environment.Job instance at 0x7f3a69a3c3c0>,24,13,[9 1],25,-1,38,-1,25
1,<environment.Job instance at 0x7f3a69a3cf00>,25,21,[3 8],26,-1,47,-1,26
1,<environment.Job instance at 0x7f3a69a3cfa0>,27,18,[ 3 12],28,-1,46,-1,28
1,<environment.Job instance at 0x7f3a69a3cc80>,31,18,[5 2],32,-1,50,-1,32
1,<environment.Job instance at 0x7f3a69a3ce10>,32,21,[1 8],33,-1,54,-1,33
1,<environment.Job instance at 0x7f3a69dbcaf0>,34,17,[10  1],35,-1,52,-1,35
1,<environment.Job instance at 0x7f3a69dbccd0>,36,17,[10  2],37,-1,54,-1,37
1,<environment.Job instance at 0x7f3a69dbcd70>,37,22,[7 5],38,-1,60,-1,38
1,<environment.Job instance at 0x7f3a68d96aa0>,10,16,[ 4 10],11,-1,62,-1,46
1,<environment.Job instance at 0x7f3a69dbce10>,42,15,[5 7],43,-1,63,-1,48
1,<environment.Job instance at 0x7f3a69dbce60>,38,18,[7 1],39,-1,66,-1,48
1,<environment.Job instance at 0x7f3a69dc1500>,47,16,[6 1],48,-1,71,-1,55
1,<environment.Job instance at 0x7f3a69dc14b0>,50,18,[6 2],51,-1,73,-1,55
1,<environment.Job instance at 0x7f3a69dbc910>,40,12,[8 1],41,-1,67,-1,55
1,<environment.Job instance at 0x7f3a69a2a1e0>,51,15,[4 5],52,-1,70,-1,55
1,<environment.Job instance at 0x7f3a69a295a0>,54,18,[ 3 10],55,-1,73,-1,55
1,<environment.Job instance at 0x7f3a69a29690>,57,18,[2 7],58,-1,76,-1,58
1,<environment.Job instance at 0x7f3a69a29fa0>,52,15,[4 8],53,-1,74,-1,59
1,<environment.Job instance at 0x7f3a69db97d0>,62,26,[8 2],63,-1,91,-1,65
1,<environment.Job instance at 0x7f3a69db95a0>,65,18,[10  1],66,-1,84,-1,66
1,<environment.Job instance at 0x7f3a69db9960>,66,27,[5 8],67,-1,94,-1,67
1,<environment.Job instance at 0x7f3a69dbcfa0>,41,16,[ 1 11],42,-1,88,-1,72
1,<environment.Job instance at 0x7f3a69a29960>,60,13,[10  5],61,-1,85,-1,72
1,<environment.Job instance at 0x7f3a69db9c30>,71,3,[8 3],72,-1,79,-1,76
1,<environment.Job instance at 0x7f3a69db9550>,70,21,[5 7],71,-1,97,-1,76
1,<environment.Job instance at 0x7f3a696f9550>,78,16,[2 8],79,-1,95,-1,79
1,<environment.Job instance at 0x7f3a69a2a9b0>,49,18,[4 5],50,-1,101,-1,83
1,<environment.Job instance at 0x7f3a69db98c0>,72,17,[5 3],73,-1,100,-1,83
1,<environment.Job instance at 0x7f3a696f9050>,83,26,[7 3],84,-1,110,-1,84
1,<environment.Job instance at 0x7f3a696f90a0>,84,18,[5 8],85,-1,103,-1,85
1,<environment.Job instance at 0x7f3a696f9730>,85,15,[3 7],86,-1,101,-1,86
1,<environment.Job instance at 0x7f3a696f9190>,86,17,[5 7],87,-1,104,-1,87
1,<environment.Job instance at 0x7f3a696f9dc0>,87,14,[ 4 10],88,-1,102,-1,88
1,<environment.Job instance at 0x7f3a69dd2230>,89,16,[3 7],90,-1,106,-1,90
1,<environment.Job instance at 0x7f3a69dd22d0>,93,13,[5 5],94,-1,107,-1,94
1,<environment.Job instance at 0x7f3a696f9e60>,82,12,[2 7],83,-1,107,-1,95
1,<environment.Job instance at 0x7f3a696f9eb0>,73,1,[1 8],74,-1,97,-1,96
1,<environment.Job instance at 0x7f3a69dd2690>,96,12,[8 5],97,-1,109,-1,97
1,<environment.Job instance at 0x7f3a69dd2370>,97,24,[9 3],98,-1,122,-1,98
1,<environment.Job instance at 0x7f3a69dd2870>,99,15,[10  1],100,-1,115,-1,100
1,<environment.Job instance at 0x7f3a68da92d0>,100,18,[8 5],101,-1,119,-1,101
1,<environment.Job instance at 0x7f3a699e1dc0>,102,14,[8 4],103,-1,117,-1,103
1,<environment.Job instance at 0x7f3a699e1b90>,103,15,[3 5],104,-1,119,-1,104
1,<environment.Job instance at 0x7f3a69f92e60>,106,25,[10  1],107,-1,134,-1,109
1,<environment.Job instance at 0x7f3a68d9c550>,113,27,[4 5],114,-1,155,-1,128
1,<environment.Job instance at 0x7f3a68d9c7d0>,115,20,[5 6],116,-1,149,-1,129
1,<environment.Job instance at 0x7f3a69929e10>,121,17,[ 5 10],122,-1,205,-1,188
1,<environment.Job instance at 0x7f3a6a30de60>,13,17,[13  3],14,-1,36,-1,19
1,<environment.Job instance at 0x7f3a68e66960>,17,13,[12  4],18,-1,34,-1,21
1,<environment.Job instance at 0x7f3a72f9d320>,27,18,[ 3 12],28,-1,76,-1,58
1,<environment.Job instance at 0x7f3a6a3be550>,41,16,[ 1 11],42,-1,111,-1,95
1,<environment.Job instance at 0x7f3a699b79b0>,53,18,[12  1],54,-1,168,-1,150
1,<environment.Job instance at 0x7f3a68e44410>,62,26,[8 2],63,-1,215,-1,189
1,<environment.Job instance at 0x7f3a6a217870>,66,27,[5 8],67,-1,220,-1,193
1,<environment.Job instance at 0x7f3a6a6eda00>,80,3,[ 3 12],81,-1,228,-1,225
1,<environment.Job instance at 0x7f3a69b94f50>,83,26,[7 3],84,-1,255,-1,229
1,<environment.Job instance at 0x7f3a68e2ce10>,97,24,[9 3],98,-1,342,-1,318
1,<environment.Job instance at 0x7f3a68e19aa0>,104,1,[12  4],105,-1,332,-1,331
1,<environment.Job instance at 0x7f3a68e19e10>,106,25,[10  1],107,-1,370,-1,345
1,<environment.Job instance at 0x7f3a69bb9e60>,110,24,[ 4 13],111,-1,372,-1,348
1,<environment.Job instance at 0x7f3a68ff5550>,111,14,[12  1],112,-1,362,-1,348
1,<environment.Job instance at 0x7f3a68ff5690>,113,27,[4 5],114,-1,390,-1,363
1,<environment.Job instance at 0x7f3a69ede9b0>,124,16,[ 2 11],125,-1,426,-1,410
1,<environment.Job instance at 0x7f3a6979bd20>,0,16,[4 9],1,-1,17,-1,1
1,<environment.Job instance at 0x7f3a6a5ed550>,4,13,[9 2],5,-1,20,-1,7
1,<environment.Job instance at 0x7f3a6a5edf00>,7,17,[3 8],8,-1,25,-1,8
1,<environment.Job instance at 0x7f3a6a5ed0a0>,8,18,[5 5],9,-1,27,-1,9
1,<environment.Job instance at 0x7f3a6a646190>,12,18,[5 7],13,-1,31,-1,13
1,<environment.Job instance at 0x7f3a6a646dc0>,16,15,[8 4],17,-1,32,-1,17
1,<environment.Job instance at 0x7f3a69effdc0>,18,18,[5 3],19,-1,37,-1,19
1,<environment.Job instance at 0x7f3a69eff640>,19,18,[8 4],20,-1,38,-1,20
1,<environment.Job instance at 0x7f3a69eff280>,20,15,[1 8],21,-1,36,-1,21
1,<environment.Job instance at 0x7f3a69effc30>,21,28,[7 5],22,-1,50,-1,22
1,<environment.Job instance at 0x7f3a69eff3c0>,23,15,[10  2],24,-1,39,-1,24
1,<environment.Job instance at 0x7f3a69eff8c0>,25,17,[2 9],26,-1,43,-1,26
1,<environment.Job instance at 0x7f3a69eff820>,27,14,[3 8],28,-1,42,-1,28
1,<environment.Job instance at 0x7f3a68e66500>,29,18,[4 6],30,-1,48,-1,30
1,<environment.Job instance at 0x7f3a68e66c30>,32,17,[9 3],33,-1,50,-1,33
1,<environment.Job instance at 0x7f3a68e66c80>,34,14,[2 9],35,-1,49,-1,35
1,<environment.Job instance at 0x7f3a68e66820>,36,18,[9 5],37,-1,55,-1,37
1,<environment.Job instance at 0x7f3a68e66050>,37,15,[10  2],38,-1,53,-1,38
1,<environment.Job instance at 0x7f3a68e66e60>,39,16,[ 2 10],40,-1,56,-1,40
1,<environment.Job instance at 0x7f3a72d044b0>,41,14,[10  4],42,-1,57,-1,43
1,<environment.Job instance at 0x7f3a72d04f50>,43,15,[ 4 10],44,-1,59,-1,44
1,<environment.Job instance at 0x7f3a69ba82d0>,50,13,[9 1],51,-1,64,-1,51
1,<environment.Job instance at 0x7f3a69ba8190>,53,17,[ 4 10],54,-1,92,-1,75
1,<environment.Job instance at 0x7f3a68ec05f0>,61,16,[5 5],62,-1,91,-1,75
1,<environment.Job instance at 0x7f3a68ec0780>,60,18,[7 5],61,-1,93,-1,75
1,<environment.Job instance at 0x7f3a6a5ed500>,6,15,[2 9],7,-1,90,-1,75
1,<environment.Job instance at 0x7f3a68ec0d70>,66,24,[5 3],67,-1,100,-1,76
1,<environment.Job instance at 0x7f3a68ec0640>,57,18,[ 3 11],58,-1,94,-1,76
1,<environment.Job instance at 0x7f3a68ec0410>,67,13,[2 9],68,-1,89,-1,76
1,<environment.Job instance at 0x7f3a6991d0a0>,70,16,[1 7],71,-1,94,-1,78
1,<environment.Job instance at 0x7f3a6991d870>,71,18,[6 5],72,-1,96,-1,78
1,<environment.Job instance at 0x7f3a69dce320>,81,18,[ 5 10],82,-1,112,-1,94
1,<environment.Job instance at 0x7f3a68ec0eb0>,64,12,[ 5 10],65,-1,109,-1,97
1,<environment.Job instance at 0x7f3a69dce3c0>,85,15,[10  1],86,-1,115,-1,100
1,<environment.Job instance at 0x7f3a69dcedc0>,83,18,[2 7],84,-1,118,-1,100
1,<environment.Job instance at 0x7f3a68f51af0>,94,19,[3 6],95,-1,145,-1,126
1,<environment.Job instance at 0x7f3a68ec01e0>,9,16,[13  5],10,-1,33,-1,17
1,<environment.Job instance at 0x7f3a6a0bac80>,17,1,[ 3 11],18,-1,37,-1,36
1,<environment.Job instance at 0x7f3a6a1fb190>,21,28,[7 5],22,-1,96,-1,68
1,<environment.Job instance at 0x7f3a6a5f0280>,47,1,[ 2 11],48,-1,181,-1,180
1,<environment.Job instance at 0x7f3a6a6ede60>,55,3,[ 4 12],56,-1,210,-1,207
1,<environment.Job instance at 0x7f3a68e1dc30>,57,18,[ 3 11],58,-1,225,-1,207
1,<environment.Job instance at 0x7f3a68e1dbe0>,58,2,[14  5],59,-1,209,-1,207
1,<environment.Job instance at 0x7f3a6a217280>,66,24,[5 3],67,-1,266,-1,242
1,<environment.Job instance at 0x7f3a699fabe0>,74,28,[10  4],75,-1,305,-1,277
1,<environment.Job instance at 0x7f3a699faaf0>,75,15,[ 4 12],76,-1,292,-1,277
1,<environment.Job instance at 0x7f3a6981f500>,87,2,[ 5 12],88,-1,319,-1,317
1,<environment.Job instance at 0x7f3a694dd960>,92,25,[2 8],93,-1,353,-1,328
1,<environment.Job instance at 0x7f3a68ff16e0>,96,26,[ 1 12],97,-1,368,-1,342
1,<environment.Job instance at 0x7f3a696f90f0>,103,2,[11  4],104,-1,374,-1,372
1,<environment.Job instance at 0x7f3a6a0cd7d0>,107,2,[11  1],108,-1,387,-1,385
1,<environment.Job instance at 0x7f3a6a66c9b0>,119,2,[ 3 11],120,-1,426,-1,424
1,<environment.Job instance at 0x7fcbaa2f5af0>,2,14,[ 2 10],3,-1,18,-1,4
1,<environment.Job instance at 0x7fcbaa2f59b0>,4,13,[3 6],5,-1,18,-1,5
1,<environment.Job instance at 0x7fcbaa2f5cd0>,6,15,[2 8],7,-1,22,-1,7
1,<environment.Job instance at 0x7fcbaa2f5e10>,7,14,[7 5],8,-1,22,-1,8
1,<environment.Job instance at 0x7fcbaa2f5e60>,8,17,[1 8],9,-1,26,-1,9
1,<environment.Job instance at 0x7fcbaa2f5f00>,9,12,[8 2],10,-1,22,-1,10
1,<environment.Job instance at 0x7fcbb38e58c0>,3,22,[2 5],4,-1,32,-1,10
1,<environment.Job instance at 0x7fcbaa2f5be0>,10,22,[8 1],11,-1,33,-1,11
1,<environment.Job instance at 0x7fcbaa2f8140>,12,23,[6 4],13,-1,36,-1,13
1,<environment.Job instance at 0x7fcbaa2f8320>,13,18,[5 9],14,-1,32,-1,14
1,<environment.Job instance at 0x7fcbaa2f8230>,14,21,[8 1],15,-1,38,-1,17
1,<environment.Job instance at 0x7fcbaa2f8550>,17,12,[5 1],18,-1,30,-1,18
1,<environment.Job instance at 0x7fcbaa2f8500>,18,26,[7 4],19,-1,45,-1,19
1,<environment.Job instance at 0x7fcbaa2f8640>,19,25,[5 9],20,-1,45,-1,20
1,<environment.Job instance at 0x7fcbaa2f8410>,16,18,[7 3],17,-1,38,-1,20
1,<environment.Job instance at 0x7fcbaa2f8780>,21,18,[9 4],22,-1,40,-1,22
1,<environment.Job instance at 0x7fcbaa2f8c30>,26,12,[8 5],27,-1,39,-1,27
1,<environment.Job instance at 0x7fcbaa2f8dc0>,27,17,[4 6],28,-1,45,-1,28
1,<environment.Job instance at 0x7fcbaa2fb820>,39,14,[9 4],40,-1,56,-1,42
1,<environment.Job instance at 0x7fcbaa2fe320>,49,17,[10  2],50,-1,76,-1,59
1,<environment.Job instance at 0x7fcbaa2fe0a0>,47,13,[ 3 10],48,-1,72,-1,59
1,<environment.Job instance at 0x7fcbaa2fe6e0>,54,18,[7 1],55,-1,77,-1,59
1,<environment.Job instance at 0x7fcbaa2fe7d0>,57,16,[ 2 11],58,-1,78,-1,62
1,<environment.Job instance at 0x7fcbaa2fe870>,58,17,[3 7],59,-1,79,-1,62
1,<environment.Job instance at 0x7fcbaa2fb280>,34,14,[1 9],35,-1,76,-1,62
1,<environment.Job instance at 0x7fcbaa2fb0a0>,32,21,[5 9],33,-1,83,-1,62
1,<environment.Job instance at 0x7fcbaa2fb8c0>,40,26,[ 1 10],41,-1,92,-1,66
1,<environment.Job instance at 0x7fcbaa302190>,62,14,[4 9],63,-1,80,-1,66
1,<environment.Job instance at 0x7fcbaa2fe9b0>,59,19,[1 7],60,-1,85,-1,66
1,<environment.Job instance at 0x7fcbaa302780>,70,1,[5 4],71,-1,75,-1,74
1,<environment.Job instance at 0x7fcbaa3025f0>,68,14,[6 4],69,-1,88,-1,74
1,<environment.Job instance at 0x7fcbaa302960>,72,18,[3 5],73,-1,97,-1,79
1,<environment.Job instance at 0x7fcbaa2fb140>,33,26,[3 6],34,-1,105,-1,79
1,<environment.Job instance at 0x7fcbaa302c30>,76,13,[10  1],77,-1,92,-1,79
1,<environment.Job instance at 0x7fcbaa302690>,69,14,[9 4],70,-1,93,-1,79
1,<environment.Job instance at 0x7fcbaa302e60>,79,19,[10  3],80,-1,99,-1,80
1,<environment.Job instance at 0x7fcbaa303140>,81,14,[8 5],82,-1,97,-1,83
1,<environment.Job instance at 0x7fcbaa303410>,82,21,[4 8],83,-1,104,-1,83
1,<environment.Job instance at 0x7fcbaa3032d0>,83,18,[ 3 10],84,-1,102,-1,84
1,<environment.Job instance at 0x7fcbaa303870>,87,18,[7 1],88,-1,107,-1,89
1,<environment.Job instance at 0x7fcbaa303910>,88,16,[4 9],89,-1,105,-1,89
1,<environment.Job instance at 0x7fcbaa3035a0>,85,15,[1 7],86,-1,105,-1,90
1,<environment.Job instance at 0x7fcbaa303820>,89,17,[ 5 14],90,-1,109,-1,92
1,<environment.Job instance at 0x7fcbaa3039b0>,91,18,[5 4],92,-1,111,-1,93
1,<environment.Job instance at 0x7fcbaa2ef0a0>,96,18,[2 6],97,-1,121,-1,103
1,<environment.Job instance at 0x7fcbb392b140>,101,15,[2 7],102,-1,119,-1,104
1,<environment.Job instance at 0x7fcbaa2ccc30>,102,13,[9 4],103,-1,119,-1,106
1,<environment.Job instance at 0x7fcbaa2ece60>,103,16,[1 9],104,-1,122,-1,106
1,<environment.Job instance at 0x7fcbaa2ec8c0>,107,18,[5 5],108,-1,126,-1,108
1,<environment.Job instance at 0x7fcbaa41a370>,108,3,[5 5],109,-1,112,-1,109
1,<environment.Job instance at 0x7fcbaa2ec5f0>,109,27,[3 9],110,-1,137,-1,110
1,<environment.Job instance at 0x7fcbaa2ec0f0>,110,23,[5 1],111,-1,134,-1,111
1,<environment.Job instance at 0x7fcbaa363820>,111,17,[6 4],112,-1,129,-1,112
1,<environment.Job instance at 0x7fcbaa387460>,112,12,[1 6],113,-1,125,-1,113
1,<environment.Job instance at 0x7fcbaa38eaf0>,113,17,[5 1],114,-1,131,-1,114
1,<environment.Job instance at 0x7fcbaa2ec690>,105,16,[7 5],106,-1,135,-1,119
1,<environment.Job instance at 0x7fcbaa7c4a00>,122,18,[7 5],123,-1,149,-1,131
1,<environment.Job instance at 0x7fcbaa41c9b0>,135,15,[8 3],136,-1,158,-1,143
1,<environment.Job instance at 0x7fcbaa31d410>,132,18,[10  4],133,-1,248,-1,230
1,<environment.Job instance at 0x7fcbaa302410>,12,23,[6 4],13,-1,53,-1,30
1,<environment.Job instance at 0x7fcbaa49e280>,18,26,[7 4],19,-1,70,-1,44
1,<environment.Job instance at 0x7fcbaa2ecaa0>,19,25,[5 9],20,-1,83,-1,58
1,<environment.Job instance at 0x7fcbaa31d870>,28,17,[ 1 13],29,-1,87,-1,70
1,<environment.Job instance at 0x7fcbaa2f5870>,30,26,[9 4],31,-1,110,-1,84
1,<environment.Job instance at 0x7fcbaa2f5a50>,31,1,[ 2 14],32,-1,85,-1,84
1,<environment.Job instance at 0x7fcbaa3a5b90>,33,26,[3 6],34,-1,110,-1,84
1,<environment.Job instance at 0x7fcbaa3a4500>,40,26,[ 1 10],41,-1,139,-1,113
1,<environment.Job instance at 0x7fcbaa330550>,57,16,[ 2 11],58,-1,183,-1,167
1,<environment.Job instance at 0x7fcbaa2d8eb0>,89,17,[ 5 14],90,-1,289,-1,272
1,<environment.Job instance at 0x7fcbaa2e94b0>,93,25,[ 1 10],94,-1,320,-1,295
1,<environment.Job instance at 0x7fcbaa3031e0>,109,27,[3 9],110,-1,371,-1,344
1,<environment.Job instance at 0x7fcbaa3035f0>,110,23,[5 1],111,-1,367,-1,344
1,<environment.Job instance at 0x7fcbaa290320>,117,3,[ 3 13],118,-1,367,-1,364
1,<environment.Job instance at 0x7fcbaa2903c0>,119,28,[7 5],120,-1,406,-1,378
1,<environment.Job instance at 0x7fcbaa2904b0>,120,19,[ 5 12],121,-1,397,-1,378
1,<environment.Job instance at 0x7fcbaa2920f0>,137,28,[ 2 10],138,-1,458,-1,430
1,<environment.Job instance at 0x7fcba9ccb8c0>,1,14,[ 3 10],2,-1,17,-1,3
1,<environment.Job instance at 0x7fcba9cce0f0>,11,22,[5 6],12,-1,34,-1,12
1,<environment.Job instance at 0x7fcba9d58410>,15,17,[10  4],16,-1,33,-1,16
1,<environment.Job instance at 0x7fcba9d587d0>,17,21,[10  4],18,-1,39,-1,18
1,<environment.Job instance at 0x7fcba9d58b40>,20,24,[1 5],21,-1,45,-1,21
1,<environment.Job instance at 0x7fcba9d58af0>,22,20,[10  5],23,-1,43,-1,23
1,<environment.Job instance at 0x7fcba9d58820>,24,14,[10  5],25,-1,39,-1,25
1,<environment.Job instance at 0x7fcba9cd1910>,2,15,[ 2 13],3,-1,46,-1,31
1,<environment.Job instance at 0x7fcba9d615f0>,31,13,[5 7],32,-1,45,-1,32
1,<environment.Job instance at 0x7fcba9d61a00>,30,17,[4 7],31,-1,49,-1,32
1,<environment.Job instance at 0x7fcba9d61a50>,32,3,[8 5],33,-1,36,-1,33
1,<environment.Job instance at 0x7fcba9d61cd0>,33,24,[3 7],34,-1,58,-1,34
1,<environment.Job instance at 0x7fcba9d61fa0>,34,19,[3 8],35,-1,54,-1,35
1,<environment.Job instance at 0x7fcba9d66e10>,35,17,[5 1],36,-1,53,-1,36
1,<environment.Job instance at 0x7fcba9d66190>,37,16,[8 4],38,-1,54,-1,38
1,<environment.Job instance at 0x7fcba9d66550>,40,17,[3 5],41,-1,58,-1,41
1,<environment.Job instance at 0x7fcba9d663c0>,42,1,[8 3],43,-1,44,-1,43
1,<environment.Job instance at 0x7fcba9d66410>,44,19,[6 2],45,-1,64,-1,45
1,<environment.Job instance at 0x7fcba9d669b0>,46,17,[9 1],47,-1,64,-1,47
1,<environment.Job instance at 0x7fcba9dc2460>,47,13,[9 5],48,-1,61,-1,48
1,<environment.Job instance at 0x7fcba9b87c30>,50,17,[9 5],51,-1,72,-1,55
1,<environment.Job instance at 0x7fcba9b71f50>,52,15,[ 2 14],53,-1,77,-1,62
1,<environment.Job instance at 0x7fcba9936690>,60,23,[4 7],61,-1,89,-1,66
1,<environment.Job instance at 0x7fcba997fb90>,58,21,[2 7],59,-1,88,-1,67
1,<environment.Job instance at 0x7fcba9945050>,61,14,[ 1 10],62,-1,81,-1,67
1,<environment.Job instance at 0x7fcbb392b460>,48,27,[ 3 12],49,-1,94,-1,67
1,<environment.Job instance at 0x7fcbb3a50a00>,65,19,[ 1 10],66,-1,86,-1,67
1,<environment.Job instance at 0x7fcba988ddc0>,63,14,[5 9],64,-1,81,-1,67
1,<environment.Job instance at 0x7fcba99d95a0>,68,20,[ 2 10],69,-1,90,-1,70
1,<environment.Job instance at 0x7fcba988d280>,69,15,[5 5],70,-1,85,-1,70
1,<environment.Job instance at 0x7fcba9aa34b0>,71,17,[3 6],72,-1,89,-1,72
1,<environment.Job instance at 0x7fcba9900550>,66,16,[6 5],67,-1,93,-1,77
1,<environment.Job instance at 0x7fcba98a6780>,76,16,[1 8],77,-1,97,-1,81
1,<environment.Job instance at 0x7fcba98a61e0>,78,23,[1 9],79,-1,104,-1,81
1,<environment.Job instance at 0x7fcba9a33dc0>,74,16,[5 6],75,-1,97,-1,81
1,<environment.Job instance at 0x7fcba9ab3b40>,75,21,[1 6],76,-1,102,-1,81
1,<environment.Job instance at 0x7fcba98a6640>,79,17,[8 5],80,-1,98,-1,81
1,<environment.Job instance at 0x7fcba98a63c0>,82,15,[8 2],83,-1,99,-1,84
1,<environment.Job instance at 0x7fcba98a4e10>,84,15,[8 5],85,-1,100,-1,85
1,<environment.Job instance at 0x7fcba98a48c0>,88,19,[4 7],89,-1,109,-1,90
1,<environment.Job instance at 0x7fcba9942aa0>,93,22,[9 1],94,-1,118,-1,96
1,<environment.Job instance at 0x7fcba9b71370>,54,26,[3 9],55,-1,125,-1,99
1,<environment.Job instance at 0x7fcba98a3960>,98,13,[2 7],99,-1,112,-1,99
1,<environment.Job instance at 0x7fcba9977a50>,100,13,[5 9],101,-1,114,-1,101
1,<environment.Job instance at 0x7fcba98a68c0>,77,18,[ 1 14],78,-1,144,-1,126
1,<environment.Job instance at 0x7fcba99c90a0>,112,23,[1 8],113,-1,149,-1,126
1,<environment.Job instance at 0x7fcba9a25410>,105,27,[6 1],106,-1,153,-1,126
1,<environment.Job instance at 0x7fcba99c9b40>,111,16,[5 8],112,-1,143,-1,127
1,<environment.Job instance at 0x7fcba98a20f0>,119,3,[4 8],120,-1,130,-1,127
1,<environment.Job instance at 0x7fcbb3976e60>,117,14,[10  5],118,-1,142,-1,128
1,<environment.Job instance at 0x7fcba9924f00>,123,26,[5 3],124,-1,154,-1,128
1,<environment.Job instance at 0x7fcba98a4320>,85,17,[12  1],86,-1,150,-1,133
1,<environment.Job instance at 0x7fcba99cba00>,126,15,[6 5],127,-1,148,-1,133
1,<environment.Job instance at 0x7fcba99d2d20>,128,17,[1 5],129,-1,150,-1,133
1,<environment.Job instance at 0x7fcba9889dc0>,113,1,[9 5],114,-1,135,-1,134
1,<environment.Job instance at 0x7fcba9b161e0>,130,18,[5 8],131,-1,154,-1,136
1,<environment.Job instance at 0x7fcba99d2fa0>,129,18,[5 2],130,-1,155,-1,137
1,<environment.Job instance at 0x7fcba9924fa0>,125,18,[ 1 10],126,-1,157,-1,139
1,<environment.Job instance at 0x7fcba99d5a50>,132,18,[3 8],133,-1,159,-1,141
1,<environment.Job instance at 0x7fcba9b12d20>,137,15,[3 6],138,-1,169,-1,154
1,<environment.Job instance at 0x7fcba9cce550>,2,15,[ 2 13],3,-1,18,-1,3
1,<environment.Job instance at 0x7fcba9ccb140>,4,20,[13  4],5,-1,25,-1,5
1,<environment.Job instance at 0x7fcba991f5a0>,13,1,[12  5],14,-1,18,-1,17
1,<environment.Job instance at 0x7fcbaa290910>,20,24,[1 5],21,-1,50,-1,26
1,<environment.Job instance at 0x7fcbaa2903c0>,26,13,[ 5 14],27,-1,49,-1,36
1,<environment.Job instance at 0x7fcbaa303960>,33,24,[3 7],34,-1,80,-1,56
1,<environment.Job instance at 0x7fcba9c8de10>,48,27,[ 3 12],49,-1,123,-1,96
1,<environment.Job instance at 0x7fcba9ab9aa0>,52,15,[ 2 14],53,-1,124,-1,109
1,<environment.Job instance at 0x7fcba9be2dc0>,54,26,[3 9],55,-1,140,-1,114
1,<environment.Job instance at 0x7fcba9ab7280>,60,23,[4 7],61,-1,155,-1,132
1,<environment.Job instance at 0x7fcba9a96280>,70,1,[14  4],71,-1,174,-1,173
1,<environment.Job instance at 0x7fcba9bd8640>,77,18,[ 1 14],78,-1,223,-1,205
1,<environment.Job instance at 0x7fcba9b533c0>,78,23,[1 9],79,-1,244,-1,221
1,<environment.Job instance at 0x7fcba9bb02d0>,85,17,[12  1],86,-1,253,-1,236
1,<environment.Job instance at 0x7fcba9a4d7d0>,90,16,[14  3],91,-1,281,-1,265
1,<environment.Job instance at 0x7fcba9a510f0>,97,2,[ 1 12],98,-1,285,-1,283
1,<environment.Job instance at 0x7fcba9a94190>,105,27,[6 1],106,-1,351,-1,324
1,<environment.Job instance at 0x7fcba9a74f00>,112,23,[1 8],113,-1,378,-1,355
1,<environment.Job instance at 0x7fcba9a5c640>,123,26,[5 3],124,-1,404,-1,378
1,<environment.Job instance at 0x7fcba98f3730>,0,15,[5 8],1,-1,16,-1,1
1,<environment.Job instance at 0x7fcba9a1c820>,1,20,[ 4 10],2,-1,22,-1,2
1,<environment.Job instance at 0x7fcba9a1c5f0>,2,15,[9 2],3,-1,20,-1,5
1,<environment.Job instance at 0x7fcba9a1c910>,5,2,[5 7],6,-1,8,-1,6
1,<environment.Job instance at 0x7fcba9a1c5a0>,6,2,[8 1],7,-1,9,-1,7
1,<environment.Job instance at 0x7fcba9a1c550>,4,16,[7 5],5,-1,23,-1,7
1,<environment.Job instance at 0x7fcba9a1c7d0>,7,27,[9 5],8,-1,35,-1,8
1,<environment.Job instance at 0x7fcba9a19690>,16,13,[8 2],17,-1,33,-1,20
1,<environment.Job instance at 0x7fcba9a194b0>,19,15,[6 5],20,-1,35,-1,20
1,<environment.Job instance at 0x7fcba9a11640>,23,17,[7 4],24,-1,42,-1,25
1,<environment.Job instance at 0x7fcba9a11410>,28,14,[7 1],29,-1,43,-1,29
1,<environment.Job instance at 0x7fcba9a11550>,29,12,[6 3],30,-1,42,-1,30
1,<environment.Job instance at 0x7fcba9a0d870>,33,16,[4 5],34,-1,50,-1,34
1,<environment.Job instance at 0x7fcba9a0d780>,34,15,[2 6],35,-1,50,-1,35
1,<environment.Job instance at 0x7fcba9a0d820>,35,16,[7 5],36,-1,52,-1,36
1,<environment.Job instance at 0x7fcba9a191e0>,24,17,[13  5],25,-1,57,-1,40
1,<environment.Job instance at 0x7fcba9a882d0>,52,20,[4 9],53,-1,80,-1,60
1,<environment.Job instance at 0x7fcba9a88870>,45,27,[4 5],46,-1,94,-1,67
1,<environment.Job instance at 0x7fcba9a0d050>,40,16,[8 3],41,-1,83,-1,67
1,<environment.Job instance at 0x7fcba9a86320>,62,17,[5 9],63,-1,84,-1,67
1,<environment.Job instance at 0x7fcba9a86500>,63,17,[7 1],64,-1,84,-1,67
1,<environment.Job instance at 0x7fcba9a0df50>,43,16,[ 4 10],44,-1,83,-1,67
1,<environment.Job instance at 0x7fcba9a86550>,64,21,[4 9],65,-1,89,-1,68
1,<environment.Job instance at 0x7fcba9a86b40>,66,13,[2 5],67,-1,81,-1,68
1,<environment.Job instance at 0x7fcba9a82640>,67,13,[12  1],68,-1,81,-1,68
1,<environment.Job instance at 0x7fcba9a82780>,68,12,[14  3],69,-1,81,-1,69
1,<environment.Job instance at 0x7fcba9a825f0>,70,14,[2 9],71,-1,85,-1,71
1,<environment.Job instance at 0x7fcba9a86be0>,59,15,[ 2 10],60,-1,91,-1,76
1,<environment.Job instance at 0x7fcba9a11500>,22,25,[ 3 11],23,-1,102,-1,77
1,<environment.Job instance at 0x7fcba9a7f460>,78,12,[6 4],79,-1,102,-1,90
1,<environment.Job instance at 0x7fcba9a7f370>,85,13,[9 1],86,-1,103,-1,90
1,<environment.Job instance at 0x7fcba9a7f3c0>,86,18,[8 3],87,-1,116,-1,98
1,<environment.Job instance at 0x7fcba9a7f190>,80,26,[8 3],81,-1,125,-1,99
1,<environment.Job instance at 0x7fcba9a7ae10>,91,18,[5 8],92,-1,118,-1,100
1,<environment.Job instance at 0x7fcba9a7aa00>,92,14,[2 8],93,-1,114,-1,100
1,<environment.Job instance at 0x7fcba9b6dfa0>,102,17,[8 2],103,-1,164,-1,147
1,<environment.Job instance at 0x7fcba9a829b0>,76,25,[2 8],77,-1,172,-1,147
1,<environment.Job instance at 0x7fcba9a29b40>,100,16,[ 4 10],101,-1,163,-1,147
1,<environment.Job instance at 0x7fcba9b6d780>,105,17,[12  4],106,-1,164,-1,147
1,<environment.Job instance at 0x7fcba9b6dbe0>,106,17,[7 4],107,-1,164,-1,147
1,<environment.Job instance at 0x7fcbaa0c3190>,110,15,[1 9],111,-1,172,-1,157
1,<environment.Job instance at 0x7fcba9c25fa0>,114,18,[10  5],115,-1,175,-1,157
1,<environment.Job instance at 0x7fcba98e38c0>,109,18,[10  4],110,-1,179,-1,161
1,<environment.Job instance at 0x7fcba9b96b40>,116,16,[2 9],117,-1,177,-1,161
1,<environment.Job instance at 0x7fcba9b71e60>,120,16,[8 5],121,-1,181,-1,165
1,<environment.Job instance at 0x7fcbaa7fe910>,118,15,[10  4],119,-1,181,-1,166
1,<environment.Job instance at 0x7fcba9a356e0>,121,16,[4 5],122,-1,182,-1,166
1,<environment.Job instance at 0x7fcbaa7dfb90>,123,18,[1 6],124,-1,184,-1,166
1,<environment.Job instance at 0x7fcba9a88c80>,7,27,[9 5],8,-1,45,-1,18
1,<environment.Job instance at 0x7fcba9a86eb0>,9,14,[12  2],10,-1,32,-1,18
1,<environment.Job instance at 0x7fcbaa1a3820>,21,17,[ 5 14],22,-1,54,-1,37
1,<environment.Job instance at 0x7fcba9a33b40>,22,25,[ 3 11],23,-1,62,-1,37
1,<environment.Job instance at 0x7fcba98fde60>,24,17,[13  5],25,-1,55,-1,38
1,<environment.Job instance at 0x7fcbaa4744b0>,25,13,[ 5 14],26,-1,51,-1,38
1,<environment.Job instance at 0x7fcba98a3be0>,45,27,[4 5],46,-1,155,-1,128
1,<environment.Job instance at 0x7fcba9ccbb90>,47,12,[13  4],48,-1,140,-1,128
1,<environment.Job instance at 0x7fcba98a65a0>,48,12,[ 5 12],49,-1,140,-1,128
1,<environment.Job instance at 0x7fcba98f6780>,67,13,[12  1],68,-1,187,-1,174
1,<environment.Job instance at 0x7fcba98f65a0>,68,12,[14  3],69,-1,186,-1,174
1,<environment.Job instance at 0x7fcba98f9280>,69,1,[ 4 11],70,-1,175,-1,174
1,<environment.Job instance at 0x7fcba99e9050>,76,25,[2 8],77,-1,223,-1,198
1,<environment.Job instance at 0x7fcba9bd6aa0>,80,26,[8 3],81,-1,240,-1,214
1,<environment.Job instance at 0x7fcba99cbf00>,94,2,[11  3],95,-1,255,-1,253
1,<environment.Job instance at 0x7fcba99d2be0>,105,17,[12  4],106,-1,315,-1,298
1,<environment.Job instance at 0x7fcba9b2daf0>,117,2,[ 3 11],118,-1,356,-1,354
1,<environment.Job instance at 0x7fcba9b2d320>,122,27,[8 3],123,-1,414,-1,387
1,<environment.Job instance at 0x7fcba9b2d5a0>,126,27,[2 6],127,-1,431,-1,404
1,<environment.Job instance at 0x7fcba9a2c2d0>,130,14,[ 4 14],131,-1,434,-1,420
1,<environment.Job instance at 0x7fcba9a60be0>,0,12,[10  5],1,-1,15,-1,3
1,<environment.Job instance at 0x7fcba9858050>,2,16,[6 4],3,-1,20,-1,4
1,<environment.Job instance at 0x7fcba9858410>,6,21,[ 4 10],7,-1,28,-1,7
1,<environment.Job instance at 0x7fcba9858500>,7,23,[2 8],8,-1,31,-1,8
1,<environment.Job instance at 0x7fcba9858b90>,15,17,[ 5 10],16,-1,34,-1,17
1,<environment.Job instance at 0x7fcba9858d20>,18,14,[8 2],19,-1,33,-1,19
1,<environment.Job instance at 0x7fcba9858c30>,20,25,[6 4],21,-1,46,-1,21
1,<environment.Job instance at 0x7fcba985b1e0>,23,13,[ 4 10],24,-1,37,-1,24
1,<environment.Job instance at 0x7fcba985b370>,24,24,[5 5],25,-1,49,-1,25
1,<environment.Job instance at 0x7fcba985b460>,26,14,[2 5],27,-1,41,-1,27
1,<environment.Job instance at 0x7fcba985b550>,28,28,[ 5 10],29,-1,57,-1,29
1,<environment.Job instance at 0x7fcba985b730>,29,15,[9 5],30,-1,45,-1,30
1,<environment.Job instance at 0x7fcba985b690>,30,13,[5 5],31,-1,44,-1,31
1,<environment.Job instance at 0x7fcba985b8c0>,31,17,[7 5],32,-1,49,-1,32
1,<environment.Job instance at 0x7fcba985bcd0>,35,14,[3 8],36,-1,50,-1,36
1,<environment.Job instance at 0x7fcba985bd20>,36,12,[ 5 12],37,-1,49,-1,37
1,<environment.Job instance at 0x7fcba985bf00>,38,15,[2 9],39,-1,54,-1,39
1,<environment.Job instance at 0x7fcba985d050>,40,12,[4 5],41,-1,53,-1,41
1,<environment.Job instance at 0x7fcba985d500>,43,15,[6 4],44,-1,59,-1,44
1,<environment.Job instance at 0x7fcba985d7d0>,46,12,[10  2],47,-1,59,-1,47
1,<environment.Job instance at 0x7fcba985dc30>,51,16,[ 1 14],52,-1,71,-1,55
1,<environment.Job instance at 0x7fcba9858280>,16,14,[9 4],17,-1,69,-1,55
1,<environment.Job instance at 0x7fcba9858d70>,19,17,[12  4],20,-1,72,-1,55
1,<environment.Job instance at 0x7fcba985dd20>,52,14,[5 3],53,-1,69,-1,55
1,<environment.Job instance at 0x7fcba985e1e0>,55,20,[7 5],56,-1,76,-1,56
1,<environment.Job instance at 0x7fcba985ddc0>,54,22,[7 3],55,-1,78,-1,56
1,<environment.Job instance at 0x7fcba9a1c9b0>,61,15,[7 1],62,-1,86,-1,71
1,<environment.Job instance at 0x7fcba9c5de60>,67,18,[8 2],68,-1,89,-1,71
1,<environment.Job instance at 0x7fcbaa0055f0>,64,17,[14  5],65,-1,88,-1,71
1,<environment.Job instance at 0x7fcbaa7561e0>,73,14,[9 3],74,-1,88,-1,74
1,<environment.Job instance at 0x7fcba9c72550>,75,17,[8 2],76,-1,93,-1,76
1,<environment.Job instance at 0x7fcbaa760f00>,82,16,[10  4],83,-1,108,-1,92
1,<environment.Job instance at 0x7fcba984d190>,63,2,[9 1],64,-1,94,-1,92
1,<environment.Job instance at 0x7fcba9c72c80>,76,16,[1 9],77,-1,109,-1,93
1,<environment.Job instance at 0x7fcbaa245e60>,86,22,[1 8],87,-1,117,-1,95
1,<environment.Job instance at 0x7fcbaa16b7d0>,84,16,[9 5],85,-1,114,-1,98
1,<environment.Job instance at 0x7fcba9ff8aa0>,87,28,[5 9],88,-1,126,-1,98
1,<environment.Job instance at 0x7fcba9c581e0>,89,18,[5 8],90,-1,116,-1,98
1,<environment.Job instance at 0x7fcba9c582d0>,90,18,[ 2 10],91,-1,117,-1,99
1,<environment.Job instance at 0x7fcba9fdfd70>,92,13,[1 5],93,-1,113,-1,100
1,<environment.Job instance at 0x7fcba9fdfaa0>,94,16,[6 1],95,-1,118,-1,102
1,<environment.Job instance at 0x7fcba9fdf9b0>,96,18,[ 5 10],97,-1,120,-1,102
1,<environment.Job instance at 0x7fcba9fd8190>,97,28,[9 1],98,-1,132,-1,104
1,<environment.Job instance at 0x7fcbaa7603c0>,83,16,[6 5],84,-1,120,-1,104
1,<environment.Job instance at 0x7fcba9c6ceb0>,72,17,[4 5],73,-1,121,-1,104
1,<environment.Job instance at 0x7fcba9c75820>,108,15,[2 8],109,-1,124,-1,109
1,<environment.Job instance at 0x7fcba9c75960>,109,18,[1 7],110,-1,128,-1,110
1,<environment.Job instance at 0x7fcba9fdae10>,102,26,[5 8],103,-1,137,-1,111
1,<environment.Job instance at 0x7fcba9c7c0a0>,101,14,[9 2],102,-1,125,-1,111
1,<environment.Job instance at 0x7fcba9c58b40>,91,15,[8 1],92,-1,128,-1,113
1,<environment.Job instance at 0x7fcba9c75b40>,115,18,[4 6],116,-1,146,-1,128
1,<environment.Job instance at 0x7fcba9c7dc30>,120,22,[7 1],121,-1,150,-1,128
1,<environment.Job instance at 0x7fcba9c7d190>,121,12,[1 6],122,-1,140,-1,128
1,<environment.Job instance at 0x7fcba9c7d870>,122,21,[5 7],123,-1,150,-1,129
1,<environment.Job instance at 0x7fcba9c7d050>,125,16,[4 7],126,-1,145,-1,129
1,<environment.Job instance at 0x7fcba9c7d6e0>,126,18,[9 3],127,-1,148,-1,130
1,<environment.Job instance at 0x7fcba9c75640>,117,28,[ 5 10],118,-1,164,-1,136
1,<environment.Job instance at 0x7fcba9c7d2d0>,128,16,[1 7],129,-1,152,-1,136
1,<environment.Job instance at 0x7fcba9c7ddc0>,129,18,[8 2],130,-1,155,-1,137
1,<environment.Job instance at 0x7fcba9c7d910>,119,18,[3 8],120,-1,161,-1,143
1,<environment.Job instance at 0x7fcba9c7daa0>,133,17,[4 7],134,-1,160,-1,143
1,<environment.Job instance at 0x7fcba984bf50>,135,15,[5 9],136,-1,158,-1,143
1,<environment.Job instance at 0x7fcba985d9b0>,7,23,[2 8],8,-1,36,-1,13
1,<environment.Job instance at 0x7fcba985d190>,8,3,[11  1],9,-1,16,-1,13
1,<environment.Job instance at 0x7fcba984d5a0>,9,19,[13  3],10,-1,32,-1,13
1,<environment.Job instance at 0x7fcba9fd1690>,14,13,[ 4 11],15,-1,32,-1,19
1,<environment.Job instance at 0x7fcba9c75b90>,19,17,[12  4],20,-1,47,-1,30
1,<environment.Job instance at 0x7fcba9c751e0>,20,25,[6 4],21,-1,58,-1,33
1,<environment.Job instance at 0x7fcba9c7d5f0>,22,3,[14  5],23,-1,36,-1,33
1,<environment.Job instance at 0x7fcba9c7dcd0>,24,24,[5 5],25,-1,67,-1,43
1,<environment.Job instance at 0x7fcba9a7a2d0>,28,28,[ 5 10],29,-1,87,-1,59
1,<environment.Job instance at 0x7fcba9b2db90>,36,12,[ 5 12],37,-1,89,-1,77
1,<environment.Job instance at 0x7fcba9b2ddc0>,39,2,[ 5 14],40,-1,92,-1,90
1,<environment.Job instance at 0x7fcba99d2c80>,51,16,[ 1 14],52,-1,151,-1,135
1,<environment.Job instance at 0x7fcba99f80f0>,64,17,[14  5],65,-1,186,-1,169
1,<environment.Job instance at 0x7fcba9936500>,71,2,[14  5],72,-1,181,-1,179
1,<environment.Job instance at 0x7fcba98f9be0>,87,28,[5 9],88,-1,277,-1,249
1,<environment.Job instance at 0x7fcba997f3c0>,97,28,[9 1],98,-1,320,-1,292
1,<environment.Job instance at 0x7fcba9cce1e0>,102,26,[5 8],103,-1,334,-1,308
1,<environment.Job instance at 0x7fcba9b161e0>,106,2,[ 5 13],107,-1,323,-1,321
1,<environment.Job instance at 0x7fcba9a31640>,111,1,[13  4],112,-1,330,-1,329
1,<environment.Job instance at 0x7fcba9b04f50>,118,2,[12  3],119,-1,358,-1,356
1,<environment.Job instance at 0x7fcba9c97aa0>,117,28,[ 5 10],118,-1,443,-1,415
1,<environment.Job instance at 0x7fcba9d35e10>,0,26,[3 7],1,-1,27,-1,1
1,<environment.Job instance at 0x7fcbaa9a25a0>,4,16,[1 5],5,-1,22,-1,6
1,<environment.Job instance at 0x7fcba9a7aa50>,5,18,[4 9],6,-1,25,-1,7
1,<environment.Job instance at 0x7fcbaa9a2dc0>,7,18,[10  5],8,-1,27,-1,9
1,<environment.Job instance at 0x7fcbaa9a2050>,10,13,[10  1],11,-1,24,-1,11
1,<environment.Job instance at 0x7fcbaa9a24b0>,12,24,[1 9],13,-1,37,-1,13
1,<environment.Job instance at 0x7fcbaa9a2aa0>,16,12,[10  1],17,-1,29,-1,17
1,<environment.Job instance at 0x7fcbaa5bc3c0>,20,17,[5 6],21,-1,38,-1,21
1,<environment.Job instance at 0x7fcbaa5bcf00>,21,27,[7 1],22,-1,49,-1,22
1,<environment.Job instance at 0x7fcbaa5bc870>,22,26,[ 3 10],23,-1,49,-1,23
1,<environment.Job instance at 0x7fcbaa5bc8c0>,25,21,[ 2 10],26,-1,47,-1,26
1,<environment.Job instance at 0x7fcbaa5bc5f0>,31,17,[11  3],32,-1,50,-1,33
1,<environment.Job instance at 0x7fcbaa5bc460>,26,15,[10  2],27,-1,48,-1,33
1,<environment.Job instance at 0x7fcbaa635410>,36,12,[6 4],37,-1,51,-1,39
1,<environment.Job instance at 0x7fcbaa5bc370>,29,13,[4 7],30,-1,52,-1,39
1,<environment.Job instance at 0x7fcbaa635c80>,39,15,[ 3 10],40,-1,55,-1,40
1,<environment.Job instance at 0x7fcbaa635910>,38,3,[9 3],39,-1,43,-1,40
1,<environment.Job instance at 0x7fcbaa6355f0>,40,17,[10  2],41,-1,58,-1,41
1,<environment.Job instance at 0x7fcbaa635190>,41,13,[10  2],42,-1,55,-1,42
1,<environment.Job instance at 0x7fcbaa5bc140>,30,16,[10  1],31,-1,59,-1,43
1,<environment.Job instance at 0x7fcbaa635730>,42,14,[5 1],43,-1,58,-1,44
1,<environment.Job instance at 0x7fcbaa635b40>,43,24,[2 6],44,-1,68,-1,44
1,<environment.Job instance at 0x7fcbaa5bc0f0>,32,16,[12  1],33,-1,64,-1,48
1,<environment.Job instance at 0x7fcbaa635a50>,45,2,[ 2 11],46,-1,50,-1,48
1,<environment.Job instance at 0x7fcbaa0b1820>,50,14,[5 8],51,-1,65,-1,51
1,<environment.Job instance at 0x7fcbaa0b1960>,52,18,[6 2],53,-1,71,-1,53
1,<environment.Job instance at 0x7fcbaa0b1190>,54,18,[6 2],55,-1,73,-1,55
1,<environment.Job instance at 0x7fcbaa0b1fa0>,55,19,[6 3],56,-1,75,-1,56
1,<environment.Job instance at 0x7fcbaa0b1a50>,61,14,[3 6],62,-1,76,-1,62
1,<environment.Job instance at 0x7fcbaa0b19b0>,62,27,[5 7],63,-1,90,-1,63
1,<environment.Job instance at 0x7fcbaa0b13c0>,66,15,[10  3],67,-1,84,-1,69
1,<environment.Job instance at 0x7fcbaa341a50>,65,16,[9 2],66,-1,85,-1,69
1,<environment.Job instance at 0x7fcbaa3415f0>,69,17,[5 2],70,-1,87,-1,70
1,<environment.Job instance at 0x7fcbaa6abdc0>,75,15,[6 2],76,-1,93,-1,78
1,<environment.Job instance at 0x7fcbaa3411e0>,68,15,[11  4],69,-1,97,-1,82
1,<environment.Job instance at 0x7fcbaa82a910>,93,24,[8 5],94,-1,177,-1,153
1,<environment.Job instance at 0x7fcbaa6ab8c0>,91,18,[ 3 10],92,-1,171,-1,153
1,<environment.Job instance at 0x7fcbaa00a370>,108,20,[3 9],109,-1,235,-1,215
1,<environment.Job instance at 0x7fcbaa82abe0>,103,15,[ 3 10],104,-1,230,-1,215
1,<environment.Job instance at 0x7fcbaa5ec550>,113,14,[ 5 13],114,-1,288,-1,274
1,<environment.Job instance at 0x7fcbaa3e2dc0>,124,18,[6 4],125,-1,292,-1,274
1,<environment.Job instance at 0x7fcbaa6ab140>,81,18,[4 9],82,-1,292,-1,274
1,<environment.Job instance at 0x7fcbaa3e2050>,125,15,[4 7],126,-1,289,-1,274
1,<environment.Job instance at 0x7fcbaa3e21e0>,127,17,[8 4],128,-1,293,-1,276
1,<environment.Job instance at 0x7fcbaa402820>,117,21,[4 8],118,-1,297,-1,276
1,<environment.Job instance at 0x7fcbaa3e25a0>,128,16,[1 7],129,-1,292,-1,276
1,<environment.Job instance at 0x7fcbaa5bcd20>,0,26,[3 7],1,-1,27,-1,1
1,<environment.Job instance at 0x7fcbaa5bcb90>,1,18,[11  5],2,-1,20,-1,2
1,<environment.Job instance at 0x7fcbaa3419b0>,9,1,[12  2],10,-1,16,-1,15
1,<environment.Job instance at 0x7fcbaa6abeb0>,12,24,[1 9],13,-1,52,-1,28
1,<environment.Job instance at 0x7fcbaa00a1e0>,21,27,[7 1],22,-1,81,-1,54
1,<environment.Job instance at 0x7fcbaa5b6cd0>,22,26,[ 3 10],23,-1,80,-1,54
1,<environment.Job instance at 0x7fcbaa5b6820>,23,2,[ 3 13],24,-1,56,-1,54
1,<environment.Job instance at 0x7fcbaa5b6410>,27,1,[ 3 14],28,-1,56,-1,55
1,<environment.Job instance at 0x7fcbaa5b6640>,28,12,[ 2 11],29,-1,67,-1,55
1,<environment.Job instance at 0x7fcbaa9a2960>,31,17,[11  3],32,-1,82,-1,65
1,<environment.Job instance at 0x7fcbaa9a2c80>,32,16,[12  1],33,-1,81,-1,65
1,<environment.Job instance at 0x7fcbaa9a2a00>,33,15,[ 4 13],34,-1,80,-1,65
1,<environment.Job instance at 0x7fcba9977370>,43,24,[2 6],44,-1,134,-1,110
1,<environment.Job instance at 0x7fcba9b04f50>,44,13,[ 5 12],45,-1,123,-1,110
1,<environment.Job instance at 0x7fcba9ed8370>,45,2,[ 2 11],46,-1,112,-1,110
1,<environment.Job instance at 0x7fcba99e97d0>,62,27,[5 7],63,-1,211,-1,184
1,<environment.Job instance at 0x7fcba9bd6a00>,64,24,[13  2],65,-1,208,-1,184
1,<environment.Job instance at 0x7fcba9936be0>,68,15,[11  4],69,-1,218,-1,203
1,<environment.Job instance at 0x7fcba99cba00>,71,14,[ 4 13],72,-1,232,-1,218
1,<environment.Job instance at 0x7fcba9b2d5a0>,87,14,[11  4],88,-1,298,-1,284
1,<environment.Job instance at 0x7fcba9b2db90>,90,18,[ 4 11],91,-1,314,-1,296
1,<environment.Job instance at 0x7fcba9a2c550>,93,24,[8 5],94,-1,341,-1,317
1,<environment.Job instance at 0x7fcba9853eb0>,98,13,[12  1],99,-1,347,-1,334
1,<environment.Job instance at 0x7fcba9fd1690>,106,3,[14  2],107,-1,366,-1,363
1,<environment.Job instance at 0x7fcba9c6c690>,113,14,[ 5 13],114,-1,407,-1,393
1,<environment.Job instance at 0x7fcba985d9b0>,118,23,[3 9],119,-1,433,-1,410
1,<environment.Job instance at 0x7fcbaa2d8aa0>,130,2,[ 1 11],131,-1,463,-1,461
1,<environment.Job instance at 0x7fcbaa6b0140>,137,12,[ 3 14],138,-1,494,-1,482
1,<environment.Job instance at 0x7fcbb398adc0>,1,16,[8 4],2,-1,18,-1,2
1,<environment.Job instance at 0x7fcba956d6e0>,3,18,[6 4],4,-1,22,-1,4
1,<environment.Job instance at 0x7fcba9627a50>,15,21,[9 5],16,-1,37,-1,16
1,<environment.Job instance at 0x7fcba9536960>,16,18,[10  5],17,-1,35,-1,17
1,<environment.Job instance at 0x7fcba9536b40>,17,14,[1 9],18,-1,32,-1,18
1,<environment.Job instance at 0x7fcba9519910>,21,16,[1 6],22,-1,38,-1,22
1,<environment.Job instance at 0x7fcba9519e60>,23,27,[3 5],24,-1,51,-1,24
1,<environment.Job instance at 0x7fcba9f13f00>,27,17,[5 7],28,-1,45,-1,28
1,<environment.Job instance at 0x7fcba9560e60>,28,12,[7 5],29,-1,41,-1,29
1,<environment.Job instance at 0x7fcba9560960>,29,12,[1 9],30,-1,42,-1,30
1,<environment.Job instance at 0x7fcba9560b40>,33,12,[9 3],34,-1,46,-1,34
1,<environment.Job instance at 0x7fcba9560cd0>,35,14,[5 2],36,-1,51,-1,37
1,<environment.Job instance at 0x7fcbb3537a50>,37,17,[2 6],38,-1,55,-1,38
1,<environment.Job instance at 0x7fcbb3537be0>,38,17,[5 4],39,-1,56,-1,39
1,<environment.Job instance at 0x7fcbb3537870>,40,16,[9 4],41,-1,57,-1,41
1,<environment.Job instance at 0x7fcbb3537690>,42,12,[8 3],43,-1,55,-1,43
1,<environment.Job instance at 0x7fcbaa35b050>,43,13,[5 6],44,-1,57,-1,44
1,<environment.Job instance at 0x7fcbaa43d550>,45,18,[3 9],46,-1,64,-1,46
1,<environment.Job instance at 0x7fcbaada94b0>,46,27,[10  4],47,-1,74,-1,47
1,<environment.Job instance at 0x7fcbaae7a9b0>,49,14,[9 4],50,-1,64,-1,50
1,<environment.Job instance at 0x7fcbaada9320>,51,18,[4 8],52,-1,70,-1,52
1,<environment.Job instance at 0x7fcbaa6cb8c0>,52,25,[7 3],53,-1,78,-1,53
1,<environment.Job instance at 0x7fcbaa997280>,56,17,[2 9],57,-1,74,-1,57
1,<environment.Job instance at 0x7fcbaa9c8d20>,57,13,[4 7],58,-1,71,-1,58
1,<environment.Job instance at 0x7fcbaa9fd500>,36,12,[6 4],37,-1,74,-1,62
1,<environment.Job instance at 0x7fcba9de7230>,61,17,[10  5],62,-1,79,-1,62
1,<environment.Job instance at 0x7fcba952df50>,62,2,[3 9],63,-1,65,-1,63
1,<environment.Job instance at 0x7fcba952db40>,63,17,[6 1],64,-1,81,-1,64
1,<environment.Job instance at 0x7fcba952d140>,68,14,[13  2],69,-1,84,-1,70
1,<environment.Job instance at 0x7fcbaa997320>,59,14,[4 7],60,-1,86,-1,72
1,<environment.Job instance at 0x7fcba95579b0>,69,18,[5 2],70,-1,90,-1,72
1,<environment.Job instance at 0x7fcbaa9a4f00>,77,16,[2 7],78,-1,96,-1,80
1,<environment.Job instance at 0x7fcbaa9a48c0>,78,15,[6 2],79,-1,95,-1,80
1,<environment.Job instance at 0x7fcbaacee140>,71,2,[ 2 10],72,-1,82,-1,80
1,<environment.Job instance at 0x7fcbaa9a4eb0>,79,14,[7 2],80,-1,94,-1,80
1,<environment.Job instance at 0x7fcbaa98d6e0>,80,18,[1 7],81,-1,99,-1,81
1,<environment.Job instance at 0x7fcbaa98da50>,85,26,[4 8],86,-1,112,-1,86
1,<environment.Job instance at 0x7fcbaa8fdf50>,86,20,[4 8],87,-1,107,-1,87
1,<environment.Job instance at 0x7fcbaa98d410>,82,14,[8 5],83,-1,103,-1,89
1,<environment.Job instance at 0x7fcbaa8fdc30>,90,25,[5 4],91,-1,116,-1,91
1,<environment.Job instance at 0x7fcbaa8fda00>,88,16,[8 4],89,-1,108,-1,92
1,<environment.Job instance at 0x7fcbaac78410>,93,18,[ 2 10],94,-1,112,-1,94
1,<environment.Job instance at 0x7fcbaa8fd5f0>,91,21,[5 5],92,-1,118,-1,97
1,<environment.Job instance at 0x7fcbaac78c80>,95,25,[5 7],96,-1,122,-1,97
1,<environment.Job instance at 0x7fcbaa8ea910>,97,22,[5 8],98,-1,126,-1,104
1,<environment.Job instance at 0x7fcbaac78e60>,94,13,[7 3],95,-1,119,-1,106
1,<environment.Job instance at 0x7fcbaa901730>,101,12,[3 9],102,-1,119,-1,107
1,<environment.Job instance at 0x7fcbaad34870>,103,27,[8 5],104,-1,136,-1,109
1,<environment.Job instance at 0x7fcba9ab6050>,104,12,[ 5 13],105,-1,121,-1,109
1,<environment.Job instance at 0x7fcba9ab6b90>,105,14,[7 3],106,-1,124,-1,110
1,<environment.Job instance at 0x7fcba988d870>,113,24,[3 5],114,-1,139,-1,115
1,<environment.Job instance at 0x7fcbaacc46e0>,76,1,[2 8],77,-1,118,-1,117
1,<environment.Job instance at 0x7fcba9d44230>,115,14,[10  1],116,-1,131,-1,117
1,<environment.Job instance at 0x7fcba988dcd0>,116,15,[3 6],117,-1,134,-1,119
1,<environment.Job instance at 0x7fcba9d44a50>,117,17,[2 7],118,-1,136,-1,119
1,<environment.Job instance at 0x7fcba988d2d0>,114,14,[4 6],115,-1,137,-1,123
1,<environment.Job instance at 0x7fcba9d44b40>,121,18,[5 9],122,-1,141,-1,123
1,<environment.Job instance at 0x7fcba9d44d20>,118,15,[5 5],119,-1,143,-1,128
1,<environment.Job instance at 0x7fcba9d440f0>,124,27,[1 8],125,-1,155,-1,128
1,<environment.Job instance at 0x7fcba9d440a0>,123,18,[3 7],124,-1,146,-1,128
1,<environment.Job instance at 0x7fcbaacc4140>,75,12,[3 7],76,-1,141,-1,129
1,<environment.Job instance at 0x7fcba9f76820>,125,3,[6 4],126,-1,137,-1,134
1,<environment.Job instance at 0x7fcba9dea2d0>,131,15,[6 3],132,-1,151,-1,136
1,<environment.Job instance at 0x7fcba9dea960>,132,12,[6 2],133,-1,152,-1,140
1,<environment.Job instance at 0x7fcba9dea190>,127,3,[3 8],128,-1,143,-1,140
1,<environment.Job instance at 0x7fcba9dea7d0>,134,23,[4 5],135,-1,163,-1,140
1,<environment.Job instance at 0x7fcba9deaa00>,135,13,[8 4],136,-1,154,-1,141
1,<environment.Job instance at 0x7fcba9cc9a50>,136,13,[6 5],137,-1,154,-1,141
1,<environment.Job instance at 0x7fcba9cc9410>,138,12,[5 5],139,-1,154,-1,142
1,<environment.Job instance at 0x7fcba9cc94b0>,137,13,[12  5],138,-1,155,-1,142
1,<environment.Job instance at 0x7fcbaa655fa0>,8,16,[13  3],9,-1,25,-1,9
1,<environment.Job instance at 0x7fcba988d5a0>,23,27,[3 5],24,-1,66,-1,39
1,<environment.Job instance at 0x7fcba96845a0>,24,1,[12  4],25,-1,40,-1,39
1,<environment.Job instance at 0x7fcba9dead70>,25,2,[14  1],26,-1,41,-1,39
1,<environment.Job instance at 0x7fcbaa6d9cd0>,50,1,[ 5 11],51,-1,148,-1,147
1,<environment.Job instance at 0x7fcbaa6d9e60>,52,25,[7 3],53,-1,186,-1,161
1,<environment.Job instance at 0x7fcba9cc99b0>,46,27,[10  4],47,-1,188,-1,161
1,<environment.Job instance at 0x7fcbaa6d9320>,54,13,[ 3 12],55,-1,174,-1,161
1,<environment.Job instance at 0x7fcba9db2690>,68,14,[13  2],69,-1,239,-1,225
1,<environment.Job instance at 0x7fcbaa6ea3c0>,85,26,[4 8],86,-1,313,-1,287
1,<environment.Job instance at 0x7fcbaa6ea780>,90,25,[5 4],91,-1,318,-1,293
1,<environment.Job instance at 0x7fcba98a4a50>,95,25,[5 7],96,-1,332,-1,307
1,<environment.Job instance at 0x7fcba98a4a00>,99,3,[11  3],100,-1,322,-1,319
1,<environment.Job instance at 0x7fcba98a4cd0>,103,27,[8 5],104,-1,363,-1,336
1,<environment.Job instance at 0x7fcba98a4fa0>,104,12,[ 5 13],105,-1,348,-1,336
1,<environment.Job instance at 0x7fcba9f87870>,109,1,[12  4],110,-1,349,-1,348
1,<environment.Job instance at 0x7fcba9f87730>,113,24,[3 5],114,-1,376,-1,352
1,<environment.Job instance at 0x7fcbaa73db90>,124,27,[1 8],125,-1,442,-1,415
1,<environment.Job instance at 0x7fcbaa73da50>,134,23,[4 5],135,-1,472,-1,449
1,<environment.Job instance at 0x7fcbaa661cd0>,137,13,[12  5],138,-1,462,-1,449
1,<environment.Job instance at 0x7fcbaa0c7f50>,10,17,[5 8],11,-1,28,-1,11
1,<environment.Job instance at 0x7fcbaa8e8780>,13,20,[5 3],14,-1,35,-1,15
1,<environment.Job instance at 0x7fcbaa8e8550>,15,17,[6 3],16,-1,33,-1,16
1,<environment.Job instance at 0x7fcbaa8e8190>,16,14,[10  1],17,-1,31,-1,17
1,<environment.Job instance at 0x7fcbaa0ab4b0>,20,18,[5 6],21,-1,39,-1,21
1,<environment.Job instance at 0x7fcbaa0ab500>,21,17,[2 9],22,-1,39,-1,22
1,<environment.Job instance at 0x7fcbaac7da00>,14,16,[2 7],15,-1,40,-1,24
1,<environment.Job instance at 0x7fcbaa9bfcd0>,27,22,[10  1],28,-1,50,-1,28
1,<environment.Job instance at 0x7fcbaa8e87d0>,3,14,[ 4 11],4,-1,18,-1,4
1,<environment.Job instance at 0x7fcbb34bed20>,6,26,[8 5],7,-1,34,-1,8
1,<environment.Job instance at 0x7fcba9c5e640>,8,18,[13  1],9,-1,27,-1,9
1,<environment.Job instance at 0x7fcbaa78c960>,28,16,[13  1],29,-1,82,-1,66
1,<environment.Job instance at 0x7fcbaa78c910>,31,3,[11  4],32,-1,72,-1,69
1,<environment.Job instance at 0x7fcba9f87eb0>,36,26,[9 5],37,-1,121,-1,95
1,<environment.Job instance at 0x7fcba98a4f00>,47,1,[ 4 12],48,-1,115,-1,114
1,<environment.Job instance at 0x7fcba98a4c30>,50,15,[13  3],51,-1,131,-1,116
1,<environment.Job instance at 0x7fcbaa6ea690>,52,25,[7 5],53,-1,150,-1,125
1,<environment.Job instance at 0x7fcbaa6ea0f0>,53,2,[14  5],54,-1,127,-1,125
1,<environment.Job instance at 0x7fcbaa6eafa0>,54,2,[13  4],55,-1,127,-1,125
1,<environment.Job instance at 0x7fcbaa6eaaa0>,56,12,[12  4],57,-1,137,-1,125
1,<environment.Job instance at 0x7fcba9c8ec80>,65,15,[ 4 12],66,-1,174,-1,159
1,<environment.Job instance at 0x7fcba9db20a0>,77,27,[8 5],78,-1,247,-1,220
1,<environment.Job instance at 0x7fcba9d0ccd0>,89,2,[ 2 12],90,-1,265,-1,263
1,<environment.Job instance at 0x7fcba9cc99b0>,92,24,[4 6],93,-1,303,-1,279
1,<environment.Job instance at 0x7fcba9cc9d70>,93,15,[ 2 13],94,-1,294,-1,279
1,<environment.Job instance at 0x7fcbaa635320>,97,18,[14  1],98,-1,314,-1,296
1,<environment.Job instance at 0x7fcba9ed8370>,103,13,[ 3 11],104,-1,328,-1,315
1,<environment.Job instance at 0x7fcba988de10>,106,15,[11  2],107,-1,342,-1,327
1,<environment.Job instance at 0x7fcba9d44eb0>,110,12,[ 3 12],111,-1,349,-1,337
1,<environment.Job instance at 0x7fcbaada99b0>,120,25,[10  4],121,-1,431,-1,406
1,<environment.Job instance at 0x7fcba97de7d0>,137,16,[13  1],138,-1,469,-1,453
1,<environment.Job instance at 0x7fcbaac69c30>,2,18,[8 1],3,-1,23,-1,5
1,<environment.Job instance at 0x7fcbaac694b0>,4,14,[5 8],5,-1,20,-1,6
1,<environment.Job instance at 0x7fcbaac69a00>,6,20,[10  4],7,-1,29,-1,9
1,<environment.Job instance at 0x7fcba9cb2910>,8,17,[9 2],9,-1,26,-1,9
1,<environment.Job instance at 0x7fcba9cb2500>,12,18,[5 3],13,-1,31,-1,13
1,<environment.Job instance at 0x7fcba9cb2af0>,14,18,[6 3],15,-1,34,-1,16
1,<environment.Job instance at 0x7fcbaa2fe960>,18,13,[2 7],19,-1,32,-1,19
1,<environment.Job instance at 0x7fcbaa2fe730>,19,15,[4 7],20,-1,35,-1,20
1,<environment.Job instance at 0x7fcbaa2fee10>,22,17,[5 9],23,-1,40,-1,23
1,<environment.Job instance at 0x7fcbaa2feaf0>,23,18,[5 5],24,-1,42,-1,24
1,<environment.Job instance at 0x7fcbaa2febe0>,24,15,[8 2],25,-1,46,-1,31
1,<environment.Job instance at 0x7fcba98a26e0>,33,28,[8 2],34,-1,84,-1,56
1,<environment.Job instance at 0x7fcbaa2fe5f0>,30,27,[5 4],31,-1,83,-1,56
1,<environment.Job instance at 0x7fcba98a2af0>,38,17,[5 3],39,-1,73,-1,56
1,<environment.Job instance at 0x7fcba98a2910>,42,14,[3 8],43,-1,72,-1,58
1,<environment.Job instance at 0x7fcba98a2140>,43,16,[7 2],44,-1,74,-1,58
1,<environment.Job instance at 0x7fcbaa07c640>,44,12,[9 3],45,-1,70,-1,58
1,<environment.Job instance at 0x7fcbaa07cd70>,47,18,[2 6],48,-1,80,-1,62
1,<environment.Job instance at 0x7fcba9ba8500>,48,15,[3 9],49,-1,78,-1,63
1,<environment.Job instance at 0x7fcbaa2fec30>,28,18,[ 3 10],29,-1,81,-1,63
1,<environment.Job instance at 0x7fcba9ba8d70>,49,12,[10  4],50,-1,75,-1,63
1,<environment.Job instance at 0x7fcba9cb2870>,25,17,[6 4],26,-1,80,-1,63
1,<environment.Job instance at 0x7fcba98a2dc0>,37,3,[5 6],38,-1,66,-1,63
1,<environment.Job instance at 0x7fcba98a2050>,39,13,[7 1],40,-1,78,-1,65
1,<environment.Job instance at 0x7fcba9ab9a50>,54,15,[10  1],55,-1,80,-1,65
1,<environment.Job instance at 0x7fcba9cb27d0>,10,27,[ 3 13],11,-1,92,-1,65
1,<environment.Job instance at 0x7fcba9ab9370>,55,18,[7 4],56,-1,83,-1,65
1,<environment.Job instance at 0x7fcba9ab9cd0>,58,18,[ 2 10],59,-1,83,-1,65
1,<environment.Job instance at 0x7fcba9ab9a00>,59,13,[5 8],60,-1,79,-1,66
1,<environment.Job instance at 0x7fcba9cb28c0>,13,27,[1 7],14,-1,93,-1,66
1,<environment.Job instance at 0x7fcba9ab9af0>,60,17,[ 5 13],61,-1,83,-1,66
1,<environment.Job instance at 0x7fcbaa2fe910>,31,28,[7 5],32,-1,94,-1,66
1,<environment.Job instance at 0x7fcba9ab9c80>,52,1,[7 1],53,-1,67,-1,66
1,<environment.Job instance at 0x7fcbb3492370>,63,27,[5 1],64,-1,93,-1,66
1,<environment.Job instance at 0x7fcbb34920a0>,64,15,[5 5],65,-1,81,-1,66
1,<environment.Job instance at 0x7fcbaa206d20>,65,14,[5 9],66,-1,80,-1,66
1,<environment.Job instance at 0x7fcbb3492690>,62,14,[4 6],63,-1,84,-1,70
1,<environment.Job instance at 0x7fcbaa0b3cd0>,70,13,[7 3],71,-1,85,-1,72
1,<environment.Job instance at 0x7fcbaac07910>,73,18,[6 4],74,-1,93,-1,75
1,<environment.Job instance at 0x7fcba9ab95f0>,57,13,[5 1],58,-1,90,-1,77
1,<environment.Job instance at 0x7fcbaac07c30>,76,14,[5 7],77,-1,91,-1,77
1,<environment.Job instance at 0x7fcba9822e60>,80,18,[2 9],81,-1,104,-1,86
1,<environment.Job instance at 0x7fcbaa3a4820>,83,18,[5 3],84,-1,104,-1,86
1,<environment.Job instance at 0x7fcbaac50c80>,86,13,[7 1],87,-1,100,-1,87
1,<environment.Job instance at 0x7fcbaaae7e60>,87,26,[3 7],88,-1,114,-1,88
1,<environment.Job instance at 0x7fcbaac075a0>,74,18,[9 1],75,-1,108,-1,90
1,<environment.Job instance at 0x7fcbaae51b40>,78,16,[1 7],79,-1,118,-1,102
1,<environment.Job instance at 0x7fcbaa41fe10>,96,18,[5 4],97,-1,122,-1,104
1,<environment.Job instance at 0x7fcbaa8c4cd0>,94,17,[5 1],95,-1,121,-1,104
1,<environment.Job instance at 0x7fcba9849960>,81,12,[13  5],82,-1,116,-1,104
1,<environment.Job instance at 0x7fcba9b08fa0>,99,25,[3 8],100,-1,129,-1,104
1,<environment.Job instance at 0x7fcbaa8c4780>,95,1,[8 4],96,-1,107,-1,106
1,<environment.Job instance at 0x7fcba9b08b90>,101,17,[7 4],102,-1,126,-1,109
1,<environment.Job instance at 0x7fcba9ab6640>,102,15,[3 6],103,-1,124,-1,109
1,<environment.Job instance at 0x7fcba9e4b640>,98,12,[5 5],99,-1,121,-1,109
1,<environment.Job instance at 0x7fcbaaa30280>,104,12,[1 5],105,-1,121,-1,109
1,<environment.Job instance at 0x7fcbaaa30140>,105,18,[8 2],106,-1,127,-1,109
1,<environment.Job instance at 0x7fcbaaa30e10>,107,28,[4 9],108,-1,137,-1,109
1,<environment.Job instance at 0x7fcbaaa30af0>,110,1,[3 6],111,-1,113,-1,112
1,<environment.Job instance at 0x7fcbaaa30dc0>,111,18,[13  5],112,-1,130,-1,112
1,<environment.Job instance at 0x7fcbaaa30c80>,112,13,[9 3],113,-1,128,-1,115
1,<environment.Job instance at 0x7fcba9a4d460>,115,14,[11  2],116,-1,130,-1,116
1,<environment.Job instance at 0x7fcba9a4d230>,116,15,[10  2],117,-1,132,-1,117
1,<environment.Job instance at 0x7fcbaa8bf0a0>,120,14,[10  4],121,-1,136,-1,122
1,<environment.Job instance at 0x7fcba9f0b730>,128,16,[10  1],129,-1,145,-1,129
1,<environment.Job instance at 0x7fcba9f0b9b0>,129,18,[8 2],130,-1,148,-1,130
1,<environment.Job instance at 0x7fcba9f0b4b0>,130,18,[2 8],131,-1,149,-1,131
1,<environment.Job instance at 0x7fcba9f0bf50>,133,14,[5 7],134,-1,148,-1,134
1,<environment.Job instance at 0x7fcba9f0bfa0>,135,18,[9 1],136,-1,154,-1,136
1,<environment.Job instance at 0x7fcbaaa6b410>,137,12,[9 1],138,-1,150,-1,138
1,<environment.Job instance at 0x7fcbaa2fea50>,1,2,[13  4],2,-1,4,-1,2
1,<environment.Job instance at 0x7fcbaac07460>,10,27,[ 3 13],11,-1,46,-1,19
1,<environment.Job instance at 0x7fcbaa0e0aa0>,13,27,[1 7],14,-1,51,-1,24
1,<environment.Job instance at 0x7fcba9e4b0f0>,15,18,[ 3 12],16,-1,42,-1,24
1,<environment.Job instance at 0x7fcba9a4d0f0>,20,1,[12  1],21,-1,31,-1,30
1,<environment.Job instance at 0x7fcbaad38500>,21,25,[9 1],22,-1,73,-1,48
1,<environment.Job instance at 0x7fcba97de0f0>,30,27,[5 4],31,-1,123,-1,96
1,<environment.Job instance at 0x7fcba9627be0>,31,28,[7 5],32,-1,124,-1,96
1,<environment.Job instance at 0x7fcba97de370>,33,28,[8 2],34,-1,137,-1,109
1,<environment.Job instance at 0x7fcbb3976e60>,51,1,[ 5 14],52,-1,164,-1,163
1,<environment.Job instance at 0x7fcba9d0c730>,60,17,[ 5 13],61,-1,206,-1,189
1,<environment.Job instance at 0x7fcbaa6d90a0>,63,27,[5 1],64,-1,234,-1,207
1,<environment.Job instance at 0x7fcbaa6d9be0>,66,2,[ 5 12],67,-1,212,-1,210
1,<environment.Job instance at 0x7fcba9db25a0>,75,17,[14  4],76,-1,255,-1,238
1,<environment.Job instance at 0x7fcba9c8e460>,81,12,[13  5],82,-1,278,-1,266
1,<environment.Job instance at 0x7fcba9c8e2d0>,87,26,[3 7],88,-1,325,-1,299
1,<environment.Job instance at 0x7fcbaa6ea6e0>,97,1,[ 2 11],98,-1,318,-1,317
1,<environment.Job instance at 0x7fcba98a4f00>,99,25,[3 8],100,-1,350,-1,325
1,<environment.Job instance at 0x7fcba9f87eb0>,111,18,[13  5],112,-1,388,-1,370
1,<environment.Job instance at 0x7fcba98a4f50>,107,28,[4 9],108,-1,411,-1,383
1,<environment.Job instance at 0x7fcbaa78c050>,115,14,[11  2],116,-1,397,-1,383
1,<environment.Job instance at 0x7fcbaae09cd0>,118,1,[14  2],119,-1,385,-1,384
1,<environment.Job instance at 0x7fcbaa78cd70>,119,1,[ 1 11],120,-1,385,-1,384
1,<environment.Job instance at 0x7fcbaa20afa0>,4,21,[8 1],5,-1,26,-1,5
1,<environment.Job instance at 0x7fcbaa20a2d0>,9,25,[ 3 10],10,-1,35,-1,10
1,<environment.Job instance at 0x7fcbaa20a230>,10,18,[ 2 11],11,-1,30,-1,12
1,<environment.Job instance at 0x7fcbaa20a370>,11,12,[ 1 10],12,-1,26,-1,14
1,<environment.Job instance at 0x7fcba96b9d20>,14,17,[5 4],15,-1,32,-1,15
1,<environment.Job instance at 0x7fcba96b9460>,15,15,[9 4],16,-1,32,-1,17
1,<environment.Job instance at 0x7fcba96b9f00>,17,23,[9 2],18,-1,41,-1,18
1,<environment.Job instance at 0x7fcba96b95f0>,16,15,[4 7],17,-1,34,-1,19
1,<environment.Job instance at 0x7fcba96b9780>,20,15,[4 8],21,-1,36,-1,21
1,<environment.Job instance at 0x7fcba96b9e60>,23,17,[7 4],24,-1,41,-1,24
1,<environment.Job instance at 0x7fcba96b9a50>,25,15,[9 1],26,-1,44,-1,29
1,<environment.Job instance at 0x7fcbaa348e10>,28,16,[6 5],29,-1,45,-1,29
1,<environment.Job instance at 0x7fcbaa3482d0>,32,18,[ 2 10],33,-1,51,-1,33
1,<environment.Job instance at 0x7fcbaa348960>,33,14,[4 9],34,-1,48,-1,34
1,<environment.Job instance at 0x7fcbaa348370>,37,15,[1 6],38,-1,53,-1,38
1,<environment.Job instance at 0x7fcbaa348af0>,41,18,[5 5],42,-1,61,-1,43
1,<environment.Job instance at 0x7fcbaa348dc0>,43,24,[4 7],44,-1,68,-1,44
1,<environment.Job instance at 0x7fcba9d0cb40>,44,16,[4 7],45,-1,61,-1,45
1,<environment.Job instance at 0x7fcba96280f0>,48,23,[ 4 10],49,-1,72,-1,49
1,<environment.Job instance at 0x7fcba9628050>,52,14,[4 9],53,-1,67,-1,53
1,<environment.Job instance at 0x7fcba961ba00>,57,18,[3 9],58,-1,76,-1,58
1,<environment.Job instance at 0x7fcba961b870>,62,15,[ 1 10],63,-1,78,-1,63
1,<environment.Job instance at 0x7fcba961bf50>,63,24,[3 5],64,-1,88,-1,64
1,<environment.Job instance at 0x7fcba961b0f0>,68,17,[10  4],69,-1,86,-1,69
1,<environment.Job instance at 0x7fcbaa323eb0>,71,17,[4 7],72,-1,89,-1,72
1,<environment.Job instance at 0x7fcbaa323c80>,72,15,[2 7],73,-1,88,-1,73
1,<environment.Job instance at 0x7fcbaa323b40>,73,17,[4 9],74,-1,91,-1,74
1,<environment.Job instance at 0x7fcbaa323a50>,78,16,[9 2],79,-1,95,-1,79
1,<environment.Job instance at 0x7fcbaa323f50>,79,24,[7 1],80,-1,104,-1,80
1,<environment.Job instance at 0x7fcbaa323af0>,80,26,[4 8],81,-1,107,-1,81
1,<environment.Job instance at 0x7fcbaa323fa0>,81,16,[2 7],82,-1,98,-1,82
1,<environment.Job instance at 0x7fcba9611c80>,85,18,[6 2],86,-1,104,-1,86
1,<environment.Job instance at 0x7fcba9611fa0>,87,13,[ 5 10],88,-1,101,-1,88
1,<environment.Job instance at 0x7fcba9611d20>,88,13,[ 5 10],89,-1,102,-1,89
1,<environment.Job instance at 0x7fcba9611a00>,90,18,[8 5],91,-1,109,-1,91
1,<environment.Job instance at 0x7fcba9611c30>,92,18,[4 5],93,-1,111,-1,93
1,<environment.Job instance at 0x7fcba96115f0>,93,18,[8 1],94,-1,112,-1,94
1,<environment.Job instance at 0x7fcba96efc80>,94,13,[4 6],95,-1,108,-1,95
1,<environment.Job instance at 0x7fcba9759c80>,110,18,[7 3],111,-1,155,-1,137
1,<environment.Job instance at 0x7fcba96efcd0>,99,15,[5 9],100,-1,199,-1,184
1,<environment.Job instance at 0x7fcbb36b8a00>,121,17,[ 2 10],122,-1,201,-1,184
1,<environment.Job instance at 0x7fcbaa6db8c0>,125,16,[10  3],126,-1,200,-1,184
1,<environment.Job instance at 0x7fcba9a7ffa0>,127,26,[8 5],128,-1,210,-1,184
1,<environment.Job instance at 0x7fcbaa6dbe60>,124,24,[5 9],125,-1,211,-1,187
1,<environment.Job instance at 0x7fcbaa3e5370>,109,18,[ 3 12],110,-1,221,-1,203
1,<environment.Job instance at 0x7fcba961b050>,10,18,[ 2 11],11,-1,34,-1,16
1,<environment.Job instance at 0x7fcba961b320>,9,25,[ 3 10],10,-1,42,-1,17
1,<environment.Job instance at 0x7fcba9f60f00>,17,23,[9 2],18,-1,64,-1,41
1,<environment.Job instance at 0x7fcba9db2500>,36,17,[ 1 14],37,-1,109,-1,92
1,<environment.Job instance at 0x7fcba9db2820>,39,18,[14  4],40,-1,112,-1,94
1,<environment.Job instance at 0x7fcba9db2730>,43,24,[4 7],44,-1,135,-1,111
1,<environment.Job instance at 0x7fcbaad97550>,48,23,[ 4 10],49,-1,166,-1,143
1,<environment.Job instance at 0x7fcbb3b1e5a0>,55,13,[ 3 12],56,-1,160,-1,147
1,<environment.Job instance at 0x7fcbb36a9e10>,56,13,[ 4 12],57,-1,160,-1,147
1,<environment.Job instance at 0x7fcba985d550>,63,24,[3 5],64,-1,189,-1,165
1,<environment.Job instance at 0x7fcba957ee60>,79,24,[7 1],80,-1,257,-1,233
1,<environment.Job instance at 0x7fcbaa938230>,80,26,[4 8],81,-1,259,-1,233
1,<environment.Job instance at 0x7fcbaa2d83c0>,95,15,[12  1],96,-1,322,-1,307
1,<environment.Job instance at 0x7fcbaada9820>,103,1,[ 3 13],104,-1,343,-1,342
1,<environment.Job instance at 0x7fcba9e370f0>,109,18,[ 3 12],110,-1,376,-1,358
1,<environment.Job instance at 0x7fcbb34951e0>,115,1,[ 5 13],116,-1,377,-1,376
1,<environment.Job instance at 0x7fcbaa1f2fa0>,124,24,[5 9],125,-1,435,-1,411
1,<environment.Job instance at 0x7fcba972d960>,127,26,[8 5],128,-1,454,-1,428
1,<environment.Job instance at 0x7fcbaadd3a00>,133,26,[7 5],134,-1,486,-1,460
1,<environment.Job instance at 0x7fcbaa471410>,135,2,[13  2],136,-1,462,-1,460
1,<environment.Job instance at 0x7fcba95a8a00>,2,18,[4 7],3,-1,21,-1,3
1,<environment.Job instance at 0x7fcba95a80f0>,5,17,[9 3],6,-1,27,-1,10
1,<environment.Job instance at 0x7fcba95a8460>,11,12,[10  4],12,-1,24,-1,12
1,<environment.Job instance at 0x7fcba95a8550>,12,1,[7 3],13,-1,14,-1,13
1,<environment.Job instance at 0x7fcba95a8500>,14,3,[3 9],15,-1,18,-1,15
1,<environment.Job instance at 0x7fcba95a8640>,9,15,[5 5],10,-1,31,-1,16
1,<environment.Job instance at 0x7fcba9685050>,25,17,[5 9],26,-1,44,-1,27
1,<environment.Job instance at 0x7fcbaa077960>,26,23,[10  4],27,-1,50,-1,27
1,<environment.Job instance at 0x7fcbaa077820>,28,17,[4 9],29,-1,47,-1,30
1,<environment.Job instance at 0x7fcbaa077f00>,29,18,[9 5],30,-1,48,-1,30
1,<environment.Job instance at 0x7fcbaa077a00>,31,17,[8 2],32,-1,50,-1,33
1,<environment.Job instance at 0x7fcbaa077190>,32,18,[10  5],33,-1,51,-1,33
1,<environment.Job instance at 0x7fcbaa077690>,35,16,[3 8],36,-1,53,-1,37
1,<environment.Job instance at 0x7fcba9999640>,37,18,[5 4],38,-1,56,-1,38
1,<environment.Job instance at 0x7fcba9999820>,40,12,[2 9],41,-1,53,-1,41
1,<environment.Job instance at 0x7fcba9999280>,41,17,[7 2],42,-1,59,-1,42
1,<environment.Job instance at 0x7fcba99993c0>,43,16,[3 9],44,-1,60,-1,44
1,<environment.Job instance at 0x7fcba99998c0>,44,13,[10  1],45,-1,58,-1,45
1,<environment.Job instance at 0x7fcba9999870>,49,25,[8 3],50,-1,75,-1,50
1,<environment.Job instance at 0x7fcba9999190>,51,17,[3 7],52,-1,69,-1,52
1,<environment.Job instance at 0x7fcba9999b40>,53,18,[2 6],54,-1,72,-1,54
1,<environment.Job instance at 0x7fcbaae4b280>,54,18,[8 2],55,-1,73,-1,55
1,<environment.Job instance at 0x7fcbaae4b870>,56,17,[1 6],57,-1,74,-1,57
1,<environment.Job instance at 0x7fcbaae4b780>,57,18,[5 2],58,-1,81,-1,63
1,<environment.Job instance at 0x7fcbaae4b820>,60,14,[6 3],61,-1,77,-1,63
1,<environment.Job instance at 0x7fcbaae4baa0>,62,18,[10  1],63,-1,85,-1,67
1,<environment.Job instance at 0x7fcba9999500>,3,3,[11  3],4,-1,7,-1,4
1,<environment.Job instance at 0x7fcbaae80c30>,18,16,[ 5 13],19,-1,48,-1,32
1,<environment.Job instance at 0x7fcba96f6500>,21,15,[14  4],22,-1,51,-1,36
1,<environment.Job instance at 0x7fcba976fd70>,26,23,[10  4],27,-1,68,-1,45
1,<environment.Job instance at 0x7fcbb39278c0>,49,25,[8 3],50,-1,176,-1,151
1,<environment.Job instance at 0x7fcbaa0df6e0>,52,24,[11  1],53,-1,175,-1,151
1,<environment.Job instance at 0x7fcbaa0cd2d0>,83,2,[12  1],84,-1,278,-1,276
1,<environment.Job instance at 0x7fcbaa0cdc30>,84,1,[ 5 14],85,-1,277,-1,276
1,<environment.Job instance at 0x7fcba9933af0>,88,28,[8 3],89,-1,322,-1,294
1,<environment.Job instance at 0x7fcbaa0dc410>,96,13,[ 5 11],97,-1,339,-1,326
1,<environment.Job instance at 0x7fcbaa00d2d0>,97,2,[13  1],98,-1,328,-1,326
1,<environment.Job instance at 0x7fcba96b2eb0>,104,1,[11  3],105,-1,356,-1,355
1,<environment.Job instance at 0x7fcbaa527a50>,111,13,[ 1 13],112,-1,399,-1,386
1,<environment.Job instance at 0x7fcbaa527460>,112,27,[9 1],113,-1,428,-1,401
1,<environment.Job instance at 0x7fcbaa3a5280>,116,21,[12  2],117,-1,424,-1,403
1,<environment.Job instance at 0x7fcba97ab2d0>,118,14,[ 1 14],119,-1,417,-1,403
1,<environment.Job instance at 0x7fcba97ab780>,120,15,[12  3],121,-1,419,-1,404
1,<environment.Job instance at 0x7fcbaa850a00>,126,2,[12  3],127,-1,424,-1,422
1,<environment.Job instance at 0x7fcbaade9370>,131,23,[5 9],132,-1,463,-1,440
1,<environment.Job instance at 0x7fcbaade9050>,135,15,[ 4 12],136,-1,469,-1,454
1,<environment.Job instance at 0x7fcba9a8d140>,1,26,[7 2],2,-1,28,-1,2
1,<environment.Job instance at 0x7fcbaa92f050>,3,16,[ 3 10],4,-1,22,-1,6
1,<environment.Job instance at 0x7fcba9d96b40>,4,14,[10  5],5,-1,20,-1,6
1,<environment.Job instance at 0x7fcbaa92f4b0>,8,19,[ 5 11],9,-1,29,-1,10
1,<environment.Job instance at 0x7fcbaa92f6e0>,11,17,[10  3],12,-1,31,-1,14
1,<environment.Job instance at 0x7fcbaa92fa00>,14,18,[5 3],15,-1,33,-1,15
1,<environment.Job instance at 0x7fcbaa92fe10>,19,19,[9 1],20,-1,39,-1,20
1,<environment.Job instance at 0x7fcbaa93b460>,24,23,[8 3],25,-1,48,-1,25
1,<environment.Job instance at 0x7fcbaa92f910>,13,12,[9 4],14,-1,38,-1,26
1,<environment.Job instance at 0x7fcbaa93b730>,26,17,[2 7],27,-1,49,-1,32
1,<environment.Job instance at 0x7fcbaa93baf0>,31,15,[10  1],32,-1,47,-1,32
1,<environment.Job instance at 0x7fcbaa963460>,42,17,[5 9],43,-1,61,-1,44
1,<environment.Job instance at 0x7fcbaa963960>,43,18,[6 1],44,-1,62,-1,44
1,<environment.Job instance at 0x7fcbaa963cd0>,47,17,[3 7],48,-1,65,-1,48
1,<environment.Job instance at 0x7fcbaa963e60>,48,16,[8 5],49,-1,65,-1,49
1,<environment.Job instance at 0x7fcbaa9308c0>,59,27,[5 8],60,-1,87,-1,60
1,<environment.Job instance at 0x7fcbaa930370>,55,22,[9 4],56,-1,92,-1,70
1,<environment.Job instance at 0x7fcbaa930a00>,60,13,[5 8],61,-1,83,-1,70
1,<environment.Job instance at 0x7fcbaa93beb0>,34,25,[8 2],35,-1,95,-1,70
1,<environment.Job instance at 0x7fcbaa930dc0>,65,12,[3 5],66,-1,82,-1,70
1,<environment.Job instance at 0x7fcbaa930cd0>,66,22,[3 8],67,-1,92,-1,70
1,<environment.Job instance at 0x7fcbaa930e60>,67,14,[6 2],68,-1,84,-1,70
1,<environment.Job instance at 0x7fcbaa930aa0>,62,15,[ 5 10],63,-1,88,-1,73
1,<environment.Job instance at 0x7fcbaa9545f0>,72,1,[3 9],73,-1,75,-1,74
1,<environment.Job instance at 0x7fcbaa9548c0>,75,15,[13  3],76,-1,91,-1,76
1,<environment.Job instance at 0x7fcbaa954870>,76,12,[3 8],77,-1,90,-1,78
1,<environment.Job instance at 0x7fcbaa954960>,78,17,[3 7],79,-1,96,-1,79
1,<environment.Job instance at 0x7fcbaa954d20>,80,18,[9 4],81,-1,99,-1,81
1,<environment.Job instance at 0x7fcbaa954be0>,81,12,[ 4 10],82,-1,94,-1,82
1,<environment.Job instance at 0x7fcbaa953550>,89,27,[ 3 13],90,-1,126,-1,99
1,<environment.Job instance at 0x7fcbaa954eb0>,83,14,[ 1 10],84,-1,116,-1,102
1,<environment.Job instance at 0x7fcbaa953690>,91,15,[10  3],92,-1,118,-1,103
1,<environment.Job instance at 0x7fcbaa953730>,92,18,[1 9],93,-1,121,-1,103
1,<environment.Job instance at 0x7fcbaa9537d0>,93,17,[6 3],94,-1,120,-1,103
1,<environment.Job instance at 0x7fcbaa953870>,94,17,[7 1],95,-1,120,-1,103
1,<environment.Job instance at 0x7fcbaa954f50>,84,17,[14  4],85,-1,166,-1,149
1,<environment.Job instance at 0x7fcbaa9510a0>,106,18,[8 5],107,-1,167,-1,149
1,<environment.Job instance at 0x7fcba9c70370>,102,18,[4 9],103,-1,167,-1,149
1,<environment.Job instance at 0x7fcbaa54e370>,114,13,[1 9],115,-1,179,-1,166
1,<environment.Job instance at 0x7fcbaa93de60>,110,15,[9 2],111,-1,201,-1,186
1,<environment.Job instance at 0x7fcba9e88dc0>,124,15,[9 2],125,-1,201,-1,186
1,<environment.Job instance at 0x7fcbaa5243c0>,121,17,[3 7],122,-1,203,-1,186
1,<environment.Job instance at 0x7fcba9da3910>,123,14,[4 6],124,-1,210,-1,196
1,<environment.Job instance at 0x7fcba9dc5e10>,130,26,[2 8],131,-1,222,-1,196
1,<environment.Job instance at 0x7fcbaa92fd70>,1,26,[7 2],2,-1,28,-1,2
1,<environment.Job instance at 0x7fcbaa93b320>,2,2,[ 2 13],3,-1,5,-1,3
1,<environment.Job instance at 0x7fcbaa92fc80>,6,12,[11  2],7,-1,19,-1,7
1,<environment.Job instance at 0x7fcbaa9637d0>,7,1,[14  5],8,-1,9,-1,8
1,<environment.Job instance at 0x7fcbaa963b90>,8,19,[ 5 11],9,-1,28,-1,9
1,<environment.Job instance at 0x7fcbaa954cd0>,18,1,[ 4 13],19,-1,26,-1,25
1,<environment.Job instance at 0x7fcba9db7640>,22,2,[ 3 14],23,-1,34,-1,32
1,<environment.Job instance at 0x7fcba9db7820>,24,23,[8 3],25,-1,57,-1,34
1,<environment.Job instance at 0x7fcba97ab0a0>,29,1,[11  4],30,-1,36,-1,35
1,<environment.Job instance at 0x7fcbaa3a5b90>,33,27,[9 4],34,-1,83,-1,56
1,<environment.Job instance at 0x7fcbaa3a5820>,34,25,[8 2],35,-1,81,-1,56
1,<environment.Job instance at 0x7fcbaa39f190>,40,12,[ 4 12],41,-1,71,-1,59
1,<environment.Job instance at 0x7fcba9f4a960>,59,27,[5 8],60,-1,160,-1,133
1,<environment.Job instance at 0x7fcbaaef9c80>,75,15,[13  3],76,-1,194,-1,179
1,<environment.Job instance at 0x7fcbaa89cd20>,82,1,[14  1],83,-1,199,-1,198
1,<environment.Job instance at 0x7fcba96f6870>,84,17,[14  4],85,-1,231,-1,214
1,<environment.Job instance at 0x7fcbaae80c80>,88,24,[8 2],89,-1,256,-1,232
1,<environment.Job instance at 0x7fcbaae80b40>,89,27,[ 3 13],90,-1,259,-1,232
1,<environment.Job instance at 0x7fcbaae80b90>,90,18,[ 2 12],91,-1,250,-1,232
1,<environment.Job instance at 0x7fcbaa6009b0>,96,24,[13  3],97,-1,272,-1,248
1,<environment.Job instance at 0x7fcbaa61a820>,113,26,[7 3],114,-1,335,-1,309
1,<environment.Job instance at 0x7fcbaacf3e60>,117,27,[1 8],118,-1,356,-1,329
1,<environment.Job instance at 0x7fcbaaa1dc30>,130,26,[2 8],131,-1,430,-1,404
1,<environment.Job instance at 0x7fcbaa092af0>,1,14,[9 4],2,-1,16,-1,2
1,<environment.Job instance at 0x7fcbaac070a0>,3,17,[3 7],4,-1,21,-1,4
1,<environment.Job instance at 0x7fcbaac07cd0>,4,21,[6 1],5,-1,26,-1,5
1,<environment.Job instance at 0x7fcba9d367d0>,11,16,[9 2],12,-1,29,-1,13
1,<environment.Job instance at 0x7fcba9d55e10>,15,13,[10  4],16,-1,29,-1,16
1,<environment.Job instance at 0x7fcba9d55820>,17,17,[9 1],18,-1,35,-1,18
1,<environment.Job instance at 0x7fcba9d556e0>,22,13,[ 4 10],23,-1,36,-1,23
1,<environment.Job instance at 0x7fcba9d55a50>,23,17,[7 2],24,-1,43,-1,26
1,<environment.Job instance at 0x7fcba95be6e0>,26,14,[9 1],27,-1,41,-1,27
1,<environment.Job instance at 0x7fcba95be2d0>,27,15,[2 5],28,-1,43,-1,28
1,<environment.Job instance at 0x7fcba95be690>,31,14,[ 2 10],32,-1,46,-1,32
1,<environment.Job instance at 0x7fcba95be370>,33,18,[8 3],34,-1,52,-1,34
1,<environment.Job instance at 0x7fcba95be870>,34,12,[7 5],35,-1,47,-1,35
1,<environment.Job instance at 0x7fcba95be460>,35,25,[6 2],36,-1,61,-1,36
1,<environment.Job instance at 0x7fcba9579cd0>,39,18,[ 1 10],40,-1,58,-1,40
1,<environment.Job instance at 0x7fcba9d55640>,25,24,[7 4],26,-1,68,-1,44
1,<environment.Job instance at 0x7fcba9579640>,45,18,[4 5],46,-1,65,-1,47
1,<environment.Job instance at 0x7fcba95799b0>,47,17,[8 3],48,-1,65,-1,48
1,<environment.Job instance at 0x7fcba9579fa0>,46,26,[10  2],47,-1,78,-1,52
1,<environment.Job instance at 0x7fcba9579140>,50,17,[8 5],51,-1,69,-1,52
1,<environment.Job instance at 0x7fcba9b08d20>,52,21,[9 5],53,-1,74,-1,53
1,<environment.Job instance at 0x7fcba9b083c0>,51,15,[3 7],52,-1,72,-1,57
1,<environment.Job instance at 0x7fcba9b08960>,61,18,[5 5],62,-1,80,-1,62
1,<environment.Job instance at 0x7fcba9d550f0>,20,24,[ 4 14],21,-1,91,-1,67
1,<environment.Job instance at 0x7fcba9b08dc0>,65,18,[10  4],66,-1,88,-1,70
1,<environment.Job instance at 0x7fcba9b08b40>,62,15,[ 1 10],63,-1,85,-1,70
1,<environment.Job instance at 0x7fcba9b08a50>,64,18,[9 2],65,-1,88,-1,70
1,<environment.Job instance at 0x7fcba9bb65a0>,68,28,[ 2 11],69,-1,98,-1,70
1,<environment.Job instance at 0x7fcba9bb6190>,67,15,[5 9],68,-1,86,-1,71
1,<environment.Job instance at 0x7fcba9bb6dc0>,71,17,[8 2],72,-1,89,-1,72
1,<environment.Job instance at 0x7fcba9bb6e60>,70,15,[10  5],71,-1,89,-1,74
1,<environment.Job instance at 0x7fcba9bb6780>,74,18,[8 4],75,-1,93,-1,75
1,<environment.Job instance at 0x7fcba9bb6730>,77,17,[2 7],78,-1,95,-1,78
1,<environment.Job instance at 0x7fcba9d55230>,24,14,[ 1 11],25,-1,98,-1,84
1,<environment.Job instance at 0x7fcba9b085f0>,66,17,[3 5],67,-1,101,-1,84
1,<environment.Job instance at 0x7fcba9bb6c30>,79,14,[6 4],80,-1,98,-1,84
1,<environment.Job instance at 0x7fcba9bb60a0>,76,15,[ 2 12],77,-1,99,-1,84
1,<environment.Job instance at 0x7fcba9bb66e0>,84,18,[3 9],85,-1,103,-1,85
1,<environment.Job instance at 0x7fcba9698be0>,85,15,[6 1],86,-1,102,-1,87
1,<environment.Job instance at 0x7fcba9698230>,91,17,[10  2],92,-1,110,-1,93
1,<environment.Job instance at 0x7fcba96988c0>,92,12,[3 7],93,-1,105,-1,93
1,<environment.Job instance at 0x7fcba9698c80>,83,15,[ 5 12],84,-1,109,-1,94
1,<environment.Job instance at 0x7fcba9698c30>,93,13,[4 6],94,-1,107,-1,94
1,<environment.Job instance at 0x7fcba9698730>,95,13,[ 5 10],96,-1,109,-1,96
1,<environment.Job instance at 0x7fcbaaae4cd0>,97,18,[7 5],98,-1,117,-1,99
1,<environment.Job instance at 0x7fcba96e2dc0>,99,16,[6 3],100,-1,117,-1,101
1,<environment.Job instance at 0x7fcbaae3ad70>,101,17,[5 3],102,-1,119,-1,102
1,<environment.Job instance at 0x7fcbaa1b3d20>,102,16,[6 5],103,-1,119,-1,103
1,<environment.Job instance at 0x7fcbaa34e140>,103,12,[5 7],104,-1,119,-1,107
1,<environment.Job instance at 0x7fcbaa303d20>,111,16,[3 9],112,-1,128,-1,112
1,<environment.Job instance at 0x7fcbaae3a2d0>,100,17,[11  3],101,-1,130,-1,113
1,<environment.Job instance at 0x7fcbaa6e8b90>,112,12,[7 5],113,-1,127,-1,115
1,<environment.Job instance at 0x7fcba96507d0>,115,14,[6 4],116,-1,134,-1,120
1,<environment.Job instance at 0x7fcbaa6e4e10>,119,3,[8 2],120,-1,124,-1,121
1,<environment.Job instance at 0x7fcbaa1d1910>,120,16,[8 2],121,-1,139,-1,123
1,<environment.Job instance at 0x7fcbaa7dce10>,121,28,[5 9],122,-1,151,-1,123
1,<environment.Job instance at 0x7fcbaa08c140>,122,14,[7 1],123,-1,138,-1,124
1,<environment.Job instance at 0x7fcbaa9e2f00>,123,28,[6 1],124,-1,152,-1,124
1,<environment.Job instance at 0x7fcbaaa20870>,126,18,[9 2],127,-1,147,-1,129
1,<environment.Job instance at 0x7fcbaaa20e60>,128,23,[ 3 10],129,-1,152,-1,129
1,<environment.Job instance at 0x7fcba9e69be0>,117,24,[8 1],118,-1,158,-1,134
1,<environment.Job instance at 0x7fcba99e9370>,127,16,[10  4],128,-1,150,-1,134
1,<environment.Job instance at 0x7fcba9a88e10>,132,14,[4 6],133,-1,148,-1,134
1,<environment.Job instance at 0x7fcbaa2bbaf0>,133,18,[ 5 11],134,-1,152,-1,134
1,<environment.Job instance at 0x7fcba9a290f0>,138,1,[9 4],139,-1,140,-1,139
1,<environment.Job instance at 0x7fcbaaa207d0>,129,17,[4 5],130,-1,156,-1,139
1,<environment.Job instance at 0x7fcba9579410>,5,17,[ 1 11],6,-1,23,-1,6
1,<environment.Job instance at 0x7fcba9579870>,7,13,[12  4],8,-1,21,-1,8
1,<environment.Job instance at 0x7fcbaa61a1e0>,20,24,[ 4 14],21,-1,78,-1,54
1,<environment.Job instance at 0x7fcbaa5fe780>,24,14,[ 1 11],25,-1,76,-1,62
1,<environment.Job instance at 0x7fcbaa600460>,25,24,[7 4],26,-1,88,-1,64
1,<environment.Job instance at 0x7fcbb36432d0>,35,25,[6 2],36,-1,135,-1,110
1,<environment.Job instance at 0x7fcbaa52aeb0>,36,2,[ 1 13],37,-1,112,-1,110
1,<environment.Job instance at 0x7fcbb3b81190>,46,26,[10  2],47,-1,170,-1,144
1,<environment.Job instance at 0x7fcbaa3a56e0>,54,1,[12  5],55,-1,176,-1,175
1,<environment.Job instance at 0x7fcbaa963870>,55,1,[ 2 14],56,-1,176,-1,175
1,<environment.Job instance at 0x7fcbaa3a5550>,57,2,[14  3],58,-1,177,-1,175
1,<environment.Job instance at 0x7fcbb346c4b0>,68,28,[ 2 11],69,-1,239,-1,211
1,<environment.Job instance at 0x7fcba9788280>,76,15,[ 2 12],77,-1,269,-1,254
1,<environment.Job instance at 0x7fcba9cd0960>,80,12,[ 1 11],81,-1,277,-1,265
1,<environment.Job instance at 0x7fcbaa597c30>,83,15,[ 5 12],84,-1,294,-1,279
1,<environment.Job instance at 0x7fcbb3966f50>,100,17,[11  3],101,-1,374,-1,357
1,<environment.Job instance at 0x7fcbaa4223c0>,117,24,[8 1],118,-1,459,-1,435
1,<environment.Job instance at 0x7fcbaa5122d0>,121,28,[5 9],122,-1,471,-1,443
1,<environment.Job instance at 0x7fcba9e5abe0>,123,28,[6 1],124,-1,474,-1,446
1,<environment.Job instance at 0x7fcbaac5a960>,128,23,[ 3 10],129,-1,487,-1,464
1,<environment.Job instance at 0x7fcbaa87ee10>,133,18,[ 5 11],134,-1,503,-1,485
1,<environment.Job instance at 0x7fcba9bd40a0>,2,18,[6 5],3,-1,21,-1,3
1,<environment.Job instance at 0x7fcba96c45f0>,6,22,[3 7],7,-1,30,-1,8
1,<environment.Job instance at 0x7fcba9d9cc30>,9,14,[3 7],10,-1,24,-1,10
1,<environment.Job instance at 0x7fcba9d9cfa0>,10,17,[9 5],11,-1,28,-1,11
1,<environment.Job instance at 0x7fcba9ee24b0>,11,14,[9 4],12,-1,26,-1,12
1,<environment.Job instance at 0x7fcba976fa50>,13,12,[2 8],14,-1,26,-1,14
1,<environment.Job instance at 0x7fcba976f960>,14,18,[6 5],15,-1,33,-1,15
1,<environment.Job instance at 0x7fcba96c4910>,7,21,[5 3],8,-1,37,-1,16
1,<environment.Job instance at 0x7fcbaa696f00>,18,18,[1 8],19,-1,38,-1,20
1,<environment.Job instance at 0x7fcbaa696eb0>,19,21,[10  5],20,-1,41,-1,20
1,<environment.Job instance at 0x7fcbaa9f5870>,25,16,[ 4 14],26,-1,46,-1,30
1,<environment.Job instance at 0x7fcbaa9f51e0>,31,16,[6 2],32,-1,48,-1,32
1,<environment.Job instance at 0x7fcbaa9f5e60>,32,20,[1 9],33,-1,53,-1,33
1,<environment.Job instance at 0x7fcbaa9f5b90>,33,18,[3 7],34,-1,52,-1,34
1,<environment.Job instance at 0x7fcbaa2f0b90>,37,26,[ 2 12],38,-1,68,-1,42
1,<environment.Job instance at 0x7fcbaa2f0370>,38,17,[2 5],39,-1,62,-1,45
1,<environment.Job instance at 0x7fcbaad60aa0>,44,18,[2 9],45,-1,64,-1,46
1,<environment.Job instance at 0x7fcbaad60be0>,45,26,[5 5],46,-1,72,-1,46
1,<environment.Job instance at 0x7fcbaa352910>,47,15,[8 4],48,-1,63,-1,48
1,<environment.Job instance at 0x7fcba9b2aa00>,48,22,[10  5],49,-1,71,-1,49
1,<environment.Job instance at 0x7fcba9ab7370>,50,17,[2 7],51,-1,68,-1,51
1,<environment.Job instance at 0x7fcbb3a58870>,54,25,[9 4],55,-1,80,-1,55
1,<environment.Job instance at 0x7fcba952b1e0>,60,25,[9 5],61,-1,88,-1,63
1,<environment.Job instance at 0x7fcba952b3c0>,63,3,[9 5],64,-1,67,-1,64
1,<environment.Job instance at 0x7fcbaa9f5dc0>,28,17,[7 4],29,-1,81,-1,64
1,<environment.Job instance at 0x7fcba9ab7050>,49,15,[2 8],50,-1,80,-1,65
1,<environment.Job instance at 0x7fcbb38e52d0>,64,17,[6 3],65,-1,82,-1,65
1,<environment.Job instance at 0x7fcbb38e54b0>,65,22,[6 4],66,-1,89,-1,67
1,<environment.Job instance at 0x7fcbaa2d3a00>,67,15,[5 4],68,-1,83,-1,68
1,<environment.Job instance at 0x7fcba9cd0050>,70,26,[10  1],71,-1,97,-1,71
1,<environment.Job instance at 0x7fcba97dc410>,36,18,[3 6],37,-1,91,-1,73
1,<environment.Job instance at 0x7fcbaa502410>,72,22,[2 7],73,-1,95,-1,73
1,<environment.Job instance at 0x7fcbb38e5050>,66,15,[7 3],67,-1,89,-1,74
1,<environment.Job instance at 0x7fcbaa9f6aa0>,74,12,[1 9],75,-1,87,-1,75
1,<environment.Job instance at 0x7fcbaa502fa0>,71,16,[ 2 10],72,-1,94,-1,78
1,<environment.Job instance at 0x7fcbaac33dc0>,76,18,[8 3],77,-1,96,-1,78
1,<environment.Job instance at 0x7fcbaac54b90>,75,16,[10  3],76,-1,96,-1,80
1,<environment.Job instance at 0x7fcba9587e10>,80,15,[9 4],81,-1,97,-1,82
1,<environment.Job instance at 0x7fcbaa0df2d0>,82,17,[9 5],83,-1,105,-1,88
1,<environment.Job instance at 0x7fcbaaef99b0>,79,17,[1 9],80,-1,106,-1,89
1,<environment.Job instance at 0x7fcbb36ca0a0>,86,16,[6 4],87,-1,105,-1,89
1,<environment.Job instance at 0x7fcbb36ca6e0>,87,25,[6 4],88,-1,114,-1,89
1,<environment.Job instance at 0x7fcbaabf80a0>,93,18,[10  5],94,-1,112,-1,94
1,<environment.Job instance at 0x7fcbaaccd6e0>,98,16,[8 2],99,-1,117,-1,101
1,<environment.Job instance at 0x7fcbaac64550>,85,27,[5 8],86,-1,132,-1,105
1,<environment.Job instance at 0x7fcbaaccdb40>,101,21,[4 7],102,-1,127,-1,106
1,<environment.Job instance at 0x7fcba9d36dc0>,3,1,[13  4],4,-1,5,-1,4
1,<environment.Job instance at 0x7fcbaab4b550>,4,17,[12  2],5,-1,22,-1,5
1,<environment.Job instance at 0x7fcbaaccd960>,16,28,[7 3],17,-1,65,-1,37
1,<environment.Job instance at 0x7fcba96e73c0>,25,16,[ 4 14],26,-1,71,-1,55
1,<environment.Job instance at 0x7fcba9aea410>,37,26,[ 2 12],38,-1,128,-1,102
1,<environment.Job instance at 0x7fcbaa370e10>,39,1,[ 3 12],40,-1,103,-1,102
1,<environment.Job instance at 0x7fcbaa5ab5a0>,42,3,[11  1],43,-1,109,-1,106
1,<environment.Job instance at 0x7fcbaa8fd140>,45,26,[5 5],46,-1,150,-1,124
1,<environment.Job instance at 0x7fcba9c88a00>,54,25,[9 4],55,-1,180,-1,155
1,<environment.Job instance at 0x7fcbaa387460>,60,25,[9 5],61,-1,189,-1,164
1,<environment.Job instance at 0x7fcba9cd08c0>,61,3,[11  1],62,-1,167,-1,164
1,<environment.Job instance at 0x7fcba9cd0230>,62,3,[12  5],63,-1,167,-1,164
1,<environment.Job instance at 0x7fcbb346c4b0>,70,26,[10  1],71,-1,251,-1,225
1,<environment.Job instance at 0x7fcbb3b1e5a0>,85,27,[5 8],86,-1,304,-1,277
1,<environment.Job instance at 0x7fcbaad97050>,87,25,[6 4],88,-1,314,-1,289
1,<environment.Job instance at 0x7fcbaa0df6e0>,89,25,[10  1],90,-1,318,-1,293
1,<environment.Job instance at 0x7fcbaad98b90>,90,14,[ 1 14],91,-1,307,-1,293
1,<environment.Job instance at 0x7fcbaacf3d20>,111,26,[5 4],112,-1,389,-1,363
1,<environment.Job instance at 0x7fcba9579d70>,118,26,[ 3 10],119,-1,411,-1,385
1,<environment.Job instance at 0x7fcbaa5f30a0>,137,3,[ 5 11],138,-1,462,-1,459
1,<environment.Job instance at 0x7fcbaa816e60>,4,16,[10  2],5,-1,23,-1,7
1,<environment.Job instance at 0x7fcbaa816b90>,6,16,[5 6],7,-1,23,-1,7
1,<environment.Job instance at 0x7fcbaa79a730>,13,12,[9 5],14,-1,27,-1,15
1,<environment.Job instance at 0x7fcbaa772a50>,15,14,[5 8],16,-1,30,-1,16
1,<environment.Job instance at 0x7fcbaa772eb0>,16,14,[5 5],17,-1,31,-1,17
1,<environment.Job instance at 0x7fcbaa772b90>,17,17,[3 7],18,-1,35,-1,18
1,<environment.Job instance at 0x7fcbaa772820>,18,16,[7 5],19,-1,35,-1,19
1,<environment.Job instance at 0x7fcbaa772050>,19,20,[5 5],20,-1,40,-1,20
1,<environment.Job instance at 0x7fcbaa765280>,25,15,[1 9],26,-1,41,-1,26
1,<environment.Job instance at 0x7fcbaa765af0>,26,18,[1 8],27,-1,45,-1,27
1,<environment.Job instance at 0x7fcba990beb0>,31,14,[10  5],32,-1,46,-1,32
1,<environment.Job instance at 0x7fcba991dfa0>,35,15,[7 2],36,-1,51,-1,36
1,<environment.Job instance at 0x7fcbaa3fda00>,37,28,[8 2],38,-1,66,-1,38
1,<environment.Job instance at 0x7fcbaa3fd960>,38,15,[8 5],39,-1,54,-1,39
1,<environment.Job instance at 0x7fcbaa3ddaa0>,50,22,[9 5],51,-1,75,-1,53
1,<environment.Job instance at 0x7fcbaa3d9410>,58,18,[8 4],59,-1,82,-1,64
1,<environment.Job instance at 0x7fcbaa3d9e10>,59,18,[2 5],60,-1,84,-1,66
1,<environment.Job instance at 0x7fcbaa3d99b0>,63,25,[ 4 10],64,-1,93,-1,68
1,<environment.Job instance at 0x7fcbaa3fd910>,36,13,[13  5],37,-1,101,-1,88
1,<environment.Job instance at 0x7fcbaa4110f0>,72,17,[4 5],73,-1,107,-1,90
1,<environment.Job instance at 0x7fcbaa411190>,73,19,[8 5],74,-1,109,-1,90
1,<environment.Job instance at 0x7fcbaa3d96e0>,65,17,[11  2],66,-1,112,-1,95
1,<environment.Job instance at 0x7fcbaa411550>,79,22,[3 7],80,-1,117,-1,95
1,<environment.Job instance at 0x7fcbaa3d9640>,69,21,[14  3],70,-1,120,-1,99
1,<environment.Job instance at 0x7fcbaa411eb0>,86,20,[5 3],87,-1,132,-1,112
1,<environment.Job instance at 0x7fcbaa4134b0>,90,21,[5 4],91,-1,137,-1,116
1,<environment.Job instance at 0x7fcbaa413230>,88,12,[9 1],89,-1,128,-1,116
1,<environment.Job instance at 0x7fcbaa4136e0>,92,18,[9 2],93,-1,135,-1,117
1,<environment.Job instance at 0x7fcbaa4130f0>,91,13,[6 3],92,-1,130,-1,117
1,<environment.Job instance at 0x7fcbaa413410>,96,16,[5 8],97,-1,133,-1,117
1,<environment.Job instance at 0x7fcbaa413e10>,100,17,[10  5],101,-1,145,-1,128
1,<environment.Job instance at 0x7fcbaa413c30>,103,14,[8 3],104,-1,144,-1,130
1,<environment.Job instance at 0x7fcbaa3dd870>,52,27,[8 4],53,-1,173,-1,146
1,<environment.Job instance at 0x7fcbaa3e7050>,105,17,[9 4],106,-1,216,-1,199
1,<environment.Job instance at 0x7fcbaa3e7d20>,120,15,[5 9],121,-1,214,-1,199
1,<environment.Job instance at 0x7fcbaa3e7dc0>,121,18,[8 4],122,-1,217,-1,199
1,<environment.Job instance at 0x7fcbaa3e7f50>,123,18,[4 6],124,-1,217,-1,199
1,<environment.Job instance at 0x7fcbaa79a500>,1,18,[ 3 14],2,-1,20,-1,2
1,<environment.Job instance at 0x7fcba9514780>,8,13,[14  3],9,-1,22,-1,9
1,<environment.Job instance at 0x7fcbaa3df870>,27,2,[13  4],28,-1,81,-1,79
1,<environment.Job instance at 0x7fcba9942a50>,36,13,[13  5],37,-1,117,-1,104
1,<environment.Job instance at 0x7fcbaab6e460>,40,17,[14  5],41,-1,134,-1,117
1,<environment.Job instance at 0x7fcbaab6ee10>,41,14,[13  2],42,-1,131,-1,117
1,<environment.Job instance at 0x7fcba9942c80>,37,28,[8 2],38,-1,147,-1,119
1,<environment.Job instance at 0x7fcbaa711370>,52,27,[8 4],53,-1,180,-1,153
1,<environment.Job instance at 0x7fcbaa9e2a00>,62,1,[ 1 13],63,-1,171,-1,170
1,<environment.Job instance at 0x7fcbaa5fe730>,65,17,[11  2],66,-1,193,-1,176
1,<environment.Job instance at 0x7fcbaa6007d0>,69,21,[14  3],70,-1,207,-1,186
1,<environment.Job instance at 0x7fcbaacf3780>,63,25,[ 4 10],64,-1,216,-1,191
1,<environment.Job instance at 0x7fcbaa0b38c0>,87,1,[ 2 11],88,-1,224,-1,223
1,<environment.Job instance at 0x7fcbaa0d9370>,94,17,[11  1],95,-1,265,-1,248
1,<environment.Job instance at 0x7fcbaa387690>,107,3,[ 5 11],108,-1,309,-1,306
1,<environment.Job instance at 0x7fcbaa422d20>,124,12,[13  3],125,-1,412,-1,400
1,<environment.Job instance at 0x7fcbaacff140>,135,28,[5 5],136,-1,467,-1,439
1,<environment.Job instance at 0x7fcbaac54690>,3,16,[10  5],4,-1,23,-1,7
1,<environment.Job instance at 0x7fcbaac54b40>,6,17,[7 1],7,-1,24,-1,7
1,<environment.Job instance at 0x7fcbaad945f0>,10,21,[6 2],11,-1,35,-1,14
1,<environment.Job instance at 0x7fcbaad94820>,13,13,[10  4],14,-1,27,-1,14
1,<environment.Job instance at 0x7fcbaad94d20>,17,12,[8 1],18,-1,30,-1,18
1,<environment.Job instance at 0x7fcbaad94eb0>,18,22,[4 8],19,-1,41,-1,19
1,<environment.Job instance at 0x7fcba96e2b40>,20,28,[4 7],21,-1,49,-1,21
1,<environment.Job instance at 0x7fcbaa072910>,24,14,[ 1 10],25,-1,39,-1,25
1,<environment.Job instance at 0x7fcba99954b0>,25,14,[4 5],26,-1,40,-1,26
1,<environment.Job instance at 0x7fcbaa558910>,31,15,[4 5],32,-1,47,-1,32
1,<environment.Job instance at 0x7fcbaa558d20>,32,16,[10  5],33,-1,49,-1,33
1,<environment.Job instance at 0x7fcba9f4e370>,34,13,[6 3],35,-1,48,-1,35
1,<environment.Job instance at 0x7fcba9803cd0>,35,15,[10  3],36,-1,51,-1,36
1,<environment.Job instance at 0x7fcbaae31a00>,36,12,[3 9],37,-1,49,-1,37
1,<environment.Job instance at 0x7fcba9b12190>,38,18,[2 9],39,-1,57,-1,39
1,<environment.Job instance at 0x7fcbaad1bd70>,39,17,[6 4],40,-1,57,-1,40
1,<environment.Job instance at 0x7fcbaac529b0>,41,16,[ 4 10],42,-1,58,-1,42
1,<environment.Job instance at 0x7fcba9f3c690>,46,16,[7 1],47,-1,63,-1,47
1,<environment.Job instance at 0x7fcba9f3c730>,47,13,[5 5],48,-1,61,-1,48
1,<environment.Job instance at 0x7fcba9f358c0>,48,17,[ 1 10],49,-1,66,-1,49
1,<environment.Job instance at 0x7fcba95c6500>,49,15,[7 2],50,-1,65,-1,50
1,<environment.Job instance at 0x7fcba97e4aa0>,55,16,[5 2],56,-1,72,-1,56
1,<environment.Job instance at 0x7fcba97d9640>,60,14,[3 8],61,-1,75,-1,61
1,<environment.Job instance at 0x7fcba97d9eb0>,61,16,[6 5],62,-1,78,-1,62
1,<environment.Job instance at 0x7fcbaa5374b0>,64,17,[4 9],65,-1,82,-1,65
1,<environment.Job instance at 0x7fcba96a6e60>,65,17,[ 5 10],66,-1,83,-1,66
1,<environment.Job instance at 0x7fcba96a63c0>,69,18,[9 4],70,-1,88,-1,70
1,<environment.Job instance at 0x7fcba97ff870>,79,16,[4 9],80,-1,103,-1,87
1,<environment.Job instance at 0x7fcbaae0eaf0>,0,12,[ 4 14],1,-1,13,-1,1
1,<environment.Job instance at 0x7fcbaae19140>,8,1,[ 1 11],9,-1,18,-1,17
1,<environment.Job instance at 0x7fcbaa3ed230>,19,16,[ 4 11],20,-1,47,-1,31
1,<environment.Job instance at 0x7fcbaa3ed050>,20,28,[4 7],21,-1,59,-1,31
1,<environment.Job instance at 0x7fcbaa3edd20>,21,15,[ 5 14],22,-1,46,-1,31
1,<environment.Job instance at 0x7fcbaa3e7af0>,23,14,[ 3 11],24,-1,45,-1,31
1,<environment.Job instance at 0x7fcbaa8fdaf0>,37,17,[ 4 14],38,-1,91,-1,74
1,<environment.Job instance at 0x7fcbaa820a50>,71,16,[14  3],72,-1,216,-1,200
1,<environment.Job instance at 0x7fcbaa820e10>,72,3,[ 1 14],73,-1,203,-1,200
1,<environment.Job instance at 0x7fcbaa072410>,86,3,[ 5 11],87,-1,248,-1,245
1,<environment.Job instance at 0x7fcbaac64f50>,94,24,[8 1],95,-1,320,-1,296
1,<environment.Job instance at 0x7fcbaac64d70>,96,25,[6 2],97,-1,321,-1,296
1,<environment.Job instance at 0x7fcba9d1eaa0>,112,24,[8 2],113,-1,388,-1,364
1,<environment.Job instance at 0x7fcba98dc5a0>,117,12,[13  5],118,-1,378,-1,366
1,<environment.Job instance at 0x7fcba9905280>,122,2,[ 1 12],123,-1,383,-1,381
1,<environment.Job instance at 0x7fcba98dad20>,129,25,[1 7],130,-1,445,-1,420
1,<environment.Job instance at 0x7fcba9a7f140>,138,14,[ 5 11],139,-1,463,-1,449
1,<environment.Job instance at 0x7fcba9c30370>,2,18,[ 1 10],3,-1,22,-1,4
1,<environment.Job instance at 0x7fcba9c30500>,4,12,[9 4],5,-1,17,-1,5
1,<environment.Job instance at 0x7fcba9c301e0>,5,18,[6 1],6,-1,24,-1,6
1,<environment.Job instance at 0x7fcba9c30550>,6,15,[4 7],7,-1,22,-1,7
1,<environment.Job instance at 0x7fcba9c30820>,8,17,[9 3],9,-1,26,-1,9
1,<environment.Job instance at 0x7fcba9c30fa0>,10,14,[10  1],11,-1,25,-1,11
1,<environment.Job instance at 0x7fcba9c304b0>,12,18,[10  1],13,-1,31,-1,13
1,<environment.Job instance at 0x7fcba9c30a50>,13,15,[7 2],14,-1,29,-1,14
1,<environment.Job instance at 0x7fcba9c308c0>,14,27,[1 7],15,-1,42,-1,15
1,<environment.Job instance at 0x7fcba9c305a0>,16,13,[4 6],17,-1,30,-1,17
1,<environment.Job instance at 0x7fcbaaa18c80>,17,18,[6 1],18,-1,36,-1,18
1,<environment.Job instance at 0x7fcbaaa18aa0>,18,17,[3 6],19,-1,36,-1,19
1,<environment.Job instance at 0x7fcbaaa18230>,21,12,[ 5 10],22,-1,34,-1,22
1,<environment.Job instance at 0x7fcbaaa188c0>,22,15,[4 7],23,-1,38,-1,23
1,<environment.Job instance at 0x7fcbaaa18cd0>,23,14,[9 2],24,-1,38,-1,24
1,<environment.Job instance at 0x7fcbaaa18140>,26,16,[1 9],27,-1,43,-1,27
1,<environment.Job instance at 0x7fcba9a4d550>,30,13,[4 7],31,-1,44,-1,31
1,<environment.Job instance at 0x7fcba9a4d410>,31,18,[4 6],32,-1,50,-1,32
1,<environment.Job instance at 0x7fcba9a4de10>,34,14,[1 7],35,-1,49,-1,35
1,<environment.Job instance at 0x7fcba9a4dcd0>,35,13,[10  4],36,-1,49,-1,36
1,<environment.Job instance at 0x7fcbaac64fa0>,36,19,[5 4],37,-1,56,-1,37
1,<environment.Job instance at 0x7fcba9a3fcd0>,37,17,[1 8],38,-1,55,-1,38
1,<environment.Job instance at 0x7fcbaa14b5f0>,38,18,[4 6],39,-1,57,-1,39
1,<environment.Job instance at 0x7fcbaa182b40>,39,13,[8 2],40,-1,53,-1,40
1,<environment.Job instance at 0x7fcbaa1540a0>,42,14,[5 6],43,-1,57,-1,43
1,<environment.Job instance at 0x7fcbaac53230>,43,18,[10  1],44,-1,62,-1,44
1,<environment.Job instance at 0x7fcbaa1d1be0>,44,15,[9 3],45,-1,60,-1,45
1,<environment.Job instance at 0x7fcbaa206a50>,46,17,[ 2 10],47,-1,64,-1,47
1,<environment.Job instance at 0x7fcbaa206820>,51,16,[9 3],52,-1,68,-1,52
1,<environment.Job instance at 0x7fcba9e374b0>,70,22,[9 3],71,-1,146,-1,124
1,<environment.Job instance at 0x7fcba9a4d8c0>,14,27,[1 7],15,-1,62,-1,35
1,<environment.Job instance at 0x7fcbaa90e780>,45,16,[ 5 13],46,-1,178,-1,162
1,<environment.Job instance at 0x7fcbaa323a50>,49,16,[ 1 13],50,-1,197,-1,181
1,<environment.Job instance at 0x7fcbaac840f0>,52,15,[ 2 12],53,-1,201,-1,186
1,<environment.Job instance at 0x7fcbaac840a0>,56,17,[11  2],57,-1,211,-1,194
1,<environment.Job instance at 0x7fcbb392b550>,59,23,[9 3],60,-1,232,-1,209
1,<environment.Job instance at 0x7fcbaa0b3dc0>,68,12,[ 1 13],69,-1,253,-1,241
1,<environment.Job instance at 0x7fcba99951e0>,71,28,[1 5],72,-1,278,-1,250
1,<environment.Job instance at 0x7fcbaa5fb550>,72,12,[ 4 14],73,-1,262,-1,250
1,<environment.Job instance at 0x7fcbaa50a5a0>,76,14,[11  1],77,-1,275,-1,261
1,<environment.Job instance at 0x7fcba9e614b0>,84,2,[14  4],85,-1,305,-1,303
1,<environment.Job instance at 0x7fcba9e61730>,85,3,[14  3],86,-1,306,-1,303
1,<environment.Job instance at 0x7fcba9e67960>,86,18,[12  4],87,-1,321,-1,303
1,<environment.Job instance at 0x7fcbb398aaa0>,87,3,[ 4 13],88,-1,306,-1,303
1,<environment.Job instance at 0x7fcbaa155190>,91,27,[6 5],92,-1,349,-1,322
1,<environment.Job instance at 0x7fcbaae5adc0>,93,3,[ 1 13],94,-1,325,-1,322
1,<environment.Job instance at 0x7fcba9f72be0>,96,16,[ 1 12],97,-1,338,-1,322
1,<environment.Job instance at 0x7fcba9f72410>,98,25,[10  1],99,-1,364,-1,339
1,<environment.Job instance at 0x7fcbb3987280>,99,23,[4 9],100,-1,362,-1,339
1,<environment.Job instance at 0x7fcbaa0f47d0>,107,25,[1 9],108,-1,387,-1,362
1,<environment.Job instance at 0x7fcbaa3c2320>,109,27,[9 3],110,-1,389,-1,362
1,<environment.Job instance at 0x7fcbaa0a85a0>,111,28,[6 2],112,-1,390,-1,362
1,<environment.Job instance at 0x7fcba9803780>,133,1,[ 4 14],134,-1,418,-1,417
1,<environment.Job instance at 0x7fcba951b140>,6,15,[9 4],7,-1,23,-1,8
1,<environment.Job instance at 0x7fcba9dd9e10>,7,18,[5 9],8,-1,26,-1,8
1,<environment.Job instance at 0x7fcba9a0eb40>,8,25,[3 6],9,-1,34,-1,9
1,<environment.Job instance at 0x7fcbaa293aa0>,10,17,[8 5],11,-1,28,-1,11
1,<environment.Job instance at 0x7fcbaacc4d20>,12,13,[3 8],13,-1,27,-1,14
1,<environment.Job instance at 0x7fcbaacc4f50>,15,14,[7 2],16,-1,30,-1,16
1,<environment.Job instance at 0x7fcbaacc4c80>,17,16,[2 5],18,-1,34,-1,18
1,<environment.Job instance at 0x7fcba9ab3140>,18,15,[5 5],19,-1,34,-1,19
1,<environment.Job instance at 0x7fcbaac82b90>,21,13,[ 4 11],22,-1,35,-1,22
1,<environment.Job instance at 0x7fcba9a0e2d0>,13,12,[5 7],14,-1,34,-1,22
1,<environment.Job instance at 0x7fcba994ca50>,22,20,[3 6],23,-1,43,-1,23
1,<environment.Job instance at 0x7fcba972ceb0>,23,17,[10  4],24,-1,44,-1,27
1,<environment.Job instance at 0x7fcba9514320>,26,21,[10  4],27,-1,48,-1,27
1,<environment.Job instance at 0x7fcba9a56af0>,27,15,[3 8],28,-1,45,-1,30
1,<environment.Job instance at 0x7fcbaa06c7d0>,30,16,[10  1],31,-1,53,-1,37
1,<environment.Job instance at 0x7fcba99d8d70>,29,15,[14  4],30,-1,52,-1,37
1,<environment.Job instance at 0x7fcbaae1d780>,38,17,[7 2],39,-1,57,-1,40
1,<environment.Job instance at 0x7fcbaae1d8c0>,41,15,[5 5],42,-1,57,-1,42
1,<environment.Job instance at 0x7fcbaada7be0>,44,17,[7 2],45,-1,62,-1,45
1,<environment.Job instance at 0x7fcbaa77d5f0>,47,14,[3 8],48,-1,62,-1,48
1,<environment.Job instance at 0x7fcbaae1dc30>,39,15,[8 4],40,-1,65,-1,50
1,<environment.Job instance at 0x7fcba9a62a50>,51,12,[ 5 10],52,-1,65,-1,53
1,<environment.Job instance at 0x7fcbaad8ad70>,52,15,[9 5],53,-1,68,-1,53
1,<environment.Job instance at 0x7fcbaa40a8c0>,57,17,[3 5],58,-1,77,-1,60
1,<environment.Job instance at 0x7fcba9f17c80>,61,20,[5 5],62,-1,82,-1,62
1,<environment.Job instance at 0x7fcbaa2d3410>,63,22,[2 8],64,-1,86,-1,64
1,<environment.Job instance at 0x7fcbaa75b4b0>,67,18,[3 6],68,-1,86,-1,68
1,<environment.Job instance at 0x7fcbaa75b6e0>,72,20,[ 1 10],73,-1,93,-1,73
1,<environment.Job instance at 0x7fcbaa75b410>,73,17,[6 1],74,-1,91,-1,74
1,<environment.Job instance at 0x7fcba9b7c280>,76,16,[ 2 10],77,-1,95,-1,79
1,<environment.Job instance at 0x7fcba9b7c460>,80,12,[9 1],81,-1,93,-1,81
1,<environment.Job instance at 0x7fcba9b7c0f0>,82,21,[9 2],83,-1,104,-1,83
1,<environment.Job instance at 0x7fcba9662730>,84,18,[2 6],85,-1,103,-1,85
1,<environment.Job instance at 0x7fcba9662230>,86,17,[3 9],87,-1,109,-1,92
1,<environment.Job instance at 0x7fcba9b7caa0>,78,17,[ 3 13],79,-1,160,-1,143
1,<environment.Job instance at 0x7fcbaad30690>,112,18,[ 5 10],113,-1,161,-1,143
1,<environment.Job instance at 0x7fcba9662370>,92,25,[3 6],93,-1,168,-1,143
1,<environment.Job instance at 0x7fcbaad30910>,113,17,[13  3],114,-1,160,-1,143
1,<environment.Job instance at 0x7fcba962e730>,117,13,[12  4],118,-1,156,-1,143
1,<environment.Job instance at 0x7fcba962e870>,122,15,[9 1],123,-1,164,-1,149
1,<environment.Job instance at 0x7fcba962ecd0>,124,13,[9 1],125,-1,162,-1,149
1,<environment.Job instance at 0x7fcba962e6e0>,125,21,[3 8],126,-1,170,-1,149
1,<environment.Job instance at 0x7fcba962e230>,121,16,[ 5 10],122,-1,166,-1,150
1,<environment.Job instance at 0x7fcbaae1be10>,127,18,[ 3 12],128,-1,168,-1,150
1,<environment.Job instance at 0x7fcbaae1bf50>,131,18,[5 2],132,-1,168,-1,150
1,<environment.Job instance at 0x7fcbaae1b1e0>,132,21,[1 8],133,-1,171,-1,150
1,<environment.Job instance at 0x7fcbaae1b4b0>,133,13,[3 6],134,-1,163,-1,150
1,<environment.Job instance at 0x7fcbaae1ba50>,134,17,[10  1],135,-1,167,-1,150
1,<environment.Job instance at 0x7fcbaae1baa0>,135,12,[5 4],136,-1,162,-1,150
1,<environment.Job instance at 0x7fcbaae1b280>,136,17,[10  2],137,-1,167,-1,150
1,<environment.Job instance at 0x7fcba9662e10>,91,19,[6 5],92,-1,169,-1,150
1,<environment.Job instance at 0x7fcbaae1b230>,137,22,[7 5],138,-1,172,-1,150
1,<environment.Job instance at 0x7fcbaae1b3c0>,130,19,[5 1],131,-1,169,-1,150
1,<environment.Job instance at 0x7fcba972cc80>,3,12,[ 1 14],4,-1,16,-1,4
1,<environment.Job instance at 0x7fcbaa77da00>,8,25,[3 6],9,-1,34,-1,9
1,<environment.Job instance at 0x7fcba9b7c410>,21,13,[ 4 11],22,-1,63,-1,50
1,<environment.Job instance at 0x7fcbaaea0d70>,29,15,[14  4],30,-1,82,-1,67
1,<environment.Job instance at 0x7fcba9bd78c0>,37,24,[9 5],38,-1,126,-1,102
1,<environment.Job instance at 0x7fcbb3987370>,46,1,[12  5],47,-1,135,-1,134
1,<environment.Job instance at 0x7fcba9e61730>,49,16,[13  2],50,-1,165,-1,149
1,<environment.Job instance at 0x7fcba9813be0>,75,13,[13  1],76,-1,220,-1,207
1,<environment.Job instance at 0x7fcbaa4148c0>,78,17,[ 3 13],79,-1,228,-1,211
1,<environment.Job instance at 0x7fcbaad30960>,85,13,[ 4 14],86,-1,245,-1,232
1,<environment.Job instance at 0x7fcbaaa71500>,92,25,[3 6],93,-1,290,-1,265
1,<environment.Job instance at 0x7fcbaa915280>,98,3,[ 1 13],99,-1,305,-1,302
1,<environment.Job instance at 0x7fcba9806370>,113,17,[13  3],114,-1,340,-1,323
1,<environment.Job instance at 0x7fcba9806f00>,117,13,[12  4],118,-1,347,-1,334
1,<environment.Job instance at 0x7fcbaadf6be0>,127,18,[ 3 12],128,-1,396,-1,378
1,<environment.Job instance at 0x7fcbaa16fb90>,2,15,[5 7],3,-1,19,-1,4
1,<environment.Job instance at 0x7fcbaa16f280>,3,12,[6 4],4,-1,18,-1,6
1,<environment.Job instance at 0x7fcbaaa73a00>,9,18,[4 5],10,-1,29,-1,11
1,<environment.Job instance at 0x7fcbaaa73050>,10,18,[6 2],11,-1,29,-1,11
1,<environment.Job instance at 0x7fcbaaa73eb0>,12,15,[4 8],13,-1,30,-1,15
1,<environment.Job instance at 0x7fcbaa41af50>,17,18,[2 7],18,-1,36,-1,18
1,<environment.Job instance at 0x7fcbaa41a690>,18,16,[10  5],19,-1,35,-1,19
1,<environment.Job instance at 0x7fcbaaa7cc30>,22,26,[8 2],23,-1,49,-1,23
1,<environment.Job instance at 0x7fcbaaa8ecd0>,25,18,[10  1],26,-1,47,-1,29
1,<environment.Job instance at 0x7fcbaaa73d20>,13,18,[12  1],14,-1,47,-1,29
1,<environment.Job instance at 0x7fcbaadeaa50>,30,21,[5 7],31,-1,52,-1,31
1,<environment.Job instance at 0x7fcba97390f0>,35,3,[1 5],36,-1,39,-1,36
1,<environment.Job instance at 0x7fcbaa455b40>,14,18,[ 3 10],15,-1,55,-1,37
1,<environment.Job instance at 0x7fcbaaa8ed20>,27,13,[8 1],28,-1,52,-1,39
1,<environment.Job instance at 0x7fcba9d4ee10>,38,16,[2 8],39,-1,55,-1,39
1,<environment.Job instance at 0x7fcba97414b0>,44,18,[5 8],45,-1,63,-1,45
1,<environment.Job instance at 0x7fcba97415f0>,42,12,[2 7],43,-1,58,-1,46
1,<environment.Job instance at 0x7fcba9741f00>,45,15,[3 7],46,-1,61,-1,46
1,<environment.Job instance at 0x7fcba9741320>,46,17,[5 7],47,-1,64,-1,47
1,<environment.Job instance at 0x7fcba9741c80>,47,14,[ 4 10],48,-1,62,-1,48
1,<environment.Job instance at 0x7fcba9d550f0>,49,16,[3 7],50,-1,66,-1,50
1,<environment.Job instance at 0x7fcba968e9b0>,52,13,[4 9],53,-1,66,-1,53
1,<environment.Job instance at 0x7fcba968e5a0>,53,13,[5 5],54,-1,68,-1,55
1,<environment.Job instance at 0x7fcba9697280>,57,24,[9 3],58,-1,82,-1,58
1,<environment.Job instance at 0x7fcba9741280>,43,26,[7 3],44,-1,87,-1,61
1,<environment.Job instance at 0x7fcba9697820>,60,18,[8 5],61,-1,79,-1,61
1,<environment.Job instance at 0x7fcbaaa7cfa0>,65,12,[5 5],66,-1,82,-1,70
1,<environment.Job instance at 0x7fcbaaa7c7d0>,63,15,[3 5],64,-1,87,-1,72
1,<environment.Job instance at 0x7fcbaaa7c960>,62,14,[8 4],63,-1,86,-1,72
1,<environment.Job instance at 0x7fcba9731af0>,68,15,[7 3],69,-1,87,-1,72
1,<environment.Job instance at 0x7fcba97310f0>,72,14,[6 4],73,-1,87,-1,73
1,<environment.Job instance at 0x7fcba97235f0>,74,17,[9 3],75,-1,93,-1,76
1,<environment.Job instance at 0x7fcba9723370>,75,20,[5 6],76,-1,96,-1,76
1,<environment.Job instance at 0x7fcba9697fa0>,56,12,[8 5],57,-1,93,-1,81
1,<environment.Job instance at 0x7fcba968fa00>,81,17,[ 5 10],82,-1,106,-1,89
1,<environment.Job instance at 0x7fcba968f5a0>,82,17,[6 5],83,-1,106,-1,89
1,<environment.Job instance at 0x7fcba968ffa0>,83,14,[1 7],84,-1,103,-1,89
1,<environment.Job instance at 0x7fcba9731690>,66,25,[10  1],67,-1,114,-1,89
1,<environment.Job instance at 0x7fcba968f820>,85,12,[10  5],86,-1,101,-1,89
1,<environment.Job instance at 0x7fcba968f500>,87,17,[4 5],88,-1,106,-1,89
1,<environment.Job instance at 0x7fcba972ea50>,90,16,[4 9],91,-1,107,-1,91
1,<environment.Job instance at 0x7fcba9714b40>,94,13,[9 2],95,-1,109,-1,96
1,<environment.Job instance at 0x7fcba968fb40>,86,19,[5 9],87,-1,117,-1,98
1,<environment.Job instance at 0x7fcba9714f00>,97,17,[3 8],98,-1,115,-1,98
1,<environment.Job instance at 0x7fcba9731050>,71,14,[12  1],72,-1,113,-1,99
1,<environment.Job instance at 0x7fcba97143c0>,98,18,[5 5],99,-1,120,-1,102
1,<environment.Job instance at 0x7fcba97142d0>,99,16,[13  5],100,-1,118,-1,102
1,<environment.Job instance at 0x7fcba968a3c0>,101,14,[5 7],102,-1,116,-1,102
1,<environment.Job instance at 0x7fcbaadceeb0>,102,18,[5 7],103,-1,121,-1,103
1,<environment.Job instance at 0x7fcbaa7d1af0>,103,20,[2 6],104,-1,125,-1,105
1,<environment.Job instance at 0x7fcbaa7d17d0>,104,13,[5 9],105,-1,118,-1,105
1,<environment.Job instance at 0x7fcba96a5460>,106,15,[8 4],107,-1,124,-1,109
1,<environment.Job instance at 0x7fcba96a56e0>,109,18,[8 4],110,-1,128,-1,110
1,<environment.Job instance at 0x7fcba96a5050>,108,18,[5 3],109,-1,128,-1,110
1,<environment.Job instance at 0x7fcbaa7dc8c0>,110,15,[1 8],111,-1,127,-1,112
1,<environment.Job instance at 0x7fcbaadd0b40>,111,28,[7 5],112,-1,140,-1,112
1,<environment.Job instance at 0x7fcbaade5b40>,115,17,[2 9],116,-1,134,-1,117
1,<environment.Job instance at 0x7fcbaade5af0>,113,15,[10  2],114,-1,132,-1,117
1,<environment.Job instance at 0x7fcbaa9a5050>,119,18,[4 6],120,-1,138,-1,120
1,<environment.Job instance at 0x7fcbaa995c80>,126,18,[9 5],127,-1,156,-1,138
1,<environment.Job instance at 0x7fcba968fbe0>,84,16,[ 2 11],85,-1,157,-1,141
1,<environment.Job instance at 0x7fcbaa9957d0>,129,16,[ 2 10],130,-1,158,-1,142
1,<environment.Job instance at 0x7fcbaa9a5190>,122,17,[9 3],123,-1,160,-1,143
1,<environment.Job instance at 0x7fcba9c23280>,133,15,[ 4 10],134,-1,160,-1,145
1,<environment.Job instance at 0x7fcbaaa8e500>,26,27,[5 8],27,-1,172,-1,145
1,<environment.Job instance at 0x7fcbaa995a50>,131,14,[10  4],132,-1,182,-1,168
1,<environment.Job instance at 0x7fcba968f050>,1,16,[ 1 11],2,-1,18,-1,2
1,<environment.Job instance at 0x7fcba98e5f50>,13,18,[12  1],14,-1,36,-1,18
1,<environment.Job instance at 0x7fcba98f26e0>,22,26,[8 2],23,-1,90,-1,64
1,<environment.Job instance at 0x7fcbaa2fd5f0>,26,27,[5 8],27,-1,99,-1,72
1,<environment.Job instance at 0x7fcba98fc0a0>,40,3,[ 3 12],41,-1,100,-1,97
1,<environment.Job instance at 0x7fcbaa012a00>,43,26,[7 3],44,-1,140,-1,114
1,<environment.Job instance at 0x7fcbaa015550>,57,24,[9 3],58,-1,200,-1,176
1,<environment.Job instance at 0x7fcbaa0432d0>,64,1,[12  4],65,-1,190,-1,189
1,<environment.Job instance at 0x7fcbaa8720a0>,66,25,[10  1],67,-1,228,-1,203
1,<environment.Job instance at 0x7fcbaa03d910>,70,24,[ 4 13],71,-1,232,-1,208
1,<environment.Job instance at 0x7fcbaa86fa50>,71,14,[12  1],72,-1,222,-1,208
1,<environment.Job instance at 0x7fcbaa02af00>,73,27,[4 5],74,-1,248,-1,221
1,<environment.Job instance at 0x7fcbaa877c80>,84,16,[ 2 11],85,-1,280,-1,264
1,<environment.Job instance at 0x7fcbaa2fae60>,99,16,[13  5],100,-1,337,-1,321
1,<environment.Job instance at 0x7fcbaa08f9b0>,107,1,[ 3 11],108,-1,357,-1,356
1,<environment.Job instance at 0x7fcba9532e60>,111,28,[7 5],112,-1,415,-1,387
1,<environment.Job instance at 0x7fcbaa430d70>,137,1,[ 2 11],138,-1,494,-1,493
1,<environment.Job instance at 0x7fcba970cf00>,0,13,[9 1],1,-1,16,-1,3
1,<environment.Job instance at 0x7fcba970ccd0>,3,17,[ 4 10],4,-1,21,-1,4
1,<environment.Job instance at 0x7fcba970c780>,6,16,[ 1 10],7,-1,23,-1,7
1,<environment.Job instance at 0x7fcba970cbe0>,7,18,[ 3 11],8,-1,26,-1,8
1,<environment.Job instance at 0x7fcba970c190>,10,18,[7 5],11,-1,29,-1,11
1,<environment.Job instance at 0x7fcba970ceb0>,11,16,[5 5],12,-1,28,-1,12
1,<environment.Job instance at 0x7fcba970c500>,14,12,[ 5 10],15,-1,27,-1,15
1,<environment.Job instance at 0x7fcba970c410>,15,19,[5 1],16,-1,35,-1,16
1,<environment.Job instance at 0x7fcba970c5a0>,16,24,[5 3],17,-1,41,-1,17
1,<environment.Job instance at 0x7fcba970c320>,17,13,[2 9],18,-1,31,-1,18
1,<environment.Job instance at 0x7fcba9e2d4b0>,18,13,[7 3],19,-1,32,-1,19
1,<environment.Job instance at 0x7fcba9e2deb0>,20,16,[1 7],21,-1,37,-1,21
1,<environment.Job instance at 0x7fcba9e2d050>,21,18,[6 5],22,-1,40,-1,22
1,<environment.Job instance at 0x7fcba970c140>,2,13,[2 5],3,-1,38,-1,25
1,<environment.Job instance at 0x7fcbaa7bf780>,29,17,[8 3],30,-1,49,-1,32
1,<environment.Job instance at 0x7fcbaa7bf730>,33,18,[2 7],34,-1,52,-1,34
1,<environment.Job instance at 0x7fcbaa7b71e0>,35,15,[10  1],36,-1,51,-1,36
1,<environment.Job instance at 0x7fcba9728c80>,39,14,[8 2],40,-1,54,-1,40
1,<environment.Job instance at 0x7fcbaa7bfeb0>,31,18,[ 5 10],32,-1,59,-1,41
1,<environment.Job instance at 0x7fcba97222d0>,43,17,[ 1 10],44,-1,62,-1,45
1,<environment.Job instance at 0x7fcba9722cd0>,47,13,[3 5],48,-1,61,-1,48
1,<environment.Job instance at 0x7fcba97220f0>,50,15,[ 4 10],51,-1,66,-1,51
1,<environment.Job instance at 0x7fcba9722460>,51,13,[1 5],52,-1,65,-1,52
1,<environment.Job instance at 0x7fcba9722140>,52,15,[7 5],53,-1,68,-1,53
1,<environment.Job instance at 0x7fcba9722550>,55,16,[9 5],56,-1,72,-1,56
1,<environment.Job instance at 0x7fcba9d5aaa0>,56,18,[6 5],57,-1,75,-1,57
1,<environment.Job instance at 0x7fcba9722a50>,44,19,[3 6],45,-1,77,-1,58
1,<environment.Job instance at 0x7fcba9d5a910>,64,12,[10  4],65,-1,92,-1,80
1,<environment.Job instance at 0x7fcba9d4cf00>,79,12,[6 4],80,-1,92,-1,80
1,<environment.Job instance at 0x7fcba9d4cc80>,80,24,[2 5],81,-1,106,-1,82
1,<environment.Job instance at 0x7fcba9d4c050>,82,16,[4 9],83,-1,99,-1,83
1,<environment.Job instance at 0x7fcba9d82f50>,85,20,[5 4],86,-1,106,-1,86
1,<environment.Job instance at 0x7fcba9d82c30>,86,24,[ 1 10],87,-1,111,-1,87
1,<environment.Job instance at 0x7fcba9d829b0>,91,17,[5 8],92,-1,109,-1,92
1,<environment.Job instance at 0x7fcba9d822d0>,93,25,[4 6],94,-1,126,-1,101
1,<environment.Job instance at 0x7fcba9d70d20>,70,13,[7 3],71,-1,114,-1,101
1,<environment.Job instance at 0x7fcba9d82730>,94,16,[ 5 10],95,-1,118,-1,102
1,<environment.Job instance at 0x7fcba9d65460>,97,22,[10  3],98,-1,124,-1,102
1,<environment.Job instance at 0x7fcba9d65c30>,96,13,[9 4],97,-1,118,-1,105
1,<environment.Job instance at 0x7fcba9d65280>,98,21,[1 6],99,-1,126,-1,105
1,<environment.Job instance at 0x7fcba9690460>,103,18,[ 5 12],104,-1,123,-1,105
1,<environment.Job instance at 0x7fcbaa9a5d70>,104,16,[2 9],105,-1,122,-1,106
1,<environment.Job instance at 0x7fcba9d65b40>,101,14,[ 5 10],102,-1,121,-1,107
1,<environment.Job instance at 0x7fcbaa9a5960>,106,13,[4 7],107,-1,121,-1,108
1,<environment.Job instance at 0x7fcbaa9a5e60>,105,16,[7 5],106,-1,125,-1,109
1,<environment.Job instance at 0x7fcba9d65410>,100,17,[2 8],101,-1,127,-1,110
1,<environment.Job instance at 0x7fcbaa9a58c0>,109,16,[14  3],110,-1,132,-1,116
1,<environment.Job instance at 0x7fcba97ec140>,114,16,[2 6],115,-1,132,-1,116
1,<environment.Job instance at 0x7fcba9a79690>,111,16,[10  5],112,-1,132,-1,116
1,<environment.Job instance at 0x7fcba9d705a0>,73,12,[9 4],74,-1,143,-1,131
1,<environment.Job instance at 0x7fcbaada7a00>,117,2,[5 1],118,-1,133,-1,131
1,<environment.Job instance at 0x7fcba9e24e60>,115,12,[3 7],116,-1,143,-1,131
1,<environment.Job instance at 0x7fcba9c19af0>,124,3,[3 7],125,-1,134,-1,131
1,<environment.Job instance at 0x7fcba9c19500>,126,18,[5 9],127,-1,149,-1,131
1,<environment.Job instance at 0x7fcba9723230>,127,19,[ 4 10],128,-1,150,-1,131
1,<environment.Job instance at 0x7fcba9729050>,121,17,[9 1],122,-1,148,-1,131
1,<environment.Job instance at 0x7fcba9c2aaf0>,128,3,[ 1 10],129,-1,134,-1,131
1,<environment.Job instance at 0x7fcba9728690>,42,25,[2 8],43,-1,156,-1,131
1,<environment.Job instance at 0x7fcba9723460>,130,14,[6 2],131,-1,145,-1,131
1,<environment.Job instance at 0x7fcba9723640>,129,12,[5 4],130,-1,143,-1,131
1,<environment.Job instance at 0x7fcba9f1c280>,131,2,[8 5],132,-1,134,-1,132
1,<environment.Job instance at 0x7fcbaaa38e10>,125,17,[6 3],126,-1,149,-1,132
1,<environment.Job instance at 0x7fcbaac04140>,132,16,[8 2],133,-1,152,-1,136
1,<environment.Job instance at 0x7fcbaa7dc3c0>,136,23,[ 4 10],137,-1,160,-1,137
1,<environment.Job instance at 0x7fcbaa7dca50>,137,13,[4 9],138,-1,152,-1,139
1,<environment.Job instance at 0x7fcba9d4c370>,5,3,[ 4 12],6,-1,9,-1,6
1,<environment.Job instance at 0x7fcba9d5a4b0>,7,18,[ 3 11],8,-1,26,-1,8
1,<environment.Job instance at 0x7fcba9d4cf50>,8,2,[14  5],9,-1,11,-1,9
1,<environment.Job instance at 0x7fcba9930e60>,16,24,[5 3],17,-1,52,-1,28
1,<environment.Job instance at 0x7fcba99ee0f0>,24,28,[10  4],25,-1,91,-1,63
1,<environment.Job instance at 0x7fcbaa8d2460>,25,15,[ 4 12],26,-1,78,-1,63
1,<environment.Job instance at 0x7fcbaa170a50>,37,2,[ 5 12],38,-1,99,-1,97
1,<environment.Job instance at 0x7fcbb3450820>,42,25,[2 8],43,-1,129,-1,104
1,<environment.Job instance at 0x7fcbaa4ff0a0>,46,26,[ 1 12],47,-1,142,-1,116
1,<environment.Job instance at 0x7fcbb342e5f0>,53,2,[11  4],54,-1,150,-1,148
1,<environment.Job instance at 0x7fcbaad54230>,57,2,[11  1],58,-1,165,-1,163
1,<environment.Job instance at 0x7fcbaa0baaf0>,69,2,[ 3 11],70,-1,204,-1,202
1,<environment.Job instance at 0x7fcbaaa734b0>,80,24,[2 5],81,-1,267,-1,243
1,<environment.Job instance at 0x7fcbaab72b90>,86,24,[ 1 10],87,-1,273,-1,249
1,<environment.Job instance at 0x7fcbaab727d0>,87,3,[13  1],88,-1,252,-1,249
1,<environment.Job instance at 0x7fcbaa9b8b90>,93,25,[4 6],94,-1,289,-1,264
1,<environment.Job instance at 0x7fcbb345b820>,103,18,[ 5 12],104,-1,318,-1,300
1,<environment.Job instance at 0x7fcba9f080f0>,109,16,[14  3],110,-1,351,-1,335
1,<environment.Job instance at 0x7fcbb36c6280>,119,3,[14  2],120,-1,370,-1,367
1,<environment.Job instance at 0x7fcbaa368730>,136,23,[ 4 10],137,-1,463,-1,440
1,<environment.Job instance at 0x7fcba96a60a0>,3,15,[ 5 10],4,-1,20,-1,5
1,<environment.Job instance at 0x7fcba96a63c0>,4,18,[8 1],5,-1,23,-1,5
1,<environment.Job instance at 0x7fcba9f4e0a0>,7,12,[10  3],8,-1,22,-1,10
1,<environment.Job instance at 0x7fcba9f4e820>,10,18,[5 7],11,-1,29,-1,11
1,<environment.Job instance at 0x7fcba9f4e050>,11,13,[ 3 10],12,-1,25,-1,12
1,<environment.Job instance at 0x7fcba9f4e4b0>,12,18,[6 5],13,-1,31,-1,13
1,<environment.Job instance at 0x7fcba9f4eaa0>,14,16,[9 5],15,-1,31,-1,15
1,<environment.Job instance at 0x7fcbaa4fc5a0>,18,14,[5 7],19,-1,33,-1,19
1,<environment.Job instance at 0x7fcba98f4f00>,26,17,[10  5],27,-1,44,-1,27
1,<environment.Job instance at 0x7fcba98f40a0>,29,21,[7 5],30,-1,51,-1,30
1,<environment.Job instance at 0x7fcba98f4190>,30,12,[4 7],31,-1,43,-1,31
1,<environment.Job instance at 0x7fcbaa86f2d0>,34,18,[1 8],35,-1,53,-1,35
1,<environment.Job instance at 0x7fcbaa86fbe0>,35,21,[6 2],36,-1,57,-1,36
1,<environment.Job instance at 0x7fcbaa86fb90>,39,17,[9 1],40,-1,57,-1,40
1,<environment.Job instance at 0x7fcba97225f0>,42,17,[5 5],43,-1,60,-1,43
1,<environment.Job instance at 0x7fcba9722690>,44,15,[5 9],45,-1,60,-1,45
1,<environment.Job instance at 0x7fcba9722e60>,45,13,[1 9],46,-1,59,-1,46
1,<environment.Job instance at 0x7fcba9722410>,46,17,[7 1],47,-1,64,-1,47
1,<environment.Job instance at 0x7fcba9bf70f0>,49,16,[9 2],50,-1,66,-1,50
1,<environment.Job instance at 0x7fcba9bf76e0>,53,17,[2 7],54,-1,71,-1,54
1,<environment.Job instance at 0x7fcba9bf78c0>,56,17,[ 2 10],57,-1,74,-1,57
1,<environment.Job instance at 0x7fcba9bf7820>,57,16,[3 9],58,-1,74,-1,58
1,<environment.Job instance at 0x7fcba9bf7280>,59,16,[6 3],60,-1,76,-1,60
1,<environment.Job instance at 0x7fcbb3a30500>,63,18,[5 3],64,-1,82,-1,64
1,<environment.Job instance at 0x7fcbb3a304b0>,64,14,[7 5],65,-1,79,-1,65
1,<environment.Job instance at 0x7fcba97317d0>,65,14,[5 5],66,-1,80,-1,66
1,<environment.Job instance at 0x7fcba97312d0>,66,22,[8 4],67,-1,89,-1,67
1,<environment.Job instance at 0x7fcba9731e60>,67,20,[5 5],68,-1,88,-1,68
1,<environment.Job instance at 0x7fcba9731280>,68,20,[6 2],69,-1,89,-1,69
1,<environment.Job instance at 0x7fcba97319b0>,69,14,[ 2 10],70,-1,84,-1,70
1,<environment.Job instance at 0x7fcba9f4eb40>,9,14,[ 5 10],10,-1,104,-1,90
1,<environment.Job instance at 0x7fcba968edc0>,87,23,[2 9],88,-1,113,-1,90
1,<environment.Job instance at 0x7fcba98f4780>,31,19,[14  4],32,-1,144,-1,125
1,<environment.Job instance at 0x7fcba968e8c0>,79,13,[7 2],80,-1,138,-1,125
1,<environment.Job instance at 0x7fcbaa029320>,93,16,[8 1],94,-1,141,-1,125
1,<environment.Job instance at 0x7fcba9c23640>,96,15,[10  3],97,-1,146,-1,131
1,<environment.Job instance at 0x7fcba9c233c0>,99,18,[4 9],100,-1,149,-1,131
1,<environment.Job instance at 0x7fcbaa2d45f0>,127,17,[10  1],128,-1,266,-1,249
1,<environment.Job instance at 0x7fcbaae94e10>,129,17,[3 7],130,-1,266,-1,249
1,<environment.Job instance at 0x7fcbaacc4a00>,134,18,[8 4],135,-1,267,-1,249
1,<environment.Job instance at 0x7fcba9731410>,13,24,[ 5 11],14,-1,47,-1,23
1,<environment.Job instance at 0x7fcba9d2ab90>,24,16,[12  5],25,-1,84,-1,68
1,<environment.Job instance at 0x7fcba968a7d0>,31,19,[14  4],32,-1,103,-1,84
1,<environment.Job instance at 0x7fcbaa901b40>,37,3,[ 5 11],38,-1,101,-1,98
1,<environment.Job instance at 0x7fcbaa901eb0>,38,1,[11  4],39,-1,99,-1,98
1,<environment.Job instance at 0x7fcbaad54b90>,70,17,[11  3],71,-1,228,-1,211
1,<environment.Job instance at 0x7fcbaac9ecd0>,75,1,[ 5 14],76,-1,226,-1,225
1,<environment.Job instance at 0x7fcbb34860a0>,87,23,[2 9],88,-1,290,-1,267
1,<environment.Job instance at 0x7fcbaaedcf50>,88,2,[ 1 11],89,-1,269,-1,267
1,<environment.Job instance at 0x7fcba9efd910>,111,23,[10  2],112,-1,377,-1,354
1,<environment.Job instance at 0x7fcba9cbddc0>,131,26,[14  5],132,-1,475,-1,449
1,<environment.Job instance at 0x7f92e8ce8af0>,2,14,[ 2 10],3,-1,18,-1,4
1,<environment.Job instance at 0x7f92f22d88c0>,3,22,[2 5],4,-1,26,-1,4
1,<environment.Job instance at 0x7f92e8ce8e60>,7,14,[7 5],8,-1,23,-1,9
1,<environment.Job instance at 0x7f92e8ce8e10>,8,17,[1 8],9,-1,26,-1,9
1,<environment.Job instance at 0x7f92e8ceb0a0>,10,22,[8 1],11,-1,35,-1,13
1,<environment.Job instance at 0x7f92e8ceb140>,12,23,[6 4],13,-1,36,-1,13
1,<environment.Job instance at 0x7f92e8ceb230>,13,18,[5 9],14,-1,32,-1,14
1,<environment.Job instance at 0x7f92e8ceb190>,14,21,[8 1],15,-1,38,-1,17
1,<environment.Job instance at 0x7f92e8ceb500>,16,18,[7 3],17,-1,35,-1,17
1,<environment.Job instance at 0x7f92e8ceb550>,18,26,[7 4],19,-1,45,-1,19
1,<environment.Job instance at 0x7f92e8ceb7d0>,19,25,[5 9],20,-1,45,-1,20
1,<environment.Job instance at 0x7f92e8ceb8c0>,21,18,[9 4],22,-1,40,-1,22
1,<environment.Job instance at 0x7f92e8ceb910>,23,16,[6 2],24,-1,40,-1,24
1,<environment.Job instance at 0x7f92e8cebfa0>,27,17,[4 6],28,-1,45,-1,28
1,<environment.Job instance at 0x7f92e8cee0a0>,28,17,[ 1 13],29,-1,46,-1,29
1,<environment.Job instance at 0x7f92e8cee1e0>,30,26,[9 4],31,-1,57,-1,31
1,<environment.Job instance at 0x7f92e8cee2d0>,32,21,[5 9],33,-1,54,-1,33
1,<environment.Job instance at 0x7f92e8cee4b0>,33,26,[3 6],34,-1,60,-1,34
1,<environment.Job instance at 0x7f92e8cee460>,34,14,[1 9],35,-1,49,-1,35
1,<environment.Job instance at 0x7f92e8cee640>,35,16,[1 9],36,-1,52,-1,36
1,<environment.Job instance at 0x7f92e8cee780>,37,14,[5 8],38,-1,52,-1,38
1,<environment.Job instance at 0x7f92e8cee550>,39,14,[9 4],40,-1,55,-1,41
1,<environment.Job instance at 0x7f92e8cee7d0>,41,1,[7 1],42,-1,43,-1,42
1,<environment.Job instance at 0x7f92e8ceec80>,43,12,[4 5],44,-1,56,-1,44
1,<environment.Job instance at 0x7f92e8ceea00>,40,26,[ 1 10],41,-1,70,-1,44
1,<environment.Job instance at 0x7f92e8ceeb40>,45,15,[7 5],46,-1,61,-1,46
1,<environment.Job instance at 0x7f92e8cf00a0>,47,13,[ 3 10],48,-1,61,-1,48
1,<environment.Job instance at 0x7f92e8cf01e0>,48,12,[9 2],49,-1,63,-1,51
1,<environment.Job instance at 0x7f92e8cf0280>,49,17,[10  2],50,-1,68,-1,51
1,<environment.Job instance at 0x7f92e8cf0780>,54,18,[7 1],55,-1,74,-1,56
1,<environment.Job instance at 0x7f92e8cf0aa0>,57,16,[ 2 11],58,-1,74,-1,58
1,<environment.Job instance at 0x7f92e8cf0b90>,58,17,[3 7],59,-1,76,-1,59
1,<environment.Job instance at 0x7f92e8cf09b0>,59,19,[1 7],60,-1,79,-1,60
1,<environment.Job instance at 0x7f92e8cf0f00>,62,14,[4 9],63,-1,77,-1,63
1,<environment.Job instance at 0x7f92e8cf5410>,67,16,[1 9],68,-1,84,-1,68
1,<environment.Job instance at 0x7f92e8cf5640>,68,14,[6 4],69,-1,83,-1,69
1,<environment.Job instance at 0x7f92e8cf5500>,69,14,[9 4],70,-1,84,-1,70
1,<environment.Job instance at 0x7f92e8cf5870>,72,18,[3 5],73,-1,91,-1,73
1,<environment.Job instance at 0x7f92e8cf5dc0>,76,13,[10  1],77,-1,91,-1,78
1,<environment.Job instance at 0x7f92e8cf5b40>,78,14,[6 1],79,-1,93,-1,79
1,<environment.Job instance at 0x7f92e8cf30a0>,79,19,[10  3],80,-1,99,-1,80
1,<environment.Job instance at 0x7f92e8cf5eb0>,77,16,[8 1],78,-1,97,-1,81
1,<environment.Job instance at 0x7f92e8cf31e0>,82,21,[4 8],83,-1,104,-1,83
1,<environment.Job instance at 0x7f92e8cf3500>,83,18,[ 3 10],84,-1,102,-1,84
1,<environment.Job instance at 0x7f92e8cf3870>,87,18,[7 1],88,-1,106,-1,88
1,<environment.Job instance at 0x7f92e8cf39b0>,88,16,[4 9],89,-1,105,-1,89
1,<environment.Job instance at 0x7f92e8d2da50>,96,18,[2 6],97,-1,116,-1,98
1,<environment.Job instance at 0x7f92e8cdf550>,107,18,[5 5],108,-1,126,-1,108
1,<environment.Job instance at 0x7f92e8f1c5a0>,111,17,[6 4],112,-1,129,-1,112
1,<environment.Job instance at 0x7f92e8e018c0>,110,23,[5 1],111,-1,137,-1,114
1,<environment.Job instance at 0x7f92e8ce23c0>,12,23,[6 4],13,-1,53,-1,30
1,<environment.Job instance at 0x7f92e8df67d0>,18,26,[7 4],19,-1,70,-1,44
1,<environment.Job instance at 0x7f92e8e91cd0>,19,25,[5 9],20,-1,83,-1,58
1,<environment.Job instance at 0x7f92e8d98af0>,28,17,[ 1 13],29,-1,87,-1,70
1,<environment.Job instance at 0x7f92e8d97730>,30,26,[9 4],31,-1,110,-1,84
1,<environment.Job instance at 0x7f92e8d97050>,31,1,[ 2 14],32,-1,85,-1,84
1,<environment.Job instance at 0x7f92e8e07be0>,33,26,[3 6],34,-1,110,-1,84
1,<environment.Job instance at 0x7f92e8ce8910>,40,26,[ 1 10],41,-1,139,-1,113
1,<environment.Job instance at 0x7f92e8ccb2d0>,57,16,[ 2 11],58,-1,183,-1,167
1,<environment.Job instance at 0x7f92e8c820f0>,89,17,[ 5 14],90,-1,289,-1,272
1,<environment.Job instance at 0x7f92e8c82370>,93,25,[ 1 10],94,-1,320,-1,295
1,<environment.Job instance at 0x7f92e8c82190>,109,27,[3 9],110,-1,371,-1,344
1,<environment.Job instance at 0x7f92e8c82e10>,110,23,[5 1],111,-1,367,-1,344
1,<environment.Job instance at 0x7f92e8c845a0>,117,3,[ 3 13],118,-1,367,-1,364
1,<environment.Job instance at 0x7f92e8c84640>,119,28,[7 5],120,-1,406,-1,378
1,<environment.Job instance at 0x7f92e8c84730>,120,19,[ 5 12],121,-1,397,-1,378
1,<environment.Job instance at 0x7f92e8c87370>,137,28,[ 2 10],138,-1,458,-1,430
1,<environment.Job instance at 0x7f92e8c87870>,142,15,[ 2 13],143,-1,450,-1,435
1,<environment.Job instance at 0x7f92e8c87910>,144,20,[13  4],145,-1,460,-1,440
1,<environment.Job instance at 0x7f92e86c2fa0>,1,22,[5 6],2,-1,24,-1,2
1,<environment.Job instance at 0x7f92e8753230>,5,17,[10  4],6,-1,24,-1,7
1,<environment.Job instance at 0x7f92e87532d0>,7,21,[10  4],8,-1,29,-1,8
1,<environment.Job instance at 0x7f92e8753960>,10,24,[1 5],11,-1,35,-1,11
1,<environment.Job instance at 0x7f92e8753b40>,12,20,[10  5],13,-1,33,-1,13
1,<environment.Job instance at 0x7f92e8753a00>,14,14,[10  5],15,-1,29,-1,15
1,<environment.Job instance at 0x7f92e8757af0>,20,17,[4 7],21,-1,38,-1,21
1,<environment.Job instance at 0x7f92e8757dc0>,23,24,[3 7],24,-1,48,-1,24
1,<environment.Job instance at 0x7f92e8757f00>,24,19,[3 8],25,-1,44,-1,25
1,<environment.Job instance at 0x7f92e875c280>,27,16,[8 4],28,-1,44,-1,28
1,<environment.Job instance at 0x7f92e875c140>,30,17,[3 5],31,-1,48,-1,31
1,<environment.Job instance at 0x7f92e87c7910>,31,18,[6 2],32,-1,50,-1,32
1,<environment.Job instance at 0x7f92e8c91c30>,6,12,[1 6],7,-1,44,-1,32
1,<environment.Job instance at 0x7f92e8845be0>,34,19,[6 2],35,-1,54,-1,35
1,<environment.Job instance at 0x7f92e88eda50>,36,17,[9 1],37,-1,54,-1,37
1,<environment.Job instance at 0x7f92e879b0a0>,37,13,[9 5],38,-1,51,-1,38
1,<environment.Job instance at 0x7f92e88f5cd0>,40,17,[9 5],41,-1,58,-1,41
1,<environment.Job instance at 0x7f92e87a6550>,43,12,[1 9],44,-1,56,-1,44
1,<environment.Job instance at 0x7f92e87a61e0>,44,26,[3 9],45,-1,71,-1,45
1,<environment.Job instance at 0x7f92e87a6280>,45,15,[5 3],46,-1,61,-1,46
1,<environment.Job instance at 0x7f92e87a60a0>,48,21,[2 7],49,-1,70,-1,49
1,<environment.Job instance at 0x7f92e868faf0>,50,23,[4 7],51,-1,74,-1,51
1,<environment.Job instance at 0x7f92e88cfeb0>,51,14,[ 1 10],52,-1,66,-1,52
1,<environment.Job instance at 0x7f92e86906e0>,53,14,[5 9],54,-1,68,-1,54
1,<environment.Job instance at 0x7f92e876b8c0>,55,19,[ 1 10],56,-1,75,-1,56
1,<environment.Job instance at 0x7f92f24481e0>,56,16,[6 5],57,-1,73,-1,57
1,<environment.Job instance at 0x7f92e856b190>,58,20,[ 2 10],59,-1,79,-1,59
1,<environment.Job instance at 0x7f92e88f1b40>,59,15,[5 5],60,-1,75,-1,60
1,<environment.Job instance at 0x7f92e83c89b0>,61,17,[3 6],62,-1,79,-1,62
1,<environment.Job instance at 0x7f92e8338a00>,64,16,[5 6],65,-1,81,-1,65
1,<environment.Job instance at 0x7f92e84270f0>,65,21,[1 6],66,-1,87,-1,66
1,<environment.Job instance at 0x7f92e831d410>,66,16,[1 8],67,-1,83,-1,67
1,<environment.Job instance at 0x7f92e83be140>,68,23,[1 9],69,-1,92,-1,69
1,<environment.Job instance at 0x7f92e83bfe60>,69,17,[8 5],70,-1,87,-1,70
1,<environment.Job instance at 0x7f92e8298960>,74,15,[8 5],75,-1,90,-1,75
1,<environment.Job instance at 0x7f92e8298d70>,78,19,[4 7],79,-1,98,-1,79
1,<environment.Job instance at 0x7f92e879b050>,38,27,[ 3 12],39,-1,119,-1,92
1,<environment.Job instance at 0x7f92e827e190>,85,18,[5 4],86,-1,111,-1,93
1,<environment.Job instance at 0x7f92e829ad20>,93,13,[9 2],94,-1,109,-1,96
1,<environment.Job instance at 0x7f92e8297dc0>,97,14,[10  3],98,-1,112,-1,98
1,<environment.Job instance at 0x7f92e8297640>,101,16,[5 8],102,-1,120,-1,104
1,<environment.Job instance at 0x7f92e8281b90>,107,14,[10  5],108,-1,122,-1,108
1,<environment.Job instance at 0x7f92e8295c30>,102,23,[1 8],103,-1,135,-1,112
1,<environment.Job instance at 0x7f92e838ccd0>,113,26,[5 3],114,-1,219,-1,193
1,<environment.Job instance at 0x7f92e8757eb0>,3,1,[12  5],4,-1,5,-1,4
1,<environment.Job instance at 0x7f92e829a0a0>,10,24,[1 5],11,-1,43,-1,19
1,<environment.Job instance at 0x7f92e8297820>,16,13,[ 5 14],17,-1,34,-1,21
1,<environment.Job instance at 0x7f92e8c84be0>,23,24,[3 7],24,-1,65,-1,41
1,<environment.Job instance at 0x7f92e8c82fa0>,38,27,[ 3 12],39,-1,105,-1,78
1,<environment.Job instance at 0x7f92e8c82d20>,42,15,[ 2 14],43,-1,107,-1,92
1,<environment.Job instance at 0x7f92e8c825f0>,44,26,[3 9],45,-1,134,-1,108
1,<environment.Job instance at 0x7f92e8c82410>,50,23,[4 7],51,-1,139,-1,116
1,<environment.Job instance at 0x7f92e8cf5b90>,60,1,[14  4],61,-1,153,-1,152
1,<environment.Job instance at 0x7f92e8428dc0>,67,18,[ 1 14],68,-1,202,-1,184
1,<environment.Job instance at 0x7f92e84c3af0>,68,23,[1 9],69,-1,223,-1,200
1,<environment.Job instance at 0x7f92e84ac410>,75,17,[12  1],76,-1,232,-1,215
1,<environment.Job instance at 0x7f92e84ac960>,80,16,[14  3],81,-1,260,-1,244
1,<environment.Job instance at 0x7f92e8621460>,87,2,[ 1 12],88,-1,264,-1,262
1,<environment.Job instance at 0x7f92e848a870>,95,27,[6 1],96,-1,330,-1,303
1,<environment.Job instance at 0x7f92e85b9820>,102,23,[1 8],103,-1,357,-1,334
1,<environment.Job instance at 0x7f92e84a91e0>,113,26,[5 3],114,-1,383,-1,357
1,<environment.Job instance at 0x7f92e8495460>,129,26,[2 8],130,-1,461,-1,435
1,<environment.Job instance at 0x7f92e844d280>,137,27,[9 5],138,-1,501,-1,474
1,<environment.Job instance at 0x7f92e844deb0>,139,14,[12  2],140,-1,488,-1,474
1,<environment.Job instance at 0x7f92e83cdfa0>,13,16,[4 5],14,-1,31,-1,15
1,<environment.Job instance at 0x7f92e83cd320>,15,16,[7 5],16,-1,32,-1,16
1,<environment.Job instance at 0x7f92e83cd550>,18,14,[9 4],19,-1,33,-1,19
1,<environment.Job instance at 0x7f92e83c5e60>,19,18,[5 6],20,-1,38,-1,20
1,<environment.Job instance at 0x7f92e83c5870>,20,16,[8 3],21,-1,37,-1,21
1,<environment.Job instance at 0x7f92e83c5cd0>,23,16,[ 4 10],24,-1,40,-1,24
1,<environment.Job instance at 0x7f92e83c5d70>,25,27,[4 5],26,-1,53,-1,26
1,<environment.Job instance at 0x7f92e83cd3c0>,1,17,[ 5 14],2,-1,19,-1,2
1,<environment.Job instance at 0x7f92e83cdd20>,2,25,[ 3 11],3,-1,28,-1,3
1,<environment.Job instance at 0x7f92e83c5eb0>,4,17,[13  5],5,-1,22,-1,5
1,<environment.Job instance at 0x7f92e83ca870>,5,13,[ 5 14],6,-1,19,-1,6
1,<environment.Job instance at 0x7f92f24be5a0>,25,27,[4 5],26,-1,86,-1,59
1,<environment.Job instance at 0x7f92e8b33320>,27,12,[13  4],28,-1,71,-1,59
1,<environment.Job instance at 0x7f92e831db90>,28,12,[ 5 12],29,-1,71,-1,59
1,<environment.Job instance at 0x7f92e8324410>,47,13,[12  1],48,-1,120,-1,107
1,<environment.Job instance at 0x7f92e82cf870>,48,12,[14  3],49,-1,119,-1,107
1,<environment.Job instance at 0x7f92e82cf500>,49,1,[ 4 11],50,-1,108,-1,107
1,<environment.Job instance at 0x7f92e86c4230>,56,25,[2 8],57,-1,153,-1,128
1,<environment.Job instance at 0x7f92e8292320>,60,26,[8 3],61,-1,168,-1,142
1,<environment.Job instance at 0x7f92e838d4b0>,74,2,[11  3],75,-1,175,-1,173
1,<environment.Job instance at 0x7f92e83cca50>,85,17,[12  4],86,-1,252,-1,235
1,<environment.Job instance at 0x7f92e841fbe0>,97,2,[ 3 11],98,-1,286,-1,284
1,<environment.Job instance at 0x7f92e841f780>,102,27,[8 3],103,-1,343,-1,316
1,<environment.Job instance at 0x7f92e841f910>,106,27,[2 6],107,-1,360,-1,333
1,<environment.Job instance at 0x7f92e840f870>,110,14,[ 4 14],111,-1,364,-1,350
1,<environment.Job instance at 0x7f92e841b870>,127,23,[2 8],128,-1,417,-1,394
1,<environment.Job instance at 0x7f92e841baf0>,128,3,[11  1],129,-1,397,-1,394
1,<environment.Job instance at 0x7f92e841bbe0>,129,19,[13  3],130,-1,413,-1,394
1,<environment.Job instance at 0x7f92e841bd20>,134,13,[ 4 11],135,-1,425,-1,412
1,<environment.Job instance at 0x7f92e8417f50>,139,17,[12  4],140,-1,444,-1,427
1,<environment.Job instance at 0x7f92e84170a0>,140,25,[6 4],141,-1,457,-1,432
1,<environment.Job instance at 0x7f92e8417e10>,142,3,[14  5],143,-1,435,-1,432
1,<environment.Job instance at 0x7f92e8417050>,144,24,[5 5],145,-1,465,-1,441
1,<environment.Job instance at 0x7f92e8417d20>,148,28,[ 5 10],149,-1,486,-1,458
1,<environment.Job instance at 0x7f92e8479c30>,1,17,[7 5],2,-1,19,-1,2
1,<environment.Job instance at 0x7f92e8257aa0>,8,15,[2 9],9,-1,26,-1,11
1,<environment.Job instance at 0x7f92e8259230>,15,13,[6 3],16,-1,29,-1,16
1,<environment.Job instance at 0x7f92e82595a0>,16,12,[10  2],17,-1,29,-1,17
1,<environment.Job instance at 0x7f92e82597d0>,17,12,[6 2],18,-1,31,-1,19
1,<environment.Job instance at 0x7f92e8259870>,20,12,[3 7],21,-1,33,-1,21
1,<environment.Job instance at 0x7f92e8259780>,22,14,[5 3],23,-1,37,-1,23
1,<environment.Job instance at 0x7f92e8259af0>,23,12,[2 7],24,-1,36,-1,24
1,<environment.Job instance at 0x7f92e8259b90>,24,22,[7 3],25,-1,47,-1,25
1,<environment.Job instance at 0x7f92e8259410>,18,13,[8 3],19,-1,38,-1,25
1,<environment.Job instance at 0x7f92e8259a00>,25,20,[7 5],26,-1,46,-1,26
1,<environment.Job instance at 0x7f92e825b5f0>,34,17,[14  5],35,-1,52,-1,35
1,<environment.Job instance at 0x7f92e825bf00>,42,17,[4 5],43,-1,60,-1,43
1,<environment.Job instance at 0x7f92e825f0f0>,43,14,[9 3],44,-1,58,-1,44
1,<environment.Job instance at 0x7f92e825f190>,45,17,[8 2],46,-1,63,-1,46
1,<environment.Job instance at 0x7f92e825f2d0>,46,16,[1 9],47,-1,63,-1,47
1,<environment.Job instance at 0x7f92e825f3c0>,47,16,[7 2],48,-1,66,-1,50
1,<environment.Job instance at 0x7f92e825b6e0>,35,12,[4 5],36,-1,65,-1,53
1,<environment.Job instance at 0x7f92e825f960>,52,16,[10  4],53,-1,69,-1,53
1,<environment.Job instance at 0x7f92e825f820>,54,16,[9 5],55,-1,71,-1,55
1,<environment.Job instance at 0x7f92e830d050>,56,22,[1 8],57,-1,79,-1,57
1,<environment.Job instance at 0x7f92e824e2d0>,57,28,[5 9],58,-1,87,-1,59
1,<environment.Job instance at 0x7f92e825fa00>,53,16,[6 5],54,-1,76,-1,60
1,<environment.Job instance at 0x7f92e824d3c0>,59,18,[5 8],60,-1,78,-1,60
1,<environment.Job instance at 0x7f92e824dbe0>,60,18,[ 2 10],61,-1,80,-1,62
1,<environment.Job instance at 0x7f92e824d870>,61,15,[8 1],62,-1,77,-1,62
1,<environment.Job instance at 0x7f92e825bcd0>,40,15,[2 5],41,-1,83,-1,68
1,<environment.Job instance at 0x7f92e824d280>,66,18,[ 5 10],67,-1,86,-1,68
1,<environment.Job instance at 0x7f92e8be4a00>,67,28,[9 1],68,-1,100,-1,72
1,<environment.Job instance at 0x7f92e8658320>,71,14,[9 2],72,-1,87,-1,73
1,<environment.Job instance at 0x7f92e8b661e0>,72,26,[5 8],73,-1,99,-1,73
1,<environment.Job instance at 0x7f92e89e1820>,78,15,[2 8],79,-1,95,-1,80
1,<environment.Job instance at 0x7f92e89e1be0>,80,14,[7 2],81,-1,95,-1,81
1,<environment.Job instance at 0x7f92e865a690>,82,17,[8 1],83,-1,100,-1,83
1,<environment.Job instance at 0x7f92e89e1c80>,79,18,[1 7],80,-1,102,-1,84
1,<environment.Job instance at 0x7f92e825b910>,37,18,[8 2],38,-1,104,-1,86
1,<environment.Job instance at 0x7f92e89c6280>,83,22,[3 5],84,-1,108,-1,86
1,<environment.Job instance at 0x7f92e8241730>,90,22,[7 1],91,-1,114,-1,92
1,<environment.Job instance at 0x7f92e89ec0a0>,92,21,[5 7],93,-1,114,-1,93
1,<environment.Job instance at 0x7f92e89d3b90>,96,18,[9 3],97,-1,115,-1,97
1,<environment.Job instance at 0x7f92e8668640>,98,16,[1 7],99,-1,115,-1,99
1,<environment.Job instance at 0x7f92e89e72d0>,85,18,[4 6],86,-1,118,-1,100
1,<environment.Job instance at 0x7f92e86688c0>,99,18,[8 2],100,-1,120,-1,102
1,<environment.Job instance at 0x7f92e863ef50>,89,18,[3 8],90,-1,122,-1,104
1,<environment.Job instance at 0x7f92e863ef00>,87,28,[ 5 10],88,-1,132,-1,104
1,<environment.Job instance at 0x7f92e86680a0>,103,17,[4 7],104,-1,121,-1,104
1,<environment.Job instance at 0x7f92e86680f0>,104,16,[ 5 10],105,-1,121,-1,105
1,<environment.Job instance at 0x7f92e8668280>,105,15,[5 9],106,-1,121,-1,106
1,<environment.Job instance at 0x7f92e8656780>,117,18,[10  5],118,-1,143,-1,125
1,<environment.Job instance at 0x7f92e8656b40>,118,13,[5 5],119,-1,138,-1,125
1,<environment.Job instance at 0x7f92e8656d20>,124,12,[9 3],125,-1,137,-1,125
1,<environment.Job instance at 0x7f92e8652780>,130,17,[5 6],131,-1,150,-1,133
1,<environment.Job instance at 0x7f92e8652320>,131,27,[7 1],132,-1,164,-1,137
1,<environment.Job instance at 0x7f92e8668960>,101,12,[2 6],102,-1,149,-1,137
1,<environment.Job instance at 0x7f92e8652c80>,132,26,[ 3 10],133,-1,163,-1,137
1,<environment.Job instance at 0x7f92e8656960>,115,18,[4 9],116,-1,155,-1,137
1,<environment.Job instance at 0x7f92e8652aa0>,136,15,[10  2],137,-1,153,-1,138
1,<environment.Job instance at 0x7f92e86525a0>,135,21,[ 2 10],136,-1,159,-1,138
1,<environment.Job instance at 0x7f92e89dd280>,110,26,[3 7],111,-1,166,-1,140
1,<environment.Job instance at 0x7f92e86529b0>,140,16,[10  1],141,-1,157,-1,141
1,<environment.Job instance at 0x7f92e8652c30>,141,17,[11  3],142,-1,159,-1,142
1,<environment.Job instance at 0x7f92e8652550>,142,16,[12  1],143,-1,160,-1,144
1,<environment.Job instance at 0x7f92e8652870>,143,15,[ 4 13],144,-1,161,-1,146
1,<environment.Job instance at 0x7f92e825baa0>,6,12,[ 5 12],7,-1,19,-1,7
1,<environment.Job instance at 0x7f92e8b400f0>,9,2,[ 5 14],10,-1,17,-1,15
1,<environment.Job instance at 0x7f92e8656320>,21,16,[ 1 14],22,-1,65,-1,49
1,<environment.Job instance at 0x7f92e8417320>,34,17,[14  5],35,-1,94,-1,77
1,<environment.Job instance at 0x7f92e841bd20>,41,2,[14  5],42,-1,95,-1,93
1,<environment.Job instance at 0x7f92e840fa50>,57,28,[5 9],58,-1,193,-1,165
1,<environment.Job instance at 0x7f92e841f6e0>,67,28,[9 1],68,-1,234,-1,206
1,<environment.Job instance at 0x7f92e841fbe0>,72,26,[5 8],73,-1,247,-1,221
1,<environment.Job instance at 0x7f92e84bf230>,76,2,[ 5 13],77,-1,226,-1,224
1,<environment.Job instance at 0x7f92e83ccb40>,81,1,[13  4],82,-1,241,-1,240
1,<environment.Job instance at 0x7f92e83cc5f0>,88,2,[12  3],89,-1,272,-1,270
1,<environment.Job instance at 0x7f92e83cca00>,87,28,[ 5 10],88,-1,352,-1,324
1,<environment.Job instance at 0x7f92e84fee10>,110,26,[3 7],111,-1,386,-1,360
1,<environment.Job instance at 0x7f92e84feaf0>,111,18,[11  5],112,-1,378,-1,360
1,<environment.Job instance at 0x7f92e83c7230>,119,1,[12  2],120,-1,380,-1,379
1,<environment.Job instance at 0x7f92e827e910>,122,24,[1 9],123,-1,418,-1,394
1,<environment.Job instance at 0x7f92f24be5a0>,131,27,[7 1],132,-1,454,-1,427
1,<environment.Job instance at 0x7f92e8abe2d0>,133,2,[ 3 13],134,-1,429,-1,427
1,<environment.Job instance at 0x7f92e8abe370>,132,26,[ 3 10],133,-1,463,-1,437
1,<environment.Job instance at 0x7f92e91a3e60>,137,1,[ 3 14],138,-1,440,-1,439
1,<environment.Job instance at 0x7f92e8a624b0>,138,12,[ 2 11],139,-1,451,-1,439
1,<environment.Job instance at 0x7f92e8a458c0>,141,17,[11  3],142,-1,469,-1,452
1,<environment.Job instance at 0x7f92e83205f0>,142,16,[12  1],143,-1,468,-1,452
1,<environment.Job instance at 0x7f92e8427a50>,143,15,[ 4 13],144,-1,467,-1,452
1,<environment.Job instance at 0x7f92e8b53870>,0,17,[10  2],1,-1,19,-1,2
1,<environment.Job instance at 0x7f92e9393230>,2,14,[5 1],3,-1,17,-1,3
1,<environment.Job instance at 0x7f92e9393370>,3,24,[2 6],4,-1,28,-1,4
1,<environment.Job instance at 0x7f92e9393820>,4,13,[ 5 12],5,-1,19,-1,6
1,<environment.Job instance at 0x7f92e8b53910>,1,13,[10  2],2,-1,19,-1,6
1,<environment.Job instance at 0x7f92e9393b40>,6,14,[8 4],7,-1,22,-1,8
1,<environment.Job instance at 0x7f92e9393aa0>,7,14,[9 2],8,-1,22,-1,8
1,<environment.Job instance at 0x7f92e9393c30>,14,18,[6 2],15,-1,33,-1,15
1,<environment.Job instance at 0x7f92e93932d0>,15,19,[6 3],16,-1,35,-1,16
1,<environment.Job instance at 0x7f92e8f5eeb0>,21,14,[3 6],22,-1,36,-1,22
1,<environment.Job instance at 0x7f92e8f5e050>,22,27,[5 7],23,-1,50,-1,23
1,<environment.Job instance at 0x7f92e8f5ec80>,25,16,[9 2],26,-1,43,-1,27
1,<environment.Job instance at 0x7f92e8f5ebe0>,26,15,[10  3],27,-1,42,-1,27
1,<environment.Job instance at 0x7f92e8f5e280>,27,15,[9 1],28,-1,44,-1,29
1,<environment.Job instance at 0x7f92e8f5e320>,28,15,[11  4],29,-1,44,-1,29
1,<environment.Job instance at 0x7f92e8abe550>,35,15,[6 2],36,-1,51,-1,36
1,<environment.Job instance at 0x7f92e8abeaf0>,39,17,[6 2],40,-1,58,-1,41
1,<environment.Job instance at 0x7f92e8abebe0>,41,18,[4 9],42,-1,60,-1,42
1,<environment.Job instance at 0x7f92e8a456e0>,42,12,[6 2],43,-1,55,-1,43
1,<environment.Job instance at 0x7f92e8a45a50>,45,16,[6 2],46,-1,62,-1,46
1,<environment.Job instance at 0x7f92e8a45960>,46,16,[8 2],47,-1,63,-1,47
1,<environment.Job instance at 0x7f92e8a45190>,47,14,[11  4],48,-1,62,-1,48
1,<environment.Job instance at 0x7f92e8a45cd0>,48,14,[8 5],49,-1,63,-1,49
1,<environment.Job instance at 0x7f92e8a45280>,49,16,[7 4],50,-1,66,-1,50
1,<environment.Job instance at 0x7f92e8a45640>,50,18,[ 4 11],51,-1,69,-1,51
1,<environment.Job instance at 0x7f92e8a45eb0>,51,18,[ 3 10],52,-1,70,-1,52
1,<environment.Job instance at 0x7f92e8a45050>,53,24,[8 5],54,-1,78,-1,54
1,<environment.Job instance at 0x7f92e8a45730>,54,14,[ 1 10],55,-1,69,-1,55
1,<environment.Job instance at 0x7f92e8a450f0>,55,13,[5 7],56,-1,69,-1,56
1,<environment.Job instance at 0x7f92e8b38410>,59,15,[1 6],60,-1,75,-1,60
1,<environment.Job instance at 0x7f92e8b38c30>,61,15,[8 1],62,-1,77,-1,62
1,<environment.Job instance at 0x7f92e8b38780>,62,16,[5 4],63,-1,79,-1,63
1,<environment.Job instance at 0x7f92e8b38fa0>,63,15,[ 3 10],64,-1,79,-1,64
1,<environment.Job instance at 0x7f92e8b38aa0>,65,15,[5 6],66,-1,81,-1,66
1,<environment.Job instance at 0x7f92e8b38af0>,67,14,[7 2],68,-1,82,-1,68
1,<environment.Job instance at 0x7f92e8b38050>,68,20,[3 9],69,-1,89,-1,69
1,<environment.Job instance at 0x7f92e8b385f0>,70,16,[5 4],71,-1,87,-1,71
1,<environment.Job instance at 0x7f92e8b38320>,71,17,[ 4 10],72,-1,89,-1,72
1,<environment.Job instance at 0x7f92e8e07e60>,77,21,[4 8],78,-1,99,-1,78
1,<environment.Job instance at 0x7f92e8e07370>,78,23,[3 9],79,-1,102,-1,79
1,<environment.Job instance at 0x7f92e8e07af0>,79,13,[10  5],80,-1,93,-1,80
1,<environment.Job instance at 0x7f92e8e070f0>,84,18,[6 4],85,-1,103,-1,85
1,<environment.Job instance at 0x7f92e8e07c80>,85,15,[4 7],86,-1,101,-1,86
1,<environment.Job instance at 0x7f92e8e07d70>,87,17,[8 4],88,-1,105,-1,88
1,<environment.Job instance at 0x7f92e8e07230>,88,16,[1 7],89,-1,105,-1,89
1,<environment.Job instance at 0x7f92e8a6e1e0>,101,16,[8 4],102,-1,118,-1,102
1,<environment.Job instance at 0x7f92e8a6e780>,103,18,[6 4],104,-1,123,-1,105
1,<environment.Job instance at 0x7f92e8abedc0>,40,17,[5 2],41,-1,122,-1,105
1,<environment.Job instance at 0x7f92e8e07f50>,89,15,[ 2 10],90,-1,124,-1,109
1,<environment.Job instance at 0x7f92e9395780>,116,18,[10  5],117,-1,136,-1,118
1,<environment.Job instance at 0x7f92e9395190>,115,21,[9 5],116,-1,139,-1,118
1,<environment.Job instance at 0x7f92e8f92b90>,108,16,[13  3],109,-1,136,-1,120
1,<environment.Job instance at 0x7f92e8df0af0>,117,14,[1 9],118,-1,139,-1,125
1,<environment.Job instance at 0x7f92e90ba7d0>,112,12,[4 7],113,-1,137,-1,125
1,<environment.Job instance at 0x7f92e90a50a0>,122,1,[5 3],123,-1,126,-1,125
1,<environment.Job instance at 0x7f92e8a6edc0>,123,27,[3 5],124,-1,153,-1,126
1,<environment.Job instance at 0x7f92e90cd6e0>,121,16,[1 6],122,-1,143,-1,127
1,<environment.Job instance at 0x7f92e8ac5dc0>,126,12,[4 8],127,-1,139,-1,127
1,<environment.Job instance at 0x7f92e8ac58c0>,127,17,[5 7],128,-1,147,-1,130
1,<environment.Job instance at 0x7f92e8ac54b0>,129,12,[1 9],130,-1,152,-1,140
1,<environment.Job instance at 0x7f92e8a45a00>,58,13,[12  1],59,-1,153,-1,140
1,<environment.Job instance at 0x7f92e8ac50a0>,133,12,[9 3],134,-1,152,-1,140
1,<environment.Job instance at 0x7f92e8e8f6e0>,137,17,[2 6],138,-1,158,-1,141
1,<environment.Job instance at 0x7f92e8e8f870>,138,17,[5 4],139,-1,158,-1,141
1,<environment.Job instance at 0x7f92e8e8faf0>,140,16,[9 4],141,-1,158,-1,142
1,<environment.Job instance at 0x7f92e90f9410>,145,18,[3 9],146,-1,172,-1,154
1,<environment.Job instance at 0x7f92e8b387d0>,4,13,[ 5 12],5,-1,18,-1,5
1,<environment.Job instance at 0x7f92e8b38370>,5,2,[ 2 11],6,-1,8,-1,6
1,<environment.Job instance at 0x7f92e8f5ef50>,3,24,[2 6],4,-1,41,-1,17
1,<environment.Job instance at 0x7f92e9393910>,22,27,[5 7],23,-1,76,-1,49
1,<environment.Job instance at 0x7f92e93937d0>,24,24,[13  2],25,-1,73,-1,49
1,<environment.Job instance at 0x7f92e8a450a0>,28,15,[11  4],29,-1,73,-1,58
1,<environment.Job instance at 0x7f92e88edd20>,31,14,[ 4 13],32,-1,90,-1,76
1,<environment.Job instance at 0x7f92e8508280>,47,14,[11  4],48,-1,154,-1,140
1,<environment.Job instance at 0x7f92e85789b0>,50,18,[ 4 11],51,-1,170,-1,152
1,<environment.Job instance at 0x7f92e838d4b0>,53,24,[8 5],54,-1,198,-1,174
1,<environment.Job instance at 0x7f92e83cc960>,58,13,[12  1],59,-1,201,-1,188
1,<environment.Job instance at 0x7f92e84bfd70>,66,3,[14  2],67,-1,214,-1,211
1,<environment.Job instance at 0x7f92e840f230>,73,14,[ 5 13],74,-1,252,-1,238
1,<environment.Job instance at 0x7f92e840f0f0>,78,23,[3 9],79,-1,291,-1,268
1,<environment.Job instance at 0x7f92e841baf0>,90,2,[ 1 11],91,-1,302,-1,300
1,<environment.Job instance at 0x7f92e8652410>,97,12,[ 3 14],98,-1,340,-1,328
1,<environment.Job instance at 0x7f92e9123b40>,108,16,[13  3],109,-1,374,-1,358
1,<environment.Job instance at 0x7f92e90f9aa0>,123,27,[3 5],124,-1,431,-1,404
1,<environment.Job instance at 0x7f92e90f91e0>,124,1,[12  4],125,-1,405,-1,404
1,<environment.Job instance at 0x7f92e90f9190>,125,2,[14  1],126,-1,406,-1,404
1,<environment.Job instance at 0x7f92e8fe6aa0>,146,27,[10  4],147,-1,521,-1,494
1,<environment.Job instance at 0x7f92e930a8c0>,1,18,[4 8],2,-1,20,-1,2
1,<environment.Job instance at 0x7f92e8f1e280>,6,17,[2 9],7,-1,25,-1,8
1,<environment.Job instance at 0x7f92e8f1e820>,9,14,[4 7],10,-1,24,-1,10
1,<environment.Job instance at 0x7f92e8f1e870>,10,16,[10  3],11,-1,27,-1,11
1,<environment.Job instance at 0x7f92e8f1e370>,11,17,[10  5],12,-1,29,-1,12
1,<environment.Job instance at 0x7f92f230e370>,16,13,[8 5],17,-1,30,-1,17
1,<environment.Job instance at 0x7f92e97531e0>,19,18,[5 2],20,-1,38,-1,20
1,<environment.Job instance at 0x7f92e97eafa0>,25,12,[3 7],26,-1,38,-1,26
1,<environment.Job instance at 0x7f92e97eaa50>,27,16,[2 7],28,-1,44,-1,28
1,<environment.Job instance at 0x7f92e97eae10>,29,14,[7 2],30,-1,44,-1,30
1,<environment.Job instance at 0x7f92e8f1e320>,30,18,[1 7],31,-1,49,-1,31
1,<environment.Job instance at 0x7f92e96aa4b0>,31,14,[1 7],32,-1,46,-1,32
1,<environment.Job instance at 0x7f92e96aa0f0>,32,14,[8 5],33,-1,47,-1,33
1,<environment.Job instance at 0x7f92e96aa550>,35,26,[4 8],36,-1,62,-1,36
1,<environment.Job instance at 0x7f92e96aab40>,36,20,[4 8],37,-1,57,-1,37
1,<environment.Job instance at 0x7f92e9300e60>,38,16,[8 4],39,-1,55,-1,39
1,<environment.Job instance at 0x7f92e93006e0>,40,25,[5 4],41,-1,66,-1,41
1,<environment.Job instance at 0x7f92e9300d70>,41,21,[5 5],42,-1,63,-1,42
1,<environment.Job instance at 0x7f92e9300a00>,43,18,[ 2 10],44,-1,62,-1,44
1,<environment.Job instance at 0x7f92e8f2a050>,45,25,[5 7],46,-1,71,-1,46
1,<environment.Job instance at 0x7f92e9300d20>,47,22,[5 8],48,-1,70,-1,48
1,<environment.Job instance at 0x7f92e939d0f0>,50,15,[3 8],51,-1,66,-1,51
1,<environment.Job instance at 0x7f92e939d4b0>,51,12,[3 9],52,-1,64,-1,52
1,<environment.Job instance at 0x7f92e85cb730>,53,27,[8 5],54,-1,81,-1,54
1,<environment.Job instance at 0x7f92e912e960>,63,24,[3 5],64,-1,88,-1,64
1,<environment.Job instance at 0x7f92e912e140>,64,14,[4 6],65,-1,79,-1,65
1,<environment.Job instance at 0x7f92e912ebe0>,65,14,[10  1],66,-1,80,-1,66
1,<environment.Job instance at 0x7f92f24235a0>,66,15,[3 6],67,-1,82,-1,67
1,<environment.Job instance at 0x7f92f2423500>,67,17,[2 7],68,-1,85,-1,68
1,<environment.Job instance at 0x7f92f24236e0>,68,15,[5 5],69,-1,85,-1,70
1,<environment.Job instance at 0x7f92f24232d0>,71,18,[5 9],72,-1,90,-1,72
1,<environment.Job instance at 0x7f92e979fb40>,73,18,[3 7],74,-1,92,-1,74
1,<environment.Job instance at 0x7f92e979fe10>,74,27,[1 8],75,-1,102,-1,75
1,<environment.Job instance at 0x7f92e979f1e0>,76,15,[5 1],77,-1,92,-1,77
1,<environment.Job instance at 0x7f92e979f5a0>,78,12,[1 8],79,-1,91,-1,79
1,<environment.Job instance at 0x7f92e9028e60>,80,18,[2 7],81,-1,99,-1,81
1,<environment.Job instance at 0x7f92e90289b0>,81,15,[6 3],82,-1,97,-1,82
1,<environment.Job instance at 0x7f92e86c2500>,84,23,[4 5],85,-1,108,-1,85
1,<environment.Job instance at 0x7f92e8efd0a0>,85,13,[8 4],86,-1,99,-1,86
1,<environment.Job instance at 0x7f92e88208c0>,87,13,[12  5],88,-1,101,-1,88
1,<environment.Job instance at 0x7f92e8820500>,88,12,[5 5],89,-1,101,-1,89
1,<environment.Job instance at 0x7f92e8820f00>,89,18,[7 4],90,-1,108,-1,90
1,<environment.Job instance at 0x7f92e921d730>,94,18,[3 6],95,-1,113,-1,95
1,<environment.Job instance at 0x7f92e8975dc0>,96,26,[8 5],97,-1,125,-1,99
1,<environment.Job instance at 0x7f92e932b0f0>,99,20,[6 3],100,-1,120,-1,100
1,<environment.Job instance at 0x7f92e93671e0>,100,17,[5 8],101,-1,118,-1,101
1,<environment.Job instance at 0x7f92e9130780>,103,20,[5 3],104,-1,124,-1,104
1,<environment.Job instance at 0x7f92e880cfa0>,104,16,[2 7],105,-1,121,-1,105
1,<environment.Job instance at 0x7f92e880cf50>,105,17,[6 3],106,-1,123,-1,106
1,<environment.Job instance at 0x7f92e880c280>,106,14,[10  1],107,-1,125,-1,111
1,<environment.Job instance at 0x7f92e88f6b90>,111,17,[2 9],112,-1,129,-1,112
1,<environment.Job instance at 0x7f92e88f6aa0>,117,22,[10  1],118,-1,140,-1,118
1,<environment.Job instance at 0x7f92e8675a00>,140,15,[13  3],141,-1,450,-1,435
1,<environment.Job instance at 0x7f92e8626910>,146,12,[12  4],147,-1,469,-1,457
1,<environment.Job instance at 0x7f92e8675f50>,139,22,[7 3],140,-1,479,-1,457
1,<environment.Job instance at 0x7f92e8e010f0>,0,1,[ 5 11],1,-1,2,-1,1
1,<environment.Job instance at 0x7f92e9753910>,2,25,[7 3],3,-1,28,-1,3
1,<environment.Job instance at 0x7f92e8f3fe10>,4,13,[ 3 12],5,-1,18,-1,5
1,<environment.Job instance at 0x7f92e921dd70>,18,14,[13  2],19,-1,58,-1,44
1,<environment.Job instance at 0x7f92e86c1cd0>,35,26,[4 8],36,-1,138,-1,112
1,<environment.Job instance at 0x7f92e8fe6be0>,40,25,[5 4],41,-1,143,-1,118
1,<environment.Job instance at 0x7f92e8fe6690>,45,25,[5 7],46,-1,157,-1,132
1,<environment.Job instance at 0x7f92e89e7af0>,49,3,[11  3],50,-1,147,-1,144
1,<environment.Job instance at 0x7f92e840f190>,53,27,[8 5],54,-1,182,-1,155
1,<environment.Job instance at 0x7f92e840ffa0>,54,12,[ 5 13],55,-1,167,-1,155
1,<environment.Job instance at 0x7f92e840f820>,59,1,[12  4],60,-1,162,-1,161
1,<environment.Job instance at 0x7f92e840feb0>,63,24,[3 5],64,-1,190,-1,166
1,<environment.Job instance at 0x7f92e8295780>,74,27,[1 8],75,-1,239,-1,212
1,<environment.Job instance at 0x7f92e8ba51e0>,84,23,[4 5],85,-1,268,-1,245
1,<environment.Job instance at 0x7f92e84460a0>,87,13,[12  5],88,-1,261,-1,248
1,<environment.Job instance at 0x7f92e8446f50>,93,14,[ 4 11],94,-1,289,-1,275
1,<environment.Job instance at 0x7f92e8446460>,96,26,[8 5],97,-1,319,-1,293
1,<environment.Job instance at 0x7f92e8446320>,98,18,[13  1],99,-1,311,-1,293
1,<environment.Job instance at 0x7f92e918d500>,118,16,[13  1],119,-1,371,-1,355
1,<environment.Job instance at 0x7f92e918df50>,121,3,[11  4],122,-1,377,-1,374
1,<environment.Job instance at 0x7f92e8bac0f0>,126,26,[9 5],127,-1,415,-1,389
1,<environment.Job instance at 0x7f92e8bac2d0>,137,1,[ 4 12],138,-1,424,-1,423
1,<environment.Job instance at 0x7f92e8955370>,140,15,[13  3],141,-1,443,-1,428
1,<environment.Job instance at 0x7f92e8955230>,142,25,[7 5],143,-1,459,-1,434
1,<environment.Job instance at 0x7f92e8955640>,143,2,[14  5],144,-1,436,-1,434
1,<environment.Job instance at 0x7f92e8955f00>,144,2,[13  4],145,-1,436,-1,434
1,<environment.Job instance at 0x7f92e8955c80>,146,12,[12  4],147,-1,446,-1,434
1,<environment.Job instance at 0x7f92e8e12b90>,0,16,[ 2 10],1,-1,20,-1,4
1,<environment.Job instance at 0x7f92e8e120a0>,3,15,[4 8],4,-1,19,-1,4
1,<environment.Job instance at 0x7f92e84a46e0>,6,18,[5 8],7,-1,26,-1,8
1,<environment.Job instance at 0x7f92e84a4cd0>,9,17,[ 2 10],10,-1,27,-1,10
1,<environment.Job instance at 0x7f92e85a6eb0>,11,18,[8 1],12,-1,30,-1,12
1,<environment.Job instance at 0x7f92e85a68c0>,12,15,[3 9],13,-1,28,-1,13
1,<environment.Job instance at 0x7f92e84a4870>,13,20,[8 4],14,-1,34,-1,14
1,<environment.Job instance at 0x7f92e85b8190>,7,13,[5 8],8,-1,29,-1,16
1,<environment.Job instance at 0x7f92e8c1f190>,17,27,[8 5],18,-1,45,-1,18
1,<environment.Job instance at 0x7f92e8c2d460>,21,15,[2 7],22,-1,38,-1,23
1,<environment.Job instance at 0x7f92e8c2d2d0>,22,17,[3 5],23,-1,42,-1,25
1,<environment.Job instance at 0x7f92e9738cd0>,25,13,[10  5],26,-1,40,-1,27
1,<environment.Job instance at 0x7f92e97389b0>,26,17,[7 3],27,-1,44,-1,27
1,<environment.Job instance at 0x7f92e97320f0>,31,17,[9 4],32,-1,49,-1,32
1,<environment.Job instance at 0x7f92e8c0d6e0>,32,24,[4 6],33,-1,57,-1,33
1,<environment.Job instance at 0x7f92e8c09aa0>,35,14,[10  1],36,-1,51,-1,37
1,<environment.Job instance at 0x7f92e8abf2d0>,37,18,[14  1],38,-1,56,-1,38
1,<environment.Job instance at 0x7f92e8abfb90>,38,1,[1 9],39,-1,40,-1,39
1,<environment.Job instance at 0x7f92e8abf5f0>,39,1,[3 6],40,-1,41,-1,40
1,<environment.Job instance at 0x7f92e974c960>,40,16,[5 4],41,-1,57,-1,41
1,<environment.Job instance at 0x7f92e974c2d0>,41,18,[7 2],42,-1,60,-1,42
1,<environment.Job instance at 0x7f92e8ae00f0>,42,12,[5 2],43,-1,55,-1,43
1,<environment.Job instance at 0x7f92e8abd6e0>,49,18,[ 5 10],50,-1,80,-1,62
1,<environment.Job instance at 0x7f92e8c0df00>,33,15,[ 2 13],34,-1,96,-1,81
1,<environment.Job instance at 0x7f92e8aed230>,57,17,[6 2],58,-1,100,-1,83
1,<environment.Job instance at 0x7f92e8aed370>,58,16,[6 5],59,-1,99,-1,83
1,<environment.Job instance at 0x7f92e8aed0f0>,60,25,[10  4],61,-1,108,-1,83
1,<environment.Job instance at 0x7f92e8af5370>,64,13,[5 7],65,-1,97,-1,84
1,<environment.Job instance at 0x7f92e8af5550>,65,17,[8 5],66,-1,109,-1,92
1,<environment.Job instance at 0x7f92e8abda50>,53,16,[6 1],54,-1,115,-1,99
1,<environment.Job instance at 0x7f92e8af5870>,72,15,[4 9],73,-1,117,-1,102
1,<environment.Job instance at 0x7f92e8ac3af0>,46,15,[11  2],47,-1,117,-1,102
1,<environment.Job instance at 0x7f92e8af5be0>,75,15,[7 1],76,-1,117,-1,102
1,<environment.Job instance at 0x7f92e8af5c80>,76,16,[7 5],77,-1,164,-1,148
1,<environment.Job instance at 0x7f92e8aed140>,56,13,[8 4],57,-1,161,-1,148
1,<environment.Job instance at 0x7f92e9359370>,86,20,[10  4],87,-1,172,-1,152
1,<environment.Job instance at 0x7f92e8af5b90>,77,16,[13  1],78,-1,168,-1,152
1,<environment.Job instance at 0x7f92e9359870>,90,27,[ 3 13],91,-1,179,-1,152
1,<environment.Job instance at 0x7f92e9359910>,91,13,[5 2],92,-1,165,-1,152
1,<environment.Job instance at 0x7f92e8af5910>,73,18,[8 3],74,-1,170,-1,152
1,<environment.Job instance at 0x7f92e9359be0>,92,18,[5 3],93,-1,170,-1,152
1,<environment.Job instance at 0x7f92e9359c30>,94,18,[6 3],95,-1,170,-1,152
1,<environment.Job instance at 0x7f92e9359eb0>,95,18,[ 3 12],96,-1,170,-1,152
1,<environment.Job instance at 0x7f92e93597d0>,89,14,[7 5],90,-1,166,-1,152
1,<environment.Job instance at 0x7f92e9333690>,102,17,[5 9],103,-1,182,-1,165
1,<environment.Job instance at 0x7f92e9333500>,103,18,[5 5],104,-1,183,-1,165
1,<environment.Job instance at 0x7f92e9333140>,101,25,[9 1],102,-1,190,-1,165
1,<environment.Job instance at 0x7f92e93337d0>,105,17,[6 4],106,-1,188,-1,171
1,<environment.Job instance at 0x7f92e93339b0>,108,18,[ 3 10],109,-1,189,-1,171
1,<environment.Job instance at 0x7f92e9333dc0>,113,28,[8 2],114,-1,597,-1,569
1,<environment.Job instance at 0x7f92e9331cd0>,133,19,[7 1],134,-1,592,-1,573
1,<environment.Job instance at 0x7f92e9320370>,143,27,[5 1],144,-1,602,-1,575
1,<environment.Job instance at 0x7f92e9320550>,144,15,[5 5],145,-1,590,-1,575
1,<environment.Job instance at 0x7f92e93204b0>,145,14,[5 9],146,-1,589,-1,575
1,<environment.Job instance at 0x7f92e93315a0>,139,13,[5 8],140,-1,588,-1,575
1,<environment.Job instance at 0x7f92e9333af0>,110,27,[5 4],111,-1,605,-1,578
1,<environment.Job instance at 0x7f92e9333b90>,111,28,[7 5],112,-1,606,-1,578
1,<environment.Job instance at 0x7f92e9320190>,140,17,[ 5 13],141,-1,595,-1,578
1,<environment.Job instance at 0x7f92e8af52d0>,5,15,[ 4 12],6,-1,21,-1,6
1,<environment.Job instance at 0x7f92e9320b90>,17,27,[8 5],18,-1,86,-1,59
1,<environment.Job instance at 0x7f92e932d780>,29,2,[ 2 12],30,-1,93,-1,91
1,<environment.Job instance at 0x7f92e932d960>,32,24,[4 6],33,-1,131,-1,107
1,<environment.Job instance at 0x7f92e8955730>,33,15,[ 2 13],34,-1,122,-1,107
1,<environment.Job instance at 0x7f92e89558c0>,37,18,[14  1],38,-1,126,-1,108
1,<environment.Job instance at 0x7f92e8bac320>,43,13,[ 3 11],44,-1,151,-1,138
1,<environment.Job instance at 0x7f92e8bacbe0>,46,15,[11  2],47,-1,157,-1,142
1,<environment.Job instance at 0x7f92e8bac780>,50,12,[ 3 12],51,-1,171,-1,159
1,<environment.Job instance at 0x7f92f23697d0>,60,25,[10  4],61,-1,251,-1,226
1,<environment.Job instance at 0x7f92e8446c80>,77,16,[13  1],78,-1,284,-1,268
1,<environment.Job instance at 0x7f92e84463c0>,81,2,[13  4],82,-1,292,-1,290
1,<environment.Job instance at 0x7f92e89fff50>,90,27,[ 3 13],91,-1,345,-1,318
1,<environment.Job instance at 0x7f92e90baa50>,93,27,[1 7],94,-1,359,-1,332
1,<environment.Job instance at 0x7f92e8295410>,95,18,[ 3 12],96,-1,359,-1,341
1,<environment.Job instance at 0x7f92e83cc910>,100,1,[12  1],101,-1,361,-1,360
1,<environment.Job instance at 0x7f92e83cc4b0>,101,25,[9 1],102,-1,392,-1,367
1,<environment.Job instance at 0x7f92e840f2d0>,110,27,[5 4],111,-1,450,-1,423
1,<environment.Job instance at 0x7f92e840fe10>,111,28,[7 5],112,-1,451,-1,423
1,<environment.Job instance at 0x7f92e840f320>,113,28,[8 2],114,-1,452,-1,424
1,<environment.Job instance at 0x7f92e8622af0>,131,1,[ 5 14],132,-1,491,-1,490
1,<environment.Job instance at 0x7f92e891b8c0>,140,17,[ 5 13],141,-1,535,-1,518
1,<environment.Job instance at 0x7f92e92925f0>,143,27,[5 1],144,-1,558,-1,531
1,<environment.Job instance at 0x7f92e89756e0>,146,2,[ 5 12],147,-1,540,-1,538
1,<environment.Job instance at 0x7f92e88710a0>,3,18,[6 4],4,-1,22,-1,4
1,<environment.Job instance at 0x7f92e8871780>,4,18,[9 1],5,-1,23,-1,5
1,<environment.Job instance at 0x7f92e8871870>,7,12,[3 8],8,-1,20,-1,8
1,<environment.Job instance at 0x7f92e88719b0>,8,16,[1 7],9,-1,25,-1,9
1,<environment.Job instance at 0x7f92e8871410>,10,18,[2 9],11,-1,29,-1,11
1,<environment.Job instance at 0x7f92e94d45f0>,17,26,[3 7],18,-1,44,-1,18
1,<environment.Job instance at 0x7f92e94d46e0>,20,13,[1 6],21,-1,34,-1,21
1,<environment.Job instance at 0x7f92e8aa75a0>,29,25,[3 8],30,-1,56,-1,31
1,<environment.Job instance at 0x7f92e8aa7b90>,24,17,[5 1],25,-1,48,-1,31
1,<environment.Job instance at 0x7f92e86b3140>,31,17,[7 4],32,-1,49,-1,32
1,<environment.Job instance at 0x7f92e86b31e0>,32,15,[3 6],33,-1,48,-1,33
1,<environment.Job instance at 0x7f92e86b3870>,37,28,[4 9],38,-1,66,-1,38
1,<environment.Job instance at 0x7f92e86b3460>,35,18,[8 2],36,-1,60,-1,42
1,<environment.Job instance at 0x7f92e956a0a0>,42,13,[9 3],43,-1,56,-1,43
1,<environment.Job instance at 0x7f92e86b3500>,41,18,[13  5],42,-1,65,-1,47
1,<environment.Job instance at 0x7f92e956ab90>,46,15,[10  2],47,-1,67,-1,52
1,<environment.Job instance at 0x7f92e87cef50>,60,18,[2 8],61,-1,100,-1,82
1,<environment.Job instance at 0x7f92e87ce910>,52,3,[2 8],53,-1,88,-1,85
1,<environment.Job instance at 0x7f92e8ad4d70>,64,15,[7 2],65,-1,101,-1,86
1,<environment.Job instance at 0x7f92e8ad4730>,65,18,[9 1],66,-1,106,-1,88
1,<environment.Job instance at 0x7f92e8ad4a50>,66,3,[4 7],67,-1,91,-1,88
1,<environment.Job instance at 0x7f92e8ad41e0>,67,12,[9 1],68,-1,100,-1,88
1,<environment.Job instance at 0x7f92e8aa7d20>,26,18,[5 4],27,-1,106,-1,88
1,<environment.Job instance at 0x7f92e8f53140>,63,14,[5 7],64,-1,102,-1,88
1,<environment.Job instance at 0x7f92e87ce410>,58,16,[10  1],59,-1,104,-1,88
1,<environment.Job instance at 0x7f92e8ad4dc0>,70,15,[5 8],71,-1,104,-1,89
1,<environment.Job instance at 0x7f92e88efb90>,74,21,[8 1],75,-1,110,-1,89
1,<environment.Job instance at 0x7f92e88465f0>,81,12,[ 1 10],82,-1,129,-1,117
1,<environment.Job instance at 0x7f92e8220410>,85,15,[9 4],86,-1,132,-1,117
1,<environment.Job instance at 0x7f92e9218320>,86,15,[4 7],87,-1,132,-1,117
1,<environment.Job instance at 0x7f92e89036e0>,90,15,[4 8],91,-1,132,-1,117
1,<environment.Job instance at 0x7f92e9175230>,91,3,[9 5],92,-1,120,-1,117
1,<environment.Job instance at 0x7f92e8846f00>,87,23,[9 2],88,-1,140,-1,117
1,<environment.Job instance at 0x7f92e978a050>,94,1,[1 8],95,-1,118,-1,117
1,<environment.Job instance at 0x7f92e8f9c460>,93,17,[7 4],94,-1,134,-1,117
1,<environment.Job instance at 0x7f92e95f7cd0>,80,18,[ 2 11],81,-1,135,-1,117
1,<environment.Job instance at 0x7f92f1f2a1e0>,98,16,[6 5],99,-1,133,-1,117
1,<environment.Job instance at 0x7f92e8da5320>,100,15,[7 2],101,-1,132,-1,117
1,<environment.Job instance at 0x7f92e92c8b90>,96,3,[1 7],97,-1,120,-1,117
1,<environment.Job instance at 0x7f92e8955870>,95,15,[9 1],96,-1,132,-1,117
1,<environment.Job instance at 0x7f92e9870fa0>,102,18,[ 2 10],103,-1,135,-1,117
1,<environment.Job instance at 0x7f92e9252aa0>,104,12,[9 4],105,-1,129,-1,117
1,<environment.Job instance at 0x7f92e9252190>,106,17,[ 1 14],107,-1,134,-1,117
1,<environment.Job instance at 0x7f92e9252e10>,107,15,[1 6],108,-1,132,-1,117
1,<environment.Job instance at 0x7f92e9252fa0>,109,18,[14  4],110,-1,142,-1,124
1,<environment.Job instance at 0x7f92e92525f0>,103,14,[4 9],104,-1,138,-1,124
1,<environment.Job instance at 0x7f92e9252460>,113,24,[4 7],114,-1,148,-1,124
1,<environment.Job instance at 0x7f92e9252640>,114,16,[4 7],115,-1,141,-1,125
1,<environment.Job instance at 0x7f92e9252a00>,111,18,[5 5],112,-1,143,-1,125
1,<environment.Job instance at 0x7f92e8845460>,79,25,[ 3 10],80,-1,152,-1,127
1,<environment.Job instance at 0x7f92f21d0f50>,118,23,[ 4 10],119,-1,150,-1,127
1,<environment.Job instance at 0x7f92e9252960>,110,16,[3 7],111,-1,143,-1,127
1,<environment.Job instance at 0x7f92e9396550>,127,18,[3 9],128,-1,151,-1,133
1,<environment.Job instance at 0x7f92e9252a50>,115,3,[6 4],116,-1,150,-1,147
1,<environment.Job instance at 0x7f92e86c22d0>,125,13,[ 3 12],126,-1,160,-1,147
1,<environment.Job instance at 0x7f92e9396f50>,133,24,[3 5],134,-1,171,-1,147
1,<environment.Job instance at 0x7f92e8c8a550>,122,14,[4 9],123,-1,161,-1,147
1,<environment.Job instance at 0x7f92e82ec140>,84,17,[5 4],85,-1,167,-1,150
1,<environment.Job instance at 0x7f92e9396780>,135,16,[5 5],136,-1,166,-1,150
1,<environment.Job instance at 0x7f92e8e12f00>,138,17,[10  4],139,-1,167,-1,150
1,<environment.Job instance at 0x7f92e8e124b0>,140,14,[2 8],141,-1,164,-1,150
1,<environment.Job instance at 0x7f92e8e12dc0>,141,17,[4 7],142,-1,167,-1,150
1,<environment.Job instance at 0x7f92e9396910>,132,15,[ 1 10],133,-1,165,-1,150
1,<environment.Job instance at 0x7f92e8e12be0>,143,17,[4 9],144,-1,168,-1,151
1,<environment.Job instance at 0x7f92e8fa8f50>,148,16,[9 2],149,-1,167,-1,151
1,<environment.Job instance at 0x7f92e8aa7af0>,5,17,[14  4],6,-1,23,-1,6
1,<environment.Job instance at 0x7f92e9408d20>,11,12,[13  5],12,-1,30,-1,18
1,<environment.Job instance at 0x7f92e8ad4960>,17,26,[3 7],18,-1,73,-1,47
1,<environment.Job instance at 0x7f92e9396960>,27,1,[ 2 11],28,-1,67,-1,66
1,<environment.Job instance at 0x7f92e8fa89b0>,29,25,[3 8],30,-1,92,-1,67
1,<environment.Job instance at 0x7f92e86c1c80>,37,28,[4 9],38,-1,124,-1,96
1,<environment.Job instance at 0x7f92e8622c30>,41,18,[13  5],42,-1,118,-1,100
1,<environment.Job instance at 0x7f92e8549d20>,45,14,[11  2],46,-1,129,-1,115
1,<environment.Job instance at 0x7f92e8fe6550>,48,1,[14  2],49,-1,119,-1,118
1,<environment.Job instance at 0x7f92e8fe6e60>,49,1,[ 1 11],50,-1,119,-1,118
1,<environment.Job instance at 0x7f92e918de10>,80,18,[ 2 11],81,-1,247,-1,229
1,<environment.Job instance at 0x7f92e918d280>,79,25,[ 3 10],80,-1,265,-1,240
1,<environment.Job instance at 0x7f92e8bacbe0>,87,23,[9 2],88,-1,285,-1,262
1,<environment.Job instance at 0x7f92e932d6e0>,106,17,[ 1 14],107,-1,338,-1,321
1,<environment.Job instance at 0x7f92e932d1e0>,109,18,[14  4],110,-1,345,-1,327
1,<environment.Job instance at 0x7f92e9320fa0>,113,24,[4 7],114,-1,380,-1,356
1,<environment.Job instance at 0x7f92e8693f50>,125,13,[ 3 12],126,-1,387,-1,374
1,<environment.Job instance at 0x7f92e9359a50>,126,13,[ 4 12],127,-1,387,-1,374
1,<environment.Job instance at 0x7f92e9320e60>,118,23,[ 4 10],119,-1,410,-1,387
1,<environment.Job instance at 0x7f92e875c8c0>,133,24,[3 5],134,-1,419,-1,395
1,<environment.Job instance at 0x7f92e93637d0>,0,26,[4 8],1,-1,27,-1,1
1,<environment.Job instance at 0x7f92e9363f00>,1,16,[2 7],2,-1,18,-1,2
1,<environment.Job instance at 0x7f92e82b8190>,8,13,[ 5 10],9,-1,23,-1,10
1,<environment.Job instance at 0x7f92e82b8640>,10,18,[8 5],11,-1,29,-1,11
1,<environment.Job instance at 0x7f92e82b8820>,12,18,[4 5],13,-1,31,-1,13
1,<environment.Job instance at 0x7f92e82b89b0>,13,18,[8 1],14,-1,32,-1,14
1,<environment.Job instance at 0x7f92e82b8b90>,14,13,[4 6],15,-1,28,-1,15
1,<environment.Job instance at 0x7f92e82b87d0>,16,13,[5 6],17,-1,33,-1,20
1,<environment.Job instance at 0x7f92e82b8730>,22,16,[3 5],23,-1,39,-1,23
1,<environment.Job instance at 0x7f92f1eb1eb0>,25,22,[1 9],26,-1,48,-1,26
1,<environment.Job instance at 0x7f92f1eb1640>,29,18,[ 3 12],30,-1,48,-1,30
1,<environment.Job instance at 0x7f92f1eb1140>,30,18,[7 3],31,-1,49,-1,31
1,<environment.Job instance at 0x7f92f1eb1960>,33,17,[10  3],34,-1,51,-1,34
1,<environment.Job instance at 0x7f92f1eb1c80>,36,12,[4 7],37,-1,49,-1,37
1,<environment.Job instance at 0x7f92e7fca410>,37,15,[6 4],38,-1,53,-1,38
1,<environment.Job instance at 0x7f92e7fcaf00>,38,17,[3 8],39,-1,56,-1,39
1,<environment.Job instance at 0x7f92e7fca550>,39,15,[ 5 10],40,-1,55,-1,40
1,<environment.Job instance at 0x7f92e7fcaaf0>,40,19,[5 4],41,-1,60,-1,41
1,<environment.Job instance at 0x7f92e7fca1e0>,41,17,[ 2 10],42,-1,59,-1,42
1,<environment.Job instance at 0x7f92e7fcac80>,43,18,[9 2],44,-1,62,-1,44
1,<environment.Job instance at 0x7f92e7fca230>,44,24,[5 9],45,-1,69,-1,45
1,<environment.Job instance at 0x7f92e7fcae60>,45,16,[10  3],46,-1,65,-1,49
1,<environment.Job instance at 0x7f92e82b8cd0>,18,17,[10  4],19,-1,75,-1,58
1,<environment.Job instance at 0x7f92e7fca2d0>,50,17,[10  1],51,-1,75,-1,58
1,<environment.Job instance at 0x7f92e7fcad70>,49,15,[6 5],50,-1,73,-1,58
1,<environment.Job instance at 0x7f92e7fca500>,53,26,[7 5],54,-1,84,-1,58
1,<environment.Job instance at 0x7f92e7fcad20>,54,16,[3 9],55,-1,74,-1,58
1,<environment.Job instance at 0x7f92e7fca640>,56,20,[3 6],57,-1,78,-1,58
1,<environment.Job instance at 0x7f92e8281eb0>,57,18,[ 3 10],58,-1,76,-1,58
1,<environment.Job instance at 0x7f92e8281a50>,58,16,[3 5],59,-1,77,-1,61
1,<environment.Job instance at 0x7f92e82810f0>,59,16,[8 5],60,-1,78,-1,62
1,<environment.Job instance at 0x7f92e8281370>,62,18,[4 7],63,-1,81,-1,63
1,<environment.Job instance at 0x7f92e8281b40>,65,17,[9 3],66,-1,83,-1,66
1,<environment.Job instance at 0x7f92e8020780>,69,15,[5 5],70,-1,85,-1,70
1,<environment.Job instance at 0x7f92e7fcab40>,48,3,[1 9],49,-1,73,-1,70
1,<environment.Job instance at 0x7f92e80204b0>,71,12,[10  4],72,-1,84,-1,72
1,<environment.Job instance at 0x7f92e82b5500>,78,16,[ 5 13],79,-1,95,-1,79
1,<environment.Job instance at 0x7f92e82b5960>,84,17,[5 9],85,-1,102,-1,85
1,<environment.Job instance at 0x7f92e7fca8c0>,47,26,[8 5],48,-1,112,-1,86
1,<environment.Job instance at 0x7f92e82b5640>,82,13,[7 3],83,-1,99,-1,86
1,<environment.Job instance at 0x7f92e82b5f50>,86,23,[10  4],87,-1,110,-1,87
1,<environment.Job instance at 0x7f92e82b5d70>,87,15,[5 5],88,-1,103,-1,88
1,<environment.Job instance at 0x7f92e82b5dc0>,88,17,[4 9],89,-1,106,-1,89
1,<environment.Job instance at 0x7f92e82b57d0>,89,18,[9 5],90,-1,108,-1,90
1,<environment.Job instance at 0x7f92e82b5f00>,91,17,[8 2],92,-1,109,-1,92
1,<environment.Job instance at 0x7f92e80310a0>,92,18,[10  5],93,-1,111,-1,93
1,<environment.Job instance at 0x7f92e82b5a00>,85,17,[5 9],86,-1,112,-1,95
1,<environment.Job instance at 0x7f92e8031a00>,95,16,[3 8],96,-1,113,-1,97
1,<environment.Job instance at 0x7f92e8031190>,97,18,[5 4],98,-1,116,-1,98
1,<environment.Job instance at 0x7f92e82b3b90>,101,17,[7 2],102,-1,119,-1,102
1,<environment.Job instance at 0x7f92e82b3d20>,103,16,[3 9],104,-1,120,-1,104
1,<environment.Job instance at 0x7f92e80d5af0>,109,25,[8 3],110,-1,138,-1,113
1,<environment.Job instance at 0x7f92e88f9a50>,111,17,[3 7],112,-1,130,-1,113
1,<environment.Job instance at 0x7f92f2444870>,112,24,[11  1],113,-1,138,-1,114
1,<environment.Job instance at 0x7f92e86fbe60>,105,13,[ 3 10],106,-1,128,-1,115
1,<environment.Job instance at 0x7f92e89bb690>,113,18,[2 6],114,-1,133,-1,115
1,<environment.Job instance at 0x7f92e92e4870>,116,17,[1 6],117,-1,134,-1,117
1,<environment.Job instance at 0x7f92e9830d20>,120,14,[6 3],121,-1,141,-1,127
1,<environment.Job instance at 0x7f92e8412aa0>,121,15,[10  5],122,-1,142,-1,127
1,<environment.Job instance at 0x7f92e7fca3c0>,52,13,[9 1],53,-1,140,-1,127
1,<environment.Job instance at 0x7f92e8564550>,122,18,[10  1],123,-1,146,-1,128
1,<environment.Job instance at 0x7f92f1e9b230>,118,17,[3 5],119,-1,154,-1,137
1,<environment.Job instance at 0x7f92e8a610a0>,126,3,[7 4],127,-1,140,-1,137
1,<environment.Job instance at 0x7f92e97d6a00>,128,2,[8 3],129,-1,139,-1,137
1,<environment.Job instance at 0x7f92e867cf50>,129,1,[ 3 10],130,-1,138,-1,137
1,<environment.Job instance at 0x7f92e965c370>,130,2,[8 2],131,-1,139,-1,137
1,<environment.Job instance at 0x7f92e8b4f050>,131,18,[7 1],132,-1,155,-1,137
1,<environment.Job instance at 0x7f92e97d66e0>,132,1,[4 6],133,-1,138,-1,137
1,<environment.Job instance at 0x7f92e9381870>,133,18,[ 3 10],134,-1,156,-1,138
1,<environment.Job instance at 0x7f92e8165d20>,134,1,[5 8],135,-1,139,-1,138
1,<environment.Job instance at 0x7f92e93811e0>,135,3,[7 3],136,-1,141,-1,138
1,<environment.Job instance at 0x7f92e92d3d20>,136,2,[5 5],137,-1,140,-1,138
1,<environment.Job instance at 0x7f92e8f3b5a0>,137,3,[ 1 10],138,-1,141,-1,138
1,<environment.Job instance at 0x7f92e89bb230>,114,18,[8 2],115,-1,156,-1,138
1,<environment.Job instance at 0x7f92e93c2550>,138,12,[10  2],139,-1,154,-1,142
1,<environment.Job instance at 0x7f92e94b6f00>,142,14,[ 1 10],143,-1,157,-1,143
1,<environment.Job instance at 0x7f92e91fe640>,145,15,[10  1],146,-1,161,-1,146
1,<environment.Job instance at 0x7f92e91fe370>,146,21,[3 7],147,-1,168,-1,147
1,<environment.Job instance at 0x7f92e91fe280>,147,15,[ 3 10],148,-1,163,-1,148
1,<environment.Job instance at 0x7f92e91fef50>,148,28,[8 3],149,-1,177,-1,149
1,<environment.Job instance at 0x7f92e82b81e0>,0,26,[4 8],1,-1,27,-1,1
1,<environment.Job instance at 0x7f92e8031230>,15,15,[12  1],16,-1,52,-1,37
1,<environment.Job instance at 0x7f92e932dc80>,23,1,[ 3 13],24,-1,74,-1,73
1,<environment.Job instance at 0x7f92e891b280>,29,18,[ 3 12],30,-1,104,-1,86
1,<environment.Job instance at 0x7f92e9701f00>,35,1,[ 5 13],36,-1,104,-1,103
1,<environment.Job instance at 0x7f92e83cc0a0>,44,24,[5 9],45,-1,176,-1,152
1,<environment.Job instance at 0x7f92e83cc910>,47,26,[8 5],48,-1,196,-1,170
1,<environment.Job instance at 0x7f92e806f5a0>,53,26,[7 5],54,-1,215,-1,189
1,<environment.Job instance at 0x7f92e7f31dc0>,55,2,[13  2],56,-1,191,-1,189
1,<environment.Job instance at 0x7f92e8671c80>,63,3,[11  3],64,-1,226,-1,223
1,<environment.Job instance at 0x7f92e80e3b90>,78,16,[ 5 13],79,-1,283,-1,267
1,<environment.Job instance at 0x7f92f1f31dc0>,81,15,[14  4],82,-1,285,-1,270
1,<environment.Job instance at 0x7f92e8d7a320>,86,23,[10  4],87,-1,315,-1,292
1,<environment.Job instance at 0x7f92e8c5d7d0>,109,25,[8 3],110,-1,430,-1,405
1,<environment.Job instance at 0x7f92e90e0730>,112,24,[11  1],113,-1,429,-1,405
1,<environment.Job instance at 0x7f92e9396960>,143,2,[12  1],144,-1,523,-1,521
1,<environment.Job instance at 0x7f92e92a10f0>,144,1,[ 5 14],145,-1,522,-1,521
1,<environment.Job instance at 0x7f92e855b1e0>,148,28,[8 3],149,-1,567,-1,539
1,<environment.Job instance at 0x7f92e8176320>,1,17,[5 6],2,-1,19,-1,2
1,<environment.Job instance at 0x7f92e8176c80>,2,16,[10  1],3,-1,20,-1,4
1,<environment.Job instance at 0x7f92e81768c0>,4,12,[4 9],5,-1,17,-1,5
1,<environment.Job instance at 0x7f92e8176640>,5,12,[7 2],6,-1,18,-1,6
1,<environment.Job instance at 0x7f92e81762d0>,6,13,[ 5 11],7,-1,20,-1,7
1,<environment.Job instance at 0x7f92e8176780>,3,17,[ 2 10],4,-1,25,-1,8
1,<environment.Job instance at 0x7f92e8176a00>,8,15,[10  2],9,-1,25,-1,10
1,<environment.Job instance at 0x7f92e81875a0>,9,18,[3 8],10,-1,29,-1,11
1,<environment.Job instance at 0x7f92e81875f0>,11,18,[4 6],12,-1,30,-1,12
1,<environment.Job instance at 0x7f92e8187d70>,16,13,[8 3],17,-1,30,-1,17
1,<environment.Job instance at 0x7f92e8187cd0>,17,12,[ 3 10],18,-1,30,-1,18
1,<environment.Job instance at 0x7f92e8187280>,18,15,[8 2],19,-1,34,-1,19
1,<environment.Job instance at 0x7f92e867d2d0>,23,12,[5 9],24,-1,37,-1,25
1,<environment.Job instance at 0x7f92e867d410>,27,2,[1 5],28,-1,30,-1,28
1,<environment.Job instance at 0x7f92e867df50>,29,20,[2 8],30,-1,50,-1,30
1,<environment.Job instance at 0x7f92e81873c0>,24,16,[1 8],25,-1,46,-1,30
1,<environment.Job instance at 0x7f92f1e9db90>,41,23,[5 9],42,-1,71,-1,48
1,<environment.Job instance at 0x7f92f1e9d7d0>,34,13,[10  5],35,-1,63,-1,50
1,<environment.Job instance at 0x7f92f1e9d460>,43,14,[5 6],44,-1,64,-1,50
1,<environment.Job instance at 0x7f92f1e9dd70>,40,18,[5 7],41,-1,72,-1,54
1,<environment.Job instance at 0x7f92f1e9d6e0>,46,18,[1 5],47,-1,72,-1,54
1,<environment.Job instance at 0x7f92e85a2f00>,6,13,[ 5 11],7,-1,20,-1,7
1,<environment.Job instance at 0x7f92e90c42d0>,7,2,[13  1],8,-1,10,-1,8
1,<environment.Job instance at 0x7f92e92c5640>,14,1,[11  3],15,-1,34,-1,33
1,<environment.Job instance at 0x7f92f1ef68c0>,21,13,[ 1 13],22,-1,82,-1,69
1,<environment.Job instance at 0x7f92f1ea7a50>,22,27,[9 1],23,-1,104,-1,77
1,<environment.Job instance at 0x7f92e8c5d640>,26,21,[12  2],27,-1,104,-1,83
1,<environment.Job instance at 0x7f92e96c0910>,28,14,[ 1 14],29,-1,106,-1,92
1,<environment.Job instance at 0x7f92e97eb280>,30,15,[12  3],31,-1,108,-1,93
1,<environment.Job instance at 0x7f92e8fe1730>,36,2,[12  3],37,-1,100,-1,98
1,<environment.Job instance at 0x7f92e8d7a320>,41,23,[5 9],42,-1,153,-1,130
1,<environment.Job instance at 0x7f92f1e605a0>,45,15,[ 4 12],46,-1,147,-1,132
1,<environment.Job instance at 0x7f92f1e60f50>,49,3,[ 4 11],50,-1,147,-1,144
1,<environment.Job instance at 0x7f92e8fbfdc0>,51,26,[7 2],52,-1,173,-1,147
1,<environment.Job instance at 0x7f92e8fbfaa0>,52,2,[ 2 13],53,-1,149,-1,147
1,<environment.Job instance at 0x7f92e7f57550>,56,12,[11  2],57,-1,177,-1,165
1,<environment.Job instance at 0x7f92e8671b40>,57,1,[14  5],58,-1,166,-1,165
1,<environment.Job instance at 0x7f92e86715f0>,58,19,[ 5 11],59,-1,184,-1,165
1,<environment.Job instance at 0x7f92e8aa78c0>,68,1,[ 4 13],69,-1,191,-1,190
1,<environment.Job instance at 0x7f92e8169820>,72,2,[ 3 14],73,-1,193,-1,191
1,<environment.Job instance at 0x7f92e836b370>,74,23,[8 3],75,-1,222,-1,199
1,<environment.Job instance at 0x7f92e91fe140>,79,1,[11  4],80,-1,209,-1,208
1,<environment.Job instance at 0x7f92f1eb1190>,83,27,[9 4],84,-1,242,-1,215
1,<environment.Job instance at 0x7f92e8a60fa0>,84,25,[8 2],85,-1,240,-1,215
1,<environment.Job instance at 0x7f92e9262910>,90,12,[ 4 12],91,-1,244,-1,232
1,<environment.Job instance at 0x7f92e83cd820>,109,27,[5 8],110,-1,338,-1,311
1,<environment.Job instance at 0x7f92e88ddc30>,125,15,[13  3],126,-1,361,-1,346
1,<environment.Job instance at 0x7f92e8b4f5a0>,132,1,[14  1],133,-1,366,-1,365
1,<environment.Job instance at 0x7f92e8d34690>,134,17,[14  4],135,-1,398,-1,381
1,<environment.Job instance at 0x7f92e8d34820>,138,24,[8 2],139,-1,420,-1,396
1,<environment.Job instance at 0x7f92e8d34b40>,139,27,[ 3 13],140,-1,423,-1,396
1,<environment.Job instance at 0x7f92e81aff50>,140,18,[ 2 12],141,-1,414,-1,396
1,<environment.Job instance at 0x7f92e8c35730>,146,24,[13  3],147,-1,442,-1,418
1,<environment.Job instance at 0x7f92e829f780>,2,18,[4 9],3,-1,21,-1,3
1,<environment.Job instance at 0x7f92e829f6e0>,4,15,[9 5],5,-1,20,-1,5
1,<environment.Job instance at 0x7f92e829f960>,6,18,[8 5],7,-1,25,-1,7
1,<environment.Job instance at 0x7f92e829fe60>,10,15,[9 2],11,-1,27,-1,12
1,<environment.Job instance at 0x7f92e829ffa0>,13,26,[7 3],14,-1,40,-1,14
1,<environment.Job instance at 0x7f92e8070dc0>,11,12,[7 1],12,-1,26,-1,14
1,<environment.Job instance at 0x7f92e82962d0>,16,17,[1 8],17,-1,34,-1,17
1,<environment.Job instance at 0x7f92e8296500>,19,13,[9 5],20,-1,34,-1,21
1,<environment.Job instance at 0x7f92e8296550>,21,17,[3 7],22,-1,39,-1,22
1,<environment.Job instance at 0x7f92e82966e0>,20,15,[2 8],21,-1,37,-1,22
1,<environment.Job instance at 0x7f92e8296690>,22,14,[1 9],23,-1,38,-1,24
1,<environment.Job instance at 0x7f92e8296780>,23,14,[4 6],24,-1,38,-1,24
1,<environment.Job instance at 0x7f92e8296820>,24,15,[9 2],25,-1,45,-1,30
1,<environment.Job instance at 0x7f92e82b10a0>,32,14,[9 2],33,-1,47,-1,33
1,<environment.Job instance at 0x7f92e82b11e0>,33,14,[9 2],34,-1,48,-1,34
1,<environment.Job instance at 0x7f92e82b1320>,35,16,[5 1],36,-1,52,-1,36
1,<environment.Job instance at 0x7f92e82b1690>,38,12,[9 4],39,-1,51,-1,39
1,<environment.Job instance at 0x7f92e82b1500>,40,20,[7 1],41,-1,61,-1,41
1,<environment.Job instance at 0x7f92e82b18c0>,41,14,[9 4],42,-1,56,-1,42
1,<environment.Job instance at 0x7f92e82b1a00>,43,17,[3 7],44,-1,61,-1,44
1,<environment.Job instance at 0x7f92e82b1be0>,44,21,[6 1],45,-1,66,-1,45
1,<environment.Job instance at 0x7f92e89e05a0>,57,17,[9 1],58,-1,79,-1,62
1,<environment.Job instance at 0x7f92e89e09b0>,60,24,[ 4 14],61,-1,90,-1,66
1,<environment.Job instance at 0x7f92e89e01e0>,51,16,[9 2],52,-1,82,-1,66
1,<environment.Job instance at 0x7f92e89e0c30>,64,14,[ 1 11],65,-1,80,-1,66
1,<environment.Job instance at 0x7f92e89e0eb0>,65,24,[7 4],66,-1,90,-1,66
1,<environment.Job instance at 0x7f92e89bcf00>,66,14,[9 1],67,-1,81,-1,67
1,<environment.Job instance at 0x7f92e82b1820>,39,17,[12  4],40,-1,85,-1,68
1,<environment.Job instance at 0x7f92e89e02d0>,52,16,[6 1],53,-1,87,-1,71
1,<environment.Job instance at 0x7f92e89bc140>,70,12,[8 4],71,-1,86,-1,74
1,<environment.Job instance at 0x7f92e89e0f00>,63,17,[7 2],64,-1,92,-1,75
1,<environment.Job instance at 0x7f92e89bc780>,71,14,[ 2 10],72,-1,90,-1,76
1,<environment.Job instance at 0x7f92e89bc500>,75,25,[6 2],76,-1,101,-1,76
1,<environment.Job instance at 0x7f92e89bc370>,79,18,[ 1 10],80,-1,104,-1,86
1,<environment.Job instance at 0x7f92e89df0f0>,82,15,[4 5],83,-1,105,-1,90
1,<environment.Job instance at 0x7f92e89df2d0>,85,18,[4 5],86,-1,108,-1,90
1,<environment.Job instance at 0x7f92e89df550>,86,26,[10  2],87,-1,116,-1,90
1,<environment.Job instance at 0x7f92e89df410>,87,17,[8 3],88,-1,107,-1,90
1,<environment.Job instance at 0x7f92e89df640>,88,14,[9 3],89,-1,104,-1,90
1,<environment.Job instance at 0x7f92e89bc870>,73,18,[8 3],74,-1,110,-1,92
1,<environment.Job instance at 0x7f92e89df6e0>,90,17,[8 5],91,-1,109,-1,92
1,<environment.Job instance at 0x7f92e89df910>,92,21,[9 5],93,-1,118,-1,97
1,<environment.Job instance at 0x7f92e89dfbe0>,96,15,[3 5],97,-1,118,-1,103
1,<environment.Job instance at 0x7f92e89f2410>,101,18,[5 5],102,-1,123,-1,105
1,<environment.Job instance at 0x7f92e82a90a0>,104,18,[9 2],105,-1,123,-1,105
1,<environment.Job instance at 0x7f92e809e4b0>,105,18,[10  4],106,-1,124,-1,106
1,<environment.Job instance at 0x7f92e89df960>,91,15,[3 7],92,-1,124,-1,109
1,<environment.Job instance at 0x7f92e8294280>,108,28,[ 2 11],109,-1,137,-1,109
1,<environment.Job instance at 0x7f92e8f9dc80>,107,15,[5 9],108,-1,124,-1,109
1,<environment.Job instance at 0x7f92e82a1410>,110,15,[10  5],111,-1,126,-1,111
1,<environment.Job instance at 0x7f92e89e03c0>,53,14,[ 4 10],54,-1,126,-1,112
1,<environment.Job instance at 0x7f92e82a1870>,111,17,[8 2],112,-1,129,-1,112
1,<environment.Job instance at 0x7f92e7f52370>,114,18,[8 4],115,-1,133,-1,115
1,<environment.Job instance at 0x7f92e930c370>,117,17,[2 7],118,-1,135,-1,118
1,<environment.Job instance at 0x7f92e930f6e0>,124,18,[3 9],125,-1,143,-1,125
1,<environment.Job instance at 0x7f92e89f2550>,102,15,[ 1 10],103,-1,152,-1,137
1,<environment.Job instance at 0x7f92e82b1d20>,47,13,[12  4],48,-1,150,-1,137
1,<environment.Job instance at 0x7f92e98840a0>,130,17,[1 5],131,-1,154,-1,137
1,<environment.Job instance at 0x7f92e80a8140>,142,16,[6 5],143,-1,216,-1,200
1,<environment.Job instance at 0x7f92e89df050>,13,26,[7 3],14,-1,48,-1,22
1,<environment.Job instance at 0x7f92e80a8c30>,17,27,[1 8],18,-1,65,-1,38
1,<environment.Job instance at 0x7f92e88dd4b0>,30,26,[2 8],31,-1,134,-1,108
1,<environment.Job instance at 0x7f92e92621e0>,39,17,[12  4],40,-1,153,-1,136
1,<environment.Job instance at 0x7f92e836b8c0>,45,17,[ 1 11],46,-1,181,-1,164
1,<environment.Job instance at 0x7f92e806f5a0>,47,13,[12  4],48,-1,177,-1,164
1,<environment.Job instance at 0x7f92f1e60050>,60,24,[ 4 14],61,-1,244,-1,220
1,<environment.Job instance at 0x7f92e944ec80>,64,14,[ 1 11],65,-1,236,-1,222
1,<environment.Job instance at 0x7f92e944e280>,65,24,[7 4],66,-1,262,-1,238
1,<environment.Job instance at 0x7f92e8165be0>,75,25,[6 2],76,-1,298,-1,273
1,<environment.Job instance at 0x7f92f226d280>,76,2,[ 1 13],77,-1,275,-1,273
1,<environment.Job instance at 0x7f92e9740460>,86,26,[10  2],87,-1,337,-1,311
1,<environment.Job instance at 0x7f92e93a55a0>,94,1,[12  5],95,-1,341,-1,340
1,<environment.Job instance at 0x7f92e93a5e10>,95,1,[ 2 14],96,-1,341,-1,340
1,<environment.Job instance at 0x7f92e93af7d0>,97,2,[14  3],98,-1,344,-1,342
1,<environment.Job instance at 0x7f92e8a44320>,108,28,[ 2 11],109,-1,408,-1,380
1,<environment.Job instance at 0x7f92e7f09f00>,116,15,[ 2 12],117,-1,441,-1,426
1,<environment.Job instance at 0x7f92e9682dc0>,120,12,[ 1 11],121,-1,456,-1,444
1,<environment.Job instance at 0x7f92e87e4be0>,123,15,[ 5 12],124,-1,473,-1,458
1,<environment.Job instance at 0x7f92e87d1f00>,140,17,[11  3],141,-1,545,-1,528
1,<environment.Job instance at 0x7f92e8b85730>,1,16,[3 9],2,-1,18,-1,2
1,<environment.Job instance at 0x7f92e8b85640>,5,14,[6 4],6,-1,20,-1,6
1,<environment.Job instance at 0x7f92e8b85f50>,7,24,[8 1],8,-1,32,-1,8
1,<environment.Job instance at 0x7f92e8b85550>,10,16,[8 2],11,-1,28,-1,12
1,<environment.Job instance at 0x7f92e8b858c0>,12,14,[7 1],13,-1,27,-1,13
1,<environment.Job instance at 0x7f92e8b85870>,13,28,[6 1],14,-1,42,-1,14
1,<environment.Job instance at 0x7f92e8b85fa0>,14,2,[ 2 10],15,-1,17,-1,15
1,<environment.Job instance at 0x7f92e87c2c80>,11,28,[5 9],12,-1,43,-1,15
1,<environment.Job instance at 0x7f92e7faa460>,16,18,[9 2],17,-1,36,-1,18
1,<environment.Job instance at 0x7f92e7faa910>,17,16,[10  4],18,-1,34,-1,18
1,<environment.Job instance at 0x7f92e7faa370>,18,23,[ 3 10],19,-1,42,-1,19
1,<environment.Job instance at 0x7f92e7faa190>,19,17,[4 5],20,-1,37,-1,20
1,<environment.Job instance at 0x7f92e7faa780>,23,18,[ 5 11],24,-1,42,-1,24
1,<environment.Job instance at 0x7f92e7faa550>,27,19,[6 3],28,-1,47,-1,28
1,<environment.Job instance at 0x7f92e7faa6e0>,30,18,[7 1],31,-1,50,-1,32
1,<environment.Job instance at 0x7f92e7fb0f00>,32,18,[6 5],33,-1,51,-1,33
1,<environment.Job instance at 0x7f92e7fb0be0>,36,22,[3 7],37,-1,60,-1,38
1,<environment.Job instance at 0x7f92e7fb0870>,39,14,[3 7],40,-1,54,-1,40
1,<environment.Job instance at 0x7f92e7fb03c0>,40,17,[9 5],41,-1,58,-1,41
1,<environment.Job instance at 0x7f92e7fb0190>,37,21,[5 3],38,-1,62,-1,41
1,<environment.Job instance at 0x7f92e7fb0230>,41,14,[9 4],42,-1,59,-1,45
1,<environment.Job instance at 0x7f92e7fb00a0>,44,18,[6 5],45,-1,67,-1,49
1,<environment.Job instance at 0x7f92e7fb0820>,49,21,[10  5],50,-1,72,-1,51
1,<environment.Job instance at 0x7f92e954f780>,50,15,[4 9],51,-1,80,-1,65
1,<environment.Job instance at 0x7f92e954f960>,61,16,[6 2],62,-1,102,-1,86
1,<environment.Job instance at 0x7f92e954f730>,59,1,[5 9],60,-1,87,-1,86
1,<environment.Job instance at 0x7f92e954f140>,63,18,[3 7],64,-1,107,-1,89
1,<environment.Job instance at 0x7f92e954f4b0>,66,18,[3 6],67,-1,107,-1,89
1,<environment.Job instance at 0x7f92e9928f50>,67,26,[ 2 12],68,-1,115,-1,89
1,<environment.Job instance at 0x7f92e9928a50>,68,17,[2 5],69,-1,106,-1,89
1,<environment.Job instance at 0x7f92e954f0a0>,55,16,[ 4 14],56,-1,105,-1,89
1,<environment.Job instance at 0x7f92e954f230>,58,17,[7 4],59,-1,106,-1,89
1,<environment.Job instance at 0x7f92e99285a0>,75,26,[5 5],76,-1,117,-1,91
1,<environment.Job instance at 0x7f92e954f410>,57,16,[2 6],58,-1,110,-1,94
1,<environment.Job instance at 0x7f92e99283c0>,76,3,[7 1],77,-1,97,-1,94
1,<environment.Job instance at 0x7f92e9928140>,78,22,[10  5],79,-1,116,-1,94
1,<environment.Job instance at 0x7f92e99284b0>,77,15,[8 4],78,-1,109,-1,94
1,<environment.Job instance at 0x7f92e99288c0>,84,25,[9 4],85,-1,135,-1,110
1,<environment.Job instance at 0x7f92e9928550>,80,17,[2 7],81,-1,127,-1,110
1,<environment.Job instance at 0x7f92e9928dc0>,87,14,[4 5],88,-1,124,-1,110
1,<environment.Job instance at 0x7f92e83cab40>,90,25,[9 5],91,-1,135,-1,110
1,<environment.Job instance at 0x7f92e954f190>,62,20,[1 9],63,-1,130,-1,110
1,<environment.Job instance at 0x7f92e9928aa0>,83,12,[10  3],84,-1,123,-1,111
1,<environment.Job instance at 0x7f92e83ca960>,94,17,[6 3],95,-1,128,-1,111
1,<environment.Job instance at 0x7f92e83cac80>,96,15,[7 3],97,-1,126,-1,111
1,<environment.Job instance at 0x7f92e83ca4b0>,95,22,[6 4],96,-1,133,-1,111
1,<environment.Job instance at 0x7f92e83ca370>,97,15,[5 4],98,-1,126,-1,111
1,<environment.Job instance at 0x7f92e83ca870>,100,26,[10  1],101,-1,137,-1,111
1,<environment.Job instance at 0x7f92e83caeb0>,99,14,[ 1 10],100,-1,126,-1,112
1,<environment.Job instance at 0x7f92e83ca140>,102,22,[2 7],103,-1,134,-1,112
1,<environment.Job instance at 0x7f92e83cabe0>,98,13,[2 8],99,-1,125,-1,112
1,<environment.Job instance at 0x7f92e983e140>,105,16,[10  3],106,-1,130,-1,114
1,<environment.Job instance at 0x7f92e83ca730>,101,16,[ 2 10],102,-1,131,-1,115
1,<environment.Job instance at 0x7f92e983ecd0>,104,12,[1 9],105,-1,127,-1,115
1,<environment.Job instance at 0x7f92e983eaf0>,106,18,[8 3],107,-1,133,-1,115
1,<environment.Job instance at 0x7f92e87af140>,110,15,[9 4],111,-1,130,-1,115
1,<environment.Job instance at 0x7f92f1eb97d0>,111,14,[8 1],112,-1,129,-1,115
1,<environment.Job instance at 0x7f92e818ae10>,109,17,[1 9],110,-1,132,-1,115
1,<environment.Job instance at 0x7f92e983ef00>,108,2,[5 1],109,-1,117,-1,115
1,<environment.Job instance at 0x7f92e90c3aa0>,114,18,[6 4],115,-1,133,-1,115
1,<environment.Job instance at 0x7f92e943a9b0>,112,17,[9 5],113,-1,133,-1,116
1,<environment.Job instance at 0x7f92e90c3370>,115,27,[5 8],116,-1,143,-1,116
1,<environment.Job instance at 0x7f92e90c3a50>,116,16,[6 4],117,-1,134,-1,118
1,<environment.Job instance at 0x7f92e8abee60>,123,18,[10  5],124,-1,142,-1,124
1,<environment.Job instance at 0x7f92e88dc780>,125,12,[9 4],126,-1,138,-1,126
1,<environment.Job instance at 0x7f92e90c3910>,117,25,[6 4],118,-1,154,-1,129
1,<environment.Job instance at 0x7f92e937f640>,141,26,[5 4],142,-1,178,-1,152
1,<environment.Job instance at 0x7f92e9928820>,7,24,[8 1],8,-1,40,-1,16
1,<environment.Job instance at 0x7f92e83cae10>,11,28,[5 9],12,-1,51,-1,23
1,<environment.Job instance at 0x7f92e90c3e60>,13,28,[6 1],14,-1,54,-1,26
1,<environment.Job instance at 0x7f92e8223e10>,18,23,[ 3 10],19,-1,55,-1,32
1,<environment.Job instance at 0x7f92e8010fa0>,23,18,[ 5 11],24,-1,65,-1,47
1,<environment.Job instance at 0x7f92e9717230>,33,1,[13  4],34,-1,80,-1,79
1,<environment.Job instance at 0x7f92e93a55a0>,34,17,[12  2],35,-1,96,-1,79
1,<environment.Job instance at 0x7f92e80b7e10>,46,28,[7 3],47,-1,145,-1,117
1,<environment.Job instance at 0x7f92e9333fa0>,55,16,[ 4 14],56,-1,156,-1,140
1,<environment.Job instance at 0x7f92e822d3c0>,67,26,[ 2 12],68,-1,213,-1,187
1,<environment.Job instance at 0x7f92e7f85730>,69,1,[ 3 12],70,-1,191,-1,190
1,<environment.Job instance at 0x7f92e89004b0>,72,3,[11  1],73,-1,210,-1,207
1,<environment.Job instance at 0x7f92e8900780>,75,26,[5 5],76,-1,236,-1,210
1,<environment.Job instance at 0x7f92e9637a00>,84,25,[9 4],85,-1,289,-1,264
1,<environment.Job instance at 0x7f92e94b8a50>,90,25,[9 5],91,-1,292,-1,267
1,<environment.Job instance at 0x7f92e8508190>,91,3,[11  1],92,-1,270,-1,267
1,<environment.Job instance at 0x7f92e8508320>,92,3,[12  5],93,-1,270,-1,267
1,<environment.Job instance at 0x7f92e8292b90>,100,26,[10  1],101,-1,324,-1,298
1,<environment.Job instance at 0x7f92e8c724b0>,115,27,[5 8],116,-1,400,-1,373
1,<environment.Job instance at 0x7f92f1efd500>,117,25,[6 4],118,-1,406,-1,381
1,<environment.Job instance at 0x7f92f1efdeb0>,120,14,[ 1 14],121,-1,403,-1,389
1,<environment.Job instance at 0x7f92e8c82fa0>,119,25,[10  1],120,-1,432,-1,407
1,<environment.Job instance at 0x7f92e923f500>,141,26,[5 4],142,-1,487,-1,461
1,<environment.Job instance at 0x7f92e964d9b0>,148,26,[ 3 10],149,-1,517,-1,491
1,<environment.Job instance at 0x7f92e8324eb0>,11,16,[5 4],12,-1,28,-1,12
1,<environment.Job instance at 0x7f92e9088b90>,12,18,[2 9],13,-1,31,-1,13
1,<environment.Job instance at 0x7f92e8172eb0>,13,14,[3 7],14,-1,28,-1,14
1,<environment.Job instance at 0x7f92e96b7b90>,19,13,[3 8],20,-1,33,-1,20
1,<environment.Job instance at 0x7f92e96b7aa0>,23,18,[5 5],24,-1,42,-1,24
1,<environment.Job instance at 0x7f92e96b70f0>,24,16,[10  2],25,-1,42,-1,26
1,<environment.Job instance at 0x7f92e7f66c80>,26,16,[5 6],27,-1,43,-1,27
1,<environment.Job instance at 0x7f92e9830730>,29,13,[4 7],30,-1,43,-1,30
1,<environment.Job instance at 0x7f92e9830230>,32,15,[5 5],33,-1,48,-1,33
1,<environment.Job instance at 0x7f92e93bccd0>,33,12,[9 5],34,-1,47,-1,35
1,<environment.Job instance at 0x7f92e93bcb40>,35,14,[5 8],36,-1,50,-1,36
1,<environment.Job instance at 0x7f92e93bce60>,36,14,[5 5],37,-1,51,-1,37
1,<environment.Job instance at 0x7f92e93bc550>,37,17,[3 7],38,-1,55,-1,38
1,<environment.Job instance at 0x7f92e93bc9b0>,38,16,[7 5],39,-1,55,-1,39
1,<environment.Job instance at 0x7f92e93bc320>,39,20,[5 5],40,-1,60,-1,40
1,<environment.Job instance at 0x7f92e7f2f320>,45,15,[1 9],46,-1,61,-1,46
1,<environment.Job instance at 0x7f92e7f2f8c0>,46,18,[1 8],47,-1,65,-1,47
1,<environment.Job instance at 0x7f92e7f2f780>,49,1,[5 1],50,-1,51,-1,50
1,<environment.Job instance at 0x7f92e8cb01e0>,51,14,[10  5],52,-1,66,-1,52
1,<environment.Job instance at 0x7f92e9785dc0>,53,13,[7 4],54,-1,67,-1,54
1,<environment.Job instance at 0x7f92e9785f00>,54,3,[3 5],55,-1,58,-1,55
1,<environment.Job instance at 0x7f92e9785c30>,55,15,[7 2],56,-1,71,-1,56
1,<environment.Job instance at 0x7f92e9359d20>,57,28,[8 2],58,-1,134,-1,106
1,<environment.Job instance at 0x7f92e8b596e0>,70,22,[9 5],71,-1,128,-1,106
1,<environment.Job instance at 0x7f92f20b9c80>,72,27,[8 4],73,-1,135,-1,108
1,<environment.Job instance at 0x7f92e93590a0>,60,17,[14  5],61,-1,132,-1,115
1,<environment.Job instance at 0x7f92f20b9c30>,76,14,[8 5],77,-1,129,-1,115
1,<environment.Job instance at 0x7f92f20b9960>,78,18,[8 4],79,-1,134,-1,116
1,<environment.Job instance at 0x7f92e9359e60>,61,14,[13  2],62,-1,130,-1,116
1,<environment.Job instance at 0x7f92f20b95f0>,79,18,[2 5],80,-1,134,-1,116
1,<environment.Job instance at 0x7f92e7f79aa0>,17,3,[ 5 11],18,-1,45,-1,42
1,<environment.Job instance at 0x7f92e93bc640>,21,18,[ 3 14],22,-1,67,-1,49
1,<environment.Job instance at 0x7f92f2451640>,28,13,[14  3],29,-1,92,-1,79
1,<environment.Job instance at 0x7f92e95cbb90>,47,2,[13  4],48,-1,156,-1,154
1,<environment.Job instance at 0x7f92f1e55fa0>,56,13,[13  5],57,-1,199,-1,186
1,<environment.Job instance at 0x7f92e8b8c280>,60,17,[14  5],61,-1,218,-1,201
1,<environment.Job instance at 0x7f92e8b8caa0>,61,14,[13  2],62,-1,215,-1,201
1,<environment.Job instance at 0x7f92f1e55820>,57,28,[8 2],58,-1,230,-1,202
1,<environment.Job instance at 0x7f92e96373c0>,72,27,[8 4],73,-1,254,-1,227
1,<environment.Job instance at 0x7f92e8c5d690>,82,1,[ 1 13],83,-1,249,-1,248
1,<environment.Job instance at 0x7f92e8c5dd70>,85,17,[11  2],86,-1,280,-1,263
1,<environment.Job instance at 0x7f92e9441460>,89,21,[14  3],90,-1,287,-1,266
1,<environment.Job instance at 0x7f92e81ef4b0>,83,25,[ 4 10],84,-1,307,-1,282
1,<environment.Job instance at 0x7f92e8010460>,107,1,[ 2 11],108,-1,305,-1,304
1,<environment.Job instance at 0x7f92e8afe370>,114,17,[11  1],115,-1,346,-1,329
1,<environment.Job instance at 0x7f92e97c98c0>,127,3,[ 5 11],128,-1,392,-1,389
1,<environment.Job instance at 0x7f92e8f530f0>,144,12,[13  3],145,-1,495,-1,483
1,<environment.Job instance at 0x7f92e8925a00>,0,16,[7 5],1,-1,17,-1,1
1,<environment.Job instance at 0x7f92e8943410>,5,28,[5 5],6,-1,34,-1,6
1,<environment.Job instance at 0x7f92e8943690>,9,18,[1 5],10,-1,28,-1,10
1,<environment.Job instance at 0x7f92e8977c80>,11,21,[4 8],12,-1,33,-1,12
1,<environment.Job instance at 0x7f92e89770f0>,13,16,[10  5],14,-1,30,-1,14
1,<environment.Job instance at 0x7f92e896f280>,20,21,[6 2],21,-1,42,-1,21
1,<environment.Job instance at 0x7f92e8954730>,23,13,[10  4],24,-1,41,-1,28
1,<environment.Job instance at 0x7f92e8b7a320>,27,12,[8 1],28,-1,40,-1,28
1,<environment.Job instance at 0x7f92e93ea550>,28,22,[4 8],29,-1,51,-1,29
1,<environment.Job instance at 0x7f92e8b56690>,35,14,[4 5],36,-1,61,-1,47
1,<environment.Job instance at 0x7f92e8b60f00>,46,12,[3 9],47,-1,59,-1,47
1,<environment.Job instance at 0x7f92e94206e0>,47,17,[ 4 14],48,-1,300,-1,283
1,<environment.Job instance at 0x7f92e8b60e10>,45,15,[10  3],46,-1,301,-1,286
1,<environment.Job instance at 0x7f92e8b6bcd0>,89,16,[4 9],90,-1,306,-1,290
1,<environment.Job instance at 0x7f92e8b6b2d0>,75,17,[ 5 10],76,-1,311,-1,294
1,<environment.Job instance at 0x7f92e8b75230>,97,18,[7 5],98,-1,323,-1,305
1,<environment.Job instance at 0x7f92e8b755f0>,103,17,[8 4],104,-1,339,-1,322
1,<environment.Job instance at 0x7f92e8b754b0>,101,18,[5 9],102,-1,341,-1,323
1,<environment.Job instance at 0x7f92e8b75730>,105,18,[9 4],106,-1,342,-1,324
1,<environment.Job instance at 0x7f92e8b75870>,107,17,[8 2],108,-1,341,-1,324
1,<environment.Job instance at 0x7f92e8b75690>,104,24,[8 1],105,-1,348,-1,324
1,<environment.Job instance at 0x7f92e8b6b9b0>,84,17,[5 2],85,-1,341,-1,324
1,<environment.Job instance at 0x7f92e8b759b0>,109,17,[7 1],110,-1,341,-1,324
1,<environment.Job instance at 0x7f92e8b75a50>,110,15,[8 3],111,-1,339,-1,324
1,<environment.Job instance at 0x7f92e8b75c30>,113,15,[3 8],114,-1,339,-1,324
1,<environment.Job instance at 0x7f92e8b43050>,119,16,[10  3],120,-1,363,-1,347
1,<environment.Job instance at 0x7f92e8b43370>,124,15,[4 9],125,-1,364,-1,349
1,<environment.Job instance at 0x7f92e8b43230>,122,24,[8 2],123,-1,391,-1,367
1,<environment.Job instance at 0x7f92e8b439b0>,134,13,[8 2],135,-1,382,-1,369
1,<environment.Job instance at 0x7f92e8b43a50>,135,12,[8 3],136,-1,381,-1,369
1,<environment.Job instance at 0x7f92e8b43550>,127,12,[13  5],128,-1,382,-1,370
1,<environment.Job instance at 0x7f92e8b43b90>,137,12,[7 5],138,-1,382,-1,370
1,<environment.Job instance at 0x7f92e8b43af0>,136,12,[7 2],137,-1,383,-1,371
1,<environment.Job instance at 0x7f92e8b43cd0>,139,25,[1 7],140,-1,396,-1,371
1,<environment.Job instance at 0x7f92e8b43e10>,141,16,[5 9],142,-1,387,-1,371
1,<environment.Job instance at 0x7f92e8b43eb0>,142,17,[7 4],143,-1,388,-1,371
1,<environment.Job instance at 0x7f92e8b43f50>,143,14,[2 7],144,-1,386,-1,372
1,<environment.Job instance at 0x7f92e8b3d050>,144,12,[4 7],145,-1,384,-1,372
1,<environment.Job instance at 0x7f92e8b3d190>,146,17,[10  4],147,-1,389,-1,372
1,<environment.Job instance at 0x7f92e8b3d0f0>,145,13,[1 5],146,-1,388,-1,375
1,<environment.Job instance at 0x7f92e8b3d2d0>,148,14,[ 5 11],149,-1,389,-1,375
1,<environment.Job instance at 0x7f92e8b757d0>,106,25,[6 2],107,-1,400,-1,375
1,<environment.Job instance at 0x7f92e940d9b0>,30,28,[4 7],31,-1,403,-1,375
1,<environment.Job instance at 0x7f92e8b6bf50>,93,17,[9 1],94,-1,394,-1,377
1,<environment.Job instance at 0x7f92e93ead70>,5,28,[5 5],6,-1,34,-1,6
1,<environment.Job instance at 0x7f92e8b3db90>,10,12,[ 4 14],11,-1,23,-1,11
1,<environment.Job instance at 0x7f92e8b790f0>,18,1,[ 1 11],19,-1,26,-1,25
1,<environment.Job instance at 0x7f92e8b60640>,29,16,[ 4 11],30,-1,62,-1,46
1,<environment.Job instance at 0x7f92e8b47870>,31,15,[ 5 14],32,-1,62,-1,47
1,<environment.Job instance at 0x7f92e8b60910>,30,28,[4 7],31,-1,75,-1,47
1,<environment.Job instance at 0x7f92e8b660a0>,33,14,[ 3 11],34,-1,61,-1,47
1,<environment.Job instance at 0x7f92e8165780>,47,17,[ 4 14],48,-1,106,-1,89
1,<environment.Job instance at 0x7f92e7fa6d70>,81,16,[14  3],82,-1,228,-1,212
1,<environment.Job instance at 0x7f92f21c6780>,82,3,[ 1 14],83,-1,215,-1,212
1,<environment.Job instance at 0x7f92e822d140>,96,3,[ 5 11],97,-1,259,-1,256
1,<environment.Job instance at 0x7f92e94b8870>,104,24,[8 1],105,-1,344,-1,320
1,<environment.Job instance at 0x7f92f1ef1320>,106,25,[6 2],107,-1,345,-1,320
1,<environment.Job instance at 0x7f92f1efdd70>,122,24,[8 2],123,-1,398,-1,374
1,<environment.Job instance at 0x7f92e907d960>,127,12,[13  5],128,-1,402,-1,390
1,<environment.Job instance at 0x7f92e85d2370>,132,2,[ 1 12],133,-1,408,-1,406
1,<environment.Job instance at 0x7f92f2451640>,139,25,[1 7],140,-1,458,-1,433
1,<environment.Job instance at 0x7f92e93bc500>,148,14,[ 5 11],149,-1,477,-1,463
1,<environment.Job instance at 0x7f92e8d2dd70>,2,18,[ 1 10],3,-1,22,-1,4
1,<environment.Job instance at 0x7f92e858b190>,4,12,[9 4],5,-1,17,-1,5
1,<environment.Job instance at 0x7f92e858b6e0>,5,18,[6 1],6,-1,24,-1,6
1,<environment.Job instance at 0x7f92e858bf50>,6,15,[4 7],7,-1,22,-1,7
1,<environment.Job instance at 0x7f92e858b460>,8,17,[9 3],9,-1,26,-1,9
1,<environment.Job instance at 0x7f92e858b2d0>,10,14,[10  1],11,-1,25,-1,11
1,<environment.Job instance at 0x7f92e858b640>,12,18,[10  1],13,-1,31,-1,13
1,<environment.Job instance at 0x7f92e858b690>,13,15,[7 2],14,-1,29,-1,14
1,<environment.Job instance at 0x7f92e858b550>,14,27,[1 7],15,-1,42,-1,15
1,<environment.Job instance at 0x7f92e86751e0>,16,13,[4 6],17,-1,30,-1,17
1,<environment.Job instance at 0x7f92e8675a00>,17,18,[6 1],18,-1,36,-1,18
1,<environment.Job instance at 0x7f92e86754b0>,18,17,[3 6],19,-1,36,-1,19
1,<environment.Job instance at 0x7f92e8675b40>,21,12,[ 5 10],22,-1,34,-1,22
1,<environment.Job instance at 0x7f92e8675910>,22,15,[4 7],23,-1,38,-1,23
1,<environment.Job instance at 0x7f92e8675500>,23,14,[9 2],24,-1,38,-1,24
1,<environment.Job instance at 0x7f92e9662500>,26,16,[1 9],27,-1,43,-1,27
1,<environment.Job instance at 0x7f92e9001910>,30,13,[4 7],31,-1,44,-1,31
1,<environment.Job instance at 0x7f92e89ca870>,31,18,[4 6],32,-1,50,-1,32
1,<environment.Job instance at 0x7f92e979c410>,34,14,[1 7],35,-1,49,-1,35
1,<environment.Job instance at 0x7f92e979c550>,35,13,[10  4],36,-1,49,-1,36
1,<environment.Job instance at 0x7f92e979c050>,36,19,[5 4],37,-1,56,-1,37
1,<environment.Job instance at 0x7f92e979c9b0>,37,17,[1 8],38,-1,55,-1,38
1,<environment.Job instance at 0x7f92e979ce60>,38,18,[4 6],39,-1,57,-1,39
1,<environment.Job instance at 0x7f92e979c7d0>,39,13,[8 2],40,-1,53,-1,40
1,<environment.Job instance at 0x7f92e9301140>,42,14,[5 6],43,-1,57,-1,43
1,<environment.Job instance at 0x7f92e9301f50>,43,18,[10  1],44,-1,62,-1,44
1,<environment.Job instance at 0x7f92e9301b40>,44,15,[9 3],45,-1,60,-1,45
1,<environment.Job instance at 0x7f92e9301230>,46,17,[ 2 10],47,-1,64,-1,47
1,<environment.Job instance at 0x7f92e8e10460>,59,23,[9 3],60,-1,83,-1,60
1,<environment.Job instance at 0x7f92e85ce460>,61,15,[7 4],62,-1,77,-1,62
1,<environment.Job instance at 0x7f92e85ce7d0>,62,16,[7 2],63,-1,79,-1,63
1,<environment.Job instance at 0x7f92e85ce050>,65,14,[ 2 10],66,-1,83,-1,69
1,<environment.Job instance at 0x7f92e98ec460>,69,15,[8 5],70,-1,85,-1,70
1,<environment.Job instance at 0x7f92e98ec1e0>,70,22,[9 3],71,-1,93,-1,71
1,<environment.Job instance at 0x7f92e9717e10>,52,15,[ 2 12],53,-1,92,-1,77
1,<environment.Job instance at 0x7f92e891dbe0>,68,12,[ 1 13],69,-1,89,-1,77
1,<environment.Job instance at 0x7f92e8ddd7d0>,77,22,[7 3],78,-1,101,-1,79
1,<environment.Job instance at 0x7f92f1e44d70>,76,14,[11  1],77,-1,94,-1,80
1,<environment.Job instance at 0x7f92e8e10c30>,56,17,[11  2],57,-1,99,-1,82
1,<environment.Job instance at 0x7f92e85cea50>,67,18,[2 7],68,-1,100,-1,82
1,<environment.Job instance at 0x7f92e8a74be0>,79,14,[6 4],80,-1,96,-1,82
1,<environment.Job instance at 0x7f92e88ae640>,83,15,[3 8],84,-1,105,-1,90
1,<environment.Job instance at 0x7f92e888a410>,90,18,[4 5],91,-1,109,-1,91
1,<environment.Job instance at 0x7f92e9546dc0>,91,27,[6 5],92,-1,119,-1,92
1,<environment.Job instance at 0x7f92e83f7d20>,94,17,[7 2],95,-1,113,-1,96
1,<environment.Job instance at 0x7f92e884d500>,96,16,[ 1 12],97,-1,113,-1,97
1,<environment.Job instance at 0x7f92e8dff640>,81,14,[5 5],82,-1,112,-1,98
1,<environment.Job instance at 0x7f92e964dbe0>,88,14,[5 9],89,-1,112,-1,98
1,<environment.Job instance at 0x7f92e884d320>,98,25,[10  1],99,-1,124,-1,99
1,<environment.Job instance at 0x7f92e8deee60>,99,23,[4 9],100,-1,123,-1,100
1,<environment.Job instance at 0x7f92e81256e0>,101,15,[10  3],102,-1,117,-1,102
1,<environment.Job instance at 0x7f92e98ecc30>,75,14,[7 4],76,-1,117,-1,103
1,<environment.Job instance at 0x7f92e8994d20>,109,27,[9 3],110,-1,140,-1,113
1,<environment.Job instance at 0x7f92f1e72a00>,89,18,[5 9],90,-1,143,-1,125
1,<environment.Job instance at 0x7f92e8994b40>,111,28,[6 2],112,-1,153,-1,125
1,<environment.Job instance at 0x7f92e884d820>,97,16,[6 5],98,-1,146,-1,130
1,<environment.Job instance at 0x7f92fae3d3c0>,14,27,[1 7],15,-1,62,-1,35
1,<environment.Job instance at 0x7f92f221c230>,45,16,[ 5 13],46,-1,178,-1,162
1,<environment.Job instance at 0x7f92f2440a00>,49,16,[ 1 13],50,-1,197,-1,181
1,<environment.Job instance at 0x7f92f2440500>,52,15,[ 2 12],53,-1,201,-1,186
1,<environment.Job instance at 0x7f92e9546aa0>,56,17,[11  2],57,-1,211,-1,194
1,<environment.Job instance at 0x7f92f1efd5f0>,59,23,[9 3],60,-1,232,-1,209
1,<environment.Job instance at 0x7f92e91b25a0>,68,12,[ 1 13],69,-1,253,-1,241
1,<environment.Job instance at 0x7f92e8e225a0>,71,28,[1 5],72,-1,278,-1,250
1,<environment.Job instance at 0x7f92e9359780>,72,12,[ 4 14],73,-1,262,-1,250
1,<environment.Job instance at 0x7f92e96a4280>,76,14,[11  1],77,-1,275,-1,261
1,<environment.Job instance at 0x7f92e972b4b0>,84,2,[14  4],85,-1,305,-1,303
1,<environment.Job instance at 0x7f92e97c6c80>,85,3,[14  3],86,-1,306,-1,303
1,<environment.Job instance at 0x7f92e84a4be0>,86,18,[12  4],87,-1,321,-1,303
1,<environment.Job instance at 0x7f92e84a4410>,87,3,[ 4 13],88,-1,306,-1,303
1,<environment.Job instance at 0x7f92e8583140>,91,27,[6 5],92,-1,349,-1,322
1,<environment.Job instance at 0x7f92e8fe1870>,93,3,[ 1 13],94,-1,325,-1,322
1,<environment.Job instance at 0x7f92e8a5cb90>,96,16,[ 1 12],97,-1,338,-1,322
1,<environment.Job instance at 0x7f92e96fee10>,98,25,[10  1],99,-1,364,-1,339
1,<environment.Job instance at 0x7f92e9846410>,99,23,[4 9],100,-1,362,-1,339
1,<environment.Job instance at 0x7f92e97432d0>,107,25,[1 9],108,-1,387,-1,362
1,<environment.Job instance at 0x7f92e82f7b90>,109,27,[9 3],110,-1,389,-1,362
1,<environment.Job instance at 0x7f92e84c7f50>,111,28,[6 2],112,-1,390,-1,362
1,<environment.Job instance at 0x7f92e84ef280>,133,1,[ 4 14],134,-1,418,-1,417
1,<environment.Job instance at 0x7f92f1e21d20>,143,12,[ 1 14],144,-1,447,-1,435
1,<environment.Job instance at 0x7f92e9271730>,148,25,[3 6],149,-1,478,-1,453
1,<environment.Job instance at 0x7f92e841ebe0>,0,17,[8 5],1,-1,18,-1,1
1,<environment.Job instance at 0x7f92e841e140>,5,14,[7 2],6,-1,20,-1,6
1,<environment.Job instance at 0x7f92e841efa0>,7,16,[2 5],8,-1,24,-1,8
1,<environment.Job instance at 0x7f92e841e640>,8,15,[5 5],9,-1,24,-1,9
1,<environment.Job instance at 0x7f92e9846d20>,12,20,[3 6],13,-1,35,-1,15
1,<environment.Job instance at 0x7f92e841e190>,13,17,[10  4],14,-1,32,-1,15
1,<environment.Job instance at 0x7f92e9846870>,16,21,[10  4],17,-1,41,-1,20
1,<environment.Job instance at 0x7f92e98462d0>,19,15,[14  4],20,-1,35,-1,20
1,<environment.Job instance at 0x7f92e9846230>,20,16,[10  1],21,-1,38,-1,22
1,<environment.Job instance at 0x7f92f21d07d0>,23,13,[5 5],24,-1,37,-1,24
1,<environment.Job instance at 0x7f92f21d0870>,27,24,[9 5],28,-1,52,-1,28
1,<environment.Job instance at 0x7f92e932b2d0>,28,17,[7 2],29,-1,46,-1,29
1,<environment.Job instance at 0x7f92e932bd20>,29,15,[8 4],30,-1,45,-1,30
1,<environment.Job instance at 0x7f92e932bc80>,31,15,[5 5],32,-1,47,-1,32
1,<environment.Job instance at 0x7f92e932b9b0>,33,14,[5 2],34,-1,48,-1,34
1,<environment.Job instance at 0x7f92e8714500>,34,17,[7 2],35,-1,52,-1,35
1,<environment.Job instance at 0x7f92e90a5af0>,37,14,[3 8],38,-1,52,-1,38
1,<environment.Job instance at 0x7f92f1e44eb0>,42,15,[9 5],43,-1,58,-1,43
1,<environment.Job instance at 0x7f92f1e44910>,47,17,[3 5],48,-1,65,-1,48
1,<environment.Job instance at 0x7f92e905daf0>,51,20,[5 5],52,-1,72,-1,52
1,<environment.Job instance at 0x7f92e905da00>,53,22,[2 8],54,-1,76,-1,54
1,<environment.Job instance at 0x7f92e889ab40>,54,14,[2 5],55,-1,69,-1,55
1,<environment.Job instance at 0x7f92e889af00>,57,18,[3 6],58,-1,76,-1,58
1,<environment.Job instance at 0x7f92e97016e0>,62,20,[ 1 10],63,-1,83,-1,63
1,<environment.Job instance at 0x7f92e8ee27d0>,63,17,[6 1],64,-1,81,-1,64
1,<environment.Job instance at 0x7f92e9127780>,66,16,[ 2 10],67,-1,83,-1,67
1,<environment.Job instance at 0x7f92e83dbe60>,72,21,[9 2],73,-1,94,-1,73
1,<environment.Job instance at 0x7f92e88c5780>,74,18,[2 6],75,-1,93,-1,75
1,<environment.Job instance at 0x7f92e88c5370>,76,17,[3 9],77,-1,103,-1,86
1,<environment.Job instance at 0x7f92e9846820>,21,18,[3 7],22,-1,123,-1,105
1,<environment.Job instance at 0x7f92e88c57d0>,78,17,[2 8],79,-1,122,-1,105
1,<environment.Job instance at 0x7f92e8020730>,100,16,[ 4 10],101,-1,121,-1,105
1,<environment.Job instance at 0x7f92e8020fa0>,103,17,[13  3],104,-1,137,-1,120
1,<environment.Job instance at 0x7f92e85a78c0>,85,16,[4 8],86,-1,136,-1,120
1,<environment.Job instance at 0x7f92e8af5f50>,107,13,[12  4],108,-1,133,-1,120
1,<environment.Job instance at 0x7f92e84a8f00>,111,16,[ 5 10],112,-1,145,-1,129
1,<environment.Job instance at 0x7f92e84a8b40>,112,15,[9 1],113,-1,145,-1,130
1,<environment.Job instance at 0x7f92e8d16870>,114,13,[9 1],115,-1,143,-1,130
1,<environment.Job instance at 0x7f92f2440320>,115,21,[3 8],116,-1,152,-1,131
1,<environment.Job instance at 0x7f92e89bac80>,117,18,[ 3 12],118,-1,149,-1,131
1,<environment.Job instance at 0x7f92e96624b0>,148,16,[10  5],149,-1,399,-1,383
1,<environment.Job instance at 0x7f92e98162d0>,11,13,[ 4 11],12,-1,31,-1,18
1,<environment.Job instance at 0x7f92e8d635a0>,19,15,[14  4],20,-1,56,-1,41
1,<environment.Job instance at 0x7f92e84c75f0>,27,24,[9 5],28,-1,85,-1,61
1,<environment.Job instance at 0x7f92e9846500>,36,1,[12  5],37,-1,107,-1,106
1,<environment.Job instance at 0x7f92e8a5cb90>,39,16,[13  2],40,-1,125,-1,109
1,<environment.Job instance at 0x7f92e800f0f0>,65,13,[13  1],66,-1,187,-1,174
1,<environment.Job instance at 0x7f92e89ec910>,68,17,[ 3 13],69,-1,201,-1,184
1,<environment.Job instance at 0x7f92e9717140>,75,13,[ 4 14],76,-1,218,-1,205
1,<environment.Job instance at 0x7f92e97ca320>,82,25,[3 6],83,-1,256,-1,231
1,<environment.Job instance at 0x7f92e8e2c870>,88,3,[ 1 13],89,-1,252,-1,249
1,<environment.Job instance at 0x7f92e88a1c80>,103,17,[13  3],104,-1,295,-1,278
1,<environment.Job instance at 0x7f92e97c0230>,107,13,[12  4],108,-1,304,-1,291
1,<environment.Job instance at 0x7f92e9644230>,117,18,[ 3 12],118,-1,344,-1,326
1,<environment.Job instance at 0x7f92e98696e0>,131,16,[ 1 11],132,-1,417,-1,401
1,<environment.Job instance at 0x7f92e91d80f0>,143,18,[12  1],144,-1,462,-1,444
1,<environment.Job instance at 0x7f92e82825a0>,0,13,[10  5],1,-1,16,-1,3
1,<environment.Job instance at 0x7f92e86f4730>,2,26,[8 2],3,-1,29,-1,3
1,<environment.Job instance at 0x7f92e86f4230>,5,18,[10  1],6,-1,25,-1,7
1,<environment.Job instance at 0x7f92e8a01370>,7,13,[8 1],8,-1,21,-1,8
1,<environment.Job instance at 0x7f92e86f4af0>,6,27,[5 8],7,-1,35,-1,8
1,<environment.Job instance at 0x7f92e8ffdc30>,10,21,[5 7],11,-1,32,-1,11
1,<environment.Job instance at 0x7f92e808c2d0>,18,16,[2 8],19,-1,36,-1,20
1,<environment.Job instance at 0x7f92e947dcd0>,22,12,[2 7],23,-1,35,-1,23
1,<environment.Job instance at 0x7f92e8e7c640>,23,26,[7 3],24,-1,50,-1,24
1,<environment.Job instance at 0x7f92e8e7c320>,24,18,[5 8],25,-1,43,-1,25
1,<environment.Job instance at 0x7f92e8e924b0>,25,15,[3 7],26,-1,41,-1,26
1,<environment.Job instance at 0x7f92e8e92050>,26,17,[5 7],27,-1,44,-1,27
1,<environment.Job instance at 0x7f92e822d280>,27,14,[ 4 10],28,-1,42,-1,28
1,<environment.Job instance at 0x7f92e822d1e0>,29,16,[3 7],30,-1,46,-1,30
1,<environment.Job instance at 0x7f92e86905a0>,32,13,[4 9],33,-1,46,-1,33
1,<environment.Job instance at 0x7f92f1eb6370>,36,12,[8 5],37,-1,49,-1,37
1,<environment.Job instance at 0x7f92f1eb6910>,37,24,[9 3],38,-1,62,-1,38
1,<environment.Job instance at 0x7f92e7f12fa0>,39,15,[10  1],40,-1,55,-1,40
1,<environment.Job instance at 0x7f92e7f12230>,40,18,[8 5],41,-1,59,-1,41
1,<environment.Job instance at 0x7f92e7f12640>,42,14,[8 4],43,-1,57,-1,43
1,<environment.Job instance at 0x7f92e7f12dc0>,43,15,[3 5],44,-1,59,-1,44
1,<environment.Job instance at 0x7f92e9069f00>,19,12,[5 1],20,-1,56,-1,44
1,<environment.Job instance at 0x7f92e8fdf7d0>,54,17,[9 3],55,-1,73,-1,56
1,<environment.Job instance at 0x7f92e808e500>,56,17,[2 5],57,-1,74,-1,57
1,<environment.Job instance at 0x7f92e7f18190>,59,14,[7 4],60,-1,74,-1,60
1,<environment.Job instance at 0x7f92e7f18f00>,60,13,[5 7],61,-1,74,-1,61
1,<environment.Job instance at 0x7f92e7f18c80>,61,17,[ 5 10],62,-1,79,-1,62
1,<environment.Job instance at 0x7f92e7f18690>,62,17,[6 5],63,-1,80,-1,63
1,<environment.Job instance at 0x7f92e7f39910>,63,14,[1 7],64,-1,78,-1,64
1,<environment.Job instance at 0x7f92e7f39fa0>,64,16,[ 2 11],65,-1,81,-1,65
1,<environment.Job instance at 0x7f92e8c056e0>,65,12,[10  5],66,-1,78,-1,66
1,<environment.Job instance at 0x7f92e9496be0>,66,19,[5 9],67,-1,86,-1,67
1,<environment.Job instance at 0x7f92e930b460>,67,17,[4 5],68,-1,85,-1,68
1,<environment.Job instance at 0x7f92e92390a0>,70,16,[4 9],71,-1,87,-1,71
1,<environment.Job instance at 0x7f92e97ebf50>,74,13,[9 2],75,-1,88,-1,75
1,<environment.Job instance at 0x7f92e97eb5f0>,76,15,[2 9],77,-1,92,-1,77
1,<environment.Job instance at 0x7f92e97eb230>,77,17,[3 8],78,-1,95,-1,78
1,<environment.Job instance at 0x7f92e97eb190>,78,18,[5 5],79,-1,97,-1,79
1,<environment.Job instance at 0x7f92e8fdfdc0>,55,20,[5 6],56,-1,118,-1,98
1,<environment.Job instance at 0x7f92e97eb960>,91,28,[7 5],92,-1,126,-1,98
1,<environment.Job instance at 0x7f92e8b3d910>,102,17,[9 3],103,-1,163,-1,146
1,<environment.Job instance at 0x7f92e97ebaf0>,86,15,[8 4],87,-1,199,-1,184
1,<environment.Job instance at 0x7f92e97eb550>,83,20,[2 6],84,-1,204,-1,184
1,<environment.Job instance at 0x7f92f237cdc0>,6,27,[5 8],7,-1,36,-1,9
1,<environment.Job instance at 0x7f92e821bbe0>,2,26,[8 2],3,-1,40,-1,14
1,<environment.Job instance at 0x7f92e9670c30>,20,3,[ 3 12],21,-1,24,-1,21
1,<environment.Job instance at 0x7f92e8a47640>,23,26,[7 3],24,-1,60,-1,34
1,<environment.Job instance at 0x7f92e92c8190>,37,24,[9 3],38,-1,118,-1,94
1,<environment.Job instance at 0x7f92e83e7500>,44,1,[12  4],45,-1,117,-1,116
1,<environment.Job instance at 0x7f92e83e70a0>,46,25,[10  1],47,-1,155,-1,130
1,<environment.Job instance at 0x7f92e8629be0>,50,24,[ 4 13],51,-1,157,-1,133
1,<environment.Job instance at 0x7f92e8629f00>,51,14,[12  1],52,-1,147,-1,133
1,<environment.Job instance at 0x7f92e8187a50>,53,27,[4 5],54,-1,175,-1,148
1,<environment.Job instance at 0x7f92e81f9910>,64,16,[ 2 11],65,-1,208,-1,192
1,<environment.Job instance at 0x7f92e800f0f0>,79,16,[13  5],80,-1,271,-1,255
1,<environment.Job instance at 0x7f92e932bd70>,87,1,[ 3 11],88,-1,292,-1,291
1,<environment.Job instance at 0x7f92e932bfa0>,91,28,[7 5],92,-1,350,-1,322
1,<environment.Job instance at 0x7f92f20bd6e0>,117,1,[ 2 11],118,-1,431,-1,430
1,<environment.Job instance at 0x7f92e80a0960>,125,3,[ 4 12],126,-1,460,-1,457
1,<environment.Job instance at 0x7f92e80a0cd0>,127,18,[ 3 11],128,-1,480,-1,462
1,<environment.Job instance at 0x7f92e80a0500>,128,2,[14  5],129,-1,464,-1,462
1,<environment.Job instance at 0x7f92e80a0730>,136,24,[5 3],137,-1,521,-1,497
1,<environment.Job instance at 0x7f92e8c7a410>,144,28,[10  4],145,-1,560,-1,532
1,<environment.Job instance at 0x7f92e8c7ae10>,145,15,[ 4 12],146,-1,547,-1,532
1,<environment.Job instance at 0x7f92e9379410>,1,18,[ 5 10],2,-1,20,-1,2
1,<environment.Job instance at 0x7f92e987a410>,3,18,[2 7],4,-1,22,-1,4
1,<environment.Job instance at 0x7f92e9364af0>,5,15,[10  1],6,-1,25,-1,10
1,<environment.Job instance at 0x7f92e9364cd0>,9,14,[8 2],10,-1,25,-1,11
1,<environment.Job instance at 0x7f92e936a410>,13,17,[ 1 10],14,-1,32,-1,15
1,<environment.Job instance at 0x7f92e93672d0>,20,15,[ 4 10],21,-1,36,-1,21
1,<environment.Job instance at 0x7f92e9367320>,22,15,[7 5],23,-1,38,-1,23
1,<environment.Job instance at 0x7f92e8f73730>,25,16,[9 5],26,-1,42,-1,26
1,<environment.Job instance at 0x7f92e8f73cd0>,26,18,[6 5],27,-1,45,-1,27
1,<environment.Job instance at 0x7f92e84dc640>,34,12,[10  4],35,-1,47,-1,35
1,<environment.Job instance at 0x7f92e84dcb90>,35,21,[ 2 10],36,-1,57,-1,36
1,<environment.Job instance at 0x7f92e84dc5a0>,36,15,[8 4],37,-1,52,-1,37
1,<environment.Job instance at 0x7f92e84dcfa0>,37,16,[2 5],38,-1,54,-1,38
1,<environment.Job instance at 0x7f92e936a0f0>,14,19,[3 6],15,-1,61,-1,42
1,<environment.Job instance at 0x7f92e84f9f50>,43,12,[9 4],44,-1,63,-1,51
1,<environment.Job instance at 0x7f92e87ff8c0>,52,16,[4 9],53,-1,69,-1,53
1,<environment.Job instance at 0x7f92e87ff820>,55,20,[5 4],56,-1,76,-1,56
1,<environment.Job instance at 0x7f92e880b500>,61,17,[5 8],62,-1,79,-1,62
1,<environment.Job instance at 0x7f92e880b780>,64,16,[ 5 10],65,-1,84,-1,68
1,<environment.Job instance at 0x7f92e880f550>,68,21,[1 6],69,-1,90,-1,69
1,<environment.Job instance at 0x7f92e880f690>,70,17,[2 8],71,-1,88,-1,71
1,<environment.Job instance at 0x7f92e87ff500>,50,24,[2 5],51,-1,96,-1,72
1,<environment.Job instance at 0x7f92e880fdc0>,75,16,[7 5],76,-1,93,-1,77
1,<environment.Job instance at 0x7f92e880f820>,74,16,[2 9],75,-1,96,-1,80
1,<environment.Job instance at 0x7f92e8836af0>,80,15,[9 1],81,-1,96,-1,81
1,<environment.Job instance at 0x7f92e8836cd0>,81,16,[10  5],82,-1,98,-1,82
1,<environment.Job instance at 0x7f92e88363c0>,79,16,[14  3],80,-1,100,-1,84
1,<environment.Job instance at 0x7f92e880ea50>,84,16,[2 6],85,-1,102,-1,86
1,<environment.Job instance at 0x7f92e84659b0>,95,17,[6 3],96,-1,121,-1,104
1,<environment.Job instance at 0x7f92e81a3d20>,91,17,[9 1],92,-1,122,-1,105
1,<environment.Job instance at 0x7f92e8465640>,97,19,[ 4 10],98,-1,124,-1,105
1,<environment.Job instance at 0x7f92e9379960>,67,22,[10  3],68,-1,127,-1,105
1,<environment.Job instance at 0x7f92e8f8cf50>,93,13,[10  5],94,-1,118,-1,105
1,<environment.Job instance at 0x7f92e8465550>,100,14,[6 2],101,-1,119,-1,105
1,<environment.Job instance at 0x7f92e846b190>,102,16,[8 2],103,-1,121,-1,105
1,<environment.Job instance at 0x7f92e88114b0>,56,24,[ 1 10],57,-1,129,-1,105
1,<environment.Job instance at 0x7f92e8465be0>,96,18,[5 9],97,-1,123,-1,105
1,<environment.Job instance at 0x7f92e8450370>,106,23,[ 4 10],107,-1,130,-1,107
1,<environment.Job instance at 0x7f92e880f4b0>,7,2,[ 5 12],8,-1,10,-1,8
1,<environment.Job instance at 0x7f92e9892d70>,12,25,[2 8],13,-1,48,-1,23
1,<environment.Job instance at 0x7f92e80a00a0>,16,26,[ 1 12],17,-1,49,-1,23
1,<environment.Job instance at 0x7f92fae3d3c0>,23,2,[11  4],24,-1,53,-1,51
1,<environment.Job instance at 0x7f92e9717820>,27,2,[11  1],28,-1,58,-1,56
1,<environment.Job instance at 0x7f92e835d0a0>,39,2,[ 3 11],40,-1,97,-1,95
1,<environment.Job instance at 0x7f92e8378c30>,50,24,[2 5],51,-1,145,-1,121
1,<environment.Job instance at 0x7f92e8bc35a0>,57,3,[13  1],58,-1,141,-1,138
1,<environment.Job instance at 0x7f92e8be8c80>,56,24,[ 1 10],57,-1,163,-1,139
1,<environment.Job instance at 0x7f92e8bf7b40>,63,25,[4 6],64,-1,181,-1,156
1,<environment.Job instance at 0x7f92e98e2640>,73,18,[ 5 12],74,-1,205,-1,187
1,<environment.Job instance at 0x7f92e8bc4be0>,79,16,[14  3],80,-1,223,-1,207
1,<environment.Job instance at 0x7f92e98bc730>,89,3,[14  2],90,-1,250,-1,247
1,<environment.Job instance at 0x7f92e8c581e0>,106,23,[ 4 10],107,-1,343,-1,320
1,<environment.Job instance at 0x7f92e98cb6e0>,109,2,[13  2],110,-1,323,-1,321
1,<environment.Job instance at 0x7f92e8179230>,123,24,[ 5 11],124,-1,395,-1,371
1,<environment.Job instance at 0x7f92e8394be0>,134,16,[12  5],135,-1,440,-1,424
1,<environment.Job instance at 0x7f92e8944500>,141,19,[14  4],142,-1,462,-1,443
1,<environment.Job instance at 0x7f92f1e1d690>,147,3,[ 5 11],148,-1,470,-1,467
1,<environment.Job instance at 0x7f92e8c4cc30>,148,1,[11  4],149,-1,468,-1,467
1,<environment.Job instance at 0x7f92e880e730>,2,17,[5 5],3,-1,20,-1,3
1,<environment.Job instance at 0x7f92e880e050>,6,17,[7 1],7,-1,24,-1,7
1,<environment.Job instance at 0x7f92e880eeb0>,7,16,[6 1],8,-1,24,-1,8
1,<environment.Job instance at 0x7f92e880efa0>,9,16,[9 2],10,-1,26,-1,10
1,<environment.Job instance at 0x7f92e880e140>,13,17,[2 7],14,-1,31,-1,14
1,<environment.Job instance at 0x7f92e8f807d0>,16,17,[ 2 10],17,-1,35,-1,18
1,<environment.Job instance at 0x7f92e8f803c0>,18,14,[3 5],19,-1,33,-1,19
1,<environment.Job instance at 0x7f92e8f80f50>,19,16,[6 3],20,-1,36,-1,20
1,<environment.Job instance at 0x7f92e8f80eb0>,20,14,[7 4],21,-1,35,-1,21
1,<environment.Job instance at 0x7f92e8f80c80>,21,13,[6 4],22,-1,35,-1,22
1,<environment.Job instance at 0x7f92e8f80cd0>,23,18,[5 3],24,-1,42,-1,24
1,<environment.Job instance at 0x7f92e8f80960>,24,14,[7 5],25,-1,39,-1,25
1,<environment.Job instance at 0x7f92e8f80910>,17,16,[3 9],18,-1,41,-1,25
1,<environment.Job instance at 0x7f92e8f80820>,26,22,[8 4],27,-1,49,-1,27
1,<environment.Job instance at 0x7f92e8f80780>,27,20,[5 5],28,-1,48,-1,28
1,<environment.Job instance at 0x7f92e8f800a0>,28,20,[6 2],29,-1,49,-1,29
1,<environment.Job instance at 0x7f92e8f805f0>,30,17,[11  3],31,-1,48,-1,31
1,<environment.Job instance at 0x7f92e846b4b0>,32,15,[6 5],33,-1,48,-1,33
1,<environment.Job instance at 0x7f92e846b5a0>,37,14,[5 4],38,-1,53,-1,39
1,<environment.Job instance at 0x7f92e846b0f0>,41,12,[8 3],42,-1,54,-1,42
1,<environment.Job instance at 0x7f92e846b9b0>,42,12,[10  2],43,-1,55,-1,43
1,<environment.Job instance at 0x7f92e8cd82d0>,43,13,[3 6],44,-1,57,-1,44
1,<environment.Job instance at 0x7f92e8cd8820>,44,17,[5 1],45,-1,62,-1,45
1,<environment.Job instance at 0x7f92e8cd8fa0>,47,23,[2 9],48,-1,71,-1,48
1,<environment.Job instance at 0x7f92e8cd8b90>,49,16,[7 1],50,-1,66,-1,50
1,<environment.Job instance at 0x7f92e8839b40>,50,15,[4 6],51,-1,66,-1,51
1,<environment.Job instance at 0x7f92e88395a0>,53,16,[8 1],54,-1,70,-1,54
1,<environment.Job instance at 0x7f92e88393c0>,54,17,[5 5],55,-1,72,-1,55
1,<environment.Job instance at 0x7f92e8839370>,56,15,[10  3],57,-1,73,-1,58
1,<environment.Job instance at 0x7f92e8839c80>,58,2,[1 8],59,-1,61,-1,59
1,<environment.Job instance at 0x7f92e88396e0>,59,18,[4 9],60,-1,78,-1,60
1,<environment.Job instance at 0x7f92e8839500>,61,1,[5 6],62,-1,63,-1,62
1,<environment.Job instance at 0x7f92e8839cd0>,62,13,[4 8],63,-1,76,-1,63
1,<environment.Job instance at 0x7f92e8839c30>,63,16,[6 1],64,-1,80,-1,64
1,<environment.Job instance at 0x7f92e8839a00>,64,13,[5 5],65,-1,78,-1,65
1,<environment.Job instance at 0x7f92e8839d20>,57,15,[5 3],58,-1,81,-1,66
1,<environment.Job instance at 0x7f92e8f62460>,70,13,[10  5],71,-1,85,-1,72
1,<environment.Job instance at 0x7f92e8f626e0>,71,23,[10  2],72,-1,95,-1,72
1,<environment.Job instance at 0x7f92e8f62640>,74,18,[2 9],75,-1,93,-1,75
1,<environment.Job instance at 0x7f92e8f62c80>,75,17,[5 9],76,-1,93,-1,76
1,<environment.Job instance at 0x7f92e8f62190>,78,18,[1 6],79,-1,97,-1,79
1,<environment.Job instance at 0x7f92e8f62140>,79,15,[1 8],80,-1,95,-1,80
1,<environment.Job instance at 0x7f92e8f730f0>,81,15,[4 5],82,-1,97,-1,82
1,<environment.Job instance at 0x7f92e8f73870>,82,15,[9 3],83,-1,98,-1,83
1,<environment.Job instance at 0x7f92e8f73370>,83,14,[1 6],84,-1,98,-1,84
1,<environment.Job instance at 0x7f92e8f73b90>,86,15,[9 5],87,-1,102,-1,87
1,<environment.Job instance at 0x7f92e8f73c80>,87,17,[10  1],88,-1,106,-1,89
1,<environment.Job instance at 0x7f92e8f73050>,89,17,[3 7],90,-1,107,-1,90
1,<environment.Job instance at 0x7f92e8f730a0>,90,1,[9 4],91,-1,92,-1,91
1,<environment.Job instance at 0x7f92e8f73910>,88,16,[ 5 10],89,-1,108,-1,92
1,<environment.Job instance at 0x7f92e8f739b0>,94,18,[8 4],95,-1,114,-1,96
1,<environment.Job instance at 0x7f92e8836690>,104,12,[ 3 10],105,-1,117,-1,105
1,<environment.Job instance at 0x7f92e88062d0>,105,13,[10  4],106,-1,123,-1,110
1,<environment.Job instance at 0x7f92e84736e0>,109,17,[4 5],110,-1,127,-1,110
1,<environment.Job instance at 0x7f92e8473eb0>,111,21,[9 2],112,-1,135,-1,114
1,<environment.Job instance at 0x7f92e841a410>,113,15,[8 1],114,-1,129,-1,114
1,<environment.Job instance at 0x7f92e8ce7fa0>,116,12,[8 4],117,-1,130,-1,118
1,<environment.Job instance at 0x7f92e8473640>,117,22,[8 1],118,-1,140,-1,118
1,<environment.Job instance at 0x7f92e94be320>,119,14,[ 4 10],120,-1,135,-1,121
1,<environment.Job instance at 0x7f92e84470a0>,121,16,[5 5],122,-1,138,-1,122
1,<environment.Job instance at 0x7f92f1f2aaf0>,122,17,[1 6],123,-1,140,-1,123
1,<environment.Job instance at 0x7f92e94be820>,120,14,[6 3],121,-1,137,-1,123
1,<environment.Job instance at 0x7f92e87ff410>,125,17,[10  3],126,-1,144,-1,127
1,<environment.Job instance at 0x7f92e844d4b0>,130,13,[10  2],131,-1,144,-1,131
1,<environment.Job instance at 0x7f92e87ff730>,126,16,[ 3 10],127,-1,147,-1,131
1,<environment.Job instance at 0x7f92e987a1e0>,138,12,[7 1],139,-1,155,-1,143
1,<environment.Job instance at 0x7f92e8f68960>,142,16,[8 3],143,-1,159,-1,143
1,<environment.Job instance at 0x7f92e987aaa0>,137,15,[3 7],138,-1,211,-1,196
1,<environment.Job instance at 0x7f92e96990f0>,30,17,[11  3],31,-1,97,-1,80
1,<environment.Job instance at 0x7f92f1ef5960>,35,1,[ 5 14],36,-1,107,-1,106
1,<environment.Job instance at 0x7f92e868c870>,47,23,[2 9],48,-1,163,-1,140
1,<environment.Job instance at 0x7f92e9313230>,48,2,[ 1 11],49,-1,142,-1,140
1,<environment.Job instance at 0x7f92e8f1b820>,71,23,[10  2],72,-1,254,-1,231
1,<environment.Job instance at 0x7f92e8f8fd70>,91,26,[14  5],92,-1,351,-1,325
1,<environment.Job instance at 0x7f92e934a5f0>,100,17,[ 5 11],101,-1,370,-1,353
1,<environment.Job instance at 0x7f92e922b320>,114,3,[13  3],115,-1,397,-1,394
1,<environment.Job instance at 0x7f92e8886280>,131,25,[12  4],132,-1,480,-1,455
1,<environment.Job instance at 0x7f92e98bdc30>,8,16,[ 4 12],9,-1,25,-1,9
1,<environment.Job instance at 0x7f92e98bdbe0>,9,18,[7 1],10,-1,28,-1,10
1,<environment.Job instance at 0x7f92e87ff1e0>,11,18,[7 5],12,-1,30,-1,12
1,<environment.Job instance at 0x7f92e87ff550>,14,13,[ 2 10],15,-1,28,-1,15
1,<environment.Job instance at 0x7f92e87ff370>,16,17,[6 5],17,-1,34,-1,17
1,<environment.Job instance at 0x7f92e87ff910>,17,18,[9 5],18,-1,36,-1,18
1,<environment.Job instance at 0x7f92e87ff050>,18,13,[10  3],19,-1,35,-1,22
1,<environment.Job instance at 0x7f92e87ffa00>,23,13,[3 9],24,-1,37,-1,24
1,<environment.Job instance at 0x7f92e9362960>,24,17,[9 4],25,-1,42,-1,25
1,<environment.Job instance at 0x7f92e9362730>,26,23,[ 4 10],27,-1,50,-1,27
1,<environment.Job instance at 0x7f92e93627d0>,27,15,[10  1],28,-1,43,-1,28
1,<environment.Job instance at 0x7f92e9362b40>,29,16,[3 8],30,-1,46,-1,30
1,<environment.Job instance at 0x7f92e9362640>,31,28,[9 4],32,-1,60,-1,32
1,<environment.Job instance at 0x7f92e9362780>,36,16,[7 3],37,-1,53,-1,37
1,<environment.Job instance at 0x7f92e84cfc80>,39,17,[10  5],40,-1,57,-1,40
1,<environment.Job instance at 0x7f92e9881d20>,44,25,[1 6],45,-1,70,-1,45
1,<environment.Job instance at 0x7f92e9881550>,46,18,[7 1],47,-1,65,-1,47
1,<environment.Job instance at 0x7f92e84df050>,51,18,[9 3],52,-1,70,-1,52
1,<environment.Job instance at 0x7f92e8bd0aa0>,55,16,[3 7],56,-1,72,-1,56
1,<environment.Job instance at 0x7f92e8bd0140>,58,14,[7 2],59,-1,74,-1,60
1,<environment.Job instance at 0x7f92e8bd0960>,56,13,[ 1 10],57,-1,73,-1,60
1,<environment.Job instance at 0x7f92e8bd0fa0>,61,14,[8 4],62,-1,76,-1,62
1,<environment.Job instance at 0x7f92e8bd0730>,62,24,[3 5],63,-1,87,-1,63
1,<environment.Job instance at 0x7f92e8bd0f50>,64,16,[5 5],65,-1,81,-1,65
1,<environment.Job instance at 0x7f92e8bd00a0>,66,15,[4 5],67,-1,82,-1,67
1,<environment.Job instance at 0x7f92e9899190>,73,14,[11  5],74,-1,88,-1,74
1,<environment.Job instance at 0x7f92e816b500>,74,17,[3 7],75,-1,92,-1,75
1,<environment.Job instance at 0x7f92e816b3c0>,75,14,[4 9],76,-1,90,-1,76
1,<environment.Job instance at 0x7f92e8947280>,79,15,[9 4],80,-1,95,-1,80
1,<environment.Job instance at 0x7f92e8947870>,81,19,[5 8],82,-1,101,-1,82
1,<environment.Job instance at 0x7f92e84bfd20>,82,13,[4 6],83,-1,96,-1,83
1,<environment.Job instance at 0x7f92e84bf1e0>,84,14,[ 1 10],85,-1,99,-1,85
1,<environment.Job instance at 0x7f92e8bd0190>,59,16,[4 7],60,-1,107,-1,91
1,<environment.Job instance at 0x7f92e8bd05f0>,57,14,[5 3],58,-1,106,-1,92
1,<environment.Job instance at 0x7f92e8bd0be0>,65,27,[1 5],66,-1,120,-1,93
1,<environment.Job instance at 0x7f92e85fa1e0>,92,16,[8 5],93,-1,110,-1,94
1,<environment.Job instance at 0x7f92e88392d0>,93,21,[4 8],94,-1,115,-1,94
1,<environment.Job instance at 0x7f92e85fae60>,89,15,[6 3],90,-1,109,-1,94
1,<environment.Job instance at 0x7f92e8b6b8c0>,94,13,[7 1],95,-1,108,-1,95
1,<environment.Job instance at 0x7f92e85fabe0>,91,13,[5 5],92,-1,110,-1,97
1,<environment.Job instance at 0x7f92e8404870>,101,2,[2 6],102,-1,105,-1,103
1,<environment.Job instance at 0x7f92e9233dc0>,102,12,[7 5],103,-1,115,-1,103
1,<environment.Job instance at 0x7f92e9899050>,69,14,[4 8],70,-1,118,-1,104
1,<environment.Job instance at 0x7f92e85657d0>,98,17,[ 1 10],99,-1,121,-1,104
1,<environment.Job instance at 0x7f92e98922d0>,104,16,[ 2 11],105,-1,122,-1,106
1,<environment.Job instance at 0x7f92e98927d0>,107,15,[4 6],108,-1,123,-1,108
1,<environment.Job instance at 0x7f92e8abf140>,100,12,[2 7],101,-1,121,-1,109
1,<environment.Job instance at 0x7f92e940d690>,114,14,[9 4],115,-1,136,-1,122
1,<environment.Job instance at 0x7f92f1e72e60>,121,17,[ 3 10],122,-1,154,-1,137
1,<environment.Job instance at 0x7f92e8fd95a0>,135,19,[9 4],136,-1,220,-1,201
1,<environment.Job instance at 0x7f92e9644550>,146,17,[3 7],147,-1,219,-1,202
1,<environment.Job instance at 0x7f92e9644c30>,148,15,[10  2],149,-1,217,-1,202
1,<environment.Job instance at 0x7f92e84cfc30>,8,16,[ 4 12],9,-1,25,-1,9
1,<environment.Job instance at 0x7f92e8bd0d20>,12,3,[12  2],13,-1,16,-1,13
1,<environment.Job instance at 0x7f92e9899a00>,13,18,[13  1],14,-1,32,-1,14
1,<environment.Job instance at 0x7f92e96c08c0>,26,23,[ 4 10],27,-1,90,-1,67
1,<environment.Job instance at 0x7f92e9644fa0>,31,28,[9 4],32,-1,102,-1,74
1,<environment.Job instance at 0x7f92e80a13c0>,32,25,[12  5],33,-1,99,-1,74
1,<environment.Job instance at 0x7f92e7f62410>,44,25,[1 6],45,-1,149,-1,124
1,<environment.Job instance at 0x7f92e8eeca00>,62,24,[3 5],63,-1,232,-1,208
1,<environment.Job instance at 0x7f92e8eecaa0>,65,27,[1 5],66,-1,249,-1,222
1,<environment.Job instance at 0x7f92e8f1b640>,73,14,[11  5],74,-1,254,-1,240
1,<environment.Job instance at 0x7f92e8ce8aa0>,104,16,[ 2 11],105,-1,368,-1,352
1,<environment.Job instance at 0x7f92e92b70f0>,106,2,[11  2],107,-1,356,-1,354
1,<environment.Job instance at 0x7f92e8f80c30>,116,15,[13  1],117,-1,402,-1,387
1,<environment.Job instance at 0x7f92e8f73960>,132,1,[11  5],133,-1,424,-1,423
1,<environment.Job instance at 0x7f92e89447d0>,141,3,[11  1],142,-1,449,-1,446
1,<environment.Job instance at 0x7f92e880bfa0>,142,2,[11  5],143,-1,448,-1,446
1,<environment.Job instance at 0x7f92e88368c0>,145,26,[9 2],146,-1,488,-1,462
1,<environment.Job instance at 0x7f92e8944a50>,140,28,[6 4],141,-1,490,-1,462
1,<environment.Job instance at 0x7f28c9938af0>,2,14,[ 2 10],3,-1,17,-1,3
1,<environment.Job instance at 0x7f28c9938e60>,6,15,[2 8],7,-1,22,-1,7
1,<environment.Job instance at 0x7f28c9938f00>,7,14,[7 5],8,-1,22,-1,8
1,<environment.Job instance at 0x7f28c9938c80>,8,17,[1 8],9,-1,26,-1,9
1,<environment.Job instance at 0x7f28c993b0a0>,10,22,[8 1],11,-1,33,-1,11
1,<environment.Job instance at 0x7f28c993b140>,12,23,[6 4],13,-1,36,-1,13
1,<environment.Job instance at 0x7f28c993b410>,13,18,[5 9],14,-1,32,-1,14
1,<environment.Job instance at 0x7f28c993b320>,14,21,[8 1],15,-1,36,-1,15
1,<environment.Job instance at 0x7f28c993b500>,16,18,[7 3],17,-1,35,-1,17
1,<environment.Job instance at 0x7f28c993b5f0>,18,26,[7 4],19,-1,45,-1,19
1,<environment.Job instance at 0x7f28c993b820>,19,25,[5 9],20,-1,45,-1,20
1,<environment.Job instance at 0x7f28c993b8c0>,21,18,[9 4],22,-1,40,-1,22
1,<environment.Job instance at 0x7f28c993ba00>,22,12,[3 8],23,-1,35,-1,23
1,<environment.Job instance at 0x7f28c993b910>,23,16,[6 2],24,-1,40,-1,24
1,<environment.Job instance at 0x7f28c993bdc0>,26,12,[8 5],27,-1,39,-1,27
1,<environment.Job instance at 0x7f28c993bf00>,27,17,[4 6],28,-1,45,-1,28
1,<environment.Job instance at 0x7f28c99410a0>,45,15,[7 5],46,-1,61,-1,46
1,<environment.Job instance at 0x7f28c9941140>,47,13,[ 3 10],48,-1,62,-1,49
1,<environment.Job instance at 0x7f28c9941320>,49,17,[10  2],50,-1,67,-1,50
1,<environment.Job instance at 0x7f28c993e190>,33,26,[3 6],34,-1,84,-1,58
1,<environment.Job instance at 0x7f28c9941230>,48,12,[9 2],49,-1,71,-1,59
1,<environment.Job instance at 0x7f28c9941a00>,54,18,[7 1],55,-1,77,-1,59
1,<environment.Job instance at 0x7f28c993e910>,40,26,[ 1 10],41,-1,85,-1,59
1,<environment.Job instance at 0x7f28c9941730>,58,17,[3 7],59,-1,76,-1,59
1,<environment.Job instance at 0x7f28c9941e60>,59,19,[1 7],60,-1,82,-1,63
1,<environment.Job instance at 0x7f28c993e1e0>,32,21,[5 9],33,-1,91,-1,70
1,<environment.Job instance at 0x7f28c99425f0>,67,16,[1 9],68,-1,86,-1,70
1,<environment.Job instance at 0x7f28c9942960>,69,14,[9 4],70,-1,89,-1,75
1,<environment.Job instance at 0x7f28c9942b40>,72,18,[3 5],73,-1,93,-1,75
1,<environment.Job instance at 0x7f28c99427d0>,68,14,[6 4],69,-1,89,-1,75
1,<environment.Job instance at 0x7f28c9942aa0>,71,2,[5 1],72,-1,77,-1,75
1,<environment.Job instance at 0x7f28c9942c80>,74,2,[1 7],75,-1,77,-1,75
1,<environment.Job instance at 0x7f28c9941c80>,57,16,[ 2 11],58,-1,93,-1,77
1,<environment.Job instance at 0x7f28c9942f00>,75,3,[10  4],76,-1,80,-1,77
1,<environment.Job instance at 0x7f28c9942fa0>,77,16,[8 1],78,-1,94,-1,78
1,<environment.Job instance at 0x7f28c99450a0>,78,14,[6 1],79,-1,93,-1,79
1,<environment.Job instance at 0x7f28c9945140>,79,19,[10  3],80,-1,99,-1,80
1,<environment.Job instance at 0x7f28c9945280>,81,14,[8 5],82,-1,96,-1,82
1,<environment.Job instance at 0x7f28c99453c0>,82,21,[4 8],83,-1,104,-1,83
1,<environment.Job instance at 0x7f28c99452d0>,83,18,[ 3 10],84,-1,102,-1,84
1,<environment.Job instance at 0x7f28c99455a0>,85,15,[1 7],86,-1,103,-1,88
1,<environment.Job instance at 0x7f28c9945a00>,88,16,[4 9],89,-1,105,-1,89
1,<environment.Job instance at 0x7f28c9945af0>,91,18,[5 4],92,-1,112,-1,94
1,<environment.Job instance at 0x7f28c9945be0>,93,25,[ 1 10],94,-1,120,-1,95
1,<environment.Job instance at 0x7f28c992f780>,96,18,[2 6],97,-1,120,-1,102
1,<environment.Job instance at 0x7f28c992f640>,102,13,[9 4],103,-1,118,-1,105
1,<environment.Job instance at 0x7f28c9a5d460>,105,16,[7 5],106,-1,122,-1,106
1,<environment.Job instance at 0x7f28c9945870>,87,18,[7 1],88,-1,129,-1,111
1,<environment.Job instance at 0x7f28c990fcd0>,107,18,[5 5],108,-1,129,-1,111
1,<environment.Job instance at 0x7f28c9a5f690>,109,27,[3 9],110,-1,139,-1,112
1,<environment.Job instance at 0x7f28c99c9f00>,113,17,[5 1],114,-1,131,-1,114
1,<environment.Job instance at 0x7f28c99b3320>,111,17,[6 4],112,-1,134,-1,117
1,<environment.Job instance at 0x7f28c9a45c30>,119,28,[7 5],120,-1,148,-1,120
1,<environment.Job instance at 0x7f28c99459b0>,89,17,[ 5 14],90,-1,141,-1,124
1,<environment.Job instance at 0x7f28c9ac5410>,120,19,[ 5 12],121,-1,143,-1,124
1,<environment.Job instance at 0x7f28c9a45960>,118,16,[5 2],119,-1,150,-1,134
1,<environment.Job instance at 0x7f28c99604b0>,130,17,[9 5],131,-1,151,-1,134
1,<environment.Job instance at 0x7f28c9960410>,131,13,[3 8],132,-1,147,-1,134
1,<environment.Job instance at 0x7f28c9960af0>,132,18,[10  4],133,-1,152,-1,134
1,<environment.Job instance at 0x7f28c99602d0>,133,2,[ 5 10],134,-1,136,-1,134
1,<environment.Job instance at 0x7f28c9960690>,129,13,[5 5],130,-1,147,-1,134
1,<environment.Job instance at 0x7f28c9a5b320>,134,12,[5 4],135,-1,148,-1,136
1,<environment.Job instance at 0x7f28c9a5bb40>,135,15,[8 3],136,-1,151,-1,136
1,<environment.Job instance at 0x7f28c9942410>,12,23,[6 4],13,-1,53,-1,30
1,<environment.Job instance at 0x7f28c9a5e230>,18,26,[7 4],19,-1,70,-1,44
1,<environment.Job instance at 0x7f28c99db8c0>,19,25,[5 9],20,-1,83,-1,58
1,<environment.Job instance at 0x7f28c9938c30>,28,17,[ 1 13],29,-1,87,-1,70
1,<environment.Job instance at 0x7f28c99e7a50>,30,26,[9 4],31,-1,110,-1,84
1,<environment.Job instance at 0x7f28c99e77d0>,31,1,[ 2 14],32,-1,85,-1,84
1,<environment.Job instance at 0x7f28c99e70f0>,33,26,[3 6],34,-1,110,-1,84
1,<environment.Job instance at 0x7f28c99e6370>,40,26,[ 1 10],41,-1,139,-1,113
1,<environment.Job instance at 0x7f28c998ee60>,57,16,[ 2 11],58,-1,183,-1,167
1,<environment.Job instance at 0x7f28c99285f0>,89,17,[ 5 14],90,-1,289,-1,272
1,<environment.Job instance at 0x7f28c9928fa0>,93,25,[ 1 10],94,-1,320,-1,295
1,<environment.Job instance at 0x7f28c98d34b0>,109,27,[3 9],110,-1,371,-1,344
1,<environment.Job instance at 0x7f28c98d3550>,110,23,[5 1],111,-1,367,-1,344
1,<environment.Job instance at 0x7f28c98d3b40>,117,3,[ 3 13],118,-1,367,-1,364
1,<environment.Job instance at 0x7f28c98d3be0>,119,28,[7 5],120,-1,406,-1,378
1,<environment.Job instance at 0x7f28c98d3cd0>,120,19,[ 5 12],121,-1,397,-1,378
1,<environment.Job instance at 0x7f28c98d5910>,137,28,[ 2 10],138,-1,458,-1,430
1,<environment.Job instance at 0x7f28c98d5e10>,142,15,[ 2 13],143,-1,450,-1,435
1,<environment.Job instance at 0x7f28c98d5f50>,144,20,[13  4],145,-1,460,-1,440
1,<environment.Job instance at 0x7f28c98d8690>,153,1,[12  5],154,-1,473,-1,472
1,<environment.Job instance at 0x7f28c92ce6e0>,2,20,[10  5],3,-1,25,-1,5
1,<environment.Job instance at 0x7f28c9317c80>,4,14,[10  5],5,-1,19,-1,5
1,<environment.Job instance at 0x7f28c938a8c0>,9,14,[ 5 10],10,-1,25,-1,11
1,<environment.Job instance at 0x7f28c9318fa0>,11,13,[5 7],12,-1,25,-1,12
1,<environment.Job instance at 0x7f28c9314a00>,13,24,[3 7],14,-1,38,-1,14
1,<environment.Job instance at 0x7f28c93148c0>,14,19,[3 8],15,-1,34,-1,15
1,<environment.Job instance at 0x7f28c9314aa0>,15,17,[5 1],16,-1,33,-1,16
1,<environment.Job instance at 0x7f28c9314280>,17,16,[8 4],18,-1,34,-1,18
1,<environment.Job instance at 0x7f28c9314820>,20,17,[3 5],21,-1,38,-1,21
1,<environment.Job instance at 0x7f28c92d3cd0>,21,18,[6 2],22,-1,40,-1,22
1,<environment.Job instance at 0x7f28c9314d70>,24,19,[6 2],25,-1,44,-1,25
1,<environment.Job instance at 0x7f28c9396370>,26,17,[9 1],27,-1,44,-1,27
1,<environment.Job instance at 0x7f28c93961e0>,27,13,[9 5],28,-1,41,-1,28
1,<environment.Job instance at 0x7f28c93a3b90>,34,26,[3 9],35,-1,62,-1,36
1,<environment.Job instance at 0x7f28c93a8780>,40,23,[4 7],41,-1,64,-1,41
1,<environment.Job instance at 0x7f28c952ad20>,30,17,[9 5],31,-1,65,-1,48
1,<environment.Job instance at 0x7f28c93a89b0>,45,19,[ 1 10],46,-1,67,-1,48
1,<environment.Job instance at 0x7f28c9312a00>,10,17,[4 7],11,-1,66,-1,49
1,<environment.Job instance at 0x7f28c93a8a50>,46,16,[6 5],47,-1,65,-1,49
1,<environment.Job instance at 0x7f28c93a8f00>,44,3,[5 6],45,-1,52,-1,49
1,<environment.Job instance at 0x7f28c93ad4b0>,48,20,[ 2 10],49,-1,69,-1,49
1,<environment.Job instance at 0x7f28c93ad460>,49,15,[5 5],50,-1,65,-1,50
1,<environment.Job instance at 0x7f28c93ad370>,50,1,[14  4],51,-1,53,-1,52
1,<environment.Job instance at 0x7f28c93a8e10>,43,14,[5 9],44,-1,66,-1,52
1,<environment.Job instance at 0x7f28c9030f50>,52,13,[2 5],53,-1,66,-1,53
1,<environment.Job instance at 0x7f28c91582d0>,55,21,[1 6],56,-1,77,-1,56
1,<environment.Job instance at 0x7f28c9158aa0>,56,16,[1 8],57,-1,73,-1,57
1,<environment.Job instance at 0x7f28c9158690>,58,23,[1 9],59,-1,83,-1,60
1,<environment.Job instance at 0x7f28d2f284b0>,62,15,[8 2],63,-1,83,-1,68
1,<environment.Job instance at 0x7f28c8f3f820>,64,15,[8 5],65,-1,83,-1,68
1,<environment.Job instance at 0x7f28c8f898c0>,68,19,[4 7],69,-1,88,-1,69
1,<environment.Job instance at 0x7f28c93140a0>,0,24,[1 5],1,-1,25,-1,1
1,<environment.Job instance at 0x7f28c9313f50>,6,13,[ 5 14],7,-1,20,-1,7
1,<environment.Job instance at 0x7f28c98d5910>,13,24,[3 7],14,-1,57,-1,33
1,<environment.Job instance at 0x7f28c98d3e60>,28,27,[ 3 12],29,-1,95,-1,68
1,<environment.Job instance at 0x7f28c98d3870>,32,15,[ 2 14],33,-1,85,-1,70
1,<environment.Job instance at 0x7f28c98d3780>,34,26,[3 9],35,-1,114,-1,88
1,<environment.Job instance at 0x7f28c98d3460>,40,23,[4 7],41,-1,130,-1,107
1,<environment.Job instance at 0x7f28c91aad70>,50,1,[14  4],51,-1,125,-1,124
1,<environment.Job instance at 0x7f28c92cc460>,57,18,[ 1 14],58,-1,173,-1,155
1,<environment.Job instance at 0x7f28c92cc870>,58,23,[1 9],59,-1,194,-1,171
1,<environment.Job instance at 0x7f28c913ed20>,65,17,[12  1],66,-1,191,-1,174
1,<environment.Job instance at 0x7f28c922a960>,70,16,[14  3],71,-1,211,-1,195
1,<environment.Job instance at 0x7f28c9163f00>,77,2,[ 1 12],78,-1,228,-1,226
1,<environment.Job instance at 0x7f28c9093410>,85,27,[6 1],86,-1,285,-1,258
1,<environment.Job instance at 0x7f28c90ecfa0>,92,23,[1 8],93,-1,305,-1,282
1,<environment.Job instance at 0x7f28c90e9280>,103,26,[5 3],104,-1,330,-1,304
1,<environment.Job instance at 0x7f28c90f7c80>,119,26,[2 8],120,-1,416,-1,390
1,<environment.Job instance at 0x7f28c90fa730>,127,27,[9 5],128,-1,454,-1,427
1,<environment.Job instance at 0x7f28c90c0730>,129,14,[12  2],130,-1,441,-1,427
1,<environment.Job instance at 0x7f28c90995f0>,141,17,[ 5 14],142,-1,493,-1,476
1,<environment.Job instance at 0x7f28c90c5b90>,142,25,[ 3 11],143,-1,501,-1,476
1,<environment.Job instance at 0x7f28c90c5be0>,144,17,[13  5],145,-1,494,-1,477
1,<environment.Job instance at 0x7f28c90c5c80>,145,13,[ 5 14],146,-1,490,-1,477
1,<environment.Job instance at 0x7f28c92288c0>,0,16,[8 3],1,-1,19,-1,3
1,<environment.Job instance at 0x7f28c9228370>,3,16,[ 4 10],4,-1,22,-1,6
1,<environment.Job instance at 0x7f28c9278780>,5,27,[4 5],6,-1,33,-1,6
1,<environment.Job instance at 0x7f28c90d5050>,19,15,[ 2 10],20,-1,35,-1,20
1,<environment.Job instance at 0x7f28c90d51e0>,22,17,[5 9],23,-1,40,-1,23
1,<environment.Job instance at 0x7f28c90d55a0>,24,21,[4 9],25,-1,46,-1,25
1,<environment.Job instance at 0x7f28c952a910>,36,25,[2 8],37,-1,62,-1,37
1,<environment.Job instance at 0x7f28c952a640>,37,14,[3 6],38,-1,52,-1,38
1,<environment.Job instance at 0x7f28c952a820>,38,12,[6 4],39,-1,51,-1,39
1,<environment.Job instance at 0x7f28c952a730>,40,26,[8 3],41,-1,67,-1,41
1,<environment.Job instance at 0x7f28c952a190>,44,14,[3 8],45,-1,59,-1,45
1,<environment.Job instance at 0x7f28c952ab40>,34,16,[5 2],35,-1,68,-1,52
1,<environment.Job instance at 0x7f28c918a910>,51,18,[5 8],52,-1,73,-1,55
1,<environment.Job instance at 0x7f28c952a3c0>,46,18,[8 3],47,-1,87,-1,69
1,<environment.Job instance at 0x7f28c918adc0>,61,15,[5 7],62,-1,95,-1,80
1,<environment.Job instance at 0x7f28c90d5b40>,27,13,[12  1],28,-1,96,-1,83
1,<environment.Job instance at 0x7f28c918ab90>,62,17,[8 2],63,-1,100,-1,83
1,<environment.Job instance at 0x7f28c918afa0>,48,16,[5 2],49,-1,100,-1,84
1,<environment.Job instance at 0x7f28c906e370>,66,17,[7 4],67,-1,102,-1,85
1,<environment.Job instance at 0x7f28c906e190>,69,18,[10  4],70,-1,103,-1,85
1,<environment.Job instance at 0x7f28c918aeb0>,60,16,[ 4 10],61,-1,101,-1,85
1,<environment.Job instance at 0x7f28c906ecd0>,71,13,[1 7],72,-1,98,-1,85
1,<environment.Job instance at 0x7f28c906e1e0>,70,15,[1 9],71,-1,100,-1,85
1,<environment.Job instance at 0x7f28c906eaa0>,73,14,[5 6],74,-1,99,-1,85
1,<environment.Job instance at 0x7f28c906e320>,74,18,[10  5],75,-1,103,-1,85
1,<environment.Job instance at 0x7f28c906e730>,76,16,[2 9],77,-1,102,-1,86
1,<environment.Job instance at 0x7f28c906e050>,78,15,[10  4],79,-1,101,-1,86
1,<environment.Job instance at 0x7f28c906b780>,80,16,[8 5],81,-1,103,-1,87
1,<environment.Job instance at 0x7f28c906be10>,81,16,[4 5],82,-1,103,-1,87
1,<environment.Job instance at 0x7f28c906b550>,82,27,[8 3],83,-1,114,-1,87
1,<environment.Job instance at 0x7f28c906b370>,83,18,[1 6],84,-1,106,-1,88
1,<environment.Job instance at 0x7f28c906b500>,84,17,[2 6],85,-1,105,-1,88
1,<environment.Job instance at 0x7f28c906e280>,65,17,[12  4],66,-1,804,-1,787
1,<environment.Job instance at 0x7f28c90655a0>,106,21,[ 4 10],107,-1,808,-1,787
1,<environment.Job instance at 0x7f28c90658c0>,108,3,[11  1],109,-1,790,-1,787
1,<environment.Job instance at 0x7f28c9065640>,114,13,[ 4 11],115,-1,802,-1,789
1,<environment.Job instance at 0x7f28c918acd0>,59,18,[5 2],60,-1,807,-1,789
1,<environment.Job instance at 0x7f28c9065a50>,115,17,[ 5 10],116,-1,807,-1,790
1,<environment.Job instance at 0x7f28c901a6e0>,119,17,[12  4],120,-1,810,-1,793
1,<environment.Job instance at 0x7f28c901aaa0>,120,25,[6 4],121,-1,818,-1,793
1,<environment.Job instance at 0x7f28c8f78a00>,129,15,[9 5],130,-1,839,-1,824
1,<environment.Job instance at 0x7f28d2fa9050>,136,12,[ 5 12],137,-1,840,-1,828
1,<environment.Job instance at 0x7f28c9074af0>,137,13,[3 7],138,-1,841,-1,828
1,<environment.Job instance at 0x7f28c935b730>,138,15,[2 9],139,-1,843,-1,828
1,<environment.Job instance at 0x7f28c901ac30>,124,24,[5 5],125,-1,852,-1,828
1,<environment.Job instance at 0x7f28c9011190>,135,14,[3 8],136,-1,842,-1,828
1,<environment.Job instance at 0x7f28c97a85f0>,140,12,[4 5],141,-1,882,-1,870
1,<environment.Job instance at 0x7f28c96968c0>,131,17,[7 5],132,-1,887,-1,870
1,<environment.Job instance at 0x7f28c914d730>,155,20,[7 5],156,-1,904,-1,884
1,<environment.Job instance at 0x7f28c9756f50>,151,16,[ 1 14],152,-1,901,-1,885
1,<environment.Job instance at 0x7f28c90188c0>,128,28,[ 5 10],129,-1,913,-1,885
1,<environment.Job instance at 0x7f28c90d50f0>,5,27,[4 5],6,-1,34,-1,7
1,<environment.Job instance at 0x7f28c952a550>,7,12,[13  4],8,-1,20,-1,8
1,<environment.Job instance at 0x7f28c952ad70>,8,12,[ 5 12],9,-1,21,-1,9
1,<environment.Job instance at 0x7f28c9785820>,27,13,[12  1],28,-1,52,-1,39
1,<environment.Job instance at 0x7f28c97850f0>,28,12,[14  3],29,-1,51,-1,39
1,<environment.Job instance at 0x7f28c9df32d0>,29,1,[ 4 11],30,-1,40,-1,39
1,<environment.Job instance at 0x7f28c9030910>,36,25,[2 8],37,-1,84,-1,59
1,<environment.Job instance at 0x7f28c91138c0>,40,26,[8 3],41,-1,99,-1,73
1,<environment.Job instance at 0x7f28c9312af0>,54,2,[11  3],55,-1,112,-1,110
1,<environment.Job instance at 0x7f28c901d1e0>,65,17,[12  4],66,-1,171,-1,154
1,<environment.Job instance at 0x7f28c8f27aa0>,77,2,[ 3 11],78,-1,220,-1,218
1,<environment.Job instance at 0x7f28c903ef00>,82,27,[8 3],83,-1,279,-1,252
1,<environment.Job instance at 0x7f28c903e960>,86,27,[2 6],87,-1,295,-1,268
1,<environment.Job instance at 0x7f28c90400a0>,90,14,[ 4 14],91,-1,298,-1,284
1,<environment.Job instance at 0x7f28c9062320>,107,23,[2 8],108,-1,356,-1,333
1,<environment.Job instance at 0x7f28c9062c30>,108,3,[11  1],109,-1,336,-1,333
1,<environment.Job instance at 0x7f28c9062d70>,109,19,[13  3],110,-1,352,-1,333
1,<environment.Job instance at 0x7f28c9060aa0>,114,13,[ 4 11],115,-1,359,-1,346
1,<environment.Job instance at 0x7f28c9060190>,119,17,[12  4],120,-1,378,-1,361
1,<environment.Job instance at 0x7f28c9060fa0>,120,25,[6 4],121,-1,387,-1,362
1,<environment.Job instance at 0x7f28c90608c0>,122,3,[14  5],123,-1,365,-1,362
1,<environment.Job instance at 0x7f28c9060eb0>,124,24,[5 5],125,-1,399,-1,375
1,<environment.Job instance at 0x7f28c9060500>,128,28,[ 5 10],129,-1,418,-1,390
1,<environment.Job instance at 0x7f28c90571e0>,136,12,[ 5 12],137,-1,422,-1,410
1,<environment.Job instance at 0x7f28c9057c30>,139,2,[ 5 14],140,-1,424,-1,422
1,<environment.Job instance at 0x7f28c9054fa0>,151,16,[ 1 14],152,-1,483,-1,467
1,<environment.Job instance at 0x7f28ca479230>,7,18,[8 2],8,-1,29,-1,11
1,<environment.Job instance at 0x7f28ca479370>,12,17,[4 5],13,-1,30,-1,13
1,<environment.Job instance at 0x7f28ca47cd20>,17,16,[7 2],18,-1,34,-1,18
1,<environment.Job instance at 0x7f28ca47c550>,13,14,[9 3],14,-1,37,-1,23
1,<environment.Job instance at 0x7f28ca47c690>,23,16,[6 5],24,-1,40,-1,24
1,<environment.Job instance at 0x7f28ca47c6e0>,24,16,[9 5],25,-1,41,-1,25
1,<environment.Job instance at 0x7f28ca47c190>,22,16,[10  4],23,-1,43,-1,27
1,<environment.Job instance at 0x7f28ca450820>,27,28,[5 9],28,-1,56,-1,28
1,<environment.Job instance at 0x7f28ca450f00>,29,18,[5 8],30,-1,48,-1,30
1,<environment.Job instance at 0x7f28ca4585f0>,30,18,[ 2 10],31,-1,53,-1,35
1,<environment.Job instance at 0x7f28ca483910>,37,28,[9 1],38,-1,68,-1,40
1,<environment.Job instance at 0x7f28ca4835f0>,38,13,[9 1],39,-1,54,-1,41
1,<environment.Job instance at 0x7f28ca483730>,39,3,[6 3],40,-1,44,-1,41
1,<environment.Job instance at 0x7f28ca483c30>,36,18,[ 5 10],37,-1,59,-1,41
1,<environment.Job instance at 0x7f28ca483e60>,42,26,[5 8],43,-1,69,-1,43
1,<environment.Job instance at 0x7f28ca483e10>,41,14,[9 2],42,-1,63,-1,49
1,<environment.Job instance at 0x7f28c8e9f640>,50,14,[7 2],51,-1,67,-1,53
1,<environment.Job instance at 0x7f28c8e9f550>,48,15,[2 8],49,-1,68,-1,53
1,<environment.Job instance at 0x7f28c8e9f5f0>,49,18,[1 7],50,-1,71,-1,53
1,<environment.Job instance at 0x7f28c8e9f6e0>,52,17,[8 1],53,-1,78,-1,61
1,<environment.Job instance at 0x7f28c8e9fa00>,55,18,[4 6],56,-1,79,-1,61
1,<environment.Job instance at 0x7f28c8e9fb40>,57,28,[ 5 10],58,-1,89,-1,61
1,<environment.Job instance at 0x7f28c8e9fc80>,59,18,[3 8],60,-1,81,-1,63
1,<environment.Job instance at 0x7f28c8f20dc0>,62,21,[5 7],63,-1,90,-1,69
1,<environment.Job instance at 0x7f28ca45f730>,65,16,[4 7],66,-1,86,-1,70
1,<environment.Job instance at 0x7f28c92c5af0>,66,18,[9 3],67,-1,91,-1,73
1,<environment.Job instance at 0x7f28c8e9fd20>,60,22,[7 1],61,-1,95,-1,73
1,<environment.Job instance at 0x7f28c92b7f50>,69,18,[8 2],70,-1,92,-1,74
1,<environment.Job instance at 0x7f28c92c5c30>,68,16,[1 7],69,-1,99,-1,83
1,<environment.Job instance at 0x7f28c92c50f0>,74,16,[ 5 10],75,-1,99,-1,83
1,<environment.Job instance at 0x7f28c9370730>,75,15,[5 9],76,-1,98,-1,83
1,<environment.Job instance at 0x7f28c986d4b0>,73,17,[4 7],74,-1,100,-1,83
1,<environment.Job instance at 0x7f28c93759b0>,81,18,[11  5],82,-1,101,-1,83
1,<environment.Job instance at 0x7f28c9d376e0>,80,26,[3 7],81,-1,111,-1,85
1,<environment.Job instance at 0x7f28c963df00>,83,12,[8 2],84,-1,97,-1,85
1,<environment.Job instance at 0x7f28c963d500>,85,18,[4 9],86,-1,111,-1,93
1,<environment.Job instance at 0x7f28c960f780>,87,18,[10  5],88,-1,112,-1,94
1,<environment.Job instance at 0x7f28c9873190>,92,24,[1 9],93,-1,126,-1,102
1,<environment.Job instance at 0x7f28c9873460>,90,13,[10  1],91,-1,115,-1,102
1,<environment.Job instance at 0x7f28c9644460>,94,12,[9 3],95,-1,114,-1,102
1,<environment.Job instance at 0x7f28c9644f00>,96,12,[10  1],97,-1,114,-1,102
1,<environment.Job instance at 0x7f28c961d140>,93,14,[6 5],94,-1,118,-1,104
1,<environment.Job instance at 0x7f28c9644320>,100,17,[5 6],101,-1,125,-1,108
1,<environment.Job instance at 0x7f28c9637460>,105,21,[ 2 10],106,-1,129,-1,108
1,<environment.Job instance at 0x7f28c96378c0>,106,15,[10  2],107,-1,123,-1,108
1,<environment.Job instance at 0x7f28c96446e0>,101,27,[7 1],102,-1,143,-1,116
1,<environment.Job instance at 0x7f28c9637500>,109,13,[4 7],110,-1,129,-1,116
1,<environment.Job instance at 0x7f28c9637e60>,111,17,[11  3],112,-1,133,-1,116
1,<environment.Job instance at 0x7f28c9646a50>,119,15,[ 3 10],120,-1,135,-1,120
1,<environment.Job instance at 0x7f28c960e230>,120,17,[10  2],121,-1,138,-1,121
1,<environment.Job instance at 0x7f28c9637be0>,110,16,[10  1],111,-1,145,-1,129
1,<environment.Job instance at 0x7f28ca47ce60>,16,16,[1 9],17,-1,145,-1,129
1,<environment.Job instance at 0x7f28c964b140>,124,13,[ 5 12],125,-1,142,-1,129
1,<environment.Job instance at 0x7f28c9646c30>,122,14,[5 1],123,-1,143,-1,129
1,<environment.Job instance at 0x7f28c9621730>,126,14,[8 4],127,-1,143,-1,129
1,<environment.Job instance at 0x7f28c9621550>,127,14,[9 2],128,-1,143,-1,129
1,<environment.Job instance at 0x7f28c964b2d0>,123,24,[2 6],124,-1,153,-1,129
1,<environment.Job instance at 0x7f28c9621690>,130,14,[5 8],131,-1,145,-1,131
1,<environment.Job instance at 0x7f28c9361230>,132,18,[6 2],133,-1,152,-1,134
1,<environment.Job instance at 0x7f28c93615a0>,134,18,[6 2],135,-1,154,-1,136
1,<environment.Job instance at 0x7f28c9361dc0>,135,19,[6 3],136,-1,155,-1,136
1,<environment.Job instance at 0x7f28c9632a00>,137,15,[6 1],138,-1,154,-1,139
1,<environment.Job instance at 0x7f28c92c3c80>,141,14,[3 6],142,-1,156,-1,142
1,<environment.Job instance at 0x7f28c92c3a00>,142,27,[5 7],143,-1,170,-1,143
1,<environment.Job instance at 0x7f28c92c95a0>,146,15,[10  3],147,-1,164,-1,149
1,<environment.Job instance at 0x7f28c92c9230>,147,15,[9 1],148,-1,168,-1,153
1,<environment.Job instance at 0x7f28c8e8c140>,151,14,[ 4 13],152,-1,167,-1,153
1,<environment.Job instance at 0x7f28c8e8c9b0>,149,17,[5 2],150,-1,170,-1,153
1,<environment.Job instance at 0x7f28c9775f50>,4,17,[14  5],5,-1,22,-1,5
1,<environment.Job instance at 0x7f28c9618690>,11,2,[14  5],12,-1,21,-1,19
1,<environment.Job instance at 0x7f28c929de10>,27,28,[5 9],28,-1,100,-1,72
1,<environment.Job instance at 0x7f28c90543c0>,37,28,[9 1],38,-1,145,-1,117
1,<environment.Job instance at 0x7f28c9057dc0>,42,26,[5 8],43,-1,173,-1,147
1,<environment.Job instance at 0x7f28c9057190>,46,2,[ 5 13],47,-1,149,-1,147
1,<environment.Job instance at 0x7f28c9057eb0>,51,1,[13  4],52,-1,163,-1,162
1,<environment.Job instance at 0x7f28c90606e0>,58,2,[12  3],59,-1,180,-1,178
1,<environment.Job instance at 0x7f28c90601e0>,57,28,[ 5 10],58,-1,257,-1,229
1,<environment.Job instance at 0x7f28c9062cd0>,80,26,[3 7],81,-1,293,-1,267
1,<environment.Job instance at 0x7f28c90625a0>,81,18,[11  5],82,-1,285,-1,267
1,<environment.Job instance at 0x7f28c9040780>,89,1,[12  2],90,-1,287,-1,286
1,<environment.Job instance at 0x7f28c903ea00>,92,24,[1 9],93,-1,325,-1,301
1,<environment.Job instance at 0x7f28c8f74730>,101,27,[7 1],102,-1,361,-1,334
1,<environment.Job instance at 0x7f28c8f27a00>,103,2,[ 3 13],104,-1,336,-1,334
1,<environment.Job instance at 0x7f28c8f270a0>,102,26,[ 3 10],103,-1,370,-1,344
1,<environment.Job instance at 0x7f28c8fdea00>,107,1,[ 3 14],108,-1,345,-1,344
1,<environment.Job instance at 0x7f28c8fde280>,108,12,[ 2 11],109,-1,356,-1,344
1,<environment.Job instance at 0x7f28c8fde820>,111,17,[11  3],112,-1,363,-1,346
1,<environment.Job instance at 0x7f28c901de10>,112,16,[12  1],113,-1,362,-1,346
1,<environment.Job instance at 0x7f28c901d1e0>,113,15,[ 4 13],114,-1,361,-1,346
1,<environment.Job instance at 0x7f28c93142d0>,123,24,[2 6],124,-1,416,-1,392
1,<environment.Job instance at 0x7f28c93141e0>,124,13,[ 5 12],125,-1,405,-1,392
1,<environment.Job instance at 0x7f28c8ef2730>,125,2,[ 2 11],126,-1,394,-1,392
1,<environment.Job instance at 0x7f28c9b70dc0>,142,27,[5 7],143,-1,492,-1,465
1,<environment.Job instance at 0x7f28c9df30f0>,144,24,[13  2],145,-1,489,-1,465
1,<environment.Job instance at 0x7f28c8f19cd0>,148,15,[11  4],149,-1,499,-1,484
1,<environment.Job instance at 0x7f28c96c0370>,151,14,[ 4 13],152,-1,513,-1,499
1,<environment.Job instance at 0x7f28c9a2fb40>,1,18,[4 9],2,-1,20,-1,2
1,<environment.Job instance at 0x7f28c9a51c30>,6,16,[8 2],7,-1,24,-1,8
1,<environment.Job instance at 0x7f28c9a2ffa0>,7,14,[11  4],8,-1,22,-1,8
1,<environment.Job instance at 0x7f28c9a51370>,8,14,[8 5],9,-1,24,-1,10
1,<environment.Job instance at 0x7f28c9a513c0>,10,18,[ 4 11],11,-1,30,-1,12
1,<environment.Job instance at 0x7f28c9a518c0>,12,12,[7 2],13,-1,25,-1,13
1,<environment.Job instance at 0x7f28c9a517d0>,13,24,[8 5],14,-1,38,-1,14
1,<environment.Job instance at 0x7f28c9a511e0>,14,14,[ 1 10],15,-1,29,-1,15
1,<environment.Job instance at 0x7f28c9a516e0>,15,13,[5 7],16,-1,29,-1,16
1,<environment.Job instance at 0x7f28c9a51320>,22,16,[5 4],23,-1,40,-1,24
1,<environment.Job instance at 0x7f28c9658c30>,28,20,[3 9],29,-1,66,-1,46
1,<environment.Job instance at 0x7f28c9658960>,31,17,[ 4 10],32,-1,64,-1,47
1,<environment.Job instance at 0x7f28c96585a0>,23,15,[ 3 10],24,-1,76,-1,61
1,<environment.Job instance at 0x7f28c9658460>,34,17,[3 5],35,-1,78,-1,61
1,<environment.Job instance at 0x7f28c96582d0>,33,14,[ 5 13],34,-1,77,-1,63
1,<environment.Job instance at 0x7f28c9a519b0>,19,15,[1 6],20,-1,79,-1,64
1,<environment.Job instance at 0x7f28c9c59be0>,38,23,[3 9],39,-1,98,-1,75
1,<environment.Job instance at 0x7f28c9658640>,37,21,[4 8],38,-1,96,-1,75
1,<environment.Job instance at 0x7f28c9c59f00>,44,18,[6 4],45,-1,93,-1,75
1,<environment.Job instance at 0x7f28c9c594b0>,47,17,[8 4],48,-1,100,-1,83
1,<environment.Job instance at 0x7f28c9c59910>,48,16,[1 7],49,-1,99,-1,83
1,<environment.Job instance at 0x7f28c9658dc0>,36,14,[6 5],37,-1,97,-1,83
1,<environment.Job instance at 0x7f28c9c59050>,49,15,[ 2 10],50,-1,98,-1,83
1,<environment.Job instance at 0x7f28c9c59960>,39,13,[10  5],40,-1,96,-1,83
1,<environment.Job instance at 0x7f28c9e98500>,55,13,[6 4],56,-1,96,-1,83
1,<environment.Job instance at 0x7f28c9c59cd0>,42,14,[2 6],43,-1,97,-1,83
1,<environment.Job instance at 0x7f28c9e98aa0>,59,12,[5 2],60,-1,95,-1,83
1,<environment.Job instance at 0x7f28c9e98c80>,61,16,[8 4],62,-1,100,-1,84
1,<environment.Job instance at 0x7f28c9e98370>,63,18,[6 4],64,-1,103,-1,85
1,<environment.Job instance at 0x7f28c9c598c0>,46,12,[1 7],47,-1,97,-1,85
1,<environment.Job instance at 0x7f28c9c596e0>,50,2,[ 1 11],51,-1,87,-1,85
1,<environment.Job instance at 0x7f28c9e985f0>,70,13,[5 8],71,-1,98,-1,85
1,<environment.Job instance at 0x7f28c9e985a0>,60,2,[2 7],61,-1,88,-1,86
1,<environment.Job instance at 0x7f28c9c714b0>,73,15,[6 2],74,-1,104,-1,89
1,<environment.Job instance at 0x7f28c9e98d70>,67,2,[8 3],68,-1,91,-1,89
1,<environment.Job instance at 0x7f28c9e98d20>,66,1,[10  4],67,-1,90,-1,89
1,<environment.Job instance at 0x7f28c9c717d0>,76,18,[10  5],77,-1,109,-1,91
1,<environment.Job instance at 0x7f28c9c71af0>,77,14,[1 9],78,-1,105,-1,91
1,<environment.Job instance at 0x7f28c9c71be0>,72,12,[4 7],73,-1,103,-1,91
1,<environment.Job instance at 0x7f28c9c71550>,75,21,[9 5],76,-1,112,-1,91
1,<environment.Job instance at 0x7f28c9c715f0>,80,12,[2 5],81,-1,103,-1,91
1,<environment.Job instance at 0x7f28c9c71230>,74,1,[6 4],75,-1,93,-1,92
1,<environment.Job instance at 0x7f28c9a450a0>,83,27,[3 5],84,-1,120,-1,93
1,<environment.Job instance at 0x7f28c9a453c0>,84,1,[12  4],85,-1,94,-1,93
1,<environment.Job instance at 0x7f28c9a45aa0>,87,17,[5 7],88,-1,110,-1,93
1,<environment.Job instance at 0x7f28c9c718c0>,81,16,[1 6],82,-1,109,-1,93
1,<environment.Job instance at 0x7f28c9a452d0>,88,12,[7 5],89,-1,105,-1,93
1,<environment.Job instance at 0x7f28c9c71b90>,78,12,[7 5],79,-1,105,-1,93
1,<environment.Job instance at 0x7f28c9a45280>,89,12,[1 9],90,-1,114,-1,102
1,<environment.Job instance at 0x7f28c9c789b0>,93,12,[9 3],94,-1,115,-1,103
1,<environment.Job instance at 0x7f28c9c78320>,94,12,[1 5],95,-1,115,-1,103
1,<environment.Job instance at 0x7f28c9e98140>,68,16,[13  3],69,-1,120,-1,104
1,<environment.Job instance at 0x7f28c9c78870>,96,12,[6 4],97,-1,116,-1,104
1,<environment.Job instance at 0x7f28c9c78d70>,100,16,[9 4],101,-1,124,-1,108
1,<environment.Job instance at 0x7f28c9c781e0>,97,17,[2 6],98,-1,127,-1,110
1,<environment.Job instance at 0x7f28c9c78c80>,98,17,[5 4],99,-1,128,-1,111
1,<environment.Job instance at 0x7f28c9c780a0>,105,18,[3 9],106,-1,131,-1,113
1,<environment.Job instance at 0x7f28c9c785a0>,107,1,[5 6],108,-1,114,-1,113
1,<environment.Job instance at 0x7f28c9c78410>,106,27,[10  4],107,-1,147,-1,120
1,<environment.Job instance at 0x7f28c9a407d0>,108,14,[4 5],109,-1,134,-1,120
1,<environment.Job instance at 0x7f28ca43e820>,111,18,[4 8],112,-1,138,-1,120
1,<environment.Job instance at 0x7f28c99ad320>,112,25,[7 3],113,-1,145,-1,120
1,<environment.Job instance at 0x7f28c999bb40>,116,17,[2 9],117,-1,138,-1,121
1,<environment.Job instance at 0x7f28c9c78690>,95,14,[5 2],96,-1,135,-1,121
1,<environment.Job instance at 0x7f28c999b5f0>,117,13,[4 7],118,-1,134,-1,121
1,<environment.Job instance at 0x7f28c99b9be0>,119,14,[4 7],120,-1,135,-1,121
1,<environment.Job instance at 0x7f28c9b1d5a0>,114,13,[ 3 12],115,-1,143,-1,130
1,<environment.Job instance at 0x7f28c9a60eb0>,123,17,[6 1],124,-1,148,-1,131
1,<environment.Job instance at 0x7f28c9a40410>,109,14,[9 4],110,-1,147,-1,133
1,<environment.Job instance at 0x7f28ca419410>,128,14,[13  2],129,-1,147,-1,133
1,<environment.Job instance at 0x7f28c99b9550>,121,17,[10  5],122,-1,151,-1,134
1,<environment.Job instance at 0x7f28c9a65820>,129,18,[5 2],130,-1,152,-1,134
1,<environment.Job instance at 0x7f28c9ae07d0>,126,13,[8 5],127,-1,149,-1,136
1,<environment.Job instance at 0x7f28c9a40a00>,135,12,[3 7],136,-1,152,-1,140
1,<environment.Job instance at 0x7f28c9a40fa0>,138,15,[6 2],139,-1,157,-1,142
1,<environment.Job instance at 0x7f28c9a05eb0>,130,3,[ 1 10],131,-1,145,-1,142
1,<environment.Job instance at 0x7f28c9a40cd0>,140,18,[1 7],141,-1,161,-1,143
1,<environment.Job instance at 0x7f28c9a40c30>,139,14,[7 2],140,-1,157,-1,143
1,<environment.Job instance at 0x7f28c9a40140>,142,14,[8 5],143,-1,157,-1,143
1,<environment.Job instance at 0x7f28c9a40500>,137,16,[2 7],138,-1,169,-1,153
1,<environment.Job instance at 0x7f28c9a465a0>,146,20,[4 8],147,-1,177,-1,157
1,<environment.Job instance at 0x7f28c9a46f50>,150,25,[5 4],151,-1,182,-1,157
1,<environment.Job instance at 0x7f28c9a469b0>,149,1,[5 6],150,-1,158,-1,157
1,<environment.Job instance at 0x7f28c9a467d0>,151,21,[5 5],152,-1,179,-1,158
1,<environment.Job instance at 0x7f28c9a461e0>,145,26,[4 8],146,-1,184,-1,158
1,<environment.Job instance at 0x7f28c9a46cd0>,153,18,[ 2 10],154,-1,178,-1,160
1,<environment.Job instance at 0x7f28c9a46910>,155,25,[5 7],156,-1,185,-1,160
1,<environment.Job instance at 0x7f28c9a46aa0>,156,12,[5 9],157,-1,172,-1,160
1,<environment.Job instance at 0x7f28c9a46b90>,157,22,[5 8],158,-1,182,-1,160
1,<environment.Job instance at 0x7f28c9c71870>,7,14,[11  4],8,-1,22,-1,8
1,<environment.Job instance at 0x7f28c9a455f0>,10,18,[ 4 11],11,-1,38,-1,20
1,<environment.Job instance at 0x7f28c9a45640>,13,24,[8 5],14,-1,55,-1,31
1,<environment.Job instance at 0x7f28c9c78730>,18,13,[12  1],19,-1,60,-1,47
1,<environment.Job instance at 0x7f28c96c0370>,26,3,[14  2],27,-1,79,-1,76
1,<environment.Job instance at 0x7f28c8f392d0>,33,14,[ 5 13],34,-1,106,-1,92
1,<environment.Job instance at 0x7f28c907a410>,38,23,[3 9],39,-1,133,-1,110
1,<environment.Job instance at 0x7f28c8ef2eb0>,50,2,[ 1 11],51,-1,170,-1,168
1,<environment.Job instance at 0x7f28c8fde280>,57,12,[ 3 14],58,-1,201,-1,189
1,<environment.Job instance at 0x7f28c903ee60>,68,16,[13  3],69,-1,227,-1,211
1,<environment.Job instance at 0x7f28c9057280>,83,27,[3 5],84,-1,288,-1,261
1,<environment.Job instance at 0x7f28c9057410>,84,1,[12  4],85,-1,262,-1,261
1,<environment.Job instance at 0x7f28c9057190>,85,2,[14  1],86,-1,263,-1,261
1,<environment.Job instance at 0x7f28c9361190>,106,27,[10  4],107,-1,386,-1,359
1,<environment.Job instance at 0x7f28c9621230>,110,1,[ 5 11],111,-1,367,-1,366
1,<environment.Job instance at 0x7f28c9637320>,112,25,[7 3],113,-1,405,-1,380
1,<environment.Job instance at 0x7f28c961d0a0>,114,13,[ 3 12],115,-1,393,-1,380
1,<environment.Job instance at 0x7f28ca47cdc0>,128,14,[13  2],129,-1,469,-1,455
1,<environment.Job instance at 0x7f28c9719b40>,145,26,[4 8],146,-1,543,-1,517
1,<environment.Job instance at 0x7f28c97193c0>,150,25,[5 4],151,-1,548,-1,523
1,<environment.Job instance at 0x7f28c9719640>,155,25,[5 7],156,-1,561,-1,536
1,<environment.Job instance at 0x7f28c8c02e10>,2,2,[10  4],3,-1,5,-1,3
1,<environment.Job instance at 0x7f28c8c020a0>,3,27,[8 5],4,-1,31,-1,4
1,<environment.Job instance at 0x7f28c8be7e10>,13,24,[3 5],14,-1,38,-1,14
1,<environment.Job instance at 0x7f28c8d29370>,15,14,[10  1],16,-1,31,-1,17
1,<environment.Job instance at 0x7f28c8ff9460>,17,17,[2 7],18,-1,35,-1,18
1,<environment.Job instance at 0x7f28c900a6e0>,18,15,[5 5],19,-1,34,-1,19
1,<environment.Job instance at 0x7f28c900a550>,19,1,[6 2],20,-1,21,-1,20
1,<environment.Job instance at 0x7f28c8be7050>,16,15,[3 6],17,-1,35,-1,20
1,<environment.Job instance at 0x7f28c9fc1b90>,21,18,[5 9],22,-1,40,-1,22
1,<environment.Job instance at 0x7f28c927ffa0>,23,18,[3 7],24,-1,42,-1,24
1,<environment.Job instance at 0x7f28c9d32320>,24,27,[1 8],25,-1,52,-1,25
1,<environment.Job instance at 0x7f28c8fd9960>,26,15,[5 1],27,-1,42,-1,27
1,<environment.Job instance at 0x7f28c9fbc280>,28,12,[1 8],29,-1,41,-1,29
1,<environment.Job instance at 0x7f28c9fbcdc0>,29,1,[4 5],30,-1,31,-1,30
1,<environment.Job instance at 0x7f28c9d40be0>,30,18,[2 7],31,-1,49,-1,31
1,<environment.Job instance at 0x7f28c8d2beb0>,31,15,[6 3],32,-1,48,-1,33
1,<environment.Job instance at 0x7f28c8d2bc80>,34,23,[4 5],35,-1,58,-1,35
1,<environment.Job instance at 0x7f28c927e190>,37,13,[12  5],38,-1,56,-1,43
1,<environment.Job instance at 0x7f28c8ffa2d0>,39,18,[7 4],40,-1,63,-1,45
1,<environment.Job instance at 0x7f28c8ffae10>,36,13,[6 5],37,-1,58,-1,45
1,<environment.Job instance at 0x7f28c8bfd190>,46,26,[8 5],47,-1,73,-1,47
1,<environment.Job instance at 0x7f28c997d820>,49,20,[6 3],50,-1,71,-1,51
1,<environment.Job instance at 0x7f28c9a65230>,52,2,[5 1],53,-1,55,-1,53
1,<environment.Job instance at 0x7f28c9fe3c30>,50,17,[5 8],51,-1,70,-1,53
1,<environment.Job instance at 0x7f28c9a65410>,51,2,[8 5],52,-1,55,-1,53
1,<environment.Job instance at 0x7f28c8bfd960>,44,18,[3 6],45,-1,71,-1,53
1,<environment.Job instance at 0x7f28c9a658c0>,53,20,[5 3],54,-1,74,-1,54
1,<environment.Job instance at 0x7f28c9d300f0>,54,16,[2 7],55,-1,71,-1,55
1,<environment.Job instance at 0x7f28c99b3730>,55,17,[6 3],56,-1,73,-1,56
1,<environment.Job instance at 0x7f28ca4c0730>,56,14,[10  1],57,-1,71,-1,57
1,<environment.Job instance at 0x7f28ca4166e0>,59,12,[7 5],60,-1,73,-1,61
1,<environment.Job instance at 0x7f28c9b970a0>,61,17,[2 9],62,-1,79,-1,62
1,<environment.Job instance at 0x7f28ca363eb0>,64,12,[10  2],65,-1,77,-1,65
1,<environment.Job instance at 0x7f28c9b27780>,66,13,[9 1],67,-1,80,-1,67
1,<environment.Job instance at 0x7f28c9b27a50>,69,14,[5 1],70,-1,86,-1,72
1,<environment.Job instance at 0x7f28c9b27410>,67,22,[10  1],68,-1,94,-1,72
1,<environment.Job instance at 0x7f28c9b271e0>,70,20,[3 8],71,-1,93,-1,73
1,<environment.Job instance at 0x7f28c9b27af0>,72,13,[9 2],73,-1,90,-1,77
1,<environment.Job instance at 0x7f28c8be1b40>,76,26,[9 5],77,-1,103,-1,77
1,<environment.Job instance at 0x7f28c8be1780>,79,13,[8 5],80,-1,96,-1,83
1,<environment.Job instance at 0x7f28ca3515f0>,83,16,[6 3],84,-1,100,-1,84
1,<environment.Job instance at 0x7f28ca3cfd20>,84,17,[1 8],85,-1,102,-1,85
1,<environment.Job instance at 0x7f28c9ab48c0>,89,22,[7 3],90,-1,112,-1,90
1,<environment.Job instance at 0x7f28ca3514b0>,82,13,[ 3 10],83,-1,112,-1,99
1,<environment.Job instance at 0x7f28ca0d3500>,90,15,[13  3],91,-1,124,-1,109
1,<environment.Job instance at 0x7f28ca4266e0>,100,16,[ 2 10],101,-1,131,-1,115
1,<environment.Job instance at 0x7f28ca426960>,99,13,[ 1 10],100,-1,128,-1,115
1,<environment.Job instance at 0x7f28c8f3f6e0>,105,15,[ 4 12],106,-1,130,-1,115
1,<environment.Job instance at 0x7f28c8f3fc80>,106,18,[5 8],107,-1,139,-1,121
1,<environment.Job instance at 0x7f28c8f3fa00>,107,13,[5 8],108,-1,135,-1,122
1,<environment.Job instance at 0x7f28c9ab4050>,92,25,[7 5],93,-1,147,-1,122
1,<environment.Job instance at 0x7f28c92d2dc0>,111,18,[8 1],112,-1,141,-1,123
1,<environment.Job instance at 0x7f28c92d2a50>,108,13,[5 5],109,-1,137,-1,124
1,<environment.Job instance at 0x7f28c92d20a0>,113,20,[8 4],114,-1,146,-1,126
1,<environment.Job instance at 0x7f28c9dd7eb0>,117,27,[8 5],118,-1,157,-1,130
1,<environment.Job instance at 0x7f28c9b276e0>,68,16,[13  1],69,-1,149,-1,133
1,<environment.Job instance at 0x7f28c9dd74b0>,120,13,[3 8],121,-1,146,-1,133
1,<environment.Job instance at 0x7f28c92d2690>,109,17,[ 2 10],110,-1,151,-1,134
1,<environment.Job instance at 0x7f28c9dd7aa0>,121,15,[2 7],122,-1,149,-1,134
1,<environment.Job instance at 0x7f28c9dd7690>,125,13,[10  5],126,-1,147,-1,134
1,<environment.Job instance at 0x7f28c9dd7c30>,126,17,[7 3],127,-1,151,-1,134
1,<environment.Job instance at 0x7f28c9dd71e0>,128,13,[8 3],129,-1,147,-1,134
1,<environment.Job instance at 0x7f28c9dd7190>,123,16,[5 2],124,-1,150,-1,134
1,<environment.Job instance at 0x7f28c93eb870>,131,17,[9 4],132,-1,151,-1,134
1,<environment.Job instance at 0x7f28c93eb640>,132,24,[4 6],133,-1,159,-1,135
1,<environment.Job instance at 0x7f28c9945820>,135,14,[10  1],136,-1,150,-1,136
1,<environment.Job instance at 0x7f28c93eb5f0>,130,13,[1 9],131,-1,149,-1,136
1,<environment.Job instance at 0x7f28c9945e10>,136,12,[9 5],137,-1,150,-1,138
1,<environment.Job instance at 0x7f28c93160f0>,140,16,[5 4],141,-1,157,-1,141
1,<environment.Job instance at 0x7f28c9945960>,137,18,[14  1],138,-1,168,-1,150
1,<environment.Job instance at 0x7f28c9316be0>,144,12,[7 2],145,-1,162,-1,150
1,<environment.Job instance at 0x7f28c93163c0>,143,13,[ 3 11],144,-1,165,-1,152
1,<environment.Job instance at 0x7f28c9316870>,141,18,[7 2],142,-1,170,-1,152
1,<environment.Job instance at 0x7f28c9520190>,149,18,[ 5 10],150,-1,179,-1,161
1,<environment.Job instance at 0x7f28c9520410>,156,13,[8 4],157,-1,194,-1,181
1,<environment.Job instance at 0x7f28c9316230>,146,15,[11  2],147,-1,196,-1,181
1,<environment.Job instance at 0x7f28c9520af0>,157,17,[6 2],158,-1,198,-1,181
1,<environment.Job instance at 0x7f28c9fc17d0>,3,27,[8 5],4,-1,32,-1,5
1,<environment.Job instance at 0x7f28c8d29f50>,4,12,[ 5 13],5,-1,17,-1,5
1,<environment.Job instance at 0x7f28c9a654b0>,9,1,[12  4],10,-1,11,-1,10
1,<environment.Job instance at 0x7f28c9ff2aa0>,13,24,[3 5],14,-1,42,-1,18
1,<environment.Job instance at 0x7f28c93ebf00>,24,27,[1 8],25,-1,92,-1,65
1,<environment.Job instance at 0x7f28c93f8550>,34,23,[4 5],35,-1,106,-1,83
1,<environment.Job instance at 0x7f28c901de10>,37,13,[12  5],38,-1,104,-1,91
1,<environment.Job instance at 0x7f28c9030aa0>,43,14,[ 4 11],44,-1,131,-1,117
1,<environment.Job instance at 0x7f28c9a46be0>,46,26,[8 5],47,-1,154,-1,128
1,<environment.Job instance at 0x7f28c9a40af0>,48,18,[13  1],49,-1,146,-1,128
1,<environment.Job instance at 0x7f28c8f46320>,68,16,[13  1],69,-1,211,-1,195
1,<environment.Job instance at 0x7f28c91b8320>,71,3,[11  4],72,-1,200,-1,197
1,<environment.Job instance at 0x7f28c9460b40>,76,26,[9 5],77,-1,249,-1,223
1,<environment.Job instance at 0x7f28c9544d20>,87,1,[ 4 12],88,-1,243,-1,242
1,<environment.Job instance at 0x7f28c93dc8c0>,90,15,[13  3],91,-1,259,-1,244
1,<environment.Job instance at 0x7f28c93dc410>,92,25,[7 5],93,-1,279,-1,254
1,<environment.Job instance at 0x7f28c93dc1e0>,93,2,[14  5],94,-1,256,-1,254
1,<environment.Job instance at 0x7f28c93dcd20>,94,2,[13  4],95,-1,256,-1,254
1,<environment.Job instance at 0x7f28c93dc5f0>,96,12,[12  4],97,-1,266,-1,254
1,<environment.Job instance at 0x7f28c9d80370>,105,15,[ 4 12],106,-1,302,-1,287
1,<environment.Job instance at 0x7f28c9dc5eb0>,117,27,[8 5],118,-1,378,-1,351
1,<environment.Job instance at 0x7f28c96f8e10>,129,2,[ 2 12],130,-1,406,-1,404
1,<environment.Job instance at 0x7f28c9a2ad20>,132,24,[4 6],133,-1,444,-1,420
1,<environment.Job instance at 0x7f28c96f8230>,133,15,[ 2 13],134,-1,435,-1,420
1,<environment.Job instance at 0x7f28c9a2a370>,137,18,[14  1],138,-1,451,-1,433
1,<environment.Job instance at 0x7f28c9a2a280>,143,13,[ 3 11],144,-1,472,-1,459
1,<environment.Job instance at 0x7f28c9a2a320>,146,15,[11  2],147,-1,481,-1,466
1,<environment.Job instance at 0x7f28c9f7bc80>,150,12,[ 3 12],151,-1,492,-1,480
1,<environment.Job instance at 0x7f28c95244b0>,0,25,[10  4],1,-1,26,-1,1
1,<environment.Job instance at 0x7f28c9b84cd0>,5,17,[8 5],6,-1,23,-1,6
1,<environment.Job instance at 0x7f28c95b84b0>,10,18,[6 4],11,-1,29,-1,11
1,<environment.Job instance at 0x7f28c93db140>,12,15,[4 9],13,-1,28,-1,13
1,<environment.Job instance at 0x7f28c93dbaa0>,13,18,[8 3],14,-1,32,-1,14
1,<environment.Job instance at 0x7f28c93db4b0>,16,16,[7 5],17,-1,33,-1,17
1,<environment.Job instance at 0x7f28c9a98780>,24,14,[5 8],25,-1,39,-1,25
1,<environment.Job instance at 0x7f28c9023820>,26,20,[10  4],27,-1,47,-1,27
1,<environment.Job instance at 0x7f28c9a98d20>,28,17,[9 2],29,-1,47,-1,30
1,<environment.Job instance at 0x7f28c93339b0>,29,14,[7 5],30,-1,45,-1,31
1,<environment.Job instance at 0x7f28c96a80f0>,32,18,[5 3],33,-1,51,-1,33
1,<environment.Job instance at 0x7f28c96a81e0>,33,27,[1 7],34,-1,61,-1,34
1,<environment.Job instance at 0x7f28c9a6b500>,34,18,[6 3],35,-1,53,-1,35
1,<environment.Job instance at 0x7f28c9a5a6e0>,39,15,[4 7],40,-1,55,-1,40
1,<environment.Job instance at 0x7f28c9a5a370>,42,17,[5 9],43,-1,60,-1,43
1,<environment.Job instance at 0x7f28c9a7d960>,43,18,[5 5],44,-1,62,-1,44
1,<environment.Job instance at 0x7f28c9a7df00>,44,15,[8 2],45,-1,61,-1,46
1,<environment.Job instance at 0x7f28c9a7da50>,46,17,[1 6],47,-1,64,-1,47
1,<environment.Job instance at 0x7f28c9a7dd70>,47,18,[5 5],48,-1,66,-1,48
1,<environment.Job instance at 0x7f28c9a7dc30>,48,18,[ 3 10],49,-1,67,-1,49
1,<environment.Job instance at 0x7f28c9a7dcd0>,49,13,[8 4],50,-1,63,-1,50
1,<environment.Job instance at 0x7f28c9a7deb0>,50,27,[5 4],51,-1,78,-1,51
1,<environment.Job instance at 0x7f28ca123230>,51,28,[7 5],52,-1,80,-1,52
1,<environment.Job instance at 0x7f28ca1230f0>,53,28,[8 2],54,-1,82,-1,54
1,<environment.Job instance at 0x7f28ca123190>,54,16,[2 5],55,-1,71,-1,55
1,<environment.Job instance at 0x7f28ca123910>,55,13,[ 5 10],56,-1,69,-1,56
1,<environment.Job instance at 0x7f28ca123550>,58,17,[5 3],59,-1,76,-1,59
1,<environment.Job instance at 0x7f28ca12f960>,62,14,[3 8],63,-1,77,-1,63
1,<environment.Job instance at 0x7f28ca12f780>,63,16,[7 2],64,-1,80,-1,64
1,<environment.Job instance at 0x7f28ca12f6e0>,64,12,[9 3],65,-1,77,-1,65
1,<environment.Job instance at 0x7f28ca12fe10>,67,18,[2 6],68,-1,86,-1,68
1,<environment.Job instance at 0x7f28ca12ff50>,68,15,[3 9],69,-1,84,-1,69
1,<environment.Job instance at 0x7f28ca12fe60>,69,12,[10  4],70,-1,86,-1,74
1,<environment.Job instance at 0x7f28c9a913c0>,45,17,[6 4],46,-1,91,-1,74
1,<environment.Job instance at 0x7f28ca11c3c0>,74,15,[10  1],75,-1,91,-1,76
1,<environment.Job instance at 0x7f28ca11c640>,75,18,[7 4],76,-1,96,-1,78
1,<environment.Job instance at 0x7f28ca11c730>,77,13,[5 1],78,-1,92,-1,79
1,<environment.Job instance at 0x7f28ca11c780>,79,13,[5 8],80,-1,93,-1,80
1,<environment.Job instance at 0x7f28ca0f92d0>,93,18,[6 4],94,-1,172,-1,154
1,<environment.Job instance at 0x7f28ca0f9be0>,100,18,[2 9],101,-1,172,-1,154
1,<environment.Job instance at 0x7f28ca0f9f50>,107,26,[3 7],108,-1,180,-1,154
1,<environment.Job instance at 0x7f28ca0f9370>,94,18,[9 1],95,-1,172,-1,154
1,<environment.Job instance at 0x7f28c9860370>,0,25,[10  4],1,-1,26,-1,1
1,<environment.Job instance at 0x7f28ca131f50>,17,16,[13  1],18,-1,41,-1,25
1,<environment.Job instance at 0x7f28ca133d20>,21,2,[13  4],22,-1,55,-1,53
1,<environment.Job instance at 0x7f28c9317be0>,30,27,[ 3 13],31,-1,103,-1,76
1,<environment.Job instance at 0x7f28c9a8dc80>,33,27,[1 7],34,-1,117,-1,90
1,<environment.Job instance at 0x7f28c9333aa0>,35,18,[ 3 12],36,-1,118,-1,100
1,<environment.Job instance at 0x7f28ca130280>,40,1,[12  1],41,-1,125,-1,124
1,<environment.Job instance at 0x7f28c9a5e780>,41,25,[9 1],42,-1,152,-1,127
1,<environment.Job instance at 0x7f28c9a2a320>,50,27,[5 4],51,-1,205,-1,178
1,<environment.Job instance at 0x7f28c9a2a410>,51,28,[7 5],52,-1,206,-1,178
1,<environment.Job instance at 0x7f28c9a2ab40>,53,28,[8 2],54,-1,217,-1,189
1,<environment.Job instance at 0x7f28c9dc5320>,71,1,[ 5 14],72,-1,249,-1,248
1,<environment.Job instance at 0x7f28c9dc5d70>,80,17,[ 5 13],81,-1,297,-1,280
1,<environment.Job instance at 0x7f28c9d80910>,83,27,[5 1],84,-1,313,-1,286
1,<environment.Job instance at 0x7f28c9d80c30>,86,2,[ 5 12],87,-1,302,-1,300
1,<environment.Job instance at 0x7f28c93dc140>,95,17,[14  4],96,-1,344,-1,327
1,<environment.Job instance at 0x7f28c93dc2d0>,101,12,[13  5],102,-1,375,-1,363
1,<environment.Job instance at 0x7f28c9544460>,107,26,[3 7],108,-1,428,-1,402
1,<environment.Job instance at 0x7f28c94602d0>,117,1,[ 2 11],118,-1,410,-1,409
1,<environment.Job instance at 0x7f28c91b84b0>,119,25,[3 8],120,-1,447,-1,422
1,<environment.Job instance at 0x7f28c93e1d70>,127,28,[4 9],128,-1,467,-1,439
1,<environment.Job instance at 0x7f28c93e1190>,131,18,[13  5],132,-1,458,-1,440
1,<environment.Job instance at 0x7f28c93e1050>,135,14,[11  2],136,-1,468,-1,454
1,<environment.Job instance at 0x7f28c93f0b40>,138,1,[14  2],139,-1,460,-1,459
1,<environment.Job instance at 0x7f28c9a40550>,139,1,[ 1 11],140,-1,460,-1,459
1,<environment.Job instance at 0x7f28c9a401e0>,4,21,[8 1],5,-1,26,-1,5
1,<environment.Job instance at 0x7f28c92a68c0>,9,25,[ 3 10],10,-1,36,-1,11
1,<environment.Job instance at 0x7f28c92a6280>,11,12,[ 1 10],12,-1,24,-1,12
1,<environment.Job instance at 0x7f28c9f7bdc0>,10,18,[ 2 11],11,-1,31,-1,13
1,<environment.Job instance at 0x7f28c92a6b40>,14,17,[5 4],15,-1,32,-1,15
1,<environment.Job instance at 0x7f28c92a6910>,15,15,[9 4],16,-1,32,-1,17
1,<environment.Job instance at 0x7f28c92a6140>,17,23,[9 2],18,-1,41,-1,18
1,<environment.Job instance at 0x7f28c92a63c0>,20,15,[4 8],21,-1,36,-1,21
1,<environment.Job instance at 0x7f28c92a6410>,16,15,[4 7],17,-1,36,-1,21
1,<environment.Job instance at 0x7f28c95190a0>,23,17,[7 4],24,-1,43,-1,26
1,<environment.Job instance at 0x7f28c9519a00>,27,1,[6 5],28,-1,29,-1,28
1,<environment.Job instance at 0x7f28c9519c30>,25,15,[9 1],26,-1,43,-1,28
1,<environment.Job instance at 0x7f28c95191e0>,28,16,[6 5],29,-1,45,-1,29
1,<environment.Job instance at 0x7f28ca3ef4b0>,32,18,[ 2 10],33,-1,51,-1,33
1,<environment.Job instance at 0x7f28ca3ef690>,33,14,[4 9],34,-1,48,-1,34
1,<environment.Job instance at 0x7f28ca3ef870>,37,15,[1 6],38,-1,53,-1,38
1,<environment.Job instance at 0x7f28ca3efb90>,41,18,[5 5],42,-1,61,-1,43
1,<environment.Job instance at 0x7f28ca1ba0f0>,43,24,[4 7],44,-1,68,-1,44
1,<environment.Job instance at 0x7f28ca1bad20>,44,16,[4 7],45,-1,61,-1,45
1,<environment.Job instance at 0x7f28ca1baaf0>,48,23,[ 4 10],49,-1,72,-1,49
1,<environment.Job instance at 0x7f28ca23e640>,52,14,[4 9],53,-1,67,-1,53
1,<environment.Job instance at 0x7f28c9724be0>,57,18,[3 9],58,-1,76,-1,58
1,<environment.Job instance at 0x7f28ca1ba690>,42,14,[5 7],43,-1,72,-1,58
1,<environment.Job instance at 0x7f28c9460e60>,62,15,[ 1 10],63,-1,79,-1,64
1,<environment.Job instance at 0x7f28c9460690>,63,24,[3 5],64,-1,91,-1,67
1,<environment.Job instance at 0x7f28c92020f0>,68,17,[10  4],69,-1,88,-1,71
1,<environment.Job instance at 0x7f28ca091820>,71,17,[4 7],72,-1,89,-1,72
1,<environment.Job instance at 0x7f28c9f142d0>,73,17,[4 9],74,-1,91,-1,74
1,<environment.Job instance at 0x7f28c977a640>,78,16,[9 2],79,-1,101,-1,85
1,<environment.Job instance at 0x7f28c9c005f0>,84,15,[3 8],85,-1,102,-1,87
1,<environment.Job instance at 0x7f28c971d320>,90,18,[8 5],91,-1,140,-1,122
1,<environment.Job instance at 0x7f28c954f4b0>,55,13,[ 3 12],56,-1,174,-1,161
1,<environment.Job instance at 0x7f28c92ceaf0>,98,17,[10  4],99,-1,178,-1,161
1,<environment.Job instance at 0x7f28c92cee60>,99,15,[5 9],100,-1,176,-1,161
1,<environment.Job instance at 0x7f28c8b6c3c0>,94,13,[4 6],95,-1,174,-1,161
1,<environment.Job instance at 0x7f28c92ce690>,102,16,[3 5],103,-1,178,-1,162
1,<environment.Job instance at 0x7f28c92ce5a0>,105,22,[1 9],106,-1,184,-1,162
1,<environment.Job instance at 0x7f28d2b81410>,113,17,[10  3],114,-1,205,-1,188
1,<environment.Job instance at 0x7f28ca56e0a0>,118,17,[3 8],119,-1,205,-1,188
1,<environment.Job instance at 0x7f28ca56eb40>,117,15,[6 4],118,-1,203,-1,188
1,<environment.Job instance at 0x7f28c9545140>,119,15,[ 5 10],120,-1,203,-1,188
1,<environment.Job instance at 0x7f28c94228c0>,121,17,[ 2 10],122,-1,205,-1,188
1,<environment.Job instance at 0x7f28c9422910>,123,18,[9 2],124,-1,209,-1,191
1,<environment.Job instance at 0x7f28c9f2a780>,124,24,[5 9],125,-1,215,-1,191
1,<environment.Job instance at 0x7f28c9f2af50>,125,16,[10  3],126,-1,207,-1,191
1,<environment.Job instance at 0x7f28c9f2a190>,127,26,[8 5],128,-1,218,-1,192
1,<environment.Job instance at 0x7f28c9f2ac30>,133,26,[7 5],134,-1,248,-1,222
1,<environment.Job instance at 0x7f28c95be370>,137,18,[ 3 10],138,-1,243,-1,225
1,<environment.Job instance at 0x7f28c9422f50>,120,19,[5 4],121,-1,280,-1,261
1,<environment.Job instance at 0x7f28c95be320>,142,18,[4 7],143,-1,279,-1,261
1,<environment.Job instance at 0x7f28ca17db90>,151,12,[10  4],152,-1,284,-1,272
1,<environment.Job instance at 0x7f28ca3ef730>,10,18,[ 2 11],11,-1,34,-1,16
1,<environment.Job instance at 0x7f28ca23eeb0>,9,25,[ 3 10],10,-1,42,-1,17
1,<environment.Job instance at 0x7f28c92ce6e0>,17,23,[9 2],18,-1,64,-1,41
1,<environment.Job instance at 0x7f28c92dd140>,36,17,[ 1 14],37,-1,109,-1,92
1,<environment.Job instance at 0x7f28c9030910>,39,18,[14  4],40,-1,112,-1,94
1,<environment.Job instance at 0x7f28c9a46780>,43,24,[4 7],44,-1,135,-1,111
1,<environment.Job instance at 0x7f28c9a40af0>,48,23,[ 4 10],49,-1,166,-1,143
1,<environment.Job instance at 0x7f28c9460c30>,55,13,[ 3 12],56,-1,160,-1,147
1,<environment.Job instance at 0x7f28c9460500>,56,13,[ 4 12],57,-1,160,-1,147
1,<environment.Job instance at 0x7f28c9544500>,63,24,[3 5],64,-1,189,-1,165
1,<environment.Job instance at 0x7f28c9d80500>,79,24,[7 1],80,-1,257,-1,233
1,<environment.Job instance at 0x7f28c9d80d70>,80,26,[4 8],81,-1,259,-1,233
1,<environment.Job instance at 0x7f28c9a2ad20>,95,15,[12  1],96,-1,322,-1,307
1,<environment.Job instance at 0x7f28c9a2a320>,103,1,[ 3 13],104,-1,343,-1,342
1,<environment.Job instance at 0x7f28c9a5efa0>,109,18,[ 3 12],110,-1,376,-1,358
1,<environment.Job instance at 0x7f28ca123a00>,115,1,[ 5 13],116,-1,377,-1,376
1,<environment.Job instance at 0x7f28c9a7d050>,124,24,[5 9],125,-1,435,-1,411
1,<environment.Job instance at 0x7f28c9a6bf50>,127,26,[8 5],128,-1,454,-1,428
1,<environment.Job instance at 0x7f28ca131aa0>,133,26,[7 5],134,-1,486,-1,460
1,<environment.Job instance at 0x7f28ca0f98c0>,135,2,[13  2],136,-1,462,-1,460
1,<environment.Job instance at 0x7f28c969f5a0>,143,3,[11  3],144,-1,496,-1,493
1,<environment.Job instance at 0x7f28c9ec1370>,158,16,[ 5 13],159,-1,551,-1,535
1,<environment.Job instance at 0x7f28c97478c0>,4,17,[5 9],5,-1,23,-1,6
1,<environment.Job instance at 0x7f28c93f8e10>,5,17,[5 9],6,-1,23,-1,6
1,<environment.Job instance at 0x7f28c9747d70>,6,23,[10  4],7,-1,31,-1,8
1,<environment.Job instance at 0x7f28c97474b0>,8,17,[4 9],9,-1,26,-1,9
1,<environment.Job instance at 0x7f28c9747550>,9,18,[9 5],10,-1,28,-1,10
1,<environment.Job instance at 0x7f28c9747280>,11,17,[8 2],12,-1,29,-1,12
1,<environment.Job instance at 0x7f28c97472d0>,12,18,[10  5],13,-1,31,-1,13
1,<environment.Job instance at 0x7f28c9747a00>,15,16,[3 8],16,-1,32,-1,16
1,<environment.Job instance at 0x7f28c9747140>,16,14,[4 7],17,-1,31,-1,17
1,<environment.Job instance at 0x7f28c97473c0>,17,18,[5 4],18,-1,36,-1,18
1,<environment.Job instance at 0x7f28c98b0b40>,21,17,[7 2],22,-1,39,-1,22
1,<environment.Job instance at 0x7f28c98b0780>,22,1,[2 7],23,-1,24,-1,23
1,<environment.Job instance at 0x7f28c98b0280>,23,16,[3 9],24,-1,40,-1,24
1,<environment.Job instance at 0x7f28c98b0460>,24,13,[10  1],25,-1,38,-1,25
1,<environment.Job instance at 0x7f28c98b0690>,25,13,[ 3 10],26,-1,39,-1,26
1,<environment.Job instance at 0x7f28c98b0870>,26,14,[1 5],27,-1,41,-1,27
1,<environment.Job instance at 0x7f28c98b0410>,29,25,[8 3],30,-1,55,-1,30
1,<environment.Job instance at 0x7f28c98b0230>,31,17,[3 7],32,-1,49,-1,32
1,<environment.Job instance at 0x7f28c98b0820>,33,18,[2 6],34,-1,52,-1,34
1,<environment.Job instance at 0x7f28c98b0cd0>,34,18,[8 2],35,-1,53,-1,35
1,<environment.Job instance at 0x7f28c98b00a0>,36,17,[1 6],37,-1,54,-1,37
1,<environment.Job instance at 0x7f28c98b06e0>,37,18,[5 2],38,-1,56,-1,38
1,<environment.Job instance at 0x7f28c955feb0>,38,17,[3 5],39,-1,56,-1,39
1,<environment.Job instance at 0x7f28c955f4b0>,39,13,[4 7],40,-1,53,-1,40
1,<environment.Job instance at 0x7f28c955f960>,41,15,[10  5],42,-1,57,-1,42
1,<environment.Job instance at 0x7f28c955fe10>,42,18,[10  1],43,-1,61,-1,43
1,<environment.Job instance at 0x7f28c955f910>,51,18,[7 1],52,-1,70,-1,52
1,<environment.Job instance at 0x7f28c955f230>,53,18,[ 3 10],54,-1,72,-1,54
1,<environment.Job instance at 0x7f28c8c19870>,58,12,[10  2],59,-1,71,-1,59
1,<environment.Job instance at 0x7f28c8c19fa0>,61,15,[9 5],62,-1,77,-1,62
1,<environment.Job instance at 0x7f28c8c19eb0>,62,14,[ 1 10],63,-1,77,-1,63
1,<environment.Job instance at 0x7f28c8c19c30>,65,15,[10  1],66,-1,81,-1,66
1,<environment.Job instance at 0x7f28c8c196e0>,66,21,[3 7],67,-1,88,-1,67
1,<environment.Job instance at 0x7f28c8c19500>,67,15,[ 3 10],68,-1,83,-1,68
1,<environment.Job instance at 0x7f28c8c19aa0>,68,28,[8 3],69,-1,97,-1,69
1,<environment.Job instance at 0x7f28c970ea00>,69,20,[1 9],70,-1,90,-1,70
1,<environment.Job instance at 0x7f28c970e5f0>,71,17,[5 6],72,-1,89,-1,72
1,<environment.Job instance at 0x7f28c970e050>,72,16,[10  1],73,-1,89,-1,73
1,<environment.Job instance at 0x7f28c970e320>,73,17,[ 2 10],74,-1,91,-1,74
1,<environment.Job instance at 0x7f28c970e460>,76,13,[ 5 11],77,-1,90,-1,77
1,<environment.Job instance at 0x7f28c970e1e0>,78,15,[10  2],79,-1,94,-1,79
1,<environment.Job instance at 0x7f28c970e140>,79,18,[3 8],80,-1,98,-1,80
1,<environment.Job instance at 0x7f28c970e780>,81,18,[4 6],82,-1,100,-1,82
1,<environment.Job instance at 0x7f28c970e960>,82,15,[1 7],83,-1,98,-1,83
1,<environment.Job instance at 0x7f28c970e870>,83,17,[6 1],84,-1,101,-1,84
1,<environment.Job instance at 0x7f28c970ec30>,86,13,[8 3],87,-1,100,-1,87
1,<environment.Job instance at 0x7f28c8b84e10>,87,12,[ 3 10],88,-1,100,-1,88
1,<environment.Job instance at 0x7f28c8b84320>,94,16,[1 8],95,-1,111,-1,95
1,<environment.Job instance at 0x7f28c8c350a0>,99,20,[2 8],100,-1,175,-1,155
1,<environment.Job instance at 0x7f28c8c353c0>,103,18,[8 1],104,-1,173,-1,155
1,<environment.Job instance at 0x7f28c9730230>,111,23,[5 9],112,-1,178,-1,155
1,<environment.Job instance at 0x7f28c955faa0>,1,15,[14  4],2,-1,17,-1,2
1,<environment.Job instance at 0x7f28c8c19550>,6,23,[10  4],7,-1,39,-1,16
1,<environment.Job instance at 0x7f28c9858e60>,29,25,[8 3],30,-1,140,-1,115
1,<environment.Job instance at 0x7f28c98d3be0>,32,24,[11  1],33,-1,139,-1,115
1,<environment.Job instance at 0x7f28c9adf1e0>,63,2,[12  1],64,-1,235,-1,233
1,<environment.Job instance at 0x7f28c9adf9b0>,64,1,[ 5 14],65,-1,234,-1,233
1,<environment.Job instance at 0x7f28ca243780>,68,28,[8 3],69,-1,275,-1,247
1,<environment.Job instance at 0x7f28c981eb90>,76,13,[ 5 11],77,-1,293,-1,280
1,<environment.Job instance at 0x7f28c981ea00>,77,2,[13  1],78,-1,282,-1,280
1,<environment.Job instance at 0x7f28c9702690>,84,1,[11  3],85,-1,317,-1,316
1,<environment.Job instance at 0x7f28c97ecfa0>,91,13,[ 1 13],92,-1,365,-1,352
1,<environment.Job instance at 0x7f28d2fb97d0>,92,27,[9 1],93,-1,380,-1,353
1,<environment.Job instance at 0x7f28ca24a320>,96,21,[12  2],97,-1,387,-1,366
1,<environment.Job instance at 0x7f28ca24a1e0>,98,14,[ 1 14],99,-1,382,-1,368
1,<environment.Job instance at 0x7f28c98de730>,100,15,[12  3],101,-1,384,-1,369
1,<environment.Job instance at 0x7f28c9f6af50>,106,2,[12  3],107,-1,383,-1,381
1,<environment.Job instance at 0x7f28d3090460>,111,23,[5 9],112,-1,436,-1,413
1,<environment.Job instance at 0x7f28c941d640>,115,15,[ 4 12],116,-1,428,-1,413
1,<environment.Job instance at 0x7f28d2e55b90>,119,3,[ 4 11],120,-1,430,-1,427
1,<environment.Job instance at 0x7f28c91e9280>,121,26,[7 2],122,-1,456,-1,430
1,<environment.Job instance at 0x7f28c9a16960>,122,2,[ 2 13],123,-1,432,-1,430
1,<environment.Job instance at 0x7f28c9273e10>,126,12,[11  2],127,-1,445,-1,433
1,<environment.Job instance at 0x7f28c9273a50>,127,1,[14  5],128,-1,434,-1,433
1,<environment.Job instance at 0x7f28c9f076e0>,128,19,[ 5 11],129,-1,452,-1,433
1,<environment.Job instance at 0x7f28c9533870>,138,1,[ 4 13],139,-1,471,-1,470
1,<environment.Job instance at 0x7f28ca526cd0>,142,2,[ 3 14],143,-1,477,-1,475
1,<environment.Job instance at 0x7f28c9d35cd0>,144,23,[8 3],145,-1,500,-1,477
1,<environment.Job instance at 0x7f28c900fb90>,149,1,[11  4],150,-1,483,-1,482
1,<environment.Job instance at 0x7f28c96b8f50>,153,27,[9 4],154,-1,529,-1,502
1,<environment.Job instance at 0x7f28c9ff3e60>,154,25,[8 2],155,-1,527,-1,502
1,<environment.Job instance at 0x7f28ca10e730>,2,17,[5 9],3,-1,21,-1,4
1,<environment.Job instance at 0x7f28ca10e500>,3,18,[6 1],4,-1,22,-1,4
1,<environment.Job instance at 0x7f28c9dfa2d0>,7,17,[3 7],8,-1,26,-1,9
1,<environment.Job instance at 0x7f28c9dfa690>,9,16,[5 1],10,-1,26,-1,10
1,<environment.Job instance at 0x7f28c9dfac30>,8,16,[8 5],9,-1,26,-1,10
1,<environment.Job instance at 0x7f28ca294fa0>,15,22,[9 4],16,-1,38,-1,16
1,<environment.Job instance at 0x7f28ca2948c0>,19,27,[5 8],20,-1,47,-1,20
1,<environment.Job instance at 0x7f28ca2940a0>,21,12,[10  5],22,-1,34,-1,22
1,<environment.Job instance at 0x7f28ca294960>,22,15,[ 5 10],23,-1,38,-1,23
1,<environment.Job instance at 0x7f28ca2947d0>,23,16,[5 8],24,-1,40,-1,24
1,<environment.Job instance at 0x7f28ca294460>,25,12,[3 5],26,-1,38,-1,26
1,<environment.Job instance at 0x7f28ca294190>,26,22,[3 8],27,-1,49,-1,27
1,<environment.Job instance at 0x7f28c9223eb0>,41,12,[ 4 10],42,-1,54,-1,42
1,<environment.Job instance at 0x7f28c9223280>,40,18,[9 4],41,-1,62,-1,44
1,<environment.Job instance at 0x7f28c9223870>,43,14,[ 1 10],44,-1,59,-1,45
1,<environment.Job instance at 0x7f28c9c78be0>,48,24,[8 2],49,-1,79,-1,55
1,<environment.Job instance at 0x7f28c9c78eb0>,50,18,[ 2 12],51,-1,73,-1,55
1,<environment.Job instance at 0x7f28c9223140>,44,17,[14  4],45,-1,79,-1,62
1,<environment.Job instance at 0x7f28c9c783c0>,53,17,[6 3],54,-1,79,-1,62
1,<environment.Job instance at 0x7f28c9c78730>,52,18,[1 9],53,-1,80,-1,62
1,<environment.Job instance at 0x7f28c9dfa550>,0,12,[ 4 12],1,-1,13,-1,1
1,<environment.Job instance at 0x7f28c9533aa0>,19,27,[5 8],20,-1,81,-1,54
1,<environment.Job instance at 0x7f28c9d5a780>,35,15,[13  3],36,-1,101,-1,86
1,<environment.Job instance at 0x7f28ca24ad20>,42,1,[14  1],43,-1,105,-1,104
1,<environment.Job instance at 0x7f28c9b455a0>,44,17,[14  4],45,-1,135,-1,118
1,<environment.Job instance at 0x7f28c97ec2d0>,48,24,[8 2],49,-1,157,-1,133
1,<environment.Job instance at 0x7f28c8cdb050>,49,27,[ 3 13],50,-1,160,-1,133
1,<environment.Job instance at 0x7f28c9920d70>,50,18,[ 2 12],51,-1,151,-1,133
1,<environment.Job instance at 0x7f28c9be2f00>,56,24,[13  3],57,-1,179,-1,155
1,<environment.Job instance at 0x7f28ca3ea730>,73,26,[7 3],74,-1,246,-1,220
1,<environment.Job instance at 0x7f28c9747190>,77,27,[1 8],78,-1,271,-1,244
1,<environment.Job instance at 0x7f28c970e550>,90,26,[2 8],91,-1,325,-1,299
1,<environment.Job instance at 0x7f28ca39b7d0>,99,17,[12  4],100,-1,345,-1,328
1,<environment.Job instance at 0x7f28c9b9f9b0>,105,17,[ 1 11],106,-1,357,-1,340
1,<environment.Job instance at 0x7f28c9c6e320>,107,13,[12  4],108,-1,367,-1,354
1,<environment.Job instance at 0x7f28c8c575a0>,120,24,[ 4 14],121,-1,425,-1,401
1,<environment.Job instance at 0x7f28c952a3c0>,124,14,[ 1 11],125,-1,429,-1,415
1,<environment.Job instance at 0x7f28c952ac80>,125,24,[7 4],126,-1,440,-1,416
1,<environment.Job instance at 0x7f28d2ab0f50>,135,25,[6 2],136,-1,483,-1,458
1,<environment.Job instance at 0x7f28c9f71af0>,136,2,[ 1 13],137,-1,460,-1,458
1,<environment.Job instance at 0x7f28c9275050>,146,26,[10  2],147,-1,516,-1,490
1,<environment.Job instance at 0x7f28c9702af0>,154,1,[12  5],155,-1,520,-1,519
1,<environment.Job instance at 0x7f28c9fedc80>,155,1,[ 2 14],156,-1,520,-1,519
1,<environment.Job instance at 0x7f28c9fed4b0>,157,2,[14  3],158,-1,523,-1,521
1,<environment.Job instance at 0x7f28ca29d780>,1,18,[5 5],2,-1,20,-1,2
1,<environment.Job instance at 0x7f28c9575e10>,2,15,[ 1 10],3,-1,19,-1,4
1,<environment.Job instance at 0x7f28c9575fa0>,4,18,[9 2],5,-1,24,-1,6
1,<environment.Job instance at 0x7f28c9575e60>,5,18,[10  4],6,-1,24,-1,6
1,<environment.Job instance at 0x7f28c95560f0>,7,15,[5 9],8,-1,23,-1,8
1,<environment.Job instance at 0x7f28c9556320>,10,15,[10  5],11,-1,27,-1,12
1,<environment.Job instance at 0x7f28c95561e0>,11,17,[8 2],12,-1,29,-1,12
1,<environment.Job instance at 0x7f28c9556500>,14,18,[8 4],15,-1,33,-1,15
1,<environment.Job instance at 0x7f28c9556910>,17,17,[2 7],18,-1,37,-1,20
1,<environment.Job instance at 0x7f28c9556eb0>,24,18,[3 9],25,-1,43,-1,25
1,<environment.Job instance at 0x7f28c95615a0>,30,17,[1 5],31,-1,48,-1,31
1,<environment.Job instance at 0x7f28c95618c0>,35,13,[ 5 10],36,-1,53,-1,40
1,<environment.Job instance at 0x7f28c9561fa0>,40,17,[11  3],41,-1,58,-1,41
1,<environment.Job instance at 0x7f28c9556a00>,19,14,[6 4],20,-1,61,-1,47
1,<environment.Job instance at 0x7f28c9561f50>,41,17,[5 3],42,-1,64,-1,47
1,<environment.Job instance at 0x7f28c95615f0>,31,17,[10  2],32,-1,64,-1,47
1,<environment.Job instance at 0x7f28c9561dc0>,39,16,[6 3],40,-1,91,-1,75
1,<environment.Job instance at 0x7f28c95555a0>,51,16,[3 9],52,-1,91,-1,75
1,<environment.Job instance at 0x7f28c95558c0>,55,14,[6 4],56,-1,95,-1,81
1,<environment.Job instance at 0x7f28c9555640>,52,12,[7 5],53,-1,94,-1,82
1,<environment.Job instance at 0x7f28c9555c30>,60,16,[8 2],61,-1,102,-1,86
1,<environment.Job instance at 0x7f28c9555b90>,61,28,[5 9],62,-1,114,-1,86
1,<environment.Job instance at 0x7f28c9579230>,66,18,[9 2],67,-1,104,-1,86
1,<environment.Job instance at 0x7f28c95792d0>,67,16,[10  4],68,-1,102,-1,86
1,<environment.Job instance at 0x7f28c9555fa0>,63,28,[6 1],64,-1,114,-1,86
1,<environment.Job instance at 0x7f28c9579320>,68,23,[ 3 10],69,-1,109,-1,86
1,<environment.Job instance at 0x7f28c95793c0>,69,17,[4 5],70,-1,103,-1,86
1,<environment.Job instance at 0x7f28c9555be0>,57,24,[8 1],58,-1,121,-1,97
1,<environment.Job instance at 0x7f28c9579640>,72,14,[4 6],73,-1,111,-1,97
1,<environment.Job instance at 0x7f28c9579dc0>,77,19,[6 3],78,-1,116,-1,97
1,<environment.Job instance at 0x7f28c9579d70>,80,18,[7 1],81,-1,115,-1,97
1,<environment.Job instance at 0x7f28c95799b0>,73,18,[ 5 11],74,-1,115,-1,97
1,<environment.Job instance at 0x7f28c957f1e0>,81,3,[8 2],82,-1,100,-1,97
1,<environment.Job instance at 0x7f28c957f410>,84,17,[12  2],85,-1,114,-1,97
1,<environment.Job instance at 0x7f28c9579500>,71,3,[5 9],72,-1,102,-1,99
1,<environment.Job instance at 0x7f28c957f820>,86,22,[3 7],87,-1,123,-1,101
1,<environment.Job instance at 0x7f28c957f870>,87,21,[5 3],88,-1,122,-1,101
1,<environment.Job instance at 0x7f28c957f730>,89,14,[3 7],90,-1,115,-1,101
1,<environment.Job instance at 0x7f28c957f910>,90,17,[9 5],91,-1,119,-1,102
1,<environment.Job instance at 0x7f28c95552d0>,46,14,[8 4],47,-1,116,-1,102
1,<environment.Job instance at 0x7f28c957f9b0>,91,14,[9 4],92,-1,116,-1,102
1,<environment.Job instance at 0x7f28c9555e60>,62,14,[7 1],63,-1,116,-1,102
1,<environment.Job instance at 0x7f28c957fb90>,94,18,[6 5],95,-1,121,-1,103
1,<environment.Job instance at 0x7f28c957f460>,82,18,[6 5],83,-1,121,-1,103
1,<environment.Job instance at 0x7f28c8f612d0>,98,18,[1 8],99,-1,124,-1,106
1,<environment.Job instance at 0x7f28c8f61370>,100,15,[4 9],101,-1,122,-1,107
1,<environment.Job instance at 0x7f28c957fcd0>,96,28,[7 3],97,-1,135,-1,107
1,<environment.Job instance at 0x7f28c957faf0>,93,12,[2 8],94,-1,119,-1,107
1,<environment.Job instance at 0x7f28c8f61a00>,104,13,[3 8],105,-1,120,-1,107
1,<environment.Job instance at 0x7f28c8f619b0>,105,16,[ 4 14],106,-1,123,-1,107
1,<environment.Job instance at 0x7f28c957c280>,107,16,[2 6],108,-1,125,-1,109
1,<environment.Job instance at 0x7f28c957c3c0>,108,17,[7 4],109,-1,126,-1,109
1,<environment.Job instance at 0x7f28c93c6eb0>,110,12,[4 8],111,-1,124,-1,112
1,<environment.Job instance at 0x7f28c8f61280>,99,21,[10  5],100,-1,134,-1,113
1,<environment.Job instance at 0x7f28c93c6550>,112,20,[1 9],113,-1,133,-1,113
1,<environment.Job instance at 0x7f28c93c6dc0>,113,18,[3 7],114,-1,132,-1,114
1,<environment.Job instance at 0x7f28c93c6140>,111,16,[6 2],112,-1,151,-1,135
1,<environment.Job instance at 0x7f28c97f7190>,118,17,[2 5],119,-1,152,-1,135
1,<environment.Job instance at 0x7f28c9c94f50>,128,22,[10  5],129,-1,157,-1,135
1,<environment.Job instance at 0x7f28c916a500>,125,26,[5 5],126,-1,161,-1,135
1,<environment.Job instance at 0x7f28c9694730>,124,18,[2 9],125,-1,153,-1,135
1,<environment.Job instance at 0x7f28ca120be0>,129,15,[2 8],130,-1,150,-1,135
1,<environment.Job instance at 0x7f28c95797d0>,8,28,[ 2 11],9,-1,46,-1,18
1,<environment.Job instance at 0x7f28c9702af0>,16,15,[ 2 12],17,-1,53,-1,38
1,<environment.Job instance at 0x7f28c9275cd0>,20,12,[ 1 11],21,-1,64,-1,52
1,<environment.Job instance at 0x7f28c9275aa0>,23,15,[ 5 12],24,-1,84,-1,69
1,<environment.Job instance at 0x7f28c9b555a0>,40,17,[11  3],41,-1,148,-1,131
1,<environment.Job instance at 0x7f28ca243c30>,57,24,[8 1],58,-1,229,-1,205
1,<environment.Job instance at 0x7f28c9be2280>,61,28,[5 9],62,-1,238,-1,210
1,<environment.Job instance at 0x7f28c9920730>,63,28,[6 1],64,-1,252,-1,224
1,<environment.Job instance at 0x7f28d2fb97d0>,68,23,[ 3 10],69,-1,262,-1,239
1,<environment.Job instance at 0x7f28c9d5a730>,73,18,[ 5 11],74,-1,275,-1,257
1,<environment.Job instance at 0x7f28c9f076e0>,83,1,[13  4],84,-1,292,-1,291
1,<environment.Job instance at 0x7f28c8e80640>,84,17,[12  2],85,-1,308,-1,291
1,<environment.Job instance at 0x7f28ca294910>,96,28,[7 3],97,-1,358,-1,330
1,<environment.Job instance at 0x7f28c9c7df50>,105,16,[ 4 14],106,-1,375,-1,359
1,<environment.Job instance at 0x7f28ca00d0a0>,117,26,[ 2 12],118,-1,437,-1,411
1,<environment.Job instance at 0x7f28c9104fa0>,119,1,[ 3 12],120,-1,413,-1,412
1,<environment.Job instance at 0x7f28ca0cb0a0>,122,3,[11  1],123,-1,417,-1,414
1,<environment.Job instance at 0x7f28c8dd7870>,125,26,[5 5],126,-1,444,-1,418
1,<environment.Job instance at 0x7f28c9f3f550>,134,25,[9 4],135,-1,490,-1,465
1,<environment.Job instance at 0x7f28c90e75a0>,140,25,[9 5],141,-1,496,-1,471
1,<environment.Job instance at 0x7f28c90e7aa0>,141,3,[11  1],142,-1,474,-1,471
1,<environment.Job instance at 0x7f28ca4bed20>,142,3,[12  5],143,-1,474,-1,471
1,<environment.Job instance at 0x7f28ca47d690>,150,26,[10  1],151,-1,551,-1,525
1,<environment.Job instance at 0x7f28c90eaf00>,0,15,[9 4],1,-1,17,-1,2
1,<environment.Job instance at 0x7f28c8bc4410>,2,17,[9 5],3,-1,20,-1,3
1,<environment.Job instance at 0x7f28c9fedbe0>,1,14,[8 1],2,-1,17,-1,3
1,<environment.Job instance at 0x7f28c8bc4320>,4,18,[6 4],5,-1,23,-1,5
1,<environment.Job instance at 0x7f28c8bc4230>,5,27,[5 8],6,-1,33,-1,6
1,<environment.Job instance at 0x7f28c8bc4370>,7,25,[6 4],8,-1,33,-1,8
1,<environment.Job instance at 0x7f28d2ad1f00>,9,25,[10  1],10,-1,35,-1,10
1,<environment.Job instance at 0x7f28d2ad1b40>,13,18,[10  5],14,-1,32,-1,14
1,<environment.Job instance at 0x7f28d2ad1230>,18,16,[8 2],19,-1,37,-1,21
1,<environment.Job instance at 0x7f28d2ad1af0>,21,21,[4 7],22,-1,43,-1,22
1,<environment.Job instance at 0x7f28d2ad1460>,25,17,[4 6],26,-1,43,-1,26
1,<environment.Job instance at 0x7f28c9dfa5a0>,29,3,[ 2 10],30,-1,33,-1,30
1,<environment.Job instance at 0x7f28c9dfa8c0>,30,18,[7 3],31,-1,49,-1,31
1,<environment.Job instance at 0x7f28c9dfabe0>,31,26,[5 4],32,-1,58,-1,32
1,<environment.Job instance at 0x7f28c9dfac30>,34,15,[6 1],35,-1,50,-1,35
1,<environment.Job instance at 0x7f28c9dfa6e0>,35,17,[2 7],36,-1,53,-1,36
1,<environment.Job instance at 0x7f28c9dfa690>,36,17,[5 2],37,-1,54,-1,37
1,<environment.Job instance at 0x7f28c9dfa410>,37,18,[1 7],38,-1,56,-1,38
1,<environment.Job instance at 0x7f28c9dfab90>,40,22,[ 3 10],41,-1,63,-1,41
1,<environment.Job instance at 0x7f28ca016aa0>,42,13,[3 9],43,-1,56,-1,43
1,<environment.Job instance at 0x7f28ca016e60>,43,12,[5 8],44,-1,56,-1,44
1,<environment.Job instance at 0x7f28ca016280>,51,16,[5 4],52,-1,68,-1,52
1,<environment.Job instance at 0x7f28ca016550>,52,18,[2 9],53,-1,71,-1,53
1,<environment.Job instance at 0x7f28ca016050>,53,14,[3 7],54,-1,68,-1,54
1,<environment.Job instance at 0x7f28ca016af0>,55,13,[6 3],56,-1,69,-1,56
1,<environment.Job instance at 0x7f28ca4d7be0>,59,13,[3 8],60,-1,73,-1,60
1,<environment.Job instance at 0x7f28ca4d76e0>,61,18,[ 3 14],62,-1,290,-1,272
1,<environment.Job instance at 0x7f28c9d14d20>,91,14,[10  5],92,-1,290,-1,276
1,<environment.Job instance at 0x7f28c9d14870>,79,20,[5 5],80,-1,299,-1,279
1,<environment.Job instance at 0x7f28c9d146e0>,97,28,[8 2],98,-1,319,-1,291
1,<environment.Job instance at 0x7f28c9d14dc0>,95,15,[7 2],96,-1,306,-1,291
1,<environment.Job instance at 0x7f28c9d14eb0>,100,17,[14  5],101,-1,309,-1,292
1,<environment.Job instance at 0x7f28c9d14690>,96,13,[13  5],97,-1,305,-1,292
1,<environment.Job instance at 0x7f28d2e1e370>,101,14,[13  2],102,-1,306,-1,292
1,<environment.Job instance at 0x7f28c9d14b40>,98,15,[8 5],99,-1,307,-1,292
1,<environment.Job instance at 0x7f28d2e1e280>,102,16,[5 6],103,-1,325,-1,309
1,<environment.Job instance at 0x7f28d2e1eb90>,112,27,[8 4],113,-1,341,-1,314
1,<environment.Job instance at 0x7f28d2e1e1e0>,117,17,[1 5],118,-1,331,-1,314
1,<environment.Job instance at 0x7f28d2e1ea00>,118,18,[8 4],119,-1,332,-1,314
1,<environment.Job instance at 0x7f28c9d14410>,86,18,[1 8],87,-1,332,-1,314
1,<environment.Job instance at 0x7f28d2e1eeb0>,119,18,[2 5],120,-1,332,-1,314
1,<environment.Job instance at 0x7f28ca247320>,123,25,[ 4 10],124,-1,340,-1,315
1,<environment.Job instance at 0x7f28d2e1e820>,116,14,[8 5],117,-1,329,-1,315
1,<environment.Job instance at 0x7f28ca2470a0>,125,17,[11  2],126,-1,334,-1,317
1,<environment.Job instance at 0x7f28c97d8d70>,131,12,[9 4],132,-1,329,-1,317
1,<environment.Job instance at 0x7f28c97d8e60>,132,17,[4 5],133,-1,334,-1,317
1,<environment.Job instance at 0x7f28c93e80f0>,133,19,[8 5],134,-1,336,-1,317
1,<environment.Job instance at 0x7f28ca128c80>,139,22,[3 7],140,-1,342,-1,320
1,<environment.Job instance at 0x7f28c98dee60>,140,16,[6 4],141,-1,336,-1,320
1,<environment.Job instance at 0x7f28ca4d71e0>,63,18,[5 5],64,-1,338,-1,320
1,<environment.Job instance at 0x7f28d2e1ed70>,110,22,[9 5],111,-1,342,-1,320
1,<environment.Job instance at 0x7f28c8fe96e0>,142,12,[ 4 10],143,-1,334,-1,322
1,<environment.Job instance at 0x7f28c93e8640>,134,3,[4 7],135,-1,325,-1,322
1,<environment.Job instance at 0x7f28ca247370>,120,16,[5 2],121,-1,338,-1,322
1,<environment.Job instance at 0x7f28ca01b690>,149,2,[1 5],150,-1,324,-1,322
1,<environment.Job instance at 0x7f28ca01ba50>,150,21,[5 4],151,-1,343,-1,322
1,<environment.Job instance at 0x7f28d2ae2870>,152,18,[9 2],153,-1,342,-1,324
1,<environment.Job instance at 0x7f28c9dd2dc0>,154,17,[11  1],155,-1,341,-1,324
1,<environment.Job instance at 0x7f28c99c7550>,151,13,[6 3],152,-1,337,-1,324
1,<environment.Job instance at 0x7f28ca10c960>,156,16,[5 8],157,-1,340,-1,324
1,<environment.Job instance at 0x7f28c9b70be0>,146,20,[5 3],147,-1,344,-1,324
1,<environment.Job instance at 0x7f28ca4166e0>,148,12,[9 1],149,-1,336,-1,324
1,<environment.Job instance at 0x7f28c9dfa0a0>,38,26,[ 3 10],39,-1,350,-1,324
1,<environment.Job instance at 0x7f28c9222190>,129,21,[14  3],130,-1,345,-1,324
1,<environment.Job instance at 0x7f28ca4d78c0>,5,27,[5 8],6,-1,43,-1,16
1,<environment.Job instance at 0x7f28c9054b40>,7,25,[6 4],8,-1,41,-1,16
1,<environment.Job instance at 0x7f28c99e73c0>,10,14,[ 1 14],11,-1,31,-1,17
1,<environment.Job instance at 0x7f28c9a5ba00>,9,25,[10  1],10,-1,68,-1,43
1,<environment.Job instance at 0x7f28c9f3b690>,31,26,[5 4],32,-1,97,-1,71
1,<environment.Job instance at 0x7f28c9dfa4b0>,38,26,[ 3 10],39,-1,128,-1,102
1,<environment.Job instance at 0x7f28ca00a690>,57,3,[ 5 11],58,-1,147,-1,144
1,<environment.Job instance at 0x7f28c9abee10>,61,18,[ 3 14],62,-1,176,-1,158
1,<environment.Job instance at 0x7f28c9dcba00>,68,13,[14  3],69,-1,198,-1,185
1,<environment.Job instance at 0x7f28c9658230>,87,2,[13  4],88,-1,261,-1,259
1,<environment.Job instance at 0x7f28c96bd0f0>,96,13,[13  5],97,-1,304,-1,291
1,<environment.Job instance at 0x7f28c96bd050>,97,28,[8 2],98,-1,334,-1,306
1,<environment.Job instance at 0x7f28ca2ec690>,100,17,[14  5],101,-1,323,-1,306
1,<environment.Job instance at 0x7f28ca2ecd70>,101,14,[13  2],102,-1,320,-1,306
1,<environment.Job instance at 0x7f28c97ff550>,112,27,[8 4],113,-1,364,-1,337
1,<environment.Job instance at 0x7f28c92ada00>,122,1,[ 1 13],123,-1,368,-1,367
1,<environment.Job instance at 0x7f28ca0f9f50>,123,25,[ 4 10],124,-1,399,-1,374
1,<environment.Job instance at 0x7f28c92ad280>,125,17,[11  2],126,-1,391,-1,374
1,<environment.Job instance at 0x7f28c903eb90>,129,21,[14  3],130,-1,399,-1,378
1,<environment.Job instance at 0x7f28c91c8cd0>,147,1,[ 2 11],148,-1,418,-1,417
1,<environment.Job instance at 0x7f28c90a13c0>,154,17,[11  1],155,-1,467,-1,450
1,<environment.Job instance at 0x7f28c963de60>,0,17,[10  5],1,-1,19,-1,2
1,<environment.Job instance at 0x7f28c963d960>,3,14,[8 3],4,-1,19,-1,5
1,<environment.Job instance at 0x7f28c963d690>,4,13,[10  2],5,-1,18,-1,5
1,<environment.Job instance at 0x7f28c9905870>,5,17,[9 4],6,-1,23,-1,6
1,<environment.Job instance at 0x7f28c973f3c0>,6,16,[10  4],7,-1,25,-1,9
1,<environment.Job instance at 0x7f28c9226f00>,11,12,[3 5],12,-1,24,-1,12
1,<environment.Job instance at 0x7f28c92261e0>,12,18,[3 6],13,-1,31,-1,13
1,<environment.Job instance at 0x7f28c9226550>,13,16,[5 8],14,-1,30,-1,14
1,<environment.Job instance at 0x7f28ca21bc80>,18,18,[2 8],19,-1,37,-1,19
1,<environment.Job instance at 0x7f28ca0db5a0>,20,15,[5 9],21,-1,36,-1,21
1,<environment.Job instance at 0x7f28c90bd460>,21,18,[8 4],22,-1,40,-1,22
1,<environment.Job instance at 0x7f28c90bd0f0>,22,17,[5 3],23,-1,40,-1,23
1,<environment.Job instance at 0x7f28c90bdd20>,23,18,[4 6],24,-1,42,-1,24
1,<environment.Job instance at 0x7f28ca1b5460>,26,16,[7 4],27,-1,43,-1,27
1,<environment.Job instance at 0x7f28ca1b5910>,30,16,[7 5],31,-1,47,-1,31
1,<environment.Job instance at 0x7f28c9132a50>,35,28,[5 5],36,-1,64,-1,36
1,<environment.Job instance at 0x7f28c8d23e60>,36,15,[6 4],37,-1,52,-1,37
1,<environment.Job instance at 0x7f28c8d23c80>,38,14,[3 7],39,-1,53,-1,39
1,<environment.Job instance at 0x7f28c8d23fa0>,41,21,[4 8],42,-1,63,-1,42
1,<environment.Job instance at 0x7f28c8d23140>,42,14,[1 7],43,-1,57,-1,43
1,<environment.Job instance at 0x7f28c8d23c30>,43,16,[10  5],44,-1,60,-1,44
1,<environment.Job instance at 0x7f28c9dbf7d0>,8,14,[10  3],9,-1,62,-1,48
1,<environment.Job instance at 0x7f28c91955a0>,53,13,[10  4],54,-1,71,-1,58
1,<environment.Job instance at 0x7f28c9195aa0>,58,22,[4 8],59,-1,81,-1,59
1,<environment.Job instance at 0x7f28c9195af0>,60,28,[4 7],61,-1,89,-1,61
1,<environment.Job instance at 0x7f28c9b9f320>,72,16,[10  5],73,-1,90,-1,74
1,<environment.Job instance at 0x7f28d2aed0a0>,64,14,[ 1 10],65,-1,88,-1,74
1,<environment.Job instance at 0x7f28c94f60f0>,63,14,[ 3 11],64,-1,90,-1,76
1,<environment.Job instance at 0x7f28c92d3fa0>,75,15,[10  3],76,-1,91,-1,76
1,<environment.Job instance at 0x7f28c94eab90>,77,17,[ 4 14],78,-1,95,-1,78
1,<environment.Job instance at 0x7f28c9195a00>,59,16,[ 4 11],60,-1,97,-1,81
1,<environment.Job instance at 0x7f28c9b70a00>,79,17,[6 4],80,-1,98,-1,81
1,<environment.Job instance at 0x7f28c9195730>,57,12,[8 1],58,-1,93,-1,81
1,<environment.Job instance at 0x7f28c96e94b0>,78,18,[2 9],79,-1,101,-1,83
1,<environment.Job instance at 0x7f28c9cb3e60>,71,15,[4 5],72,-1,98,-1,83
1,<environment.Job instance at 0x7f28c96e96e0>,80,14,[3 9],81,-1,97,-1,83
1,<environment.Job instance at 0x7f28c8fff7d0>,86,16,[7 1],87,-1,103,-1,87
1,<environment.Job instance at 0x7f28c8fff730>,87,13,[5 5],88,-1,101,-1,88
1,<environment.Job instance at 0x7f28c96e9e60>,82,2,[1 7],83,-1,91,-1,89
1,<environment.Job instance at 0x7f28c8fff910>,88,17,[ 1 10],89,-1,106,-1,89
1,<environment.Job instance at 0x7f28c8fff780>,89,15,[7 2],90,-1,105,-1,90
1,<environment.Job instance at 0x7f28ca3076e0>,95,16,[5 2],96,-1,112,-1,96
1,<environment.Job instance at 0x7f28ca018230>,101,16,[6 5],102,-1,118,-1,102
1,<environment.Job instance at 0x7f28ca018410>,104,17,[4 9],105,-1,122,-1,105
1,<environment.Job instance at 0x7f28c8da0410>,105,17,[ 5 10],106,-1,125,-1,108
1,<environment.Job instance at 0x7f28c9490fa0>,109,18,[9 4],110,-1,129,-1,111
1,<environment.Job instance at 0x7f28c8bbdc30>,114,17,[5 2],115,-1,132,-1,115
1,<environment.Job instance at 0x7f28c96e9b90>,81,16,[ 4 10],82,-1,132,-1,116
1,<environment.Job instance at 0x7f28c8bbd4b0>,117,1,[9 4],118,-1,126,-1,125
1,<environment.Job instance at 0x7f28ca3eca50>,123,17,[9 1],124,-1,142,-1,125
1,<environment.Job instance at 0x7f28c9b6caa0>,119,16,[4 9],120,-1,141,-1,125
1,<environment.Job instance at 0x7f28ca3ec640>,124,13,[10  1],125,-1,139,-1,126
1,<environment.Job instance at 0x7f28c98d3a00>,127,18,[7 5],128,-1,146,-1,128
1,<environment.Job instance at 0x7f28c97e2410>,129,18,[ 3 10],130,-1,148,-1,130
1,<environment.Job instance at 0x7f28c92d6c30>,131,18,[5 9],132,-1,152,-1,134
1,<environment.Job instance at 0x7f28c9c29230>,133,17,[8 4],134,-1,151,-1,134
1,<environment.Job instance at 0x7f28c9ef18c0>,135,18,[9 4],136,-1,154,-1,136
1,<environment.Job instance at 0x7f28c9b6cd20>,120,12,[3 8],121,-1,152,-1,140
1,<environment.Job instance at 0x7f28c9ef19b0>,139,17,[7 1],140,-1,157,-1,140
1,<environment.Job instance at 0x7f28ca0ff230>,140,15,[8 3],141,-1,156,-1,141
1,<environment.Job instance at 0x7f28c8bc8410>,111,16,[14  3],112,-1,160,-1,144
1,<environment.Job instance at 0x7f28c8d4cf50>,146,12,[10  1],147,-1,160,-1,148
1,<environment.Job instance at 0x7f28c973f8c0>,132,14,[9 2],133,-1,163,-1,149
1,<environment.Job instance at 0x7f28c9721050>,149,16,[10  3],150,-1,168,-1,152
1,<environment.Job instance at 0x7f28c9ae0550>,152,24,[8 2],153,-1,178,-1,154
1,<environment.Job instance at 0x7f28c9ae0780>,154,15,[4 9],155,-1,170,-1,155
1,<environment.Job instance at 0x7f28c96c0690>,151,20,[5 3],152,-1,177,-1,157
1,<environment.Job instance at 0x7f28ca087dc0>,156,14,[5 9],157,-1,172,-1,158
1,<environment.Job instance at 0x7f28c9386b90>,7,3,[ 5 11],8,-1,21,-1,18
1,<environment.Job instance at 0x7f28c9b92690>,24,12,[13  3],25,-1,108,-1,96
1,<environment.Job instance at 0x7f28c90a1370>,35,28,[5 5],36,-1,163,-1,135
1,<environment.Job instance at 0x7f28c9f15e10>,40,12,[ 4 14],41,-1,161,-1,149
1,<environment.Job instance at 0x7f28c92ad7d0>,48,1,[ 1 11],49,-1,180,-1,179
1,<environment.Job instance at 0x7f28c96bda00>,59,16,[ 4 11],60,-1,216,-1,200
1,<environment.Job instance at 0x7f28c96bd870>,60,28,[4 7],61,-1,229,-1,201
1,<environment.Job instance at 0x7f28ca2ecaa0>,61,15,[ 5 14],62,-1,216,-1,201
1,<environment.Job instance at 0x7f28c9222820>,63,14,[ 3 11],64,-1,215,-1,201
1,<environment.Job instance at 0x7f28c8b85be0>,77,17,[ 4 14],78,-1,275,-1,258
1,<environment.Job instance at 0x7f28ca12f910>,111,16,[14  3],112,-1,394,-1,378
1,<environment.Job instance at 0x7f28ca47d4b0>,112,3,[ 1 14],113,-1,381,-1,378
1,<environment.Job instance at 0x7f28d2f5e910>,126,3,[ 5 11],127,-1,427,-1,424
1,<environment.Job instance at 0x7f28ca00c5a0>,134,24,[8 1],135,-1,510,-1,486
1,<environment.Job instance at 0x7f28ca00c370>,136,25,[6 2],137,-1,511,-1,486
1,<environment.Job instance at 0x7f28c8ee9230>,152,24,[8 2],153,-1,577,-1,553
1,<environment.Job instance at 0x7f28c8ee97d0>,157,12,[13  5],158,-1,567,-1,555
1,<environment.Job instance at 0x7f28c9e5d910>,7,12,[7 5],8,-1,20,-1,8
1,<environment.Job instance at 0x7f28c9e5d1e0>,9,25,[1 7],10,-1,35,-1,10
1,<environment.Job instance at 0x7f28c96d85f0>,11,16,[5 9],12,-1,28,-1,12
1,<environment.Job instance at 0x7f28c981c910>,12,17,[7 4],13,-1,30,-1,13
1,<environment.Job instance at 0x7f28c9e33500>,13,14,[2 7],14,-1,28,-1,14
1,<environment.Job instance at 0x7f28c9e43910>,16,17,[10  4],17,-1,34,-1,17
1,<environment.Job instance at 0x7f28c9e439b0>,17,14,[7 2],18,-1,32,-1,18
1,<environment.Job instance at 0x7f28c9e435f0>,18,14,[ 5 11],19,-1,33,-1,19
1,<environment.Job instance at 0x7f28c9e43320>,19,17,[1 7],20,-1,37,-1,20
1,<environment.Job instance at 0x7f28c9e43b90>,20,14,[2 6],21,-1,35,-1,21
1,<environment.Job instance at 0x7f28c9c02690>,22,18,[ 1 10],23,-1,41,-1,23
1,<environment.Job instance at 0x7f28ca4f7550>,23,15,[1 5],24,-1,40,-1,25
1,<environment.Job instance at 0x7f28c9e63190>,25,18,[6 1],26,-1,44,-1,26
1,<environment.Job instance at 0x7f28c9e32aa0>,26,15,[4 7],27,-1,42,-1,27
1,<environment.Job instance at 0x7f28c8d78370>,28,17,[9 3],29,-1,46,-1,29
1,<environment.Job instance at 0x7f28c8d8b5a0>,29,2,[2 5],30,-1,32,-1,30
1,<environment.Job instance at 0x7f28c8d8b0f0>,30,14,[10  1],31,-1,45,-1,31
1,<environment.Job instance at 0x7f28c8d72820>,33,15,[7 2],34,-1,55,-1,40
1,<environment.Job instance at 0x7f28c8d7b190>,36,13,[4 6],37,-1,53,-1,40
1,<environment.Job instance at 0x7f28c8d78730>,32,18,[10  1],33,-1,58,-1,40
1,<environment.Job instance at 0x7f28c8d7b050>,37,18,[6 1],38,-1,61,-1,43
1,<environment.Job instance at 0x7f28c8d7be60>,42,15,[4 7],43,-1,58,-1,43
1,<environment.Job instance at 0x7f28c8d7b960>,43,14,[9 2],44,-1,58,-1,44
1,<environment.Job instance at 0x7f28c8d7e0a0>,46,16,[1 9],47,-1,63,-1,47
1,<environment.Job instance at 0x7f28c9e2f550>,51,18,[4 6],52,-1,70,-1,52
1,<environment.Job instance at 0x7f28c9e2fe60>,50,13,[4 7],51,-1,67,-1,54
1,<environment.Job instance at 0x7f28c8d55aa0>,54,14,[1 7],55,-1,70,-1,56
1,<environment.Job instance at 0x7f28c9bedf00>,55,13,[10  4],56,-1,69,-1,56
1,<environment.Job instance at 0x7f28c8d55b40>,56,19,[5 4],57,-1,76,-1,57
1,<environment.Job instance at 0x7f28c9e3ba00>,57,17,[1 8],58,-1,75,-1,58
1,<environment.Job instance at 0x7f28c9c0e910>,58,18,[4 6],59,-1,77,-1,59
1,<environment.Job instance at 0x7f28c8d71e10>,59,13,[8 2],60,-1,77,-1,64
1,<environment.Job instance at 0x7f28ca4ee370>,64,15,[9 3],65,-1,80,-1,65
1,<environment.Job instance at 0x7f28c8d71f50>,63,18,[10  1],64,-1,88,-1,70
1,<environment.Job instance at 0x7f28c9e4c280>,66,17,[ 2 10],67,-1,87,-1,70
1,<environment.Job instance at 0x7f28c8d850a0>,72,15,[ 2 12],73,-1,89,-1,74
1,<environment.Job instance at 0x7f28c9c06d70>,70,2,[5 6],71,-1,76,-1,74
1,<environment.Job instance at 0x7f28c9c06280>,71,16,[9 3],72,-1,90,-1,74
1,<environment.Job instance at 0x7f28c8d85320>,74,14,[5 8],75,-1,89,-1,75
1,<environment.Job instance at 0x7f28c8d85280>,76,17,[11  2],77,-1,94,-1,77
1,<environment.Job instance at 0x7f28c8d7b780>,41,12,[ 5 10],42,-1,94,-1,82
1,<environment.Job instance at 0x7f28c8d853c0>,75,13,[7 3],76,-1,95,-1,82
1,<environment.Job instance at 0x7f28c8d857d0>,81,15,[7 4],82,-1,97,-1,82
1,<environment.Job instance at 0x7f28c8d85780>,79,23,[9 3],80,-1,105,-1,82
1,<environment.Job instance at 0x7f28c8d85910>,82,16,[7 2],83,-1,102,-1,86
1,<environment.Job instance at 0x7f28c8d85c30>,87,18,[2 7],88,-1,106,-1,88
1,<environment.Job instance at 0x7f28c9dd7eb0>,90,22,[9 3],91,-1,115,-1,93
1,<environment.Job instance at 0x7f28c9dd7820>,94,15,[7 5],95,-1,111,-1,96
1,<environment.Job instance at 0x7f28c9dd7a50>,92,12,[ 4 14],93,-1,119,-1,107
1,<environment.Job instance at 0x7f28c9dd79b0>,97,22,[7 3],98,-1,133,-1,111
1,<environment.Job instance at 0x7f28c9dd7c80>,91,28,[1 5],92,-1,142,-1,114
1,<environment.Job instance at 0x7f28c9dd7370>,99,14,[6 4],100,-1,130,-1,116
1,<environment.Job instance at 0x7f28c9dd7af0>,101,14,[5 5],102,-1,130,-1,116
1,<environment.Job instance at 0x7f28c9dd7960>,103,15,[3 8],104,-1,131,-1,116
1,<environment.Job instance at 0x7f28c9dd78c0>,106,18,[12  4],107,-1,134,-1,116
1,<environment.Job instance at 0x7f28c9dd7cd0>,100,18,[1 7],101,-1,139,-1,121
1,<environment.Job instance at 0x7f28c9dd77d0>,109,18,[5 9],110,-1,139,-1,121
1,<environment.Job instance at 0x7f28c9dd7730>,110,18,[4 5],111,-1,139,-1,121
1,<environment.Job instance at 0x7f28c9dd7f50>,96,14,[11  1],97,-1,135,-1,121
1,<environment.Job instance at 0x7f28c9dd70f0>,108,14,[5 9],109,-1,135,-1,121
1,<environment.Job instance at 0x7f28c9dad4b0>,114,17,[7 2],115,-1,138,-1,121
1,<environment.Job instance at 0x7f28c9dd7d20>,105,3,[14  3],106,-1,124,-1,121
1,<environment.Job instance at 0x7f28c9dad5a0>,116,16,[ 1 12],117,-1,137,-1,121
1,<environment.Job instance at 0x7f28c9dad8c0>,117,16,[6 5],118,-1,137,-1,121
1,<environment.Job instance at 0x7f28c9dad0a0>,111,27,[6 5],112,-1,148,-1,121
1,<environment.Job instance at 0x7f28c9dad870>,118,25,[10  1],119,-1,146,-1,121
1,<environment.Job instance at 0x7f28c9dad960>,120,2,[ 2 10],121,-1,123,-1,121
1,<environment.Job instance at 0x7f28c9dadaa0>,121,15,[10  3],122,-1,138,-1,123
1,<environment.Job instance at 0x7f28c9dadd20>,122,12,[8 1],123,-1,135,-1,123
1,<environment.Job instance at 0x7f28c9bfa960>,34,27,[1 7],35,-1,155,-1,128
1,<environment.Job instance at 0x7f28c9dadf50>,125,16,[1 9],126,-1,144,-1,128
1,<environment.Job instance at 0x7f28c9e5daa0>,2,2,[ 1 12],3,-1,5,-1,3
1,<environment.Job instance at 0x7f28c8d7b2d0>,9,25,[1 7],10,-1,39,-1,14
1,<environment.Job instance at 0x7f28c9dade60>,18,14,[ 5 11],19,-1,55,-1,41
1,<environment.Job instance at 0x7f28c8ee9be0>,34,27,[1 7],35,-1,149,-1,122
1,<environment.Job instance at 0x7f28c8d230f0>,65,16,[ 5 13],66,-1,273,-1,257
1,<environment.Job instance at 0x7f28c8d23820>,69,16,[ 1 13],70,-1,291,-1,275
1,<environment.Job instance at 0x7f28ca016460>,72,15,[ 2 12],73,-1,293,-1,278
1,<environment.Job instance at 0x7f28ca016fa0>,76,17,[11  2],77,-1,311,-1,294
1,<environment.Job instance at 0x7f28c8dd7410>,79,23,[9 3],80,-1,333,-1,310
1,<environment.Job instance at 0x7f28c9f3b730>,88,12,[ 1 13],89,-1,343,-1,331
1,<environment.Job instance at 0x7f28ca0fa820>,92,12,[ 4 14],93,-1,361,-1,349
1,<environment.Job instance at 0x7f28ca35e6e0>,91,28,[1 5],92,-1,377,-1,349
1,<environment.Job instance at 0x7f28c92260f0>,96,14,[11  1],97,-1,363,-1,349
1,<environment.Job instance at 0x7f28c91f2960>,104,2,[14  4],105,-1,383,-1,381
1,<environment.Job instance at 0x7f28d2af8be0>,105,3,[14  3],106,-1,384,-1,381
1,<environment.Job instance at 0x7f28c9e4ea50>,106,18,[12  4],107,-1,399,-1,381
1,<environment.Job instance at 0x7f28c9e4e190>,107,3,[ 4 13],108,-1,384,-1,381
1,<environment.Job instance at 0x7f28c9140e10>,113,3,[ 1 13],114,-1,413,-1,410
1,<environment.Job instance at 0x7f28c8bad140>,111,27,[6 5],112,-1,455,-1,428
1,<environment.Job instance at 0x7f28c9222870>,116,16,[ 1 12],117,-1,444,-1,428
1,<environment.Job instance at 0x7f28c96bd870>,119,23,[4 9],120,-1,455,-1,432
1,<environment.Job instance at 0x7f28c96bda00>,118,25,[10  1],119,-1,480,-1,455
1,<environment.Job instance at 0x7f28ca0db460>,127,25,[1 9],128,-1,495,-1,470
1,<environment.Job instance at 0x7f28ca0f9c80>,131,28,[6 2],132,-1,499,-1,471
1,<environment.Job instance at 0x7f28ca0f91e0>,129,27,[9 3],130,-1,498,-1,471
1,<environment.Job instance at 0x7f28c8da00f0>,153,1,[ 4 14],154,-1,519,-1,518
1,<environment.Job instance at 0x7f28ca0bd500>,6,15,[9 4],7,-1,23,-1,8
1,<environment.Job instance at 0x7f28c970f910>,7,18,[5 9],8,-1,26,-1,8
1,<environment.Job instance at 0x7f28ca0bdcd0>,8,25,[3 6],9,-1,34,-1,9
1,<environment.Job instance at 0x7f28c9f512d0>,10,17,[8 5],11,-1,28,-1,11
1,<environment.Job instance at 0x7f28c9f51500>,12,13,[3 8],13,-1,27,-1,14
1,<environment.Job instance at 0x7f28c9f51b90>,15,14,[7 2],16,-1,30,-1,16
1,<environment.Job instance at 0x7f28ca0bd870>,13,12,[5 7],14,-1,28,-1,16
1,<environment.Job instance at 0x7f28c99c1c30>,17,16,[2 5],18,-1,34,-1,18
1,<environment.Job instance at 0x7f28c9b6c460>,22,20,[3 6],23,-1,43,-1,23
1,<environment.Job instance at 0x7f28c9f511e0>,23,17,[10  4],24,-1,41,-1,24
1,<environment.Job instance at 0x7f28ca1adf00>,26,21,[10  4],27,-1,48,-1,27
1,<environment.Job instance at 0x7f28c991a1e0>,30,16,[10  1],31,-1,47,-1,31
1,<environment.Job instance at 0x7f28c97e0870>,31,18,[3 7],32,-1,50,-1,32
1,<environment.Job instance at 0x7f28c8e2dd20>,37,24,[9 5],38,-1,62,-1,38
1,<environment.Job instance at 0x7f28c8cddd20>,38,17,[7 2],39,-1,56,-1,39
1,<environment.Job instance at 0x7f28c8cddfa0>,39,15,[8 4],40,-1,56,-1,41
1,<environment.Job instance at 0x7f28c8e0f190>,41,15,[5 5],42,-1,57,-1,42
1,<environment.Job instance at 0x7f28ca53cd20>,47,14,[3 8],48,-1,62,-1,48
1,<environment.Job instance at 0x7f28ca48a050>,61,20,[5 5],62,-1,85,-1,65
1,<environment.Job instance at 0x7f28ca48a140>,63,22,[2 8],64,-1,87,-1,65
1,<environment.Job instance at 0x7f28c934c780>,44,17,[7 2],45,-1,82,-1,65
1,<environment.Job instance at 0x7f28ca48a0a0>,64,14,[2 5],65,-1,79,-1,65
1,<environment.Job instance at 0x7f28ca285cd0>,67,18,[3 6],68,-1,86,-1,68
1,<environment.Job instance at 0x7f28ca50cf00>,72,20,[ 1 10],73,-1,98,-1,78
1,<environment.Job instance at 0x7f28ca50c4b0>,73,17,[6 1],74,-1,97,-1,80
1,<environment.Job instance at 0x7f28c99c1820>,21,13,[ 4 11],22,-1,94,-1,81
1,<environment.Job instance at 0x7f28ca521a50>,80,12,[9 1],81,-1,93,-1,81
1,<environment.Job instance at 0x7f28c96b8140>,78,17,[ 3 13],79,-1,98,-1,81
1,<environment.Job instance at 0x7f28c991b460>,49,16,[13  2],50,-1,99,-1,83
1,<environment.Job instance at 0x7f28ca3ea5f0>,76,16,[ 2 10],77,-1,99,-1,83
1,<environment.Job instance at 0x7f28ca521d70>,82,21,[9 2],83,-1,104,-1,83
1,<environment.Job instance at 0x7f28c96bca00>,75,13,[13  1],76,-1,98,-1,85
1,<environment.Job instance at 0x7f28c99724b0>,84,18,[2 6],85,-1,103,-1,85
1,<environment.Job instance at 0x7f28c8c89230>,86,17,[3 9],87,-1,106,-1,89
1,<environment.Job instance at 0x7f28c983f5f0>,91,19,[6 5],92,-1,111,-1,92
1,<environment.Job instance at 0x7f28c983fcd0>,92,25,[3 6],93,-1,118,-1,93
1,<environment.Job instance at 0x7f28c8c5f6e0>,88,17,[2 8],89,-1,114,-1,97
1,<environment.Job instance at 0x7f28c983f780>,95,16,[4 8],96,-1,119,-1,103
1,<environment.Job instance at 0x7f28c8c896e0>,85,13,[ 4 14],86,-1,127,-1,114
1,<environment.Job instance at 0x7f28d2af8f50>,110,16,[ 4 10],111,-1,131,-1,115
1,<environment.Job instance at 0x7f28ca2b2d70>,107,16,[8 2],108,-1,131,-1,115
1,<environment.Job instance at 0x7f28ca11b190>,112,18,[ 5 10],113,-1,133,-1,115
1,<environment.Job instance at 0x7f28ca11bfa0>,111,13,[8 5],112,-1,136,-1,123
1,<environment.Job instance at 0x7f28ca2ec730>,121,16,[ 5 10],122,-1,139,-1,123
1,<environment.Job instance at 0x7f28c97cd780>,127,18,[ 3 12],128,-1,151,-1,133
1,<environment.Job instance at 0x7f28c97cd230>,125,21,[3 8],126,-1,157,-1,136
1,<environment.Job instance at 0x7f28ca2ec5a0>,122,15,[9 1],123,-1,159,-1,144
1,<environment.Job instance at 0x7f28ca018780>,113,17,[13  3],114,-1,266,-1,249
1,<environment.Job instance at 0x7f28c9cb3d20>,142,15,[5 7],143,-1,264,-1,249
1,<environment.Job instance at 0x7f28c9753280>,151,15,[4 5],152,-1,287,-1,272
1,<environment.Job instance at 0x7f28c9b92b40>,149,18,[4 5],150,-1,291,-1,273
1,<environment.Job instance at 0x7f28c9753320>,152,15,[4 8],153,-1,291,-1,276
1,<environment.Job instance at 0x7f28d2aed1e0>,147,16,[6 1],148,-1,293,-1,277
1,<environment.Job instance at 0x7f28c9753d20>,154,18,[ 3 10],155,-1,296,-1,278
1,<environment.Job instance at 0x7f28c9753af0>,158,16,[10  5],159,-1,298,-1,282
1,<environment.Job instance at 0x7f28c9972af0>,3,12,[ 1 14],4,-1,16,-1,4
1,<environment.Job instance at 0x7f28c9cb3af0>,8,25,[3 6],9,-1,34,-1,9
1,<environment.Job instance at 0x7f28d2c81eb0>,21,13,[ 4 11],22,-1,63,-1,50
1,<environment.Job instance at 0x7f28c9dd72d0>,29,15,[14  4],30,-1,82,-1,67
1,<environment.Job instance at 0x7f28c8d85460>,37,24,[9 5],38,-1,126,-1,102
1,<environment.Job instance at 0x7f28c9cf1550>,46,1,[12  5],47,-1,135,-1,134
1,<environment.Job instance at 0x7f28c93e80a0>,49,16,[13  2],50,-1,165,-1,149
1,<environment.Job instance at 0x7f28d2a78280>,75,13,[13  1],76,-1,220,-1,207
1,<environment.Job instance at 0x7f28c9458e10>,78,17,[ 3 13],79,-1,228,-1,211
1,<environment.Job instance at 0x7f28c9baec80>,85,13,[ 4 14],86,-1,245,-1,232
1,<environment.Job instance at 0x7f28c8e41dc0>,92,25,[3 6],93,-1,290,-1,265
1,<environment.Job instance at 0x7f28c98d30a0>,98,3,[ 1 13],99,-1,305,-1,302
1,<environment.Job instance at 0x7f28c8badf50>,113,17,[13  3],114,-1,340,-1,323
1,<environment.Job instance at 0x7f28c8ef4050>,117,13,[12  4],118,-1,347,-1,334
1,<environment.Job instance at 0x7f28ca054500>,127,18,[ 3 12],128,-1,396,-1,378
1,<environment.Job instance at 0x7f28c9b6c280>,141,16,[ 1 11],142,-1,459,-1,443
1,<environment.Job instance at 0x7f28c9bb44b0>,153,18,[12  1],154,-1,519,-1,501
1,<environment.Job instance at 0x7f28c9b6cfa0>,0,13,[10  5],1,-1,17,-1,4
1,<environment.Job instance at 0x7f28c954b780>,4,3,[5 8],5,-1,8,-1,5
1,<environment.Job instance at 0x7f28c969f820>,2,26,[8 2],3,-1,31,-1,5
1,<environment.Job instance at 0x7f28c954baa0>,5,18,[10  1],6,-1,25,-1,7
1,<environment.Job instance at 0x7f28ca210050>,7,13,[8 1],8,-1,21,-1,8
1,<environment.Job instance at 0x7f28ca210820>,8,2,[7 1],9,-1,11,-1,9
1,<environment.Job instance at 0x7f28ca210b40>,9,1,[4 9],10,-1,11,-1,10
1,<environment.Job instance at 0x7f28ca2109b0>,10,21,[5 7],11,-1,32,-1,11
1,<environment.Job instance at 0x7f28ca210fa0>,11,3,[8 3],12,-1,15,-1,12
1,<environment.Job instance at 0x7f28c92d6280>,12,17,[5 3],13,-1,30,-1,13
1,<environment.Job instance at 0x7f28c92d62d0>,13,1,[1 8],14,-1,15,-1,14
1,<environment.Job instance at 0x7f28c92d6550>,14,1,[8 4],15,-1,16,-1,15
1,<environment.Job instance at 0x7f28c92d6870>,15,3,[1 5],16,-1,19,-1,16
1,<environment.Job instance at 0x7f28c92d6640>,16,3,[1 9],17,-1,20,-1,17
1,<environment.Job instance at 0x7f28c954bcd0>,6,27,[5 8],7,-1,44,-1,17
1,<environment.Job instance at 0x7f28c92d6f00>,18,16,[2 8],19,-1,36,-1,20
1,<environment.Job instance at 0x7f28c9fffdc0>,23,26,[7 3],24,-1,50,-1,24
1,<environment.Job instance at 0x7f28c9e9e1e0>,24,18,[5 8],25,-1,43,-1,25
1,<environment.Job instance at 0x7f28c9d5e050>,25,15,[3 7],26,-1,41,-1,26
1,<environment.Job instance at 0x7f28c9c96a50>,26,17,[5 7],27,-1,44,-1,27
1,<environment.Job instance at 0x7f28c9c96dc0>,27,14,[ 4 10],28,-1,42,-1,28
1,<environment.Job instance at 0x7f28c8df3af0>,29,16,[3 7],30,-1,46,-1,30
1,<environment.Job instance at 0x7f28c9d524b0>,32,13,[4 9],33,-1,46,-1,33
1,<environment.Job instance at 0x7f28c99ad550>,37,24,[9 3],38,-1,62,-1,38
1,<environment.Job instance at 0x7f28c9f47690>,39,15,[10  1],40,-1,55,-1,40
1,<environment.Job instance at 0x7f28c9f47960>,40,18,[8 5],41,-1,64,-1,46
1,<environment.Job instance at 0x7f28c9025730>,43,15,[3 5],44,-1,61,-1,46
1,<environment.Job instance at 0x7f28c9025910>,45,12,[5 5],46,-1,58,-1,46
1,<environment.Job instance at 0x7f28c9025fa0>,46,25,[10  1],47,-1,74,-1,49
1,<environment.Job instance at 0x7f28c8bd9320>,52,14,[6 4],53,-1,69,-1,55
1,<environment.Job instance at 0x7f28c8d25c30>,55,20,[5 6],56,-1,76,-1,56
1,<environment.Job instance at 0x7f28c8bd9460>,53,27,[4 5],54,-1,83,-1,56
1,<environment.Job instance at 0x7f28c8d25280>,58,12,[4 6],59,-1,71,-1,59
1,<environment.Job instance at 0x7f28c9025230>,42,14,[8 4],43,-1,74,-1,60
1,<environment.Job instance at 0x7f28c8d252d0>,56,17,[2 5],57,-1,77,-1,60
1,<environment.Job instance at 0x7f28c8d25230>,60,13,[5 7],61,-1,74,-1,61
1,<environment.Job instance at 0x7f28c9ab1960>,61,17,[ 5 10],62,-1,79,-1,62
1,<environment.Job instance at 0x7f28c9ab1730>,62,17,[6 5],63,-1,80,-1,63
1,<environment.Job instance at 0x7f28c9ab1870>,63,14,[1 7],64,-1,78,-1,64
1,<environment.Job instance at 0x7f28c9ab1320>,64,16,[ 2 11],65,-1,85,-1,69
1,<environment.Job instance at 0x7f28c9f9f370>,70,16,[4 9],71,-1,87,-1,71
1,<environment.Job instance at 0x7f28c9ab1c80>,67,17,[4 5],68,-1,92,-1,75
1,<environment.Job instance at 0x7f28c9ab1500>,66,19,[5 9],67,-1,94,-1,75
1,<environment.Job instance at 0x7f28c9580640>,73,14,[7 2],74,-1,89,-1,75
1,<environment.Job instance at 0x7f28c95800f0>,75,2,[5 9],76,-1,78,-1,76
1,<environment.Job instance at 0x7f28c9580c80>,76,15,[2 9],77,-1,92,-1,77
1,<environment.Job instance at 0x7f28c95804b0>,74,13,[9 2],75,-1,90,-1,77
1,<environment.Job instance at 0x7f28c9580780>,77,17,[3 8],78,-1,95,-1,78
1,<environment.Job instance at 0x7f28c9edf550>,78,18,[5 5],79,-1,97,-1,79
1,<environment.Job instance at 0x7f28c9edfb90>,80,2,[5 5],81,-1,84,-1,82
1,<environment.Job instance at 0x7f28c9edf7d0>,82,18,[5 7],83,-1,101,-1,83
1,<environment.Job instance at 0x7f28c9edffa0>,83,20,[2 6],84,-1,104,-1,84
1,<environment.Job instance at 0x7f28c9edf820>,84,13,[5 9],85,-1,98,-1,85
1,<environment.Job instance at 0x7f28c9edfa00>,86,15,[8 4],87,-1,102,-1,87
1,<environment.Job instance at 0x7f28ca24d9b0>,88,18,[5 3],89,-1,107,-1,89
1,<environment.Job instance at 0x7f28ca24d7d0>,89,18,[8 4],90,-1,108,-1,90
1,<environment.Job instance at 0x7f28ca2b2500>,90,15,[1 8],91,-1,106,-1,91
1,<environment.Job instance at 0x7f28c9775870>,91,28,[7 5],92,-1,120,-1,92
1,<environment.Job instance at 0x7f28c8ce2230>,93,15,[10  2],94,-1,111,-1,96
1,<environment.Job instance at 0x7f28c9226870>,95,17,[2 9],96,-1,113,-1,96
1,<environment.Job instance at 0x7f28c902b5f0>,99,18,[4 6],100,-1,118,-1,100
1,<environment.Job instance at 0x7f28d2b412d0>,102,17,[9 3],103,-1,120,-1,103
1,<environment.Job instance at 0x7f28c9914f50>,97,14,[3 8],98,-1,119,-1,105
1,<environment.Job instance at 0x7f28ca00d230>,104,14,[2 9],105,-1,121,-1,107
1,<environment.Job instance at 0x7f28c9000730>,107,15,[10  2],108,-1,123,-1,108
1,<environment.Job instance at 0x7f28d2ae02d0>,108,1,[10  2],109,-1,110,-1,109
1,<environment.Job instance at 0x7f28d2ae0e60>,109,16,[ 2 10],110,-1,126,-1,110
1,<environment.Job instance at 0x7f28c9585320>,106,18,[9 5],107,-1,128,-1,110
1,<environment.Job instance at 0x7f28ca1ad190>,111,14,[10  4],112,-1,133,-1,119
1,<environment.Job instance at 0x7f28c8cb4820>,123,17,[ 4 10],124,-1,141,-1,124
1,<environment.Job instance at 0x7f28c9edfe10>,79,16,[13  5],80,-1,140,-1,124
1,<environment.Job instance at 0x7f28c9ae00a0>,126,16,[ 1 10],127,-1,143,-1,127
1,<environment.Job instance at 0x7f28c9721b90>,127,18,[ 3 11],128,-1,146,-1,128
1,<environment.Job instance at 0x7f28c9fb08c0>,119,13,[3 6],120,-1,142,-1,129
1,<environment.Job instance at 0x7f28c99c55f0>,130,18,[7 5],131,-1,149,-1,131
1,<environment.Job instance at 0x7f28c99c5370>,131,16,[5 5],132,-1,148,-1,132
1,<environment.Job instance at 0x7f28c99c5870>,132,13,[5 5],133,-1,148,-1,135
1,<environment.Job instance at 0x7f28ca3ec370>,135,19,[5 1],136,-1,155,-1,136
1,<environment.Job instance at 0x7f28ca3ec230>,136,24,[5 3],137,-1,161,-1,137
1,<environment.Job instance at 0x7f28ca3ecbe0>,134,12,[ 5 10],135,-1,153,-1,141
1,<environment.Job instance at 0x7f28ca3ec0a0>,138,13,[7 3],139,-1,154,-1,141
1,<environment.Job instance at 0x7f28c9990370>,140,16,[1 7],141,-1,157,-1,141
1,<environment.Job instance at 0x7f28c9990500>,141,18,[6 5],142,-1,160,-1,142
1,<environment.Job instance at 0x7f28c92e0230>,144,28,[10  4],145,-1,173,-1,145
1,<environment.Job instance at 0x7f28c92e0e60>,145,15,[ 4 12],146,-1,161,-1,146
1,<environment.Job instance at 0x7f28c92e05a0>,146,17,[6 1],147,-1,167,-1,150
1,<environment.Job instance at 0x7f28c92e0c30>,149,17,[8 3],150,-1,167,-1,150
1,<environment.Job instance at 0x7f28c92e04b0>,151,18,[ 5 10],152,-1,170,-1,152
1,<environment.Job instance at 0x7f28c9990c30>,6,27,[5 8],7,-1,36,-1,9
1,<environment.Job instance at 0x7f28c9580aa0>,2,26,[8 2],3,-1,40,-1,14
1,<environment.Job instance at 0x7f28ca1adcd0>,20,3,[ 3 12],21,-1,24,-1,21
1,<environment.Job instance at 0x7f28ca0ffd20>,23,26,[7 3],24,-1,60,-1,34
1,<environment.Job instance at 0x7f28c9b6b780>,37,24,[9 3],38,-1,118,-1,94
1,<environment.Job instance at 0x7f28c9a5b460>,44,1,[12  4],45,-1,117,-1,116
1,<environment.Job instance at 0x7f28c96b8370>,46,25,[10  1],47,-1,155,-1,130
1,<environment.Job instance at 0x7f28ca0f96e0>,50,24,[ 4 13],51,-1,157,-1,133
1,<environment.Job instance at 0x7f28c902b370>,51,14,[12  1],52,-1,147,-1,133
1,<environment.Job instance at 0x7f28c902b780>,53,27,[4 5],54,-1,175,-1,148
1,<environment.Job instance at 0x7f28c8e3c7d0>,64,16,[ 2 11],65,-1,208,-1,192
1,<environment.Job instance at 0x7f28c8e22780>,79,16,[13  5],80,-1,271,-1,255
1,<environment.Job instance at 0x7f28c9f5a0f0>,87,1,[ 3 11],88,-1,292,-1,291
1,<environment.Job instance at 0x7f28ca2432d0>,91,28,[7 5],92,-1,350,-1,322
1,<environment.Job instance at 0x7f28ca2972d0>,117,1,[ 2 11],118,-1,431,-1,430
1,<environment.Job instance at 0x7f28c929dd20>,125,3,[ 4 12],126,-1,460,-1,457
1,<environment.Job instance at 0x7f28c99e8f00>,127,18,[ 3 11],128,-1,480,-1,462
1,<environment.Job instance at 0x7f28c99e8780>,128,2,[14  5],129,-1,464,-1,462
1,<environment.Job instance at 0x7f28c9b6a1e0>,136,24,[5 3],137,-1,521,-1,497
1,<environment.Job instance at 0x7f28c945c3c0>,144,28,[10  4],145,-1,560,-1,532
1,<environment.Job instance at 0x7f28c9d41e10>,145,15,[ 4 12],146,-1,547,-1,532
1,<environment.Job instance at 0x7f28c9e625f0>,157,2,[ 5 12],158,-1,569,-1,567
1,<environment.Job instance at 0x7f28c93e8280>,3,17,[ 1 10],4,-1,22,-1,5
1,<environment.Job instance at 0x7f28c93e8320>,7,13,[3 5],8,-1,21,-1,8
1,<environment.Job instance at 0x7f28c93e8140>,8,12,[9 5],9,-1,21,-1,9
1,<environment.Job instance at 0x7f28c9e6ef50>,10,15,[ 4 10],11,-1,26,-1,11
1,<environment.Job instance at 0x7f28c8f0a190>,12,15,[7 5],13,-1,28,-1,13
1,<environment.Job instance at 0x7f28c8f0ab90>,15,16,[9 5],16,-1,32,-1,16
1,<environment.Job instance at 0x7f28c8f0a370>,16,18,[6 5],17,-1,35,-1,17
1,<environment.Job instance at 0x7f28c9a2d7d0>,24,12,[10  4],25,-1,37,-1,25
1,<environment.Job instance at 0x7f28c9a2d230>,25,21,[ 2 10],26,-1,47,-1,26
1,<environment.Job instance at 0x7f28c9a2d870>,26,15,[8 4],27,-1,42,-1,27
1,<environment.Job instance at 0x7f28ca53c690>,33,12,[9 4],34,-1,46,-1,34
1,<environment.Job instance at 0x7f28ca387550>,4,19,[3 6],5,-1,59,-1,40
1,<environment.Job instance at 0x7f28ca05c550>,40,24,[2 5],41,-1,65,-1,41
1,<environment.Job instance at 0x7f28ca05c8c0>,42,16,[4 9],43,-1,59,-1,43
1,<environment.Job instance at 0x7f28ca05cfa0>,45,20,[5 4],46,-1,66,-1,46
1,<environment.Job instance at 0x7f28ca018e10>,54,16,[ 5 10],55,-1,74,-1,58
1,<environment.Job instance at 0x7f28ca05c780>,46,24,[ 1 10],47,-1,82,-1,58
1,<environment.Job instance at 0x7f28ca018320>,57,22,[10  3],58,-1,81,-1,59
1,<environment.Job instance at 0x7f28ca0185f0>,60,17,[2 8],61,-1,78,-1,61
1,<environment.Job instance at 0x7f28ca018140>,61,14,[ 5 10],62,-1,77,-1,63
1,<environment.Job instance at 0x7f28ca018a00>,64,16,[2 9],65,-1,81,-1,65
1,<environment.Job instance at 0x7f28ca018500>,65,16,[7 5],66,-1,83,-1,67
1,<environment.Job instance at 0x7f28ca018eb0>,56,13,[9 4],57,-1,88,-1,75
1,<environment.Job instance at 0x7f28d2aaeb90>,71,16,[10  5],72,-1,91,-1,75
1,<environment.Job instance at 0x7f28ca018d70>,63,18,[ 5 12],64,-1,124,-1,106
1,<environment.Job instance at 0x7f28c9b84f00>,87,19,[ 4 10],88,-1,155,-1,136
1,<environment.Job instance at 0x7f28ca18ae60>,109,14,[ 5 10],110,-1,225,-1,211
1,<environment.Job instance at 0x7f28ca1ade60>,112,18,[6 5],113,-1,229,-1,211
1,<environment.Job instance at 0x7f28ca1adfa0>,110,18,[5 7],111,-1,234,-1,216
1,<environment.Job instance at 0x7f28ca1ad910>,113,24,[ 5 11],114,-1,240,-1,216
1,<environment.Job instance at 0x7f28c8c5f2d0>,104,18,[8 1],105,-1,265,-1,247
1,<environment.Job instance at 0x7f28c8f45960>,129,21,[7 5],130,-1,268,-1,247
1,<environment.Job instance at 0x7f28c9325c30>,126,17,[10  5],127,-1,264,-1,247
1,<environment.Job instance at 0x7f28c8c5f690>,135,21,[6 2],136,-1,288,-1,267
1,<environment.Job instance at 0x7f28c931c1e0>,114,16,[9 5],115,-1,283,-1,267
1,<environment.Job instance at 0x7f28c8c5faf0>,139,17,[9 1],140,-1,284,-1,267
1,<environment.Job instance at 0x7f28c9f2c8c0>,127,12,[10  4],128,-1,281,-1,269
1,<environment.Job instance at 0x7f28c92a54b0>,143,12,[1 5],144,-1,281,-1,269
1,<environment.Job instance at 0x7f28c92a55f0>,144,15,[5 9],145,-1,284,-1,269
1,<environment.Job instance at 0x7f28c92a5a50>,142,17,[5 5],143,-1,303,-1,286
1,<environment.Job instance at 0x7f28c9b6ca50>,153,17,[2 7],154,-1,303,-1,286
1,<environment.Job instance at 0x7f28c9b6ccd0>,149,16,[9 2],150,-1,303,-1,287
1,<environment.Job instance at 0x7f28c9b6cd20>,157,16,[3 9],158,-1,303,-1,287
1,<environment.Job instance at 0x7f28d2aae910>,69,16,[14  3],70,-1,303,-1,287
1,<environment.Job instance at 0x7f28c9b6c7d0>,156,17,[ 2 10],157,-1,304,-1,287
1,<environment.Job instance at 0x7f28c9972870>,96,23,[ 4 10],97,-1,310,-1,287
1,<environment.Job instance at 0x7f28c8c5f4b0>,131,19,[14  4],132,-1,306,-1,287
1,<environment.Job instance at 0x7f28c8f0a2d0>,2,25,[2 8],3,-1,28,-1,3
1,<environment.Job instance at 0x7f28ca53c9b0>,6,26,[ 1 12],7,-1,33,-1,7
1,<environment.Job instance at 0x7f28ca05c320>,13,2,[11  4],14,-1,23,-1,21
1,<environment.Job instance at 0x7f28d2aae370>,17,2,[11  1],18,-1,34,-1,32
1,<environment.Job instance at 0x7f28c9e4eaf0>,29,2,[ 3 11],30,-1,69,-1,67
1,<environment.Job instance at 0x7f28c945c230>,40,24,[2 5],41,-1,122,-1,98
1,<environment.Job instance at 0x7f28ca310730>,46,24,[ 1 10],47,-1,131,-1,107
1,<environment.Job instance at 0x7f28c92babe0>,47,3,[13  1],48,-1,110,-1,107
1,<environment.Job instance at 0x7f28c8f78230>,53,25,[4 6],54,-1,151,-1,126
1,<environment.Job instance at 0x7f28c8e22500>,63,18,[ 5 12],64,-1,165,-1,147
1,<environment.Job instance at 0x7f28c8ba32d0>,69,16,[14  3],70,-1,198,-1,182
1,<environment.Job instance at 0x7f28d2c81d20>,79,3,[14  2],80,-1,223,-1,220
1,<environment.Job instance at 0x7f28d2cff050>,96,23,[ 4 10],97,-1,323,-1,300
1,<environment.Job instance at 0x7f28c9b6baa0>,99,2,[13  2],100,-1,302,-1,300
1,<environment.Job instance at 0x7f28c9b6c6e0>,113,24,[ 5 11],114,-1,372,-1,348
1,<environment.Job instance at 0x7f28c9644500>,124,16,[12  5],125,-1,417,-1,401
1,<environment.Job instance at 0x7f28c9323280>,131,19,[14  4],132,-1,439,-1,420
1,<environment.Job instance at 0x7f28c9323cd0>,137,3,[ 5 11],138,-1,448,-1,445
1,<environment.Job instance at 0x7f28c9323640>,138,1,[11  4],139,-1,446,-1,445
1,<environment.Job instance at 0x7f28c92bda00>,3,18,[5 3],4,-1,22,-1,4
1,<environment.Job instance at 0x7f28c95ab500>,6,22,[8 4],7,-1,29,-1,7
1,<environment.Job instance at 0x7f28c95ab5f0>,7,20,[5 5],8,-1,28,-1,8
1,<environment.Job instance at 0x7f28c95ab780>,8,20,[6 2],9,-1,29,-1,9
1,<environment.Job instance at 0x7f28c95abe60>,9,14,[ 2 10],10,-1,24,-1,10
1,<environment.Job instance at 0x7f28c958c820>,17,14,[5 4],18,-1,34,-1,20
1,<environment.Job instance at 0x7f28c958cf50>,21,12,[8 3],22,-1,34,-1,22
1,<environment.Job instance at 0x7f28c958c5a0>,22,12,[10  2],23,-1,35,-1,23
1,<environment.Job instance at 0x7f28c958cb40>,23,13,[3 6],24,-1,37,-1,24
1,<environment.Job instance at 0x7f28c958c960>,24,17,[5 1],25,-1,42,-1,25
1,<environment.Job instance at 0x7f28c9598f00>,27,23,[2 9],28,-1,51,-1,28
1,<environment.Job instance at 0x7f28c9598e60>,29,16,[7 1],30,-1,46,-1,30
1,<environment.Job instance at 0x7f28c9598320>,30,15,[4 6],31,-1,46,-1,31
1,<environment.Job instance at 0x7f28c95985a0>,33,16,[8 1],34,-1,51,-1,35
1,<environment.Job instance at 0x7f28c9598870>,34,17,[5 5],35,-1,52,-1,35
1,<environment.Job instance at 0x7f28c958f370>,36,15,[10  3],37,-1,55,-1,40
1,<environment.Job instance at 0x7f28c9a7a820>,42,13,[4 8],43,-1,56,-1,43
1,<environment.Job instance at 0x7f28c958ff50>,43,16,[6 1],44,-1,60,-1,44
1,<environment.Job instance at 0x7f28c958feb0>,44,13,[5 5],45,-1,58,-1,45
1,<environment.Job instance at 0x7f28c95950a0>,49,12,[10  1],50,-1,62,-1,50
1,<environment.Job instance at 0x7f28c9595c80>,50,13,[10  5],51,-1,64,-1,51
1,<environment.Job instance at 0x7f28c9a63960>,51,23,[10  2],52,-1,75,-1,52
1,<environment.Job instance at 0x7f28ca085730>,53,17,[6 2],54,-1,71,-1,54
1,<environment.Job instance at 0x7f28c9a8b5f0>,54,18,[2 9],55,-1,73,-1,55
1,<environment.Job instance at 0x7f28ca0b33c0>,55,17,[5 9],56,-1,73,-1,56
1,<environment.Job instance at 0x7f28ca0b3b40>,56,15,[3 6],57,-1,72,-1,57
1,<environment.Job instance at 0x7f28c95c76e0>,58,18,[1 6],59,-1,77,-1,59
1,<environment.Job instance at 0x7f28c95c7e60>,59,15,[1 8],60,-1,75,-1,60
1,<environment.Job instance at 0x7f28c95c7d20>,61,15,[4 5],62,-1,77,-1,62
1,<environment.Job instance at 0x7f28c95c7190>,62,15,[9 3],63,-1,78,-1,63
1,<environment.Job instance at 0x7f28c95c75a0>,63,14,[1 6],64,-1,78,-1,64
1,<environment.Job instance at 0x7f28c95c74b0>,64,17,[7 2],65,-1,82,-1,65
1,<environment.Job instance at 0x7f28c959c550>,66,15,[9 5],67,-1,82,-1,67
1,<environment.Job instance at 0x7f28c959c370>,67,17,[10  1],68,-1,85,-1,68
1,<environment.Job instance at 0x7f28c959c230>,68,16,[ 5 10],69,-1,85,-1,69
1,<environment.Job instance at 0x7f28c959ce10>,69,17,[3 7],70,-1,87,-1,70
1,<environment.Job instance at 0x7f28ca093f50>,74,18,[8 4],75,-1,93,-1,75
1,<environment.Job instance at 0x7f28c958fdc0>,39,18,[4 9],40,-1,93,-1,75
1,<environment.Job instance at 0x7f28ca0827d0>,80,17,[ 5 11],81,-1,98,-1,81
1,<environment.Job instance at 0x7f28ca08bf00>,81,2,[1 6],82,-1,84,-1,82
1,<environment.Job instance at 0x7f28ca08b230>,82,1,[7 3],83,-1,84,-1,83
1,<environment.Job instance at 0x7f28ca0775a0>,91,21,[9 2],92,-1,113,-1,92
1,<environment.Job instance at 0x7f28ca077550>,96,12,[8 4],97,-1,112,-1,100
1,<environment.Job instance at 0x7f28ca077370>,89,17,[4 5],90,-1,118,-1,101
1,<environment.Job instance at 0x7f28ca0977d0>,99,14,[ 4 10],100,-1,117,-1,103
1,<environment.Job instance at 0x7f28ca08b280>,84,12,[ 3 10],85,-1,115,-1,103
1,<environment.Job instance at 0x7f28ca077320>,97,22,[8 1],98,-1,125,-1,103
1,<environment.Job instance at 0x7f28c9a755f0>,100,14,[6 3],101,-1,118,-1,104
1,<environment.Job instance at 0x7f28ca0a1a00>,110,13,[10  2],111,-1,124,-1,111
1,<environment.Job instance at 0x7f28ca0a19b0>,112,18,[10  1],113,-1,131,-1,113
1,<environment.Job instance at 0x7f28ca0a15f0>,106,16,[ 3 10],107,-1,131,-1,115
1,<environment.Job instance at 0x7f28ca0a1b40>,111,25,[12  4],112,-1,142,-1,117
1,<environment.Job instance at 0x7f28ca08b190>,85,13,[10  4],86,-1,132,-1,119
1,<environment.Job instance at 0x7f28c90c10f0>,116,17,[6 4],117,-1,139,-1,122
1,<environment.Job instance at 0x7f28c9a69370>,105,17,[10  3],106,-1,139,-1,122
1,<environment.Job instance at 0x7f28c90c1050>,120,17,[3 6],121,-1,139,-1,122
1,<environment.Job instance at 0x7f28c90c1410>,122,16,[8 3],123,-1,145,-1,129
1,<environment.Job instance at 0x7f28c90c1780>,124,16,[8 1],125,-1,145,-1,129
1,<environment.Job instance at 0x7f28c90c1820>,125,12,[ 4 10],126,-1,141,-1,129
1,<environment.Job instance at 0x7f28c90c1730>,127,14,[5 5],128,-1,143,-1,129
1,<environment.Job instance at 0x7f28c90c1960>,126,17,[5 4],127,-1,146,-1,129
1,<environment.Job instance at 0x7f28c90c17d0>,128,15,[1 7],129,-1,145,-1,130
1,<environment.Job instance at 0x7f28ca0975f0>,101,16,[5 5],102,-1,153,-1,137
1,<environment.Job instance at 0x7f28c90c1910>,133,17,[5 3],134,-1,154,-1,137
1,<environment.Job instance at 0x7f28c90af640>,139,18,[7 1],140,-1,158,-1,140
1,<environment.Job instance at 0x7f28c90af780>,141,18,[7 5],142,-1,160,-1,142
1,<environment.Job instance at 0x7f28c90af050>,135,13,[1 9],136,-1,158,-1,145
1,<environment.Job instance at 0x7f28c90afdc0>,146,17,[6 5],147,-1,164,-1,147
1,<environment.Job instance at 0x7f28c90afcd0>,147,18,[9 5],148,-1,166,-1,148
1,<environment.Job instance at 0x7f28ca085e60>,10,17,[11  3],11,-1,32,-1,15
1,<environment.Job instance at 0x7f28ca08b550>,15,1,[ 5 14],16,-1,19,-1,18
1,<environment.Job instance at 0x7f28c90c1f00>,27,23,[2 9],28,-1,86,-1,63
1,<environment.Job instance at 0x7f28c90c1a50>,28,2,[ 1 11],29,-1,65,-1,63
1,<environment.Job instance at 0x7f28c9323b90>,51,23,[10  2],52,-1,166,-1,143
1,<environment.Job instance at 0x7f28c9990b90>,71,26,[14  5],72,-1,274,-1,248
1,<environment.Job instance at 0x7f28ca1add70>,80,17,[ 5 11],81,-1,289,-1,272
1,<environment.Job instance at 0x7f28c9a5b9b0>,94,3,[13  3],95,-1,302,-1,299
1,<environment.Job instance at 0x7f28c9eb4aa0>,111,25,[12  4],112,-1,394,-1,369
1,<environment.Job instance at 0x7f28c8d9cc30>,138,16,[ 4 12],139,-1,503,-1,487
1,<environment.Job instance at 0x7f28c945c550>,142,3,[12  2],143,-1,507,-1,504
1,<environment.Job instance at 0x7f28c945cdc0>,143,18,[13  1],144,-1,522,-1,504
1,<environment.Job instance at 0x7f28c9f07960>,156,23,[ 4 10],157,-1,586,-1,563
1,<environment.Job instance at 0x7f28ca0933c0>,1,28,[9 4],2,-1,30,-1,2
1,<environment.Job instance at 0x7f28ca093be0>,8,12,[9 2],9,-1,21,-1,9
1,<environment.Job instance at 0x7f28c9a8b780>,9,17,[10  5],10,-1,27,-1,10
1,<environment.Job instance at 0x7f28ca0938c0>,6,16,[7 3],7,-1,27,-1,11
1,<environment.Job instance at 0x7f28c9a8b230>,14,25,[1 6],15,-1,45,-1,20
1,<environment.Job instance at 0x7f28ca097b90>,25,16,[3 7],26,-1,46,-1,30
1,<environment.Job instance at 0x7f28c9590500>,29,16,[4 7],30,-1,46,-1,30
1,<environment.Job instance at 0x7f28c9590fa0>,31,14,[8 4],32,-1,46,-1,32
1,<environment.Job instance at 0x7f28c9a8b820>,21,18,[9 3],22,-1,50,-1,32
1,<environment.Job instance at 0x7f28c9590550>,32,24,[3 5],33,-1,57,-1,33
1,<environment.Job instance at 0x7f28c9590dc0>,34,16,[5 5],35,-1,51,-1,35
1,<environment.Job instance at 0x7f28c9590b40>,35,27,[1 5],36,-1,63,-1,36
1,<environment.Job instance at 0x7f28c95900f0>,36,15,[4 5],37,-1,52,-1,37
1,<environment.Job instance at 0x7f28c9590cd0>,37,17,[6 2],38,-1,57,-1,40
1,<environment.Job instance at 0x7f28ca41e820>,43,14,[11  5],44,-1,58,-1,44
1,<environment.Job instance at 0x7f28ca41e1e0>,44,17,[3 7],45,-1,62,-1,45
1,<environment.Job instance at 0x7f28ca41e0a0>,45,14,[4 9],46,-1,60,-1,46
1,<environment.Job instance at 0x7f28c9a69690>,49,15,[9 4],50,-1,65,-1,50
1,<environment.Job instance at 0x7f28c9a692d0>,51,19,[5 8],52,-1,71,-1,52
1,<environment.Job instance at 0x7f28c9a695f0>,54,14,[ 1 10],55,-1,69,-1,55
1,<environment.Job instance at 0x7f28c9a69a00>,56,13,[ 3 10],57,-1,70,-1,57
1,<environment.Job instance at 0x7f28c9a69e10>,57,18,[1 6],58,-1,76,-1,58
1,<environment.Job instance at 0x7f28c9a69500>,58,16,[6 3],59,-1,75,-1,59
1,<environment.Job instance at 0x7f28c9a696e0>,60,15,[7 1],61,-1,76,-1,61
1,<environment.Job instance at 0x7f28c9590640>,39,14,[4 8],40,-1,76,-1,62
1,<environment.Job instance at 0x7f28c92b5e10>,62,16,[8 5],63,-1,79,-1,63
1,<environment.Job instance at 0x7f28c92b5f50>,63,21,[4 8],64,-1,85,-1,64
1,<environment.Job instance at 0x7f28ca086280>,68,17,[ 1 10],69,-1,86,-1,69
1,<environment.Job instance at 0x7f28ca0863c0>,70,12,[2 7],71,-1,83,-1,71
1,<environment.Job instance at 0x7f28ca086320>,72,12,[7 5],73,-1,85,-1,73
1,<environment.Job instance at 0x7f28ca0864b0>,74,16,[ 2 11],75,-1,91,-1,75
1,<environment.Job instance at 0x7f28ca077410>,75,12,[5 6],76,-1,88,-1,76
1,<environment.Job instance at 0x7f28ca077fa0>,77,15,[4 6],78,-1,95,-1,80
1,<environment.Job instance at 0x7f28ca0a3e10>,80,15,[6 2],81,-1,97,-1,82
1,<environment.Job instance at 0x7f28ca0a36e0>,84,14,[9 4],85,-1,99,-1,85
1,<environment.Job instance at 0x7f28ca0a3f50>,90,13,[1 6],91,-1,104,-1,91
1,<environment.Job instance at 0x7f28c9bb3d20>,91,17,[ 3 10],92,-1,109,-1,92
1,<environment.Job instance at 0x7f28ca0a3190>,81,15,[8 2],82,-1,132,-1,117
1,<environment.Job instance at 0x7f28c9bb7d20>,100,22,[5 2],101,-1,139,-1,117
1,<environment.Job instance at 0x7f28c8b616e0>,106,13,[ 4 10],107,-1,130,-1,117
1,<environment.Job instance at 0x7f28ca08b140>,108,16,[10  1],109,-1,133,-1,117
1,<environment.Job instance at 0x7f28ca0b3730>,110,28,[6 4],111,-1,145,-1,117
1,<environment.Job instance at 0x7f28ca097eb0>,105,19,[9 4],106,-1,136,-1,117
1,<environment.Job instance at 0x7f28ca0a3640>,89,15,[6 1],90,-1,132,-1,117
1,<environment.Job instance at 0x7f28c9dcd2d0>,115,26,[9 2],116,-1,143,-1,117
1,<environment.Job instance at 0x7f28ca23e9b0>,117,16,[10  1],118,-1,135,-1,119
1,<environment.Job instance at 0x7f28c93e0640>,122,14,[8 4],123,-1,150,-1,136
1,<environment.Job instance at 0x7f28c9dd1050>,126,17,[14  5],127,-1,153,-1,136
1,<environment.Job instance at 0x7f28c9dd1cd0>,127,16,[1 9],128,-1,152,-1,136
1,<environment.Job instance at 0x7f28c93e0e60>,121,23,[4 5],122,-1,159,-1,136
1,<environment.Job instance at 0x7f28c9a78a50>,129,18,[4 8],130,-1,154,-1,136
1,<environment.Job instance at 0x7f28c9a78d70>,134,21,[10  4],135,-1,158,-1,137
1,<environment.Job instance at 0x7f28c93d2cd0>,120,16,[8 1],121,-1,153,-1,137
1,<environment.Job instance at 0x7f28c940b460>,139,14,[3 7],140,-1,166,-1,152
1,<environment.Job instance at 0x7f28c92d71e0>,138,26,[1 5],139,-1,181,-1,155
1,<environment.Job instance at 0x7f28c92f97d0>,151,13,[5 3],152,-1,168,-1,155
1,<environment.Job instance at 0x7f28ca4d9410>,152,12,[4 6],153,-1,168,-1,156
1,<environment.Job instance at 0x7f28c9d4d0f0>,153,16,[4 7],154,-1,172,-1,156
1,<environment.Job instance at 0x7f28c958f280>,145,12,[8 2],146,-1,168,-1,156
1,<environment.Job instance at 0x7f28c9d4d550>,155,15,[1 7],156,-1,171,-1,156
1,<environment.Job instance at 0x7f28c9d4d320>,154,12,[ 2 10],155,-1,168,-1,156
1,<environment.Job instance at 0x7f28c9a69be0>,1,28,[9 4],2,-1,30,-1,2
1,<environment.Job instance at 0x7f28c9a69f50>,2,25,[12  5],3,-1,28,-1,3
1,<environment.Job instance at 0x7f28c9a841e0>,14,25,[1 6],15,-1,50,-1,25
1,<environment.Job instance at 0x7f28c90c10a0>,32,24,[3 5],33,-1,101,-1,77
1,<environment.Job instance at 0x7f28c90c1a50>,35,27,[1 5],36,-1,107,-1,80
1,<environment.Job instance at 0x7f28c95905f0>,43,14,[11  5],44,-1,123,-1,109
1,<environment.Job instance at 0x7f28d2f50960>,74,16,[ 2 11],75,-1,234,-1,218
1,<environment.Job instance at 0x7f28c954ba50>,76,2,[11  2],77,-1,228,-1,226
1,<environment.Job instance at 0x7f28c9124870>,86,15,[13  1],87,-1,266,-1,251
1,<environment.Job instance at 0x7f28c963d460>,102,1,[11  5],103,-1,289,-1,288
1,<environment.Job instance at 0x7f28c8bd7780>,110,28,[6 4],111,-1,337,-1,309
1,<environment.Job instance at 0x7f28c8bd7320>,111,3,[11  1],112,-1,312,-1,309
1,<environment.Job instance at 0x7f28ca3a0730>,112,2,[11  5],113,-1,311,-1,309
1,<environment.Job instance at 0x7f28ca3a0460>,115,26,[9 2],116,-1,338,-1,312
1,<environment.Job instance at 0x7f28ca36fe60>,121,23,[4 5],122,-1,364,-1,341
1,<environment.Job instance at 0x7f28c9bd8be0>,125,3,[ 3 11],126,-1,348,-1,345
1,<environment.Job instance at 0x7f28c9bd8f00>,126,17,[14  5],127,-1,362,-1,345
1,<environment.Job instance at 0x7f28c9e07230>,138,26,[1 5],139,-1,419,-1,393
1,<environment.Job instance at 0x7f28c9cb3820>,142,2,[ 4 13],143,-1,402,-1,400
1,<environment.Job instance at 0x7f28c8bd0c80>,149,16,[ 1 14],150,-1,431,-1,415
1,<environment.Job instance at 0x7f28c8e8f7d0>,8,13,[6 3],9,-1,22,-1,9
1,<environment.Job instance at 0x7f28c8e8f140>,14,20,[ 1 10],15,-1,38,-1,18
1,<environment.Job instance at 0x7f28c8e8f190>,15,18,[5 5],16,-1,36,-1,18
1,<environment.Job instance at 0x7f28c8e8fc80>,17,18,[6 1],18,-1,38,-1,20
1,<environment.Job instance at 0x7f28c8e8f3c0>,11,12,[5 4],12,-1,32,-1,20
1,<environment.Job instance at 0x7f28c9273320>,19,17,[5 7],20,-1,39,-1,22
1,<environment.Job instance at 0x7f28c9273e10>,24,15,[4 7],25,-1,41,-1,26
1,<environment.Job instance at 0x7f28c9743410>,28,15,[6 4],29,-1,44,-1,29
1,<environment.Job instance at 0x7f28c9743960>,30,17,[1 6],31,-1,48,-1,31
1,<environment.Job instance at 0x7f28c9743e60>,36,15,[7 3],37,-1,53,-1,38
1,<environment.Job instance at 0x7f28c97438c0>,35,16,[10  3],36,-1,54,-1,38
1,<environment.Job instance at 0x7f28c9743aa0>,37,21,[1 8],38,-1,59,-1,38
1,<environment.Job instance at 0x7f28c9743140>,38,17,[5 7],39,-1,56,-1,39
1,<environment.Job instance at 0x7f28c96d7c80>,43,25,[6 2],44,-1,69,-1,44
1,<environment.Job instance at 0x7f28c96d7a50>,44,15,[10  3],45,-1,60,-1,45
1,<environment.Job instance at 0x7f28c96d7780>,46,20,[ 5 11],47,-1,67,-1,47
1,<environment.Job instance at 0x7f28c8e8feb0>,16,15,[5 3],17,-1,64,-1,49
1,<environment.Job instance at 0x7f28c92733c0>,25,16,[7 4],26,-1,65,-1,49
1,<environment.Job instance at 0x7f28c96d7050>,48,15,[10  5],49,-1,71,-1,56
1,<environment.Job instance at 0x7f28c975d1e0>,54,14,[2 5],55,-1,70,-1,56
1,<environment.Job instance at 0x7f28c975d050>,53,17,[8 4],54,-1,73,-1,56
1,<environment.Job instance at 0x7f28c9fb01e0>,65,17,[13  3],66,-1,167,-1,150
1,<environment.Job instance at 0x7f28c9fb03c0>,71,17,[1 7],72,-1,169,-1,152
1,<environment.Job instance at 0x7f28c975dd70>,61,18,[14  2],62,-1,170,-1,152
1,<environment.Job instance at 0x7f28c9fb0140>,68,14,[10  4],69,-1,166,-1,152
1,<environment.Job instance at 0x7f28c9d58780>,84,22,[9 1],85,-1,232,-1,210
1,<environment.Job instance at 0x7f28c9d601e0>,89,18,[6 3],90,-1,228,-1,210
1,<environment.Job instance at 0x7f28c9d585a0>,80,24,[8 2],81,-1,234,-1,210
1,<environment.Job instance at 0x7f28c9d58a50>,82,19,[2 9],83,-1,229,-1,210
1,<environment.Job instance at 0x7f28c9d60d20>,90,13,[ 2 10],91,-1,223,-1,210
1,<environment.Job instance at 0x7f28c9d60af0>,97,14,[9 5],98,-1,224,-1,210
1,<environment.Job instance at 0x7f28c9d60280>,98,14,[8 5],99,-1,225,-1,211
1,<environment.Job instance at 0x7f28c9d60be0>,99,16,[3 8],100,-1,230,-1,214
1,<environment.Job instance at 0x7f28c8b69b90>,101,22,[10  3],102,-1,236,-1,214
1,<environment.Job instance at 0x7f28c8b695a0>,103,16,[ 4 10],104,-1,230,-1,214
1,<environment.Job instance at 0x7f28c8b69140>,104,18,[6 5],105,-1,232,-1,214
1,<environment.Job instance at 0x7f28c8e8fdc0>,1,14,[ 4 14],2,-1,16,-1,2
1,<environment.Job instance at 0x7f28c96d7cd0>,9,15,[ 5 13],10,-1,31,-1,16
1,<environment.Job instance at 0x7f28c8b69f00>,10,3,[13  2],11,-1,19,-1,16
1,<environment.Job instance at 0x7f28c96bdcd0>,21,18,[12  2],22,-1,56,-1,38
1,<environment.Job instance at 0x7f28c93df0a0>,22,2,[ 2 13],23,-1,40,-1,38
1,<environment.Job instance at 0x7f28c93dfeb0>,23,13,[ 1 11],24,-1,51,-1,38
1,<environment.Job instance at 0x7f28c9cb3c80>,31,24,[10  2],32,-1,94,-1,70
1,<environment.Job instance at 0x7f28c963dfa0>,43,25,[6 2],44,-1,145,-1,120
1,<environment.Job instance at 0x7f28c9fd0d70>,46,20,[ 5 11],47,-1,141,-1,121
1,<environment.Job instance at 0x7f28c954baa0>,61,18,[14  2],62,-1,218,-1,200
1,<environment.Job instance at 0x7f28ca1a2cd0>,65,17,[13  3],66,-1,229,-1,212
1,<environment.Job instance at 0x7f28c8ca0960>,70,2,[13  1],71,-1,231,-1,229
1,<environment.Job instance at 0x7f28ca0a1e60>,75,1,[11  2],76,-1,246,-1,245
1,<environment.Job instance at 0x7f28ca0a1460>,76,28,[5 5],77,-1,275,-1,247
1,<environment.Job instance at 0x7f28c9590780>,80,24,[8 2],81,-1,285,-1,261
1,<environment.Job instance at 0x7f28c93d2b90>,92,3,[ 3 14],93,-1,307,-1,304
1,<environment.Job instance at 0x7f28c90f79b0>,100,25,[ 5 10],101,-1,369,-1,344
1,<environment.Job instance at 0x7f28ca4a7550>,107,12,[ 3 12],108,-1,376,-1,364
1,<environment.Job instance at 0x7f28ca106370>,108,3,[11  2],109,-1,367,-1,364
1,<environment.Job instance at 0x7f28ca2a75a0>,109,26,[14  4],110,-1,390,-1,364
1,<environment.Job instance at 0x7f28c90cb820>,111,24,[10  4],112,-1,408,-1,384
1,<environment.Job instance at 0x7f28ca03a780>,113,2,[ 3 14],114,-1,386,-1,384
1,<environment.Job instance at 0x7f28d30a3500>,126,25,[8 2],127,-1,491,-1,466
1,<environment.Job instance at 0x7f28c8b614b0>,130,13,[ 3 13],131,-1,494,-1,481
1,<environment.Job instance at 0x7f28c8b61aa0>,132,17,[12  2],133,-1,498,-1,481
1,<environment.Job instance at 0x7f28c98e8af0>,146,15,[ 5 13],147,-1,583,-1,568
1,<environment.Job instance at 0x7f28ca35e5a0>,150,1,[ 3 11],151,-1,584,-1,583
1,<environment.Job instance at 0x7f28c8c6c820>,156,3,[ 2 13],157,-1,608,-1,605
1,<environment.Job instance at 0x7fbd14b98be0>,3,22,[2 5],4,-1,26,-1,4
1,<environment.Job instance at 0x7fbd14b98e60>,6,15,[2 8],7,-1,22,-1,7
1,<environment.Job instance at 0x7fbd14b98f00>,7,14,[7 5],8,-1,22,-1,8
1,<environment.Job instance at 0x7fbd14b98dc0>,8,17,[1 8],9,-1,26,-1,9
1,<environment.Job instance at 0x7fbd14b9b0a0>,10,22,[8 1],11,-1,33,-1,11
1,<environment.Job instance at 0x7fbd14b9b140>,12,23,[6 4],13,-1,36,-1,13
1,<environment.Job instance at 0x7fbd14b9b410>,13,18,[5 9],14,-1,32,-1,14
1,<environment.Job instance at 0x7fbd14b9b320>,14,21,[8 1],15,-1,36,-1,15
1,<environment.Job instance at 0x7fbd14b9b500>,16,18,[7 3],17,-1,35,-1,17
1,<environment.Job instance at 0x7fbd14b9b5f0>,18,26,[7 4],19,-1,45,-1,19
1,<environment.Job instance at 0x7fbd14b9b820>,19,25,[5 9],20,-1,45,-1,20
1,<environment.Job instance at 0x7fbd14b9b8c0>,21,18,[9 4],22,-1,40,-1,22
1,<environment.Job instance at 0x7fbd14b9b910>,23,16,[6 2],24,-1,40,-1,24
1,<environment.Job instance at 0x7fbd14b9be60>,26,12,[8 5],27,-1,40,-1,28
1,<environment.Job instance at 0x7fbd14b9bf50>,28,17,[ 1 13],29,-1,46,-1,29
1,<environment.Job instance at 0x7fbd14b9e0a0>,29,2,[4 7],30,-1,32,-1,30
1,<environment.Job instance at 0x7fbd14b9e140>,30,26,[9 4],31,-1,57,-1,31
1,<environment.Job instance at 0x7fbd14b9bd70>,27,17,[4 6],28,-1,49,-1,32
1,<environment.Job instance at 0x7fbd14b9bfa0>,32,21,[5 9],33,-1,54,-1,33
1,<environment.Job instance at 0x7fbd14b9e280>,33,26,[3 6],34,-1,60,-1,34
1,<environment.Job instance at 0x7fbd14b9e370>,34,14,[1 9],35,-1,50,-1,36
1,<environment.Job instance at 0x7fbd14b9e640>,37,14,[5 8],38,-1,52,-1,38
1,<environment.Job instance at 0x7fbd14b9e5a0>,35,16,[1 9],36,-1,55,-1,39
1,<environment.Job instance at 0x7fbd14b9e8c0>,39,14,[9 4],40,-1,55,-1,41
1,<environment.Job instance at 0x7fbd14b9e500>,40,26,[ 1 10],41,-1,69,-1,43
1,<environment.Job instance at 0x7fbd14ba0320>,48,12,[9 2],49,-1,61,-1,49
1,<environment.Job instance at 0x7fbd14ba0230>,49,17,[10  2],50,-1,68,-1,51
1,<environment.Job instance at 0x7fbd14ba0500>,51,2,[5 3],52,-1,54,-1,52
1,<environment.Job instance at 0x7fbd14ba0820>,54,18,[7 1],55,-1,73,-1,55
1,<environment.Job instance at 0x7fbd14ba0960>,55,12,[2 6],56,-1,68,-1,56
1,<environment.Job instance at 0x7fbd14ba07d0>,57,16,[ 2 11],58,-1,74,-1,58
1,<environment.Job instance at 0x7fbd14ba0c30>,58,17,[3 7],59,-1,76,-1,59
1,<environment.Job instance at 0x7fbd14ba0910>,59,19,[1 7],60,-1,79,-1,60
1,<environment.Job instance at 0x7fbd14ba0fa0>,62,14,[4 9],63,-1,77,-1,63
1,<environment.Job instance at 0x7fbd14ba4230>,67,16,[1 9],68,-1,84,-1,68
1,<environment.Job instance at 0x7fbd14ba4640>,68,14,[6 4],69,-1,83,-1,69
1,<environment.Job instance at 0x7fbd14ba42d0>,69,14,[9 4],70,-1,84,-1,70
1,<environment.Job instance at 0x7fbd14ba4550>,72,18,[3 5],73,-1,91,-1,73
1,<environment.Job instance at 0x7fbd14ba4e60>,76,13,[10  1],77,-1,91,-1,78
1,<environment.Job instance at 0x7fbd14ba4fa0>,77,16,[8 1],78,-1,94,-1,78
1,<environment.Job instance at 0x7fbd14ba60a0>,79,19,[10  3],80,-1,99,-1,80
1,<environment.Job instance at 0x7fbd14ba6370>,82,21,[4 8],83,-1,104,-1,83
1,<environment.Job instance at 0x7fbd14ba65a0>,83,18,[ 3 10],84,-1,102,-1,84
1,<environment.Job instance at 0x7fbd14ba6910>,87,18,[7 1],88,-1,106,-1,88
1,<environment.Job instance at 0x7fbd14ba6a50>,88,16,[4 9],89,-1,105,-1,89
1,<environment.Job instance at 0x7fbd14ba6be0>,91,18,[5 4],92,-1,110,-1,92
1,<environment.Job instance at 0x7fbd14b8fe60>,96,18,[2 6],97,-1,115,-1,97
1,<environment.Job instance at 0x7fbd14ce07d0>,101,15,[2 7],102,-1,118,-1,103
1,<environment.Job instance at 0x7fbd14b8fb90>,103,16,[1 9],104,-1,120,-1,104
1,<environment.Job instance at 0x7fbd14ca3820>,105,16,[7 5],106,-1,122,-1,106
1,<environment.Job instance at 0x7fbd14c21be0>,107,18,[5 5],108,-1,126,-1,108
1,<environment.Job instance at 0x7fbd14c5a0f0>,109,27,[3 9],110,-1,137,-1,110
1,<environment.Job instance at 0x7fbd15067b40>,110,23,[5 1],111,-1,134,-1,111
1,<environment.Job instance at 0x7fbd14c296e0>,111,17,[6 4],112,-1,129,-1,112
1,<environment.Job instance at 0x7fbd14c0dc80>,112,12,[1 6],113,-1,125,-1,113
1,<environment.Job instance at 0x7fbd14d23230>,118,16,[5 2],119,-1,135,-1,119
1,<environment.Job instance at 0x7fbd14bbbd20>,119,28,[7 5],120,-1,148,-1,120
1,<environment.Job instance at 0x7fbd14bbbdc0>,120,19,[ 5 12],121,-1,140,-1,121
1,<environment.Job instance at 0x7fbd14cbb640>,122,18,[7 5],123,-1,141,-1,123
1,<environment.Job instance at 0x7fbd14bc0af0>,128,1,[7 1],129,-1,130,-1,129
1,<environment.Job instance at 0x7fbd14bc0960>,129,13,[5 5],130,-1,143,-1,130
1,<environment.Job instance at 0x7fbd14bc05f0>,130,17,[9 5],131,-1,148,-1,131
1,<environment.Job instance at 0x7fbd14bc0e10>,131,13,[3 8],132,-1,145,-1,132
1,<environment.Job instance at 0x7fbd14d1e730>,132,18,[10  4],133,-1,151,-1,133
1,<environment.Job instance at 0x7fbd14c13c30>,134,12,[5 4],135,-1,147,-1,135
1,<environment.Job instance at 0x7fbd14c48f00>,135,15,[8 3],136,-1,151,-1,136
1,<environment.Job instance at 0x7fbd14c485a0>,137,28,[ 2 10],138,-1,166,-1,138
1,<environment.Job instance at 0x7fbd14c48c30>,141,14,[ 3 10],142,-1,156,-1,142
1,<environment.Job instance at 0x7fbd14cb9a00>,149,17,[5 7],150,-1,167,-1,150
1,<environment.Job instance at 0x7fbd14c47050>,151,22,[5 6],152,-1,174,-1,152
1,<environment.Job instance at 0x7fbd14c47550>,155,17,[10  4],156,-1,173,-1,156
1,<environment.Job instance at 0x7fbd14ca6820>,157,21,[10  4],158,-1,179,-1,158
1,<environment.Job instance at 0x7fbd14bd3370>,160,24,[1 5],161,-1,185,-1,161
1,<environment.Job instance at 0x7fbd14b75c80>,162,20,[10  5],163,-1,183,-1,163
1,<environment.Job instance at 0x7fbd14bf9320>,164,14,[10  5],165,-1,179,-1,165
1,<environment.Job instance at 0x7fbd14b923c0>,12,23,[6 4],13,-1,53,-1,30
1,<environment.Job instance at 0x7fbd14c42dc0>,18,26,[7 4],19,-1,70,-1,44
1,<environment.Job instance at 0x7fbd14cbb5a0>,19,25,[5 9],20,-1,83,-1,58
1,<environment.Job instance at 0x7fbd14cb9dc0>,28,17,[ 1 13],29,-1,87,-1,70
1,<environment.Job instance at 0x7fbd14c47640>,30,26,[9 4],31,-1,110,-1,84
1,<environment.Job instance at 0x7fbd14b83500>,31,1,[ 2 14],32,-1,85,-1,84
1,<environment.Job instance at 0x7fbd14b6f960>,33,26,[3 6],34,-1,110,-1,84
1,<environment.Job instance at 0x7fbd14b7b820>,40,26,[ 1 10],41,-1,139,-1,113
1,<environment.Job instance at 0x7fbd14b8c3c0>,57,16,[ 2 11],58,-1,183,-1,167
1,<environment.Job instance at 0x7fbd14b33a50>,89,17,[ 5 14],90,-1,289,-1,272
1,<environment.Job instance at 0x7fbd14b33cd0>,93,25,[ 1 10],94,-1,320,-1,295
1,<environment.Job instance at 0x7fbd14b35870>,109,27,[3 9],110,-1,371,-1,344
1,<environment.Job instance at 0x7fbd14b35910>,110,23,[5 1],111,-1,367,-1,344
1,<environment.Job instance at 0x7fbd14b35f00>,117,3,[ 3 13],118,-1,367,-1,364
1,<environment.Job instance at 0x7fbd14b38050>,119,28,[7 5],120,-1,406,-1,378
1,<environment.Job instance at 0x7fbd14b380f0>,120,19,[ 5 12],121,-1,397,-1,378
1,<environment.Job instance at 0x7fbd14b38cd0>,137,28,[ 2 10],138,-1,458,-1,430
1,<environment.Job instance at 0x7fbd14b3a1e0>,142,15,[ 2 13],143,-1,450,-1,435
1,<environment.Job instance at 0x7fbd14b3a2d0>,144,20,[13  4],145,-1,460,-1,440
1,<environment.Job instance at 0x7fbd14b3aa50>,153,1,[12  5],154,-1,473,-1,472
1,<environment.Job instance at 0x7fbd14b3adc0>,160,24,[1 5],161,-1,534,-1,510
1,<environment.Job instance at 0x7fbd14b3e190>,166,13,[ 5 14],167,-1,543,-1,530
1,<environment.Job instance at 0x7fbd145fe5a0>,0,17,[4 7],1,-1,18,-1,1
1,<environment.Job instance at 0x7fbd145fee10>,4,19,[3 8],5,-1,25,-1,6
1,<environment.Job instance at 0x7fbd145feb40>,7,16,[8 4],8,-1,24,-1,8
1,<environment.Job instance at 0x7fbd145fed20>,5,17,[5 1],6,-1,27,-1,10
1,<environment.Job instance at 0x7fbd145febe0>,10,17,[3 5],11,-1,29,-1,12
1,<environment.Job instance at 0x7fbd146076e0>,11,18,[6 2],12,-1,32,-1,14
1,<environment.Job instance at 0x7fbd14607d70>,16,17,[9 1],17,-1,35,-1,18
1,<environment.Job instance at 0x7fbd1460b550>,20,17,[9 5],21,-1,38,-1,21
1,<environment.Job instance at 0x7fbd1460b690>,24,26,[3 9],25,-1,51,-1,25
1,<environment.Job instance at 0x7fbd1460b0f0>,25,15,[5 3],26,-1,41,-1,26
1,<environment.Job instance at 0x7fbd1460b370>,28,21,[2 7],29,-1,50,-1,29
1,<environment.Job instance at 0x7fbd1460b820>,30,23,[4 7],31,-1,54,-1,31
1,<environment.Job instance at 0x7fbd1460bd70>,31,14,[ 1 10],32,-1,46,-1,32
1,<environment.Job instance at 0x7fbd14690d70>,33,14,[5 9],34,-1,48,-1,34
1,<environment.Job instance at 0x7fbd145ec190>,35,19,[ 1 10],36,-1,55,-1,36
1,<environment.Job instance at 0x7fbd145ec1e0>,36,16,[6 5],37,-1,53,-1,37
1,<environment.Job instance at 0x7fbd146c43c0>,38,20,[ 2 10],39,-1,59,-1,39
1,<environment.Job instance at 0x7fbd147a42d0>,39,15,[5 5],40,-1,55,-1,40
1,<environment.Job instance at 0x7fbd1465ac80>,41,17,[3 6],42,-1,59,-1,42
1,<environment.Job instance at 0x7fbd1465a730>,44,16,[5 6],45,-1,61,-1,45
1,<environment.Job instance at 0x7fbd1465a3c0>,45,21,[1 6],46,-1,67,-1,46
1,<environment.Job instance at 0x7fbd1465ab40>,46,16,[1 8],47,-1,63,-1,47
1,<environment.Job instance at 0x7fbd1465a050>,48,23,[1 9],49,-1,72,-1,49
1,<environment.Job instance at 0x7fbd1465a1e0>,49,17,[8 5],50,-1,67,-1,50
1,<environment.Job instance at 0x7fbd14543a50>,54,15,[8 5],55,-1,70,-1,55
1,<environment.Job instance at 0x7fbd1461f4b0>,58,19,[4 7],59,-1,78,-1,59
1,<environment.Job instance at 0x7fbd145fe640>,3,24,[3 7],4,-1,39,-1,15
1,<environment.Job instance at 0x7fbd14b3ac30>,18,27,[ 3 12],19,-1,52,-1,25
1,<environment.Job instance at 0x7fbd14b35c30>,22,15,[ 2 14],23,-1,55,-1,40
1,<environment.Job instance at 0x7fbd14b35b40>,24,26,[3 9],25,-1,81,-1,55
1,<environment.Job instance at 0x7fbd14b35370>,30,23,[4 7],31,-1,83,-1,60
1,<environment.Job instance at 0x7fbd14b33d20>,40,1,[14  4],41,-1,85,-1,84
1,<environment.Job instance at 0x7fbd14b338c0>,47,18,[ 1 14],48,-1,132,-1,114
1,<environment.Job instance at 0x7fbd14b33870>,48,23,[1 9],49,-1,153,-1,130
1,<environment.Job instance at 0x7fbd14b33230>,55,17,[12  1],56,-1,150,-1,133
1,<environment.Job instance at 0x7fbd14ba4e10>,60,16,[14  3],61,-1,170,-1,154
1,<environment.Job instance at 0x7fbd14398140>,67,2,[ 1 12],68,-1,187,-1,185
1,<environment.Job instance at 0x7fbd1435fc30>,75,27,[6 1],76,-1,244,-1,217
1,<environment.Job instance at 0x7fbd144855a0>,82,23,[1 8],83,-1,264,-1,241
1,<environment.Job instance at 0x7fbd1435d4b0>,93,26,[5 3],94,-1,289,-1,263
1,<environment.Job instance at 0x7fbd143ed460>,109,26,[2 8],110,-1,366,-1,340
1,<environment.Job instance at 0x7fbd142f60a0>,117,27,[9 5],118,-1,409,-1,382
1,<environment.Job instance at 0x7fbd142f6460>,119,14,[12  2],120,-1,396,-1,382
1,<environment.Job instance at 0x7fbd14339af0>,131,17,[ 5 14],132,-1,441,-1,424
1,<environment.Job instance at 0x7fbd14339c30>,132,25,[ 3 11],133,-1,449,-1,424
1,<environment.Job instance at 0x7fbd143112d0>,134,17,[13  5],135,-1,442,-1,425
1,<environment.Job instance at 0x7fbd1430c640>,135,13,[ 5 14],136,-1,438,-1,425
1,<environment.Job instance at 0x7fbd14327fa0>,155,27,[4 5],156,-1,539,-1,512
1,<environment.Job instance at 0x7fbd14327f50>,157,12,[13  4],158,-1,524,-1,512
1,<environment.Job instance at 0x7fbd14320cd0>,158,12,[ 5 12],159,-1,524,-1,512
1,<environment.Job instance at 0x7fbd142c43c0>,2,17,[5 9],3,-1,20,-1,3
1,<environment.Job instance at 0x7fbd142c4c80>,4,21,[4 9],5,-1,26,-1,5
1,<environment.Job instance at 0x7fbd142bfaf0>,17,14,[3 6],18,-1,33,-1,19
1,<environment.Job instance at 0x7fbd142bfaa0>,20,26,[8 3],21,-1,47,-1,21
1,<environment.Job instance at 0x7fbd142bfe60>,24,14,[3 8],25,-1,39,-1,25
1,<environment.Job instance at 0x7fbd142ba6e0>,28,16,[5 2],29,-1,45,-1,29
1,<environment.Job instance at 0x7fbd142ba550>,31,18,[5 8],32,-1,50,-1,32
1,<environment.Job instance at 0x7fbd142ba820>,32,14,[2 8],33,-1,47,-1,33
1,<environment.Job instance at 0x7fbd142bad20>,35,15,[1 5],36,-1,51,-1,36
1,<environment.Job instance at 0x7fbd143deaf0>,37,13,[ 5 10],38,-1,51,-1,38
1,<environment.Job instance at 0x7fbd143deaa0>,39,18,[5 2],40,-1,58,-1,40
1,<environment.Job instance at 0x7fbd143deb90>,40,16,[ 4 10],41,-1,57,-1,41
1,<environment.Job instance at 0x7fbd143de320>,41,15,[5 7],42,-1,57,-1,42
1,<environment.Job instance at 0x7fbd143de7d0>,42,17,[8 2],43,-1,60,-1,43
1,<environment.Job instance at 0x7fbd143de640>,44,17,[6 1],45,-1,62,-1,45
1,<environment.Job instance at 0x7fbd142b78c0>,46,17,[7 4],47,-1,64,-1,47
1,<environment.Job instance at 0x7fbd142b79b0>,49,18,[10  4],50,-1,69,-1,51
1,<environment.Job instance at 0x7fbd142b70f0>,54,18,[10  5],55,-1,73,-1,55
1,<environment.Job instance at 0x7fbd142b7280>,56,16,[2 9],57,-1,73,-1,57
1,<environment.Job instance at 0x7fbd142b28c0>,58,15,[10  4],59,-1,75,-1,60
1,<environment.Job instance at 0x7fbd142bfeb0>,26,18,[8 3],27,-1,81,-1,63
1,<environment.Job instance at 0x7fbd142b2af0>,62,27,[8 3],63,-1,91,-1,64
1,<environment.Job instance at 0x7fbd142b2a00>,60,16,[8 5],61,-1,80,-1,64
1,<environment.Job instance at 0x7fbd142b24b0>,67,16,[7 4],68,-1,85,-1,69
1,<environment.Job instance at 0x7fbd142ae780>,71,16,[4 5],72,-1,127,-1,111
1,<environment.Job instance at 0x7fbd142ae230>,82,16,[6 4],83,-1,128,-1,112
1,<environment.Job instance at 0x7fbd142b2230>,63,18,[1 6],64,-1,147,-1,129
1,<environment.Job instance at 0x7fbd142acf50>,86,21,[ 4 10],87,-1,150,-1,129
1,<environment.Job instance at 0x7fbd142ac500>,94,13,[ 4 11],95,-1,161,-1,148
1,<environment.Job instance at 0x7fbd143276e0>,95,17,[ 5 10],96,-1,166,-1,149
1,<environment.Job instance at 0x7fbd143275a0>,99,17,[12  4],100,-1,175,-1,158
1,<environment.Job instance at 0x7fbd143279b0>,100,25,[6 4],101,-1,183,-1,158
1,<environment.Job instance at 0x7fbd14327500>,96,14,[9 4],97,-1,173,-1,159
1,<environment.Job instance at 0x7fbd14327870>,98,14,[8 2],99,-1,173,-1,159
1,<environment.Job instance at 0x7fbd14572820>,103,13,[ 4 10],104,-1,172,-1,159
1,<environment.Job instance at 0x7fbd1435c3c0>,104,24,[5 5],105,-1,187,-1,163
1,<environment.Job instance at 0x7fbd1435c140>,108,28,[ 5 10],109,-1,191,-1,163
1,<environment.Job instance at 0x7fbd1435c8c0>,109,15,[9 5],110,-1,184,-1,169
1,<environment.Job instance at 0x7fbd142acf00>,85,13,[7 4],86,-1,183,-1,170
1,<environment.Job instance at 0x7fbd1427d690>,111,17,[7 5],112,-1,187,-1,170
1,<environment.Job instance at 0x7fbd14db0870>,117,13,[3 7],118,-1,188,-1,175
1,<environment.Job instance at 0x7fbd14db0dc0>,116,12,[ 5 12],117,-1,187,-1,175
1,<environment.Job instance at 0x7fbd142db4b0>,144,17,[14  5],145,-1,309,-1,292
1,<environment.Job instance at 0x7fbd1419f870>,147,18,[8 2],148,-1,318,-1,300
1,<environment.Job instance at 0x7fbd142b2410>,66,27,[2 6],67,-1,327,-1,300
1,<environment.Job instance at 0x7fbd1497a0f0>,135,20,[7 5],136,-1,335,-1,315
1,<environment.Job instance at 0x7fbd1419f230>,152,17,[4 5],153,-1,332,-1,315
1,<environment.Job instance at 0x7fbd141a2320>,156,16,[1 9],157,-1,331,-1,315
1,<environment.Job instance at 0x7fbd141a2280>,157,16,[7 2],158,-1,331,-1,315
1,<environment.Job instance at 0x7fbd15032820>,154,2,[9 4],155,-1,317,-1,315
1,<environment.Job instance at 0x7fbd141a2050>,155,17,[8 2],156,-1,333,-1,316
1,<environment.Job instance at 0x7fbd141dce60>,162,16,[10  4],163,-1,332,-1,316
1,<environment.Job instance at 0x7fbd141dcb40>,163,16,[6 5],164,-1,332,-1,316
1,<environment.Job instance at 0x7fbd141dc870>,164,16,[9 5],165,-1,332,-1,316
1,<environment.Job instance at 0x7fbd148fe9b0>,166,22,[1 8],167,-1,340,-1,318
1,<environment.Job instance at 0x7fbd148fe4b0>,167,28,[5 9],168,-1,346,-1,318
1,<environment.Job instance at 0x7fbd142bffa0>,7,13,[12  1],8,-1,21,-1,8
1,<environment.Job instance at 0x7fbd142b2910>,8,12,[14  3],9,-1,21,-1,9
1,<environment.Job instance at 0x7fbd142b2b90>,9,1,[ 4 11],10,-1,11,-1,10
1,<environment.Job instance at 0x7fbd141481e0>,16,25,[2 8],17,-1,48,-1,23
1,<environment.Job instance at 0x7fbd141dc500>,20,26,[8 3],21,-1,72,-1,46
1,<environment.Job instance at 0x7fbd14277870>,34,2,[11  3],35,-1,73,-1,71
1,<environment.Job instance at 0x7fbd1457c3c0>,45,17,[12  4],46,-1,134,-1,117
1,<environment.Job instance at 0x7fbd1428c320>,57,2,[ 3 11],58,-1,167,-1,165
1,<environment.Job instance at 0x7fbd144522d0>,62,27,[8 3],63,-1,226,-1,199
1,<environment.Job instance at 0x7fbd14452370>,66,27,[2 6],67,-1,243,-1,216
1,<environment.Job instance at 0x7fbd14327e10>,70,14,[ 4 14],71,-1,246,-1,232
1,<environment.Job instance at 0x7fbd14323500>,87,23,[2 8],88,-1,300,-1,277
1,<environment.Job instance at 0x7fbd143239b0>,88,3,[11  1],89,-1,280,-1,277
1,<environment.Job instance at 0x7fbd14323550>,89,19,[13  3],90,-1,296,-1,277
1,<environment.Job instance at 0x7fbd1431d280>,94,13,[ 4 11],95,-1,312,-1,299
1,<environment.Job instance at 0x7fbd1431da00>,99,17,[12  4],100,-1,332,-1,315
1,<environment.Job instance at 0x7fbd1431d870>,100,25,[6 4],101,-1,341,-1,316
1,<environment.Job instance at 0x7fbd1431db40>,102,3,[14  5],103,-1,319,-1,316
1,<environment.Job instance at 0x7fbd1431df00>,104,24,[5 5],105,-1,354,-1,330
1,<environment.Job instance at 0x7fbd14320e10>,108,28,[ 5 10],109,-1,372,-1,344
1,<environment.Job instance at 0x7fbd143204b0>,116,12,[ 5 12],117,-1,374,-1,362
1,<environment.Job instance at 0x7fbd14320aa0>,119,2,[ 5 14],120,-1,378,-1,376
1,<environment.Job instance at 0x7fbd1431ad70>,131,16,[ 1 14],132,-1,449,-1,433
1,<environment.Job instance at 0x7fbd143147d0>,144,17,[14  5],145,-1,478,-1,461
1,<environment.Job instance at 0x7fbd14314aa0>,151,2,[14  5],152,-1,479,-1,477
1,<environment.Job instance at 0x7fbd14311410>,167,28,[5 9],168,-1,580,-1,552
1,<environment.Job instance at 0x7fbd14466550>,0,18,[ 2 10],1,-1,20,-1,2
1,<environment.Job instance at 0x7fbd140ff370>,2,13,[1 5],3,-1,16,-1,3
1,<environment.Job instance at 0x7fbd1445f280>,1,15,[8 1],2,-1,18,-1,3
1,<environment.Job instance at 0x7fbd140ff6e0>,6,18,[ 5 10],7,-1,25,-1,7
1,<environment.Job instance at 0x7fbd140ff5a0>,8,13,[9 1],9,-1,22,-1,9
1,<environment.Job instance at 0x7fbd140ffaa0>,11,14,[9 2],12,-1,27,-1,13
1,<environment.Job instance at 0x7fbd140ffa50>,13,2,[7 2],14,-1,16,-1,14
1,<environment.Job instance at 0x7fbd140ffa00>,12,26,[5 8],13,-1,40,-1,14
1,<environment.Job instance at 0x7fbd140ffe10>,16,2,[ 5 13],17,-1,19,-1,17
1,<environment.Job instance at 0x7fbd140ffc80>,17,1,[6 2],18,-1,19,-1,18
1,<environment.Job instance at 0x7fbd140fff50>,18,15,[2 8],19,-1,34,-1,19
1,<environment.Job instance at 0x7fbd140ffe60>,19,18,[1 7],20,-1,38,-1,20
1,<environment.Job instance at 0x7fbd14102320>,22,17,[8 1],23,-1,41,-1,24
1,<environment.Job instance at 0x7fbd14102280>,23,22,[3 5],24,-1,46,-1,24
1,<environment.Job instance at 0x7fbd14102500>,25,18,[4 6],26,-1,44,-1,26
1,<environment.Job instance at 0x7fbd14102780>,29,18,[3 8],30,-1,48,-1,30
1,<environment.Job instance at 0x7fbd141029b0>,31,12,[1 6],32,-1,44,-1,32
1,<environment.Job instance at 0x7fbd14102910>,32,21,[5 7],33,-1,54,-1,33
1,<environment.Job instance at 0x7fbd14102eb0>,35,16,[4 7],36,-1,52,-1,36
1,<environment.Job instance at 0x7fbd14102c30>,36,18,[9 3],37,-1,55,-1,37
1,<environment.Job instance at 0x7fbd14104140>,38,16,[1 7],39,-1,55,-1,39
1,<environment.Job instance at 0x7fbd14104280>,39,18,[8 2],40,-1,58,-1,40
1,<environment.Job instance at 0x7fbd14104690>,43,17,[4 7],44,-1,61,-1,44
1,<environment.Job instance at 0x7fbd141047d0>,44,16,[ 5 10],45,-1,61,-1,45
1,<environment.Job instance at 0x7fbd14104730>,45,15,[5 9],46,-1,61,-1,46
1,<environment.Job instance at 0x7fbd14104c80>,50,26,[3 7],51,-1,77,-1,51
1,<environment.Job instance at 0x7fbd14105140>,54,16,[1 5],55,-1,71,-1,55
1,<environment.Job instance at 0x7fbd141052d0>,55,18,[4 9],56,-1,74,-1,56
1,<environment.Job instance at 0x7fbd141053c0>,57,18,[10  5],58,-1,76,-1,58
1,<environment.Job instance at 0x7fbd14105550>,60,13,[10  1],61,-1,74,-1,61
1,<environment.Job instance at 0x7fbd140f54b0>,62,24,[1 9],63,-1,87,-1,63
1,<environment.Job instance at 0x7fbd140f5640>,63,14,[6 5],64,-1,78,-1,64
1,<environment.Job instance at 0x7fbd140f5870>,64,12,[9 3],65,-1,77,-1,65
1,<environment.Job instance at 0x7fbd140f5550>,66,12,[10  1],67,-1,79,-1,67
1,<environment.Job instance at 0x7fbd14ad1e60>,70,17,[5 6],71,-1,88,-1,71
1,<environment.Job instance at 0x7fbd149217d0>,75,21,[ 2 10],76,-1,103,-1,82
1,<environment.Job instance at 0x7fbd147918c0>,76,15,[10  2],77,-1,99,-1,84
1,<environment.Job instance at 0x7fbd1451e280>,82,16,[12  1],83,-1,210,-1,194
1,<environment.Job instance at 0x7fbd1488bfa0>,93,24,[2 6],94,-1,221,-1,197
1,<environment.Job instance at 0x7fbd14feca00>,96,14,[8 4],97,-1,211,-1,197
1,<environment.Job instance at 0x7fbd1451b320>,90,17,[10  2],91,-1,229,-1,212
1,<environment.Job instance at 0x7fbd14883e10>,102,18,[6 2],103,-1,231,-1,213
1,<environment.Job instance at 0x7fbd14511b90>,100,14,[5 8],101,-1,227,-1,213
1,<environment.Job instance at 0x7fbd14511c30>,101,2,[5 5],102,-1,215,-1,213
1,<environment.Job instance at 0x7fbd148835f0>,105,19,[6 3],106,-1,232,-1,213
1,<environment.Job instance at 0x7fbd14883500>,104,18,[6 2],105,-1,231,-1,213
1,<environment.Job instance at 0x7fbd14889690>,108,13,[1 5],109,-1,226,-1,213
1,<environment.Job instance at 0x7fbd14896320>,112,27,[5 7],113,-1,246,-1,219
1,<environment.Job instance at 0x7fbd1488f190>,115,16,[9 2],116,-1,235,-1,219
1,<environment.Job instance at 0x7fbd1488fc30>,116,15,[10  3],117,-1,234,-1,219
1,<environment.Job instance at 0x7fbd1488f910>,117,15,[9 1],118,-1,234,-1,219
1,<environment.Job instance at 0x7fbd1488fbe0>,118,15,[11  4],119,-1,234,-1,219
1,<environment.Job instance at 0x7fbd14896cd0>,111,14,[3 6],112,-1,233,-1,219
1,<environment.Job instance at 0x7fbd1488f7d0>,119,17,[5 2],120,-1,236,-1,219
1,<environment.Job instance at 0x7fbd14501640>,131,18,[4 9],132,-1,1746,-1,1728
1,<environment.Job instance at 0x7fbd145010f0>,139,16,[7 4],140,-1,1744,-1,1728
1,<environment.Job instance at 0x7fbd14501820>,140,18,[ 4 11],141,-1,1746,-1,1728
1,<environment.Job instance at 0x7fbd14501e10>,137,14,[11  4],138,-1,1742,-1,1728
1,<environment.Job instance at 0x7fbd14501960>,141,18,[ 3 10],142,-1,1746,-1,1728
1,<environment.Job instance at 0x7fbd14501aa0>,143,24,[8 5],144,-1,1752,-1,1728
1,<environment.Job instance at 0x7fbd145018c0>,142,12,[7 2],143,-1,1740,-1,1728
1,<environment.Job instance at 0x7fbd14512a00>,81,17,[11  3],82,-1,1745,-1,1728
1,<environment.Job instance at 0x7fbd14501730>,144,14,[ 1 10],145,-1,1774,-1,1760
1,<environment.Job instance at 0x7fbd144f2d20>,153,15,[ 3 10],154,-1,1775,-1,1760
1,<environment.Job instance at 0x7fbd144f2140>,155,15,[5 6],156,-1,1775,-1,1760
1,<environment.Job instance at 0x7fbd145012d0>,145,13,[5 7],146,-1,1776,-1,1763
1,<environment.Job instance at 0x7fbd144f23c0>,158,20,[3 9],159,-1,1783,-1,1763
1,<environment.Job instance at 0x7fbd144f27d0>,161,17,[ 4 10],162,-1,1782,-1,1765
1,<environment.Job instance at 0x7fbd144f2fa0>,151,15,[8 1],152,-1,1780,-1,1765
1,<environment.Job instance at 0x7fbd144f2cd0>,164,17,[3 5],165,-1,1782,-1,1765
1,<environment.Job instance at 0x7fbd144f2050>,167,21,[4 8],168,-1,1786,-1,1765
1,<environment.Job instance at 0x7fbd144f2190>,168,23,[3 9],169,-1,1788,-1,1765
1,<environment.Job instance at 0x7fbd14104f00>,51,18,[11  5],52,-1,1783,-1,1765
1,<environment.Job instance at 0x7fbd140f5d20>,7,28,[9 1],8,-1,47,-1,19
1,<environment.Job instance at 0x7fbd144f26e0>,12,26,[5 8],13,-1,53,-1,27
1,<environment.Job instance at 0x7fbd148a1320>,16,2,[ 5 13],17,-1,35,-1,33
1,<environment.Job instance at 0x7fbd140f2730>,21,1,[13  4],22,-1,38,-1,37
1,<environment.Job instance at 0x7fbd140ef9b0>,28,2,[12  3],29,-1,67,-1,65
1,<environment.Job instance at 0x7fbd140ef7d0>,27,28,[ 5 10],28,-1,128,-1,100
1,<environment.Job instance at 0x7fbd143145f0>,50,26,[3 7],51,-1,181,-1,155
1,<environment.Job instance at 0x7fbd143142d0>,51,18,[11  5],52,-1,173,-1,155
1,<environment.Job instance at 0x7fbd1431ab40>,59,1,[12  2],60,-1,175,-1,174
1,<environment.Job instance at 0x7fbd1431a6e0>,62,24,[1 9],63,-1,213,-1,189
1,<environment.Job instance at 0x7fbd1431adc0>,71,27,[7 1],72,-1,249,-1,222
1,<environment.Job instance at 0x7fbd14320a00>,73,2,[ 3 13],74,-1,224,-1,222
1,<environment.Job instance at 0x7fbd14320d20>,72,26,[ 3 10],73,-1,258,-1,232
1,<environment.Job instance at 0x7fbd14320910>,77,1,[ 3 14],78,-1,233,-1,232
1,<environment.Job instance at 0x7fbd14320c80>,78,12,[ 2 11],79,-1,244,-1,232
1,<environment.Job instance at 0x7fbd14320690>,81,17,[11  3],82,-1,251,-1,234
1,<environment.Job instance at 0x7fbd143207d0>,82,16,[12  1],83,-1,250,-1,234
1,<environment.Job instance at 0x7fbd143208c0>,83,15,[ 4 13],84,-1,249,-1,234
1,<environment.Job instance at 0x7fbd1431da00>,93,24,[2 6],94,-1,304,-1,280
1,<environment.Job instance at 0x7fbd1431daa0>,94,13,[ 5 12],95,-1,293,-1,280
1,<environment.Job instance at 0x7fbd1431dbe0>,95,2,[ 2 11],96,-1,282,-1,280
1,<environment.Job instance at 0x7fbd14323fa0>,112,27,[5 7],113,-1,367,-1,340
1,<environment.Job instance at 0x7fbd14327f00>,114,24,[13  2],115,-1,364,-1,340
1,<environment.Job instance at 0x7fbd143271e0>,118,15,[11  4],119,-1,369,-1,354
1,<environment.Job instance at 0x7fbd14327fa0>,121,14,[ 4 13],122,-1,386,-1,372
1,<environment.Job instance at 0x7fbd14454500>,137,14,[11  4],138,-1,445,-1,431
1,<environment.Job instance at 0x7fbd142db730>,140,18,[ 4 11],141,-1,467,-1,449
1,<environment.Job instance at 0x7fbd14545410>,143,24,[8 5],144,-1,488,-1,464
1,<environment.Job instance at 0x7fbd142c4f50>,148,13,[12  1],149,-1,493,-1,480
1,<environment.Job instance at 0x7fbd142d9a00>,156,3,[14  2],157,-1,513,-1,510
1,<environment.Job instance at 0x7fbd15032f00>,163,14,[ 5 13],164,-1,557,-1,543
1,<environment.Job instance at 0x7fbd142ac690>,168,23,[3 9],169,-1,587,-1,564
1,<environment.Job instance at 0x7fbd150f3af0>,4,18,[6 4],5,-1,23,-1,5
1,<environment.Job instance at 0x7fbd150f37d0>,5,15,[4 7],6,-1,21,-1,6
1,<environment.Job instance at 0x7fbd150f3f00>,7,17,[8 4],8,-1,25,-1,8
1,<environment.Job instance at 0x7fbd150f3460>,8,16,[1 7],9,-1,25,-1,9
1,<environment.Job instance at 0x7fbd150f36e0>,9,15,[ 2 10],10,-1,25,-1,10
1,<environment.Job instance at 0x7fbd14fa8be0>,21,16,[8 4],22,-1,38,-1,22
1,<environment.Job instance at 0x7fbd14fa8690>,23,18,[6 4],24,-1,42,-1,24
1,<environment.Job instance at 0x7fbd14eef460>,33,15,[6 2],34,-1,49,-1,34
1,<environment.Job instance at 0x7fbd14eef3c0>,34,1,[6 4],35,-1,36,-1,35
1,<environment.Job instance at 0x7fbd14eefa00>,35,21,[9 5],36,-1,57,-1,36
1,<environment.Job instance at 0x7fbd14eef280>,36,18,[10  5],37,-1,55,-1,37
1,<environment.Job instance at 0x7fbd14eefd70>,37,14,[1 9],38,-1,52,-1,38
1,<environment.Job instance at 0x7fbd14eef820>,38,12,[7 5],39,-1,51,-1,39
1,<environment.Job instance at 0x7fbd14e16f00>,41,16,[1 6],42,-1,58,-1,42
1,<environment.Job instance at 0x7fbd14e16500>,43,27,[3 5],44,-1,71,-1,44
1,<environment.Job instance at 0x7fbd14e16050>,46,12,[4 8],47,-1,60,-1,48
1,<environment.Job instance at 0x7fbd14e16a00>,48,12,[7 5],49,-1,61,-1,49
1,<environment.Job instance at 0x7fbd14e16c80>,49,12,[1 9],50,-1,62,-1,50
1,<environment.Job instance at 0x7fbd14f694b0>,53,12,[9 3],54,-1,66,-1,54
1,<environment.Job instance at 0x7fbd14f69dc0>,54,12,[1 5],55,-1,67,-1,55
1,<environment.Job instance at 0x7fbd14f69f50>,55,14,[5 2],56,-1,70,-1,56
1,<environment.Job instance at 0x7fbd14f69d20>,56,12,[6 4],57,-1,69,-1,57
1,<environment.Job instance at 0x7fbd14f69a00>,57,17,[2 6],58,-1,75,-1,58
1,<environment.Job instance at 0x7fbd14f69a50>,58,17,[5 4],59,-1,76,-1,59
1,<environment.Job instance at 0x7fbd14f695a0>,60,16,[9 4],61,-1,77,-1,61
1,<environment.Job instance at 0x7fbd14f69c30>,63,13,[5 6],64,-1,77,-1,64
1,<environment.Job instance at 0x7fbd1524df00>,65,18,[3 9],66,-1,84,-1,66
1,<environment.Job instance at 0x7fbd1524d230>,66,27,[10  4],67,-1,94,-1,67
1,<environment.Job instance at 0x7fbd1524d140>,68,14,[4 5],69,-1,83,-1,69
1,<environment.Job instance at 0x7fbd1524dfa0>,69,14,[9 4],70,-1,84,-1,70
1,<environment.Job instance at 0x7fbd1524da00>,71,18,[4 8],72,-1,90,-1,72
1,<environment.Job instance at 0x7fbd1524d0f0>,72,25,[7 3],73,-1,98,-1,73
1,<environment.Job instance at 0x7fbd1524d820>,74,13,[ 3 12],75,-1,88,-1,75
1,<environment.Job instance at 0x7fbd14e16780>,47,17,[5 7],48,-1,93,-1,76
1,<environment.Job instance at 0x7fbd1497eb40>,76,17,[2 9],77,-1,95,-1,78
1,<environment.Job instance at 0x7fbd1497e0a0>,80,16,[10  3],81,-1,97,-1,81
1,<environment.Job instance at 0x7fbd1497edc0>,81,17,[10  5],82,-1,99,-1,82
1,<environment.Job instance at 0x7fbd1497e7d0>,83,17,[6 1],84,-1,101,-1,84
1,<environment.Job instance at 0x7fbd1497e960>,86,13,[8 5],87,-1,100,-1,87
1,<environment.Job instance at 0x7fbd14e9c8c0>,89,18,[5 2],90,-1,108,-1,90
1,<environment.Job instance at 0x7fbd1495d370>,97,16,[2 7],98,-1,114,-1,98
1,<environment.Job instance at 0x7fbd1495ddc0>,98,15,[6 2],99,-1,114,-1,99
1,<environment.Job instance at 0x7fbd1495d280>,99,14,[7 2],100,-1,114,-1,100
1,<environment.Job instance at 0x7fbd1495d0a0>,100,18,[1 7],101,-1,119,-1,101
1,<environment.Job instance at 0x7fbd1495d690>,101,14,[1 7],102,-1,116,-1,102
1,<environment.Job instance at 0x7fbd140f9be0>,102,14,[8 5],103,-1,117,-1,103
1,<environment.Job instance at 0x7fbd148dd4b0>,106,20,[4 8],107,-1,127,-1,107
1,<environment.Job instance at 0x7fbd148dd050>,108,16,[8 4],109,-1,125,-1,109
1,<environment.Job instance at 0x7fbd1524b280>,110,25,[5 4],111,-1,136,-1,111
1,<environment.Job instance at 0x7fbd14ca7aa0>,111,21,[5 5],112,-1,133,-1,112
1,<environment.Job instance at 0x7fbd14dadf50>,113,18,[ 2 10],114,-1,134,-1,116
1,<environment.Job instance at 0x7fbd149eaaa0>,116,12,[5 9],117,-1,129,-1,117
1,<environment.Job instance at 0x7fbd1520b8c0>,117,22,[5 8],118,-1,140,-1,118
1,<environment.Job instance at 0x7fbd14c13dc0>,120,15,[3 8],121,-1,136,-1,121
1,<environment.Job instance at 0x7fbd1495d500>,123,27,[8 5],124,-1,151,-1,124
1,<environment.Job instance at 0x7fbd14e1b4b0>,133,24,[3 5],134,-1,158,-1,134
1,<environment.Job instance at 0x7fbd14e1b140>,134,14,[4 6],135,-1,149,-1,135
1,<environment.Job instance at 0x7fbd14e1b6e0>,135,14,[10  1],136,-1,150,-1,136
1,<environment.Job instance at 0x7fbd151cfaf0>,115,25,[5 7],116,-1,162,-1,137
1,<environment.Job instance at 0x7fbd151cf050>,114,13,[7 3],115,-1,153,-1,140
1,<environment.Job instance at 0x7fbd149ebc80>,136,15,[3 6],137,-1,155,-1,140
1,<environment.Job instance at 0x7fbd149ebf50>,140,15,[6 3],141,-1,156,-1,141
1,<environment.Job instance at 0x7fbd149ebeb0>,141,18,[5 9],142,-1,160,-1,142
1,<environment.Job instance at 0x7fbd149ebd20>,143,18,[3 7],144,-1,162,-1,144
1,<environment.Job instance at 0x7fbd149eb140>,138,15,[5 5],139,-1,164,-1,149
1,<environment.Job instance at 0x7fbd14e8f3c0>,151,15,[6 3],152,-1,167,-1,152
1,<environment.Job instance at 0x7fbd14e8fbe0>,150,18,[2 7],151,-1,172,-1,154
1,<environment.Job instance at 0x7fbd1495da50>,124,12,[ 5 13],125,-1,167,-1,155
1,<environment.Job instance at 0x7fbd14e8f910>,153,13,[5 2],154,-1,168,-1,155
1,<environment.Job instance at 0x7fbd14e8fa00>,155,13,[8 4],156,-1,169,-1,156
1,<environment.Job instance at 0x7fbd14e8fb40>,156,13,[6 5],157,-1,170,-1,157
1,<environment.Job instance at 0x7fbd14e8f550>,157,13,[12  5],158,-1,171,-1,158
1,<environment.Job instance at 0x7fbd14e8f640>,154,23,[4 5],155,-1,181,-1,158
1,<environment.Job instance at 0x7fbd14e8f6e0>,158,12,[5 5],159,-1,172,-1,160
1,<environment.Job instance at 0x7fbd1496e4b0>,164,18,[3 6],165,-1,184,-1,166
1,<environment.Job instance at 0x7fbd149eb5f0>,144,27,[1 8],145,-1,193,-1,166
1,<environment.Job instance at 0x7fbd1496eb90>,163,14,[ 4 11],164,-1,180,-1,166
1,<environment.Job instance at 0x7fbd1496e870>,166,26,[8 5],167,-1,193,-1,167
1,<environment.Job instance at 0x7fbd14e8f0a0>,159,18,[7 4],160,-1,188,-1,170
1,<environment.Job instance at 0x7fbd1524d960>,10,2,[ 1 11],11,-1,19,-1,17
1,<environment.Job instance at 0x7fbd151cfd20>,17,12,[ 3 14],18,-1,47,-1,35
1,<environment.Job instance at 0x7fbd14e8f1e0>,28,16,[13  3],29,-1,75,-1,59
1,<environment.Job instance at 0x7fbd14454820>,43,27,[3 5],44,-1,135,-1,108
1,<environment.Job instance at 0x7fbd14454500>,44,1,[12  4],45,-1,109,-1,108
1,<environment.Job instance at 0x7fbd14454f50>,45,2,[14  1],46,-1,110,-1,108
1,<environment.Job instance at 0x7fbd143235f0>,66,27,[10  4],67,-1,226,-1,199
1,<environment.Job instance at 0x7fbd1431d2d0>,70,1,[ 5 11],71,-1,201,-1,200
1,<environment.Job instance at 0x7fbd1431d320>,72,25,[7 3],73,-1,255,-1,230
1,<environment.Job instance at 0x7fbd1431d0a0>,74,13,[ 3 12],75,-1,243,-1,230
1,<environment.Job instance at 0x7fbd143205f0>,88,14,[13  2],89,-1,302,-1,288
1,<environment.Job instance at 0x7fbd1431a460>,105,26,[4 8],106,-1,376,-1,350
1,<environment.Job instance at 0x7fbd143110a0>,110,25,[5 4],111,-1,381,-1,356
1,<environment.Job instance at 0x7fbd140ff550>,115,25,[5 7],116,-1,397,-1,372
1,<environment.Job instance at 0x7fbd140ef910>,119,3,[11  3],120,-1,387,-1,384
1,<environment.Job instance at 0x7fbd140f23c0>,123,27,[8 5],124,-1,428,-1,401
1,<environment.Job instance at 0x7fbd140f2f00>,124,12,[ 5 13],125,-1,413,-1,401
1,<environment.Job instance at 0x7fbd140f2cd0>,129,1,[12  4],130,-1,414,-1,413
1,<environment.Job instance at 0x7fbd1488c410>,133,24,[3 5],134,-1,441,-1,417
1,<environment.Job instance at 0x7fbd141044b0>,144,27,[1 8],145,-1,507,-1,480
1,<environment.Job instance at 0x7fbd1498d370>,154,23,[4 5],155,-1,533,-1,510
1,<environment.Job instance at 0x7fbd14e534b0>,157,13,[12  5],158,-1,533,-1,520
1,<environment.Job instance at 0x7fbd14e53c80>,163,14,[ 4 11],164,-1,565,-1,551
1,<environment.Job instance at 0x7fbd14e537d0>,166,26,[8 5],167,-1,580,-1,554
1,<environment.Job instance at 0x7fbd14e53a00>,168,18,[13  1],169,-1,572,-1,554
1,<environment.Job instance at 0x7fbd150247d0>,0,17,[5 8],1,-1,18,-1,1
1,<environment.Job instance at 0x7fbd13eb3460>,3,20,[5 3],4,-1,24,-1,4
1,<environment.Job instance at 0x7fbd13de1f50>,6,14,[10  1],7,-1,24,-1,10
1,<environment.Job instance at 0x7fbd14c76370>,10,18,[5 6],11,-1,29,-1,11
1,<environment.Job instance at 0x7fbd14c76c30>,11,17,[2 9],12,-1,29,-1,12
1,<environment.Job instance at 0x7fbd14c76820>,12,2,[5 2],13,-1,15,-1,13
1,<environment.Job instance at 0x7fbd14c764b0>,9,12,[7 5],10,-1,25,-1,13
1,<environment.Job instance at 0x7fbd15310820>,14,12,[10  2],15,-1,29,-1,17
1,<environment.Job instance at 0x7fbd14ac6a50>,16,13,[9 1],17,-1,30,-1,17
1,<environment.Job instance at 0x7fbd155491e0>,17,22,[10  1],18,-1,40,-1,18
1,<environment.Job instance at 0x7fbd14d41460>,20,20,[3 8],21,-1,41,-1,21
1,<environment.Job instance at 0x7fbd14cc5820>,26,26,[9 5],27,-1,53,-1,27
1,<environment.Job instance at 0x7fbd14ca0910>,29,13,[8 5],30,-1,47,-1,34
1,<environment.Job instance at 0x7fbd1569ea00>,34,17,[1 8],35,-1,52,-1,35
1,<environment.Job instance at 0x7fbd1569edc0>,35,13,[4 7],36,-1,49,-1,36
1,<environment.Job instance at 0x7fbd13dc6780>,39,22,[7 3],40,-1,63,-1,41
1,<environment.Job instance at 0x7fbd13dc6550>,42,25,[7 5],43,-1,68,-1,43
1,<environment.Job instance at 0x7fbd13dc61e0>,40,15,[13  3],41,-1,64,-1,49
1,<environment.Job instance at 0x7fbd14bbb910>,53,15,[4 8],54,-1,69,-1,54
1,<environment.Job instance at 0x7fbd1563b280>,55,15,[ 4 12],56,-1,71,-1,56
1,<environment.Job instance at 0x7fbd152466e0>,48,12,[10  2],49,-1,69,-1,57
1,<environment.Job instance at 0x7fbd1563bd70>,56,18,[5 8],57,-1,75,-1,57
1,<environment.Job instance at 0x7fbd14f7edc0>,59,17,[ 2 10],60,-1,78,-1,61
1,<environment.Job instance at 0x7fbd1571ecd0>,61,18,[8 1],62,-1,81,-1,63
1,<environment.Job instance at 0x7fbd1571e0f0>,62,15,[3 9],63,-1,78,-1,63
1,<environment.Job instance at 0x7fbd156794b0>,50,16,[ 2 10],51,-1,80,-1,64
1,<environment.Job instance at 0x7fbd14684c30>,67,27,[8 5],68,-1,95,-1,68
1,<environment.Job instance at 0x7fbd15609280>,63,20,[8 4],64,-1,91,-1,71
1,<environment.Job instance at 0x7fbd151cab40>,71,15,[2 7],72,-1,87,-1,72
1,<environment.Job instance at 0x7fbd150fc1e0>,73,16,[5 2],74,-1,91,-1,75
1,<environment.Job instance at 0x7fbd150fc550>,75,13,[10  5],76,-1,89,-1,76
1,<environment.Job instance at 0x7fbd150fc7d0>,76,17,[7 3],77,-1,94,-1,77
1,<environment.Job instance at 0x7fbd1529ac80>,81,17,[9 4],82,-1,118,-1,101
1,<environment.Job instance at 0x7fbd1529ae60>,82,24,[4 6],83,-1,125,-1,101
1,<environment.Job instance at 0x7fbd13e5d3c0>,83,15,[ 2 13],84,-1,116,-1,101
1,<environment.Job instance at 0x7fbd146d4e10>,87,18,[14  1],88,-1,119,-1,101
1,<environment.Job instance at 0x7fbd14dfb230>,84,18,[5 2],85,-1,120,-1,102
1,<environment.Job instance at 0x7fbd1563b3c0>,60,14,[6 3],61,-1,118,-1,104
1,<environment.Job instance at 0x7fbd1e301780>,90,16,[5 4],91,-1,120,-1,104
1,<environment.Job instance at 0x7fbd1532b870>,93,13,[ 3 11],94,-1,117,-1,104
1,<environment.Job instance at 0x7fbd1e301730>,91,18,[7 2],92,-1,122,-1,104
1,<environment.Job instance at 0x7fbd1456eaa0>,86,12,[9 5],87,-1,116,-1,104
1,<environment.Job instance at 0x7fbd14690d70>,96,15,[11  2],97,-1,119,-1,104
1,<environment.Job instance at 0x7fbd14690e10>,97,12,[7 2],98,-1,116,-1,104
1,<environment.Job instance at 0x7fbd1e301640>,92,12,[5 2],93,-1,119,-1,107
1,<environment.Job instance at 0x7fbd14690dc0>,99,18,[ 5 10],100,-1,125,-1,107
1,<environment.Job instance at 0x7fbd152f5640>,101,15,[5 5],102,-1,122,-1,107
1,<environment.Job instance at 0x7fbd14695f00>,102,19,[2 5],103,-1,126,-1,107
1,<environment.Job instance at 0x7fbd14695c30>,106,13,[8 4],107,-1,130,-1,117
1,<environment.Job instance at 0x7fbd14690410>,100,12,[ 3 12],101,-1,129,-1,117
1,<environment.Job instance at 0x7fbd14695b90>,107,17,[6 2],108,-1,134,-1,117
1,<environment.Job instance at 0x7fbd1e36e0f0>,110,25,[10  4],111,-1,142,-1,117
1,<environment.Job instance at 0x7fbd1527c0a0>,114,13,[5 7],115,-1,133,-1,120
1,<environment.Job instance at 0x7fbd1527c050>,115,17,[8 5],116,-1,137,-1,120
1,<environment.Job instance at 0x7fbd14695e60>,108,16,[6 5],109,-1,136,-1,120
1,<environment.Job instance at 0x7fbd14695b40>,103,16,[6 1],104,-1,136,-1,120
1,<environment.Job instance at 0x7fbd1527c7d0>,119,12,[1 6],120,-1,132,-1,120
1,<environment.Job instance at 0x7fbd1527cc80>,120,18,[6 4],121,-1,142,-1,124
1,<environment.Job instance at 0x7fbd14921690>,122,15,[4 9],123,-1,139,-1,124
1,<environment.Job instance at 0x7fbd14921780>,123,18,[8 3],124,-1,144,-1,126
1,<environment.Job instance at 0x7fbd14cc53c0>,32,13,[ 3 10],33,-1,168,-1,155
1,<environment.Job instance at 0x7fbd150f8370>,138,17,[9 2],139,-1,189,-1,172
1,<environment.Job instance at 0x7fbd150f8f00>,140,27,[ 3 13],141,-1,199,-1,172
1,<environment.Job instance at 0x7fbd150f89b0>,136,20,[10  4],137,-1,270,-1,250
1,<environment.Job instance at 0x7fbd14271780>,160,27,[5 4],161,-1,314,-1,287
1,<environment.Job instance at 0x7fbd142710f0>,161,28,[7 5],162,-1,315,-1,287
1,<environment.Job instance at 0x7fbd14271af0>,163,28,[8 2],164,-1,315,-1,287
1,<environment.Job instance at 0x7fbd14cdcbe0>,153,18,[5 5],154,-1,305,-1,287
1,<environment.Job instance at 0x7fbd150f8640>,145,18,[ 3 12],146,-1,305,-1,287
1,<environment.Job instance at 0x7fbd14271320>,165,13,[ 5 10],166,-1,300,-1,287
1,<environment.Job instance at 0x7fbd14cdc6e0>,152,17,[5 9],153,-1,304,-1,287
1,<environment.Job instance at 0x7fbd147af5f0>,18,16,[13  1],19,-1,62,-1,46
1,<environment.Job instance at 0x7fbd150e3960>,21,3,[11  4],22,-1,59,-1,56
1,<environment.Job instance at 0x7fbd14fb23c0>,26,26,[9 5],27,-1,97,-1,71
1,<environment.Job instance at 0x7fbd14e8f4b0>,37,1,[ 4 12],38,-1,103,-1,102
1,<environment.Job instance at 0x7fbd14e16dc0>,40,15,[13  3],41,-1,119,-1,104
1,<environment.Job instance at 0x7fbd14e9c870>,42,25,[7 5],43,-1,131,-1,106
1,<environment.Job instance at 0x7fbd14eef8c0>,43,2,[14  5],44,-1,108,-1,106
1,<environment.Job instance at 0x7fbd14701eb0>,44,2,[13  4],45,-1,108,-1,106
1,<environment.Job instance at 0x7fbd1563b640>,46,12,[12  4],47,-1,118,-1,106
1,<environment.Job instance at 0x7fbd15024fa0>,55,15,[ 4 12],56,-1,155,-1,140
1,<environment.Job instance at 0x7fbd14c76f00>,67,27,[8 5],68,-1,219,-1,192
1,<environment.Job instance at 0x7fbd14d41410>,79,2,[ 2 12],80,-1,244,-1,242
1,<environment.Job instance at 0x7fbd14c195a0>,82,24,[4 6],83,-1,282,-1,258
1,<environment.Job instance at 0x7fbd14c195f0>,83,15,[ 2 13],84,-1,273,-1,258
1,<environment.Job instance at 0x7fbd14c19370>,87,18,[14  1],88,-1,276,-1,258
1,<environment.Job instance at 0x7fbd149236e0>,93,13,[ 3 11],94,-1,305,-1,292
1,<environment.Job instance at 0x7fbd1569e500>,96,15,[11  2],97,-1,308,-1,293
1,<environment.Job instance at 0x7fbd1569e230>,100,12,[ 3 12],101,-1,325,-1,313
1,<environment.Job instance at 0x7fbd156f5c30>,110,25,[10  4],111,-1,401,-1,376
1,<environment.Job instance at 0x7fbd13dd4af0>,127,16,[13  1],128,-1,442,-1,426
1,<environment.Job instance at 0x7fbd15578780>,131,2,[13  4],132,-1,446,-1,444
1,<environment.Job instance at 0x7fbd1e22f9b0>,140,27,[ 3 13],141,-1,523,-1,496
1,<environment.Job instance at 0x7fbd14988dc0>,143,27,[1 7],144,-1,525,-1,498
1,<environment.Job instance at 0x7fbd14d22460>,145,18,[ 3 12],146,-1,527,-1,509
1,<environment.Job instance at 0x7fbd1482adc0>,150,1,[12  1],151,-1,517,-1,516
1,<environment.Job instance at 0x7fbd14f55cd0>,151,25,[9 1],152,-1,559,-1,534
1,<environment.Job instance at 0x7fbd15175af0>,160,27,[5 4],161,-1,609,-1,582
1,<environment.Job instance at 0x7fbd15175820>,161,28,[7 5],162,-1,610,-1,582
1,<environment.Job instance at 0x7fbd1e0c4d20>,163,28,[8 2],164,-1,614,-1,586
1,<environment.Job instance at 0x7fbd14c89820>,4,12,[9 3],5,-1,17,-1,5
1,<environment.Job instance at 0x7fbd14c89c80>,7,18,[2 6],8,-1,26,-1,8
1,<environment.Job instance at 0x7fbd14c89e60>,8,15,[3 9],9,-1,24,-1,9
1,<environment.Job instance at 0x7fbd14c895a0>,9,12,[10  4],10,-1,23,-1,11
1,<environment.Job instance at 0x7fbd14c893c0>,14,15,[10  1],15,-1,30,-1,15
1,<environment.Job instance at 0x7fbd14ca6140>,15,18,[7 4],16,-1,34,-1,16
1,<environment.Job instance at 0x7fbd14ca6370>,18,18,[ 2 10],19,-1,37,-1,19
1,<environment.Job instance at 0x7fbd14ca6410>,19,13,[5 8],20,-1,33,-1,20
1,<environment.Job instance at 0x7fbd14ca68c0>,25,14,[5 9],26,-1,42,-1,28
1,<environment.Job instance at 0x7fbd14ca6f00>,30,13,[7 3],31,-1,45,-1,32
1,<environment.Job instance at 0x7fbd14cb8280>,33,18,[6 4],34,-1,52,-1,34
1,<environment.Job instance at 0x7fbd14cb8370>,34,18,[9 1],35,-1,56,-1,38
1,<environment.Job instance at 0x7fbd14cb8320>,36,14,[5 7],37,-1,52,-1,38
1,<environment.Job instance at 0x7fbd14cb85f0>,39,3,[4 7],40,-1,48,-1,45
1,<environment.Job instance at 0x7fbd14cb8410>,35,17,[14  4],36,-1,63,-1,46
1,<environment.Job instance at 0x7fbd14cb87d0>,40,18,[2 9],41,-1,65,-1,47
1,<environment.Job instance at 0x7fbd14cb8960>,43,18,[5 3],44,-1,65,-1,47
1,<environment.Job instance at 0x7fbd14cb8d70>,47,26,[3 7],48,-1,77,-1,51
1,<environment.Job instance at 0x7fbd14cb80f0>,31,12,[3 8],32,-1,63,-1,51
1,<environment.Job instance at 0x7fbd14cb8e10>,50,13,[1 6],51,-1,65,-1,52
1,<environment.Job instance at 0x7fbd14cb66e0>,54,17,[5 1],55,-1,76,-1,59
1,<environment.Job instance at 0x7fbd14cb67d0>,56,18,[5 4],57,-1,78,-1,60
1,<environment.Job instance at 0x7fbd14cb6370>,59,25,[3 8],60,-1,87,-1,62
1,<environment.Job instance at 0x7fbd14cb8640>,41,12,[13  5],42,-1,75,-1,63
1,<environment.Job instance at 0x7fbd14c89f00>,13,19,[7 1],14,-1,94,-1,75
1,<environment.Job instance at 0x7fbd14cb6fa0>,65,18,[8 2],66,-1,94,-1,76
1,<environment.Job instance at 0x7fbd14cb6a50>,60,17,[7 1],61,-1,94,-1,77
1,<environment.Job instance at 0x7fbd14cb6b40>,62,15,[3 6],63,-1,94,-1,79
1,<environment.Job instance at 0x7fbd14c9d370>,71,18,[13  5],72,-1,98,-1,80
1,<environment.Job instance at 0x7fbd14cb6b90>,61,17,[7 4],62,-1,97,-1,80
1,<environment.Job instance at 0x7fbd14cb6f00>,67,28,[4 9],68,-1,108,-1,80
1,<environment.Job instance at 0x7fbd14c9d500>,72,13,[9 3],73,-1,93,-1,80
1,<environment.Job instance at 0x7fbd14c9df50>,80,14,[10  4],81,-1,97,-1,83
1,<environment.Job instance at 0x7fbd14c9d320>,74,13,[5 5],75,-1,102,-1,89
1,<environment.Job instance at 0x7fbd14c7f910>,88,16,[10  1],89,-1,105,-1,89
1,<environment.Job instance at 0x7fbd14c7faa0>,89,18,[8 2],90,-1,108,-1,90
1,<environment.Job instance at 0x7fbd14c7f820>,90,18,[2 8],91,-1,112,-1,94
1,<environment.Job instance at 0x7fbd14c7f190>,81,15,[7 2],82,-1,110,-1,95
1,<environment.Job instance at 0x7fbd14c7fcd0>,94,15,[7 2],95,-1,110,-1,95
1,<environment.Job instance at 0x7fbd14c7ff50>,95,18,[9 1],96,-1,114,-1,96
1,<environment.Job instance at 0x7fbd149f7190>,97,12,[9 1],98,-1,110,-1,98
1,<environment.Job instance at 0x7fbd149f7a50>,100,15,[5 8],101,-1,116,-1,101
1,<environment.Job instance at 0x7fbd149f7aa0>,102,12,[5 5],103,-1,115,-1,103
1,<environment.Job instance at 0x7fbd149f7cd0>,104,21,[8 1],105,-1,126,-1,105
1,<environment.Job instance at 0x7fbd13f90370>,105,13,[2 6],106,-1,119,-1,106
1,<environment.Job instance at 0x7fbd14a1e280>,109,25,[ 3 10],110,-1,135,-1,110
1,<environment.Job instance at 0x7fbd13e1a6e0>,114,17,[5 4],115,-1,132,-1,115
1,<environment.Job instance at 0x7fbd1540df00>,115,15,[9 4],116,-1,133,-1,118
1,<environment.Job instance at 0x7fbd1439af00>,120,15,[4 8],121,-1,136,-1,121
1,<environment.Job instance at 0x7fbd143c07d0>,123,17,[7 4],124,-1,142,-1,125
1,<environment.Job instance at 0x7fbd14c7fe60>,93,14,[5 7],94,-1,140,-1,126
1,<environment.Job instance at 0x7fbd1dd58190>,125,15,[9 1],126,-1,144,-1,129
1,<environment.Job instance at 0x7fbd14ec7cd0>,130,15,[7 2],131,-1,146,-1,131
1,<environment.Job instance at 0x7fbd145246e0>,128,16,[6 5],129,-1,148,-1,132
1,<environment.Job instance at 0x7fbd13f58910>,117,23,[9 2],118,-1,156,-1,133
1,<environment.Job instance at 0x7fbd14ec7d70>,133,14,[4 9],134,-1,149,-1,135
1,<environment.Job instance at 0x7fbd15203410>,143,24,[4 7],144,-1,180,-1,156
1,<environment.Job instance at 0x7fbd15203320>,144,16,[4 7],145,-1,172,-1,156
1,<environment.Job instance at 0x7fbd143a3dc0>,132,18,[ 2 10],133,-1,175,-1,157
1,<environment.Job instance at 0x7fbd14f5ed70>,140,16,[3 7],141,-1,174,-1,158
1,<environment.Job instance at 0x7fbd13e0ee60>,110,18,[ 2 11],111,-1,176,-1,158
1,<environment.Job instance at 0x7fbd151d0f00>,148,23,[ 4 10],149,-1,183,-1,160
1,<environment.Job instance at 0x7fbd14f5ea50>,139,18,[14  4],140,-1,180,-1,162
1,<environment.Job instance at 0x7fbd151d0c80>,156,13,[ 4 12],157,-1,178,-1,165
1,<environment.Job instance at 0x7fbd151d0e10>,157,18,[3 9],158,-1,185,-1,167
1,<environment.Job instance at 0x7fbd151d0550>,155,13,[ 3 12],156,-1,180,-1,167
1,<environment.Job instance at 0x7fbd151faeb0>,160,15,[5 3],161,-1,182,-1,167
1,<environment.Job instance at 0x7fbd14d17910>,159,14,[5 4],160,-1,183,-1,169
1,<environment.Job instance at 0x7fbd1450daf0>,165,16,[5 5],166,-1,186,-1,170
1,<environment.Job instance at 0x7fbd14396a00>,163,24,[3 5],164,-1,194,-1,170
1,<environment.Job instance at 0x7fbd13e06730>,168,17,[10  4],169,-1,187,-1,170
1,<environment.Job instance at 0x7fbd14c9d2d0>,11,1,[ 5 14],12,-1,20,-1,19
1,<environment.Job instance at 0x7fbd149f70a0>,20,17,[ 5 13],21,-1,62,-1,45
1,<environment.Job instance at 0x7fbd14f5e7d0>,23,27,[5 1],24,-1,88,-1,61
1,<environment.Job instance at 0x7fbd151d0eb0>,26,2,[ 5 12],27,-1,75,-1,73
1,<environment.Job instance at 0x7fbd14c89640>,35,17,[14  4],36,-1,116,-1,99
1,<environment.Job instance at 0x7fbd1e0c4d20>,41,12,[13  5],42,-1,138,-1,126
1,<environment.Job instance at 0x7fbd15175f50>,47,26,[3 7],48,-1,184,-1,158
1,<environment.Job instance at 0x7fbd1482ab40>,57,1,[ 2 11],58,-1,177,-1,176
1,<environment.Job instance at 0x7fbd152332d0>,59,25,[3 8],60,-1,211,-1,186
1,<environment.Job instance at 0x7fbd13f270a0>,67,28,[4 9],68,-1,257,-1,229
1,<environment.Job instance at 0x7fbd13dd4820>,71,18,[13  5],72,-1,247,-1,229
1,<environment.Job instance at 0x7fbd13dd4d20>,75,14,[11  2],76,-1,251,-1,237
1,<environment.Job instance at 0x7fbd149d78c0>,78,1,[14  2],79,-1,248,-1,247
1,<environment.Job instance at 0x7fbd149d7050>,79,1,[ 1 11],80,-1,248,-1,247
1,<environment.Job instance at 0x7fbd14c199b0>,110,18,[ 2 11],111,-1,362,-1,344
1,<environment.Job instance at 0x7fbd14ca0c80>,109,25,[ 3 10],110,-1,384,-1,359
1,<environment.Job instance at 0x7fbd14d41e10>,117,23,[9 2],118,-1,400,-1,377
1,<environment.Job instance at 0x7fbd145b1f00>,136,17,[ 1 14],137,-1,459,-1,442
1,<environment.Job instance at 0x7fbd15024500>,139,18,[14  4],140,-1,466,-1,448
1,<environment.Job instance at 0x7fbd13e0b690>,143,24,[4 7],144,-1,501,-1,477
1,<environment.Job instance at 0x7fbd14545410>,155,13,[ 3 12],156,-1,508,-1,495
1,<environment.Job instance at 0x7fbd1496ecd0>,156,13,[ 4 12],157,-1,508,-1,495
1,<environment.Job instance at 0x7fbd14eefaa0>,148,23,[ 4 10],149,-1,531,-1,508
1,<environment.Job instance at 0x7fbd1498d8c0>,163,24,[3 5],164,-1,540,-1,516
1,<environment.Job instance at 0x7fbd14c905a0>,1,17,[4 7],2,-1,19,-1,2
1,<environment.Job instance at 0x7fbd15178280>,3,17,[4 9],4,-1,21,-1,4
1,<environment.Job instance at 0x7fbd1e22d280>,8,16,[9 2],9,-1,25,-1,9
1,<environment.Job instance at 0x7fbd1e22dd20>,9,24,[7 1],10,-1,34,-1,10
1,<environment.Job instance at 0x7fbd1e22de60>,10,26,[4 8],11,-1,37,-1,11
1,<environment.Job instance at 0x7fbd1e22d6e0>,11,16,[2 7],12,-1,28,-1,12
1,<environment.Job instance at 0x7fbd152f1320>,14,15,[3 8],15,-1,30,-1,15
1,<environment.Job instance at 0x7fbd152f1230>,15,18,[6 2],16,-1,34,-1,16
1,<environment.Job instance at 0x7fbd152f14b0>,18,13,[ 5 10],19,-1,32,-1,19
1,<environment.Job instance at 0x7fbd152f1500>,20,18,[8 5],21,-1,39,-1,21
1,<environment.Job instance at 0x7fbd152f1910>,22,18,[4 5],23,-1,41,-1,23
1,<environment.Job instance at 0x7fbd152f1640>,23,18,[8 1],24,-1,42,-1,24
1,<environment.Job instance at 0x7fbd156f8d20>,25,15,[12  1],26,-1,41,-1,26
1,<environment.Job instance at 0x7fbd156f8dc0>,26,13,[5 6],27,-1,40,-1,27
1,<environment.Job instance at 0x7fbd156f83c0>,27,3,[1 6],28,-1,31,-1,28
1,<environment.Job instance at 0x7fbd156f8280>,28,17,[10  4],29,-1,46,-1,29
1,<environment.Job instance at 0x7fbd156f8b40>,29,15,[5 9],30,-1,45,-1,30
1,<environment.Job instance at 0x7fbd155dbb40>,32,16,[3 5],33,-1,49,-1,33
1,<environment.Job instance at 0x7fbd155dba00>,35,22,[1 9],36,-1,58,-1,36
1,<environment.Job instance at 0x7fbd1529d1e0>,40,18,[7 3],41,-1,62,-1,44
1,<environment.Job instance at 0x7fbd1529d2d0>,43,17,[10  3],44,-1,61,-1,44
1,<environment.Job instance at 0x7fbd156f9e10>,47,15,[6 4],48,-1,63,-1,48
1,<environment.Job instance at 0x7fbd156f95f0>,48,17,[3 8],49,-1,66,-1,49
1,<environment.Job instance at 0x7fbd156f9b90>,49,15,[ 5 10],50,-1,65,-1,50
1,<environment.Job instance at 0x7fbd156f93c0>,50,19,[5 4],51,-1,70,-1,51
1,<environment.Job instance at 0x7fbd156f9f00>,51,17,[ 2 10],52,-1,69,-1,52
1,<environment.Job instance at 0x7fbd156f9aa0>,53,18,[9 2],54,-1,72,-1,54
1,<environment.Job instance at 0x7fbd14de0f50>,54,24,[5 9],55,-1,79,-1,55
1,<environment.Job instance at 0x7fbd14de0aa0>,55,16,[10  3],56,-1,74,-1,58
1,<environment.Job instance at 0x7fbd14de07d0>,57,26,[8 5],58,-1,84,-1,58
1,<environment.Job instance at 0x7fbd14de03c0>,60,17,[10  1],61,-1,78,-1,61
1,<environment.Job instance at 0x7fbd14de0500>,62,13,[9 1],63,-1,76,-1,63
1,<environment.Job instance at 0x7fbd14de0fa0>,63,26,[7 5],64,-1,90,-1,64
1,<environment.Job instance at 0x7fbd14de0d70>,64,16,[3 9],65,-1,81,-1,65
1,<environment.Job instance at 0x7fbd153270a0>,66,20,[3 6],67,-1,87,-1,67
1,<environment.Job instance at 0x7fbd15327550>,67,18,[ 3 10],68,-1,86,-1,68
1,<environment.Job instance at 0x7fbd15327af0>,68,16,[3 5],69,-1,85,-1,69
1,<environment.Job instance at 0x7fbd15327910>,69,16,[8 5],70,-1,86,-1,70
1,<environment.Job instance at 0x7fbd15327320>,72,18,[4 7],73,-1,91,-1,73
1,<environment.Job instance at 0x7fbd146aefa0>,75,17,[9 3],76,-1,97,-1,80
1,<environment.Job instance at 0x7fbd147a6e60>,79,15,[5 5],80,-1,95,-1,80
1,<environment.Job instance at 0x7fbd14aae5a0>,94,17,[5 9],95,-1,112,-1,95
1,<environment.Job instance at 0x7fbd143b1190>,95,17,[5 9],96,-1,113,-1,96
1,<environment.Job instance at 0x7fbd146ec820>,98,17,[4 9],99,-1,116,-1,99
1,<environment.Job instance at 0x7fbd1dcc8dc0>,99,18,[9 5],100,-1,118,-1,100
1,<environment.Job instance at 0x7fbd1dcc80a0>,101,17,[8 2],102,-1,120,-1,103
1,<environment.Job instance at 0x7fbd14339cd0>,105,16,[3 8],106,-1,122,-1,106
1,<environment.Job instance at 0x7fbd14339550>,106,14,[4 7],107,-1,121,-1,107
1,<environment.Job instance at 0x7fbd14339d70>,107,18,[5 4],108,-1,126,-1,108
1,<environment.Job instance at 0x7fbd14339aa0>,108,12,[6 1],109,-1,121,-1,109
1,<environment.Job instance at 0x7fbd14339c80>,109,12,[5 9],110,-1,122,-1,110
1,<environment.Job instance at 0x7fbd150ae870>,110,12,[2 9],111,-1,123,-1,111
1,<environment.Job instance at 0x7fbd14339f00>,102,18,[10  5],103,-1,129,-1,111
1,<environment.Job instance at 0x7fbd150ae960>,113,16,[3 9],114,-1,140,-1,124
1,<environment.Job instance at 0x7fbd14ffce60>,115,13,[ 3 10],116,-1,137,-1,124
1,<environment.Job instance at 0x7fbd156f4be0>,122,24,[11  1],123,-1,148,-1,124
1,<environment.Job instance at 0x7fbd156f4050>,123,18,[2 6],124,-1,143,-1,125
1,<environment.Job instance at 0x7fbd156f4730>,124,18,[8 2],125,-1,148,-1,130
1,<environment.Job instance at 0x7fbd1435fa50>,132,18,[10  1],133,-1,164,-1,146
1,<environment.Job instance at 0x7fbd15387c30>,141,18,[7 1],142,-1,164,-1,146
1,<environment.Job instance at 0x7fbd15114b90>,143,18,[ 3 10],144,-1,164,-1,146
1,<environment.Job instance at 0x7fbd156d4960>,91,15,[14  4],92,-1,219,-1,204
1,<environment.Job instance at 0x7fbd1dccd910>,155,15,[10  1],156,-1,225,-1,210
1,<environment.Job instance at 0x7fbd152e1a50>,158,28,[8 3],159,-1,240,-1,212
1,<environment.Job instance at 0x7fbd1dccd960>,156,21,[3 7],157,-1,235,-1,214
1,<environment.Job instance at 0x7fbd15187b40>,159,20,[1 9],160,-1,234,-1,214
1,<environment.Job instance at 0x7fbd1435f820>,131,15,[10  5],132,-1,229,-1,214
1,<environment.Job instance at 0x7fbd14fb2230>,163,17,[ 2 10],164,-1,231,-1,214
1,<environment.Job instance at 0x7fbd15187730>,161,17,[5 6],162,-1,231,-1,214
1,<environment.Job instance at 0x7fbd141ebb90>,162,16,[10  1],163,-1,230,-1,214
1,<environment.Job instance at 0x7fbd1529dd20>,9,24,[7 1],10,-1,43,-1,19
1,<environment.Job instance at 0x7fbd14de02d0>,10,26,[4 8],11,-1,57,-1,31
1,<environment.Job instance at 0x7fbd15114820>,25,15,[12  1],26,-1,84,-1,69
1,<environment.Job instance at 0x7fbd14390460>,33,1,[ 3 13],34,-1,105,-1,104
1,<environment.Job instance at 0x7fbd14fb2280>,39,18,[ 3 12],40,-1,138,-1,120
1,<environment.Job instance at 0x7fbd14e8f280>,45,1,[ 5 13],46,-1,140,-1,139
1,<environment.Job instance at 0x7fbd13eb3140>,54,24,[5 9],55,-1,213,-1,189
1,<environment.Job instance at 0x7fbd145b1f00>,57,26,[8 5],58,-1,216,-1,190
1,<environment.Job instance at 0x7fbd14ac6d20>,63,26,[7 5],64,-1,248,-1,222
1,<environment.Job instance at 0x7fbd14ac6280>,65,2,[13  2],66,-1,224,-1,222
1,<environment.Job instance at 0x7fbd14cc5370>,73,3,[11  3],74,-1,258,-1,255
1,<environment.Job instance at 0x7fbd14ca0dc0>,88,16,[ 5 13],89,-1,320,-1,304
1,<environment.Job instance at 0x7fbd1569e690>,91,15,[14  4],92,-1,322,-1,307
1,<environment.Job instance at 0x7fbd13dc63c0>,96,23,[10  4],97,-1,345,-1,322
1,<environment.Job instance at 0x7fbd13dd4af0>,119,25,[8 3],120,-1,468,-1,443
1,<environment.Job instance at 0x7fbd1498a5f0>,122,24,[11  1],123,-1,467,-1,443
1,<environment.Job instance at 0x7fbd1451f6e0>,153,2,[12  1],154,-1,575,-1,573
1,<environment.Job instance at 0x7fbd14f5ecd0>,154,1,[ 5 14],155,-1,574,-1,573
1,<environment.Job instance at 0x7fbd149f7640>,158,28,[8 3],159,-1,621,-1,593
1,<environment.Job instance at 0x7fbd14cb6af0>,166,13,[ 5 11],167,-1,632,-1,619
1,<environment.Job instance at 0x7fbd14cb6550>,167,2,[13  1],168,-1,621,-1,619
1,<environment.Job instance at 0x7fbd13f196e0>,1,18,[4 6],2,-1,20,-1,2
1,<environment.Job instance at 0x7fbd13f0bcd0>,6,13,[8 3],7,-1,21,-1,8
1,<environment.Job instance at 0x7fbd13f0b460>,8,15,[8 2],9,-1,24,-1,9
1,<environment.Job instance at 0x7fbd13f2eb40>,14,16,[1 8],15,-1,31,-1,15
1,<environment.Job instance at 0x7fbd13f2e500>,20,15,[12  3],21,-1,42,-1,27
1,<environment.Job instance at 0x7fbd1563e780>,25,12,[10  3],26,-1,39,-1,27
1,<environment.Job instance at 0x7fbd1563e8c0>,30,18,[5 7],31,-1,49,-1,31
1,<environment.Job instance at 0x7fbd1563eb40>,31,23,[5 9],32,-1,56,-1,33
1,<environment.Job instance at 0x7fbd13f2eb90>,16,21,[12  2],17,-1,66,-1,45
1,<environment.Job instance at 0x7fbd1563e2d0>,34,15,[6 4],35,-1,60,-1,45
1,<environment.Job instance at 0x7fbd1563e640>,35,15,[ 4 12],36,-1,60,-1,45
1,<environment.Job instance at 0x7fbd1563ec30>,33,14,[5 6],34,-1,61,-1,47
1,<environment.Job instance at 0x7fbd1428daf0>,41,26,[7 2],42,-1,73,-1,47
1,<environment.Job instance at 0x7fbd1428de10>,43,16,[ 3 10],44,-1,65,-1,49
1,<environment.Job instance at 0x7fbd1428d5f0>,44,14,[10  5],45,-1,63,-1,49
1,<environment.Job instance at 0x7fbd1428d8c0>,48,19,[ 5 11],49,-1,69,-1,50
1,<environment.Job instance at 0x7fbd1428d730>,49,14,[8 2],50,-1,69,-1,55
1,<environment.Job instance at 0x7fbd1428d460>,51,17,[10  3],52,-1,72,-1,55
1,<environment.Job instance at 0x7fbd1428dc80>,46,12,[11  2],47,-1,67,-1,55
1,<environment.Job instance at 0x7fbd1428dd20>,52,13,[5 2],53,-1,68,-1,55
1,<environment.Job instance at 0x7fbd13f2ed20>,19,20,[2 8],20,-1,75,-1,55
1,<environment.Job instance at 0x7fbd13f0e8c0>,54,18,[5 3],55,-1,73,-1,55
1,<environment.Job instance at 0x7fbd13f0e460>,59,19,[9 1],60,-1,87,-1,68
1,<environment.Job instance at 0x7fbd13f0ea50>,66,17,[2 7],67,-1,85,-1,68
1,<environment.Job instance at 0x7fbd156395a0>,68,2,[3 5],69,-1,73,-1,71
1,<environment.Job instance at 0x7fbd15639b90>,71,15,[10  1],72,-1,87,-1,72
1,<environment.Job instance at 0x7fbd13f0e910>,64,23,[8 3],65,-1,95,-1,72
1,<environment.Job instance at 0x7fbd1563e370>,36,18,[1 5],37,-1,93,-1,75
1,<environment.Job instance at 0x7fbd15639d20>,73,27,[9 4],74,-1,102,-1,75
1,<environment.Job instance at 0x7fbd156395f0>,76,18,[7 2],77,-1,95,-1,77
1,<environment.Job instance at 0x7fbd1480e140>,82,17,[5 9],83,-1,100,-1,83
1,<environment.Job instance at 0x7fbd15639550>,80,12,[ 4 12],81,-1,101,-1,89
1,<environment.Job instance at 0x7fbd1480efa0>,87,17,[3 7],88,-1,108,-1,91
1,<environment.Job instance at 0x7fbd1480e410>,88,16,[8 5],89,-1,107,-1,91
1,<environment.Job instance at 0x7fbd15639050>,79,18,[5 1],80,-1,111,-1,93
1,<environment.Job instance at 0x7fbd15639f50>,74,25,[8 2],75,-1,124,-1,99
1,<environment.Job instance at 0x7fbd13f5df00>,95,22,[9 4],96,-1,121,-1,99
1,<environment.Job instance at 0x7fbd13ea2e60>,102,15,[ 5 10],103,-1,120,-1,105
1,<environment.Job instance at 0x7fbd13f62a50>,101,12,[10  5],102,-1,120,-1,108
1,<environment.Job instance at 0x7fbd13ea27d0>,103,16,[5 8],104,-1,124,-1,108
1,<environment.Job instance at 0x7fbd13ea21e0>,105,12,[3 5],106,-1,120,-1,108
1,<environment.Job instance at 0x7fbd1dd47320>,99,27,[5 8],100,-1,135,-1,108
1,<environment.Job instance at 0x7fbd13ea2c30>,106,22,[3 8],107,-1,131,-1,109
1,<environment.Job instance at 0x7fbd14de45f0>,118,17,[3 7],119,-1,141,-1,124
1,<environment.Job instance at 0x7fbd13dc1aa0>,120,18,[9 4],121,-1,144,-1,126
1,<environment.Job instance at 0x7fbd13f62550>,98,14,[3 7],99,-1,151,-1,137
1,<environment.Job instance at 0x7fbd13dc1b90>,121,12,[ 4 10],122,-1,149,-1,137
1,<environment.Job instance at 0x7fbd14a51370>,123,14,[ 1 10],124,-1,151,-1,137
1,<environment.Job instance at 0x7fbd14a3eeb0>,126,13,[2 9],127,-1,150,-1,137
1,<environment.Job instance at 0x7fbd14a3e140>,128,24,[8 2],129,-1,161,-1,137
1,<environment.Job instance at 0x7fbd14a3ecd0>,130,18,[ 2 12],131,-1,157,-1,139
1,<environment.Job instance at 0x7fbd15402730>,131,15,[10  3],132,-1,154,-1,139
1,<environment.Job instance at 0x7fbd154024b0>,132,18,[1 9],133,-1,158,-1,140
1,<environment.Job instance at 0x7fbd15402690>,133,17,[6 3],134,-1,157,-1,140
1,<environment.Job instance at 0x7fbd15402780>,134,17,[7 1],135,-1,157,-1,140
1,<environment.Job instance at 0x7fbd1426c460>,142,18,[4 9],143,-1,183,-1,165
1,<environment.Job instance at 0x7fbd144da3c0>,146,18,[8 5],147,-1,187,-1,169
1,<environment.Job instance at 0x7fbd1428da00>,4,1,[11  3],5,-1,6,-1,5
1,<environment.Job instance at 0x7fbd156399b0>,11,13,[ 1 13],12,-1,34,-1,21
1,<environment.Job instance at 0x7fbd15639410>,12,27,[9 1],13,-1,48,-1,21
1,<environment.Job instance at 0x7fbd157a0230>,16,21,[12  2],17,-1,55,-1,34
1,<environment.Job instance at 0x7fbd13ea2050>,18,14,[ 1 14],19,-1,49,-1,35
1,<environment.Job instance at 0x7fbd1480ec80>,20,15,[12  3],21,-1,50,-1,35
1,<environment.Job instance at 0x7fbd14274b90>,26,2,[12  3],27,-1,52,-1,50
1,<environment.Job instance at 0x7fbd14817e60>,31,23,[5 9],32,-1,89,-1,66
1,<environment.Job instance at 0x7fbd1461b640>,35,15,[ 4 12],36,-1,89,-1,74
1,<environment.Job instance at 0x7fbd1460fc30>,39,3,[ 4 11],40,-1,88,-1,85
1,<environment.Job instance at 0x7fbd13f19050>,41,26,[7 2],42,-1,119,-1,93
1,<environment.Job instance at 0x7fbd13f19f00>,42,2,[ 2 13],43,-1,95,-1,93
1,<environment.Job instance at 0x7fbd14c9d6e0>,46,12,[11  2],47,-1,109,-1,97
1,<environment.Job instance at 0x7fbd14c9daf0>,47,1,[14  5],48,-1,98,-1,97
1,<environment.Job instance at 0x7fbd149f75a0>,48,19,[ 5 11],49,-1,116,-1,97
1,<environment.Job instance at 0x7fbd13e5da50>,58,1,[ 4 13],59,-1,137,-1,136
1,<environment.Job instance at 0x7fbd13eb3140>,62,2,[ 3 14],63,-1,141,-1,139
1,<environment.Job instance at 0x7fbd156f5be0>,64,23,[8 3],65,-1,170,-1,147
1,<environment.Job instance at 0x7fbd1435f640>,69,1,[11  4],70,-1,149,-1,148
1,<environment.Job instance at 0x7fbd1529d820>,73,27,[9 4],74,-1,190,-1,163
1,<environment.Job instance at 0x7fbd1529d640>,74,25,[8 2],75,-1,188,-1,163
1,<environment.Job instance at 0x7fbd1562e5a0>,80,12,[ 4 12],81,-1,181,-1,169
1,<environment.Job instance at 0x7fbd13f637d0>,99,27,[5 8],100,-1,295,-1,268
1,<environment.Job instance at 0x7fbd156db2d0>,115,15,[13  3],116,-1,309,-1,294
1,<environment.Job instance at 0x7fbd156db550>,122,1,[14  1],123,-1,313,-1,312
1,<environment.Job instance at 0x7fbd156db500>,124,17,[14  4],125,-1,332,-1,315
1,<environment.Job instance at 0x7fbd156db1e0>,128,24,[8 2],129,-1,355,-1,331
1,<environment.Job instance at 0x7fbd156dbd20>,129,27,[ 3 13],130,-1,358,-1,331
1,<environment.Job instance at 0x7fbd156db730>,130,18,[ 2 12],131,-1,349,-1,331
1,<environment.Job instance at 0x7fbd13ec0280>,136,24,[13  3],137,-1,378,-1,354
1,<environment.Job instance at 0x7fbd13f29d20>,153,26,[7 3],154,-1,445,-1,419
1,<environment.Job instance at 0x7fbd14601fa0>,157,27,[1 8],158,-1,472,-1,445
1,<environment.Job instance at 0x7fbd1458a190>,2,14,[9 2],3,-1,18,-1,4
1,<environment.Job instance at 0x7fbd14c9dfa0>,3,14,[9 2],4,-1,19,-1,5
1,<environment.Job instance at 0x7fbd1458a8c0>,10,20,[7 1],11,-1,32,-1,12
1,<environment.Job instance at 0x7fbd1458aa00>,12,14,[7 1],13,-1,27,-1,13
1,<environment.Job instance at 0x7fbd1458aa50>,13,17,[3 7],14,-1,31,-1,14
1,<environment.Job instance at 0x7fbd14587140>,21,16,[9 2],22,-1,38,-1,22
1,<environment.Job instance at 0x7fbd145875f0>,27,17,[9 1],28,-1,50,-1,33
1,<environment.Job instance at 0x7fbd14587cd0>,33,17,[7 2],34,-1,51,-1,34
1,<environment.Job instance at 0x7fbd14587e60>,35,24,[7 4],36,-1,60,-1,36
1,<environment.Job instance at 0x7fbd1458ab90>,15,17,[ 1 11],16,-1,54,-1,37
1,<environment.Job instance at 0x7fbd14587b90>,34,14,[ 1 11],35,-1,51,-1,37
1,<environment.Job instance at 0x7fbd14587050>,23,14,[ 4 10],24,-1,51,-1,37
1,<environment.Job instance at 0x7fbd14587d70>,36,14,[9 1],37,-1,51,-1,37
1,<environment.Job instance at 0x7fbd14587410>,25,13,[10  4],26,-1,53,-1,40
1,<environment.Job instance at 0x7fbd14587a50>,30,24,[ 4 14],31,-1,66,-1,42
1,<environment.Job instance at 0x7fbd14587f00>,37,15,[2 5],38,-1,57,-1,42
1,<environment.Job instance at 0x7fbd145a45a0>,43,18,[8 3],44,-1,62,-1,44
1,<environment.Job instance at 0x7fbd145a4be0>,49,18,[ 1 10],50,-1,80,-1,62
1,<environment.Job instance at 0x7fbd145a1050>,57,17,[8 3],58,-1,79,-1,62
1,<environment.Job instance at 0x7fbd145a4f00>,56,26,[10  2],57,-1,101,-1,75
1,<environment.Job instance at 0x7fbd145a15a0>,60,17,[8 5],61,-1,111,-1,94
1,<environment.Job instance at 0x7fbd1dd47dc0>,71,18,[5 5],72,-1,114,-1,96
1,<environment.Job instance at 0x7fbd13e9caf0>,75,18,[10  4],76,-1,129,-1,111
1,<environment.Job instance at 0x7fbd15609140>,76,17,[3 5],77,-1,129,-1,112
1,<environment.Job instance at 0x7fbd14f7ab90>,77,15,[5 9],78,-1,127,-1,112
1,<environment.Job instance at 0x7fbd148a21e0>,80,15,[10  5],81,-1,127,-1,112
1,<environment.Job instance at 0x7fbd151ab7d0>,81,17,[8 2],82,-1,129,-1,112
1,<environment.Job instance at 0x7fbd1dcc2870>,62,21,[9 5],63,-1,148,-1,127
1,<environment.Job instance at 0x7fbd14526550>,84,18,[8 4],85,-1,145,-1,127
1,<environment.Job instance at 0x7fbd13e9c050>,74,18,[9 2],75,-1,145,-1,127
1,<environment.Job instance at 0x7fbd13e758c0>,89,14,[6 4],90,-1,141,-1,127
1,<environment.Job instance at 0x7fbd153053c0>,87,17,[2 7],88,-1,144,-1,127
1,<environment.Job instance at 0x7fbd141b74b0>,94,18,[3 9],95,-1,145,-1,127
1,<environment.Job instance at 0x7fbd14501f00>,101,17,[10  2],102,-1,173,-1,156
1,<environment.Job instance at 0x7fbd153055f0>,86,15,[ 2 12],87,-1,183,-1,168
1,<environment.Job instance at 0x7fbd145018c0>,107,18,[7 5],108,-1,186,-1,168
1,<environment.Job instance at 0x7fbd14501b90>,109,16,[6 3],110,-1,184,-1,168
1,<environment.Job instance at 0x7fbd145878c0>,0,26,[2 8],1,-1,27,-1,1
1,<environment.Job instance at 0x7fbd13ea86e0>,9,17,[12  4],10,-1,34,-1,17
1,<environment.Job instance at 0x7fbd145141e0>,15,17,[ 1 11],16,-1,48,-1,31
1,<environment.Job instance at 0x7fbd1466a6e0>,17,13,[12  4],18,-1,44,-1,31
1,<environment.Job instance at 0x7fbd1458a0a0>,30,24,[ 4 14],31,-1,104,-1,80
1,<environment.Job instance at 0x7fbd146019b0>,34,14,[ 1 11],35,-1,96,-1,82
1,<environment.Job instance at 0x7fbd1458a1e0>,35,24,[7 4],36,-1,120,-1,96
1,<environment.Job instance at 0x7fbd13f29d20>,45,25,[6 2],46,-1,162,-1,137
1,<environment.Job instance at 0x7fbd13f29be0>,46,2,[ 1 13],47,-1,139,-1,137
1,<environment.Job instance at 0x7fbd13f29640>,56,26,[10  2],57,-1,198,-1,172
1,<environment.Job instance at 0x7fbd13ec0410>,64,1,[12  5],65,-1,204,-1,203
1,<environment.Job instance at 0x7fbd13ec0140>,65,1,[ 2 14],66,-1,204,-1,203
1,<environment.Job instance at 0x7fbd156db230>,67,2,[14  3],68,-1,205,-1,203
1,<environment.Job instance at 0x7fbd156db190>,78,28,[ 2 11],79,-1,267,-1,239
1,<environment.Job instance at 0x7fbd13f12820>,86,15,[ 2 12],87,-1,297,-1,282
1,<environment.Job instance at 0x7fbd13f12780>,90,12,[ 1 11],91,-1,304,-1,292
1,<environment.Job instance at 0x7fbd13f63910>,93,15,[ 5 12],94,-1,321,-1,306
1,<environment.Job instance at 0x7fbd155dbdc0>,110,17,[11  3],111,-1,401,-1,384
1,<environment.Job instance at 0x7fbd13e5da50>,127,24,[8 1],128,-1,477,-1,453
1,<environment.Job instance at 0x7fbd1e0c48c0>,131,28,[5 9],132,-1,488,-1,460
1,<environment.Job instance at 0x7fbd14f80190>,133,28,[6 1],134,-1,495,-1,467
1,<environment.Job instance at 0x7fbd14c9daf0>,138,23,[ 3 10],139,-1,513,-1,490
1,<environment.Job instance at 0x7fbd1461bb40>,143,18,[ 5 11],144,-1,520,-1,502
1,<environment.Job instance at 0x7fbd14982460>,153,1,[13  4],154,-1,537,-1,536
1,<environment.Job instance at 0x7fbd14ed1e10>,154,17,[12  2],155,-1,553,-1,536
1,<environment.Job instance at 0x7fbd15639190>,166,28,[7 3],167,-1,605,-1,577
1,<environment.Job instance at 0x7fbd14452050>,4,13,[3 8],5,-1,19,-1,6
1,<environment.Job instance at 0x7fbd14452910>,7,16,[2 6],8,-1,24,-1,8
1,<environment.Job instance at 0x7fbd14452d70>,8,17,[7 4],9,-1,26,-1,9
1,<environment.Job instance at 0x7fbd14452b40>,10,12,[4 8],11,-1,23,-1,11
1,<environment.Job instance at 0x7fbd1ddda460>,11,16,[6 2],12,-1,28,-1,12
1,<environment.Job instance at 0x7fbd1ddda690>,12,20,[1 9],13,-1,33,-1,13
1,<environment.Job instance at 0x7fbd1dddab90>,13,18,[3 7],14,-1,32,-1,14
1,<environment.Job instance at 0x7fbd1ddda910>,16,18,[3 6],17,-1,35,-1,17
1,<environment.Job instance at 0x7fbd1dddaf00>,18,17,[2 5],19,-1,36,-1,19
1,<environment.Job instance at 0x7fbd145794b0>,5,16,[ 4 14],6,-1,37,-1,21
1,<environment.Job instance at 0x7fbd144525a0>,22,3,[11  1],23,-1,26,-1,23
1,<environment.Job instance at 0x7fbd1533b4b0>,24,18,[2 9],25,-1,44,-1,26
1,<environment.Job instance at 0x7fbd1533bb90>,25,26,[5 5],26,-1,52,-1,26
1,<environment.Job instance at 0x7fbd1533bd20>,27,15,[8 4],28,-1,44,-1,29
1,<environment.Job instance at 0x7fbd1533bc30>,28,22,[10  5],29,-1,51,-1,29
1,<environment.Job instance at 0x7fbd1533bbe0>,30,17,[2 7],31,-1,51,-1,34
1,<environment.Job instance at 0x7fbd15719d20>,33,12,[10  3],34,-1,46,-1,34
1,<environment.Job instance at 0x7fbd157195a0>,40,25,[9 5],41,-1,66,-1,41
1,<environment.Job instance at 0x7fbd15190140>,44,17,[6 3],45,-1,65,-1,48
1,<environment.Job instance at 0x7fbd15190af0>,50,26,[10  1],51,-1,78,-1,52
1,<environment.Job instance at 0x7fbd15190410>,46,15,[7 3],47,-1,67,-1,52
1,<environment.Job instance at 0x7fbd151900f0>,52,22,[2 7],53,-1,75,-1,53
1,<environment.Job instance at 0x7fbd15190960>,53,13,[5 1],54,-1,68,-1,55
1,<environment.Job instance at 0x7fbd15190280>,55,16,[10  3],56,-1,72,-1,56
1,<environment.Job instance at 0x7fbd15190c80>,56,18,[8 3],57,-1,75,-1,57
1,<environment.Job instance at 0x7fbd14f39460>,59,17,[1 9],60,-1,77,-1,60
1,<environment.Job instance at 0x7fbd14f39c80>,60,15,[9 4],61,-1,76,-1,61
1,<environment.Job instance at 0x7fbd151907d0>,45,22,[6 4],46,-1,98,-1,76
1,<environment.Job instance at 0x7fbd14f39e10>,65,27,[5 8],66,-1,105,-1,78
1,<environment.Job instance at 0x7fbd14f39af0>,66,16,[6 4],67,-1,94,-1,78
1,<environment.Job instance at 0x7fbd14f39280>,62,17,[9 5],63,-1,95,-1,78
1,<environment.Job instance at 0x7fbd14f39f00>,64,18,[6 4],65,-1,96,-1,78
1,<environment.Job instance at 0x7fbd14f39230>,67,25,[6 4],68,-1,109,-1,84
1,<environment.Job instance at 0x7fbd14a72e60>,73,18,[10  5],74,-1,102,-1,84
1,<environment.Job instance at 0x7fbd1498c820>,80,14,[5 7],81,-1,98,-1,84
1,<environment.Job instance at 0x7fbd1498c8c0>,81,21,[4 7],82,-1,106,-1,85
1,<environment.Job instance at 0x7fbd13f185f0>,85,17,[4 6],86,-1,103,-1,86
1,<environment.Job instance at 0x7fbd13f184b0>,87,13,[ 2 10],88,-1,105,-1,92
1,<environment.Job instance at 0x7fbd14455870>,91,26,[5 4],92,-1,118,-1,92
1,<environment.Job instance at 0x7fbd14455550>,95,17,[2 7],96,-1,113,-1,96
1,<environment.Job instance at 0x7fbd15719370>,34,25,[9 4],35,-1,124,-1,99
1,<environment.Job instance at 0x7fbd13f18d20>,90,18,[7 3],91,-1,120,-1,102
1,<environment.Job instance at 0x7fbd14455fa0>,98,26,[ 3 10],99,-1,128,-1,102
1,<environment.Job instance at 0x7fbd14344690>,97,18,[1 7],98,-1,120,-1,102
1,<environment.Job instance at 0x7fbd14344910>,100,22,[ 3 10],101,-1,124,-1,102
1,<environment.Job instance at 0x7fbd14eb69b0>,103,12,[5 8],104,-1,125,-1,113
1,<environment.Job instance at 0x7fbd14f39a00>,69,25,[10  1],70,-1,139,-1,114
1,<environment.Job instance at 0x7fbd1421da50>,107,15,[6 1],108,-1,130,-1,115
1,<environment.Job instance at 0x7fbd1421daf0>,108,1,[2 8],109,-1,116,-1,115
1,<environment.Job instance at 0x7fbd14455370>,96,17,[5 2],97,-1,132,-1,115
1,<environment.Job instance at 0x7fbd14f390f0>,70,14,[ 1 14],71,-1,129,-1,115
1,<environment.Job instance at 0x7fbd14d110f0>,111,16,[5 4],112,-1,132,-1,116
1,<environment.Job instance at 0x7fbd142f94b0>,113,14,[3 7],114,-1,130,-1,116
1,<environment.Job instance at 0x7fbd1421d7d0>,112,18,[2 9],113,-1,135,-1,117
1,<environment.Job instance at 0x7fbd1421d5a0>,110,2,[ 3 10],111,-1,119,-1,117
1,<environment.Job instance at 0x7fbd1521ab90>,117,3,[ 5 11],118,-1,125,-1,122
1,<environment.Job instance at 0x7fbd14718d70>,121,18,[ 3 14],122,-1,140,-1,122
1,<environment.Job instance at 0x7fbd144af320>,119,13,[3 8],120,-1,135,-1,122
1,<environment.Job instance at 0x7fbd14344af0>,123,18,[5 5],124,-1,142,-1,124
1,<environment.Job instance at 0x7fbd143440a0>,124,16,[10  2],125,-1,141,-1,125
1,<environment.Job instance at 0x7fbd14344190>,125,13,[4 8],126,-1,141,-1,128
1,<environment.Job instance at 0x7fbd14301870>,129,13,[4 7],130,-1,143,-1,130
1,<environment.Job instance at 0x7fbd14344a50>,126,16,[5 6],127,-1,146,-1,130
1,<environment.Job instance at 0x7fbd14301280>,132,15,[5 5],133,-1,149,-1,134
1,<environment.Job instance at 0x7fbd14301690>,134,18,[ 3 10],135,-1,153,-1,135
1,<environment.Job instance at 0x7fbd14301b40>,135,14,[5 8],136,-1,150,-1,136
1,<environment.Job instance at 0x7fbd143010f0>,136,14,[5 5],137,-1,151,-1,137
1,<environment.Job instance at 0x7fbd14301a50>,137,17,[3 7],138,-1,155,-1,138
1,<environment.Job instance at 0x7fbd14301eb0>,138,16,[7 5],139,-1,155,-1,139
1,<environment.Job instance at 0x7fbd14301190>,139,20,[5 5],140,-1,162,-1,142
1,<environment.Job instance at 0x7fbd148f60a0>,146,18,[1 8],147,-1,165,-1,147
1,<environment.Job instance at 0x7fbd148f6e60>,151,14,[10  5],152,-1,168,-1,154
1,<environment.Job instance at 0x7fbd148f6370>,155,15,[7 2],156,-1,172,-1,157
1,<environment.Job instance at 0x7fbd142ba370>,157,28,[8 2],158,-1,186,-1,158
1,<environment.Job instance at 0x7fbd143447d0>,128,13,[14  3],129,-1,172,-1,159
1,<environment.Job instance at 0x7fbd142ba230>,158,15,[8 5],159,-1,175,-1,160
1,<environment.Job instance at 0x7fbd142ba640>,161,14,[13  2],162,-1,176,-1,162
1,<environment.Job instance at 0x7fbd148f6730>,145,15,[1 9],146,-1,177,-1,162
1,<environment.Job instance at 0x7fbd148f6640>,162,16,[5 6],163,-1,182,-1,166
1,<environment.Job instance at 0x7fbd142baf00>,160,17,[14  5],161,-1,183,-1,166
1,<environment.Job instance at 0x7fbd148f6a50>,156,13,[13  5],157,-1,179,-1,166
1,<environment.Job instance at 0x7fbd15719aa0>,35,2,[9 4],36,-1,1229,-1,1227
1,<environment.Job instance at 0x7fbd14f399b0>,5,16,[ 4 14],6,-1,22,-1,6
1,<environment.Job instance at 0x7fbd14718cd0>,17,26,[ 2 12],18,-1,64,-1,38
1,<environment.Job instance at 0x7fbd144af410>,19,1,[ 3 12],20,-1,42,-1,41
1,<environment.Job instance at 0x7fbd14301910>,22,3,[11  1],23,-1,45,-1,42
1,<environment.Job instance at 0x7fbd14301a00>,25,26,[5 5],26,-1,82,-1,56
1,<environment.Job instance at 0x7fbd14452730>,34,25,[9 4],35,-1,105,-1,80
1,<environment.Job instance at 0x7fbd13ea2050>,41,3,[11  1],42,-1,97,-1,94
1,<environment.Job instance at 0x7fbd13ea2280>,42,3,[12  5],43,-1,97,-1,94
1,<environment.Job instance at 0x7fbd13dc1050>,40,25,[9 5],41,-1,121,-1,96
1,<environment.Job instance at 0x7fbd1428e640>,50,26,[10  1],51,-1,157,-1,131
1,<environment.Job instance at 0x7fbd1434a780>,65,27,[5 8],66,-1,218,-1,191
1,<environment.Job instance at 0x7fbd15114280>,67,25,[6 4],68,-1,232,-1,207
1,<environment.Job instance at 0x7fbd15327410>,69,25,[10  1],70,-1,234,-1,209
1,<environment.Job instance at 0x7fbd15327280>,70,14,[ 1 14],71,-1,223,-1,209
1,<environment.Job instance at 0x7fbd13f121e0>,91,26,[5 4],92,-1,305,-1,279
1,<environment.Job instance at 0x7fbd13ec0c30>,98,26,[ 3 10],99,-1,354,-1,328
1,<environment.Job instance at 0x7fbd146015a0>,117,3,[ 5 11],118,-1,368,-1,365
1,<environment.Job instance at 0x7fbd146019b0>,121,18,[ 3 14],122,-1,388,-1,370
1,<environment.Job instance at 0x7fbd144ecaa0>,128,13,[14  3],129,-1,414,-1,401
1,<environment.Job instance at 0x7fbd13e22460>,147,2,[13  4],148,-1,494,-1,492
1,<environment.Job instance at 0x7fbd14587a00>,156,13,[13  5],157,-1,540,-1,527
1,<environment.Job instance at 0x7fbd13f659b0>,157,28,[8 2],158,-1,557,-1,529
1,<environment.Job instance at 0x7fbd148fa7d0>,160,17,[14  5],161,-1,546,-1,529
1,<environment.Job instance at 0x7fbd148fa820>,161,14,[13  2],162,-1,543,-1,529
1,<environment.Job instance at 0x7fbd1458a5a0>,0,22,[9 5],1,-1,23,-1,1
1,<environment.Job instance at 0x7fbd1458a370>,2,27,[8 4],3,-1,30,-1,3
1,<environment.Job instance at 0x7fbd1458a6e0>,6,14,[8 5],7,-1,22,-1,8
1,<environment.Job instance at 0x7fbd1535afa0>,8,18,[8 4],9,-1,27,-1,9
1,<environment.Job instance at 0x7fbd1535a5a0>,9,18,[2 5],10,-1,28,-1,10
1,<environment.Job instance at 0x7fbd1458ae60>,7,17,[1 5],8,-1,27,-1,10
1,<environment.Job instance at 0x7fbd14abbb40>,13,25,[ 4 10],14,-1,39,-1,14
1,<environment.Job instance at 0x7fbd14abb050>,22,17,[4 5],23,-1,41,-1,24
1,<environment.Job instance at 0x7fbd14abbf50>,23,19,[8 5],24,-1,44,-1,25
1,<environment.Job instance at 0x7fbd145bd640>,29,22,[3 7],30,-1,52,-1,30
1,<environment.Job instance at 0x7fbd1409e0a0>,35,16,[5 5],36,-1,52,-1,36
1,<environment.Job instance at 0x7fbd1409e050>,36,20,[5 3],37,-1,57,-1,37
1,<environment.Job instance at 0x7fbd1409efa0>,38,12,[9 1],39,-1,51,-1,39
1,<environment.Job instance at 0x7fbd1409e6e0>,40,21,[5 4],41,-1,62,-1,41
1,<environment.Job instance at 0x7fbd149b61e0>,42,18,[9 2],43,-1,61,-1,43
1,<environment.Job instance at 0x7fbd1454baa0>,46,16,[5 8],47,-1,63,-1,47
1,<environment.Job instance at 0x7fbd1454bc80>,47,1,[9 3],48,-1,49,-1,48
1,<environment.Job instance at 0x7fbd1454b5a0>,48,16,[6 3],49,-1,65,-1,49
1,<environment.Job instance at 0x7fbd14fcfbe0>,50,17,[10  5],51,-1,68,-1,51
1,<environment.Job instance at 0x7fbd14fcfc30>,53,14,[8 3],54,-1,69,-1,55
1,<environment.Job instance at 0x7fbd149e96e0>,55,17,[9 4],56,-1,73,-1,56
1,<environment.Job instance at 0x7fbd150b3af0>,56,16,[10  4],57,-1,73,-1,57
1,<environment.Job instance at 0x7fbd1dee60f0>,58,14,[10  3],59,-1,73,-1,59
1,<environment.Job instance at 0x7fbd14198d70>,60,12,[1 9],61,-1,73,-1,61
1,<environment.Job instance at 0x7fbd14c21460>,62,18,[3 6],63,-1,81,-1,63
1,<environment.Job instance at 0x7fbd14c21dc0>,63,16,[5 8],64,-1,80,-1,64
1,<environment.Job instance at 0x7fbd14c21960>,68,18,[2 8],69,-1,87,-1,69
1,<environment.Job instance at 0x7fbd14c21370>,70,15,[5 9],71,-1,86,-1,71
1,<environment.Job instance at 0x7fbd14c21f50>,71,18,[8 4],72,-1,90,-1,72
1,<environment.Job instance at 0x7fbd14fcf9b0>,54,13,[10  2],55,-1,85,-1,72
1,<environment.Job instance at 0x7fbd14c21e10>,73,18,[4 6],74,-1,92,-1,74
1,<environment.Job instance at 0x7fbd150a1aa0>,79,14,[ 5 10],80,-1,94,-1,80
1,<environment.Job instance at 0x7fbd14455050>,80,16,[7 5],81,-1,97,-1,81
1,<environment.Job instance at 0x7fbd14a50640>,93,16,[10  5],94,-1,112,-1,96
1,<environment.Job instance at 0x7fbd1454bb40>,44,17,[11  1],45,-1,116,-1,99
1,<environment.Job instance at 0x7fbd157374b0>,155,17,[ 5 10],156,-1,388,-1,371
1,<environment.Job instance at 0x7fbd1478b410>,128,18,[2 9],129,-1,389,-1,371
1,<environment.Job instance at 0x7fbd1432e500>,138,17,[ 1 10],139,-1,388,-1,371
1,<environment.Job instance at 0x7fbd1470ef00>,161,16,[14  3],162,-1,391,-1,375
1,<environment.Job instance at 0x7fbd1499a230>,110,28,[4 7],111,-1,406,-1,378
1,<environment.Job instance at 0x7fbd1409e5a0>,2,27,[8 4],3,-1,50,-1,23
1,<environment.Job instance at 0x7fbd145a1c80>,12,1,[ 1 13],13,-1,24,-1,23
1,<environment.Job instance at 0x7fbd1470e190>,15,17,[11  2],16,-1,54,-1,37
1,<environment.Job instance at 0x7fbd15587230>,13,25,[ 4 10],14,-1,65,-1,40
1,<environment.Job instance at 0x7fbd156ccd70>,19,21,[14  3],20,-1,61,-1,40
1,<environment.Job instance at 0x7fbd1458aeb0>,37,1,[ 2 11],38,-1,77,-1,76
1,<environment.Job instance at 0x7fbd14abb1e0>,44,17,[11  1],45,-1,109,-1,92
1,<environment.Job instance at 0x7fbd15034e60>,57,3,[ 5 11],58,-1,159,-1,156
1,<environment.Job instance at 0x7fbd1460f0a0>,74,12,[13  3],75,-1,263,-1,251
1,<environment.Job instance at 0x7fbd15254960>,85,28,[5 5],86,-1,321,-1,293
1,<environment.Job instance at 0x7fbd1ddda410>,90,12,[ 4 14],91,-1,319,-1,307
1,<environment.Job instance at 0x7fbd144559b0>,98,1,[ 1 11],99,-1,338,-1,337
1,<environment.Job instance at 0x7fbd14465960>,109,16,[ 4 11],110,-1,391,-1,375
1,<environment.Job instance at 0x7fbd144af230>,110,28,[4 7],111,-1,410,-1,382
1,<environment.Job instance at 0x7fbd1426fbe0>,111,15,[ 5 14],112,-1,397,-1,382
1,<environment.Job instance at 0x7fbd14e3ad20>,113,14,[ 3 11],114,-1,396,-1,382
1,<environment.Job instance at 0x7fbd140d0eb0>,127,17,[ 4 14],128,-1,448,-1,431
1,<environment.Job instance at 0x7fbd1dcd1500>,161,16,[14  3],162,-1,568,-1,552
1,<environment.Job instance at 0x7fbd1dcd1140>,162,3,[ 1 14],163,-1,555,-1,552
1,<environment.Job instance at 0x7fbd151dbb40>,3,17,[9 1],4,-1,22,-1,5
1,<environment.Job instance at 0x7fbd144dccd0>,4,13,[10  1],5,-1,18,-1,5
1,<environment.Job instance at 0x7fbd14f92b90>,7,18,[7 5],8,-1,26,-1,8
1,<environment.Job instance at 0x7fbd14f921e0>,9,18,[ 3 10],10,-1,28,-1,10
1,<environment.Job instance at 0x7fbd14f92cd0>,11,18,[5 9],12,-1,30,-1,12
1,<environment.Job instance at 0x7fbd14f92870>,12,14,[9 2],13,-1,28,-1,14
1,<environment.Job instance at 0x7fbd14f92e60>,14,24,[8 1],15,-1,39,-1,15
1,<environment.Job instance at 0x7fbd1dcbf0a0>,15,18,[9 4],16,-1,34,-1,16
1,<environment.Job instance at 0x7fbd151dba50>,13,17,[8 4],14,-1,33,-1,16
1,<environment.Job instance at 0x7fbd14f922d0>,16,25,[6 2],17,-1,42,-1,17
1,<environment.Job instance at 0x7fbd146c2910>,17,17,[8 2],18,-1,35,-1,18
1,<environment.Job instance at 0x7fbd146c2a50>,19,17,[7 1],20,-1,38,-1,21
1,<environment.Job instance at 0x7fbd146c20a0>,20,15,[8 3],21,-1,37,-1,22
1,<environment.Job instance at 0x7fbd1411faa0>,25,18,[3 6],26,-1,44,-1,26
1,<environment.Job instance at 0x7fbd1411fa50>,26,12,[10  1],27,-1,46,-1,34
1,<environment.Job instance at 0x7fbd14239910>,29,16,[10  3],30,-1,50,-1,34
1,<environment.Job instance at 0x7fbd14ef39b0>,34,15,[4 9],35,-1,50,-1,35
1,<environment.Job instance at 0x7fbd1535f280>,36,14,[5 9],37,-1,51,-1,37
1,<environment.Job instance at 0x7fbd15183e60>,45,12,[8 3],46,-1,58,-1,46
1,<environment.Job instance at 0x7fbd14ef30f0>,32,24,[8 2],33,-1,72,-1,48
1,<environment.Job instance at 0x7fbd147b11e0>,31,20,[5 3],32,-1,69,-1,49
1,<environment.Job instance at 0x7fbd156caa50>,49,25,[1 7],50,-1,75,-1,50
1,<environment.Job instance at 0x7fbd156ca500>,51,16,[5 9],52,-1,68,-1,52
1,<environment.Job instance at 0x7fbd156cac80>,52,17,[7 4],53,-1,70,-1,53
1,<environment.Job instance at 0x7fbd1547ea50>,53,14,[2 7],54,-1,68,-1,54
1,<environment.Job instance at 0x7fbd1547e1e0>,56,17,[10  4],57,-1,74,-1,57
1,<environment.Job instance at 0x7fbd1547e4b0>,58,14,[ 5 11],59,-1,73,-1,59
1,<environment.Job instance at 0x7fbd1547eeb0>,59,17,[1 7],60,-1,77,-1,60
1,<environment.Job instance at 0x7fbd1547e820>,60,14,[2 6],61,-1,75,-1,61
1,<environment.Job instance at 0x7fbd1403b960>,62,18,[ 1 10],63,-1,81,-1,63
1,<environment.Job instance at 0x7fbd1535ab40>,63,15,[1 5],64,-1,79,-1,64
1,<environment.Job instance at 0x7fbd1535a910>,64,12,[9 4],65,-1,77,-1,65
1,<environment.Job instance at 0x7fbd1535a7d0>,65,18,[6 1],66,-1,84,-1,66
1,<environment.Job instance at 0x7fbd1535ad20>,66,15,[4 7],67,-1,82,-1,67
1,<environment.Job instance at 0x7fbd1535a9b0>,68,17,[9 3],69,-1,86,-1,69
1,<environment.Job instance at 0x7fbd15781190>,70,14,[10  1],71,-1,85,-1,71
1,<environment.Job instance at 0x7fbd15781be0>,72,18,[10  1],73,-1,91,-1,73
1,<environment.Job instance at 0x7fbd15781dc0>,73,15,[7 2],74,-1,89,-1,74
1,<environment.Job instance at 0x7fbd15781eb0>,74,27,[1 7],75,-1,102,-1,75
1,<environment.Job instance at 0x7fbd15781870>,76,13,[4 6],77,-1,90,-1,77
1,<environment.Job instance at 0x7fbd1dccd4b0>,77,18,[6 1],78,-1,96,-1,78
1,<environment.Job instance at 0x7fbd1dccdf50>,78,17,[3 6],79,-1,96,-1,79
1,<environment.Job instance at 0x7fbd15183500>,47,12,[7 5],48,-1,91,-1,79
1,<environment.Job instance at 0x7fbd13dc66e0>,81,12,[ 5 10],82,-1,94,-1,82
1,<environment.Job instance at 0x7fbd1dccd7d0>,82,15,[4 7],83,-1,99,-1,84
1,<environment.Job instance at 0x7fbd13dc6730>,83,14,[9 2],84,-1,98,-1,84
1,<environment.Job instance at 0x7fbd145efa00>,86,16,[1 9],87,-1,108,-1,92
1,<environment.Job instance at 0x7fbd1454bd20>,95,13,[10  4],96,-1,109,-1,96
1,<environment.Job instance at 0x7fbd15411500>,96,19,[5 4],97,-1,116,-1,97
1,<environment.Job instance at 0x7fbd14d0acd0>,97,17,[1 8],98,-1,115,-1,98
1,<environment.Job instance at 0x7fbd13f570f0>,98,18,[4 6],99,-1,117,-1,99
1,<environment.Job instance at 0x7fbd144c59b0>,103,18,[10  1],104,-1,125,-1,107
1,<environment.Job instance at 0x7fbd141f2c30>,90,13,[4 7],91,-1,121,-1,108
1,<environment.Job instance at 0x7fbd14a72730>,105,16,[ 5 13],106,-1,124,-1,108
1,<environment.Job instance at 0x7fbd140d5c80>,111,16,[9 3],112,-1,128,-1,112
1,<environment.Job instance at 0x7fbd13f1eaf0>,115,13,[7 3],116,-1,129,-1,116
1,<environment.Job instance at 0x7fbd14a72c30>,106,17,[ 2 10],107,-1,134,-1,117
1,<environment.Job instance at 0x7fbd13f1e280>,116,17,[11  2],117,-1,134,-1,117
1,<environment.Job instance at 0x7fbd13f1e910>,114,14,[5 8],115,-1,133,-1,119
1,<environment.Job instance at 0x7fbd146b59b0>,119,23,[9 3],120,-1,143,-1,120
1,<environment.Job instance at 0x7fbd156316e0>,121,15,[7 4],122,-1,137,-1,122
1,<environment.Job instance at 0x7fbd15631e10>,122,16,[7 2],123,-1,142,-1,126
1,<environment.Job instance at 0x7fbd149d19b0>,125,14,[ 2 10],126,-1,141,-1,127
1,<environment.Job instance at 0x7fbd149d1c80>,127,18,[2 7],128,-1,147,-1,129
1,<environment.Job instance at 0x7fbd14f9f6e0>,129,15,[8 5],130,-1,145,-1,130
1,<environment.Job instance at 0x7fbd14f9f0a0>,130,22,[9 3],131,-1,155,-1,133
1,<environment.Job instance at 0x7fbd14f9ffa0>,132,12,[ 4 14],133,-1,148,-1,136
1,<environment.Job instance at 0x7fbd1406edc0>,136,14,[11  1],137,-1,151,-1,137
1,<environment.Job instance at 0x7fbd1406eb40>,135,14,[7 4],136,-1,152,-1,138
1,<environment.Job instance at 0x7fbd1406e1e0>,137,22,[7 3],138,-1,160,-1,138
1,<environment.Job instance at 0x7fbd1406eb90>,134,15,[7 5],135,-1,156,-1,141
1,<environment.Job instance at 0x7fbd1406ee10>,140,18,[1 7],141,-1,160,-1,142
1,<environment.Job instance at 0x7fbd1406e820>,144,2,[14  4],145,-1,149,-1,147
1,<environment.Job instance at 0x7fbd1406e9b0>,145,3,[14  3],146,-1,151,-1,148
1,<environment.Job instance at 0x7fbd1406e230>,146,18,[12  4],147,-1,166,-1,148
1,<environment.Job instance at 0x7fbd14f9fdc0>,131,28,[1 5],132,-1,176,-1,148
1,<environment.Job instance at 0x7fbd1406ea00>,141,14,[5 5],142,-1,162,-1,148
1,<environment.Job instance at 0x7fbd140d5f50>,112,15,[ 2 12],113,-1,164,-1,149
1,<environment.Job instance at 0x7fbd1406e2d0>,143,15,[3 8],144,-1,164,-1,149
1,<environment.Job instance at 0x7fbd1406e0f0>,148,14,[5 9],149,-1,163,-1,149
1,<environment.Job instance at 0x7fbd1406e190>,149,18,[5 9],150,-1,168,-1,150
1,<environment.Job instance at 0x7fbd1406eaf0>,150,18,[4 5],151,-1,169,-1,151
1,<environment.Job instance at 0x7fbd1406e640>,151,27,[6 5],152,-1,179,-1,152
1,<environment.Job instance at 0x7fbd14fddfa0>,154,17,[7 2],155,-1,173,-1,156
1,<environment.Job instance at 0x7fbd14fdd910>,157,16,[6 5],158,-1,175,-1,159
1,<environment.Job instance at 0x7fbd14fdd410>,158,25,[10  1],159,-1,184,-1,159
1,<environment.Job instance at 0x7fbd14fdd370>,159,23,[4 9],160,-1,183,-1,160
1,<environment.Job instance at 0x7fbd14fddcd0>,161,15,[10  3],162,-1,178,-1,163
1,<environment.Job instance at 0x7fbd153f97d0>,165,16,[1 9],166,-1,182,-1,166
1,<environment.Job instance at 0x7fbd1406ed20>,6,3,[ 5 11],7,-1,10,-1,7
1,<environment.Job instance at 0x7fbd152a0f50>,14,24,[8 1],15,-1,64,-1,40
1,<environment.Job instance at 0x7fbd140a1a00>,16,25,[6 2],17,-1,70,-1,45
1,<environment.Job instance at 0x7fbd14e365a0>,32,24,[8 2],33,-1,138,-1,114
1,<environment.Job instance at 0x7fbd1460fe60>,37,12,[13  5],38,-1,128,-1,116
1,<environment.Job instance at 0x7fbd14ac6960>,42,2,[ 1 12],43,-1,133,-1,131
1,<environment.Job instance at 0x7fbd150ab5f0>,49,25,[1 7],50,-1,183,-1,158
1,<environment.Job instance at 0x7fbd15587230>,58,14,[ 5 11],59,-1,212,-1,198
1,<environment.Job instance at 0x7fbd156e9b90>,74,27,[1 7],75,-1,320,-1,293
1,<environment.Job instance at 0x7fbd145a4be0>,105,16,[ 5 13],106,-1,446,-1,430
1,<environment.Job instance at 0x7fbd13ff0b40>,109,16,[ 1 13],110,-1,472,-1,456
1,<environment.Job instance at 0x7fbd1552d050>,112,15,[ 2 12],113,-1,476,-1,461
1,<environment.Job instance at 0x7fbd141dde10>,116,17,[11  2],117,-1,482,-1,465
1,<environment.Job instance at 0x7fbd1462c8c0>,119,23,[9 3],120,-1,503,-1,480
1,<environment.Job instance at 0x7fbd14dda3c0>,128,12,[ 1 13],129,-1,516,-1,504
1,<environment.Job instance at 0x7fbd13e75a00>,131,28,[1 5],132,-1,558,-1,530
1,<environment.Job instance at 0x7fbd13e75d70>,132,12,[ 4 14],133,-1,542,-1,530
1,<environment.Job instance at 0x7fbd15719190>,136,14,[11  1],137,-1,544,-1,530
1,<environment.Job instance at 0x7fbd13f28eb0>,144,2,[14  4],145,-1,574,-1,572
1,<environment.Job instance at 0x7fbd13f289b0>,145,3,[14  3],146,-1,575,-1,572
1,<environment.Job instance at 0x7fbd152e1e10>,146,18,[12  4],147,-1,590,-1,572
1,<environment.Job instance at 0x7fbd152e11e0>,147,3,[ 4 13],148,-1,575,-1,572
1,<environment.Job instance at 0x7fbd14514cd0>,151,27,[6 5],152,-1,618,-1,591
1,<environment.Job instance at 0x7fbd1463e730>,153,3,[ 1 13],154,-1,594,-1,591
1,<environment.Job instance at 0x7fbd13e73820>,156,16,[ 1 12],157,-1,607,-1,591
1,<environment.Job instance at 0x7fbd14abb500>,158,25,[10  1],159,-1,633,-1,608
1,<environment.Job instance at 0x7fbd13e73c30>,159,23,[4 9],160,-1,631,-1,608
1,<environment.Job instance at 0x7fbd143b7500>,167,25,[1 9],168,-1,656,-1,631
1,<environment.Job instance at 0x7fbd14c21050>,1,28,[6 2],2,-1,30,-1,2
1,<environment.Job instance at 0x7fbd14a79c30>,9,15,[8 4],10,-1,26,-1,11
1,<environment.Job instance at 0x7fbd14726550>,12,14,[6 3],13,-1,27,-1,13
1,<environment.Job instance at 0x7fbd14726eb0>,14,12,[8 5],15,-1,27,-1,15
1,<environment.Job instance at 0x7fbd1568c0f0>,10,12,[4 9],11,-1,27,-1,15
1,<environment.Job instance at 0x7fbd1478b910>,34,15,[2 8],35,-1,52,-1,37
1,<environment.Job instance at 0x7fbd1480cc80>,37,18,[5 9],38,-1,56,-1,38
1,<environment.Job instance at 0x7fbd1480c1e0>,36,15,[9 4],37,-1,53,-1,38
1,<environment.Job instance at 0x7fbd1480c320>,38,25,[3 6],39,-1,64,-1,39
1,<environment.Job instance at 0x7fbd1480c780>,40,17,[8 5],41,-1,58,-1,41
1,<environment.Job instance at 0x7fbd1480c3c0>,42,13,[3 8],43,-1,57,-1,44
1,<environment.Job instance at 0x7fbd1480c0f0>,44,12,[6 3],45,-1,57,-1,45
1,<environment.Job instance at 0x7fbd1480c370>,45,14,[7 2],46,-1,60,-1,46
1,<environment.Job instance at 0x7fbd1480cc30>,47,16,[2 5],48,-1,64,-1,48
1,<environment.Job instance at 0x7fbd1480c460>,48,15,[5 5],49,-1,64,-1,49
1,<environment.Job instance at 0x7fbd1480c410>,49,2,[2 7],50,-1,52,-1,50
1,<environment.Job instance at 0x7fbd1480ce10>,50,3,[1 7],51,-1,54,-1,51
1,<environment.Job instance at 0x7fbd156f5e60>,51,13,[ 4 11],52,-1,65,-1,52
1,<environment.Job instance at 0x7fbd156f5820>,52,20,[3 6],53,-1,73,-1,53
1,<environment.Job instance at 0x7fbd156f5690>,53,17,[10  4],54,-1,71,-1,54
1,<environment.Job instance at 0x7fbd156f57d0>,54,2,[10  3],55,-1,57,-1,55
1,<environment.Job instance at 0x7fbd1480ca50>,43,12,[5 7],44,-1,68,-1,56
1,<environment.Job instance at 0x7fbd156f5d70>,56,21,[10  4],57,-1,78,-1,57
1,<environment.Job instance at 0x7fbd156f5320>,57,15,[3 8],58,-1,73,-1,58
1,<environment.Job instance at 0x7fbd156f58c0>,59,15,[14  4],60,-1,75,-1,60
1,<environment.Job instance at 0x7fbd152779b0>,67,24,[9 5],68,-1,92,-1,68
1,<environment.Job instance at 0x7fbd152771e0>,68,17,[7 2],69,-1,86,-1,69
1,<environment.Job instance at 0x7fbd15277460>,69,15,[8 4],70,-1,85,-1,70
1,<environment.Job instance at 0x7fbd152775f0>,71,15,[5 5],72,-1,87,-1,72
1,<environment.Job instance at 0x7fbd15277410>,74,17,[7 2],75,-1,92,-1,75
1,<environment.Job instance at 0x7fbd14c9d910>,77,14,[3 8],78,-1,92,-1,78
1,<environment.Job instance at 0x7fbd14c9d870>,82,15,[9 5],83,-1,98,-1,83
1,<environment.Job instance at 0x7fbd14abbb90>,87,17,[3 5],88,-1,105,-1,88
1,<environment.Job instance at 0x7fbd14abb6e0>,93,22,[2 8],94,-1,119,-1,97
1,<environment.Job instance at 0x7fbd14abb140>,94,14,[2 5],95,-1,112,-1,98
1,<environment.Job instance at 0x7fbd14766f00>,97,18,[3 6],98,-1,116,-1,98
1,<environment.Job instance at 0x7fbd14735820>,102,20,[ 1 10],103,-1,123,-1,103
1,<environment.Job instance at 0x7fbd156f5050>,61,18,[3 7],62,-1,124,-1,106
1,<environment.Job instance at 0x7fbd153eab40>,103,17,[6 1],104,-1,123,-1,106
1,<environment.Job instance at 0x7fbd156f5190>,60,16,[10  1],61,-1,122,-1,106
1,<environment.Job instance at 0x7fbd153ea280>,106,16,[ 2 10],107,-1,123,-1,107
1,<environment.Job instance at 0x7fbd14ee3190>,116,17,[3 9],117,-1,134,-1,117
1,<environment.Job instance at 0x7fbd14ee3e60>,118,17,[2 8],119,-1,138,-1,121
1,<environment.Job instance at 0x7fbd14ee3230>,121,19,[6 5],122,-1,141,-1,122
1,<environment.Job instance at 0x7fbd14ee3c80>,122,25,[3 6],123,-1,148,-1,123
1,<environment.Job instance at 0x7fbd1499aaf0>,112,21,[9 2],113,-1,145,-1,124
1,<environment.Job instance at 0x7fbd153ea870>,105,13,[13  1],106,-1,139,-1,126
1,<environment.Job instance at 0x7fbd14ee30f0>,123,2,[ 3 10],124,-1,128,-1,126
1,<environment.Job instance at 0x7fbd1410f500>,135,13,[4 8],136,-1,156,-1,143
1,<environment.Job instance at 0x7fbd14d3a140>,142,18,[ 5 10],143,-1,161,-1,143
1,<environment.Job instance at 0x7fbd14a79500>,1,28,[6 2],2,-1,30,-1,2
1,<environment.Job instance at 0x7fbd14ee39b0>,23,1,[ 4 14],24,-1,41,-1,40
1,<environment.Job instance at 0x7fbd142d7c30>,33,12,[ 1 14],34,-1,63,-1,51
1,<environment.Job instance at 0x7fbd155677d0>,38,25,[3 6],39,-1,96,-1,71
1,<environment.Job instance at 0x7fbd15719190>,51,13,[ 4 11],52,-1,127,-1,114
1,<environment.Job instance at 0x7fbd145a4f00>,59,15,[14  4],60,-1,157,-1,142
1,<environment.Job instance at 0x7fbd14818f00>,67,24,[9 5],68,-1,194,-1,170
1,<environment.Job instance at 0x7fbd1dd3b5a0>,76,1,[12  5],77,-1,203,-1,202
1,<environment.Job instance at 0x7fbd13fc5eb0>,79,16,[13  2],80,-1,228,-1,212
1,<environment.Job instance at 0x7fbd14455910>,105,13,[13  1],106,-1,287,-1,274
1,<environment.Job instance at 0x7fbd14e365a0>,108,17,[ 3 13],109,-1,305,-1,288
1,<environment.Job instance at 0x7fbd14f6c8c0>,115,13,[ 4 14],116,-1,320,-1,307
1,<environment.Job instance at 0x7fbd140a1550>,122,25,[3 6],123,-1,354,-1,329
1,<environment.Job instance at 0x7fbd157409b0>,128,3,[ 1 13],129,-1,367,-1,364
1,<environment.Job instance at 0x7fbd157403c0>,143,17,[13  3],144,-1,406,-1,389
1,<environment.Job instance at 0x7fbd1426f2d0>,147,13,[12  4],148,-1,419,-1,406
1,<environment.Job instance at 0x7fbd1426fa50>,157,18,[ 3 12],158,-1,455,-1,437
1,<environment.Job instance at 0x7fbd150673c0>,7,16,[6 1],8,-1,25,-1,9
1,<environment.Job instance at 0x7fbd150679b0>,9,18,[4 5],10,-1,28,-1,10
1,<environment.Job instance at 0x7fbd14abb4b0>,8,14,[5 4],9,-1,24,-1,10
1,<environment.Job instance at 0x7fbd150670a0>,10,18,[6 2],11,-1,30,-1,12
1,<environment.Job instance at 0x7fbd15067b40>,12,15,[4 8],13,-1,28,-1,13
1,<environment.Job instance at 0x7fbd153e19b0>,14,18,[ 3 10],15,-1,33,-1,15
1,<environment.Job instance at 0x7fbd153e12d0>,17,18,[2 7],18,-1,36,-1,18
1,<environment.Job instance at 0x7fbd153e1690>,18,16,[10  5],19,-1,35,-1,19
1,<environment.Job instance at 0x7fbd14560eb0>,22,26,[8 2],23,-1,49,-1,23
1,<environment.Job instance at 0x7fbd14656eb0>,25,18,[10  1],26,-1,45,-1,27
1,<environment.Job instance at 0x7fbd1df69730>,27,13,[8 1],28,-1,41,-1,28
1,<environment.Job instance at 0x7fbd252f2960>,26,27,[5 8],27,-1,57,-1,30
1,<environment.Job instance at 0x7fbd1480b0a0>,30,21,[5 7],31,-1,52,-1,31
1,<environment.Job instance at 0x7fbd14e56c30>,38,16,[2 8],39,-1,56,-1,40
1,<environment.Job instance at 0x7fbd14547320>,43,26,[7 3],44,-1,70,-1,44
1,<environment.Job instance at 0x7fbd14bfc2d0>,44,18,[5 8],45,-1,63,-1,45
1,<environment.Job instance at 0x7fbd14bfcaa0>,45,15,[3 7],46,-1,61,-1,46
1,<environment.Job instance at 0x7fbd14bfcd70>,46,17,[5 7],47,-1,64,-1,47
1,<environment.Job instance at 0x7fbd14bfc640>,47,14,[ 4 10],48,-1,72,-1,58
1,<environment.Job instance at 0x7fbd148188c0>,59,15,[10  1],60,-1,75,-1,60
1,<environment.Job instance at 0x7fbd14818cd0>,60,18,[8 5],61,-1,79,-1,61
1,<environment.Job instance at 0x7fbd14818910>,62,14,[8 4],63,-1,80,-1,66
1,<environment.Job instance at 0x7fbd13fe5500>,63,15,[3 5],64,-1,81,-1,66
1,<environment.Job instance at 0x7fbd13fe5910>,66,25,[10  1],67,-1,92,-1,67
1,<environment.Job instance at 0x7fbd1e22af00>,53,13,[5 5],54,-1,83,-1,70
1,<environment.Job instance at 0x7fbd14818e10>,57,24,[9 3],58,-1,94,-1,70
1,<environment.Job instance at 0x7fbd13fe55f0>,65,12,[5 5],66,-1,82,-1,70
1,<environment.Job instance at 0x7fbd157cac80>,74,17,[9 3],75,-1,102,-1,85
1,<environment.Job instance at 0x7fbd143310a0>,73,27,[4 5],74,-1,118,-1,91
1,<environment.Job instance at 0x7fbd14455550>,79,14,[7 4],80,-1,105,-1,91
1,<environment.Job instance at 0x7fbd15589c30>,76,17,[2 5],77,-1,108,-1,91
1,<environment.Job instance at 0x7fbd14336c30>,82,17,[6 5],83,-1,108,-1,91
1,<environment.Job instance at 0x7fbd1414de60>,81,17,[ 5 10],82,-1,108,-1,91
1,<environment.Job instance at 0x7fbd14412640>,72,14,[6 4],73,-1,105,-1,91
1,<environment.Job instance at 0x7fbd155bb500>,85,12,[10  5],86,-1,103,-1,91
1,<environment.Job instance at 0x7fbd14275370>,86,19,[5 9],87,-1,114,-1,95
1,<environment.Job instance at 0x7fbd155bb4b0>,84,16,[ 2 11],85,-1,111,-1,95
1,<environment.Job instance at 0x7fbd156e02d0>,75,20,[5 6],76,-1,116,-1,96
1,<environment.Job instance at 0x7fbd14766230>,87,17,[4 5],88,-1,113,-1,96
1,<environment.Job instance at 0x7fbd1562f1e0>,90,16,[4 9],91,-1,112,-1,96
1,<environment.Job instance at 0x7fbd13ff6370>,93,14,[7 2],94,-1,110,-1,96
1,<environment.Job instance at 0x7fbd13ff62d0>,94,13,[9 2],95,-1,109,-1,96
1,<environment.Job instance at 0x7fbd13e9de60>,96,15,[2 9],97,-1,112,-1,97
1,<environment.Job instance at 0x7fbd14ab2820>,97,17,[3 8],98,-1,115,-1,98
1,<environment.Job instance at 0x7fbd14ab2190>,98,18,[5 5],99,-1,117,-1,99
1,<environment.Job instance at 0x7fbd14102500>,101,14,[5 7],102,-1,118,-1,104
1,<environment.Job instance at 0x7fbd14e0e5f0>,103,20,[2 6],104,-1,125,-1,105
1,<environment.Job instance at 0x7fbd14331aa0>,70,24,[ 4 13],71,-1,131,-1,107
1,<environment.Job instance at 0x7fbd15118410>,106,15,[8 4],107,-1,122,-1,107
1,<environment.Job instance at 0x7fbd15118960>,108,18,[5 3],109,-1,137,-1,119
1,<environment.Job instance at 0x7fbd151180f0>,111,28,[7 5],112,-1,147,-1,119
1,<environment.Job instance at 0x7fbd15118cd0>,110,15,[1 8],111,-1,134,-1,119
1,<environment.Job instance at 0x7fbd15118af0>,113,15,[10  2],114,-1,134,-1,119
1,<environment.Job instance at 0x7fbd15118e60>,115,17,[2 9],116,-1,136,-1,119
1,<environment.Job instance at 0x7fbd14102be0>,102,18,[5 7],103,-1,138,-1,120
1,<environment.Job instance at 0x7fbd156d1190>,117,14,[3 8],118,-1,134,-1,120
1,<environment.Job instance at 0x7fbd156d1550>,119,18,[4 6],120,-1,139,-1,121
1,<environment.Job instance at 0x7fbd1485e960>,122,17,[9 3],123,-1,142,-1,125
1,<environment.Job instance at 0x7fbd14ba4730>,124,14,[2 9],125,-1,140,-1,126
1,<environment.Job instance at 0x7fbd154dbaa0>,126,18,[9 5],127,-1,145,-1,127
1,<environment.Job instance at 0x7fbd1550c460>,127,15,[10  2],128,-1,143,-1,128
1,<environment.Job instance at 0x7fbd1550c050>,129,16,[ 2 10],130,-1,146,-1,130
1,<environment.Job instance at 0x7fbd1550c3c0>,131,14,[10  4],132,-1,152,-1,138
1,<environment.Job instance at 0x7fbd1550c280>,133,15,[ 4 10],134,-1,153,-1,138
1,<environment.Job instance at 0x7fbd14bf90a0>,143,17,[ 4 10],144,-1,171,-1,154
1,<environment.Job instance at 0x7fbd14bf92d0>,146,16,[ 1 10],147,-1,173,-1,157
1,<environment.Job instance at 0x7fbd14bf9e10>,147,18,[ 3 11],148,-1,175,-1,157
1,<environment.Job instance at 0x7fbd14bf9c30>,150,18,[7 5],151,-1,177,-1,159
1,<environment.Job instance at 0x7fbd14bf99b0>,151,16,[5 5],152,-1,175,-1,159
1,<environment.Job instance at 0x7fbd14102370>,99,16,[13  5],100,-1,201,-1,185
1,<environment.Job instance at 0x7fbd14cb9730>,161,18,[6 5],162,-1,221,-1,203
1,<environment.Job instance at 0x7fbd14cb95a0>,164,28,[10  4],165,-1,231,-1,203
1,<environment.Job instance at 0x7fbd143319b0>,1,16,[ 1 11],2,-1,18,-1,2
1,<environment.Job instance at 0x7fbd14d307d0>,13,18,[12  1],14,-1,36,-1,18
1,<environment.Job instance at 0x7fbd1426fa50>,22,26,[8 2],23,-1,90,-1,64
1,<environment.Job instance at 0x7fbd1426f7d0>,26,27,[5 8],27,-1,99,-1,72
1,<environment.Job instance at 0x7fbd15740320>,40,3,[ 3 12],41,-1,100,-1,97
1,<environment.Job instance at 0x7fbd15740280>,43,26,[7 3],44,-1,140,-1,114
1,<environment.Job instance at 0x7fbd13fe5b90>,57,24,[9 3],58,-1,200,-1,176
1,<environment.Job instance at 0x7fbd155bbfa0>,64,1,[12  4],65,-1,190,-1,189
1,<environment.Job instance at 0x7fbd14275820>,66,25,[10  1],67,-1,228,-1,203
1,<environment.Job instance at 0x7fbd14560b90>,70,24,[ 4 13],71,-1,232,-1,208
1,<environment.Job instance at 0x7fbd14630140>,71,14,[12  1],72,-1,222,-1,208
1,<environment.Job instance at 0x7fbd148c45f0>,73,27,[4 5],74,-1,248,-1,221
1,<environment.Job instance at 0x7fbd14b89550>,84,16,[ 2 11],85,-1,280,-1,264
1,<environment.Job instance at 0x7fbd15211aa0>,99,16,[13  5],100,-1,337,-1,321
1,<environment.Job instance at 0x7fbd1522b7d0>,107,1,[ 3 11],108,-1,357,-1,356
1,<environment.Job instance at 0x7fbd14f64b40>,111,28,[7 5],112,-1,415,-1,387
1,<environment.Job instance at 0x7fbd1521be60>,137,1,[ 2 11],138,-1,494,-1,493
1,<environment.Job instance at 0x7fbd145ce820>,145,3,[ 4 12],146,-1,527,-1,524
1,<environment.Job instance at 0x7fbd14f5cfa0>,147,18,[ 3 11],148,-1,542,-1,524
1,<environment.Job instance at 0x7fbd145af870>,148,2,[14  5],149,-1,526,-1,524
1,<environment.Job instance at 0x7fbd145cc0a0>,156,24,[5 3],157,-1,588,-1,564
1,<environment.Job instance at 0x7fbd145d6b90>,164,28,[10  4],165,-1,625,-1,597
1,<environment.Job instance at 0x7fbd145d6640>,165,15,[ 4 12],166,-1,612,-1,597
1,<environment.Job instance at 0x7fbd143d7af0>,1,18,[ 5 10],2,-1,20,-1,2
1,<environment.Job instance at 0x7fbd1568abe0>,3,18,[2 7],4,-1,22,-1,4
1,<environment.Job instance at 0x7fbd15112960>,5,15,[10  1],6,-1,25,-1,10
1,<environment.Job instance at 0x7fbd1e0850f0>,9,14,[8 2],10,-1,24,-1,10
1,<environment.Job instance at 0x7fbd1466af50>,13,17,[ 1 10],14,-1,32,-1,15
1,<environment.Job instance at 0x7fbd1466a550>,20,15,[ 4 10],21,-1,36,-1,21
1,<environment.Job instance at 0x7fbd15329af0>,22,15,[7 5],23,-1,38,-1,23
1,<environment.Job instance at 0x7fbd1424a0a0>,25,16,[9 5],26,-1,42,-1,26
1,<environment.Job instance at 0x7fbd14815be0>,26,18,[6 5],27,-1,45,-1,27
1,<environment.Job instance at 0x7fbd1423ac30>,34,12,[10  4],35,-1,47,-1,35
1,<environment.Job instance at 0x7fbd14fbb780>,35,21,[ 2 10],36,-1,57,-1,36
1,<environment.Job instance at 0x7fbd14fbbd20>,36,15,[8 4],37,-1,52,-1,37
1,<environment.Job instance at 0x7fbd13e79910>,43,12,[9 4],44,-1,56,-1,44
1,<environment.Job instance at 0x7fbd155e79b0>,49,12,[6 4],50,-1,63,-1,51
1,<environment.Job instance at 0x7fbd155e71e0>,52,16,[4 9],53,-1,69,-1,53
1,<environment.Job instance at 0x7fbd13ea4eb0>,55,20,[5 4],56,-1,76,-1,56
1,<environment.Job instance at 0x7fbd13ea4910>,56,24,[ 1 10],57,-1,81,-1,57
1,<environment.Job instance at 0x7fbd14f8c960>,60,15,[3 9],61,-1,76,-1,61
1,<environment.Job instance at 0x7fbd1569e050>,61,17,[5 8],62,-1,79,-1,62
1,<environment.Job instance at 0x7fbd1569ee60>,63,25,[4 6],64,-1,89,-1,64
1,<environment.Job instance at 0x7fbd1569e1e0>,64,16,[ 5 10],65,-1,81,-1,65
1,<environment.Job instance at 0x7fbd14fb49b0>,71,14,[ 5 10],72,-1,86,-1,72
1,<environment.Job instance at 0x7fbd156723c0>,73,18,[ 5 12],74,-1,92,-1,74
1,<environment.Job instance at 0x7fbd14fb4d20>,74,16,[2 9],75,-1,92,-1,76
1,<environment.Job instance at 0x7fbd153f6550>,75,16,[7 5],76,-1,94,-1,78
1,<environment.Job instance at 0x7fbd1e085eb0>,14,19,[3 6],15,-1,100,-1,81
1,<environment.Job instance at 0x7fbd1480b050>,80,15,[9 1],81,-1,98,-1,83
1,<environment.Job instance at 0x7fbd155e7f50>,7,2,[ 5 12],8,-1,10,-1,8
1,<environment.Job instance at 0x7fbd1e2d30a0>,12,25,[2 8],13,-1,48,-1,23
1,<environment.Job instance at 0x7fbd14fb4a50>,16,26,[ 1 12],17,-1,49,-1,23
1,<environment.Job instance at 0x7fbd14647050>,23,2,[11  4],24,-1,53,-1,51
1,<environment.Job instance at 0x7fbd14647a50>,27,2,[11  1],28,-1,58,-1,56
1,<environment.Job instance at 0x7fbd1405ebe0>,39,2,[ 3 11],40,-1,97,-1,95
1,<environment.Job instance at 0x7fbd14b91460>,50,24,[2 5],51,-1,145,-1,121
1,<environment.Job instance at 0x7fbd141e15f0>,57,3,[13  1],58,-1,141,-1,138
1,<environment.Job instance at 0x7fbd149e5fa0>,56,24,[ 1 10],57,-1,163,-1,139
1,<environment.Job instance at 0x7fbd149d0730>,63,25,[4 6],64,-1,181,-1,156
1,<environment.Job instance at 0x7fbd15304230>,73,18,[ 5 12],74,-1,205,-1,187
1,<environment.Job instance at 0x7fbd14f15870>,79,16,[14  3],80,-1,223,-1,207
1,<environment.Job instance at 0x7fbd141fb230>,89,3,[14  2],90,-1,250,-1,247
1,<environment.Job instance at 0x7fbd14162e10>,106,23,[ 4 10],107,-1,343,-1,320
1,<environment.Job instance at 0x7fbd1574fd70>,109,2,[13  2],110,-1,323,-1,321
1,<environment.Job instance at 0x7fbd1517a0a0>,123,24,[ 5 11],124,-1,395,-1,371
1,<environment.Job instance at 0x7fbd14323f50>,134,16,[12  5],135,-1,440,-1,424
1,<environment.Job instance at 0x7fbd14f2b780>,141,19,[14  4],142,-1,462,-1,443
1,<environment.Job instance at 0x7fbd1465f820>,147,3,[ 5 11],148,-1,470,-1,467
1,<environment.Job instance at 0x7fbd14b7ceb0>,148,1,[11  4],149,-1,468,-1,467
1,<environment.Job instance at 0x7fbd14fb1910>,3,18,[5 3],4,-1,22,-1,4
1,<environment.Job instance at 0x7fbd14fb1690>,4,14,[7 5],5,-1,19,-1,5
1,<environment.Job instance at 0x7fbd14fb1960>,6,22,[8 4],7,-1,29,-1,7
1,<environment.Job instance at 0x7fbd14fb1730>,7,20,[5 5],8,-1,28,-1,8
1,<environment.Job instance at 0x7fbd14fb1640>,8,20,[6 2],9,-1,29,-1,9
1,<environment.Job instance at 0x7fbd1569ec30>,16,3,[5 1],17,-1,20,-1,17
1,<environment.Job instance at 0x7fbd1569eb90>,17,14,[5 4],18,-1,32,-1,18
1,<environment.Job instance at 0x7fbd1569e820>,19,13,[7 2],20,-1,33,-1,20
1,<environment.Job instance at 0x7fbd1569e500>,22,12,[10  2],23,-1,36,-1,24
1,<environment.Job instance at 0x7fbd1569e870>,24,17,[5 1],25,-1,42,-1,25
1,<environment.Job instance at 0x7fbd14261be0>,27,23,[2 9],28,-1,51,-1,28
1,<environment.Job instance at 0x7fbd1569e960>,23,13,[3 6],24,-1,43,-1,30
1,<environment.Job instance at 0x7fbd14261a00>,29,16,[7 1],30,-1,47,-1,31
1,<environment.Job instance at 0x7fbd142617d0>,33,16,[8 1],34,-1,50,-1,34
1,<environment.Job instance at 0x7fbd14261e60>,34,17,[5 5],35,-1,52,-1,35
1,<environment.Job instance at 0x7fbd14261140>,36,15,[10  3],37,-1,53,-1,38
1,<environment.Job instance at 0x7fbd14261d70>,39,18,[4 9],40,-1,58,-1,40
1,<environment.Job instance at 0x7fbd14fbba50>,42,13,[4 8],43,-1,56,-1,43
1,<environment.Job instance at 0x7fbd14fbb820>,44,13,[5 5],45,-1,58,-1,45
1,<environment.Job instance at 0x7fbd14261690>,37,15,[5 3],38,-1,61,-1,46
1,<environment.Job instance at 0x7fbd14fbb870>,49,12,[10  1],50,-1,63,-1,51
1,<environment.Job instance at 0x7fbd14cb90a0>,51,23,[10  2],52,-1,77,-1,54
1,<environment.Job instance at 0x7fbd14cb92d0>,55,17,[5 9],56,-1,75,-1,58
1,<environment.Job instance at 0x7fbd14cb9140>,54,18,[2 9],55,-1,76,-1,58
1,<environment.Job instance at 0x7fbd14cb9aa0>,53,17,[6 2],54,-1,77,-1,60
1,<environment.Job instance at 0x7fbd14688320>,59,15,[1 8],60,-1,75,-1,60
1,<environment.Job instance at 0x7fbd14cb9780>,58,18,[1 6],59,-1,79,-1,61
1,<environment.Job instance at 0x7fbd14cb9460>,56,15,[3 6],57,-1,78,-1,63
1,<environment.Job instance at 0x7fbd146883c0>,61,15,[4 5],62,-1,78,-1,63
1,<environment.Job instance at 0x7fbd146884b0>,63,14,[1 6],64,-1,78,-1,64
1,<environment.Job instance at 0x7fbd14688870>,64,17,[7 2],65,-1,82,-1,65
1,<environment.Job instance at 0x7fbd14688d20>,66,15,[9 5],67,-1,82,-1,67
1,<environment.Job instance at 0x7fbd14688910>,67,17,[10  1],68,-1,85,-1,68
1,<environment.Job instance at 0x7fbd14688190>,68,16,[ 5 10],69,-1,85,-1,69
1,<environment.Job instance at 0x7fbd146885a0>,69,17,[3 7],70,-1,87,-1,70
1,<environment.Job instance at 0x7fbd13f78be0>,74,18,[8 4],75,-1,93,-1,75
1,<environment.Job instance at 0x7fbd13f780f0>,80,17,[ 5 11],81,-1,98,-1,81
1,<environment.Job instance at 0x7fbd152b62d0>,85,13,[10  4],86,-1,99,-1,86
1,<environment.Job instance at 0x7fbd1569e640>,21,12,[8 3],22,-1,98,-1,86
1,<environment.Job instance at 0x7fbd152b6410>,86,3,[10  3],87,-1,90,-1,87
1,<environment.Job instance at 0x7fbd152b6e60>,87,3,[9 5],88,-1,91,-1,88
1,<environment.Job instance at 0x7fbd14688050>,62,15,[9 3],63,-1,104,-1,89
1,<environment.Job instance at 0x7fbd152b6f00>,89,17,[4 5],90,-1,107,-1,90
1,<environment.Job instance at 0x7fbd152b6c30>,90,14,[8 4],91,-1,105,-1,91
1,<environment.Job instance at 0x7fbd14547960>,91,21,[9 2],92,-1,115,-1,94
1,<environment.Job instance at 0x7fbd145472d0>,93,15,[8 1],94,-1,109,-1,94
1,<environment.Job instance at 0x7fbd14547aa0>,97,22,[8 1],98,-1,122,-1,100
1,<environment.Job instance at 0x7fbd14547820>,101,16,[5 5],102,-1,118,-1,102
1,<environment.Job instance at 0x7fbd14547320>,102,17,[1 6],103,-1,120,-1,103
1,<environment.Job instance at 0x7fbd156002d0>,105,17,[10  3],106,-1,123,-1,106
1,<environment.Job instance at 0x7fbd14547c80>,99,14,[ 4 10],100,-1,120,-1,106
1,<environment.Job instance at 0x7fbd15600820>,106,16,[ 3 10],107,-1,123,-1,107
1,<environment.Job instance at 0x7fbd14bfc9b0>,111,25,[12  4],112,-1,137,-1,112
1,<environment.Job instance at 0x7fbd15600910>,112,18,[10  1],113,-1,131,-1,113
1,<environment.Job instance at 0x7fbd14f89230>,110,13,[10  2],111,-1,127,-1,114
1,<environment.Job instance at 0x7fbd140644b0>,116,17,[6 4],117,-1,134,-1,117
1,<environment.Job instance at 0x7fbd154db640>,117,15,[3 7],118,-1,133,-1,118
1,<environment.Job instance at 0x7fbd1423a6e0>,120,17,[3 6],121,-1,138,-1,121
1,<environment.Job instance at 0x7fbd156726e0>,121,15,[3 7],122,-1,137,-1,122
1,<environment.Job instance at 0x7fbd14547690>,122,16,[8 3],123,-1,139,-1,123
1,<environment.Job instance at 0x7fbd143113c0>,113,21,[1 5],114,-1,145,-1,124
1,<environment.Job instance at 0x7fbd14578500>,124,16,[8 1],125,-1,142,-1,126
1,<environment.Job instance at 0x7fbd14578910>,126,17,[5 4],127,-1,144,-1,127
1,<environment.Job instance at 0x7fbd14578b40>,128,15,[1 7],129,-1,144,-1,129
1,<environment.Job instance at 0x7fbd145786e0>,129,16,[4 5],130,-1,146,-1,130
1,<environment.Job instance at 0x7fbd15167cd0>,133,17,[5 3],134,-1,151,-1,134
1,<environment.Job instance at 0x7fbd15167050>,136,13,[6 4],137,-1,150,-1,137
1,<environment.Job instance at 0x7fbd1496fcd0>,147,18,[9 5],148,-1,168,-1,150
1,<environment.Job instance at 0x7fbd1496f690>,141,18,[7 5],142,-1,168,-1,150
1,<environment.Job instance at 0x7fbd1496f280>,146,17,[6 5],147,-1,167,-1,150
1,<environment.Job instance at 0x7fbd1496ffa0>,144,13,[ 2 10],145,-1,163,-1,150
1,<environment.Job instance at 0x7fbd1496f9b0>,143,18,[13  1],144,-1,169,-1,151
1,<environment.Job instance at 0x7fbd1430c910>,150,3,[2 8],151,-1,155,-1,152
1,<environment.Job instance at 0x7fbd1430cb40>,154,17,[9 4],155,-1,172,-1,155
1,<environment.Job instance at 0x7fbd1430c640>,159,16,[3 8],160,-1,179,-1,163
1,<environment.Job instance at 0x7fbd1430cc80>,156,23,[ 4 10],157,-1,191,-1,168
1,<environment.Job instance at 0x7fbd1430c500>,162,25,[12  5],163,-1,194,-1,169
1,<environment.Job instance at 0x7fbd1430c550>,161,28,[9 4],162,-1,197,-1,169
1,<environment.Job instance at 0x7fbd1430ca50>,157,15,[10  1],158,-1,184,-1,169
1,<environment.Job instance at 0x7fbd146460f0>,168,12,[9 2],169,-1,181,-1,169
1,<environment.Job instance at 0x7fbd13f788c0>,10,17,[11  3],11,-1,32,-1,15
1,<environment.Job instance at 0x7fbd156008c0>,15,1,[ 5 14],16,-1,19,-1,18
1,<environment.Job instance at 0x7fbd1430c280>,27,23,[2 9],28,-1,86,-1,63
1,<environment.Job instance at 0x7fbd1430ce60>,28,2,[ 1 11],29,-1,65,-1,63
1,<environment.Job instance at 0x7fbd14038550>,51,23,[10  2],52,-1,166,-1,143
1,<environment.Job instance at 0x7fbd14664f00>,71,26,[14  5],72,-1,274,-1,248
1,<environment.Job instance at 0x7fbd149e5370>,80,17,[ 5 11],81,-1,289,-1,272
1,<environment.Job instance at 0x7fbd140661e0>,94,3,[13  3],95,-1,302,-1,299
1,<environment.Job instance at 0x7fbd1489a550>,111,25,[12  4],112,-1,394,-1,369
1,<environment.Job instance at 0x7fbd13f1e050>,138,16,[ 4 12],139,-1,503,-1,487
1,<environment.Job instance at 0x7fbd146187d0>,142,3,[12  2],143,-1,507,-1,504
1,<environment.Job instance at 0x7fbd14618730>,143,18,[13  1],144,-1,522,-1,504
1,<environment.Job instance at 0x7fbd149a97d0>,156,23,[ 4 10],157,-1,586,-1,563
1,<environment.Job instance at 0x7fbd149a9960>,161,28,[9 4],162,-1,601,-1,573
1,<environment.Job instance at 0x7fbd149a9f50>,162,25,[12  5],163,-1,598,-1,573
1,<environment.Job instance at 0x7fbd15325550>,6,18,[7 1],7,-1,27,-1,9
1,<environment.Job instance at 0x7fbd15325820>,8,17,[6 1],9,-1,26,-1,9
1,<environment.Job instance at 0x7fbd15325b90>,11,18,[9 3],12,-1,30,-1,12
1,<environment.Job instance at 0x7fbd15325eb0>,15,16,[3 7],16,-1,32,-1,16
1,<environment.Job instance at 0x7fbd1531b370>,19,16,[4 7],20,-1,36,-1,20
1,<environment.Job instance at 0x7fbd1531b0f0>,21,14,[8 4],22,-1,37,-1,23
1,<environment.Job instance at 0x7fbd1531b690>,24,16,[5 5],25,-1,41,-1,25
1,<environment.Job instance at 0x7fbd1531b3c0>,22,24,[3 5],23,-1,49,-1,25
1,<environment.Job instance at 0x7fbd1531b6e0>,26,15,[4 5],27,-1,43,-1,28
1,<environment.Job instance at 0x7fbd1531b820>,27,17,[6 2],28,-1,46,-1,29
1,<environment.Job instance at 0x7fbd1531b910>,33,14,[11  5],34,-1,49,-1,35
1,<environment.Job instance at 0x7fbd1534f190>,35,14,[4 9],36,-1,50,-1,36
1,<environment.Job instance at 0x7fbd1534f5a0>,39,15,[9 4],40,-1,55,-1,40
1,<environment.Job instance at 0x7fbd1534f500>,41,19,[5 8],42,-1,61,-1,42
1,<environment.Job instance at 0x7fbd1534f910>,42,13,[4 6],43,-1,56,-1,43
1,<environment.Job instance at 0x7fbd1533cd70>,44,14,[ 1 10],45,-1,59,-1,45
1,<environment.Job instance at 0x7fbd1533c5a0>,46,13,[ 3 10],47,-1,60,-1,47
1,<environment.Job instance at 0x7fbd1533c550>,47,18,[1 6],48,-1,66,-1,48
1,<environment.Job instance at 0x7fbd1533c0f0>,48,16,[6 3],49,-1,65,-1,49
1,<environment.Job instance at 0x7fbd1534f050>,34,17,[3 7],35,-1,72,-1,55
1,<environment.Job instance at 0x7fbd1531d320>,58,17,[ 1 10],59,-1,81,-1,64
1,<environment.Job instance at 0x7fbd1533c460>,51,13,[5 5],52,-1,79,-1,66
1,<environment.Job instance at 0x7fbd1531d870>,57,1,[4 9],58,-1,67,-1,66
1,<environment.Job instance at 0x7fbd140ba640>,64,16,[ 2 11],65,-1,82,-1,66
1,<environment.Job instance at 0x7fbd1531d190>,62,12,[7 5],63,-1,79,-1,67
1,<environment.Job instance at 0x7fbd1531d2d0>,65,12,[5 6],66,-1,79,-1,67
1,<environment.Job instance at 0x7fbd1531d500>,67,15,[4 6],68,-1,83,-1,68
1,<environment.Job instance at 0x7fbd14e97820>,70,15,[6 2],71,-1,87,-1,72
1,<environment.Job instance at 0x7fbd1531d7d0>,63,2,[5 8],64,-1,75,-1,73
1,<environment.Job instance at 0x7fbd15361d20>,71,15,[8 2],72,-1,88,-1,73
1,<environment.Job instance at 0x7fbd13ef6320>,74,14,[9 4],75,-1,89,-1,75
1,<environment.Job instance at 0x7fbd13ef6550>,78,15,[6 2],79,-1,98,-1,83
1,<environment.Job instance at 0x7fbd13f0a370>,81,17,[ 3 10],82,-1,100,-1,83
1,<environment.Job instance at 0x7fbd13f0a6e0>,80,13,[1 6],81,-1,100,-1,87
1,<environment.Job instance at 0x7fbd13f0cc30>,76,15,[13  1],77,-1,103,-1,88
1,<environment.Job instance at 0x7fbd13f24aa0>,86,14,[8 1],87,-1,102,-1,88
1,<environment.Job instance at 0x7fbd1533c370>,52,16,[8 5],53,-1,106,-1,90
1,<environment.Job instance at 0x7fbd13f242d0>,90,22,[5 2],91,-1,113,-1,91
1,<environment.Job instance at 0x7fbd13f24a50>,95,19,[9 4],96,-1,118,-1,99
1,<environment.Job instance at 0x7fbd13f03280>,100,28,[6 4],101,-1,129,-1,101
1,<environment.Job instance at 0x7fbd144681e0>,97,14,[2 5],98,-1,119,-1,105
1,<environment.Job instance at 0x7fbd144605a0>,103,12,[2 9],104,-1,117,-1,105
1,<environment.Job instance at 0x7fbd13f03230>,105,26,[9 2],106,-1,132,-1,106
1,<environment.Job instance at 0x7fbd13f03410>,106,17,[3 7],107,-1,124,-1,107
1,<environment.Job instance at 0x7fbd15339820>,107,16,[10  1],108,-1,124,-1,108
1,<environment.Job instance at 0x7fbd153396e0>,108,15,[10  2],109,-1,124,-1,109
1,<environment.Job instance at 0x7fbd15339410>,110,16,[8 1],111,-1,128,-1,112
1,<environment.Job instance at 0x7fbd1533b460>,111,23,[4 5],112,-1,135,-1,112
1,<environment.Job instance at 0x7fbd1533b0a0>,112,14,[8 4],113,-1,131,-1,117
1,<environment.Job instance at 0x7fbd13efdfa0>,117,16,[1 9],118,-1,134,-1,118
1,<environment.Job instance at 0x7fbd13efdc30>,116,17,[14  5],117,-1,140,-1,123
1,<environment.Job instance at 0x7fbd13efd910>,119,18,[4 8],120,-1,143,-1,125
1,<environment.Job instance at 0x7fbd13efd5f0>,125,17,[2 6],126,-1,144,-1,127
1,<environment.Job instance at 0x7fbd13efdeb0>,124,21,[10  4],125,-1,150,-1,129
1,<environment.Job instance at 0x7fbd1531daf0>,53,21,[4 8],54,-1,151,-1,130
1,<environment.Job instance at 0x7fbd1532fe60>,128,26,[1 5],129,-1,162,-1,136
1,<environment.Job instance at 0x7fbd1531b870>,25,27,[1 5],26,-1,165,-1,138
1,<environment.Job instance at 0x7fbd144538c0>,133,15,[ 2 10],134,-1,153,-1,138
1,<environment.Job instance at 0x7fbd1532c0f0>,143,16,[4 7],144,-1,160,-1,144
1,<environment.Job instance at 0x7fbd1532ca00>,142,12,[4 6],143,-1,157,-1,145
1,<environment.Job instance at 0x7fbd1532c460>,139,16,[ 1 14],140,-1,161,-1,145
1,<environment.Job instance at 0x7fbd15355730>,145,15,[1 7],146,-1,162,-1,147
1,<environment.Job instance at 0x7fbd13f156e0>,135,12,[8 2],136,-1,160,-1,148
1,<environment.Job instance at 0x7fbd15355f50>,147,15,[5 7],148,-1,163,-1,148
1,<environment.Job instance at 0x7fbd15355b90>,148,17,[5 4],149,-1,166,-1,149
1,<environment.Job instance at 0x7fbd14468690>,98,16,[10  1],99,-1,165,-1,149
1,<environment.Job instance at 0x7fbd14446910>,149,14,[10  3],150,-1,164,-1,150
1,<environment.Job instance at 0x7fbd14446690>,150,13,[8 2],151,-1,164,-1,151
1,<environment.Job instance at 0x7fbd14446e10>,153,16,[6 3],154,-1,171,-1,155
1,<environment.Job instance at 0x7fbd13f14820>,155,13,[5 5],156,-1,169,-1,156
1,<environment.Job instance at 0x7fbd13f145a0>,158,13,[6 3],159,-1,172,-1,159
1,<environment.Job instance at 0x7fbd1531dd20>,4,25,[1 6],5,-1,30,-1,5
1,<environment.Job instance at 0x7fbd13f15be0>,22,24,[3 5],23,-1,71,-1,47
1,<environment.Job instance at 0x7fbd14446cd0>,25,27,[1 5],26,-1,77,-1,50
1,<environment.Job instance at 0x7fbd15325460>,33,14,[11  5],34,-1,93,-1,79
1,<environment.Job instance at 0x7fbd13f1e8c0>,64,16,[ 2 11],65,-1,195,-1,179
1,<environment.Job instance at 0x7fbd13f1e780>,66,2,[11  2],67,-1,183,-1,181
1,<environment.Job instance at 0x7fbd155e7f50>,76,15,[13  1],77,-1,228,-1,213
1,<environment.Job instance at 0x7fbd14647320>,92,1,[11  5],93,-1,250,-1,249
1,<environment.Job instance at 0x7fbd15089d70>,101,3,[11  1],102,-1,274,-1,271
1,<environment.Job instance at 0x7fbd15089190>,102,2,[11  5],103,-1,273,-1,271
1,<environment.Job instance at 0x7fbd150b4690>,100,28,[6 4],101,-1,319,-1,291
1,<environment.Job instance at 0x7fbd15093f00>,105,26,[9 2],106,-1,317,-1,291
1,<environment.Job instance at 0x7fbd149e5e60>,111,23,[4 5],112,-1,329,-1,306
1,<environment.Job instance at 0x7fbd149e5f50>,115,3,[ 3 11],116,-1,314,-1,311
1,<environment.Job instance at 0x7fbd14664c80>,116,17,[14  5],117,-1,328,-1,311
1,<environment.Job instance at 0x7fbd141fba00>,128,26,[1 5],129,-1,377,-1,351
1,<environment.Job instance at 0x7fbd149ca550>,132,2,[ 4 13],133,-1,358,-1,356
1,<environment.Job instance at 0x7fbd140388c0>,139,16,[ 1 14],140,-1,388,-1,372
1,<environment.Job instance at 0x7fbd14fb1050>,151,14,[ 4 14],152,-1,428,-1,414
1,<environment.Job instance at 0x7fbd1496f190>,159,15,[ 5 13],160,-1,472,-1,457
1,<environment.Job instance at 0x7fbd145781e0>,160,3,[13  2],161,-1,460,-1,457
1,<environment.Job instance at 0x7fbd144468c0>,8,15,[6 4],9,-1,24,-1,9
1,<environment.Job instance at 0x7fbd14468a00>,10,17,[1 6],11,-1,28,-1,11
1,<environment.Job instance at 0x7fbd144683c0>,14,16,[6 1],15,-1,32,-1,16
1,<environment.Job instance at 0x7fbd14446c30>,15,16,[10  3],16,-1,32,-1,16
1,<environment.Job instance at 0x7fbd14468500>,16,15,[7 3],17,-1,33,-1,18
1,<environment.Job instance at 0x7fbd14468f00>,17,21,[1 8],18,-1,39,-1,18
1,<environment.Job instance at 0x7fbd14468f50>,18,17,[5 7],19,-1,36,-1,19
1,<environment.Job instance at 0x7fbd144688c0>,19,15,[8 1],20,-1,36,-1,21
1,<environment.Job instance at 0x7fbd14468eb0>,20,14,[10  4],21,-1,35,-1,21
1,<environment.Job instance at 0x7fbd1532f4b0>,24,15,[10  3],25,-1,42,-1,27
1,<environment.Job instance at 0x7fbd1532fbe0>,27,14,[6 5],28,-1,42,-1,28
1,<environment.Job instance at 0x7fbd1532f320>,28,15,[10  5],29,-1,44,-1,29
1,<environment.Job instance at 0x7fbd1532faa0>,29,13,[10  1],30,-1,43,-1,30
1,<environment.Job instance at 0x7fbd1532fa00>,30,15,[1 5],31,-1,46,-1,31
1,<environment.Job instance at 0x7fbd1532f140>,33,17,[8 4],34,-1,51,-1,34
1,<environment.Job instance at 0x7fbd14444870>,35,17,[2 5],36,-1,53,-1,36
1,<environment.Job instance at 0x7fbd144445f0>,36,15,[8 3],37,-1,52,-1,37
1,<environment.Job instance at 0x7fbd14444780>,37,16,[7 2],38,-1,54,-1,38
1,<environment.Job instance at 0x7fbd14444af0>,38,18,[5 3],39,-1,57,-1,39
1,<environment.Job instance at 0x7fbd14444140>,39,16,[5 4],40,-1,56,-1,40
1,<environment.Job instance at 0x7fbd14444f50>,43,17,[10  5],44,-1,69,-1,52
1,<environment.Job instance at 0x7fbd1532f460>,26,20,[ 5 11],27,-1,73,-1,53
1,<environment.Job instance at 0x7fbd14438960>,52,16,[8 4],53,-1,73,-1,57
1,<environment.Job instance at 0x7fbd14438280>,51,17,[1 7],52,-1,88,-1,71
1,<environment.Job instance at 0x7fbd14438e10>,56,28,[5 5],57,-1,108,-1,80
1,<environment.Job instance at 0x7fbd1533bc80>,65,17,[3 5],66,-1,97,-1,80
1,<environment.Job instance at 0x7fbd1533b960>,66,14,[6 5],67,-1,94,-1,80
1,<environment.Job instance at 0x7fbd1533b640>,62,19,[2 9],63,-1,99,-1,80
1,<environment.Job instance at 0x7fbd1533bf00>,64,22,[9 1],65,-1,102,-1,80
1,<environment.Job instance at 0x7fbd1533b910>,63,18,[8 4],64,-1,98,-1,80
1,<environment.Job instance at 0x7fbd14468b40>,11,24,[10  2],12,-1,106,-1,82
1,<environment.Job instance at 0x7fbd144445a0>,41,18,[14  2],42,-1,107,-1,89
1,<environment.Job instance at 0x7fbd14444280>,45,17,[13  3],46,-1,106,-1,89
1,<environment.Job instance at 0x7fbd1533bb90>,77,14,[9 5],78,-1,103,-1,89
1,<environment.Job instance at 0x7fbd1533b4b0>,71,18,[5 6],72,-1,107,-1,89
1,<environment.Job instance at 0x7fbd1533b3c0>,69,18,[6 3],70,-1,107,-1,89
1,<environment.Job instance at 0x7fbd1533ba00>,78,14,[8 5],79,-1,103,-1,89
1,<environment.Job instance at 0x7fbd1531d230>,80,25,[ 5 10],81,-1,114,-1,89
1,<environment.Job instance at 0x7fbd1531d780>,81,22,[10  3],82,-1,114,-1,92
1,<environment.Job instance at 0x7fbd1531d5a0>,79,16,[3 8],80,-1,108,-1,92
1,<environment.Job instance at 0x7fbd13f03a50>,84,18,[6 5],85,-1,110,-1,92
1,<environment.Job instance at 0x7fbd13f03cd0>,87,12,[ 3 12],88,-1,110,-1,98
1,<environment.Job instance at 0x7fbd1531dc80>,83,16,[ 4 10],84,-1,114,-1,98
1,<environment.Job instance at 0x7fbd13f03af0>,85,3,[ 2 10],86,-1,101,-1,98
1,<environment.Job instance at 0x7fbd13f03780>,91,24,[10  4],92,-1,122,-1,98
1,<environment.Job instance at 0x7fbd1533bc30>,68,13,[6 4],69,-1,113,-1,100
1,<environment.Job instance at 0x7fbd13f03e60>,95,13,[5 5],96,-1,115,-1,102
1,<environment.Job instance at 0x7fbd13f14f50>,97,17,[6 5],98,-1,119,-1,102
1,<environment.Job instance at 0x7fbd13f14500>,99,15,[10  3],100,-1,130,-1,115
1,<environment.Job instance at 0x7fbd144449b0>,1,18,[12  2],2,-1,20,-1,2
1,<environment.Job instance at 0x7fbd14444f00>,2,2,[ 2 13],3,-1,5,-1,3
1,<environment.Job instance at 0x7fbd1532f280>,3,13,[ 1 11],4,-1,17,-1,4
1,<environment.Job instance at 0x7fbd13f03690>,11,24,[10  2],12,-1,90,-1,66
1,<environment.Job instance at 0x7fbd14ddb3c0>,23,25,[6 2],24,-1,91,-1,66
1,<environment.Job instance at 0x7fbd146ebdc0>,26,20,[ 5 11],27,-1,88,-1,68
1,<environment.Job instance at 0x7fbd14dd62d0>,41,18,[14  2],42,-1,163,-1,145
1,<environment.Job instance at 0x7fbd140ab730>,45,17,[13  3],46,-1,166,-1,149
1,<environment.Job instance at 0x7fbd146cabe0>,50,2,[13  1],51,-1,168,-1,166
1,<environment.Job instance at 0x7fbd14d15820>,55,1,[11  2],56,-1,184,-1,183
1,<environment.Job instance at 0x7fbd14d15c80>,56,28,[5 5],57,-1,213,-1,185
1,<environment.Job instance at 0x7fbd1555c5a0>,60,24,[8 2],61,-1,223,-1,199
1,<environment.Job instance at 0x7fbd1473de60>,72,3,[ 3 14],73,-1,259,-1,256
1,<environment.Job instance at 0x7fbd14ec0f50>,80,25,[ 5 10],81,-1,321,-1,296
1,<environment.Job instance at 0x7fbd1536de60>,87,12,[ 3 12],88,-1,328,-1,316
1,<environment.Job instance at 0x7fbd1536de10>,88,3,[11  2],89,-1,319,-1,316
1,<environment.Job instance at 0x7fbd151d4640>,89,26,[14  4],90,-1,342,-1,316
1,<environment.Job instance at 0x7fbd143cf550>,91,24,[10  4],92,-1,342,-1,318
1,<environment.Job instance at 0x7fbd1434bcd0>,93,2,[ 3 14],94,-1,320,-1,318
1,<environment.Job instance at 0x7fbd156f5230>,106,25,[8 2],107,-1,446,-1,421
1,<environment.Job instance at 0x7fbd151ff690>,110,13,[ 3 13],111,-1,441,-1,428
1,<environment.Job instance at 0x7fbd151ff0f0>,112,17,[12  2],113,-1,456,-1,439
1,<environment.Job instance at 0x7fbd144f6870>,126,15,[ 5 13],127,-1,531,-1,516
1,<environment.Job instance at 0x7fbd142f94b0>,130,1,[ 3 11],131,-1,523,-1,522
1,<environment.Job instance at 0x7fbd142f9910>,136,3,[ 2 13],137,-1,546,-1,543
1,<environment.Job instance at 0x7fbd14509d20>,139,18,[14  4],140,-1,579,-1,561
1,<environment.Job instance at 0x7fbd1ddda460>,142,2,[13  5],143,-1,575,-1,573
1,<environment.Job instance at 0x7fbd146121e0>,143,17,[11  2],144,-1,590,-1,573
1,<environment.Job instance at 0x7fbd147017d0>,146,18,[14  1],147,-1,595,-1,577
1,<environment.Job instance at 0x7fbd144fc280>,149,2,[12  1],150,-1,582,-1,580
1,<environment.Job instance at 0x7fbd144fcf50>,150,13,[ 1 11],151,-1,593,-1,580
1,<environment.Job instance at 0x7fbd13f75e60>,152,13,[13  2],153,-1,594,-1,581
1,<environment.Job instance at 0x7fbd140032d0>,158,2,[ 1 11],159,-1,608,-1,606
1,<environment.Job instance at 0x7fbd14003b90>,159,2,[12  3],160,-1,608,-1,606
1,<environment.Job instance at 0x7fbd14dd7c30>,161,3,[ 1 14],162,-1,610,-1,607
1,<environment.Job instance at 0x7fbd14860320>,168,25,[ 5 10],169,-1,677,-1,652
1,<environment.Job instance at 0x7fbd143bf1e0>,0,17,[5 6],1,-1,18,-1,1
1,<environment.Job instance at 0x7fbd13f18320>,3,17,[5 5],4,-1,21,-1,4
1,<environment.Job instance at 0x7fbd13f18820>,10,19,[8 1],11,-1,30,-1,11
1,<environment.Job instance at 0x7fbd15626cd0>,13,14,[10  5],14,-1,28,-1,14
1,<environment.Job instance at 0x7fbd14ab8c80>,15,15,[1 7],16,-1,31,-1,16
1,<environment.Job instance at 0x7fbd14ab8870>,17,18,[9 5],18,-1,36,-1,18
1,<environment.Job instance at 0x7fbd14ab8910>,20,16,[9 2],21,-1,37,-1,21
1,<environment.Job instance at 0x7fbd14ab88c0>,23,18,[6 2],24,-1,42,-1,24
1,<environment.Job instance at 0x7fbd14ab8640>,29,18,[8 4],30,-1,48,-1,30
1,<environment.Job instance at 0x7fbd156bcc30>,31,21,[2 6],32,-1,53,-1,32
1,<environment.Job instance at 0x7fbd156bcaf0>,32,16,[1 6],33,-1,49,-1,33
1,<environment.Job instance at 0x7fbd156bc050>,33,15,[5 3],34,-1,49,-1,34
1,<environment.Job instance at 0x7fbd156bc730>,35,14,[5 2],36,-1,50,-1,36
1,<environment.Job instance at 0x7fbd14b401e0>,38,17,[1 7],39,-1,56,-1,39
1,<environment.Job instance at 0x7fbd141bd3c0>,40,15,[8 2],41,-1,56,-1,41
1,<environment.Job instance at 0x7fbd140c71e0>,50,16,[2 5],51,-1,68,-1,52
1,<environment.Job instance at 0x7fbd140c7c30>,51,14,[7 4],52,-1,68,-1,54
1,<environment.Job instance at 0x7fbd15271140>,55,12,[10  3],56,-1,69,-1,57
1,<environment.Job instance at 0x7fbd152710a0>,56,26,[7 5],57,-1,84,-1,58
1,<environment.Job instance at 0x7fbd152715f0>,58,12,[7 4],59,-1,71,-1,59
1,<environment.Job instance at 0x7fbd140db500>,60,14,[4 9],61,-1,75,-1,61
1,<environment.Job instance at 0x7fbd140db0a0>,61,16,[1 7],62,-1,78,-1,62
1,<environment.Job instance at 0x7fbd140db2d0>,63,18,[6 3],64,-1,82,-1,64
1,<environment.Job instance at 0x7fbd140db410>,65,18,[6 5],66,-1,84,-1,66
1,<environment.Job instance at 0x7fbd14094d20>,76,17,[10  4],77,-1,95,-1,78
1,<environment.Job instance at 0x7fbd14094960>,70,24,[5 4],71,-1,102,-1,78
1,<environment.Job instance at 0x7fbd14094550>,77,16,[10  2],78,-1,94,-1,78
1,<environment.Job instance at 0x7fbd14664d70>,78,18,[10  5],79,-1,97,-1,79
1,<environment.Job instance at 0x7fbd14ab84b0>,24,25,[9 4],25,-1,118,-1,93
1,<environment.Job instance at 0x7fbd14094050>,71,13,[3 7],72,-1,106,-1,93
1,<environment.Job instance at 0x7fbd145105f0>,85,16,[9 5],86,-1,115,-1,99
1,<environment.Job instance at 0x7fbd14510f00>,82,17,[7 5],83,-1,116,-1,99
1,<environment.Job instance at 0x7fbd14510500>,86,17,[7 5],87,-1,116,-1,99
1,<environment.Job instance at 0x7fbd14664e60>,80,15,[7 3],81,-1,114,-1,99
1,<environment.Job instance at 0x7fbd14510730>,88,27,[9 1],89,-1,126,-1,99
1,<environment.Job instance at 0x7fbd14510050>,89,16,[1 7],90,-1,115,-1,99
1,<environment.Job instance at 0x7fbd14510780>,98,15,[8 3],99,-1,114,-1,99
1,<environment.Job instance at 0x7fbd13d4f640>,103,16,[8 3],104,-1,120,-1,104
1,<environment.Job instance at 0x7fbd14ef32d0>,104,12,[ 2 10],105,-1,118,-1,106
1,<environment.Job instance at 0x7fbd13f40b40>,105,21,[1 5],106,-1,127,-1,106
1,<environment.Job instance at 0x7fbd140f91e0>,110,12,[4 6],111,-1,124,-1,112
1,<environment.Job instance at 0x7fbd1419f280>,111,17,[2 7],112,-1,130,-1,113
1,<environment.Job instance at 0x7fbd154023c0>,112,12,[9 4],113,-1,126,-1,114
1,<environment.Job instance at 0x7fbd14e755f0>,114,15,[9 3],115,-1,130,-1,115
1,<environment.Job instance at 0x7fbd1552c370>,115,28,[5 2],116,-1,144,-1,116
1,<environment.Job instance at 0x7fbd14994eb0>,117,16,[2 8],118,-1,134,-1,118
1,<environment.Job instance at 0x7fbd15219370>,119,13,[1 5],120,-1,133,-1,120
1,<environment.Job instance at 0x7fbd15316140>,121,18,[8 2],122,-1,140,-1,122
1,<environment.Job instance at 0x7fbd14f60f00>,122,18,[5 9],123,-1,141,-1,123
1,<environment.Job instance at 0x7fbd14f60af0>,123,15,[ 4 10],124,-1,139,-1,124
1,<environment.Job instance at 0x7fbd1521b6e0>,126,15,[7 5],127,-1,142,-1,127
1,<environment.Job instance at 0x7fbd1521b410>,127,20,[5 5],128,-1,148,-1,128
1,<environment.Job instance at 0x7fbd14b6c690>,130,27,[5 7],131,-1,162,-1,135
1,<environment.Job instance at 0x7fbd151fad70>,133,23,[9 1],134,-1,158,-1,135
1,<environment.Job instance at 0x7fbd14e75e10>,113,16,[ 1 13],114,-1,151,-1,135
1,<environment.Job instance at 0x7fbd151fa690>,131,15,[8 3],132,-1,151,-1,136
1,<environment.Job instance at 0x7fbd151fa5f0>,132,2,[7 1],133,-1,138,-1,136
1,<environment.Job instance at 0x7fbd14ef3280>,107,28,[9 2],108,-1,169,-1,141
1,<environment.Job instance at 0x7fbd151faf50>,137,17,[9 5],138,-1,166,-1,149
1,<environment.Job instance at 0x7fbd151fa1e0>,136,26,[ 2 10],137,-1,175,-1,149
1,<environment.Job instance at 0x7fbd1e22cf00>,141,14,[1 6],142,-1,163,-1,149
1,<environment.Job instance at 0x7fbd1e22ca50>,143,16,[10  1],144,-1,165,-1,149
1,<environment.Job instance at 0x7fbd13e8bb90>,144,12,[8 3],145,-1,161,-1,149
1,<environment.Job instance at 0x7fbd13e8ba50>,146,20,[8 3],147,-1,170,-1,150
1,<environment.Job instance at 0x7fbd14055a00>,148,17,[4 8],149,-1,171,-1,154
1,<environment.Job instance at 0x7fbd14ab81e0>,2,16,[12  1],3,-1,19,-1,3
1,<environment.Job instance at 0x7fbd156bcdc0>,5,24,[5 2],6,-1,30,-1,6
1,<environment.Job instance at 0x7fbd141bd910>,6,17,[ 3 14],7,-1,24,-1,7
1,<environment.Job instance at 0x7fbd14b6cd20>,24,25,[9 4],25,-1,78,-1,53
1,<environment.Job instance at 0x7fbd144eeb40>,41,1,[ 4 13],42,-1,93,-1,92
1,<environment.Job instance at 0x7fbd143cf640>,56,26,[7 5],57,-1,158,-1,132
1,<environment.Job instance at 0x7fbd151d4f00>,62,25,[1 9],63,-1,188,-1,163
1,<environment.Job instance at 0x7fbd14d0f780>,70,24,[5 4],71,-1,208,-1,184
1,<environment.Job instance at 0x7fbd1555c9b0>,73,28,[1 9],74,-1,240,-1,212
1,<environment.Job instance at 0x7fbd1dd351e0>,88,27,[9 1],89,-1,312,-1,285
1,<environment.Job instance at 0x7fbd144449b0>,107,28,[9 2],108,-1,356,-1,328
1,<environment.Job instance at 0x7fbd1532f280>,109,3,[13  5],110,-1,331,-1,328
1,<environment.Job instance at 0x7fbd14270730>,113,16,[ 1 13],114,-1,360,-1,344
1,<environment.Job instance at 0x7fbd1472d7d0>,115,28,[5 2],116,-1,384,-1,356
1,<environment.Job instance at 0x7fbd156f5190>,130,27,[5 7],131,-1,455,-1,428
1,<environment.Job instance at 0x7fbd156f5320>,133,23,[9 1],134,-1,466,-1,443
1,<environment.Job instance at 0x7fbd156c1fa0>,136,26,[ 2 10],137,-1,475,-1,449
1,<environment.Job instance at 0x7fbd153f65f0>,145,15,[14  1],146,-1,475,-1,460
1,<environment.Job instance at 0x7fbd153f6460>,147,3,[13  4],148,-1,475,-1,472
1,<environment.Job instance at 0x7fbd153f6cd0>,150,25,[ 1 12],151,-1,499,-1,474
1,<environment.Job instance at 0x7fbd145105a0>,158,13,[ 2 11],159,-1,517,-1,504
1,<environment.Job instance at 0x7fbd148410f0>,163,3,[ 5 13],164,-1,538,-1,535
1,<environment.Job instance at 0x7f01933c0af0>,2,14,[ 2 10],3,-1,18,-1,4
1,<environment.Job instance at 0x7f019c9b08c0>,3,22,[2 5],4,-1,26,-1,4
1,<environment.Job instance at 0x7f01933c0e60>,7,14,[7 5],8,-1,22,-1,8
1,<environment.Job instance at 0x7f01933c0eb0>,8,17,[1 8],9,-1,26,-1,9
1,<environment.Job instance at 0x7f01933c30a0>,10,22,[8 1],11,-1,33,-1,11
1,<environment.Job instance at 0x7f01933c3140>,12,23,[6 4],13,-1,36,-1,13
1,<environment.Job instance at 0x7f01933c3410>,13,18,[5 9],14,-1,32,-1,14
1,<environment.Job instance at 0x7f01933c3320>,14,21,[8 1],15,-1,38,-1,17
1,<environment.Job instance at 0x7f01933c3500>,16,18,[7 3],17,-1,35,-1,17
1,<environment.Job instance at 0x7f01933c3550>,18,26,[7 4],19,-1,45,-1,19
1,<environment.Job instance at 0x7f01933c37d0>,19,25,[5 9],20,-1,45,-1,20
1,<environment.Job instance at 0x7f01933c38c0>,21,18,[9 4],22,-1,40,-1,22
1,<environment.Job instance at 0x7f01933c3910>,23,16,[6 2],24,-1,40,-1,24
1,<environment.Job instance at 0x7f01933c3fa0>,27,17,[4 6],28,-1,45,-1,28
1,<environment.Job instance at 0x7f01933c61e0>,30,26,[9 4],31,-1,57,-1,31
1,<environment.Job instance at 0x7f01933c62d0>,32,21,[5 9],33,-1,54,-1,33
1,<environment.Job instance at 0x7f01933c64b0>,33,26,[3 6],34,-1,61,-1,35
1,<environment.Job instance at 0x7f01933c6640>,35,16,[1 9],36,-1,52,-1,36
1,<environment.Job instance at 0x7f01933c6780>,37,14,[5 8],38,-1,52,-1,38
1,<environment.Job instance at 0x7f01933c6550>,34,14,[1 9],35,-1,53,-1,39
1,<environment.Job instance at 0x7f01933c6a00>,39,14,[9 4],40,-1,55,-1,41
1,<environment.Job instance at 0x7f01933c6460>,40,26,[ 1 10],41,-1,67,-1,41
1,<environment.Job instance at 0x7f01933c6eb0>,45,15,[7 5],46,-1,63,-1,48
1,<environment.Job instance at 0x7f01933c83c0>,48,12,[9 2],49,-1,62,-1,50
1,<environment.Job instance at 0x7f01933c8370>,49,17,[10  2],50,-1,67,-1,50
1,<environment.Job instance at 0x7f01933c8a00>,54,18,[7 1],55,-1,74,-1,56
1,<environment.Job instance at 0x7f01933c8be0>,57,16,[ 2 11],58,-1,74,-1,58
1,<environment.Job instance at 0x7f01933c8d70>,58,17,[3 7],59,-1,76,-1,59
1,<environment.Job instance at 0x7f01933c8c80>,59,19,[1 7],60,-1,79,-1,60
1,<environment.Job instance at 0x7f01933cb0a0>,62,14,[4 9],63,-1,77,-1,63
1,<environment.Job instance at 0x7f01933c8b40>,55,12,[2 6],56,-1,79,-1,67
1,<environment.Job instance at 0x7f01933cb690>,67,16,[1 9],68,-1,84,-1,68
1,<environment.Job instance at 0x7f01933cb5f0>,69,14,[9 4],70,-1,86,-1,72
1,<environment.Job instance at 0x7f01933cbbe0>,72,18,[3 5],73,-1,91,-1,73
1,<environment.Job instance at 0x7f01933cbf50>,76,13,[10  1],77,-1,90,-1,77
1,<environment.Job instance at 0x7f01933cc140>,77,16,[8 1],78,-1,95,-1,79
1,<environment.Job instance at 0x7f01933cc190>,78,14,[6 1],79,-1,93,-1,79
1,<environment.Job instance at 0x7f01933cc0a0>,79,19,[10  3],80,-1,101,-1,82
1,<environment.Job instance at 0x7f01933cc3c0>,81,14,[8 5],82,-1,96,-1,82
1,<environment.Job instance at 0x7f01933cc550>,82,21,[4 8],83,-1,104,-1,83
1,<environment.Job instance at 0x7f01933cc320>,83,18,[ 3 10],84,-1,102,-1,84
1,<environment.Job instance at 0x7f01933cc9b0>,87,18,[7 1],88,-1,106,-1,88
1,<environment.Job instance at 0x7f01933ccaf0>,88,16,[4 9],89,-1,105,-1,89
1,<environment.Job instance at 0x7f019340c0a0>,95,3,[8 5],96,-1,100,-1,97
1,<environment.Job instance at 0x7f019340c8c0>,96,18,[2 6],97,-1,115,-1,97
1,<environment.Job instance at 0x7f01934e5320>,101,15,[2 7],102,-1,118,-1,103
1,<environment.Job instance at 0x7f01933b7f00>,103,16,[1 9],104,-1,120,-1,104
1,<environment.Job instance at 0x7f01933b7370>,105,16,[7 5],106,-1,122,-1,106
1,<environment.Job instance at 0x7f01933b7780>,107,18,[5 5],108,-1,126,-1,108
1,<environment.Job instance at 0x7f01934825a0>,109,27,[3 9],110,-1,137,-1,110
1,<environment.Job instance at 0x7f01933b7550>,110,23,[5 1],111,-1,134,-1,111
1,<environment.Job instance at 0x7f01933b70f0>,111,17,[6 4],112,-1,129,-1,112
1,<environment.Job instance at 0x7f019343bc30>,112,12,[1 6],113,-1,125,-1,113
1,<environment.Job instance at 0x7f01934e1500>,113,17,[5 1],114,-1,131,-1,114
1,<environment.Job instance at 0x7f01934e1fa0>,114,1,[9 2],115,-1,116,-1,115
1,<environment.Job instance at 0x7f01935f1230>,116,12,[8 4],117,-1,129,-1,117
1,<environment.Job instance at 0x7f0193463d70>,122,18,[7 5],123,-1,141,-1,123
1,<environment.Job instance at 0x7f01933e87d0>,130,17,[9 5],131,-1,151,-1,134
1,<environment.Job instance at 0x7f01933e8870>,132,18,[10  4],133,-1,152,-1,134
1,<environment.Job instance at 0x7f0193452dc0>,119,28,[7 5],120,-1,167,-1,139
1,<environment.Job instance at 0x7f019c9dafa0>,93,25,[ 1 10],94,-1,169,-1,144
1,<environment.Job instance at 0x7f01933e8d70>,131,13,[3 8],132,-1,157,-1,144
1,<environment.Job instance at 0x7f0193449f00>,137,28,[ 2 10],138,-1,172,-1,144
1,<environment.Job instance at 0x7f01933e85f0>,135,15,[8 3],136,-1,159,-1,144
1,<environment.Job instance at 0x7f01934e79b0>,142,15,[ 2 13],143,-1,167,-1,152
1,<environment.Job instance at 0x7f01934e72d0>,141,14,[ 3 10],142,-1,166,-1,152
1,<environment.Job instance at 0x7f0193470f00>,146,13,[10  5],147,-1,165,-1,152
1,<environment.Job instance at 0x7f0193470eb0>,149,17,[5 7],150,-1,169,-1,152
1,<environment.Job instance at 0x7f01934e7cd0>,139,1,[5 5],140,-1,153,-1,152
1,<environment.Job instance at 0x7f0193470910>,151,22,[5 6],152,-1,174,-1,152
1,<environment.Job instance at 0x7f01934ce730>,152,1,[9 2],153,-1,154,-1,153
1,<environment.Job instance at 0x7f0193470e10>,150,12,[5 1],151,-1,166,-1,154
1,<environment.Job instance at 0x7f019346fa50>,155,17,[10  4],156,-1,173,-1,156
1,<environment.Job instance at 0x7f019346faf0>,157,21,[10  4],158,-1,179,-1,158
1,<environment.Job instance at 0x7f019346f690>,158,2,[9 1],159,-1,161,-1,159
1,<environment.Job instance at 0x7f019346fcd0>,156,12,[1 6],157,-1,172,-1,160
1,<environment.Job instance at 0x7f019346f5f0>,159,2,[ 4 10],160,-1,162,-1,160
1,<environment.Job instance at 0x7f019346f910>,160,24,[1 5],161,-1,185,-1,161
1,<environment.Job instance at 0x7f019346f190>,162,20,[10  5],163,-1,184,-1,164
1,<environment.Job instance at 0x7f01935f3e60>,120,19,[ 5 12],121,-1,183,-1,164
1,<environment.Job instance at 0x7f019346f3c0>,161,12,[5 4],162,-1,177,-1,165
1,<environment.Job instance at 0x7f01934dfc80>,164,14,[10  5],165,-1,189,-1,175
1,<environment.Job instance at 0x7f01933cb4b0>,12,23,[6 4],13,-1,53,-1,30
1,<environment.Job instance at 0x7f01933e3d70>,18,26,[7 4],19,-1,70,-1,44
1,<environment.Job instance at 0x7f01934757d0>,19,25,[5 9],20,-1,83,-1,58
1,<environment.Job instance at 0x7f019346f410>,28,17,[ 1 13],29,-1,87,-1,70
1,<environment.Job instance at 0x7f01933f9140>,30,26,[9 4],31,-1,110,-1,84
1,<environment.Job instance at 0x7f01933fb5a0>,31,1,[ 2 14],32,-1,85,-1,84
1,<environment.Job instance at 0x7f01933ae320>,33,26,[3 6],34,-1,110,-1,84
1,<environment.Job instance at 0x7f01933b4230>,40,26,[ 1 10],41,-1,139,-1,113
1,<environment.Job instance at 0x7f01933b0c30>,57,16,[ 2 11],58,-1,183,-1,167
1,<environment.Job instance at 0x7f019335d140>,89,17,[ 5 14],90,-1,289,-1,272
1,<environment.Job instance at 0x7f019335d410>,93,25,[ 1 10],94,-1,320,-1,295
1,<environment.Job instance at 0x7f019335de10>,109,27,[3 9],110,-1,371,-1,344
1,<environment.Job instance at 0x7f0193360050>,110,23,[5 1],111,-1,367,-1,344
1,<environment.Job instance at 0x7f0193360640>,117,3,[ 3 13],118,-1,367,-1,364
1,<environment.Job instance at 0x7f01933606e0>,119,28,[7 5],120,-1,406,-1,378
1,<environment.Job instance at 0x7f01933607d0>,120,19,[ 5 12],121,-1,397,-1,378
1,<environment.Job instance at 0x7f0193363410>,137,28,[ 2 10],138,-1,458,-1,430
1,<environment.Job instance at 0x7f0193363910>,142,15,[ 2 13],143,-1,450,-1,435
1,<environment.Job instance at 0x7f01933639b0>,144,20,[13  4],145,-1,460,-1,440
1,<environment.Job instance at 0x7f0193366050>,153,1,[12  5],154,-1,473,-1,472
1,<environment.Job instance at 0x7f0193366500>,160,24,[1 5],161,-1,534,-1,510
1,<environment.Job instance at 0x7f01933668c0>,166,13,[ 5 14],167,-1,543,-1,530
1,<environment.Job instance at 0x7f0193366fa0>,173,24,[3 7],174,-1,590,-1,566
1,<environment.Job instance at 0x7f0192d9d230>,0,17,[3 5],1,-1,19,-1,2
1,<environment.Job instance at 0x7f0192d9d1e0>,1,18,[6 2],2,-1,20,-1,2
1,<environment.Job instance at 0x7f0192d9fd70>,6,17,[9 1],7,-1,25,-1,8
1,<environment.Job instance at 0x7f0192e2fc80>,15,15,[5 3],16,-1,31,-1,16
1,<environment.Job instance at 0x7f0192e2f0f0>,10,17,[9 5],11,-1,34,-1,17
1,<environment.Job instance at 0x7f0192e2fe10>,18,21,[2 7],19,-1,40,-1,19
1,<environment.Job instance at 0x7f0192e33460>,20,23,[4 7],21,-1,44,-1,21
1,<environment.Job instance at 0x7f0192e336e0>,21,14,[ 1 10],22,-1,36,-1,22
1,<environment.Job instance at 0x7f0192d587d0>,7,13,[9 5],8,-1,36,-1,23
1,<environment.Job instance at 0x7f0192e33cd0>,23,14,[5 9],24,-1,40,-1,26
1,<environment.Job instance at 0x7f0192e33f00>,26,16,[6 5],27,-1,43,-1,27
1,<environment.Job instance at 0x7f0192e33730>,28,20,[ 2 10],29,-1,49,-1,29
1,<environment.Job instance at 0x7f0192e33fa0>,29,15,[5 5],30,-1,45,-1,30
1,<environment.Job instance at 0x7f0192e38190>,31,17,[3 6],32,-1,49,-1,32
1,<environment.Job instance at 0x7f0192e385a0>,34,16,[5 6],35,-1,51,-1,35
1,<environment.Job instance at 0x7f0192e384b0>,35,21,[1 6],36,-1,57,-1,36
1,<environment.Job instance at 0x7f0192e38230>,36,16,[1 8],37,-1,53,-1,37
1,<environment.Job instance at 0x7f0192f4d690>,38,23,[1 9],39,-1,63,-1,40
1,<environment.Job instance at 0x7f0192fcd690>,43,18,[5 1],44,-1,62,-1,44
1,<environment.Job instance at 0x7f0192fba4b0>,44,15,[8 5],45,-1,60,-1,45
1,<environment.Job instance at 0x7f0192e76550>,48,19,[4 7],49,-1,68,-1,49
1,<environment.Job instance at 0x7f0192e33be0>,25,19,[ 1 10],26,-1,71,-1,52
1,<environment.Job instance at 0x7f0192fcdbe0>,42,15,[8 2],43,-1,67,-1,52
1,<environment.Job instance at 0x7f0192e76190>,49,13,[4 5],50,-1,65,-1,52
1,<environment.Job instance at 0x7f0192d6db90>,55,18,[5 4],56,-1,76,-1,58
1,<environment.Job instance at 0x7f0192d69f50>,62,12,[ 5 10],63,-1,90,-1,78
1,<environment.Job instance at 0x7f0192c464b0>,63,13,[9 2],64,-1,91,-1,78
1,<environment.Job instance at 0x7f0192c46550>,64,13,[4 5],65,-1,92,-1,79
1,<environment.Job instance at 0x7f0192c46320>,65,27,[6 1],66,-1,106,-1,79
1,<environment.Job instance at 0x7f0192c46500>,67,14,[10  3],68,-1,93,-1,79
1,<environment.Job instance at 0x7f01932c7d20>,70,13,[3 5],71,-1,93,-1,80
1,<environment.Job instance at 0x7f0192c3fcd0>,71,16,[5 8],72,-1,99,-1,83
1,<environment.Job instance at 0x7f0192e82780>,50,16,[14  3],51,-1,99,-1,83
1,<environment.Job instance at 0x7f0192aa8eb0>,72,23,[1 8],73,-1,109,-1,86
1,<environment.Job instance at 0x7f0192a12a00>,81,17,[10  2],82,-1,104,-1,87
1,<environment.Job instance at 0x7f01929730f0>,83,26,[5 3],84,-1,114,-1,88
1,<environment.Job instance at 0x7f01929735f0>,85,18,[ 1 10],86,-1,111,-1,93
1,<environment.Job instance at 0x7f0192973050>,86,15,[6 5],87,-1,112,-1,97
1,<environment.Job instance at 0x7f0192972aa0>,90,18,[5 8],91,-1,115,-1,97
1,<environment.Job instance at 0x7f0192972500>,92,18,[3 8],93,-1,115,-1,97
1,<environment.Job instance at 0x7f0192972050>,93,13,[8 3],94,-1,110,-1,97
1,<environment.Job instance at 0x7f0192970af0>,96,17,[8 4],97,-1,114,-1,97
1,<environment.Job instance at 0x7f0192970910>,97,15,[3 6],98,-1,113,-1,98
1,<environment.Job instance at 0x7f0192970b90>,98,20,[5 2],99,-1,119,-1,99
1,<environment.Job instance at 0x7f01929700a0>,99,26,[2 8],100,-1,126,-1,100
1,<environment.Job instance at 0x7f0192970d20>,100,15,[5 8],101,-1,116,-1,101
1,<environment.Job instance at 0x7f01929766e0>,101,20,[ 4 10],102,-1,122,-1,102
1,<environment.Job instance at 0x7f01929761e0>,102,15,[9 2],103,-1,118,-1,103
1,<environment.Job instance at 0x7f0192976780>,104,16,[7 5],105,-1,121,-1,105
1,<environment.Job instance at 0x7f01929fb050>,107,27,[9 5],108,-1,135,-1,108
1,<environment.Job instance at 0x7f019336cdc0>,108,13,[8 4],109,-1,140,-1,127
1,<environment.Job instance at 0x7f0192f4d5f0>,37,18,[ 1 14],38,-1,169,-1,151
1,<environment.Job instance at 0x7f01929750f0>,116,13,[8 2],117,-1,164,-1,151
1,<environment.Job instance at 0x7f0192975af0>,123,17,[7 4],124,-1,170,-1,153
1,<environment.Job instance at 0x7f01929f72d0>,127,16,[5 3],128,-1,169,-1,153
1,<environment.Job instance at 0x7f0192e82690>,53,22,[9 1],54,-1,180,-1,158
1,<environment.Job instance at 0x7f0192975dc0>,119,15,[6 5],120,-1,174,-1,159
1,<environment.Job instance at 0x7f01929f7370>,128,14,[7 1],129,-1,173,-1,159
1,<environment.Job instance at 0x7f019cb22280>,135,16,[7 5],136,-1,175,-1,159
1,<environment.Job instance at 0x7f0192aa2c30>,138,14,[9 4],139,-1,173,-1,159
1,<environment.Job instance at 0x7f0192aa2690>,140,16,[8 3],141,-1,175,-1,159
1,<environment.Job instance at 0x7f0192bd7780>,162,17,[5 9],163,-1,336,-1,319
1,<environment.Job instance at 0x7f0192973410>,8,27,[ 3 12],9,-1,36,-1,9
1,<environment.Job instance at 0x7f0192976960>,12,15,[ 2 14],13,-1,37,-1,22
1,<environment.Job instance at 0x7f01929f7f00>,14,26,[3 9],15,-1,60,-1,34
1,<environment.Job instance at 0x7f0192e7f2d0>,20,23,[4 7],21,-1,65,-1,42
1,<environment.Job instance at 0x7f0192e62230>,30,1,[14  4],31,-1,68,-1,67
1,<environment.Job instance at 0x7f0193366910>,37,18,[ 1 14],38,-1,108,-1,90
1,<environment.Job instance at 0x7f0193366730>,38,23,[1 9],39,-1,113,-1,90
1,<environment.Job instance at 0x7f0193366320>,45,17,[12  1],46,-1,123,-1,106
1,<environment.Job instance at 0x7f0193363690>,50,16,[14  3],51,-1,144,-1,128
1,<environment.Job instance at 0x7f0193363730>,57,2,[ 1 12],58,-1,145,-1,143
1,<environment.Job instance at 0x7f01933630f0>,65,27,[6 1],66,-1,213,-1,186
1,<environment.Job instance at 0x7f0193360b40>,72,23,[1 8],73,-1,233,-1,210
1,<environment.Job instance at 0x7f01933601e0>,83,26,[5 3],84,-1,258,-1,232
1,<environment.Job instance at 0x7f019335d5a0>,99,26,[2 8],100,-1,344,-1,318
1,<environment.Job instance at 0x7f0192b65cd0>,107,27,[9 5],108,-1,382,-1,355
1,<environment.Job instance at 0x7f019335d0f0>,109,14,[12  2],110,-1,369,-1,355
1,<environment.Job instance at 0x7f0192e820f0>,121,17,[ 5 14],122,-1,421,-1,404
1,<environment.Job instance at 0x7f0192d6e9b0>,122,25,[ 3 11],123,-1,429,-1,404
1,<environment.Job instance at 0x7f0192e38550>,124,17,[13  5],125,-1,422,-1,405
1,<environment.Job instance at 0x7f0192ca64b0>,125,13,[ 5 14],126,-1,418,-1,405
1,<environment.Job instance at 0x7f0192b89280>,145,27,[4 5],146,-1,516,-1,489
1,<environment.Job instance at 0x7f0192b21500>,147,12,[13  4],148,-1,501,-1,489
1,<environment.Job instance at 0x7f0192b21f50>,148,12,[ 5 12],149,-1,501,-1,489
1,<environment.Job instance at 0x7f0192b77d70>,167,13,[12  1],168,-1,556,-1,543
1,<environment.Job instance at 0x7f0192b77e10>,168,12,[14  3],169,-1,555,-1,543
1,<environment.Job instance at 0x7f0192b77c80>,169,1,[ 4 11],170,-1,544,-1,543
1,<environment.Job instance at 0x7f0192b35b90>,176,25,[2 8],177,-1,603,-1,578
1,<environment.Job instance at 0x7f0192c0df00>,0,26,[8 3],1,-1,27,-1,1
1,<environment.Job instance at 0x7f0192c0d2d0>,5,13,[9 1],6,-1,20,-1,7
1,<environment.Job instance at 0x7f0193366eb0>,6,18,[8 3],7,-1,25,-1,7
1,<environment.Job instance at 0x7f0192c64820>,11,18,[5 8],12,-1,30,-1,12
1,<environment.Job instance at 0x7f0192c640a0>,12,14,[2 8],13,-1,27,-1,13
1,<environment.Job instance at 0x7f0192c64aa0>,15,15,[1 5],16,-1,31,-1,16
1,<environment.Job instance at 0x7f0192c648c0>,17,13,[ 5 10],18,-1,31,-1,18
1,<environment.Job instance at 0x7f0192c644b0>,19,18,[5 2],20,-1,38,-1,20
1,<environment.Job instance at 0x7f0192c64d70>,20,16,[ 4 10],21,-1,37,-1,21
1,<environment.Job instance at 0x7f0192c64910>,21,15,[5 7],22,-1,37,-1,22
1,<environment.Job instance at 0x7f0192bfd4b0>,22,17,[8 2],23,-1,40,-1,23
1,<environment.Job instance at 0x7f0192bfd190>,24,17,[6 1],25,-1,42,-1,25
1,<environment.Job instance at 0x7f0192bfdc80>,26,17,[7 4],27,-1,44,-1,27
1,<environment.Job instance at 0x7f0192bfd320>,29,18,[10  4],30,-1,49,-1,31
1,<environment.Job instance at 0x7f0192afa550>,34,18,[10  5],35,-1,53,-1,35
1,<environment.Job instance at 0x7f0192afa280>,36,16,[2 9],37,-1,53,-1,37
1,<environment.Job instance at 0x7f0192afa960>,38,15,[10  4],39,-1,54,-1,39
1,<environment.Job instance at 0x7f0192afaaf0>,40,16,[8 5],41,-1,57,-1,41
1,<environment.Job instance at 0x7f0192afa050>,41,16,[4 5],42,-1,58,-1,42
1,<environment.Job instance at 0x7f0192afabe0>,42,27,[8 3],43,-1,70,-1,43
1,<environment.Job instance at 0x7f0192afa140>,43,18,[1 6],44,-1,62,-1,44
1,<environment.Job instance at 0x7f0192afaa50>,44,17,[2 6],45,-1,62,-1,45
1,<environment.Job instance at 0x7f0192ae7be0>,46,27,[2 6],47,-1,74,-1,47
1,<environment.Job instance at 0x7f0192ae7f50>,48,16,[9 2],49,-1,65,-1,49
1,<environment.Job instance at 0x7f0192ae71e0>,51,16,[4 5],52,-1,68,-1,52
1,<environment.Job instance at 0x7f0192af6230>,60,12,[10  5],61,-1,73,-1,61
1,<environment.Job instance at 0x7f0192af62d0>,62,16,[6 4],63,-1,79,-1,63
1,<environment.Job instance at 0x7f0192af1e60>,64,14,[3 6],65,-1,79,-1,65
1,<environment.Job instance at 0x7f0192af16e0>,65,13,[7 4],66,-1,79,-1,66
1,<environment.Job instance at 0x7f0192af1c80>,66,21,[ 4 10],67,-1,88,-1,67
1,<environment.Job instance at 0x7f0192af10f0>,67,23,[2 8],68,-1,91,-1,68
1,<environment.Job instance at 0x7f0192af15f0>,70,13,[6 2],71,-1,84,-1,71
1,<environment.Job instance at 0x7f0192af1780>,74,13,[ 4 11],75,-1,88,-1,75
1,<environment.Job instance at 0x7f0192bfd050>,30,15,[1 9],31,-1,90,-1,75
1,<environment.Job instance at 0x7f0192af1370>,75,17,[ 5 10],76,-1,93,-1,76
1,<environment.Job instance at 0x7f0192aed7d0>,76,14,[9 4],77,-1,93,-1,79
1,<environment.Job instance at 0x7f0192aed190>,80,25,[6 4],81,-1,106,-1,81
1,<environment.Job instance at 0x7f0192aed230>,84,24,[5 5],85,-1,109,-1,85
1,<environment.Job instance at 0x7f0192aea280>,86,14,[2 5],87,-1,101,-1,87
1,<environment.Job instance at 0x7f0192aea140>,88,28,[ 5 10],89,-1,117,-1,89
1,<environment.Job instance at 0x7f0192aeadc0>,89,15,[9 5],90,-1,105,-1,90
1,<environment.Job instance at 0x7f0192aeae10>,90,13,[5 5],91,-1,104,-1,91
1,<environment.Job instance at 0x7f0192aea5f0>,91,17,[7 5],92,-1,109,-1,92
1,<environment.Job instance at 0x7f0192cc2960>,98,15,[2 9],99,-1,116,-1,101
1,<environment.Job instance at 0x7f0192cc2b90>,100,12,[4 5],101,-1,116,-1,104
1,<environment.Job instance at 0x7f0192aa4f50>,103,15,[6 4],104,-1,119,-1,104
1,<environment.Job instance at 0x7f0192aa4640>,105,13,[6 3],106,-1,119,-1,106
1,<environment.Job instance at 0x7f0192aed960>,78,14,[8 2],79,-1,120,-1,106
1,<environment.Job instance at 0x7f0192aa4190>,106,12,[10  2],107,-1,120,-1,108
1,<environment.Job instance at 0x7f0192aa49b0>,108,13,[8 3],109,-1,122,-1,109
1,<environment.Job instance at 0x7f0192aa7f00>,114,22,[7 3],115,-1,139,-1,117
1,<environment.Job instance at 0x7f0192fdca00>,115,20,[7 5],116,-1,137,-1,117
1,<environment.Job instance at 0x7f01930d44b0>,124,17,[14  5],125,-1,546,-1,529
1,<environment.Job instance at 0x7f0192c64370>,0,26,[8 3],1,-1,27,-1,1
1,<environment.Job instance at 0x7f0192aeaaf0>,14,2,[11  3],15,-1,25,-1,23
1,<environment.Job instance at 0x7f0192cb38c0>,25,17,[12  4],26,-1,86,-1,69
1,<environment.Job instance at 0x7f0192c46640>,37,2,[ 3 11],38,-1,120,-1,118
1,<environment.Job instance at 0x7f0192c0d0f0>,42,27,[8 3],43,-1,177,-1,150
1,<environment.Job instance at 0x7f0193366370>,46,27,[2 6],47,-1,194,-1,167
1,<environment.Job instance at 0x7f0193366690>,50,14,[ 4 14],51,-1,197,-1,183
1,<environment.Job instance at 0x7f019297e320>,67,23,[2 8],68,-1,258,-1,235
1,<environment.Job instance at 0x7f019297e640>,68,3,[11  1],69,-1,238,-1,235
1,<environment.Job instance at 0x7f019297e730>,69,19,[13  3],70,-1,254,-1,235
1,<environment.Job instance at 0x7f0192972a00>,74,13,[ 4 11],75,-1,266,-1,253
1,<environment.Job instance at 0x7f0192973eb0>,79,17,[12  4],80,-1,285,-1,268
1,<environment.Job instance at 0x7f0192a03aa0>,80,25,[6 4],81,-1,298,-1,273
1,<environment.Job instance at 0x7f0192a03c30>,82,3,[14  5],83,-1,276,-1,273
1,<environment.Job instance at 0x7f01929aad70>,84,24,[5 5],85,-1,306,-1,282
1,<environment.Job instance at 0x7f01929c7690>,88,28,[ 5 10],89,-1,327,-1,299
1,<environment.Job instance at 0x7f01929ad2d0>,96,12,[ 5 12],97,-1,331,-1,319
1,<environment.Job instance at 0x7f0192aa25f0>,99,2,[ 5 14],100,-1,333,-1,331
1,<environment.Job instance at 0x7f0192aa85f0>,111,16,[ 1 14],112,-1,392,-1,376
1,<environment.Job instance at 0x7f0192b05e60>,124,17,[14  5],125,-1,429,-1,412
1,<environment.Job instance at 0x7f0192b053c0>,131,2,[14  5],132,-1,426,-1,424
1,<environment.Job instance at 0x7f0192cc2140>,147,28,[5 9],148,-1,523,-1,495
1,<environment.Job instance at 0x7f0192ae3e60>,157,28,[9 1],158,-1,577,-1,549
1,<environment.Job instance at 0x7f0192ae3460>,162,26,[5 8],163,-1,580,-1,554
1,<environment.Job instance at 0x7f0192adf410>,166,2,[ 5 13],167,-1,569,-1,567
1,<environment.Job instance at 0x7f0192be9be0>,0,22,[7 1],1,-1,23,-1,1
1,<environment.Job instance at 0x7f019382aaf0>,2,21,[5 7],3,-1,24,-1,3
1,<environment.Job instance at 0x7f019382a140>,5,16,[4 7],6,-1,22,-1,6
1,<environment.Job instance at 0x7f019382ac80>,6,18,[9 3],7,-1,26,-1,8
1,<environment.Job instance at 0x7f019382ad70>,8,16,[1 7],9,-1,25,-1,9
1,<environment.Job instance at 0x7f019382ab90>,9,18,[8 2],10,-1,28,-1,10
1,<environment.Job instance at 0x7f01930c0550>,13,17,[4 7],14,-1,31,-1,14
1,<environment.Job instance at 0x7f01930c0370>,14,16,[ 5 10],15,-1,32,-1,16
1,<environment.Job instance at 0x7f01930c0730>,16,2,[2 6],17,-1,19,-1,17
1,<environment.Job instance at 0x7f01930c07d0>,17,1,[5 1],18,-1,19,-1,18
1,<environment.Job instance at 0x7f01930c0960>,18,1,[10  1],19,-1,20,-1,19
1,<environment.Job instance at 0x7f01930c0aa0>,20,26,[3 7],21,-1,47,-1,21
1,<environment.Job instance at 0x7f01930c0be0>,21,18,[11  5],22,-1,40,-1,22
1,<environment.Job instance at 0x7f01930c0c30>,22,12,[2 9],23,-1,35,-1,23
1,<environment.Job instance at 0x7f01930c0cd0>,23,12,[8 2],24,-1,36,-1,24
1,<environment.Job instance at 0x7f01930c0d70>,24,16,[1 5],25,-1,41,-1,25
1,<environment.Job instance at 0x7f01930c0e10>,25,18,[4 9],26,-1,44,-1,26
1,<environment.Job instance at 0x7f019382aeb0>,15,15,[5 9],16,-1,42,-1,27
1,<environment.Job instance at 0x7f01930c0b90>,27,18,[10  5],28,-1,46,-1,28
1,<environment.Job instance at 0x7f019380e280>,30,13,[10  1],31,-1,46,-1,33
1,<environment.Job instance at 0x7f019380e5f0>,33,14,[6 5],34,-1,48,-1,34
1,<environment.Job instance at 0x7f019380e500>,34,12,[9 3],35,-1,47,-1,35
1,<environment.Job instance at 0x7f019380e6e0>,35,1,[1 8],36,-1,37,-1,36
1,<environment.Job instance at 0x7f019380e780>,36,12,[10  1],37,-1,49,-1,37
1,<environment.Job instance at 0x7f019380e1e0>,32,24,[1 9],33,-1,63,-1,39
1,<environment.Job instance at 0x7f019380ebe0>,40,17,[5 6],41,-1,58,-1,41
1,<environment.Job instance at 0x7f019380ecd0>,41,27,[7 1],42,-1,69,-1,42
1,<environment.Job instance at 0x7f019380ef00>,45,21,[ 2 10],46,-1,68,-1,47
1,<environment.Job instance at 0x7f019380efa0>,46,15,[10  2],47,-1,62,-1,47
1,<environment.Job instance at 0x7f01932114b0>,50,16,[10  1],51,-1,68,-1,52
1,<environment.Job instance at 0x7f0193211550>,51,17,[11  3],52,-1,69,-1,52
1,<environment.Job instance at 0x7f0193211dc0>,60,17,[10  2],61,-1,89,-1,72
1,<environment.Job instance at 0x7f01932110f0>,48,12,[ 2 11],49,-1,84,-1,72
1,<environment.Job instance at 0x7f01932123c0>,66,14,[8 4],67,-1,87,-1,73
1,<environment.Job instance at 0x7f0193212370>,67,14,[9 2],68,-1,87,-1,73
1,<environment.Job instance at 0x7f0193211c80>,59,15,[ 3 10],60,-1,88,-1,73
1,<environment.Job instance at 0x7f0193212640>,72,18,[6 2],73,-1,93,-1,75
1,<environment.Job instance at 0x7f0193212c30>,75,19,[6 3],76,-1,95,-1,76
1,<environment.Job instance at 0x7f01930aa5a0>,86,15,[10  3],87,-1,141,-1,126
1,<environment.Job instance at 0x7f0193202280>,82,27,[5 7],83,-1,153,-1,126
1,<environment.Job instance at 0x7f0193824cd0>,88,15,[11  4],89,-1,141,-1,126
1,<environment.Job instance at 0x7f0193824e10>,90,13,[5 4],91,-1,139,-1,126
1,<environment.Job instance at 0x7f0193824230>,89,17,[5 2],90,-1,145,-1,128
1,<environment.Job instance at 0x7f0193097460>,95,15,[6 2],96,-1,144,-1,129
1,<environment.Job instance at 0x7f0192a87910>,84,24,[13  2],85,-1,156,-1,132
1,<environment.Job instance at 0x7f0192ff1410>,106,16,[8 2],107,-1,169,-1,153
1,<environment.Job instance at 0x7f0192d421e0>,107,14,[11  4],108,-1,167,-1,153
1,<environment.Job instance at 0x7f0192fe1b40>,108,14,[8 5],109,-1,169,-1,155
1,<environment.Job instance at 0x7f0192d424b0>,111,18,[ 3 10],112,-1,203,-1,185
1,<environment.Job instance at 0x7f0192e03a00>,113,24,[8 5],114,-1,209,-1,185
1,<environment.Job instance at 0x7f0193097870>,101,18,[4 9],102,-1,203,-1,185
1,<environment.Job instance at 0x7f0192e03820>,114,14,[ 1 10],115,-1,203,-1,189
1,<environment.Job instance at 0x7f0192fe9780>,127,14,[7 2],128,-1,237,-1,223
1,<environment.Job instance at 0x7f0192fe9f00>,128,20,[3 9],129,-1,243,-1,223
1,<environment.Job instance at 0x7f0192d22370>,131,17,[ 4 10],132,-1,271,-1,254
1,<environment.Job instance at 0x7f0193007af0>,141,13,[2 5],142,-1,308,-1,295
1,<environment.Job instance at 0x7f0193007550>,145,15,[4 7],146,-1,311,-1,296
1,<environment.Job instance at 0x7f0192d25500>,147,17,[8 4],148,-1,376,-1,359
1,<environment.Job instance at 0x7f0192df9e60>,163,18,[6 4],164,-1,377,-1,359
1,<environment.Job instance at 0x7f0193211640>,53,15,[ 4 13],54,-1,374,-1,359
1,<environment.Job instance at 0x7f0192d32140>,170,13,[5 8],171,-1,372,-1,359
1,<environment.Job instance at 0x7f0193eeebe0>,172,12,[4 7],173,-1,371,-1,359
1,<environment.Job instance at 0x7f0192d52910>,173,15,[6 2],174,-1,374,-1,359
1,<environment.Job instance at 0x7f0192d28f00>,175,21,[9 5],176,-1,380,-1,359
1,<environment.Job instance at 0x7f0192d28d70>,176,18,[10  5],177,-1,378,-1,360
1,<environment.Job instance at 0x7f0192d28e10>,177,14,[1 9],178,-1,374,-1,360
1,<environment.Job instance at 0x7f01930a6e10>,20,26,[3 7],21,-1,89,-1,63
1,<environment.Job instance at 0x7f01930a6eb0>,21,18,[11  5],22,-1,81,-1,63
1,<environment.Job instance at 0x7f019382a500>,29,1,[12  2],30,-1,88,-1,87
1,<environment.Job instance at 0x7f0192ae3e60>,32,24,[1 9],33,-1,127,-1,103
1,<environment.Job instance at 0x7f0192cc2870>,41,27,[7 1],42,-1,160,-1,133
1,<environment.Job instance at 0x7f0192cc2640>,43,2,[ 3 13],44,-1,135,-1,133
1,<environment.Job instance at 0x7f0192cc2cd0>,42,26,[ 3 10],43,-1,170,-1,144
1,<environment.Job instance at 0x7f0192cc25f0>,47,1,[ 3 14],48,-1,145,-1,144
1,<environment.Job instance at 0x7f0192cc2370>,48,12,[ 2 11],49,-1,156,-1,144
1,<environment.Job instance at 0x7f0192cc2410>,51,17,[11  3],52,-1,162,-1,145
1,<environment.Job instance at 0x7f0192cc2dc0>,52,16,[12  1],53,-1,161,-1,145
1,<environment.Job instance at 0x7f0192cc2e10>,53,15,[ 4 13],54,-1,160,-1,145
1,<environment.Job instance at 0x7f0192b055a0>,63,24,[2 6],64,-1,217,-1,193
1,<environment.Job instance at 0x7f0192ac9870>,64,13,[ 5 12],65,-1,206,-1,193
1,<environment.Job instance at 0x7f0192ac9820>,65,2,[ 2 11],66,-1,195,-1,193
1,<environment.Job instance at 0x7f0192aa25f0>,82,27,[5 7],83,-1,284,-1,257
1,<environment.Job instance at 0x7f01929ad5f0>,84,24,[13  2],85,-1,281,-1,257
1,<environment.Job instance at 0x7f0192b030a0>,88,15,[11  4],89,-1,284,-1,269
1,<environment.Job instance at 0x7f01929c7e60>,91,14,[ 4 13],92,-1,301,-1,287
1,<environment.Job instance at 0x7f0192d9df00>,107,14,[11  4],108,-1,358,-1,344
1,<environment.Job instance at 0x7f01933663c0>,110,18,[ 4 11],111,-1,378,-1,360
1,<environment.Job instance at 0x7f01933668c0>,113,24,[8 5],114,-1,401,-1,377
1,<environment.Job instance at 0x7f0193366050>,118,13,[12  1],119,-1,404,-1,391
1,<environment.Job instance at 0x7f0192bfa9b0>,126,3,[14  2],127,-1,437,-1,434
1,<environment.Job instance at 0x7f0192aea550>,133,14,[ 5 13],134,-1,464,-1,450
1,<environment.Job instance at 0x7f0192af6960>,138,23,[3 9],139,-1,491,-1,468
1,<environment.Job instance at 0x7f0192af1460>,150,2,[ 1 11],151,-1,523,-1,521
1,<environment.Job instance at 0x7f0192f31aa0>,157,12,[ 3 14],158,-1,555,-1,543
1,<environment.Job instance at 0x7f01935b2a00>,168,16,[13  3],169,-1,579,-1,563
1,<environment.Job instance at 0x7f019365e820>,1,16,[1 6],2,-1,18,-1,2
1,<environment.Job instance at 0x7f019365eb40>,3,27,[3 5],4,-1,31,-1,4
1,<environment.Job instance at 0x7f019365e6e0>,7,17,[5 7],8,-1,25,-1,8
1,<environment.Job instance at 0x7f0193449370>,9,12,[1 9],10,-1,22,-1,10
1,<environment.Job instance at 0x7f01934498c0>,13,12,[9 3],14,-1,26,-1,14
1,<environment.Job instance at 0x7f0193449e60>,16,12,[6 4],17,-1,29,-1,17
1,<environment.Job instance at 0x7f01934493c0>,17,17,[2 6],18,-1,35,-1,18
1,<environment.Job instance at 0x7f0193449f00>,18,17,[5 4],19,-1,36,-1,19
1,<environment.Job instance at 0x7f0193449e10>,20,16,[9 4],21,-1,37,-1,21
1,<environment.Job instance at 0x7f01934496e0>,23,13,[5 6],24,-1,37,-1,24
1,<environment.Job instance at 0x7f01934e67d0>,25,18,[3 9],26,-1,44,-1,26
1,<environment.Job instance at 0x7f01934e6640>,26,27,[10  4],27,-1,54,-1,27
1,<environment.Job instance at 0x7f01934e63c0>,28,14,[4 5],29,-1,44,-1,30
1,<environment.Job instance at 0x7f01934e6e10>,30,1,[ 5 11],31,-1,32,-1,31
1,<environment.Job instance at 0x7f01934e6aa0>,31,18,[4 8],32,-1,50,-1,32
1,<environment.Job instance at 0x7f01934e6280>,32,25,[7 3],33,-1,58,-1,33
1,<environment.Job instance at 0x7f01934e6b40>,33,3,[ 1 10],34,-1,38,-1,35
1,<environment.Job instance at 0x7f01934e6d20>,34,13,[ 3 12],35,-1,48,-1,35
1,<environment.Job instance at 0x7f01934e60a0>,29,14,[9 4],30,-1,51,-1,37
1,<environment.Job instance at 0x7f01934e6b90>,38,13,[ 3 10],39,-1,53,-1,40
1,<environment.Job instance at 0x7f01935340a0>,40,16,[10  3],41,-1,57,-1,41
1,<environment.Job instance at 0x7f0193534eb0>,41,17,[10  5],42,-1,59,-1,42
1,<environment.Job instance at 0x7f0193534b40>,43,17,[6 1],44,-1,61,-1,44
1,<environment.Job instance at 0x7f0193534050>,46,13,[8 5],47,-1,60,-1,47
1,<environment.Job instance at 0x7f01936548c0>,55,12,[3 7],56,-1,68,-1,56
1,<environment.Job instance at 0x7f0193654640>,57,16,[2 7],58,-1,74,-1,58
1,<environment.Job instance at 0x7f0193654140>,58,15,[6 2],59,-1,74,-1,59
1,<environment.Job instance at 0x7f0193654460>,59,14,[7 2],60,-1,74,-1,60
1,<environment.Job instance at 0x7f0193654e10>,60,18,[1 7],61,-1,79,-1,61
1,<environment.Job instance at 0x7f0193654370>,61,14,[1 7],62,-1,76,-1,62
1,<environment.Job instance at 0x7f0193654aa0>,62,14,[8 5],63,-1,77,-1,63
1,<environment.Job instance at 0x7f01936545a0>,65,26,[4 8],66,-1,92,-1,66
1,<environment.Job instance at 0x7f0193654870>,66,20,[4 8],67,-1,87,-1,67
1,<environment.Job instance at 0x7f01936541e0>,68,16,[8 4],69,-1,85,-1,69
1,<environment.Job instance at 0x7f019360c6e0>,70,25,[5 4],71,-1,96,-1,71
1,<environment.Job instance at 0x7f019360c4b0>,73,18,[ 2 10],74,-1,92,-1,74
1,<environment.Job instance at 0x7f019360ca00>,75,25,[5 7],76,-1,101,-1,76
1,<environment.Job instance at 0x7f019360c640>,76,12,[5 9],77,-1,89,-1,77
1,<environment.Job instance at 0x7f019360cf50>,77,22,[5 8],78,-1,100,-1,78
1,<environment.Job instance at 0x7f01934e6320>,36,17,[2 9],37,-1,100,-1,83
1,<environment.Job instance at 0x7f019360cb40>,81,12,[3 9],82,-1,95,-1,83
1,<environment.Job instance at 0x7f019360c7d0>,83,27,[8 5],84,-1,111,-1,84
1,<environment.Job instance at 0x7f01936270f0>,85,14,[7 3],86,-1,100,-1,86
1,<environment.Job instance at 0x7f0193627be0>,93,24,[3 5],94,-1,118,-1,94
1,<environment.Job instance at 0x7f0193627e60>,94,14,[4 6],95,-1,109,-1,95
1,<environment.Job instance at 0x7f0193627320>,95,14,[10  1],96,-1,110,-1,96
1,<environment.Job instance at 0x7f0193627140>,96,15,[3 6],97,-1,112,-1,97
1,<environment.Job instance at 0x7f0193627690>,97,17,[2 7],98,-1,115,-1,98
1,<environment.Job instance at 0x7f0193627dc0>,98,15,[5 5],99,-1,114,-1,99
1,<environment.Job instance at 0x7f019382ac30>,101,18,[5 9],102,-1,120,-1,102
1,<environment.Job instance at 0x7f01939cc3c0>,103,18,[3 7],104,-1,122,-1,104
1,<environment.Job instance at 0x7f01934e6870>,39,14,[4 7],40,-1,118,-1,104
1,<environment.Job instance at 0x7f019396e280>,114,23,[4 5],115,-1,138,-1,115
1,<environment.Job instance at 0x7f0192c35870>,117,13,[12  5],118,-1,139,-1,126
1,<environment.Job instance at 0x7f0193aa2b90>,108,12,[1 8],109,-1,138,-1,126
1,<environment.Job instance at 0x7f019cb20960>,119,18,[7 4],120,-1,144,-1,126
1,<environment.Job instance at 0x7f01936d3fa0>,123,14,[ 4 11],124,-1,141,-1,127
1,<environment.Job instance at 0x7f019311faa0>,110,18,[2 7],111,-1,148,-1,130
1,<environment.Job instance at 0x7f0193284870>,124,18,[3 6],125,-1,148,-1,130
1,<environment.Job instance at 0x7f019314fd70>,126,26,[8 5],127,-1,156,-1,130
1,<environment.Job instance at 0x7f01939cce60>,104,27,[1 8],105,-1,157,-1,130
1,<environment.Job instance at 0x7f019326e0f0>,129,20,[6 3],130,-1,150,-1,130
1,<environment.Job instance at 0x7f019391b5a0>,147,22,[10  1],148,-1,641,-1,619
1,<environment.Job instance at 0x7f019391bd20>,152,13,[9 2],153,-1,632,-1,619
1,<environment.Job instance at 0x7f019391b730>,150,20,[3 8],151,-1,639,-1,619
1,<environment.Job instance at 0x7f019385d460>,156,26,[9 5],157,-1,680,-1,654
1,<environment.Job instance at 0x7f019333f9b0>,169,22,[7 3],170,-1,676,-1,654
1,<environment.Job instance at 0x7f0193145050>,162,13,[ 3 10],163,-1,667,-1,654
1,<environment.Job instance at 0x7f019333f870>,172,25,[7 5],173,-1,679,-1,654
1,<environment.Job instance at 0x7f019333fbe0>,171,12,[7 1],172,-1,666,-1,654
1,<environment.Job instance at 0x7f019333fc30>,176,12,[12  4],177,-1,668,-1,656
1,<environment.Job instance at 0x7f01930e7b40>,178,12,[10  2],179,-1,668,-1,656
1,<environment.Job instance at 0x7f019333f960>,170,15,[13  3],171,-1,673,-1,658
1,<environment.Job instance at 0x7f01930c0fa0>,4,1,[12  4],5,-1,6,-1,5
1,<environment.Job instance at 0x7f01935347d0>,5,2,[14  1],6,-1,8,-1,6
1,<environment.Job instance at 0x7f01934e6c30>,3,27,[3 5],4,-1,40,-1,13
1,<environment.Job instance at 0x7f0193907140>,26,27,[10  4],27,-1,98,-1,71
1,<environment.Job instance at 0x7f0193b69730>,30,1,[ 5 11],31,-1,73,-1,72
1,<environment.Job instance at 0x7f01939ff640>,32,25,[7 3],33,-1,127,-1,102
1,<environment.Job instance at 0x7f0193a73820>,34,13,[ 3 12],35,-1,115,-1,102
1,<environment.Job instance at 0x7f019314f8c0>,48,14,[13  2],49,-1,177,-1,163
1,<environment.Job instance at 0x7f0192aeab40>,65,26,[4 8],66,-1,251,-1,225
1,<environment.Job instance at 0x7f0192ca6780>,70,25,[5 4],71,-1,256,-1,231
1,<environment.Job instance at 0x7f01929ad690>,75,25,[5 7],76,-1,270,-1,245
1,<environment.Job instance at 0x7f01929ad550>,79,3,[11  3],80,-1,260,-1,257
1,<environment.Job instance at 0x7f0192aa82d0>,83,27,[8 5],84,-1,301,-1,274
1,<environment.Job instance at 0x7f0192aa83c0>,84,12,[ 5 13],85,-1,286,-1,274
1,<environment.Job instance at 0x7f0192ac98c0>,89,1,[12  4],90,-1,287,-1,286
1,<environment.Job instance at 0x7f0192ac9910>,93,24,[3 5],94,-1,314,-1,290
1,<environment.Job instance at 0x7f0192cc2a00>,104,27,[1 8],105,-1,380,-1,353
1,<environment.Job instance at 0x7f0192cc2cd0>,114,23,[4 5],115,-1,406,-1,383
1,<environment.Job instance at 0x7f0192cc2870>,117,13,[12  5],118,-1,406,-1,393
1,<environment.Job instance at 0x7f0192ae3aa0>,123,14,[ 4 11],124,-1,438,-1,424
1,<environment.Job instance at 0x7f0192ae34b0>,126,26,[8 5],127,-1,453,-1,427
1,<environment.Job instance at 0x7f019382ab40>,128,18,[13  1],129,-1,445,-1,427
1,<environment.Job instance at 0x7f0192d22190>,148,16,[13  1],149,-1,514,-1,498
1,<environment.Job instance at 0x7f01932125f0>,151,3,[11  4],152,-1,517,-1,514
1,<environment.Job instance at 0x7f0193211cd0>,156,26,[9 5],157,-1,568,-1,542
1,<environment.Job instance at 0x7f0193bb12d0>,167,1,[ 4 12],168,-1,567,-1,566
1,<environment.Job instance at 0x7f0193627a00>,170,15,[13  3],171,-1,583,-1,568
1,<environment.Job instance at 0x7f0193627e10>,172,12,[12  4],177,-1,590,-1,578
1,<environment.Job instance at 0x7f0193ee2be0>,0,16,[ 2 10],1,-1,19,-1,3
1,<environment.Job instance at 0x7f01939cc8c0>,3,15,[4 8],4,-1,19,-1,4
1,<environment.Job instance at 0x7f01939cc9b0>,6,18,[5 8],7,-1,26,-1,8
1,<environment.Job instance at 0x7f01939cc0a0>,9,17,[ 2 10],10,-1,27,-1,10
1,<environment.Job instance at 0x7f0193b69a00>,11,18,[8 1],12,-1,30,-1,12
1,<environment.Job instance at 0x7f0193b690a0>,12,15,[3 9],13,-1,28,-1,13
1,<environment.Job instance at 0x7f0193b69320>,13,20,[8 4],14,-1,34,-1,14
1,<environment.Job instance at 0x7f0193b69f00>,17,27,[8 5],18,-1,45,-1,18
1,<environment.Job instance at 0x7f01939cc4b0>,7,13,[5 8],8,-1,31,-1,18
1,<environment.Job instance at 0x7f01935f2f00>,23,16,[5 2],24,-1,40,-1,24
1,<environment.Job instance at 0x7f01935f2870>,24,1,[5 2],25,-1,26,-1,25
1,<environment.Job instance at 0x7f01935f2b40>,25,13,[10  5],26,-1,39,-1,26
1,<environment.Job instance at 0x7f01935f2230>,26,17,[7 3],27,-1,44,-1,27
1,<environment.Job instance at 0x7f01935f2820>,28,13,[8 3],29,-1,42,-1,29
1,<environment.Job instance at 0x7f01935f20f0>,30,13,[1 9],31,-1,44,-1,31
1,<environment.Job instance at 0x7f01935f2d20>,31,17,[9 4],32,-1,49,-1,32
1,<environment.Job instance at 0x7f01935f2550>,32,24,[4 6],33,-1,57,-1,33
1,<environment.Job instance at 0x7f0193b69190>,22,17,[3 5],23,-1,50,-1,33
1,<environment.Job instance at 0x7f01935f29b0>,35,14,[10  1],36,-1,51,-1,37
1,<environment.Job instance at 0x7f0193b5b550>,39,1,[3 6],40,-1,41,-1,40
1,<environment.Job instance at 0x7f0193b5bdc0>,40,16,[5 4],41,-1,57,-1,41
1,<environment.Job instance at 0x7f0193b5b320>,41,18,[7 2],42,-1,60,-1,42
1,<environment.Job instance at 0x7f0193b5b960>,42,12,[5 2],43,-1,55,-1,43
1,<environment.Job instance at 0x7f01935f2730>,36,12,[9 5],37,-1,56,-1,44
1,<environment.Job instance at 0x7f0193b5b1e0>,49,18,[ 5 10],50,-1,70,-1,52
1,<environment.Job instance at 0x7f01939ffaa0>,52,19,[2 5],53,-1,72,-1,53
1,<environment.Job instance at 0x7f01939ff050>,53,16,[6 1],54,-1,70,-1,54
1,<environment.Job instance at 0x7f01939ff5f0>,56,13,[8 4],57,-1,70,-1,57
1,<environment.Job instance at 0x7f01939ffb90>,57,17,[6 2],58,-1,75,-1,58
1,<environment.Job instance at 0x7f01939ff280>,58,16,[6 5],59,-1,75,-1,59
1,<environment.Job instance at 0x7f01939ff6e0>,60,25,[10  4],61,-1,115,-1,90
1,<environment.Job instance at 0x7f01935b2550>,65,17,[8 5],66,-1,112,-1,95
1,<environment.Job instance at 0x7f0193a73140>,73,18,[8 3],74,-1,117,-1,99
1,<environment.Job instance at 0x7f019393a820>,77,16,[13  1],78,-1,115,-1,99
1,<environment.Job instance at 0x7f019393a190>,76,16,[7 5],77,-1,115,-1,99
1,<environment.Job instance at 0x7f019393abe0>,79,14,[5 3],80,-1,114,-1,100
1,<environment.Job instance at 0x7f01935b2690>,66,14,[5 7],67,-1,114,-1,100
1,<environment.Job instance at 0x7f0192f04500>,82,18,[8 1],83,-1,118,-1,100
1,<environment.Job instance at 0x7f0192f04d20>,86,20,[10  4],87,-1,120,-1,100
1,<environment.Job instance at 0x7f0192f04b40>,88,17,[9 2],89,-1,119,-1,102
1,<environment.Job instance at 0x7f0192f04c30>,89,14,[7 5],90,-1,116,-1,102
1,<environment.Job instance at 0x7f0192f04be0>,94,18,[6 3],95,-1,139,-1,121
1,<environment.Job instance at 0x7f0192f04410>,95,18,[ 3 12],96,-1,141,-1,123
1,<environment.Job instance at 0x7f019393ad20>,78,13,[7 1],79,-1,136,-1,123
1,<environment.Job instance at 0x7f01935b2a00>,5,15,[ 4 12],6,-1,21,-1,6
1,<environment.Job instance at 0x7f019360c370>,17,27,[8 5],18,-1,86,-1,59
1,<environment.Job instance at 0x7f0193cc3410>,29,2,[ 2 12],30,-1,93,-1,91
1,<environment.Job instance at 0x7f0193f21c30>,32,24,[4 6],33,-1,131,-1,107
1,<environment.Job instance at 0x7f0193f21d70>,33,15,[ 2 13],34,-1,122,-1,107
1,<environment.Job instance at 0x7f01939abcd0>,37,18,[14  1],38,-1,126,-1,108
1,<environment.Job instance at 0x7f019335ba50>,43,13,[ 3 11],44,-1,151,-1,138
1,<environment.Job instance at 0x7f0192d76820>,46,15,[11  2],47,-1,157,-1,142
1,<environment.Job instance at 0x7f019c8e1730>,50,12,[ 3 12],51,-1,171,-1,159
1,<environment.Job instance at 0x7f0193397870>,60,25,[10  4],61,-1,251,-1,226
1,<environment.Job instance at 0x7f01933a3280>,77,16,[13  1],78,-1,284,-1,268
1,<environment.Job instance at 0x7f01931ea870>,81,2,[13  4],82,-1,292,-1,290
1,<environment.Job instance at 0x7f01938bedc0>,90,27,[ 3 13],91,-1,345,-1,318
1,<environment.Job instance at 0x7f01927c5c30>,93,27,[1 7],94,-1,359,-1,332
1,<environment.Job instance at 0x7f01927c5eb0>,95,18,[ 3 12],96,-1,359,-1,341
1,<environment.Job instance at 0x7f019c537690>,100,1,[12  1],101,-1,361,-1,360
1,<environment.Job instance at 0x7f019c537cd0>,101,25,[9 1],102,-1,392,-1,367
1,<environment.Job instance at 0x7f0193ec1d20>,110,27,[5 4],111,-1,450,-1,423
1,<environment.Job instance at 0x7f0193885370>,111,28,[7 5],112,-1,451,-1,423
1,<environment.Job instance at 0x7f01931b9a50>,113,28,[8 2],114,-1,452,-1,424
1,<environment.Job instance at 0x7f01928fe140>,131,1,[ 5 14],132,-1,491,-1,490
1,<environment.Job instance at 0x7f01928fec30>,140,17,[ 5 13],141,-1,535,-1,518
1,<environment.Job instance at 0x7f01926a0280>,143,27,[5 1],144,-1,558,-1,531
1,<environment.Job instance at 0x7f019c532230>,146,2,[ 5 12],147,-1,540,-1,538
1,<environment.Job instance at 0x7f0192d71050>,155,17,[14  4],156,-1,581,-1,564
1,<environment.Job instance at 0x7f0192729460>,161,12,[13  5],162,-1,603,-1,591
1,<environment.Job instance at 0x7f0192a12910>,167,26,[3 7],168,-1,649,-1,623
1,<environment.Job instance at 0x7f0193f1caa0>,175,1,[ 2 11],178,-1,638,-1,637
1,<environment.Job instance at 0x7f0193fae910>,1,17,[7 4],2,-1,19,-1,2
1,<environment.Job instance at 0x7f0193fae2d0>,5,18,[8 2],6,-1,24,-1,6
1,<environment.Job instance at 0x7f0193faee10>,7,28,[4 9],8,-1,36,-1,8
1,<environment.Job instance at 0x7f0193997e60>,16,15,[10  2],17,-1,36,-1,21
1,<environment.Job instance at 0x7f0192d631e0>,28,16,[10  1],29,-1,45,-1,29
1,<environment.Job instance at 0x7f0192d63b40>,29,18,[8 2],30,-1,48,-1,30
1,<environment.Job instance at 0x7f0192d63aa0>,30,18,[2 8],31,-1,49,-1,31
1,<environment.Job instance at 0x7f0192d63500>,33,14,[5 7],34,-1,48,-1,34
1,<environment.Job instance at 0x7f01939975f0>,20,14,[10  4],21,-1,52,-1,38
1,<environment.Job instance at 0x7f0192fcd410>,44,21,[8 1],45,-1,66,-1,45
1,<environment.Job instance at 0x7f0192fcd2d0>,49,25,[ 3 10],50,-1,75,-1,50
1,<environment.Job instance at 0x7f0192fcdfa0>,50,18,[ 2 11],51,-1,72,-1,54
1,<environment.Job instance at 0x7f0192af1e10>,54,17,[5 4],55,-1,72,-1,55
1,<environment.Job instance at 0x7f0192fcda00>,51,12,[ 1 10],52,-1,68,-1,56
1,<environment.Job instance at 0x7f0192fcd370>,42,12,[5 5],43,-1,69,-1,57
1,<environment.Job instance at 0x7f0192af1280>,56,15,[4 7],57,-1,72,-1,57
1,<environment.Job instance at 0x7f0192af1f50>,57,23,[9 2],58,-1,81,-1,58
1,<environment.Job instance at 0x7f0192af1410>,60,15,[4 8],61,-1,76,-1,61
1,<environment.Job instance at 0x7f0192af1690>,63,17,[7 4],64,-1,81,-1,64
1,<environment.Job instance at 0x7f0192af1370>,65,15,[9 1],66,-1,82,-1,67
1,<environment.Job instance at 0x7f0192af1460>,68,16,[6 5],69,-1,85,-1,69
1,<environment.Job instance at 0x7f0193f020a0>,72,18,[ 2 10],73,-1,91,-1,73
1,<environment.Job instance at 0x7f0193f02550>,73,14,[4 9],74,-1,88,-1,74
1,<environment.Job instance at 0x7f0193f02640>,74,12,[9 4],75,-1,87,-1,75
1,<environment.Job instance at 0x7f0192fcd550>,7,28,[4 9],8,-1,46,-1,18
1,<environment.Job instance at 0x7f0192af11e0>,11,18,[13  5],12,-1,37,-1,19
1,<environment.Job instance at 0x7f0193f028c0>,15,14,[11  2],16,-1,49,-1,35
1,<environment.Job instance at 0x7f019c5c95a0>,18,1,[14  2],19,-1,38,-1,37
1,<environment.Job instance at 0x7f0193374e60>,19,1,[ 1 11],20,-1,38,-1,37
1,<environment.Job instance at 0x7f0193fb7a00>,50,18,[ 2 11],51,-1,151,-1,133
1,<environment.Job instance at 0x7f0193fb7140>,49,25,[ 3 10],50,-1,172,-1,147
1,<environment.Job instance at 0x7f0193faee60>,57,23,[9 2],58,-1,189,-1,166
1,<environment.Job instance at 0x7f0193da0460>,76,17,[ 1 14],77,-1,247,-1,230
1,<environment.Job instance at 0x7f01928fe910>,79,18,[14  4],80,-1,254,-1,236
1,<environment.Job instance at 0x7f01928feb90>,83,24,[4 7],84,-1,289,-1,265
1,<environment.Job instance at 0x7f0192befc80>,88,23,[ 4 10],89,-1,302,-1,279
1,<environment.Job instance at 0x7f01927c5050>,95,13,[ 3 12],96,-1,293,-1,280
1,<environment.Job instance at 0x7f0192903cd0>,96,13,[ 4 12],97,-1,293,-1,280
1,<environment.Job instance at 0x7f01927c5230>,103,24,[3 5],104,-1,333,-1,309
1,<environment.Job instance at 0x7f0192e5f320>,119,24,[7 1],120,-1,388,-1,364
1,<environment.Job instance at 0x7f019315cd20>,120,26,[4 8],121,-1,405,-1,379
1,<environment.Job instance at 0x7f01938cda50>,135,15,[12  1],136,-1,446,-1,431
1,<environment.Job instance at 0x7f0193995b90>,143,1,[ 3 13],144,-1,470,-1,469
1,<environment.Job instance at 0x7f01928c7730>,149,18,[ 3 12],150,-1,502,-1,484
1,<environment.Job instance at 0x7f019c9e6910>,155,1,[ 5 13],156,-1,492,-1,491
1,<environment.Job instance at 0x7f01933b4230>,164,24,[5 9],165,-1,577,-1,553
1,<environment.Job instance at 0x7f01933b4dc0>,167,26,[8 5],168,-1,580,-1,554
1,<environment.Job instance at 0x7f01933b4d70>,173,26,[7 5],174,-1,614,-1,588
1,<environment.Job instance at 0x7f01933b45a0>,175,2,[13  2],176,-1,590,-1,588
1,<environment.Job instance at 0x7f0193860f00>,2,18,[4 7],3,-1,21,-1,3
1,<environment.Job instance at 0x7f0193863dc0>,5,17,[9 3],6,-1,27,-1,10
1,<environment.Job instance at 0x7f0193855960>,11,12,[10  4],12,-1,24,-1,12
1,<environment.Job instance at 0x7f01938550f0>,12,1,[7 3],13,-1,14,-1,13
1,<environment.Job instance at 0x7f0193865780>,9,15,[5 5],10,-1,30,-1,15
1,<environment.Job instance at 0x7f01934a99b0>,25,17,[5 9],26,-1,44,-1,27
1,<environment.Job instance at 0x7f0192baed20>,26,23,[10  4],27,-1,50,-1,27
1,<environment.Job instance at 0x7f01934b0d70>,28,17,[4 9],29,-1,46,-1,29
1,<environment.Job instance at 0x7f0192bac230>,29,18,[9 5],30,-1,50,-1,32
1,<environment.Job instance at 0x7f0192bac3c0>,32,18,[10  5],33,-1,51,-1,33
1,<environment.Job instance at 0x7f01934bf640>,35,16,[3 8],36,-1,52,-1,36
1,<environment.Job instance at 0x7f019386c8c0>,36,14,[4 7],37,-1,51,-1,37
1,<environment.Job instance at 0x7f019386cf50>,37,18,[5 4],38,-1,56,-1,38
1,<environment.Job instance at 0x7f01934bd5a0>,39,12,[5 9],40,-1,52,-1,40
1,<environment.Job instance at 0x7f01934a80f0>,41,17,[7 2],42,-1,59,-1,42
1,<environment.Job instance at 0x7f01934a83c0>,43,16,[3 9],44,-1,60,-1,44
1,<environment.Job instance at 0x7f01934a8050>,44,13,[10  1],45,-1,58,-1,45
1,<environment.Job instance at 0x7f01934a5dc0>,45,13,[ 3 10],46,-1,59,-1,46
1,<environment.Job instance at 0x7f01934d9820>,31,17,[8 2],32,-1,66,-1,49
1,<environment.Job instance at 0x7f01934c64b0>,51,17,[3 7],52,-1,70,-1,53
1,<environment.Job instance at 0x7f01934c6780>,52,24,[11  1],53,-1,77,-1,53
1,<environment.Job instance at 0x7f01934c6a00>,53,18,[2 6],54,-1,73,-1,55
1,<environment.Job instance at 0x7f01934c6b90>,54,18,[8 2],55,-1,73,-1,55
1,<environment.Job instance at 0x7f01934d78c0>,58,17,[3 5],59,-1,77,-1,60
1,<environment.Job instance at 0x7f01934d7aa0>,61,15,[10  5],62,-1,77,-1,62
1,<environment.Job instance at 0x7f01934d7c80>,62,18,[10  1],63,-1,84,-1,66
1,<environment.Job instance at 0x7f01934ba640>,71,18,[7 1],72,-1,90,-1,72
1,<environment.Job instance at 0x7f01934ba5a0>,73,18,[ 3 10],74,-1,92,-1,74
1,<environment.Job instance at 0x7f01934ae1e0>,82,14,[ 1 10],83,-1,116,-1,102
1,<environment.Job instance at 0x7f01934ae820>,88,28,[8 3],89,-1,130,-1,102
1,<environment.Job instance at 0x7f01934ae9b0>,89,20,[1 9],90,-1,122,-1,102
1,<environment.Job instance at 0x7f01934ae500>,86,21,[3 7],87,-1,125,-1,104
1,<environment.Job instance at 0x7f01934ae960>,92,16,[10  1],93,-1,120,-1,104
1,<environment.Job instance at 0x7f01934ae6e0>,87,15,[ 3 10],88,-1,119,-1,104
1,<environment.Job instance at 0x7f01934aeb90>,93,17,[ 2 10],94,-1,121,-1,104
1,<environment.Job instance at 0x7f01934aeaa0>,91,17,[5 6],92,-1,121,-1,104
1,<environment.Job instance at 0x7f01934aea00>,98,15,[10  2],99,-1,133,-1,118
1,<environment.Job instance at 0x7f01934aef50>,99,18,[3 8],100,-1,136,-1,118
1,<environment.Job instance at 0x7f01934aec30>,101,18,[4 6],102,-1,136,-1,118
1,<environment.Job instance at 0x7f01934c35f0>,108,15,[8 2],109,-1,159,-1,144
1,<environment.Job instance at 0x7f01934c31e0>,102,15,[1 7],103,-1,159,-1,144
1,<environment.Job instance at 0x7f01934c3910>,113,12,[5 9],114,-1,158,-1,146
1,<environment.Job instance at 0x7f01938553c0>,3,3,[11  3],4,-1,7,-1,4
1,<environment.Job instance at 0x7f01934c3e60>,18,16,[ 5 13],19,-1,48,-1,32
1,<environment.Job instance at 0x7f01934c3410>,21,15,[14  4],22,-1,51,-1,36
1,<environment.Job instance at 0x7f0193863960>,26,23,[10  4],27,-1,68,-1,45
1,<environment.Job instance at 0x7f0193e800f0>,49,25,[8 3],50,-1,176,-1,151
1,<environment.Job instance at 0x7f01933b4d70>,52,24,[11  1],53,-1,175,-1,151
1,<environment.Job instance at 0x7f0193ec64b0>,83,2,[12  1],84,-1,278,-1,276
1,<environment.Job instance at 0x7f0193ec6460>,84,1,[ 5 14],85,-1,277,-1,276
1,<environment.Job instance at 0x7f01a0515f00>,88,28,[8 3],89,-1,322,-1,294
1,<environment.Job instance at 0x7f01b8196960>,96,13,[ 5 11],97,-1,339,-1,326
1,<environment.Job instance at 0x7f01930fd690>,97,2,[13  1],98,-1,328,-1,326
1,<environment.Job instance at 0x7f0193660320>,104,1,[11  3],105,-1,356,-1,355
1,<environment.Job instance at 0x7f0193857d70>,111,13,[ 1 13],112,-1,399,-1,386
1,<environment.Job instance at 0x7f01929753c0>,112,27,[9 1],113,-1,428,-1,401
1,<environment.Job instance at 0x7f01927c5aa0>,116,21,[12  2],117,-1,424,-1,403
1,<environment.Job instance at 0x7f01927c5460>,118,14,[ 1 14],119,-1,417,-1,403
1,<environment.Job instance at 0x7f01927c5550>,120,15,[12  3],121,-1,419,-1,404
1,<environment.Job instance at 0x7f0192903c80>,126,2,[12  3],127,-1,424,-1,422
1,<environment.Job instance at 0x7f0192ca4960>,131,23,[5 9],132,-1,463,-1,440
1,<environment.Job instance at 0x7f01928feb40>,135,15,[ 4 12],136,-1,469,-1,454
1,<environment.Job instance at 0x7f01928fe7d0>,139,3,[ 4 11],140,-1,464,-1,461
1,<environment.Job instance at 0x7f0193da06e0>,141,26,[7 2],142,-1,496,-1,470
1,<environment.Job instance at 0x7f0193da04b0>,142,2,[ 2 13],143,-1,472,-1,470
1,<environment.Job instance at 0x7f0193e03780>,146,12,[11  2],147,-1,484,-1,472
1,<environment.Job instance at 0x7f0193e03c30>,147,1,[14  5],148,-1,473,-1,472
1,<environment.Job instance at 0x7f0192d718c0>,148,19,[ 5 11],149,-1,491,-1,472
1,<environment.Job instance at 0x7f0193fae550>,158,1,[ 4 13],159,-1,522,-1,521
1,<environment.Job instance at 0x7f0193fb7780>,162,2,[ 3 14],163,-1,525,-1,523
1,<environment.Job instance at 0x7f0193fb7140>,164,23,[8 3],165,-1,548,-1,525
1,<environment.Job instance at 0x7f0193d826e0>,169,1,[11  4],170,-1,529,-1,528
1,<environment.Job instance at 0x7f0193a41460>,174,25,[8 2],175,-1,572,-1,547
1,<environment.Job instance at 0x7f0193949730>,173,27,[9 4],174,-1,575,-1,548
1,<environment.Job instance at 0x7f0193f893c0>,2,17,[5 9],3,-1,21,-1,4
1,<environment.Job instance at 0x7f0193f89050>,3,18,[6 1],4,-1,22,-1,4
1,<environment.Job instance at 0x7f0193f89f00>,7,17,[3 7],8,-1,25,-1,8
1,<environment.Job instance at 0x7f0193f89dc0>,8,16,[8 5],9,-1,26,-1,10
1,<environment.Job instance at 0x7f01939bf280>,15,22,[9 4],16,-1,38,-1,16
1,<environment.Job instance at 0x7f01939bf730>,18,14,[3 7],19,-1,33,-1,19
1,<environment.Job instance at 0x7f01939d3280>,19,27,[5 8],20,-1,47,-1,20
1,<environment.Job instance at 0x7f01939d34b0>,20,13,[5 8],21,-1,34,-1,21
1,<environment.Job instance at 0x7f01939d3690>,21,12,[10  5],22,-1,34,-1,22
1,<environment.Job instance at 0x7f01939d33c0>,22,15,[ 5 10],23,-1,38,-1,23
1,<environment.Job instance at 0x7f01939d3eb0>,23,16,[5 8],24,-1,40,-1,24
1,<environment.Job instance at 0x7f01939d3e10>,26,22,[3 8],27,-1,49,-1,27
1,<environment.Job instance at 0x7f0193f89a00>,9,16,[5 1],10,-1,48,-1,32
1,<environment.Job instance at 0x7f01939ce500>,39,12,[ 5 10],40,-1,53,-1,41
1,<environment.Job instance at 0x7f01939ce230>,41,12,[ 4 10],42,-1,54,-1,42
1,<environment.Job instance at 0x7f01939ce370>,43,14,[ 1 10],44,-1,58,-1,44
1,<environment.Job instance at 0x7f01939cee60>,45,2,[1 6],46,-1,48,-1,46
1,<environment.Job instance at 0x7f01939cea00>,46,13,[2 9],47,-1,60,-1,47
1,<environment.Job instance at 0x7f01939cebe0>,47,1,[9 4],48,-1,49,-1,48
1,<environment.Job instance at 0x7f01939ce3c0>,40,18,[9 4],41,-1,66,-1,48
1,<environment.Job instance at 0x7f01939bf2d0>,0,12,[ 4 12],1,-1,13,-1,1
1,<environment.Job instance at 0x7f01927c5190>,19,27,[5 8],20,-1,81,-1,54
1,<environment.Job instance at 0x7f0192817d70>,35,15,[13  3],36,-1,101,-1,86
1,<environment.Job instance at 0x7f01934b09b0>,42,1,[14  1],43,-1,105,-1,104
1,<environment.Job instance at 0x7f01934a8a50>,44,17,[14  4],45,-1,135,-1,118
1,<environment.Job instance at 0x7f01934b53c0>,48,24,[8 2],49,-1,157,-1,133
1,<environment.Job instance at 0x7f01934b5190>,49,27,[ 3 13],50,-1,160,-1,133
1,<environment.Job instance at 0x7f0193863fa0>,50,18,[ 2 12],51,-1,151,-1,133
1,<environment.Job instance at 0x7f01934ae5f0>,56,24,[13  3],57,-1,179,-1,155
1,<environment.Job instance at 0x7f0192825640>,73,26,[7 3],74,-1,246,-1,220
1,<environment.Job instance at 0x7f0192825a50>,77,27,[1 8],78,-1,271,-1,244
1,<environment.Job instance at 0x7f01928435a0>,90,26,[2 8],91,-1,325,-1,299
1,<environment.Job instance at 0x7f0192827460>,99,17,[12  4],100,-1,345,-1,328
1,<environment.Job instance at 0x7f0192827a50>,105,17,[ 1 11],106,-1,357,-1,340
1,<environment.Job instance at 0x7f0192829f00>,107,13,[12  4],108,-1,367,-1,354
1,<environment.Job instance at 0x7f019c572f50>,120,24,[ 4 14],121,-1,425,-1,401
1,<environment.Job instance at 0x7f0192b984b0>,124,14,[ 1 11],125,-1,429,-1,415
1,<environment.Job instance at 0x7f0192834f00>,125,24,[7 4],126,-1,440,-1,416
1,<environment.Job instance at 0x7f019c573730>,135,25,[6 2],136,-1,483,-1,458
1,<environment.Job instance at 0x7f019c5737d0>,136,2,[ 1 13],137,-1,460,-1,458
1,<environment.Job instance at 0x7f0193f57d20>,146,26,[10  2],147,-1,516,-1,490
1,<environment.Job instance at 0x7f01934e41e0>,154,1,[12  5],155,-1,520,-1,519
1,<environment.Job instance at 0x7f0193345cd0>,155,1,[ 2 14],156,-1,520,-1,519
1,<environment.Job instance at 0x7f01933457d0>,157,2,[14  3],158,-1,523,-1,521
1,<environment.Job instance at 0x7f0192d42190>,168,28,[ 2 11],169,-1,583,-1,555
1,<environment.Job instance at 0x7f01939ea500>,176,15,[ 2 12],177,-1,615,-1,600
1,<environment.Job instance at 0x7f0192838910>,4,18,[3 9],5,-1,24,-1,6
1,<environment.Job instance at 0x7f0192cd0af0>,10,17,[1 5],11,-1,28,-1,11
1,<environment.Job instance at 0x7f019281e5f0>,11,17,[10  2],12,-1,31,-1,14
1,<environment.Job instance at 0x7f0192ca65a0>,15,13,[ 5 10],16,-1,29,-1,16
1,<environment.Job instance at 0x7f0192ca6a50>,17,18,[7 5],18,-1,36,-1,18
1,<environment.Job instance at 0x7f0192dd97d0>,19,16,[6 3],20,-1,36,-1,20
1,<environment.Job instance at 0x7f019281da50>,20,17,[11  3],21,-1,38,-1,21
1,<environment.Job instance at 0x7f019281de60>,21,17,[5 3],22,-1,39,-1,22
1,<environment.Job instance at 0x7f019281daf0>,22,16,[6 5],23,-1,39,-1,23
1,<environment.Job instance at 0x7f019281d870>,23,12,[5 7],24,-1,36,-1,24
1,<environment.Job instance at 0x7f019281d370>,26,14,[8 4],27,-1,41,-1,27
1,<environment.Job instance at 0x7f01932f7b40>,31,16,[3 9],32,-1,48,-1,32
1,<environment.Job instance at 0x7f0193313a00>,34,16,[7 2],35,-1,51,-1,35
1,<environment.Job instance at 0x7f01932f3410>,35,14,[6 4],36,-1,50,-1,36
1,<environment.Job instance at 0x7f019330a5a0>,37,24,[8 1],38,-1,62,-1,38
1,<environment.Job instance at 0x7f0192caea50>,40,16,[8 2],41,-1,57,-1,41
1,<environment.Job instance at 0x7f0192cc1e10>,41,28,[5 9],42,-1,70,-1,42
1,<environment.Job instance at 0x7f0192cc1140>,42,14,[7 1],43,-1,58,-1,44
1,<environment.Job instance at 0x7f0192c94550>,44,2,[ 2 10],45,-1,47,-1,45
1,<environment.Job instance at 0x7f0192c94780>,45,1,[ 1 10],46,-1,47,-1,46
1,<environment.Job instance at 0x7f0192c945f0>,46,18,[9 2],47,-1,65,-1,47
1,<environment.Job instance at 0x7f0192c94a00>,47,16,[10  4],48,-1,64,-1,48
1,<environment.Job instance at 0x7f0192c94910>,48,23,[ 3 10],49,-1,72,-1,49
1,<environment.Job instance at 0x7f0192c94fa0>,49,17,[4 5],50,-1,67,-1,50
1,<environment.Job instance at 0x7f0192c94d70>,52,14,[4 6],53,-1,67,-1,53
1,<environment.Job instance at 0x7f01938d60a0>,53,18,[ 5 11],54,-1,72,-1,54
1,<environment.Job instance at 0x7f0192cc1910>,43,28,[6 1],44,-1,85,-1,57
1,<environment.Job instance at 0x7f01938d6140>,57,19,[6 3],58,-1,80,-1,61
1,<environment.Job instance at 0x7f01938e1370>,62,18,[6 5],63,-1,81,-1,63
1,<environment.Job instance at 0x7f01938e17d0>,66,22,[3 7],67,-1,89,-1,67
1,<environment.Job instance at 0x7f01938e1aa0>,67,21,[5 3],68,-1,89,-1,68
1,<environment.Job instance at 0x7f01938e1320>,60,18,[7 1],61,-1,87,-1,69
1,<environment.Job instance at 0x7f01938e1cd0>,70,17,[9 5],71,-1,89,-1,72
1,<environment.Job instance at 0x7f01938c4140>,74,18,[6 5],75,-1,93,-1,75
1,<environment.Job instance at 0x7f01938c4190>,76,28,[7 3],77,-1,105,-1,77
1,<environment.Job instance at 0x7f01938c4280>,78,18,[1 8],79,-1,97,-1,79
1,<environment.Job instance at 0x7f01938c44b0>,79,21,[10  5],80,-1,101,-1,80
1,<environment.Job instance at 0x7f01938c4550>,80,15,[4 9],81,-1,96,-1,81
1,<environment.Job instance at 0x7f01938e1c30>,71,14,[9 4],72,-1,95,-1,81
1,<environment.Job instance at 0x7f01938c4b90>,87,16,[2 6],88,-1,104,-1,88
1,<environment.Job instance at 0x7f01938c4eb0>,88,17,[7 4],89,-1,106,-1,89
1,<environment.Job instance at 0x7f01938c4fa0>,90,12,[4 8],91,-1,104,-1,92
1,<environment.Job instance at 0x7f01938d9230>,92,20,[1 9],93,-1,113,-1,93
1,<environment.Job instance at 0x7f01938d9280>,93,18,[3 7],94,-1,112,-1,94
1,<environment.Job instance at 0x7f01938d94b0>,96,18,[3 6],97,-1,115,-1,97
1,<environment.Job instance at 0x7f01938c7140>,108,22,[10  5],109,-1,131,-1,109
1,<environment.Job instance at 0x7f01938d9e10>,104,18,[2 9],105,-1,128,-1,110
1,<environment.Job instance at 0x7f01938e12d0>,64,17,[12  2],65,-1,127,-1,110
1,<environment.Job instance at 0x7f01938d9fa0>,107,15,[8 4],108,-1,129,-1,114
1,<environment.Job instance at 0x7f01938c7500>,110,17,[2 7],111,-1,131,-1,114
1,<environment.Job instance at 0x7f01938cb370>,124,17,[6 3],125,-1,143,-1,126
1,<environment.Job instance at 0x7f01938cb410>,125,22,[6 4],126,-1,148,-1,126
1,<environment.Job instance at 0x7f01938d9190>,91,16,[6 2],92,-1,143,-1,127
1,<environment.Job instance at 0x7f0192ca6320>,0,12,[ 1 11],1,-1,13,-1,1
1,<environment.Job instance at 0x7f01929f4f50>,3,15,[ 5 12],4,-1,19,-1,4
1,<environment.Job instance at 0x7f01938cb0a0>,20,17,[11  3],21,-1,61,-1,44
1,<environment.Job instance at 0x7f0193345b90>,37,24,[8 1],38,-1,135,-1,111
1,<environment.Job instance at 0x7f0193345370>,41,28,[5 9],42,-1,146,-1,118
1,<environment.Job instance at 0x7f01934e4370>,43,28,[6 1],44,-1,155,-1,127
1,<environment.Job instance at 0x7f0193f578c0>,48,23,[ 3 10],49,-1,169,-1,146
1,<environment.Job instance at 0x7f019c5730f0>,53,18,[ 5 11],54,-1,181,-1,163
1,<environment.Job instance at 0x7f019c572f50>,63,1,[13  4],64,-1,186,-1,185
1,<environment.Job instance at 0x7f019c58f050>,64,17,[12  2],65,-1,202,-1,185
1,<environment.Job instance at 0x7f01934bacd0>,76,28,[7 3],77,-1,268,-1,240
1,<environment.Job instance at 0x7f01934a8f00>,85,16,[ 4 14],86,-1,274,-1,258
1,<environment.Job instance at 0x7f0193e800f0>,97,26,[ 2 12],98,-1,335,-1,309
1,<environment.Job instance at 0x7f0193857d70>,99,1,[ 3 12],100,-1,311,-1,310
1,<environment.Job instance at 0x7f01938cdb40>,102,3,[11  1],103,-1,315,-1,312
1,<environment.Job instance at 0x7f01927c53c0>,105,26,[5 5],106,-1,342,-1,316
1,<environment.Job instance at 0x7f01934f84b0>,114,25,[9 4],115,-1,395,-1,370
1,<environment.Job instance at 0x7f01939dd7d0>,120,25,[9 5],121,-1,400,-1,375
1,<environment.Job instance at 0x7f01939e4780>,121,3,[11  1],122,-1,378,-1,375
1,<environment.Job instance at 0x7f01939e4050>,122,3,[12  5],123,-1,378,-1,375
1,<environment.Job instance at 0x7f01939bff00>,130,26,[10  1],131,-1,461,-1,435
1,<environment.Job instance at 0x7f0192d32a00>,145,27,[5 8],146,-1,515,-1,488
1,<environment.Job instance at 0x7f01931acbe0>,147,25,[6 4],148,-1,524,-1,499
1,<environment.Job instance at 0x7f01931f0050>,149,25,[10  1],150,-1,529,-1,504
1,<environment.Job instance at 0x7f019276ba50>,150,14,[ 1 14],151,-1,518,-1,504
1,<environment.Job instance at 0x7f01939c1f00>,171,26,[5 4],172,-1,600,-1,574
1,<environment.Job instance at 0x7f0193c39460>,178,26,[ 3 10],179,-1,622,-1,596
1,<environment.Job instance at 0x7f019c5723c0>,0,22,[ 3 10],1,-1,24,-1,2
1,<environment.Job instance at 0x7f0193568b40>,7,15,[6 1],8,-1,23,-1,8
1,<environment.Job instance at 0x7f0193ebf410>,11,16,[5 4],12,-1,28,-1,12
1,<environment.Job instance at 0x7f0193ebfa00>,12,18,[2 9],13,-1,31,-1,13
1,<environment.Job instance at 0x7f0193ebf2d0>,13,14,[3 7],14,-1,28,-1,14
1,<environment.Job instance at 0x7f0193997cd0>,19,13,[3 8],20,-1,33,-1,20
1,<environment.Job instance at 0x7f01939971e0>,23,18,[5 5],24,-1,42,-1,24
1,<environment.Job instance at 0x7f01939970a0>,24,16,[10  2],25,-1,42,-1,26
1,<environment.Job instance at 0x7f01934b0e60>,26,16,[5 6],27,-1,43,-1,27
1,<environment.Job instance at 0x7f01934b05a0>,32,15,[5 5],33,-1,48,-1,33
1,<environment.Job instance at 0x7f01934b0eb0>,33,12,[9 5],34,-1,46,-1,34
1,<environment.Job instance at 0x7f019351daa0>,34,18,[ 3 10],35,-1,53,-1,35
1,<environment.Job instance at 0x7f019351d5f0>,35,14,[5 8],36,-1,50,-1,36
1,<environment.Job instance at 0x7f019351dc80>,36,14,[5 5],37,-1,51,-1,37
1,<environment.Job instance at 0x7f019351d8c0>,37,17,[3 7],38,-1,55,-1,38
1,<environment.Job instance at 0x7f019351dfa0>,38,16,[7 5],39,-1,55,-1,39
1,<environment.Job instance at 0x7f019351d0f0>,39,20,[5 5],40,-1,60,-1,40
1,<environment.Job instance at 0x7f0193eb8d70>,45,15,[1 9],46,-1,61,-1,46
1,<environment.Job instance at 0x7f0193eb84b0>,46,18,[1 8],47,-1,65,-1,47
1,<environment.Job instance at 0x7f019281c3c0>,51,14,[10  5],52,-1,66,-1,52
1,<environment.Job instance at 0x7f0192f26a00>,57,28,[8 2],58,-1,86,-1,58
1,<environment.Job instance at 0x7f01930fff00>,58,15,[8 5],59,-1,74,-1,59
1,<environment.Job instance at 0x7f01930ffcd0>,59,13,[5 1],60,-1,73,-1,60
1,<environment.Job instance at 0x7f01930ff780>,62,16,[5 6],63,-1,92,-1,76
1,<environment.Job instance at 0x7f0193d922d0>,76,14,[8 5],77,-1,91,-1,77
1,<environment.Job instance at 0x7f0193ebfd70>,25,13,[4 8],26,-1,104,-1,91
1,<environment.Job instance at 0x7f019c89ec30>,70,22,[9 5],71,-1,154,-1,132
1,<environment.Job instance at 0x7f01930f9e10>,89,21,[14  3],90,-1,153,-1,132
1,<environment.Job instance at 0x7f019c547e60>,72,27,[8 4],73,-1,160,-1,133
1,<environment.Job instance at 0x7f0192a12280>,92,17,[4 5],93,-1,150,-1,133
1,<environment.Job instance at 0x7f01930f9820>,91,12,[9 4],92,-1,145,-1,133
1,<environment.Job instance at 0x7f019c573aa0>,106,20,[5 3],107,-1,183,-1,163
1,<environment.Job instance at 0x7f0192c53af0>,99,22,[3 7],100,-1,185,-1,163
1,<environment.Job instance at 0x7f019c573d20>,110,21,[5 4],111,-1,184,-1,163
1,<environment.Job instance at 0x7f019c5733c0>,112,18,[9 2],113,-1,240,-1,222
1,<environment.Job instance at 0x7f0192d18190>,125,17,[9 4],126,-1,239,-1,222
1,<environment.Job instance at 0x7f0192d18d70>,126,16,[10  4],127,-1,277,-1,261
1,<environment.Job instance at 0x7f0192a12640>,93,19,[8 5],94,-1,281,-1,262
1,<environment.Job instance at 0x7f0193cd5fa0>,140,15,[5 9],141,-1,292,-1,277
1,<environment.Job instance at 0x7f01930f9a00>,85,17,[11  2],86,-1,298,-1,281
1,<environment.Job instance at 0x7f0193cd5640>,138,18,[2 8],139,-1,312,-1,294
1,<environment.Job instance at 0x7f0193cd50a0>,141,18,[8 4],142,-1,312,-1,294
1,<environment.Job instance at 0x7f0193cd5d70>,146,16,[7 4],147,-1,310,-1,294
1,<environment.Job instance at 0x7f0193cd5d20>,142,17,[5 3],143,-1,311,-1,294
1,<environment.Job instance at 0x7f0193f579b0>,149,14,[ 5 10],150,-1,308,-1,294
1,<environment.Job instance at 0x7f0193cd5230>,147,3,[10  4],148,-1,297,-1,294
1,<environment.Job instance at 0x7f0193f57c80>,150,16,[7 5],151,-1,310,-1,294
1,<environment.Job instance at 0x7f0193f57cd0>,155,28,[5 5],156,-1,322,-1,294
1,<environment.Job instance at 0x7f0193f570a0>,156,15,[6 4],157,-1,309,-1,294
1,<environment.Job instance at 0x7f0193cd5820>,143,18,[4 6],144,-1,312,-1,294
1,<environment.Job instance at 0x7f0193f57050>,158,14,[3 7],159,-1,310,-1,296
1,<environment.Job instance at 0x7f0193f57190>,161,21,[4 8],162,-1,319,-1,298
1,<environment.Job instance at 0x7f01937b7190>,163,16,[10  5],164,-1,342,-1,326
1,<environment.Job instance at 0x7f01937b7690>,166,17,[7 1],167,-1,343,-1,326
1,<environment.Job instance at 0x7f019342b550>,177,12,[8 1],178,-1,339,-1,327
1,<environment.Job instance at 0x7f019342b910>,178,22,[4 8],179,-1,349,-1,327
1,<environment.Job instance at 0x7f0192d18cd0>,114,17,[11  1],115,-1,344,-1,327
1,<environment.Job instance at 0x7f0192d18230>,17,3,[ 5 11],18,-1,45,-1,42
1,<environment.Job instance at 0x7f0193cd5910>,21,18,[ 3 14],22,-1,67,-1,49
1,<environment.Job instance at 0x7f01934f6140>,28,13,[14  3],29,-1,92,-1,79
1,<environment.Job instance at 0x7f019276ba50>,47,2,[13  4],48,-1,156,-1,154
1,<environment.Job instance at 0x7f0193558500>,56,13,[13  5],57,-1,199,-1,186
1,<environment.Job instance at 0x7f01934ca7d0>,60,17,[14  5],61,-1,218,-1,201
1,<environment.Job instance at 0x7f01934cabe0>,61,14,[13  2],62,-1,215,-1,201
1,<environment.Job instance at 0x7f0192ad10f0>,57,28,[8 2],58,-1,230,-1,202
1,<environment.Job instance at 0x7f0193ac79b0>,72,27,[8 4],73,-1,254,-1,227
1,<environment.Job instance at 0x7f019c572640>,82,1,[ 1 13],83,-1,249,-1,248
1,<environment.Job instance at 0x7f0193547050>,85,17,[11  2],86,-1,280,-1,263
1,<environment.Job instance at 0x7f0193b9fb90>,89,21,[14  3],90,-1,287,-1,266
1,<environment.Job instance at 0x7f019c572c80>,83,25,[ 4 10],84,-1,307,-1,282
1,<environment.Job instance at 0x7f0193345d20>,107,1,[ 2 11],108,-1,305,-1,304
1,<environment.Job instance at 0x7f0192d5ad20>,114,17,[11  1],115,-1,346,-1,329
1,<environment.Job instance at 0x7f01938c7c30>,127,3,[ 5 11],128,-1,392,-1,389
1,<environment.Job instance at 0x7f0192e09eb0>,144,12,[13  3],145,-1,495,-1,483
1,<environment.Job instance at 0x7f0192e096e0>,155,28,[5 5],156,-1,550,-1,522
1,<environment.Job instance at 0x7f0192e09d20>,160,12,[ 4 14],161,-1,549,-1,537
1,<environment.Job instance at 0x7f01930f6460>,168,1,[ 1 11],169,-1,572,-1,571
1,<environment.Job instance at 0x7f01926560a0>,0,28,[4 7],1,-1,29,-1,1
1,<environment.Job instance at 0x7f01927e3460>,12,16,[10  5],13,-1,30,-1,14
1,<environment.Job instance at 0x7f0192663c30>,17,17,[ 4 14],18,-1,37,-1,20
1,<environment.Job instance at 0x7f01927dac80>,19,17,[6 4],20,-1,37,-1,20
1,<environment.Job instance at 0x7f0193b8a6e0>,15,15,[10  3],16,-1,35,-1,20
1,<environment.Job instance at 0x7f0192663be0>,18,18,[2 9],19,-1,38,-1,20
1,<environment.Job instance at 0x7f01927da460>,20,14,[3 9],21,-1,35,-1,21
1,<environment.Job instance at 0x7f01927da230>,21,16,[ 4 10],22,-1,38,-1,22
1,<environment.Job instance at 0x7f01927da3c0>,26,16,[7 1],27,-1,44,-1,28
1,<environment.Job instance at 0x7f0193738a00>,28,17,[ 1 10],29,-1,46,-1,29
1,<environment.Job instance at 0x7f0192689b40>,40,14,[3 8],41,-1,55,-1,41
1,<environment.Job instance at 0x7f0192689aa0>,41,16,[6 5],42,-1,58,-1,42
1,<environment.Job instance at 0x7f019376ccd0>,44,17,[4 9],45,-1,62,-1,45
1,<environment.Job instance at 0x7f0192663960>,16,12,[3 9],17,-1,58,-1,46
1,<environment.Job instance at 0x7f0193738500>,29,15,[7 2],30,-1,61,-1,46
1,<environment.Job instance at 0x7f019376c960>,45,17,[ 5 10],46,-1,63,-1,46
1,<environment.Job instance at 0x7f019376ce60>,49,18,[9 4],50,-1,70,-1,52
1,<environment.Job instance at 0x7f019376c320>,54,17,[5 2],55,-1,72,-1,55
1,<environment.Job instance at 0x7f019373d1e0>,59,16,[4 9],60,-1,76,-1,60
1,<environment.Job instance at 0x7f019373d280>,63,17,[9 1],64,-1,81,-1,64
1,<environment.Job instance at 0x7f019373df50>,64,13,[10  1],65,-1,78,-1,65
1,<environment.Job instance at 0x7f019373de60>,65,14,[3 5],66,-1,80,-1,66
1,<environment.Job instance at 0x7f019376c410>,51,16,[14  3],52,-1,82,-1,66
1,<environment.Job instance at 0x7f019373d910>,67,18,[7 5],68,-1,86,-1,68
1,<environment.Job instance at 0x7f01927ecd20>,69,18,[ 3 10],70,-1,96,-1,78
1,<environment.Job instance at 0x7f01927eca00>,73,17,[8 4],74,-1,95,-1,78
1,<environment.Job instance at 0x7f01927ec5a0>,74,24,[8 1],75,-1,102,-1,78
1,<environment.Job instance at 0x7f01927ec190>,75,18,[9 4],76,-1,97,-1,79
1,<environment.Job instance at 0x7f01927ec5f0>,76,25,[6 2],77,-1,105,-1,80
1,<environment.Job instance at 0x7f01927ec2d0>,77,17,[8 2],78,-1,97,-1,80
1,<environment.Job instance at 0x7f01927ecaf0>,71,18,[5 9],72,-1,98,-1,80
1,<environment.Job instance at 0x7f019268f0f0>,83,15,[3 8],84,-1,99,-1,84
1,<environment.Job instance at 0x7f01927ec7d0>,79,17,[7 1],80,-1,103,-1,86
1,<environment.Job instance at 0x7f0193ee40a0>,91,20,[5 3],92,-1,117,-1,97
1,<environment.Job instance at 0x7f0193ee4dc0>,92,24,[8 2],93,-1,121,-1,97
1,<environment.Job instance at 0x7f0193ee40f0>,94,15,[4 9],95,-1,113,-1,98
1,<environment.Job instance at 0x7f01927ec500>,72,14,[9 2],73,-1,113,-1,99
1,<environment.Job instance at 0x7f01931b8f50>,96,14,[5 9],97,-1,114,-1,100
1,<environment.Job instance at 0x7f0193ee4d70>,89,16,[10  3],90,-1,119,-1,103
1,<environment.Job instance at 0x7f019309ee60>,105,12,[8 3],106,-1,118,-1,106
1,<environment.Job instance at 0x7f0192a1ffa0>,101,12,[7 4],102,-1,119,-1,107
1,<environment.Job instance at 0x7f0192a1fa00>,104,13,[8 2],105,-1,121,-1,108
1,<environment.Job instance at 0x7f019335da50>,109,25,[1 7],110,-1,136,-1,111
1,<environment.Job instance at 0x7f0192cd9b40>,108,2,[9 5],109,-1,116,-1,114
1,<environment.Job instance at 0x7f0192a46f00>,112,17,[7 4],113,-1,134,-1,117
1,<environment.Job instance at 0x7f01937380a0>,35,16,[5 2],36,-1,133,-1,117
1,<environment.Job instance at 0x7f019375dd20>,113,14,[2 7],114,-1,131,-1,117
1,<environment.Job instance at 0x7f019375dc30>,111,16,[5 9],112,-1,133,-1,117
1,<environment.Job instance at 0x7f0193b87460>,116,17,[10  4],117,-1,134,-1,117
1,<environment.Job instance at 0x7f0192a1fcd0>,106,12,[7 2],107,-1,130,-1,118
1,<environment.Job instance at 0x7f01937bdaa0>,120,14,[2 6],121,-1,135,-1,121
1,<environment.Job instance at 0x7f0192a329b0>,122,18,[ 1 10],123,-1,141,-1,123
1,<environment.Job instance at 0x7f019375d8c0>,115,13,[1 5],116,-1,138,-1,125
1,<environment.Job instance at 0x7f019391b690>,123,15,[1 5],124,-1,140,-1,125
1,<environment.Job instance at 0x7f0193761b90>,124,12,[9 4],125,-1,137,-1,125
1,<environment.Job instance at 0x7f0192b85910>,126,15,[4 7],127,-1,142,-1,127
1,<environment.Job instance at 0x7f01927dff00>,128,17,[9 3],129,-1,146,-1,129
1,<environment.Job instance at 0x7f0192957730>,130,14,[10  1],131,-1,155,-1,141
1,<environment.Job instance at 0x7f0192a23a50>,138,17,[3 6],139,-1,159,-1,142
1,<environment.Job instance at 0x7f0192a23c30>,137,18,[6 1],138,-1,160,-1,142
1,<environment.Job instance at 0x7f0192c68690>,132,18,[10  1],133,-1,160,-1,142
1,<environment.Job instance at 0x7f0193080be0>,142,15,[4 7],143,-1,158,-1,143
1,<environment.Job instance at 0x7f0193080e10>,143,14,[9 2],144,-1,161,-1,147
1,<environment.Job instance at 0x7f01930800f0>,146,16,[1 9],147,-1,168,-1,152
1,<environment.Job instance at 0x7f0193763aa0>,151,18,[4 6],152,-1,172,-1,154
1,<environment.Job instance at 0x7f01938c9e10>,114,12,[4 7],115,-1,167,-1,155
1,<environment.Job instance at 0x7f019262baa0>,118,14,[ 5 11],119,-1,169,-1,155
1,<environment.Job instance at 0x7f019c56e500>,155,13,[10  4],156,-1,169,-1,156
1,<environment.Job instance at 0x7f01932fa8c0>,141,12,[ 5 10],142,-1,171,-1,159
1,<environment.Job instance at 0x7f019c56eb40>,158,18,[4 6],159,-1,177,-1,159
1,<environment.Job instance at 0x7f019c56e0f0>,156,19,[5 4],157,-1,178,-1,159
1,<environment.Job instance at 0x7f019c56eb90>,154,14,[1 7],155,-1,183,-1,169
1,<environment.Job instance at 0x7f0193759e10>,163,18,[10  1],164,-1,188,-1,170
1,<environment.Job instance at 0x7f0192920cd0>,164,15,[9 3],165,-1,186,-1,171
1,<environment.Job instance at 0x7f019294afa0>,162,14,[5 6],163,-1,185,-1,171
1,<environment.Job instance at 0x7f019305fa50>,166,17,[ 2 10],167,-1,189,-1,172
1,<environment.Job instance at 0x7f019305feb0>,171,16,[9 3],172,-1,189,-1,173
1,<environment.Job instance at 0x7f0192f15230>,172,15,[ 2 12],173,-1,188,-1,173
1,<environment.Job instance at 0x7f01927e3b40>,0,28,[4 7],1,-1,29,-1,1
1,<environment.Job instance at 0x7f01927da6e0>,1,15,[ 5 14],2,-1,17,-1,2
1,<environment.Job instance at 0x7f01927e3f50>,3,14,[ 3 11],4,-1,18,-1,4
1,<environment.Job instance at 0x7f019268fb40>,17,17,[ 4 14],18,-1,52,-1,35
1,<environment.Job instance at 0x7f0192e46e10>,51,16,[14  3],52,-1,168,-1,152
1,<environment.Job instance at 0x7f0192e466e0>,52,3,[ 1 14],53,-1,155,-1,152
1,<environment.Job instance at 0x7f0192f48e10>,66,3,[ 5 11],67,-1,199,-1,196
1,<environment.Job instance at 0x7f0192894eb0>,74,24,[8 1],75,-1,270,-1,246
1,<environment.Job instance at 0x7f01930d7690>,76,25,[6 2],77,-1,271,-1,246
1,<environment.Job instance at 0x7f0193787c30>,92,24,[8 2],93,-1,351,-1,327
1,<environment.Job instance at 0x7f01930fc8c0>,97,12,[13  5],98,-1,341,-1,329
1,<environment.Job instance at 0x7f0192631f50>,102,2,[ 1 12],103,-1,345,-1,343
1,<environment.Job instance at 0x7f01926f5b90>,109,25,[1 7],110,-1,395,-1,370
1,<environment.Job instance at 0x7f01938f0870>,118,14,[ 5 11],119,-1,413,-1,399
1,<environment.Job instance at 0x7f0193b230a0>,134,27,[1 7],135,-1,521,-1,494
1,<environment.Job instance at 0x7f01936df2d0>,165,16,[ 5 13],166,-1,647,-1,631
1,<environment.Job instance at 0x7f0193243230>,169,16,[ 1 13],170,-1,673,-1,657
1,<environment.Job instance at 0x7f0192a9b2d0>,172,15,[ 2 12],173,-1,677,-1,662
1,<environment.Job instance at 0x7f0192a9beb0>,176,17,[11  2],177,-1,683,-1,666
1,<environment.Job instance at 0x7f0192c07140>,5,14,[ 2 10],6,-1,20,-1,6
1,<environment.Job instance at 0x7f0192c07fa0>,7,18,[2 7],8,-1,26,-1,8
1,<environment.Job instance at 0x7f0192c07550>,9,15,[8 5],10,-1,26,-1,11
1,<environment.Job instance at 0x7f0192c072d0>,10,22,[9 3],11,-1,33,-1,11
1,<environment.Job instance at 0x7f0193e4eaa0>,11,28,[1 5],12,-1,40,-1,12
1,<environment.Job instance at 0x7f0193e4e9b0>,17,22,[7 3],18,-1,42,-1,20
1,<environment.Job instance at 0x7f0193e4e5f0>,19,14,[6 4],20,-1,34,-1,20
1,<environment.Job instance at 0x7f0193e4e3c0>,20,18,[1 7],21,-1,40,-1,22
1,<environment.Job instance at 0x7f0193e4ee10>,23,15,[3 8],24,-1,39,-1,24
1,<environment.Job instance at 0x7f0193d2baa0>,47,25,[1 9],48,-1,328,-1,303
1,<environment.Job instance at 0x7f01930e78c0>,88,25,[3 6],89,-1,332,-1,307
1,<environment.Job instance at 0x7f01930e7e60>,86,15,[9 4],87,-1,323,-1,308
1,<environment.Job instance at 0x7f01930e7500>,89,13,[3 8],90,-1,321,-1,308
1,<environment.Job instance at 0x7f01930e72d0>,90,17,[8 5],91,-1,325,-1,308
1,<environment.Job instance at 0x7f01930e7b40>,92,13,[3 8],93,-1,330,-1,317
1,<environment.Job instance at 0x7f01930e7c80>,91,3,[2 5],92,-1,320,-1,317
1,<environment.Job instance at 0x7f0193ae0820>,97,16,[2 5],98,-1,333,-1,317
1,<environment.Job instance at 0x7f0193ae04b0>,101,13,[ 4 11],102,-1,330,-1,317
1,<environment.Job instance at 0x7f0193ae0190>,102,20,[3 6],103,-1,339,-1,319
1,<environment.Job instance at 0x7f0193ae0aa0>,103,17,[10  4],104,-1,336,-1,319
1,<environment.Job instance at 0x7f0193ae0d70>,106,21,[10  4],107,-1,340,-1,319
1,<environment.Job instance at 0x7f0193ae0eb0>,107,15,[3 8],108,-1,335,-1,320
1,<environment.Job instance at 0x7f0193ae0460>,110,16,[10  1],111,-1,337,-1,321
1,<environment.Job instance at 0x7f0193ae0c30>,98,15,[5 5],99,-1,340,-1,325
1,<environment.Job instance at 0x7f0193ae0230>,111,18,[3 7],112,-1,344,-1,326
1,<environment.Job instance at 0x7f0193d2bd70>,51,28,[6 2],52,-1,359,-1,331
1,<environment.Job instance at 0x7f019317cb40>,119,15,[8 4],120,-1,354,-1,339
1,<environment.Job instance at 0x7f019317c820>,118,17,[7 2],119,-1,356,-1,339
1,<environment.Job instance at 0x7f019317c690>,124,17,[7 2],125,-1,356,-1,339
1,<environment.Job instance at 0x7f019317ce60>,123,14,[5 2],124,-1,355,-1,341
1,<environment.Job instance at 0x7f019317c8c0>,127,14,[3 8],128,-1,355,-1,341
1,<environment.Job instance at 0x7f019317c0f0>,131,12,[ 5 10],132,-1,353,-1,341
1,<environment.Job instance at 0x7f019317c320>,132,15,[9 5],133,-1,356,-1,341
1,<environment.Job instance at 0x7f01930e7eb0>,87,18,[5 9],88,-1,359,-1,341
1,<environment.Job instance at 0x7f0193e14c30>,137,17,[3 5],138,-1,360,-1,343
1,<environment.Job instance at 0x7f01933364b0>,140,13,[4 7],141,-1,360,-1,347
1,<environment.Job instance at 0x7f0193336780>,143,22,[2 8],144,-1,369,-1,347
1,<environment.Job instance at 0x7f01939d9b40>,147,18,[3 6],148,-1,379,-1,361
1,<environment.Job instance at 0x7f0192762fa0>,152,20,[ 1 10],153,-1,381,-1,361
1,<environment.Job instance at 0x7f0192762eb0>,153,17,[6 1],154,-1,394,-1,377
1,<environment.Job instance at 0x7f0193f7a8c0>,158,17,[ 3 13],159,-1,394,-1,377
1,<environment.Job instance at 0x7f0192f19af0>,162,21,[9 2],163,-1,398,-1,377
1,<environment.Job instance at 0x7f01938ead70>,160,12,[9 1],161,-1,389,-1,377
1,<environment.Job instance at 0x7f0192a09140>,8,12,[ 1 13],9,-1,21,-1,9
1,<environment.Job instance at 0x7f019c4ea870>,12,12,[ 4 14],13,-1,32,-1,20
1,<environment.Job instance at 0x7f01938cea50>,11,28,[1 5],12,-1,48,-1,20
1,<environment.Job instance at 0x7f019c4ea320>,16,14,[11  1],17,-1,34,-1,20
1,<environment.Job instance at 0x7f0193f89640>,24,2,[14  4],25,-1,54,-1,52
1,<environment.Job instance at 0x7f0192d30b40>,25,3,[14  3],26,-1,55,-1,52
1,<environment.Job instance at 0x7f0192d308c0>,26,18,[12  4],27,-1,70,-1,52
1,<environment.Job instance at 0x7f0192846690>,27,3,[ 4 13],28,-1,55,-1,52
1,<environment.Job instance at 0x7f01937355a0>,31,27,[6 5],32,-1,107,-1,80
1,<environment.Job instance at 0x7f0193ae3af0>,33,3,[ 1 13],34,-1,83,-1,80
1,<environment.Job instance at 0x7f0193022be0>,36,16,[ 1 12],37,-1,98,-1,82
1,<environment.Job instance at 0x7f0193ae31e0>,38,25,[10  1],39,-1,138,-1,113
1,<environment.Job instance at 0x7f0193caaa00>,39,23,[4 9],40,-1,142,-1,119
1,<environment.Job instance at 0x7f0192fba4b0>,47,25,[1 9],48,-1,150,-1,125
1,<environment.Job instance at 0x7f019cb74730>,49,27,[9 3],50,-1,153,-1,126
1,<environment.Job instance at 0x7f01926368c0>,51,28,[6 2],52,-1,154,-1,126
1,<environment.Job instance at 0x7f019c767aa0>,73,1,[ 4 14],74,-1,179,-1,178
1,<environment.Job instance at 0x7f0193cc3140>,83,12,[ 1 14],84,-1,209,-1,197
1,<environment.Job instance at 0x7f01931123c0>,88,25,[3 6],89,-1,242,-1,217
1,<environment.Job instance at 0x7f01929f6460>,101,13,[ 4 11],102,-1,286,-1,273
1,<environment.Job instance at 0x7f019263ad70>,109,15,[14  4],110,-1,295,-1,280
1,<environment.Job instance at 0x7f01932363c0>,117,24,[9 5],118,-1,339,-1,315
1,<environment.Job instance at 0x7f01930d7f50>,126,1,[12  5],127,-1,352,-1,351
1,<environment.Job instance at 0x7f0193b2b230>,129,16,[13  2],130,-1,385,-1,369
1,<environment.Job instance at 0x7f01937ab820>,155,13,[13  1],156,-1,455,-1,442
1,<environment.Job instance at 0x7f01937abd70>,158,17,[ 3 13],159,-1,462,-1,445
1,<environment.Job instance at 0x7f019399c910>,165,13,[ 4 14],166,-1,491,-1,478
1,<environment.Job instance at 0x7f019cb96c30>,172,25,[3 6],173,-1,527,-1,502
1,<environment.Job instance at 0x7f019cb2b230>,178,3,[ 1 13],179,-1,524,-1,521
1,<environment.Job instance at 0x7f01933ec410>,7,16,[8 2],8,-1,27,-1,11
1,<environment.Job instance at 0x7f01933ec690>,11,13,[8 5],12,-1,25,-1,12
1,<environment.Job instance at 0x7f0192d130a0>,12,18,[ 5 10],13,-1,31,-1,13
1,<environment.Job instance at 0x7f0192d13a00>,21,16,[ 5 10],22,-1,38,-1,22
1,<environment.Job instance at 0x7f0192d13f00>,25,21,[3 8],26,-1,57,-1,36
1,<environment.Job instance at 0x7f0192d13e10>,27,18,[ 3 12],28,-1,54,-1,36
1,<environment.Job instance at 0x7f0193411780>,34,17,[10  1],35,-1,55,-1,38
1,<environment.Job instance at 0x7f0193411640>,32,21,[1 8],33,-1,60,-1,39
1,<environment.Job instance at 0x7f0193411960>,36,17,[10  2],37,-1,56,-1,39
1,<environment.Job instance at 0x7f0192d13dc0>,24,13,[9 1],25,-1,52,-1,39
1,<environment.Job instance at 0x7f0193411820>,35,12,[5 4],36,-1,51,-1,39
1,<environment.Job instance at 0x7f01934117d0>,38,18,[7 1],39,-1,57,-1,39
1,<environment.Job instance at 0x7f0193411a50>,37,22,[7 5],38,-1,61,-1,39
1,<environment.Job instance at 0x7f0193411b90>,40,12,[8 1],41,-1,54,-1,42
1,<environment.Job instance at 0x7f0193411be0>,42,15,[5 7],43,-1,58,-1,43
1,<environment.Job instance at 0x7f0192d48410>,49,18,[4 5],50,-1,79,-1,61
1,<environment.Job instance at 0x7f0192d48460>,50,18,[6 2],51,-1,79,-1,61
1,<environment.Job instance at 0x7f0193411d70>,41,16,[ 1 11],42,-1,77,-1,61
1,<environment.Job instance at 0x7f0192d48500>,51,15,[4 5],52,-1,76,-1,61
1,<environment.Job instance at 0x7f0192d485a0>,52,15,[4 8],53,-1,78,-1,63
1,<environment.Job instance at 0x7f01934116e0>,33,13,[3 6],34,-1,79,-1,66
1,<environment.Job instance at 0x7f0192d486e0>,54,18,[ 3 10],55,-1,84,-1,66
1,<environment.Job instance at 0x7f0192d48640>,53,18,[12  1],54,-1,84,-1,66
1,<environment.Job instance at 0x7f0193411d20>,44,2,[5 2],45,-1,75,-1,73
1,<environment.Job instance at 0x7f0192d48a50>,57,18,[2 7],58,-1,91,-1,73
1,<environment.Job instance at 0x7f0192d1a050>,65,18,[10  1],66,-1,91,-1,73
1,<environment.Job instance at 0x7f0192d48820>,62,26,[8 2],63,-1,99,-1,73
1,<environment.Job instance at 0x7f0192d1a2d0>,66,27,[5 8],67,-1,100,-1,73
1,<environment.Job instance at 0x7f0192d1a640>,70,21,[5 7],71,-1,94,-1,73
1,<environment.Job instance at 0x7f0192d1abe0>,75,3,[1 5],76,-1,95,-1,92
1,<environment.Job instance at 0x7f0192bdff00>,79,12,[5 1],80,-1,104,-1,92
1,<environment.Job instance at 0x7f0192d1a460>,67,13,[8 1],68,-1,105,-1,92
1,<environment.Job instance at 0x7f01933eb370>,80,3,[ 3 12],81,-1,97,-1,94
1,<environment.Job instance at 0x7f01933eb140>,85,15,[3 7],86,-1,111,-1,96
1,<environment.Job instance at 0x7f01933eb050>,84,18,[5 8],85,-1,114,-1,96
1,<environment.Job instance at 0x7f0192cfedc0>,78,16,[2 8],79,-1,112,-1,96
1,<environment.Job instance at 0x7f01933eb0f0>,87,14,[ 4 10],88,-1,110,-1,96
1,<environment.Job instance at 0x7f01933ebc30>,86,17,[5 7],87,-1,113,-1,96
1,<environment.Job instance at 0x7f01933ebd20>,83,26,[7 3],84,-1,123,-1,97
1,<environment.Job instance at 0x7f019272c780>,92,13,[4 9],93,-1,110,-1,97
1,<environment.Job instance at 0x7f0192d351e0>,95,12,[5 5],96,-1,109,-1,97
1,<environment.Job instance at 0x7f0193319870>,96,12,[8 5],97,-1,109,-1,97
1,<environment.Job instance at 0x7f0192b1a5a0>,89,16,[3 7],90,-1,113,-1,97
1,<environment.Job instance at 0x7f01927cdc80>,97,24,[9 3],98,-1,122,-1,98
1,<environment.Job instance at 0x7f0192d35910>,93,13,[5 5],94,-1,112,-1,99
1,<environment.Job instance at 0x7f01927cdc30>,99,15,[10  1],100,-1,116,-1,101
1,<environment.Job instance at 0x7f01927cd280>,100,18,[8 5],101,-1,119,-1,101
1,<environment.Job instance at 0x7f0192795c80>,106,25,[10  1],107,-1,132,-1,107
1,<environment.Job instance at 0x7f01927ae280>,103,15,[3 5],104,-1,123,-1,108
1,<environment.Job instance at 0x7f0193810c80>,108,15,[7 3],109,-1,124,-1,109
1,<environment.Job instance at 0x7f0193810aa0>,112,14,[6 4],113,-1,128,-1,114
1,<environment.Job instance at 0x7f019273aaf0>,114,17,[9 3],115,-1,132,-1,115
1,<environment.Job instance at 0x7f019273a190>,115,20,[5 6],116,-1,136,-1,116
1,<environment.Job instance at 0x7f01938103c0>,113,27,[4 5],114,-1,155,-1,128
1,<environment.Job instance at 0x7f01938160a0>,119,14,[7 4],120,-1,144,-1,130
1,<environment.Job instance at 0x7f01938165a0>,121,17,[ 5 10],122,-1,148,-1,131
1,<environment.Job instance at 0x7f01938168c0>,123,14,[1 7],124,-1,145,-1,131
1,<environment.Job instance at 0x7f0193816b90>,125,12,[10  5],126,-1,143,-1,131
1,<environment.Job instance at 0x7f0193816960>,124,16,[ 2 11],125,-1,147,-1,131
1,<environment.Job instance at 0x7f01938100a0>,13,17,[13  3],14,-1,36,-1,19
1,<environment.Job instance at 0x7f0193e144b0>,17,13,[12  4],18,-1,34,-1,21
1,<environment.Job instance at 0x7f01b8196960>,27,18,[ 3 12],28,-1,76,-1,58
1,<environment.Job instance at 0x7f01932baf00>,41,16,[ 1 11],42,-1,111,-1,95
1,<environment.Job instance at 0x7f01930fc8c0>,53,18,[12  1],54,-1,168,-1,150
1,<environment.Job instance at 0x7f01926f5b90>,62,26,[8 2],63,-1,215,-1,189
1,<environment.Job instance at 0x7f019c5bde60>,66,27,[5 8],67,-1,220,-1,193
1,<environment.Job instance at 0x7f019379b4b0>,80,3,[ 3 12],81,-1,228,-1,225
1,<environment.Job instance at 0x7f019cb74730>,83,26,[7 3],84,-1,255,-1,229
1,<environment.Job instance at 0x7f0193f89640>,97,24,[9 3],98,-1,342,-1,318
1,<environment.Job instance at 0x7f0192f195a0>,104,1,[12  4],105,-1,332,-1,331
1,<environment.Job instance at 0x7f01938cea50>,106,25,[10  1],107,-1,370,-1,345
1,<environment.Job instance at 0x7f0193d2f910>,110,24,[ 4 13],111,-1,372,-1,348
1,<environment.Job instance at 0x7f019331bb90>,111,14,[12  1],112,-1,362,-1,348
1,<environment.Job instance at 0x7f0193243b90>,113,27,[4 5],114,-1,390,-1,363
1,<environment.Job instance at 0x7f019349c050>,124,16,[ 2 11],125,-1,426,-1,410
1,<environment.Job instance at 0x7f0193488640>,139,16,[13  5],140,-1,503,-1,487
1,<environment.Job instance at 0x7f0193477910>,147,1,[ 3 11],148,-1,526,-1,525
1,<environment.Job instance at 0x7f0193482eb0>,151,28,[7 5],152,-1,599,-1,571
1,<environment.Job instance at 0x7f0192c595a0>,177,1,[ 2 11],178,-1,673,-1,672
1,<environment.Job instance at 0x7f019376b960>,0,13,[9 1],1,-1,16,-1,3
1,<environment.Job instance at 0x7f0193b1d4b0>,3,17,[ 4 10],4,-1,21,-1,4
1,<environment.Job instance at 0x7f0193b1d820>,6,16,[ 1 10],7,-1,23,-1,7
1,<environment.Job instance at 0x7f0193b1d0f0>,7,18,[ 3 11],8,-1,27,-1,9
1,<environment.Job instance at 0x7f0193472c80>,10,18,[7 5],11,-1,29,-1,11
1,<environment.Job instance at 0x7f0193472870>,11,16,[5 5],12,-1,28,-1,12
1,<environment.Job instance at 0x7f01934728c0>,14,12,[ 5 10],15,-1,27,-1,15
1,<environment.Job instance at 0x7f0193472550>,15,19,[5 1],16,-1,35,-1,16
1,<environment.Job instance at 0x7f0193472a50>,16,24,[5 3],17,-1,41,-1,17
1,<environment.Job instance at 0x7f019265f780>,20,16,[1 7],21,-1,37,-1,21
1,<environment.Job instance at 0x7f019265f6e0>,21,18,[6 5],22,-1,40,-1,22
1,<environment.Job instance at 0x7f019265f730>,24,28,[10  4],25,-1,53,-1,25
1,<environment.Job instance at 0x7f019336e550>,26,17,[6 1],27,-1,47,-1,30
1,<environment.Job instance at 0x7f019336ecd0>,29,17,[8 3],30,-1,47,-1,30
1,<environment.Job instance at 0x7f01927dcfa0>,31,18,[ 5 10],32,-1,52,-1,34
1,<environment.Job instance at 0x7f0193079c30>,35,15,[10  1],36,-1,51,-1,36
1,<environment.Job instance at 0x7f0192da87d0>,42,25,[2 8],43,-1,68,-1,43
1,<environment.Job instance at 0x7f0192da86e0>,43,17,[ 1 10],44,-1,61,-1,44
1,<environment.Job instance at 0x7f0192da8fa0>,44,19,[3 6],45,-1,64,-1,45
1,<environment.Job instance at 0x7f0192da8870>,45,15,[6 2],46,-1,65,-1,50
1,<environment.Job instance at 0x7f0192da89b0>,50,15,[ 4 10],51,-1,66,-1,51
1,<environment.Job instance at 0x7f0192da8aa0>,51,13,[1 5],52,-1,66,-1,53
1,<environment.Job instance at 0x7f0192da8370>,47,13,[3 5],48,-1,66,-1,53
1,<environment.Job instance at 0x7f0192aabc30>,52,15,[7 5],53,-1,68,-1,53
1,<environment.Job instance at 0x7f0193a58500>,55,16,[9 5],56,-1,73,-1,57
1,<environment.Job instance at 0x7f0192da82d0>,48,12,[9 5],49,-1,77,-1,65
1,<environment.Job instance at 0x7f01931e2140>,64,12,[10  4],65,-1,77,-1,65
1,<environment.Job instance at 0x7f0193645fa0>,65,21,[ 2 10],66,-1,87,-1,66
1,<environment.Job instance at 0x7f0193645c80>,66,15,[8 4],67,-1,82,-1,67
1,<environment.Job instance at 0x7f0193645be0>,67,16,[2 5],68,-1,85,-1,69
1,<environment.Job instance at 0x7f0193645a00>,70,13,[7 3],71,-1,87,-1,74
1,<environment.Job instance at 0x7f01933e8d70>,80,24,[2 5],81,-1,107,-1,83
1,<environment.Job instance at 0x7f0192da8f00>,46,26,[ 1 12],47,-1,113,-1,87
1,<environment.Job instance at 0x7f01933e8320>,85,20,[5 4],86,-1,107,-1,87
1,<environment.Job instance at 0x7f01933e8cd0>,86,24,[ 1 10],87,-1,115,-1,91
1,<environment.Job instance at 0x7f01933e8280>,79,12,[6 4],80,-1,103,-1,91
1,<environment.Job instance at 0x7f0192f19b40>,91,17,[5 8],92,-1,109,-1,92
1,<environment.Job instance at 0x7f0193d95dc0>,93,25,[4 6],94,-1,119,-1,94
1,<environment.Job instance at 0x7f01935f65f0>,94,16,[ 5 10],95,-1,111,-1,95
1,<environment.Job instance at 0x7f01935f61e0>,96,13,[9 4],97,-1,110,-1,97
1,<environment.Job instance at 0x7f01935f6280>,97,22,[10  3],98,-1,120,-1,98
1,<environment.Job instance at 0x7f01935f6190>,98,21,[1 6],99,-1,120,-1,99
1,<environment.Job instance at 0x7f0192cb4f00>,100,17,[2 8],101,-1,118,-1,101
1,<environment.Job instance at 0x7f0193b22a50>,101,14,[ 5 10],102,-1,117,-1,103
1,<environment.Job instance at 0x7f0192d18370>,103,18,[ 5 12],104,-1,122,-1,104
1,<environment.Job instance at 0x7f0192f19960>,90,15,[3 9],91,-1,120,-1,105
1,<environment.Job instance at 0x7f0193e627d0>,104,16,[2 9],105,-1,122,-1,106
1,<environment.Job instance at 0x7f01934c8d20>,109,16,[14  3],110,-1,126,-1,110
1,<environment.Job instance at 0x7f019c8b0460>,114,16,[2 6],115,-1,131,-1,115
1,<environment.Job instance at 0x7f0193a9fb40>,111,16,[10  5],112,-1,138,-1,122
1,<environment.Job instance at 0x7f0193828500>,121,17,[9 1],122,-1,139,-1,122
1,<environment.Job instance at 0x7f019283ffa0>,110,15,[9 1],111,-1,138,-1,123
1,<environment.Job instance at 0x7f019371a4b0>,122,15,[1 7],123,-1,139,-1,124
1,<environment.Job instance at 0x7f0192cae910>,125,17,[6 3],126,-1,143,-1,126
1,<environment.Job instance at 0x7f0193ee9c30>,126,18,[5 9],127,-1,145,-1,127
1,<environment.Job instance at 0x7f01933e8410>,82,16,[4 9],83,-1,144,-1,128
1,<environment.Job instance at 0x7f0193ee9500>,127,19,[ 4 10],128,-1,147,-1,128
1,<environment.Job instance at 0x7f0192b86460>,129,12,[5 4],130,-1,142,-1,130
1,<environment.Job instance at 0x7f0192ff7c80>,130,14,[6 2],131,-1,145,-1,131
1,<environment.Job instance at 0x7f0193eae640>,132,16,[8 2],133,-1,149,-1,133
1,<environment.Job instance at 0x7f01935f7d20>,123,13,[10  5],124,-1,149,-1,136
1,<environment.Job instance at 0x7f01934b6230>,136,23,[ 4 10],137,-1,160,-1,137
1,<environment.Job instance at 0x7f01934b6f00>,137,13,[4 9],138,-1,154,-1,141
1,<environment.Job instance at 0x7f01933cb8c0>,143,15,[ 5 10],144,-1,160,-1,145
1,<environment.Job instance at 0x7f01938db0f0>,147,12,[10  3],148,-1,160,-1,148
1,<environment.Job instance at 0x7f0193b30230>,149,14,[ 5 10],150,-1,164,-1,150
1,<environment.Job instance at 0x7f01938e33c0>,150,18,[5 7],151,-1,169,-1,151
1,<environment.Job instance at 0x7f019c709fa0>,152,18,[6 5],153,-1,171,-1,153
1,<environment.Job instance at 0x7f019388d500>,154,16,[9 5],155,-1,171,-1,155
1,<environment.Job instance at 0x7f0192ab8230>,157,16,[6 3],158,-1,174,-1,158
1,<environment.Job instance at 0x7f01934b85f0>,166,17,[10  5],167,-1,184,-1,167
1,<environment.Job instance at 0x7f01933cbf50>,144,18,[8 1],145,-1,186,-1,168
1,<environment.Job instance at 0x7f01932a91e0>,167,12,[10  4],168,-1,182,-1,170
1,<environment.Job instance at 0x7f019304fdc0>,169,21,[7 5],170,-1,192,-1,171
1,<environment.Job instance at 0x7f01938c2cd0>,170,12,[4 7],171,-1,184,-1,172
1,<environment.Job instance at 0x7f0193b2b190>,174,18,[1 8],175,-1,193,-1,175
1,<environment.Job instance at 0x7f01926f5d20>,175,21,[6 2],176,-1,197,-1,176
1,<environment.Job instance at 0x7f01938c2780>,171,19,[14  4],172,-1,197,-1,178
1,<environment.Job instance at 0x7f01934724b0>,5,3,[ 4 12],6,-1,9,-1,6
1,<environment.Job instance at 0x7f0192b62eb0>,7,18,[ 3 11],8,-1,26,-1,8
1,<environment.Job instance at 0x7f01935f6fa0>,8,2,[14  5],9,-1,11,-1,9
1,<environment.Job instance at 0x7f019376b690>,16,24,[5 3],17,-1,52,-1,28
1,<environment.Job instance at 0x7f0193493690>,24,28,[10  4],25,-1,91,-1,63
1,<environment.Job instance at 0x7f0193493f00>,25,15,[ 4 12],26,-1,78,-1,63
1,<environment.Job instance at 0x7f0192f19aa0>,37,2,[ 5 12],38,-1,99,-1,97
1,<environment.Job instance at 0x7f01930c2500>,42,25,[2 8],43,-1,129,-1,104
1,<environment.Job instance at 0x7f0193d45500>,46,26,[ 1 12],47,-1,142,-1,116
1,<environment.Job instance at 0x7f0193225e10>,53,2,[11  4],54,-1,150,-1,148
1,<environment.Job instance at 0x7f0193225dc0>,57,2,[11  1],58,-1,165,-1,163
1,<environment.Job instance at 0x7f01938eb690>,69,2,[ 3 11],70,-1,204,-1,202
1,<environment.Job instance at 0x7f0193cd5690>,80,24,[2 5],81,-1,267,-1,243
1,<environment.Job instance at 0x7f0193a9f960>,86,24,[ 1 10],87,-1,273,-1,249
1,<environment.Job instance at 0x7f019265f690>,87,3,[13  1],88,-1,252,-1,249
1,<environment.Job instance at 0x7f019312a0a0>,93,25,[4 6],94,-1,289,-1,264
1,<environment.Job instance at 0x7f0192826be0>,103,18,[ 5 12],104,-1,318,-1,300
1,<environment.Job instance at 0x7f0193e625a0>,109,16,[14  3],110,-1,351,-1,335
1,<environment.Job instance at 0x7f0192aab9b0>,119,3,[14  2],120,-1,370,-1,367
1,<environment.Job instance at 0x7f019382b730>,136,23,[ 4 10],137,-1,463,-1,440
1,<environment.Job instance at 0x7f0193738050>,139,2,[13  2],140,-1,442,-1,440
1,<environment.Job instance at 0x7f019ca54be0>,153,24,[ 5 11],154,-1,513,-1,489
1,<environment.Job instance at 0x7f0192a5f550>,164,16,[12  5],165,-1,558,-1,542
1,<environment.Job instance at 0x7f0193c35820>,171,19,[14  4],172,-1,580,-1,561
1,<environment.Job instance at 0x7f01933cb320>,177,3,[ 5 11],178,-1,590,-1,587
1,<environment.Job instance at 0x7f01933cb0a0>,178,1,[11  4],179,-1,588,-1,587
1,<environment.Job instance at 0x7f019272f4b0>,2,17,[5 5],3,-1,20,-1,3
1,<environment.Job instance at 0x7f019272faf0>,4,15,[5 9],5,-1,20,-1,5
1,<environment.Job instance at 0x7f019272fc80>,6,17,[7 1],7,-1,25,-1,8
1,<environment.Job instance at 0x7f019272feb0>,8,1,[5 4],9,-1,10,-1,9
1,<environment.Job instance at 0x7f019272fd20>,7,16,[6 1],8,-1,25,-1,9
1,<environment.Job instance at 0x7f019272f8c0>,9,16,[9 2],10,-1,30,-1,14
1,<environment.Job instance at 0x7f0193b00eb0>,13,17,[2 7],14,-1,31,-1,14
1,<environment.Job instance at 0x7f0193b00e10>,16,17,[ 2 10],17,-1,34,-1,17
1,<environment.Job instance at 0x7f0193b00b90>,17,16,[3 9],18,-1,34,-1,18
1,<environment.Job instance at 0x7f0193b008c0>,21,13,[6 4],22,-1,35,-1,22
1,<environment.Job instance at 0x7f0193b003c0>,22,1,[2 7],23,-1,24,-1,23
1,<environment.Job instance at 0x7f0193b00a00>,23,18,[5 3],24,-1,42,-1,24
1,<environment.Job instance at 0x7f0193b00be0>,24,14,[7 5],25,-1,39,-1,25
1,<environment.Job instance at 0x7f0193b00550>,25,14,[5 5],26,-1,40,-1,26
1,<environment.Job instance at 0x7f0193b00f00>,26,22,[8 4],27,-1,49,-1,27
1,<environment.Job instance at 0x7f01926ed3c0>,27,20,[5 5],28,-1,48,-1,28
1,<environment.Job instance at 0x7f01926eddc0>,28,20,[6 2],29,-1,49,-1,29
1,<environment.Job instance at 0x7f01926edb40>,29,14,[ 2 10],30,-1,44,-1,30
1,<environment.Job instance at 0x7f0192a2cdc0>,39,13,[7 2],40,-1,53,-1,40
1,<environment.Job instance at 0x7f0192a2cb90>,41,12,[8 3],42,-1,54,-1,42
1,<environment.Job instance at 0x7f0192a2c0f0>,42,12,[10  2],43,-1,55,-1,43
1,<environment.Job instance at 0x7f0192a2c2d0>,43,13,[3 6],44,-1,57,-1,44
1,<environment.Job instance at 0x7f0192a2c5a0>,44,17,[5 1],45,-1,62,-1,45
1,<environment.Job instance at 0x7f0193d8aa00>,47,23,[2 9],48,-1,71,-1,48
1,<environment.Job instance at 0x7f0193d8a960>,49,16,[7 1],50,-1,67,-1,51
1,<environment.Job instance at 0x7f01932f3af0>,53,16,[8 1],54,-1,70,-1,54
1,<environment.Job instance at 0x7f01932f3640>,54,17,[5 5],55,-1,72,-1,55
1,<environment.Job instance at 0x7f01932f37d0>,56,15,[10  3],57,-1,72,-1,57
1,<environment.Job instance at 0x7f01932f3dc0>,57,15,[5 3],58,-1,73,-1,58
1,<environment.Job instance at 0x7f01932f3aa0>,59,18,[4 9],60,-1,78,-1,60
1,<environment.Job instance at 0x7f01932f3eb0>,62,13,[4 8],63,-1,76,-1,63
1,<environment.Job instance at 0x7f01935f1410>,69,12,[10  1],70,-1,82,-1,70
1,<environment.Job instance at 0x7f0192f24910>,70,13,[10  5],71,-1,84,-1,71
1,<environment.Job instance at 0x7f0192f24d20>,71,23,[10  2],72,-1,95,-1,72
1,<environment.Job instance at 0x7f0192b85d20>,73,17,[6 2],74,-1,91,-1,74
1,<environment.Job instance at 0x7f0192cae0a0>,74,18,[2 9],75,-1,93,-1,75
1,<environment.Job instance at 0x7f0192caeaa0>,75,17,[5 9],76,-1,93,-1,76
1,<environment.Job instance at 0x7f01933cbb40>,76,15,[3 6],77,-1,92,-1,77
1,<environment.Job instance at 0x7f0193313780>,78,18,[1 6],79,-1,97,-1,79
1,<environment.Job instance at 0x7f0192bfadc0>,79,15,[1 8],80,-1,95,-1,80
1,<environment.Job instance at 0x7f0192bfa370>,81,15,[4 5],82,-1,97,-1,82
1,<environment.Job instance at 0x7f0192bbc2d0>,82,15,[9 3],83,-1,98,-1,83
1,<environment.Job instance at 0x7f0192ac21e0>,84,17,[7 2],85,-1,102,-1,85
1,<environment.Job instance at 0x7f0192df3f00>,86,15,[9 5],87,-1,102,-1,87
1,<environment.Job instance at 0x7f0193d625f0>,87,17,[10  1],88,-1,105,-1,88
1,<environment.Job instance at 0x7f0193d62780>,88,16,[ 5 10],89,-1,105,-1,89
1,<environment.Job instance at 0x7f0193d62e60>,89,17,[3 7],90,-1,107,-1,90
1,<environment.Job instance at 0x7f01930994b0>,94,18,[8 4],95,-1,113,-1,95
1,<environment.Job instance at 0x7f019343b2d0>,50,15,[4 6],51,-1,113,-1,98
1,<environment.Job instance at 0x7f0193d59aa0>,98,3,[9 1],99,-1,103,-1,100
1,<environment.Job instance at 0x7f0193d59820>,99,1,[2 5],100,-1,101,-1,100
1,<environment.Job instance at 0x7f0193d595f0>,100,17,[ 5 11],101,-1,118,-1,101
1,<environment.Job instance at 0x7f0193d598c0>,102,1,[7 3],103,-1,104,-1,103
1,<environment.Job instance at 0x7f0193d59190>,103,1,[2 6],104,-1,105,-1,104
1,<environment.Job instance at 0x7f0193d59410>,105,13,[10  4],106,-1,128,-1,115
1,<environment.Job instance at 0x7f019c8ec2d0>,117,22,[8 1],118,-1,146,-1,124
1,<environment.Job instance at 0x7f019c8ec550>,119,14,[ 4 10],120,-1,138,-1,124
1,<environment.Job instance at 0x7f0193d59140>,109,17,[4 5],110,-1,143,-1,126
1,<environment.Job instance at 0x7f019c8ec730>,118,3,[8 1],119,-1,130,-1,127
1,<environment.Job instance at 0x7f01926b9f00>,122,17,[1 6],123,-1,144,-1,127
1,<environment.Job instance at 0x7f0193d59cd0>,111,21,[9 2],112,-1,148,-1,127
1,<environment.Job instance at 0x7f0193d8b5f0>,125,17,[10  3],126,-1,144,-1,127
1,<environment.Job instance at 0x7f0193d8b370>,126,16,[ 3 10],127,-1,143,-1,127
1,<environment.Job instance at 0x7f01930f02d0>,131,25,[12  4],132,-1,157,-1,132
1,<environment.Job instance at 0x7f01930f0d20>,132,18,[10  1],133,-1,160,-1,142
1,<environment.Job instance at 0x7f01930f0c80>,134,14,[1 5],135,-1,156,-1,142
1,<environment.Job instance at 0x7f01930f0fa0>,133,21,[1 5],134,-1,164,-1,143
1,<environment.Job instance at 0x7f01930f0be0>,136,17,[6 4],137,-1,160,-1,143
1,<environment.Job instance at 0x7f01930f09b0>,138,12,[7 1],139,-1,158,-1,146
1,<environment.Job instance at 0x7f019283f6e0>,121,16,[5 5],122,-1,166,-1,150
1,<environment.Job instance at 0x7f01926b9c80>,124,1,[5 5],125,-1,152,-1,151
1,<environment.Job instance at 0x7f01930f0cd0>,141,15,[3 7],142,-1,167,-1,152
1,<environment.Job instance at 0x7f019334c9b0>,144,16,[8 1],145,-1,172,-1,156
1,<environment.Job instance at 0x7f019334cf50>,146,17,[5 4],147,-1,174,-1,157
1,<environment.Job instance at 0x7f019334ca00>,147,14,[5 5],148,-1,171,-1,157
1,<environment.Job instance at 0x7f019334c0a0>,148,15,[1 7],149,-1,172,-1,157
1,<environment.Job instance at 0x7f019334c460>,149,16,[4 5],150,-1,173,-1,157
1,<environment.Job instance at 0x7f019334c2d0>,158,16,[ 4 12],159,-1,190,-1,174
1,<environment.Job instance at 0x7f01930f0410>,142,16,[8 3],143,-1,191,-1,175
1,<environment.Job instance at 0x7f01930f0f00>,143,2,[1 9],144,-1,177,-1,175
1,<environment.Job instance at 0x7f019334c910>,161,18,[7 5],162,-1,193,-1,175
1,<environment.Job instance at 0x7f019334cb90>,162,3,[12  2],163,-1,180,-1,177
1,<environment.Job instance at 0x7f019334c0f0>,159,18,[7 1],160,-1,200,-1,182
1,<environment.Job instance at 0x7f019334c550>,163,18,[13  1],164,-1,200,-1,182
1,<environment.Job instance at 0x7f0192bac690>,167,18,[9 5],168,-1,206,-1,188
1,<environment.Job instance at 0x7f0192bac9b0>,166,17,[6 5],167,-1,205,-1,188
1,<environment.Job instance at 0x7f0192df4af0>,168,13,[10  3],169,-1,201,-1,188
1,<environment.Job instance at 0x7f019c8ec140>,116,12,[8 4],117,-1,200,-1,188
1,<environment.Job instance at 0x7f0192849690>,171,14,[5 2],172,-1,202,-1,188
1,<environment.Job instance at 0x7f0192849a00>,173,13,[3 9],174,-1,201,-1,188
1,<environment.Job instance at 0x7f019371ab40>,174,17,[9 4],175,-1,206,-1,189
1,<environment.Job instance at 0x7f019371abe0>,176,23,[ 4 10],177,-1,212,-1,189
1,<environment.Job instance at 0x7f019371a9b0>,177,15,[10  1],178,-1,204,-1,189
1,<environment.Job instance at 0x7f019272faa0>,30,17,[11  3],31,-1,97,-1,80
1,<environment.Job instance at 0x7f0192f65a00>,35,1,[ 5 14],36,-1,107,-1,106
1,<environment.Job instance at 0x7f0193f48550>,47,23,[2 9],48,-1,163,-1,140
1,<environment.Job instance at 0x7f0193f48d20>,48,2,[ 1 11],49,-1,142,-1,140
1,<environment.Job instance at 0x7f01936ef5a0>,71,23,[10  2],72,-1,254,-1,231
1,<environment.Job instance at 0x7f0193d8ff50>,91,26,[14  5],92,-1,351,-1,325
1,<environment.Job instance at 0x7f0192f192d0>,100,17,[ 5 11],101,-1,370,-1,353
1,<environment.Job instance at 0x7f0193700be0>,114,3,[13  3],115,-1,397,-1,394
1,<environment.Job instance at 0x7f01927509b0>,131,25,[12  4],132,-1,480,-1,455
1,<environment.Job instance at 0x7f01938e6960>,158,16,[ 4 12],159,-1,594,-1,578
1,<environment.Job instance at 0x7f01928bfcd0>,162,3,[12  2],163,-1,583,-1,580
1,<environment.Job instance at 0x7f01928bf9b0>,163,18,[13  1],164,-1,598,-1,580
1,<environment.Job instance at 0x7f0193adad70>,176,23,[ 4 10],177,-1,675,-1,652
1,<environment.Job instance at 0x7f0192c59b40>,1,28,[9 4],2,-1,30,-1,2
1,<environment.Job instance at 0x7f01932e8690>,8,12,[9 2],9,-1,21,-1,9
1,<environment.Job instance at 0x7f01932e8550>,9,17,[10  5],10,-1,27,-1,10
1,<environment.Job instance at 0x7f01933cb4b0>,6,16,[7 3],7,-1,27,-1,11
1,<environment.Job instance at 0x7f01932eae60>,14,25,[1 6],15,-1,40,-1,15
1,<environment.Job instance at 0x7f01932e8370>,18,17,[6 1],19,-1,36,-1,19
1,<environment.Job instance at 0x7f01932eaaf0>,21,18,[9 3],22,-1,40,-1,22
1,<environment.Job instance at 0x7f01932e43c0>,25,16,[3 7],26,-1,42,-1,26
1,<environment.Job instance at 0x7f0192df1a00>,31,14,[8 4],32,-1,48,-1,34
1,<environment.Job instance at 0x7f01932e4640>,34,16,[5 5],35,-1,53,-1,37
1,<environment.Job instance at 0x7f0192cb0870>,35,27,[1 5],36,-1,65,-1,38
1,<environment.Job instance at 0x7f0192cc4960>,37,17,[6 2],38,-1,57,-1,40
1,<environment.Job instance at 0x7f01933be0a0>,29,16,[4 7],30,-1,56,-1,40
1,<environment.Job instance at 0x7f0192cc4be0>,39,14,[4 8],40,-1,59,-1,45
1,<environment.Job instance at 0x7f0192ccb690>,43,14,[11  5],44,-1,59,-1,45
1,<environment.Job instance at 0x7f0192ccb640>,44,17,[3 7],45,-1,64,-1,47
1,<environment.Job instance at 0x7f0192ccb2d0>,45,14,[4 9],46,-1,65,-1,51
1,<environment.Job instance at 0x7f0192cd27d0>,51,19,[5 8],52,-1,71,-1,52
1,<environment.Job instance at 0x7f0192cd25a0>,52,13,[4 6],53,-1,66,-1,53
1,<environment.Job instance at 0x7f0192dfc6e0>,54,14,[ 1 10],55,-1,71,-1,57
1,<environment.Job instance at 0x7f0193398870>,57,18,[1 6],58,-1,76,-1,58
1,<environment.Job instance at 0x7f0192c98550>,58,16,[6 3],59,-1,75,-1,59
1,<environment.Job instance at 0x7f0192c98190>,59,15,[6 3],60,-1,75,-1,60
1,<environment.Job instance at 0x7f0192c98910>,60,15,[7 1],61,-1,76,-1,61
1,<environment.Job instance at 0x7f0192c987d0>,61,13,[5 5],62,-1,75,-1,62
1,<environment.Job instance at 0x7f0192c98870>,62,16,[8 5],63,-1,79,-1,63
1,<environment.Job instance at 0x7f0192c98780>,63,21,[4 8],64,-1,85,-1,64
1,<environment.Job instance at 0x7f0192c98690>,66,13,[5 4],67,-1,80,-1,67
1,<environment.Job instance at 0x7f0192c98820>,68,17,[ 1 10],69,-1,86,-1,69
1,<environment.Job instance at 0x7f0192c98e60>,72,12,[7 5],73,-1,85,-1,73
1,<environment.Job instance at 0x7f0192de2e10>,49,15,[9 4],50,-1,88,-1,73
1,<environment.Job instance at 0x7f0192c98d70>,74,16,[ 2 11],75,-1,92,-1,76
1,<environment.Job instance at 0x7f019330f190>,32,24,[3 5],33,-1,100,-1,76
1,<environment.Job instance at 0x7f0192ca52d0>,76,2,[11  2],77,-1,79,-1,77
1,<environment.Job instance at 0x7f0192ca53c0>,77,15,[4 6],78,-1,93,-1,78
1,<environment.Job instance at 0x7f0192ca5690>,80,15,[6 2],81,-1,96,-1,81
1,<environment.Job instance at 0x7f0192ca57d0>,81,15,[8 2],82,-1,97,-1,82
1,<environment.Job instance at 0x7f0192ca5a00>,84,14,[9 4],85,-1,99,-1,85
1,<environment.Job instance at 0x7f0192ca5aa0>,86,15,[13  1],87,-1,102,-1,87
1,<environment.Job instance at 0x7f0192cb80f0>,91,17,[ 3 10],92,-1,109,-1,92
1,<environment.Job instance at 0x7f0192cb8460>,96,14,[8 1],97,-1,111,-1,97
1,<environment.Job instance at 0x7f0192cb86e0>,98,1,[3 6],99,-1,100,-1,99
1,<environment.Job instance at 0x7f0192cb8910>,100,22,[5 2],101,-1,123,-1,101
1,<environment.Job instance at 0x7f0192ca5e60>,90,13,[1 6],91,-1,114,-1,101
1,<environment.Job instance at 0x7f0192cb8e10>,103,2,[ 4 10],104,-1,106,-1,104
1,<environment.Job instance at 0x7f0192cbf370>,110,28,[6 4],111,-1,142,-1,114
1,<environment.Job instance at 0x7f0192cbf820>,115,26,[9 2],116,-1,142,-1,116
1,<environment.Job instance at 0x7f0192cb8dc0>,105,19,[9 4],106,-1,137,-1,118
1,<environment.Job instance at 0x7f0192cbfaa0>,116,17,[3 7],117,-1,135,-1,118
1,<environment.Job instance at 0x7f0192cbfa00>,118,15,[10  2],119,-1,134,-1,119
1,<environment.Job instance at 0x7f0192cbf640>,111,3,[11  1],112,-1,124,-1,121
1,<environment.Job instance at 0x7f0192cbfcd0>,120,16,[8 1],121,-1,138,-1,122
1,<environment.Job instance at 0x7f0192cbfd20>,122,14,[8 4],123,-1,137,-1,123
1,<environment.Job instance at 0x7f0192cbd320>,127,16,[1 9],128,-1,147,-1,131
1,<environment.Job instance at 0x7f0192cbfe60>,121,23,[4 5],122,-1,154,-1,131
1,<environment.Job instance at 0x7f0192cbd500>,129,18,[4 8],130,-1,149,-1,131
1,<environment.Job instance at 0x7f0192cbdbe0>,134,21,[10  4],135,-1,157,-1,136
1,<environment.Job instance at 0x7f0192cca0a0>,139,14,[3 7],140,-1,155,-1,141
1,<environment.Job instance at 0x7f0192cca870>,143,15,[ 2 10],144,-1,163,-1,148
1,<environment.Job instance at 0x7f0192caab90>,153,16,[4 7],154,-1,177,-1,161
1,<environment.Job instance at 0x7f0192cbdd70>,135,17,[2 6],136,-1,180,-1,163
1,<environment.Job instance at 0x7f0192c99730>,154,12,[ 2 10],155,-1,175,-1,163
1,<environment.Job instance at 0x7f0192ccbf00>,158,17,[5 4],159,-1,180,-1,163
1,<environment.Job instance at 0x7f0192ccbd20>,159,14,[10  3],160,-1,177,-1,163
1,<environment.Job instance at 0x7f0192ccbfa0>,160,13,[8 2],161,-1,176,-1,163
1,<environment.Job instance at 0x7f0192de7640>,161,14,[ 4 14],162,-1,177,-1,163
1,<environment.Job instance at 0x7f0192de2550>,162,3,[10  4],163,-1,166,-1,163
1,<environment.Job instance at 0x7f0192cd2640>,163,16,[6 3],164,-1,180,-1,164
1,<environment.Job instance at 0x7f0192cd2d70>,164,12,[3 8],165,-1,177,-1,165
1,<environment.Job instance at 0x7f01931d2280>,165,13,[5 5],166,-1,179,-1,166
1,<environment.Job instance at 0x7f01932e8d20>,1,28,[9 4],2,-1,30,-1,2
1,<environment.Job instance at 0x7f01932ea5f0>,2,25,[12  5],3,-1,28,-1,3
1,<environment.Job instance at 0x7f0192c981e0>,14,25,[1 6],15,-1,50,-1,25
1,<environment.Job instance at 0x7f0192ccac80>,32,24,[3 5],33,-1,101,-1,77
1,<environment.Job instance at 0x7f0192cc4730>,35,27,[1 5],36,-1,107,-1,80
1,<environment.Job instance at 0x7f0192dc9140>,43,14,[11  5],44,-1,123,-1,109
1,<environment.Job instance at 0x7f01927503c0>,74,16,[ 2 11],75,-1,234,-1,218
1,<environment.Job instance at 0x7f019382b1e0>,76,2,[11  2],77,-1,228,-1,226
1,<environment.Job instance at 0x7f0192c64690>,86,15,[13  1],87,-1,266,-1,251
1,<environment.Job instance at 0x7f01934735a0>,102,1,[11  5],103,-1,289,-1,288
1,<environment.Job instance at 0x7f019cb8e3c0>,110,28,[6 4],111,-1,337,-1,309
1,<environment.Job instance at 0x7f019ca272d0>,111,3,[11  1],112,-1,312,-1,309
1,<environment.Job instance at 0x7f0193d8f960>,112,2,[11  5],113,-1,311,-1,309
1,<environment.Job instance at 0x7f0193d38d70>,115,26,[9 2],116,-1,338,-1,312
1,<environment.Job instance at 0x7f01928a5780>,121,23,[4 5],122,-1,364,-1,341
1,<environment.Job instance at 0x7f019ca046e0>,125,3,[ 3 11],126,-1,348,-1,345
1,<environment.Job instance at 0x7f019281e0a0>,126,17,[14  5],127,-1,362,-1,345
1,<environment.Job instance at 0x7f01927ea550>,138,26,[1 5],139,-1,419,-1,393
1,<environment.Job instance at 0x7f019c5474b0>,142,2,[ 4 13],143,-1,402,-1,400
1,<environment.Job instance at 0x7f01939ffd20>,149,16,[ 1 14],150,-1,431,-1,415
1,<environment.Job instance at 0x7f0192a5fcd0>,161,14,[ 4 14],162,-1,475,-1,461
1,<environment.Job instance at 0x7f0193c352d0>,169,15,[ 5 13],170,-1,502,-1,487
1,<environment.Job instance at 0x7f019272faa0>,170,3,[13  2],171,-1,490,-1,487
1,<environment.Job instance at 0x7f01937b1f50>,8,15,[6 4],9,-1,27,-1,12
1,<environment.Job instance at 0x7f01932a3370>,14,16,[6 1],15,-1,31,-1,15
1,<environment.Job instance at 0x7f01932a3230>,15,16,[10  3],16,-1,32,-1,16
1,<environment.Job instance at 0x7f01932a3910>,16,15,[7 3],17,-1,33,-1,18
1,<environment.Job instance at 0x7f0193482b40>,18,17,[5 7],19,-1,36,-1,19
1,<environment.Job instance at 0x7f019c795280>,17,21,[1 8],18,-1,40,-1,19
1,<environment.Job instance at 0x7f019cb220f0>,19,15,[8 1],20,-1,36,-1,21
1,<environment.Job instance at 0x7f0193482140>,20,14,[10  4],21,-1,36,-1,22
1,<environment.Job instance at 0x7f0193995280>,23,25,[6 2],24,-1,49,-1,24
1,<environment.Job instance at 0x7f0192d4b1e0>,24,15,[10  3],25,-1,42,-1,27
1,<environment.Job instance at 0x7f0192b72be0>,26,20,[ 5 11],27,-1,47,-1,27
1,<environment.Job instance at 0x7f0192b72190>,28,15,[10  5],29,-1,48,-1,33
1,<environment.Job instance at 0x7f0193558640>,33,17,[8 4],34,-1,54,-1,37
1,<environment.Job instance at 0x7f0192b72910>,29,13,[10  1],30,-1,50,-1,37
1,<environment.Job instance at 0x7f0193558b90>,36,15,[8 3],37,-1,52,-1,37
1,<environment.Job instance at 0x7f01935588c0>,38,18,[5 3],39,-1,57,-1,39
1,<environment.Job instance at 0x7f01935580a0>,39,16,[5 4],40,-1,56,-1,40
1,<environment.Job instance at 0x7f0193a925a0>,43,17,[10  5],44,-1,61,-1,44
1,<environment.Job instance at 0x7f0193558b40>,1,18,[12  2],2,-1,20,-1,2
1,<environment.Job instance at 0x7f01937b1eb0>,2,2,[ 2 13],3,-1,5,-1,3
1,<environment.Job instance at 0x7f0193558e60>,3,13,[ 1 11],4,-1,17,-1,4
1,<environment.Job instance at 0x7f01930f0b90>,11,24,[10  2],12,-1,90,-1,66
1,<environment.Job instance at 0x7f0193d1c140>,23,25,[6 2],24,-1,91,-1,66
1,<environment.Job instance at 0x7f019c78d7d0>,26,20,[ 5 11],27,-1,88,-1,68
1,<environment.Job instance at 0x7f01936e9410>,41,18,[14  2],42,-1,163,-1,145
1,<environment.Job instance at 0x7f01935612d0>,45,17,[13  3],46,-1,166,-1,149
1,<environment.Job instance at 0x7f0193900fa0>,50,2,[13  1],51,-1,168,-1,166
1,<environment.Job instance at 0x7f0192c22820>,55,1,[11  2],56,-1,184,-1,183
1,<environment.Job instance at 0x7f0192a9a1e0>,56,28,[5 5],57,-1,213,-1,185
1,<environment.Job instance at 0x7f0193de0d70>,60,24,[8 2],61,-1,223,-1,199
1,<environment.Job instance at 0x7f0192666aa0>,72,3,[ 3 14],73,-1,259,-1,256
1,<environment.Job instance at 0x7f01932a3730>,80,25,[ 5 10],81,-1,321,-1,296
1,<environment.Job instance at 0x7f019335d190>,87,12,[ 3 12],88,-1,328,-1,316
1,<environment.Job instance at 0x7f019c545e60>,88,3,[11  2],89,-1,319,-1,316
1,<environment.Job instance at 0x7f019c545690>,89,26,[14  4],90,-1,342,-1,316
1,<environment.Job instance at 0x7f01928bf1e0>,91,24,[10  4],92,-1,342,-1,318
1,<environment.Job instance at 0x7f01928bfc80>,93,2,[ 3 14],94,-1,320,-1,318
1,<environment.Job instance at 0x7f0192b93eb0>,106,25,[8 2],107,-1,446,-1,421
1,<environment.Job instance at 0x7f019297cfa0>,110,13,[ 3 13],111,-1,441,-1,428
1,<environment.Job instance at 0x7f0192b6a050>,112,17,[12  2],113,-1,456,-1,439
1,<environment.Job instance at 0x7f01930324b0>,126,15,[ 5 13],127,-1,531,-1,516
1,<environment.Job instance at 0x7f0193a92640>,130,1,[ 3 11],131,-1,523,-1,522
1,<environment.Job instance at 0x7f0192f1ac80>,136,3,[ 2 13],137,-1,546,-1,543
1,<environment.Job instance at 0x7f0193ef41e0>,139,18,[14  4],140,-1,579,-1,561
1,<environment.Job instance at 0x7f0193ef4410>,142,2,[13  5],143,-1,575,-1,573
1,<environment.Job instance at 0x7f019c6da8c0>,143,17,[11  2],144,-1,590,-1,573
1,<environment.Job instance at 0x7f019c4ef050>,146,18,[14  1],147,-1,595,-1,577
1,<environment.Job instance at 0x7f019cb23f00>,149,2,[12  1],150,-1,582,-1,580
1,<environment.Job instance at 0x7f019cb23960>,150,13,[ 1 11],151,-1,593,-1,580
1,<environment.Job instance at 0x7f019cb237d0>,152,13,[13  2],153,-1,594,-1,581
1,<environment.Job instance at 0x7f0192deba50>,158,2,[ 1 11],159,-1,608,-1,606
1,<environment.Job instance at 0x7f0192debaf0>,159,2,[12  3],160,-1,608,-1,606
1,<environment.Job instance at 0x7f01935afb40>,161,3,[ 1 14],162,-1,610,-1,607
1,<environment.Job instance at 0x7f0193ffaf50>,169,16,[ 5 11],170,-1,667,-1,651
1,<environment.Job instance at 0x7f0193ffa500>,168,25,[ 5 10],169,-1,677,-1,652
1,<environment.Job instance at 0x7f0192d8d370>,0,19,[8 1],1,-1,23,-1,4
1,<environment.Job instance at 0x7f0192d8dc80>,4,3,[8 5],5,-1,8,-1,5
1,<environment.Job instance at 0x7f0192d8d550>,3,14,[10  5],4,-1,19,-1,5
1,<environment.Job instance at 0x7f0192d8d2d0>,7,18,[9 5],8,-1,26,-1,8
1,<environment.Job instance at 0x7f01934b4aa0>,10,16,[9 2],11,-1,30,-1,14
1,<environment.Job instance at 0x7f01934b4af0>,13,18,[6 2],14,-1,32,-1,14
1,<environment.Job instance at 0x7f01934b4870>,17,14,[ 4 10],18,-1,32,-1,18
1,<environment.Job instance at 0x7f01934b4a00>,19,18,[8 4],20,-1,38,-1,20
1,<environment.Job instance at 0x7f01934b4550>,18,3,[ 1 10],19,-1,23,-1,20
1,<environment.Job instance at 0x7f0192ab10f0>,22,16,[1 6],23,-1,39,-1,23
1,<environment.Job instance at 0x7f0192ab1140>,28,17,[1 7],29,-1,46,-1,29
1,<environment.Job instance at 0x7f0192ab1dc0>,21,21,[2 6],22,-1,50,-1,29
1,<environment.Job instance at 0x7f0193568780>,34,1,[2 9],35,-1,36,-1,35
1,<environment.Job instance at 0x7f01932a1690>,40,16,[2 5],41,-1,57,-1,41
1,<environment.Job instance at 0x7f01926f52d0>,48,12,[7 4],49,-1,61,-1,49
1,<environment.Job instance at 0x7f01932a11e0>,44,17,[6 2],45,-1,67,-1,50
1,<environment.Job instance at 0x7f01938ea870>,49,12,[7 5],50,-1,63,-1,51
1,<environment.Job instance at 0x7f01938ead20>,51,16,[1 7],52,-1,68,-1,52
1,<environment.Job instance at 0x7f0193bb2870>,52,25,[1 9],53,-1,87,-1,62
1,<environment.Job instance at 0x7f0193b4ff00>,53,18,[6 3],54,-1,80,-1,62
1,<environment.Job instance at 0x7f01938eaa00>,54,3,[5 6],55,-1,65,-1,62
1,<environment.Job instance at 0x7f0193ac4190>,55,18,[6 5],56,-1,80,-1,62
1,<environment.Job instance at 0x7f0193b3f5f0>,60,24,[5 4],61,-1,86,-1,62
1,<environment.Job instance at 0x7f0192d18500>,45,12,[10  3],46,-1,74,-1,62
1,<environment.Job instance at 0x7f0192d18320>,46,26,[7 5],47,-1,90,-1,64
1,<environment.Job instance at 0x7f019c791050>,61,13,[3 7],62,-1,77,-1,64
1,<environment.Job instance at 0x7f019398f4b0>,66,17,[10  4],67,-1,84,-1,67
1,<environment.Job instance at 0x7f0193ac8190>,67,16,[10  2],68,-1,84,-1,68
1,<environment.Job instance at 0x7f0192a96690>,68,18,[10  5],69,-1,87,-1,69
1,<environment.Job instance at 0x7f0194000a00>,72,17,[7 5],73,-1,91,-1,74
1,<environment.Job instance at 0x7f0194000eb0>,75,16,[9 5],76,-1,99,-1,83
1,<environment.Job instance at 0x7f019328a960>,78,27,[9 1],79,-1,118,-1,91
1,<environment.Job instance at 0x7f0194000e10>,76,17,[7 5],77,-1,108,-1,91
1,<environment.Job instance at 0x7f019c55e5a0>,63,28,[1 9],64,-1,119,-1,91
1,<environment.Job instance at 0x7f01940001e0>,77,16,[2 8],78,-1,107,-1,91
1,<environment.Job instance at 0x7f01935c7640>,93,16,[8 3],94,-1,111,-1,95
1,<environment.Job instance at 0x7f0192978cd0>,86,14,[5 5],87,-1,109,-1,95
1,<environment.Job instance at 0x7f019c5453c0>,97,28,[9 2],98,-1,128,-1,100
1,<environment.Job instance at 0x7f019c545730>,95,21,[1 5],96,-1,121,-1,100
1,<environment.Job instance at 0x7f0193d98140>,101,17,[2 7],102,-1,120,-1,103
1,<environment.Job instance at 0x7f0193d987d0>,102,12,[9 4],103,-1,117,-1,105
1,<environment.Job instance at 0x7f0193d98870>,104,15,[9 3],105,-1,125,-1,110
1,<environment.Job instance at 0x7f0192a9a9b0>,103,16,[ 1 13],104,-1,126,-1,110
1,<environment.Job instance at 0x7f0192a9a640>,105,28,[5 2],106,-1,138,-1,110
1,<environment.Job instance at 0x7f0192a9a4b0>,107,16,[2 8],108,-1,126,-1,110
1,<environment.Job instance at 0x7f0192a9a780>,108,14,[5 4],109,-1,124,-1,110
1,<environment.Job instance at 0x7f0193547aa0>,111,18,[8 2],112,-1,130,-1,112
1,<environment.Job instance at 0x7f019262fc30>,112,18,[5 9],113,-1,131,-1,113
1,<environment.Job instance at 0x7f0193997f00>,116,15,[7 5],117,-1,132,-1,117
1,<environment.Job instance at 0x7f019262fd70>,113,15,[ 4 10],114,-1,133,-1,118
1,<environment.Job instance at 0x7f0193833d20>,117,20,[5 5],118,-1,139,-1,119
1,<environment.Job instance at 0x7f019354bf50>,120,27,[5 7],121,-1,155,-1,128
1,<environment.Job instance at 0x7f0192d5d960>,121,15,[8 3],122,-1,144,-1,129
1,<environment.Job instance at 0x7f0193b2b960>,123,23,[9 1],124,-1,152,-1,129
1,<environment.Job instance at 0x7f019275a5f0>,119,12,[10  4],120,-1,141,-1,129
1,<environment.Job instance at 0x7f019322f1e0>,126,26,[ 2 10],127,-1,156,-1,130
1,<environment.Job instance at 0x7f0192dc9dc0>,127,17,[9 5],128,-1,148,-1,131
1,<environment.Job instance at 0x7f01927ac7d0>,130,1,[10  5],131,-1,132,-1,131
1,<environment.Job instance at 0x7f0193b94870>,131,14,[1 6],132,-1,147,-1,133
1,<environment.Job instance at 0x7f0192978f00>,88,15,[8 3],89,-1,153,-1,138
1,<environment.Job instance at 0x7f0193deaa50>,135,15,[14  1],136,-1,156,-1,141
1,<environment.Job instance at 0x7f019328a780>,79,16,[1 7],80,-1,159,-1,143
1,<environment.Job instance at 0x7f019353aa00>,137,3,[13  4],138,-1,147,-1,144
1,<environment.Job instance at 0x7f0192a3ff00>,138,17,[4 8],139,-1,161,-1,144
1,<environment.Job instance at 0x7f019353afa0>,136,20,[8 3],137,-1,164,-1,144
1,<environment.Job instance at 0x7f0192a3ff50>,140,25,[ 1 12],141,-1,169,-1,144
1,<environment.Job instance at 0x7f0192983050>,133,16,[10  1],134,-1,160,-1,144
1,<environment.Job instance at 0x7f01932ada00>,134,12,[8 3],135,-1,159,-1,147
1,<environment.Job instance at 0x7f019353d5a0>,149,18,[3 9],150,-1,168,-1,150
1,<environment.Job instance at 0x7f019353d280>,150,18,[6 2],151,-1,170,-1,152
1,<environment.Job instance at 0x7f019353d780>,152,17,[2 6],153,-1,170,-1,153
1,<environment.Job instance at 0x7f0192afa9b0>,154,16,[5 4],155,-1,171,-1,155
1,<environment.Job instance at 0x7f0193353b90>,155,13,[8 1],156,-1,172,-1,159
1,<environment.Job instance at 0x7f0192ad13c0>,158,15,[7 4],159,-1,175,-1,160
1,<environment.Job instance at 0x7f0192ad17d0>,159,14,[3 7],160,-1,174,-1,160
1,<environment.Job instance at 0x7f019353d410>,148,13,[ 2 11],149,-1,174,-1,161
1,<environment.Job instance at 0x7f0192ad1aa0>,162,14,[5 9],163,-1,178,-1,164
1,<environment.Job instance at 0x7f019c78d730>,163,15,[10  3],164,-1,179,-1,164
1,<environment.Job instance at 0x7f0192a3f370>,139,13,[2 7],140,-1,179,-1,166
1,<environment.Job instance at 0x7f019c78dd20>,165,17,[10  3],166,-1,183,-1,166
1,<environment.Job instance at 0x7f019c78d3c0>,167,15,[10  1],168,-1,184,-1,169
1,<environment.Job instance at 0x7f0193f9d8c0>,169,16,[7 4],170,-1,186,-1,170
1,<environment.Job instance at 0x7f0193f9d870>,168,17,[1 8],169,-1,191,-1,174
1,<environment.Job instance at 0x7f0193f9d0a0>,174,18,[4 9],175,-1,195,-1,177
1,<environment.Job instance at 0x7f01932a3cd0>,14,25,[9 4],15,-1,49,-1,24
1,<environment.Job instance at 0x7f019c78d690>,31,1,[ 4 13],32,-1,66,-1,65
1,<environment.Job instance at 0x7f01934e6c80>,46,26,[7 5],47,-1,131,-1,105
1,<environment.Job instance at 0x7f0193ed4230>,52,25,[1 9],53,-1,161,-1,136
1,<environment.Job instance at 0x7f01937c1c80>,60,24,[5 4],61,-1,181,-1,157
1,<environment.Job instance at 0x7f01927da9b0>,63,28,[1 9],64,-1,213,-1,185
1,<environment.Job instance at 0x7f0193caa730>,78,27,[9 1],79,-1,285,-1,258
1,<environment.Job instance at 0x7f0192a2c280>,97,28,[9 2],98,-1,329,-1,301
1,<environment.Job instance at 0x7f0193ece780>,99,3,[13  5],100,-1,304,-1,301
1,<environment.Job instance at 0x7f01938ab190>,103,16,[ 1 13],104,-1,333,-1,317
1,<environment.Job instance at 0x7f019368d9b0>,105,28,[5 2],106,-1,357,-1,329
1,<environment.Job instance at 0x7f0193419be0>,120,27,[5 7],121,-1,427,-1,400
1,<environment.Job instance at 0x7f01937ab140>,123,23,[9 1],124,-1,438,-1,415
1,<environment.Job instance at 0x7f0192bafd20>,126,26,[ 2 10],127,-1,448,-1,422
1,<environment.Job instance at 0x7f019c54cf50>,135,15,[14  1],136,-1,447,-1,432
1,<environment.Job instance at 0x7f019c54cc80>,137,3,[13  4],138,-1,447,-1,444
1,<environment.Job instance at 0x7f01932be2d0>,140,25,[ 1 12],141,-1,471,-1,446
1,<environment.Job instance at 0x7f01934c6820>,148,13,[ 2 11],149,-1,489,-1,476
1,<environment.Job instance at 0x7f0192f89550>,153,3,[ 5 13],154,-1,510,-1,507
1,<environment.Job instance at 0x7f0192e46500>,173,18,[ 2 12],174,-1,608,-1,590
1,<environment.Job instance at 0x7f019330fd70>,1,17,[8 2],2,-1,20,-1,3
1,<environment.Job instance at 0x7f0193411aa0>,3,15,[ 1 10],4,-1,21,-1,6
1,<environment.Job instance at 0x7f0193f7bf50>,6,18,[5 5],7,-1,25,-1,7
1,<environment.Job instance at 0x7f0193b474b0>,9,18,[9 3],10,-1,28,-1,10
1,<environment.Job instance at 0x7f0193b51780>,10,13,[9 5],11,-1,24,-1,11
1,<environment.Job instance at 0x7f019275d230>,13,18,[9 4],14,-1,32,-1,14
1,<environment.Job instance at 0x7f019330f0a0>,5,14,[3 9],6,-1,29,-1,15
1,<environment.Job instance at 0x7f0192c246e0>,16,17,[4 8],17,-1,34,-1,17
1,<environment.Job instance at 0x7f019275db40>,17,20,[7 1],18,-1,39,-1,19
1,<environment.Job instance at 0x7f0192dd87d0>,19,17,[8 1],20,-1,37,-1,20
1,<environment.Job instance at 0x7f0192dd8820>,20,12,[9 5],21,-1,33,-1,21
1,<environment.Job instance at 0x7f0193402a50>,22,13,[1 9],23,-1,36,-1,23
1,<environment.Job instance at 0x7f01927df640>,23,16,[9 2],24,-1,40,-1,24
1,<environment.Job instance at 0x7f0192a8f780>,24,13,[5 9],25,-1,38,-1,25
1,<environment.Job instance at 0x7f0192c3a960>,26,16,[7 5],27,-1,43,-1,27
1,<environment.Job instance at 0x7f019329af50>,42,20,[ 5 10],43,-1,63,-1,43
1,<environment.Job instance at 0x7f01935340f0>,37,26,[9 1],38,-1,71,-1,45
1,<environment.Job instance at 0x7f019329abe0>,44,15,[9 1],45,-1,61,-1,46
1,<environment.Job instance at 0x7f01936db8c0>,40,14,[13  5],41,-1,61,-1,47
1,<environment.Job instance at 0x7f0192793910>,49,17,[ 4 10],50,-1,75,-1,58
1,<environment.Job instance at 0x7f0192793b90>,51,18,[10  3],52,-1,76,-1,58
1,<environment.Job instance at 0x7f019329adc0>,48,16,[2 9],49,-1,74,-1,58
1,<environment.Job instance at 0x7f0192793b40>,54,19,[5 8],55,-1,84,-1,65
1,<environment.Job instance at 0x7f0193412b40>,58,15,[2 5],59,-1,80,-1,65
1,<environment.Job instance at 0x7f0192793500>,50,14,[8 2],51,-1,79,-1,65
1,<environment.Job instance at 0x7f019329afa0>,45,27,[9 2],46,-1,92,-1,65
1,<environment.Job instance at 0x7f0192f74320>,34,18,[ 5 10],35,-1,92,-1,74
1,<environment.Job instance at 0x7f0193412c80>,60,14,[4 9],61,-1,88,-1,74
1,<environment.Job instance at 0x7f0192672500>,63,16,[7 5],64,-1,90,-1,74
1,<environment.Job instance at 0x7f0193424460>,64,13,[7 3],65,-1,87,-1,74
1,<environment.Job instance at 0x7f019342a460>,71,15,[7 3],72,-1,90,-1,75
1,<environment.Job instance at 0x7f019340c4b0>,65,17,[9 4],66,-1,100,-1,83
1,<environment.Job instance at 0x7f019342aa50>,74,16,[4 8],75,-1,100,-1,84
1,<environment.Job instance at 0x7f019342a5a0>,75,1,[ 1 10],76,-1,88,-1,87
1,<environment.Job instance at 0x7f0192af2a00>,81,14,[1 8],82,-1,101,-1,87
1,<environment.Job instance at 0x7f0192af26e0>,76,22,[5 9],77,-1,112,-1,90
1,<environment.Job instance at 0x7f019342a7d0>,72,18,[8 1],73,-1,109,-1,91
1,<environment.Job instance at 0x7f0192af2b40>,83,16,[8 4],84,-1,107,-1,91
1,<environment.Job instance at 0x7f0192f1c050>,99,16,[9 1],100,-1,117,-1,101
1,<environment.Job instance at 0x7f0192f1c8c0>,100,15,[10  2],101,-1,118,-1,103
1,<environment.Job instance at 0x7f0192f1cf00>,101,18,[4 7],102,-1,124,-1,106
1,<environment.Job instance at 0x7f0192f1cb40>,103,17,[2 6],104,-1,123,-1,106
1,<environment.Job instance at 0x7f0192f1c370>,104,17,[ 1 12],105,-1,123,-1,106
1,<environment.Job instance at 0x7f0192660780>,92,19,[14  1],93,-1,127,-1,108
1,<environment.Job instance at 0x7f0192f1cfa0>,106,13,[4 9],107,-1,122,-1,109
1,<environment.Job instance at 0x7f0192b03190>,109,15,[10  1],110,-1,125,-1,110
1,<environment.Job instance at 0x7f0192f1c6e0>,108,18,[6 3],109,-1,131,-1,113
1,<environment.Job instance at 0x7f0192b03cd0>,112,17,[14  3],113,-1,131,-1,114
1,<environment.Job instance at 0x7f01926727d0>,62,21,[1 8],63,-1,135,-1,114
1,<environment.Job instance at 0x7f0192b03e60>,111,15,[5 5],112,-1,130,-1,115
1,<environment.Job instance at 0x7f0192b03b90>,115,18,[4 5],116,-1,134,-1,116
1,<environment.Job instance at 0x7f0192b03320>,114,16,[1 7],115,-1,138,-1,122
1,<environment.Job instance at 0x7f0192b03dc0>,120,16,[3 9],121,-1,139,-1,123
1,<environment.Job instance at 0x7f0193b12d20>,123,12,[3 7],124,-1,144,-1,132
1,<environment.Job instance at 0x7f0193b12190>,125,2,[5 7],126,-1,134,-1,132
1,<environment.Job instance at 0x7f0192f1cb90>,107,12,[10  4],108,-1,144,-1,132
1,<environment.Job instance at 0x7f0193b125a0>,126,13,[2 7],127,-1,145,-1,132
1,<environment.Job instance at 0x7f0193b12050>,128,14,[2 5],129,-1,146,-1,132
1,<environment.Job instance at 0x7f0193b12e10>,129,14,[7 5],130,-1,146,-1,132
1,<environment.Job instance at 0x7f0193b12460>,131,13,[5 2],132,-1,145,-1,132
1,<environment.Job instance at 0x7f0193b12a50>,127,15,[5 9],128,-1,147,-1,132
1,<environment.Job instance at 0x7f0193d8b0f0>,132,13,[ 5 10],133,-1,146,-1,133
1,<environment.Job instance at 0x7f01936e2e10>,135,13,[9 1],136,-1,149,-1,136
1,<environment.Job instance at 0x7f01936e22d0>,136,18,[10  5],137,-1,155,-1,137
1,<environment.Job instance at 0x7f01936e29b0>,137,24,[5 6],138,-1,162,-1,138
1,<environment.Job instance at 0x7f01936e2370>,138,14,[9 5],139,-1,154,-1,140
1,<environment.Job instance at 0x7f01936e2c80>,144,13,[9 2],145,-1,160,-1,147
1,<environment.Job instance at 0x7f0192c29be0>,146,16,[7 5],147,-1,164,-1,148
1,<environment.Job instance at 0x7f0192c29a50>,150,22,[10  1],151,-1,177,-1,155
1,<environment.Job instance at 0x7f0192c29280>,153,18,[2 5],154,-1,173,-1,155
1,<environment.Job instance at 0x7f01931ede60>,155,23,[5 1],156,-1,179,-1,156
1,<environment.Job instance at 0x7f0192c29050>,154,18,[5 6],155,-1,175,-1,157
1,<environment.Job instance at 0x7f01926725f0>,156,20,[4 7],157,-1,179,-1,159
1,<environment.Job instance at 0x7f01936e20f0>,143,15,[10  2],144,-1,176,-1,161
1,<environment.Job instance at 0x7f0192b03230>,117,16,[7 5],118,-1,177,-1,161
1,<environment.Job instance at 0x7f019364bc80>,160,17,[5 3],161,-1,178,-1,161
1,<environment.Job instance at 0x7f0192aeab90>,163,16,[10  2],164,-1,180,-1,164
1,<environment.Job instance at 0x7f019342e6e0>,165,15,[9 2],166,-1,181,-1,166
1,<environment.Job instance at 0x7f01936c9e10>,173,17,[4 6],174,-1,194,-1,177
1,<environment.Job instance at 0x7f0192a69fa0>,8,2,[ 5 14],9,-1,11,-1,9
1,<environment.Job instance at 0x7f0192c295a0>,29,26,[ 3 11],30,-1,120,-1,94
1,<environment.Job instance at 0x7f019330f500>,36,23,[3 6],37,-1,135,-1,112
1,<environment.Job instance at 0x7f019330fc30>,37,26,[9 1],38,-1,138,-1,112
1,<environment.Job instance at 0x7f0192e46910>,40,14,[13  5],41,-1,129,-1,115
1,<environment.Job instance at 0x7f0192e46b90>,45,27,[9 2],46,-1,169,-1,142
1,<environment.Job instance at 0x7f01932be0a0>,57,3,[ 1 13],58,-1,193,-1,190
1,<environment.Job instance at 0x7f0192a2cfa0>,77,1,[11  1],78,-1,273,-1,272
1,<environment.Job instance at 0x7f0193f1d730>,92,19,[14  1],93,-1,329,-1,310
1,<environment.Job instance at 0x7f0193ed4320>,97,28,[1 7],98,-1,345,-1,317
1,<environment.Job instance at 0x7f0192d551e0>,104,17,[ 1 12],105,-1,356,-1,339
1,<environment.Job instance at 0x7f0192c64690>,112,17,[14  3],113,-1,393,-1,376
1,<environment.Job instance at 0x7f0192ad1320>,122,1,[ 2 11],123,-1,425,-1,424
1,<environment.Job instance at 0x7f019273afa0>,137,24,[5 6],138,-1,512,-1,488
1,<environment.Job instance at 0x7f019273a550>,145,3,[ 3 12],146,-1,508,-1,505
1,<environment.Job instance at 0x7f01926f5370>,155,23,[5 1],156,-1,589,-1,566
1,<environment.Job instance at 0x7f01926f5780>,164,15,[ 4 14],165,-1,603,-1,588
1,<environment.Job instance at 0x7fda58b5caf0>,2,14,[ 2 10],3,-1,18,-1,4
1,<environment.Job instance at 0x7fda58b5c9b0>,4,13,[3 6],5,-1,18,-1,5
1,<environment.Job instance at 0x7fda58b5ccd0>,6,15,[2 8],7,-1,22,-1,7
1,<environment.Job instance at 0x7fda6214c8c0>,3,22,[2 5],4,-1,29,-1,7
1,<environment.Job instance at 0x7fda58b5ce60>,8,17,[1 8],9,-1,26,-1,9
1,<environment.Job instance at 0x7fda58b5f050>,10,22,[8 1],11,-1,33,-1,11
1,<environment.Job instance at 0x7fda58b5f0f0>,12,23,[6 4],13,-1,36,-1,13
1,<environment.Job instance at 0x7fda58b5f3c0>,13,18,[5 9],14,-1,32,-1,14
1,<environment.Job instance at 0x7fda58b5f2d0>,14,21,[8 1],15,-1,36,-1,15
1,<environment.Job instance at 0x7fda58b5f4b0>,16,18,[7 3],17,-1,35,-1,17
1,<environment.Job instance at 0x7fda58b5f5a0>,18,26,[7 4],19,-1,45,-1,19
1,<environment.Job instance at 0x7fda58b5f7d0>,19,25,[5 9],20,-1,45,-1,20
1,<environment.Job instance at 0x7fda58b5f870>,21,18,[9 4],22,-1,41,-1,23
1,<environment.Job instance at 0x7fda58b5f960>,23,16,[6 2],24,-1,40,-1,24
1,<environment.Job instance at 0x7fda58b5fd20>,26,12,[8 5],27,-1,39,-1,27
1,<environment.Job instance at 0x7fda58b5fe60>,27,17,[4 6],28,-1,45,-1,28
1,<environment.Job instance at 0x7fda58b5cfa0>,22,12,[3 8],23,-1,41,-1,29
1,<environment.Job instance at 0x7fda58b62a00>,40,26,[ 1 10],41,-1,72,-1,46
1,<environment.Job instance at 0x7fda58b62f50>,45,15,[7 5],46,-1,63,-1,48
1,<environment.Job instance at 0x7fda58b625a0>,37,14,[5 8],38,-1,68,-1,54
1,<environment.Job instance at 0x7fda58b620f0>,33,26,[3 6],34,-1,80,-1,54
1,<environment.Job instance at 0x7fda58b62140>,32,21,[5 9],33,-1,97,-1,76
1,<environment.Job instance at 0x7fda58b65b90>,57,16,[ 2 11],58,-1,92,-1,76
1,<environment.Job instance at 0x7fda58b65c30>,58,17,[3 7],59,-1,93,-1,76
1,<environment.Job instance at 0x7fda58b65dc0>,59,19,[1 7],60,-1,95,-1,76
1,<environment.Job instance at 0x7fda58b65fa0>,62,14,[4 9],63,-1,90,-1,76
1,<environment.Job instance at 0x7fda58b66230>,67,16,[1 9],68,-1,93,-1,77
1,<environment.Job instance at 0x7fda58b662d0>,68,14,[6 4],69,-1,91,-1,77
1,<environment.Job instance at 0x7fda58b66370>,69,14,[9 4],70,-1,91,-1,77
1,<environment.Job instance at 0x7fda58b66730>,72,18,[3 5],73,-1,96,-1,78
1,<environment.Job instance at 0x7fda58b66960>,74,2,[1 7],75,-1,80,-1,78
1,<environment.Job instance at 0x7fda58b66780>,76,13,[10  1],77,-1,93,-1,80
1,<environment.Job instance at 0x7fda58b66eb0>,77,16,[8 1],78,-1,96,-1,80
1,<environment.Job instance at 0x7fda58b66fa0>,78,14,[6 1],79,-1,94,-1,80
1,<environment.Job instance at 0x7fda58b66f00>,79,19,[10  3],80,-1,99,-1,80
1,<environment.Job instance at 0x7fda58b65f50>,63,12,[5 3],64,-1,92,-1,80
1,<environment.Job instance at 0x7fda58b6b410>,82,21,[4 8],83,-1,104,-1,83
1,<environment.Job instance at 0x7fda58b6b2d0>,81,14,[8 5],82,-1,98,-1,84
1,<environment.Job instance at 0x7fda58b6b0f0>,83,18,[ 3 10],84,-1,102,-1,84
1,<environment.Job instance at 0x7fda58b6b550>,85,15,[1 7],86,-1,103,-1,88
1,<environment.Job instance at 0x7fda58b6b9b0>,88,16,[4 9],89,-1,105,-1,89
1,<environment.Job instance at 0x7fda58b6baf0>,91,18,[5 4],92,-1,110,-1,92
1,<environment.Job instance at 0x7fda58ba1d70>,96,18,[2 6],97,-1,115,-1,97
1,<environment.Job instance at 0x7fda58b6bd20>,93,25,[ 1 10],94,-1,132,-1,107
1,<environment.Job instance at 0x7fda58b563c0>,102,13,[9 4],103,-1,120,-1,107
1,<environment.Job instance at 0x7fda58be5410>,105,16,[7 5],106,-1,123,-1,107
1,<environment.Job instance at 0x7fda58bd1b90>,107,18,[5 5],108,-1,126,-1,108
1,<environment.Job instance at 0x7fda58b654b0>,50,2,[5 6],51,-1,112,-1,110
1,<environment.Job instance at 0x7fda58c7b550>,109,27,[3 9],110,-1,137,-1,110
1,<environment.Job instance at 0x7fda58b6b6e0>,87,18,[7 1],88,-1,128,-1,110
1,<environment.Job instance at 0x7fda58bd7c30>,110,23,[5 1],111,-1,135,-1,112
1,<environment.Job instance at 0x7fda58c11640>,112,12,[1 6],113,-1,125,-1,113
1,<environment.Job instance at 0x7fda58beeeb0>,113,17,[5 1],114,-1,131,-1,114
1,<environment.Job instance at 0x7fda58c67b40>,118,16,[5 2],119,-1,135,-1,119
1,<environment.Job instance at 0x7fda58b7fcd0>,119,28,[7 5],120,-1,148,-1,120
1,<environment.Job instance at 0x7fda58b84d70>,122,18,[7 5],123,-1,141,-1,123
1,<environment.Job instance at 0x7fda58c7f410>,130,17,[9 5],131,-1,149,-1,132
1,<environment.Job instance at 0x7fda58b66a50>,12,23,[6 4],13,-1,53,-1,30
1,<environment.Job instance at 0x7fda58d05910>,18,26,[7 4],19,-1,70,-1,44
1,<environment.Job instance at 0x7fda58b6b0a0>,19,25,[5 9],20,-1,83,-1,58
1,<environment.Job instance at 0x7fda58b39c80>,28,17,[ 1 13],29,-1,87,-1,70
1,<environment.Job instance at 0x7fda58b95e60>,30,26,[9 4],31,-1,110,-1,84
1,<environment.Job instance at 0x7fda58bb5dc0>,31,1,[ 2 14],32,-1,85,-1,84
1,<environment.Job instance at 0x7fda58b4a6e0>,33,26,[3 6],34,-1,110,-1,84
1,<environment.Job instance at 0x7fda58b50460>,40,26,[ 1 10],41,-1,139,-1,113
1,<environment.Job instance at 0x7fda58af2820>,57,16,[ 2 11],58,-1,183,-1,167
1,<environment.Job instance at 0x7fda58af8cd0>,89,17,[ 5 14],90,-1,289,-1,272
1,<environment.Job instance at 0x7fda58afb230>,93,25,[ 1 10],94,-1,320,-1,295
1,<environment.Job instance at 0x7fda58afbd70>,109,27,[3 9],110,-1,371,-1,344
1,<environment.Job instance at 0x7fda58afbf50>,110,23,[5 1],111,-1,367,-1,344
1,<environment.Job instance at 0x7fda58afd460>,117,3,[ 3 13],118,-1,367,-1,364
1,<environment.Job instance at 0x7fda58afd500>,119,28,[7 5],120,-1,406,-1,378
1,<environment.Job instance at 0x7fda58afd5f0>,120,19,[ 5 12],121,-1,397,-1,378
1,<environment.Job instance at 0x7fda58b00230>,137,28,[ 2 10],138,-1,458,-1,430
1,<environment.Job instance at 0x7fda58b00730>,142,15,[ 2 13],143,-1,450,-1,435
1,<environment.Job instance at 0x7fda58b007d0>,144,20,[13  4],145,-1,460,-1,440
1,<environment.Job instance at 0x7fda58b00fa0>,153,1,[12  5],154,-1,473,-1,472
1,<environment.Job instance at 0x7fda58b03320>,160,24,[1 5],161,-1,534,-1,510
1,<environment.Job instance at 0x7fda58b036e0>,166,13,[ 5 14],167,-1,543,-1,530
1,<environment.Job instance at 0x7fda58b03dc0>,173,24,[3 7],174,-1,590,-1,566
1,<environment.Job instance at 0x7fda58b06690>,185,27,[ 3 12],189,-1,635,-1,608
1,<environment.Job instance at 0x7fda5853c960>,0,17,[9 5],1,-1,18,-1,1
1,<environment.Job instance at 0x7fda584fa0f0>,8,21,[2 7],9,-1,32,-1,11
1,<environment.Job instance at 0x7fda584fa690>,11,14,[ 1 10],12,-1,26,-1,12
1,<environment.Job instance at 0x7fda585c4230>,13,14,[5 9],14,-1,28,-1,14
1,<environment.Job instance at 0x7fda585c4140>,15,19,[ 1 10],16,-1,35,-1,16
1,<environment.Job instance at 0x7fda585c46e0>,16,16,[6 5],17,-1,33,-1,17
1,<environment.Job instance at 0x7fda585c4820>,18,20,[ 2 10],19,-1,39,-1,19
1,<environment.Job instance at 0x7fda585c48c0>,19,15,[5 5],20,-1,35,-1,20
1,<environment.Job instance at 0x7fda58776b40>,10,23,[4 7],11,-1,44,-1,21
1,<environment.Job instance at 0x7fda585cf190>,26,16,[1 8],27,-1,43,-1,27
1,<environment.Job instance at 0x7fda585cffa0>,32,15,[8 2],33,-1,48,-1,33
1,<environment.Job instance at 0x7fda585cf1e0>,28,23,[1 9],29,-1,57,-1,34
1,<environment.Job instance at 0x7fda585d4050>,35,17,[12  1],36,-1,55,-1,38
1,<environment.Job instance at 0x7fda585cf820>,29,17,[8 5],30,-1,56,-1,39
1,<environment.Job instance at 0x7fda585d45f0>,37,12,[4 8],38,-1,51,-1,39
1,<environment.Job instance at 0x7fda585d45a0>,39,13,[4 5],40,-1,53,-1,40
1,<environment.Job instance at 0x7fda580f0dc0>,71,17,[10  2],72,-1,154,-1,137
1,<environment.Job instance at 0x7fda5814f780>,75,18,[ 1 10],76,-1,155,-1,137
1,<environment.Job instance at 0x7fda585d4a00>,45,18,[5 4],46,-1,171,-1,153
1,<environment.Job instance at 0x7fda5829d460>,73,26,[5 3],74,-1,179,-1,153
1,<environment.Job instance at 0x7fda58112d20>,80,18,[5 8],81,-1,197,-1,179
1,<environment.Job instance at 0x7fda58112a00>,83,13,[8 3],84,-1,192,-1,179
1,<environment.Job instance at 0x7fda58112320>,82,18,[3 8],83,-1,197,-1,179
1,<environment.Job instance at 0x7fda581114b0>,88,20,[5 2],89,-1,199,-1,179
1,<environment.Job instance at 0x7fda58111410>,89,26,[2 8],90,-1,218,-1,192
1,<environment.Job instance at 0x7fda581119b0>,92,15,[9 2],93,-1,207,-1,192
1,<environment.Job instance at 0x7fda58111eb0>,97,27,[9 5],98,-1,220,-1,193
1,<environment.Job instance at 0x7fda58111910>,94,16,[7 5],95,-1,209,-1,193
1,<environment.Job instance at 0x7fda58111a50>,98,13,[8 4],99,-1,207,-1,194
1,<environment.Job instance at 0x7fda5810f4b0>,111,17,[ 5 14],112,-1,236,-1,219
1,<environment.Job instance at 0x7fda581110a0>,90,15,[5 8],91,-1,234,-1,219
1,<environment.Job instance at 0x7fda5810fa00>,113,17,[7 4],114,-1,237,-1,220
1,<environment.Job instance at 0x7fda5810f370>,115,13,[ 5 14],116,-1,233,-1,220
1,<environment.Job instance at 0x7fda5810f410>,109,15,[6 5],110,-1,236,-1,221
1,<environment.Job instance at 0x7fda5810fc30>,114,17,[13  5],115,-1,238,-1,221
1,<environment.Job instance at 0x7fda5810e6e0>,103,15,[7 2],104,-1,236,-1,221
1,<environment.Job instance at 0x7fda581e35f0>,125,16,[7 5],126,-1,251,-1,235
1,<environment.Job instance at 0x7fda58b0a280>,129,18,[5 6],130,-1,253,-1,235
1,<environment.Job instance at 0x7fda581102d0>,128,14,[9 4],129,-1,249,-1,235
1,<environment.Job instance at 0x7fda622bc410>,130,16,[8 3],131,-1,252,-1,236
1,<environment.Job instance at 0x7fda580f5aa0>,135,27,[4 5],136,-1,265,-1,238
1,<environment.Job instance at 0x7fda581190f0>,142,20,[4 9],143,-1,261,-1,241
1,<environment.Job instance at 0x7fda581974b0>,149,15,[ 2 10],150,-1,268,-1,253
1,<environment.Job instance at 0x7fda58197690>,152,17,[5 9],153,-1,273,-1,256
1,<environment.Job instance at 0x7fda581804b0>,170,26,[8 3],171,-1,384,-1,358
1,<environment.Job instance at 0x7fda5837a640>,181,18,[5 8],182,-1,420,-1,402
1,<environment.Job instance at 0x7fda585cfa50>,2,15,[ 2 14],3,-1,18,-1,3
1,<environment.Job instance at 0x7fda585d4960>,4,26,[3 9],5,-1,42,-1,16
1,<environment.Job instance at 0x7fda5810c960>,10,23,[4 7],11,-1,41,-1,18
1,<environment.Job instance at 0x7fda5861b2d0>,20,1,[14  4],21,-1,37,-1,36
1,<environment.Job instance at 0x7fda585f37d0>,27,18,[ 1 14],28,-1,69,-1,51
1,<environment.Job instance at 0x7fda585c0e60>,28,23,[1 9],29,-1,89,-1,66
1,<environment.Job instance at 0x7fda58b03c30>,35,17,[12  1],36,-1,87,-1,70
1,<environment.Job instance at 0x7fda58b03460>,40,16,[14  3],41,-1,115,-1,99
1,<environment.Job instance at 0x7fda58b030a0>,47,2,[ 1 12],48,-1,108,-1,106
1,<environment.Job instance at 0x7fda58b00b40>,55,27,[6 1],56,-1,169,-1,142
1,<environment.Job instance at 0x7fda58b00500>,62,23,[1 8],63,-1,186,-1,163
1,<environment.Job instance at 0x7fda58afdb40>,73,26,[5 3],74,-1,221,-1,195
1,<environment.Job instance at 0x7fda58afbe10>,89,26,[2 8],90,-1,298,-1,272
1,<environment.Job instance at 0x7fda58afb6e0>,97,27,[9 5],98,-1,340,-1,313
1,<environment.Job instance at 0x7fda58afb5a0>,99,14,[12  2],100,-1,327,-1,313
1,<environment.Job instance at 0x7fda58af8c80>,111,17,[ 5 14],112,-1,366,-1,349
1,<environment.Job instance at 0x7fda58af8aa0>,112,25,[ 3 11],113,-1,374,-1,349
1,<environment.Job instance at 0x7fda58af8a50>,114,17,[13  5],115,-1,367,-1,350
1,<environment.Job instance at 0x7fda58af89b0>,115,13,[ 5 14],116,-1,363,-1,350
1,<environment.Job instance at 0x7fda58324780>,135,27,[4 5],136,-1,475,-1,448
1,<environment.Job instance at 0x7fda58324050>,137,12,[13  4],138,-1,460,-1,448
1,<environment.Job instance at 0x7fda583f93c0>,138,12,[ 5 12],139,-1,460,-1,448
1,<environment.Job instance at 0x7fda584a26e0>,157,13,[12  1],158,-1,509,-1,496
1,<environment.Job instance at 0x7fda5844d190>,158,12,[14  3],159,-1,508,-1,496
1,<environment.Job instance at 0x7fda584a20a0>,159,1,[ 4 11],160,-1,497,-1,496
1,<environment.Job instance at 0x7fda58401320>,166,25,[2 8],167,-1,548,-1,523
1,<environment.Job instance at 0x7fda58446d70>,170,26,[8 3],171,-1,562,-1,536
1,<environment.Job instance at 0x7fda582bd910>,184,2,[11  3],185,-1,585,-1,583
1,<environment.Job instance at 0x7fda5827b370>,0,16,[ 4 10],1,-1,17,-1,1
1,<environment.Job instance at 0x7fda5827b460>,2,17,[8 2],3,-1,21,-1,4
1,<environment.Job instance at 0x7fda5827b2d0>,9,18,[10  4],10,-1,28,-1,10
1,<environment.Job instance at 0x7fda5827b960>,10,15,[1 9],11,-1,26,-1,11
1,<environment.Job instance at 0x7fda5827b0f0>,11,13,[1 7],12,-1,25,-1,12
1,<environment.Job instance at 0x7fda58275690>,13,14,[5 6],14,-1,28,-1,14
1,<environment.Job instance at 0x7fda582752d0>,14,18,[10  5],15,-1,33,-1,15
1,<environment.Job instance at 0x7fda58275460>,16,16,[2 9],17,-1,33,-1,17
1,<environment.Job instance at 0x7fda58275910>,18,15,[10  4],19,-1,36,-1,21
1,<environment.Job instance at 0x7fda58275d70>,20,16,[8 5],21,-1,37,-1,21
1,<environment.Job instance at 0x7fda58275140>,22,27,[8 3],23,-1,50,-1,23
1,<environment.Job instance at 0x7fda58275aa0>,23,18,[1 6],24,-1,42,-1,24
1,<environment.Job instance at 0x7fda58272d70>,24,17,[2 6],25,-1,42,-1,25
1,<environment.Job instance at 0x7fda58272460>,26,27,[2 6],27,-1,54,-1,27
1,<environment.Job instance at 0x7fda58272a50>,27,16,[7 4],28,-1,44,-1,28
1,<environment.Job instance at 0x7fda58272aa0>,28,16,[9 2],29,-1,47,-1,31
1,<environment.Job instance at 0x7fda582722d0>,31,16,[4 5],32,-1,48,-1,32
1,<environment.Job instance at 0x7fda582efaf0>,42,16,[6 4],43,-1,59,-1,43
1,<environment.Job instance at 0x7fda582ef320>,44,14,[3 6],45,-1,59,-1,45
1,<environment.Job instance at 0x7fda582ef820>,45,13,[7 4],46,-1,60,-1,47
1,<environment.Job instance at 0x7fda582ef6e0>,46,21,[ 4 10],47,-1,69,-1,48
1,<environment.Job instance at 0x7fda582ef3c0>,47,23,[2 8],48,-1,71,-1,48
1,<environment.Job instance at 0x7fda582ecb90>,60,25,[6 4],61,-1,98,-1,73
1,<environment.Job instance at 0x7fda582d5910>,64,24,[5 5],65,-1,113,-1,89
1,<environment.Job instance at 0x7fda582ecc30>,55,17,[ 5 10],56,-1,107,-1,90
1,<environment.Job instance at 0x7fda58272140>,30,14,[ 4 14],31,-1,104,-1,90
1,<environment.Job instance at 0x7fda582d5460>,68,28,[ 5 10],69,-1,118,-1,90
1,<environment.Job instance at 0x7fda582ec820>,58,14,[8 2],59,-1,104,-1,90
1,<environment.Job instance at 0x7fda582d5eb0>,69,15,[9 5],70,-1,105,-1,90
1,<environment.Job instance at 0x7fda582d5690>,66,14,[2 5],67,-1,104,-1,90
1,<environment.Job instance at 0x7fda582d51e0>,71,17,[7 5],72,-1,107,-1,90
1,<environment.Job instance at 0x7fda582e66e0>,75,14,[3 8],76,-1,104,-1,90
1,<environment.Job instance at 0x7fda582d5a00>,67,1,[4 6],68,-1,91,-1,90
1,<environment.Job instance at 0x7fda58396be0>,86,12,[10  2],87,-1,132,-1,120
1,<environment.Job instance at 0x7fda582e6550>,78,15,[2 9],79,-1,146,-1,131
1,<environment.Job instance at 0x7fda582e6be0>,76,12,[ 5 12],77,-1,143,-1,131
1,<environment.Job instance at 0x7fda582d5cd0>,70,13,[5 5],71,-1,144,-1,131
1,<environment.Job instance at 0x7fda58396500>,91,16,[ 1 14],92,-1,147,-1,131
1,<environment.Job instance at 0x7fda583961e0>,92,14,[5 3],93,-1,145,-1,131
1,<environment.Job instance at 0x7fda58396d70>,94,22,[7 3],95,-1,153,-1,131
1,<environment.Job instance at 0x7fda583960a0>,95,20,[7 5],96,-1,151,-1,131
1,<environment.Job instance at 0x7fda58396a00>,93,12,[2 7],94,-1,143,-1,131
1,<environment.Job instance at 0x7fda582e45a0>,101,15,[7 1],102,-1,146,-1,131
1,<environment.Job instance at 0x7fda58396af0>,88,13,[8 3],89,-1,144,-1,131
1,<environment.Job instance at 0x7fda582e48c0>,104,17,[14  5],105,-1,148,-1,131
1,<environment.Job instance at 0x7fda582e4aa0>,102,3,[8 3],103,-1,134,-1,131
1,<environment.Job instance at 0x7fda582e45f0>,100,13,[5 5],101,-1,144,-1,131
1,<environment.Job instance at 0x7fda582e4640>,105,12,[4 5],106,-1,143,-1,131
1,<environment.Job instance at 0x7fda58282780>,110,15,[2 5],111,-1,146,-1,131
1,<environment.Job instance at 0x7fda58282050>,112,17,[4 5],113,-1,151,-1,134
1,<environment.Job instance at 0x7fda582560f0>,113,14,[9 3],114,-1,148,-1,134
1,<environment.Job instance at 0x7fda58538640>,107,18,[8 2],108,-1,153,-1,135
1,<environment.Job instance at 0x7fda5828c460>,106,2,[ 3 10],107,-1,137,-1,135
1,<environment.Job instance at 0x7fda582910a0>,117,16,[7 2],118,-1,152,-1,136
1,<environment.Job instance at 0x7fda58291690>,116,16,[1 9],117,-1,152,-1,136
1,<environment.Job instance at 0x7fda58291960>,118,2,[9 3],119,-1,138,-1,136
1,<environment.Job instance at 0x7fda590ab730>,123,16,[6 5],124,-1,152,-1,136
1,<environment.Job instance at 0x7fda58dc7b40>,124,16,[9 5],125,-1,155,-1,139
1,<environment.Job instance at 0x7fda58d7cb90>,122,16,[10  4],123,-1,155,-1,139
1,<environment.Job instance at 0x7fda582915a0>,115,17,[8 2],116,-1,156,-1,139
1,<environment.Job instance at 0x7fda58fe4690>,127,28,[5 9],128,-1,167,-1,139
1,<environment.Job instance at 0x7fda58dbf190>,129,18,[5 8],130,-1,158,-1,140
1,<environment.Job instance at 0x7fda58111dc0>,126,22,[1 8],127,-1,162,-1,140
1,<environment.Job instance at 0x7fda582ecb40>,59,17,[12  4],60,-1,158,-1,141
1,<environment.Job instance at 0x7fda58ff5730>,130,18,[ 2 10],131,-1,160,-1,142
1,<environment.Job instance at 0x7fda589536e0>,131,15,[8 1],132,-1,169,-1,154
1,<environment.Job instance at 0x7fda5810ff00>,137,28,[9 1],138,-1,182,-1,154
1,<environment.Job instance at 0x7fda5810f5a0>,138,13,[9 1],139,-1,167,-1,154
1,<environment.Job instance at 0x7fda5810f500>,136,18,[ 5 10],137,-1,175,-1,157
1,<environment.Job instance at 0x7fda5823bb40>,142,26,[5 8],143,-1,183,-1,157
1,<environment.Job instance at 0x7fda5823bdc0>,141,14,[9 2],142,-1,171,-1,157
1,<environment.Job instance at 0x7fda581690f0>,148,15,[2 8],149,-1,172,-1,157
1,<environment.Job instance at 0x7fda58169410>,152,17,[8 1],153,-1,186,-1,169
1,<environment.Job instance at 0x7fda588c67d0>,154,12,[3 9],155,-1,184,-1,172
1,<environment.Job instance at 0x7fda58929aa0>,157,28,[ 5 10],158,-1,200,-1,172
1,<environment.Job instance at 0x7fda58987910>,159,18,[3 8],160,-1,194,-1,176
1,<environment.Job instance at 0x7fda58112d70>,162,21,[5 7],163,-1,216,-1,195
1,<environment.Job instance at 0x7fda58987280>,161,12,[1 6],162,-1,207,-1,195
1,<environment.Job instance at 0x7fda5893a7d0>,153,22,[3 5],154,-1,220,-1,198
1,<environment.Job instance at 0x7fda582ecf50>,52,12,[7 5],53,-1,212,-1,200
1,<environment.Job instance at 0x7fda59046910>,169,18,[8 2],170,-1,218,-1,200
1,<environment.Job instance at 0x7fda5897d140>,168,16,[1 7],169,-1,216,-1,200
1,<environment.Job instance at 0x7fda58165050>,173,17,[4 7],174,-1,217,-1,200
1,<environment.Job instance at 0x7fda5814f5f0>,174,16,[ 5 10],175,-1,216,-1,200
1,<environment.Job instance at 0x7fda581620f0>,175,15,[5 9],176,-1,215,-1,200
1,<environment.Job instance at 0x7fda5823f050>,180,26,[3 7],181,-1,226,-1,200
1,<environment.Job instance at 0x7fda58149820>,181,18,[11  5],182,-1,218,-1,200
1,<environment.Job instance at 0x7fda581657d0>,171,12,[2 6],172,-1,212,-1,200
1,<environment.Job instance at 0x7fda582450f0>,166,18,[9 3],167,-1,218,-1,200
1,<environment.Job instance at 0x7fda58275d20>,5,17,[12  4],6,-1,23,-1,6
1,<environment.Job instance at 0x7fda622b5af0>,17,2,[ 3 11],18,-1,45,-1,43
1,<environment.Job instance at 0x7fda5823bcd0>,22,27,[8 3],23,-1,103,-1,76
1,<environment.Job instance at 0x7fda588ca0f0>,26,27,[2 6],27,-1,120,-1,93
1,<environment.Job instance at 0x7fda5814ef50>,30,14,[ 4 14],31,-1,123,-1,109
1,<environment.Job instance at 0x7fda5810ce60>,47,23,[2 8],48,-1,177,-1,154
1,<environment.Job instance at 0x7fda581e3780>,48,3,[11  1],49,-1,157,-1,154
1,<environment.Job instance at 0x7fda5810f0a0>,49,19,[13  3],50,-1,173,-1,154
1,<environment.Job instance at 0x7fda622bec80>,54,13,[ 4 11],55,-1,181,-1,168
1,<environment.Job instance at 0x7fda58401320>,59,17,[12  4],60,-1,208,-1,191
1,<environment.Job instance at 0x7fda58401870>,60,25,[6 4],61,-1,217,-1,192
1,<environment.Job instance at 0x7fda584019b0>,62,3,[14  5],63,-1,195,-1,192
1,<environment.Job instance at 0x7fda58401910>,64,24,[5 5],65,-1,225,-1,201
1,<environment.Job instance at 0x7fda58295a50>,68,28,[ 5 10],69,-1,242,-1,214
1,<environment.Job instance at 0x7fda582e43c0>,76,12,[ 5 12],77,-1,245,-1,233
1,<environment.Job instance at 0x7fda582e1460>,79,2,[ 5 14],80,-1,249,-1,247
1,<environment.Job instance at 0x7fda582e16e0>,91,16,[ 1 14],92,-1,318,-1,302
1,<environment.Job instance at 0x7fda582dd5f0>,104,17,[14  5],105,-1,353,-1,336
1,<environment.Job instance at 0x7fda582d9960>,111,2,[14  5],112,-1,352,-1,350
1,<environment.Job instance at 0x7fda5838a190>,127,28,[5 9],128,-1,449,-1,421
1,<environment.Job instance at 0x7fda5838ab90>,137,28,[9 1],138,-1,486,-1,458
1,<environment.Job instance at 0x7fda584153c0>,142,26,[5 8],143,-1,504,-1,478
1,<environment.Job instance at 0x7fda584152d0>,146,2,[ 5 13],147,-1,494,-1,492
1,<environment.Job instance at 0x7fda58415e60>,151,1,[13  4],152,-1,500,-1,499
1,<environment.Job instance at 0x7fda583c4550>,158,2,[12  3],159,-1,528,-1,526
1,<environment.Job instance at 0x7fda583c4500>,157,28,[ 5 10],158,-1,594,-1,566
1,<environment.Job instance at 0x7fda58449910>,0,13,[10  1],1,-1,16,-1,3
1,<environment.Job instance at 0x7fda59695a00>,3,14,[6 5],4,-1,18,-1,4
1,<environment.Job instance at 0x7fda59695e60>,4,12,[9 3],5,-1,17,-1,5
1,<environment.Job instance at 0x7fda596954b0>,6,12,[10  1],7,-1,19,-1,7
1,<environment.Job instance at 0x7fda58852960>,10,17,[5 6],11,-1,28,-1,11
1,<environment.Job instance at 0x7fda58852cd0>,11,27,[7 1],12,-1,39,-1,12
1,<environment.Job instance at 0x7fda588529b0>,12,26,[ 3 10],13,-1,41,-1,15
1,<environment.Job instance at 0x7fda58852320>,15,21,[ 2 10],16,-1,37,-1,16
1,<environment.Job instance at 0x7fda58852280>,16,15,[10  2],17,-1,32,-1,17
1,<environment.Job instance at 0x7fda58852d70>,18,12,[ 2 11],19,-1,31,-1,19
1,<environment.Job instance at 0x7fda58852f50>,19,13,[4 7],20,-1,33,-1,20
1,<environment.Job instance at 0x7fda58fba050>,20,16,[10  1],21,-1,37,-1,21
1,<environment.Job instance at 0x7fda58fba0f0>,21,17,[11  3],22,-1,39,-1,22
1,<environment.Job instance at 0x7fda58fba780>,29,15,[ 3 10],30,-1,45,-1,30
1,<environment.Job instance at 0x7fda58fba910>,30,17,[10  2],31,-1,48,-1,31
1,<environment.Job instance at 0x7fda58fba410>,31,13,[10  2],32,-1,45,-1,32
1,<environment.Job instance at 0x7fda58fbaaa0>,33,24,[2 6],34,-1,58,-1,34
1,<environment.Job instance at 0x7fda58fbae60>,36,14,[8 4],37,-1,51,-1,37
1,<environment.Job instance at 0x7fda58fbafa0>,37,14,[9 2],38,-1,52,-1,38
1,<environment.Job instance at 0x7fda58f951e0>,40,14,[5 8],41,-1,55,-1,41
1,<environment.Job instance at 0x7fda58f95230>,42,18,[6 2],43,-1,61,-1,43
1,<environment.Job instance at 0x7fda58f95460>,44,18,[6 2],45,-1,63,-1,45
1,<environment.Job instance at 0x7fda58f95690>,45,19,[6 3],46,-1,65,-1,46
1,<environment.Job instance at 0x7fda58f95c80>,51,14,[3 6],52,-1,66,-1,52
1,<environment.Job instance at 0x7fda58f95eb0>,52,27,[5 7],53,-1,80,-1,53
1,<environment.Job instance at 0x7fda58fad320>,58,15,[11  4],59,-1,91,-1,76
1,<environment.Job instance at 0x7fda58fad460>,61,14,[ 4 13],62,-1,90,-1,76
1,<environment.Job instance at 0x7fda58fad0a0>,57,15,[9 1],58,-1,91,-1,76
1,<environment.Job instance at 0x7fda58fadb40>,69,17,[6 2],70,-1,93,-1,76
1,<environment.Job instance at 0x7fda58fadc80>,71,18,[4 9],72,-1,94,-1,76
1,<environment.Job instance at 0x7fda58fbac80>,34,13,[ 5 12],35,-1,89,-1,76
1,<environment.Job instance at 0x7fda596915f0>,76,16,[8 2],77,-1,93,-1,77
1,<environment.Job instance at 0x7fda58faddc0>,73,1,[1 5],74,-1,78,-1,77
1,<environment.Job instance at 0x7fda5827eaf0>,78,14,[8 5],79,-1,95,-1,81
1,<environment.Job instance at 0x7fda58fad140>,55,16,[9 2],56,-1,99,-1,83
1,<environment.Job instance at 0x7fda5883ca00>,77,14,[11  4],78,-1,98,-1,84
1,<environment.Job instance at 0x7fda58fadd20>,72,12,[6 2],73,-1,104,-1,92
1,<environment.Job instance at 0x7fda58f96370>,81,18,[ 3 10],82,-1,110,-1,92
1,<environment.Job instance at 0x7fda58f705f0>,80,18,[ 4 11],81,-1,111,-1,93
1,<environment.Job instance at 0x7fda596927d0>,91,15,[8 1],92,-1,133,-1,118
1,<environment.Job instance at 0x7fda596923c0>,89,15,[1 6],90,-1,134,-1,119
1,<environment.Job instance at 0x7fda58832640>,79,16,[7 4],80,-1,136,-1,120
1,<environment.Job instance at 0x7fda58832dc0>,82,12,[7 2],83,-1,132,-1,120
1,<environment.Job instance at 0x7fda58f7c7d0>,93,15,[ 3 10],94,-1,135,-1,120
1,<environment.Job instance at 0x7fda59692a00>,92,16,[5 4],93,-1,137,-1,121
1,<environment.Job instance at 0x7fda58580410>,98,20,[3 9],99,-1,142,-1,122
1,<environment.Job instance at 0x7fda591f0460>,97,14,[7 2],98,-1,136,-1,122
1,<environment.Job instance at 0x7fda58595f00>,101,17,[ 4 10],102,-1,140,-1,123
1,<environment.Job instance at 0x7fda58999c30>,100,16,[5 4],101,-1,139,-1,123
1,<environment.Job instance at 0x7fda584e2640>,104,17,[3 5],105,-1,140,-1,123
1,<environment.Job instance at 0x7fda584e2be0>,106,14,[6 5],107,-1,137,-1,123
1,<environment.Job instance at 0x7fda58980e60>,107,21,[4 8],108,-1,144,-1,123
1,<environment.Job instance at 0x7fda585a07d0>,108,23,[3 9],109,-1,146,-1,123
1,<environment.Job instance at 0x7fda58980640>,109,13,[10  5],110,-1,136,-1,123
1,<environment.Job instance at 0x7fda59692320>,95,15,[5 6],96,-1,138,-1,123
1,<environment.Job instance at 0x7fda58577960>,112,14,[2 6],113,-1,137,-1,123
1,<environment.Job instance at 0x7fda591f8b90>,114,18,[6 4],115,-1,143,-1,125
1,<environment.Job instance at 0x7fda5899ec80>,103,14,[ 5 13],104,-1,140,-1,126
1,<environment.Job instance at 0x7fda585a9af0>,116,12,[1 7],117,-1,139,-1,127
1,<environment.Job instance at 0x7fda5849e0f0>,83,24,[8 5],84,-1,152,-1,128
1,<environment.Job instance at 0x7fda591f84b0>,115,15,[4 7],116,-1,143,-1,128
1,<environment.Job instance at 0x7fda585a9910>,118,16,[1 7],119,-1,144,-1,128
1,<environment.Job instance at 0x7fda585a9f00>,119,15,[ 2 10],120,-1,143,-1,128
1,<environment.Job instance at 0x7fda584c1320>,123,3,[3 8],124,-1,131,-1,128
1,<environment.Job instance at 0x7fda584c16e0>,125,13,[6 4],126,-1,141,-1,128
1,<environment.Job instance at 0x7fda584b82d0>,131,16,[8 4],132,-1,149,-1,133
1,<environment.Job instance at 0x7fda585a9cd0>,117,17,[8 4],118,-1,150,-1,133
1,<environment.Job instance at 0x7fda584b87d0>,132,1,[5 9],133,-1,135,-1,134
1,<environment.Job instance at 0x7fda584b8870>,133,18,[6 4],134,-1,152,-1,134
1,<environment.Job instance at 0x7fda584bf230>,127,12,[ 3 14],128,-1,159,-1,147
1,<environment.Job instance at 0x7fda5920e460>,138,16,[13  3],139,-1,163,-1,147
1,<environment.Job instance at 0x7fda584ecf50>,145,21,[9 5],146,-1,168,-1,147
1,<environment.Job instance at 0x7fda584ecc80>,146,18,[10  5],147,-1,166,-1,148
1,<environment.Job instance at 0x7fda584ecc30>,147,14,[1 9],148,-1,162,-1,148
1,<environment.Job instance at 0x7fda58577870>,111,13,[2 5],112,-1,162,-1,149
1,<environment.Job instance at 0x7fda584ec6e0>,142,12,[4 7],143,-1,161,-1,149
1,<environment.Job instance at 0x7fda584cfe60>,148,12,[7 5],149,-1,161,-1,149
1,<environment.Job instance at 0x7fda584cf320>,150,12,[2 5],151,-1,163,-1,151
1,<environment.Job instance at 0x7fda584cfe10>,151,16,[1 6],152,-1,169,-1,153
1,<environment.Job instance at 0x7fda584cf7d0>,153,27,[3 5],154,-1,181,-1,154
1,<environment.Job instance at 0x7fda58fa9500>,167,17,[2 6],168,-1,206,-1,189
1,<environment.Job instance at 0x7fda58fa9190>,168,17,[5 4],169,-1,206,-1,189
1,<environment.Job instance at 0x7fda584d8910>,170,16,[9 4],171,-1,205,-1,189
1,<environment.Job instance at 0x7fda58f92eb0>,175,18,[3 9],176,-1,221,-1,203
1,<environment.Job instance at 0x7fda58833230>,176,27,[10  4],177,-1,230,-1,203
1,<environment.Job instance at 0x7fda588427d0>,157,17,[5 7],158,-1,220,-1,203
1,<environment.Job instance at 0x7fda58972aa0>,179,14,[9 4],180,-1,217,-1,203
1,<environment.Job instance at 0x7fda58979550>,181,18,[4 8],182,-1,222,-1,204
1,<environment.Job instance at 0x7fda58fba460>,2,24,[1 9],3,-1,29,-1,5
1,<environment.Job instance at 0x7fda584c1910>,11,27,[7 1],12,-1,41,-1,14
1,<environment.Job instance at 0x7fda584bf910>,13,2,[ 3 13],14,-1,16,-1,14
1,<environment.Job instance at 0x7fda584ca410>,17,1,[ 3 14],18,-1,29,-1,28
1,<environment.Job instance at 0x7fda584ec5f0>,18,12,[ 2 11],19,-1,40,-1,28
1,<environment.Job instance at 0x7fda584c1500>,12,26,[ 3 10],13,-1,54,-1,28
1,<environment.Job instance at 0x7fda58f9daf0>,21,17,[11  3],22,-1,45,-1,28
1,<environment.Job instance at 0x7fda58f9d820>,22,16,[12  1],23,-1,44,-1,28
1,<environment.Job instance at 0x7fda58f9d3c0>,23,15,[ 4 13],24,-1,43,-1,28
1,<environment.Job instance at 0x7fda583c4910>,33,24,[2 6],34,-1,92,-1,68
1,<environment.Job instance at 0x7fda583c4640>,34,13,[ 5 12],35,-1,81,-1,68
1,<environment.Job instance at 0x7fda583c49b0>,35,2,[ 2 11],36,-1,70,-1,68
1,<environment.Job instance at 0x7fda58415af0>,52,27,[5 7],53,-1,149,-1,122
1,<environment.Job instance at 0x7fda5838ab40>,54,24,[13  2],55,-1,146,-1,122
1,<environment.Job instance at 0x7fda5838a5a0>,58,15,[11  4],59,-1,165,-1,150
1,<environment.Job instance at 0x7fda5838a640>,61,14,[ 4 13],62,-1,179,-1,165
1,<environment.Job instance at 0x7fda582d97d0>,77,14,[11  4],78,-1,239,-1,225
1,<environment.Job instance at 0x7fda582d90a0>,80,18,[ 4 11],81,-1,246,-1,228
1,<environment.Job instance at 0x7fda582ddd20>,83,24,[8 5],84,-1,282,-1,258
1,<environment.Job instance at 0x7fda582dd780>,88,13,[12  1],89,-1,285,-1,272
1,<environment.Job instance at 0x7fda582e1be0>,96,3,[14  2],97,-1,305,-1,302
1,<environment.Job instance at 0x7fda582e1050>,103,14,[ 5 13],104,-1,347,-1,333
1,<environment.Job instance at 0x7fda582e47d0>,108,23,[3 9],109,-1,376,-1,353
1,<environment.Job instance at 0x7fda583f93c0>,120,2,[ 1 11],121,-1,404,-1,402
1,<environment.Job instance at 0x7fda582f9aa0>,127,12,[ 3 14],128,-1,435,-1,423
1,<environment.Job instance at 0x7fda582e60f0>,138,16,[13  3],139,-1,459,-1,443
1,<environment.Job instance at 0x7fda59683e60>,153,27,[3 5],154,-1,520,-1,493
1,<environment.Job instance at 0x7fda591ed5a0>,154,1,[12  4],155,-1,494,-1,493
1,<environment.Job instance at 0x7fda581836e0>,155,2,[14  1],156,-1,495,-1,493
1,<environment.Job instance at 0x7fda5892b960>,176,27,[10  4],177,-1,618,-1,591
1,<environment.Job instance at 0x7fda620444b0>,180,1,[ 5 11],181,-1,599,-1,598
1,<environment.Job instance at 0x7fda58fee730>,182,25,[7 3],183,-1,637,-1,612
1,<environment.Job instance at 0x7fda59106d20>,184,13,[ 3 12],185,-1,625,-1,612
1,<environment.Job instance at 0x7fda58c825a0>,0,16,[10  3],1,-1,18,-1,2
1,<environment.Job instance at 0x7fda583c41e0>,1,17,[10  5],2,-1,19,-1,2
1,<environment.Job instance at 0x7fda58b44910>,14,12,[3 7],15,-1,28,-1,16
1,<environment.Job instance at 0x7fda58b44230>,17,16,[2 7],18,-1,34,-1,18
1,<environment.Job instance at 0x7fda58b440f0>,19,14,[7 2],20,-1,34,-1,20
1,<environment.Job instance at 0x7fda58b44dc0>,20,18,[1 7],21,-1,39,-1,21
1,<environment.Job instance at 0x7fda58f40b40>,21,14,[1 7],22,-1,36,-1,22
1,<environment.Job instance at 0x7fda58f40870>,22,14,[8 5],23,-1,37,-1,23
1,<environment.Job instance at 0x7fda58f407d0>,25,26,[4 8],26,-1,52,-1,26
1,<environment.Job instance at 0x7fda58f40fa0>,26,20,[4 8],27,-1,47,-1,27
1,<environment.Job instance at 0x7fda58f40c30>,28,16,[8 4],29,-1,45,-1,29
1,<environment.Job instance at 0x7fda58f40730>,30,25,[5 4],31,-1,56,-1,31
1,<environment.Job instance at 0x7fda58f40aa0>,31,21,[5 5],32,-1,53,-1,32
1,<environment.Job instance at 0x7fda58f40be0>,33,18,[ 2 10],34,-1,52,-1,34
1,<environment.Job instance at 0x7fda58f40e60>,35,25,[5 7],36,-1,61,-1,36
1,<environment.Job instance at 0x7fda58b575a0>,37,22,[5 8],38,-1,60,-1,38
1,<environment.Job instance at 0x7fda58b578c0>,40,15,[3 8],41,-1,56,-1,41
1,<environment.Job instance at 0x7fda58b57460>,42,2,[10  4],43,-1,45,-1,43
1,<environment.Job instance at 0x7fda58b57b90>,43,27,[8 5],44,-1,71,-1,44
1,<environment.Job instance at 0x7fda58b577d0>,44,12,[ 5 13],45,-1,57,-1,45
1,<environment.Job instance at 0x7fda58b57370>,45,14,[7 3],46,-1,60,-1,46
1,<environment.Job instance at 0x7fda58b57820>,47,1,[2 8],48,-1,49,-1,48
1,<environment.Job instance at 0x7fda58b57500>,50,12,[3 6],51,-1,63,-1,51
1,<environment.Job instance at 0x7fda582bf5f0>,53,24,[3 5],54,-1,78,-1,54
1,<environment.Job instance at 0x7fda582bf0a0>,54,14,[4 6],55,-1,69,-1,55
1,<environment.Job instance at 0x7fda582bf3c0>,55,14,[10  1],56,-1,71,-1,57
1,<environment.Job instance at 0x7fda582bf500>,57,17,[2 7],58,-1,75,-1,58
1,<environment.Job instance at 0x7fda582bf410>,58,15,[5 5],59,-1,74,-1,59
1,<environment.Job instance at 0x7fda582bfe60>,61,18,[5 9],62,-1,80,-1,62
1,<environment.Job instance at 0x7fda582bfe10>,63,18,[3 7],64,-1,82,-1,64
1,<environment.Job instance at 0x7fda582bf640>,64,27,[1 8],65,-1,92,-1,65
1,<environment.Job instance at 0x7fda588f55f0>,70,18,[2 7],71,-1,89,-1,71
1,<environment.Job instance at 0x7fda588f5190>,71,15,[6 3],72,-1,87,-1,72
1,<environment.Job instance at 0x7fda588f5640>,73,13,[5 2],74,-1,87,-1,74
1,<environment.Job instance at 0x7fda588f5730>,74,23,[4 5],75,-1,98,-1,75
1,<environment.Job instance at 0x7fda588f5500>,75,13,[8 4],76,-1,89,-1,76
1,<environment.Job instance at 0x7fda588f5eb0>,76,13,[6 5],77,-1,90,-1,77
1,<environment.Job instance at 0x7fda588f50f0>,79,18,[7 4],80,-1,98,-1,80
1,<environment.Job instance at 0x7fda582bfa50>,56,15,[3 6],57,-1,107,-1,92
1,<environment.Job instance at 0x7fda588a8140>,89,20,[6 3],90,-1,114,-1,94
1,<environment.Job instance at 0x7fda588a80f0>,93,20,[5 3],94,-1,115,-1,95
1,<environment.Job instance at 0x7fda588a8780>,95,17,[6 3],96,-1,113,-1,96
1,<environment.Job instance at 0x7fda588a84b0>,96,14,[10  1],97,-1,111,-1,97
1,<environment.Job instance at 0x7fda588a8cd0>,90,17,[5 8],91,-1,132,-1,115
1,<environment.Job instance at 0x7fda588a8320>,88,18,[13  1],89,-1,135,-1,117
1,<environment.Job instance at 0x7fda58d8d6e0>,100,18,[5 6],101,-1,135,-1,117
1,<environment.Job instance at 0x7fda58d8d140>,101,17,[2 9],102,-1,134,-1,117
1,<environment.Job instance at 0x7fda62074910>,106,13,[9 1],107,-1,133,-1,120
1,<environment.Job instance at 0x7fda58d8dc30>,108,16,[13  1],109,-1,136,-1,120
1,<environment.Job instance at 0x7fda58ff6870>,109,14,[5 1],110,-1,134,-1,120
1,<environment.Job instance at 0x7fda62074550>,107,22,[10  1],108,-1,143,-1,121
1,<environment.Job instance at 0x7fda589294b0>,110,20,[3 8],111,-1,141,-1,121
1,<environment.Job instance at 0x7fda588a8280>,84,18,[3 6],85,-1,146,-1,128
1,<environment.Job instance at 0x7fda58fa2730>,116,26,[9 5],117,-1,154,-1,128
1,<environment.Job instance at 0x7fda58e6b870>,119,13,[8 5],120,-1,141,-1,128
1,<environment.Job instance at 0x7fda588a8960>,86,26,[8 5],87,-1,154,-1,128
1,<environment.Job instance at 0x7fda59172dc0>,112,13,[9 2],113,-1,141,-1,128
1,<environment.Job instance at 0x7fda592361e0>,124,17,[1 8],125,-1,145,-1,128
1,<environment.Job instance at 0x7fda5837a1e0>,125,13,[4 7],126,-1,141,-1,128
1,<environment.Job instance at 0x7fda58e81640>,129,22,[7 3],130,-1,152,-1,130
1,<environment.Job instance at 0x7fda587ee410>,140,16,[ 2 10],141,-1,188,-1,172
1,<environment.Job instance at 0x7fda587ee7d0>,137,13,[5 3],138,-1,185,-1,172
1,<environment.Job instance at 0x7fda58ffb280>,143,15,[4 8],144,-1,187,-1,172
1,<environment.Job instance at 0x7fda58ff56e0>,145,15,[ 4 12],146,-1,187,-1,172
1,<environment.Job instance at 0x7fda58a412d0>,146,18,[5 8],147,-1,193,-1,175
1,<environment.Job instance at 0x7fda58af8a00>,132,25,[7 5],133,-1,200,-1,175
1,<environment.Job instance at 0x7fda59147910>,151,18,[8 1],152,-1,204,-1,186
1,<environment.Job instance at 0x7fda591478c0>,152,15,[3 9],153,-1,201,-1,186
1,<environment.Job instance at 0x7fda59147460>,153,20,[8 4],154,-1,206,-1,186
1,<environment.Job instance at 0x7fda59147f00>,157,27,[8 5],158,-1,214,-1,187
1,<environment.Job instance at 0x7fda58a41e10>,148,13,[5 5],149,-1,200,-1,187
1,<environment.Job instance at 0x7fda58e3c500>,161,15,[2 7],162,-1,219,-1,204
1,<environment.Job instance at 0x7fda58e3c5f0>,166,17,[7 3],167,-1,221,-1,204
1,<environment.Job instance at 0x7fda58e6fbe0>,171,17,[9 4],172,-1,238,-1,221
1,<environment.Job instance at 0x7fda58b57960>,8,14,[13  2],9,-1,31,-1,17
1,<environment.Job instance at 0x7fda581106e0>,25,26,[4 8],26,-1,108,-1,82
1,<environment.Job instance at 0x7fda597a2460>,30,25,[5 4],31,-1,110,-1,85
1,<environment.Job instance at 0x7fda59634910>,35,25,[5 7],36,-1,114,-1,89
1,<environment.Job instance at 0x7fda58dc77d0>,39,3,[11  3],40,-1,104,-1,101
1,<environment.Job instance at 0x7fda5876e140>,43,27,[8 5],44,-1,145,-1,118
1,<environment.Job instance at 0x7fda58d69500>,44,12,[ 5 13],45,-1,130,-1,118
1,<environment.Job instance at 0x7fda5834b320>,49,1,[12  4],50,-1,131,-1,130
1,<environment.Job instance at 0x7fda62174f00>,53,24,[3 5],54,-1,158,-1,134
1,<environment.Job instance at 0x7fda59683fa0>,64,27,[1 8],65,-1,224,-1,197
1,<environment.Job instance at 0x7fda5810fbe0>,74,23,[4 5],75,-1,239,-1,216
1,<environment.Job instance at 0x7fda5810ffa0>,77,13,[12  5],78,-1,238,-1,225
1,<environment.Job instance at 0x7fda5838a550>,83,14,[ 4 11],84,-1,259,-1,245
1,<environment.Job instance at 0x7fda5838a0a0>,86,26,[8 5],87,-1,279,-1,253
1,<environment.Job instance at 0x7fda5838a5a0>,88,18,[13  1],89,-1,271,-1,253
1,<environment.Job instance at 0x7fda58415e10>,108,16,[13  1],109,-1,341,-1,325
1,<environment.Job instance at 0x7fda583c4910>,111,3,[11  4],112,-1,347,-1,344
1,<environment.Job instance at 0x7fda583c44b0>,116,26,[9 5],117,-1,387,-1,361
1,<environment.Job instance at 0x7fda584b8730>,127,1,[ 4 12],128,-1,397,-1,396
1,<environment.Job instance at 0x7fda584bf9b0>,130,15,[13  3],131,-1,416,-1,401
1,<environment.Job instance at 0x7fda584c1910>,132,25,[7 5],133,-1,443,-1,418
1,<environment.Job instance at 0x7fda58fad410>,133,2,[14  5],134,-1,420,-1,418
1,<environment.Job instance at 0x7fda58f952d0>,134,2,[13  4],135,-1,420,-1,418
1,<environment.Job instance at 0x7fda58fad870>,136,12,[12  4],137,-1,430,-1,418
1,<environment.Job instance at 0x7fda588c26e0>,145,15,[ 4 12],146,-1,463,-1,448
1,<environment.Job instance at 0x7fda59072410>,157,27,[8 5],158,-1,545,-1,518
1,<environment.Job instance at 0x7fda59072140>,169,2,[ 2 12],170,-1,572,-1,570
1,<environment.Job instance at 0x7fda59072910>,172,24,[4 6],173,-1,610,-1,586
1,<environment.Job instance at 0x7fda590724b0>,173,15,[ 2 13],174,-1,601,-1,586
1,<environment.Job instance at 0x7fda58fa06e0>,177,18,[14  1],178,-1,617,-1,599
1,<environment.Job instance at 0x7fda58fa0960>,183,13,[ 3 11],184,-1,641,-1,628
1,<environment.Job instance at 0x7fda597a2730>,2,19,[2 5],3,-1,23,-1,4
1,<environment.Job instance at 0x7fda59005e60>,3,16,[6 1],4,-1,21,-1,5
1,<environment.Job instance at 0x7fda592e2500>,8,16,[6 5],9,-1,25,-1,9
1,<environment.Job instance at 0x7fda592e23c0>,10,25,[10  4],11,-1,36,-1,11
1,<environment.Job instance at 0x7fda592e22d0>,14,13,[5 7],15,-1,29,-1,16
1,<environment.Job instance at 0x7fda597a2d20>,15,17,[8 5],16,-1,33,-1,16
1,<environment.Job instance at 0x7fda592e24b0>,16,14,[5 7],17,-1,35,-1,21
1,<environment.Job instance at 0x7fda61d1bbe0>,22,15,[4 9],23,-1,38,-1,23
1,<environment.Job instance at 0x7fda61d1b3c0>,23,18,[8 3],24,-1,42,-1,24
1,<environment.Job instance at 0x7fda61d1beb0>,25,15,[7 1],26,-1,42,-1,27
1,<environment.Job instance at 0x7fda61d1bd70>,29,14,[5 3],30,-1,44,-1,30
1,<environment.Job instance at 0x7fda59236be0>,32,18,[8 1],33,-1,51,-1,33
1,<environment.Job instance at 0x7fda59137910>,34,14,[5 8],35,-1,49,-1,35
1,<environment.Job instance at 0x7fda591375a0>,36,20,[10  4],37,-1,57,-1,37
1,<environment.Job instance at 0x7fda591379b0>,38,17,[9 2],39,-1,56,-1,39
1,<environment.Job instance at 0x7fda61d1b1e0>,26,16,[7 5],27,-1,72,-1,56
1,<environment.Job instance at 0x7fda59137640>,43,27,[1 7],44,-1,91,-1,64
1,<environment.Job instance at 0x7fda59137370>,44,18,[6 3],45,-1,88,-1,70
1,<environment.Job instance at 0x7fda58e6f460>,51,25,[9 1],52,-1,95,-1,70
1,<environment.Job instance at 0x7fda59137be0>,42,18,[5 3],43,-1,90,-1,72
1,<environment.Job instance at 0x7fda59137230>,45,18,[ 3 12],46,-1,90,-1,72
1,<environment.Job instance at 0x7fda58e6f050>,53,18,[5 5],54,-1,90,-1,72
1,<environment.Job instance at 0x7fda58e6f2d0>,55,17,[6 4],56,-1,89,-1,72
1,<environment.Job instance at 0x7fda58e6f410>,52,17,[5 9],53,-1,90,-1,73
1,<environment.Job instance at 0x7fda58e6f280>,54,15,[8 2],55,-1,88,-1,73
1,<environment.Job instance at 0x7fda58c3a3c0>,60,27,[5 4],61,-1,104,-1,77
1,<environment.Job instance at 0x7fda58c3aeb0>,61,28,[7 5],62,-1,106,-1,78
1,<environment.Job instance at 0x7fda58e6fdc0>,58,18,[ 3 10],59,-1,98,-1,80
1,<environment.Job instance at 0x7fda59137320>,40,27,[ 3 13],41,-1,108,-1,81
1,<environment.Job instance at 0x7fda58c3aaf0>,63,28,[8 2],64,-1,109,-1,81
1,<environment.Job instance at 0x7fda58e6fe10>,57,18,[5 5],58,-1,99,-1,81
1,<environment.Job instance at 0x7fda58c3a7d0>,73,16,[7 2],74,-1,110,-1,94
1,<environment.Job instance at 0x7fda58c3a690>,68,17,[5 3],69,-1,111,-1,94
1,<environment.Job instance at 0x7fda58c3ae60>,74,12,[9 3],75,-1,107,-1,95
1,<environment.Job instance at 0x7fda58e6f1e0>,56,17,[1 6],57,-1,112,-1,95
1,<environment.Job instance at 0x7fda5967f7d0>,79,12,[10  4],80,-1,107,-1,95
1,<environment.Job instance at 0x7fda62074c80>,80,13,[7 1],81,-1,110,-1,97
1,<environment.Job instance at 0x7fda5967f910>,78,15,[3 9],79,-1,112,-1,97
1,<environment.Job instance at 0x7fda62074870>,84,15,[10  1],85,-1,112,-1,97
1,<environment.Job instance at 0x7fda620746e0>,85,18,[7 4],86,-1,116,-1,98
1,<environment.Job instance at 0x7fda62074f50>,83,19,[7 1],84,-1,117,-1,98
1,<environment.Job instance at 0x7fda62074820>,88,18,[ 2 10],89,-1,117,-1,99
1,<environment.Job instance at 0x7fda5967f550>,77,18,[2 6],78,-1,117,-1,99
1,<environment.Job instance at 0x7fda5952b5f0>,90,17,[ 5 13],91,-1,116,-1,99
1,<environment.Job instance at 0x7fda62074cd0>,87,13,[5 1],88,-1,112,-1,99
1,<environment.Job instance at 0x7fda58c3a0a0>,64,16,[2 5],65,-1,115,-1,99
1,<environment.Job instance at 0x7fda5952bbe0>,89,13,[5 8],90,-1,112,-1,99
1,<environment.Job instance at 0x7fda5952baf0>,93,27,[5 1],94,-1,126,-1,99
1,<environment.Job instance at 0x7fda5952b190>,95,14,[5 9],96,-1,113,-1,99
1,<environment.Job instance at 0x7fda59704be0>,103,18,[6 4],104,-1,129,-1,111
1,<environment.Job instance at 0x7fda59704c80>,104,18,[9 1],105,-1,129,-1,111
1,<environment.Job instance at 0x7fda59704a00>,106,14,[5 7],107,-1,125,-1,111
1,<environment.Job instance at 0x7fda5952b6e0>,92,14,[4 6],93,-1,126,-1,112
1,<environment.Job instance at 0x7fda59634730>,108,16,[1 7],109,-1,128,-1,112
1,<environment.Job instance at 0x7fda59634140>,110,18,[2 9],111,-1,131,-1,113
1,<environment.Job instance at 0x7fda592ab730>,111,12,[13  5],112,-1,125,-1,113
1,<environment.Job instance at 0x7fda59003af0>,113,18,[5 3],114,-1,133,-1,115
1,<environment.Job instance at 0x7fda59704500>,105,17,[14  4],106,-1,132,-1,115
1,<environment.Job instance at 0x7fda59003370>,117,26,[3 7],118,-1,148,-1,122
1,<environment.Job instance at 0x7fda5952b7d0>,94,15,[5 5],95,-1,137,-1,122
1,<environment.Job instance at 0x7fda59513f50>,116,13,[7 1],117,-1,135,-1,122
1,<environment.Job instance at 0x7fda58987960>,118,13,[2 9],119,-1,135,-1,122
1,<environment.Job instance at 0x7fda57febf50>,120,13,[1 6],121,-1,135,-1,122
1,<environment.Job instance at 0x7fda5932d690>,126,18,[5 4],127,-1,145,-1,127
1,<environment.Job instance at 0x7fda61c869b0>,128,12,[5 5],129,-1,143,-1,131
1,<environment.Job instance at 0x7fda61c864b0>,130,17,[7 1],131,-1,149,-1,132
1,<environment.Job instance at 0x7fda57f61050>,131,17,[7 4],132,-1,150,-1,133
1,<environment.Job instance at 0x7fda57f02960>,135,18,[8 2],136,-1,164,-1,146
1,<environment.Job instance at 0x7fda5802ab40>,132,15,[3 6],133,-1,162,-1,147
1,<environment.Job instance at 0x7fda584df960>,144,13,[5 5],145,-1,160,-1,147
1,<environment.Job instance at 0x7fda584dfb40>,145,14,[11  2],146,-1,161,-1,147
1,<environment.Job instance at 0x7fda57f5b050>,129,25,[3 8],130,-1,173,-1,148
1,<environment.Job instance at 0x7fda57e84370>,141,18,[13  5],142,-1,166,-1,148
1,<environment.Job instance at 0x7fda57e846e0>,137,28,[4 9],138,-1,176,-1,148
1,<environment.Job instance at 0x7fda57e848c0>,142,13,[9 3],143,-1,161,-1,148
1,<environment.Job instance at 0x7fda57e8d780>,146,15,[10  2],147,-1,165,-1,150
1,<environment.Job instance at 0x7fda594fea50>,150,14,[10  4],151,-1,166,-1,152
1,<environment.Job instance at 0x7fda57e3d1e0>,158,16,[10  1],159,-1,180,-1,164
1,<environment.Job instance at 0x7fda57e3d370>,160,18,[2 8],161,-1,185,-1,167
1,<environment.Job instance at 0x7fda57e30a00>,165,18,[9 1],166,-1,185,-1,167
1,<environment.Job instance at 0x7fda57e30730>,163,14,[5 7],164,-1,193,-1,179
1,<environment.Job instance at 0x7fda585adf50>,175,13,[2 6],176,-1,195,-1,182
1,<environment.Job instance at 0x7fda585ad370>,174,21,[8 1],175,-1,203,-1,182
1,<environment.Job instance at 0x7fda57fb1cd0>,179,25,[ 3 10],180,-1,207,-1,182
1,<environment.Job instance at 0x7fda580a8d70>,180,18,[ 2 11],181,-1,200,-1,182
1,<environment.Job instance at 0x7fda57e58370>,184,17,[5 4],185,-1,202,-1,185
1,<environment.Job instance at 0x7fda59007460>,185,15,[9 4],186,-1,201,-1,186
1,<environment.Job instance at 0x7fda57e3de60>,159,18,[8 2],160,-1,205,-1,187
1,<environment.Job instance at 0x7fda57e58a50>,186,15,[4 7],187,-1,202,-1,187
1,<environment.Job instance at 0x7fda59007140>,187,23,[9 2],188,-1,211,-1,188
1,<environment.Job instance at 0x7fda592e2af0>,0,12,[ 3 12],1,-1,13,-1,1
1,<environment.Job instance at 0x7fda57e3d320>,10,25,[10  4],11,-1,60,-1,35
1,<environment.Job instance at 0x7fda582bf9b0>,27,16,[13  1],28,-1,88,-1,72
1,<environment.Job instance at 0x7fda58b44eb0>,31,2,[13  4],32,-1,97,-1,95
1,<environment.Job instance at 0x7fda621ecf00>,40,27,[ 3 13],41,-1,155,-1,128
1,<environment.Job instance at 0x7fda5907d500>,43,27,[1 7],44,-1,166,-1,139
1,<environment.Job instance at 0x7fda57f86a50>,45,18,[ 3 12],46,-1,161,-1,143
1,<environment.Job instance at 0x7fda58304f50>,50,1,[12  1],51,-1,166,-1,165
1,<environment.Job instance at 0x7fda580936e0>,51,25,[9 1],52,-1,208,-1,183
1,<environment.Job instance at 0x7fda57f400a0>,60,27,[5 4],61,-1,249,-1,222
1,<environment.Job instance at 0x7fda57f409b0>,61,28,[7 5],62,-1,250,-1,222
1,<environment.Job instance at 0x7fda582f2370>,63,28,[8 2],64,-1,256,-1,228
1,<environment.Job instance at 0x7fda583160f0>,81,1,[ 5 14],82,-1,292,-1,291
1,<environment.Job instance at 0x7fda59702820>,90,17,[ 5 13],91,-1,335,-1,318
1,<environment.Job instance at 0x7fda580a30f0>,93,27,[5 1],94,-1,357,-1,330
1,<environment.Job instance at 0x7fda580a35f0>,96,2,[ 5 12],97,-1,346,-1,344
1,<environment.Job instance at 0x7fda57fa5e10>,105,17,[14  4],106,-1,387,-1,370
1,<environment.Job instance at 0x7fda57f84b40>,111,12,[13  5],112,-1,412,-1,400
1,<environment.Job instance at 0x7fda57fe2050>,117,26,[3 7],118,-1,449,-1,423
1,<environment.Job instance at 0x7fda57f878c0>,127,1,[ 2 11],128,-1,444,-1,443
1,<environment.Job instance at 0x7fda58241550>,129,25,[3 8],130,-1,478,-1,453
1,<environment.Job instance at 0x7fda5823f8c0>,137,28,[4 9],138,-1,517,-1,489
1,<environment.Job instance at 0x7fda5810f780>,141,18,[13  5],142,-1,508,-1,490
1,<environment.Job instance at 0x7fda580476e0>,145,14,[11  2],146,-1,522,-1,508
1,<environment.Job instance at 0x7fda62174eb0>,148,1,[14  2],149,-1,512,-1,511
1,<environment.Job instance at 0x7fda58286c30>,149,1,[ 1 11],150,-1,512,-1,511
1,<environment.Job instance at 0x7fda59284e10>,3,17,[7 4],4,-1,22,-1,5
1,<environment.Job instance at 0x7fda59284cd0>,5,15,[9 1],6,-1,24,-1,9
1,<environment.Job instance at 0x7fda61ce85f0>,8,16,[6 5],9,-1,25,-1,9
1,<environment.Job instance at 0x7fda61ce8320>,12,18,[ 2 10],13,-1,32,-1,14
1,<environment.Job instance at 0x7fda61ce8cd0>,14,12,[9 4],15,-1,27,-1,15
1,<environment.Job instance at 0x7fda61ce8dc0>,13,14,[4 9],14,-1,31,-1,17
1,<environment.Job instance at 0x7fda61ce8500>,21,18,[5 5],22,-1,40,-1,22
1,<environment.Job instance at 0x7fda59122960>,24,16,[4 7],25,-1,42,-1,26
1,<environment.Job instance at 0x7fda59739500>,37,18,[3 9],38,-1,57,-1,39
1,<environment.Job instance at 0x7fda59739460>,39,14,[5 4],40,-1,55,-1,41
1,<environment.Job instance at 0x7fda59739320>,43,24,[3 5],44,-1,68,-1,44
1,<environment.Job instance at 0x7fda61d11d70>,48,17,[10  4],49,-1,75,-1,58
1,<environment.Job instance at 0x7fda59739230>,36,13,[ 4 12],37,-1,71,-1,58
1,<environment.Job instance at 0x7fda597398c0>,42,15,[ 1 10],43,-1,73,-1,58
1,<environment.Job instance at 0x7fda61d11690>,53,17,[4 9],54,-1,75,-1,58
1,<environment.Job instance at 0x7fda61d11f00>,51,17,[4 7],52,-1,75,-1,58
1,<environment.Job instance at 0x7fda61d118c0>,50,14,[2 8],51,-1,72,-1,58
1,<environment.Job instance at 0x7fda61d115a0>,58,16,[9 2],59,-1,75,-1,59
1,<environment.Job instance at 0x7fda59139410>,60,26,[4 8],61,-1,87,-1,61
1,<environment.Job instance at 0x7fda59139050>,59,24,[7 1],60,-1,85,-1,61
1,<environment.Job instance at 0x7fda591220f0>,23,24,[4 7],24,-1,85,-1,61
1,<environment.Job instance at 0x7fda59139d20>,61,16,[2 7],62,-1,81,-1,65
1,<environment.Job instance at 0x7fda59139730>,65,18,[6 2],66,-1,84,-1,66
1,<environment.Job instance at 0x7fda59139d70>,70,18,[8 5],71,-1,97,-1,79
1,<environment.Job instance at 0x7fda59139230>,72,18,[4 5],73,-1,99,-1,81
1,<environment.Job instance at 0x7fda59139910>,73,18,[8 1],74,-1,99,-1,81
1,<environment.Job instance at 0x7fda59122c80>,28,23,[ 4 10],29,-1,112,-1,89
1,<environment.Job instance at 0x7fda591399b0>,64,15,[3 8],65,-1,104,-1,89
1,<environment.Job instance at 0x7fda593b6780>,78,17,[10  4],79,-1,106,-1,89
1,<environment.Job instance at 0x7fda59139500>,68,13,[ 5 10],69,-1,102,-1,89
1,<environment.Job instance at 0x7fda593b6960>,79,15,[5 9],80,-1,104,-1,89
1,<environment.Job instance at 0x7fda593b6820>,82,16,[3 5],83,-1,105,-1,89
1,<environment.Job instance at 0x7fda593b6140>,76,13,[5 6],77,-1,102,-1,89
1,<environment.Job instance at 0x7fda593b6910>,85,22,[1 9],86,-1,111,-1,89
1,<environment.Job instance at 0x7fda61c8ca00>,89,18,[ 3 12],90,-1,118,-1,100
1,<environment.Job instance at 0x7fda593b6be0>,75,15,[12  1],76,-1,115,-1,100
1,<environment.Job instance at 0x7fda593b6370>,90,18,[7 3],91,-1,118,-1,100
1,<environment.Job instance at 0x7fda61c8c0a0>,93,17,[10  3],94,-1,117,-1,100
1,<environment.Job instance at 0x7fda595abf50>,96,12,[4 7],97,-1,112,-1,100
1,<environment.Job instance at 0x7fda59613690>,98,17,[3 8],99,-1,117,-1,100
1,<environment.Job instance at 0x7fda58af2dc0>,99,15,[ 5 10],100,-1,116,-1,101
1,<environment.Job instance at 0x7fda596130f0>,97,15,[6 4],98,-1,116,-1,101
1,<environment.Job instance at 0x7fda61d11eb0>,52,15,[2 7],53,-1,117,-1,102
1,<environment.Job instance at 0x7fda622bf5a0>,101,17,[ 2 10],102,-1,119,-1,102
1,<environment.Job instance at 0x7fda596ba6e0>,103,18,[9 2],104,-1,122,-1,104
1,<environment.Job instance at 0x7fda596ba960>,104,24,[5 9],105,-1,129,-1,105
1,<environment.Job instance at 0x7fda596ba460>,105,16,[10  3],106,-1,122,-1,106
1,<environment.Job instance at 0x7fda596ba5a0>,107,26,[8 5],108,-1,134,-1,108
1,<environment.Job instance at 0x7fda596ba550>,109,15,[6 5],110,-1,125,-1,110
1,<environment.Job instance at 0x7fda596baf50>,110,17,[10  1],111,-1,130,-1,113
1,<environment.Job instance at 0x7fda596baa50>,113,26,[7 5],114,-1,140,-1,114
1,<environment.Job instance at 0x7fda57f19410>,114,16,[3 9],115,-1,131,-1,115
1,<environment.Job instance at 0x7fda5831fd70>,116,20,[3 6],117,-1,140,-1,120
1,<environment.Job instance at 0x7fda58b65fa0>,119,16,[8 5],120,-1,137,-1,121
1,<environment.Job instance at 0x7fda590bc730>,122,18,[4 7],123,-1,142,-1,124
1,<environment.Job instance at 0x7fda58dc99b0>,125,17,[9 3],126,-1,143,-1,126
1,<environment.Job instance at 0x7fda582439b0>,117,18,[ 3 10],118,-1,150,-1,132
1,<environment.Job instance at 0x7fda5870f320>,112,13,[9 1],113,-1,145,-1,132
1,<environment.Job instance at 0x7fda58b330f0>,129,15,[5 5],130,-1,147,-1,132
1,<environment.Job instance at 0x7fda58b0e730>,146,23,[10  4],147,-1,176,-1,153
1,<environment.Job instance at 0x7fda58b0e140>,145,17,[5 9],146,-1,177,-1,160
1,<environment.Job instance at 0x7fda58f3dd20>,149,18,[9 5],150,-1,183,-1,165
1,<environment.Job instance at 0x7fda58f3dc80>,152,18,[10  5],153,-1,188,-1,170
1,<environment.Job instance at 0x7fda58b0e5a0>,148,17,[4 9],149,-1,191,-1,174
1,<environment.Job instance at 0x7fda58f30e10>,138,16,[ 5 13],139,-1,202,-1,186
1,<environment.Job instance at 0x7fda58d05af0>,141,15,[14  4],142,-1,216,-1,201
1,<environment.Job instance at 0x7fda58b66050>,161,17,[7 2],162,-1,218,-1,201
1,<environment.Job instance at 0x7fda58b66c30>,163,16,[3 9],164,-1,217,-1,201
1,<environment.Job instance at 0x7fda58b669b0>,164,13,[10  1],165,-1,214,-1,201
1,<environment.Job instance at 0x7fda582dde60>,159,12,[5 9],160,-1,213,-1,201
1,<environment.Job instance at 0x7fda58d4b050>,169,25,[8 3],170,-1,238,-1,213
1,<environment.Job instance at 0x7fda58b667d0>,160,12,[2 9],161,-1,225,-1,213
1,<environment.Job instance at 0x7fda621f0230>,171,17,[3 7],172,-1,230,-1,213
1,<environment.Job instance at 0x7fda59610be0>,174,18,[8 2],175,-1,231,-1,213
1,<environment.Job instance at 0x7fda596105a0>,173,18,[2 6],174,-1,231,-1,213
1,<environment.Job instance at 0x7fda59610410>,172,24,[11  1],173,-1,238,-1,214
1,<environment.Job instance at 0x7fda597963c0>,177,18,[5 2],178,-1,232,-1,214
1,<environment.Job instance at 0x7fda58d3d780>,176,17,[1 6],177,-1,231,-1,214
1,<environment.Job instance at 0x7fda593b6aa0>,16,17,[ 1 14],17,-1,48,-1,31
1,<environment.Job instance at 0x7fda596ba9b0>,19,18,[14  4],20,-1,61,-1,43
1,<environment.Job instance at 0x7fda58b33b40>,23,24,[4 7],24,-1,83,-1,59
1,<environment.Job instance at 0x7fda58b0e6e0>,28,23,[ 4 10],29,-1,98,-1,75
1,<environment.Job instance at 0x7fda58e37550>,35,13,[ 3 12],36,-1,96,-1,83
1,<environment.Job instance at 0x7fda5952e7d0>,36,13,[ 4 12],37,-1,96,-1,83
1,<environment.Job instance at 0x7fda5850e8c0>,43,24,[3 5],44,-1,125,-1,101
1,<environment.Job instance at 0x7fda57f625f0>,59,24,[7 1],60,-1,208,-1,184
1,<environment.Job instance at 0x7fda57f62730>,60,26,[4 8],61,-1,219,-1,193
1,<environment.Job instance at 0x7fda57fece60>,75,15,[12  1],76,-1,266,-1,251
1,<environment.Job instance at 0x7fda583160f0>,83,1,[ 3 13],84,-1,288,-1,287
1,<environment.Job instance at 0x7fda5841f550>,89,18,[ 3 12],90,-1,321,-1,303
1,<environment.Job instance at 0x7fda5959b870>,95,1,[ 5 13],96,-1,311,-1,310
1,<environment.Job instance at 0x7fda585f6c80>,104,24,[5 9],105,-1,399,-1,375
1,<environment.Job instance at 0x7fda580936e0>,107,26,[8 5],108,-1,406,-1,380
1,<environment.Job instance at 0x7fda5907d500>,113,26,[7 5],114,-1,424,-1,398
1,<environment.Job instance at 0x7fda583043c0>,115,2,[13  2],116,-1,400,-1,398
1,<environment.Job instance at 0x7fda588f5af0>,123,3,[11  3],124,-1,447,-1,444
1,<environment.Job instance at 0x7fda59704820>,138,16,[ 5 13],139,-1,496,-1,480
1,<environment.Job instance at 0x7fda62074730>,141,15,[14  4],142,-1,496,-1,481
1,<environment.Job instance at 0x7fda61c8ca50>,146,23,[10  4],147,-1,534,-1,511
1,<environment.Job instance at 0x7fda58b12e60>,169,25,[8 3],170,-1,650,-1,625
1,<environment.Job instance at 0x7fda5852a730>,172,24,[11  1],173,-1,649,-1,625
1,<environment.Job instance at 0x7fda59604690>,3,18,[ 3 10],4,-1,22,-1,4
1,<environment.Job instance at 0x7fda59604af0>,8,12,[10  2],9,-1,24,-1,12
1,<environment.Job instance at 0x7fda59604e10>,12,14,[ 1 10],13,-1,27,-1,13
1,<environment.Job instance at 0x7fda59604d20>,11,15,[9 5],12,-1,29,-1,14
1,<environment.Job instance at 0x7fda5961c0f0>,15,15,[10  1],16,-1,32,-1,17
1,<environment.Job instance at 0x7fda5961c230>,16,21,[3 7],17,-1,38,-1,17
1,<environment.Job instance at 0x7fda5961c1e0>,17,15,[ 3 10],18,-1,33,-1,18
1,<environment.Job instance at 0x7fda5961c320>,18,28,[8 3],19,-1,47,-1,19
1,<environment.Job instance at 0x7fda5961c3c0>,19,20,[1 9],20,-1,40,-1,20
1,<environment.Job instance at 0x7fda5961c500>,21,17,[5 6],22,-1,39,-1,22
1,<environment.Job instance at 0x7fda5961c690>,22,16,[10  1],23,-1,40,-1,24
1,<environment.Job instance at 0x7fda5961c780>,24,12,[4 9],25,-1,37,-1,25
1,<environment.Job instance at 0x7fda5961c820>,25,12,[7 2],26,-1,38,-1,26
1,<environment.Job instance at 0x7fda5961c6e0>,23,17,[ 2 10],24,-1,43,-1,26
1,<environment.Job instance at 0x7fda5961ca00>,28,15,[10  2],29,-1,45,-1,30
1,<environment.Job instance at 0x7fda5961c8c0>,29,18,[3 8],30,-1,49,-1,31
1,<environment.Job instance at 0x7fda595f22d0>,36,13,[8 3],37,-1,51,-1,38
1,<environment.Job instance at 0x7fda595f2370>,38,15,[8 2],39,-1,54,-1,39
1,<environment.Job instance at 0x7fda595f2730>,43,12,[5 9],44,-1,60,-1,48
1,<environment.Job instance at 0x7fda595f2fa0>,49,20,[2 8],50,-1,71,-1,51
1,<environment.Job instance at 0x7fda595ec0a0>,51,19,[5 5],52,-1,71,-1,52
1,<environment.Job instance at 0x7fda595ec1e0>,53,18,[8 1],54,-1,72,-1,54
1,<environment.Job instance at 0x7fda595ec320>,54,13,[10  5],55,-1,68,-1,55
1,<environment.Job instance at 0x7fda595ec870>,60,18,[5 7],61,-1,79,-1,61
1,<environment.Job instance at 0x7fda595eca50>,61,23,[5 9],62,-1,89,-1,66
1,<environment.Job instance at 0x7fda5961f690>,78,19,[ 5 11],79,-1,406,-1,387
1,<environment.Job instance at 0x7fda5961adc0>,110,12,[ 4 12],111,-1,401,-1,389
1,<environment.Job instance at 0x7fda58c91140>,115,15,[4 9],116,-1,404,-1,389
1,<environment.Job instance at 0x7fda5961afa0>,113,18,[6 1],114,-1,407,-1,389
1,<environment.Job instance at 0x7fda58c91280>,117,17,[3 7],118,-1,406,-1,389
1,<environment.Job instance at 0x7fda58c91320>,118,16,[8 5],119,-1,405,-1,389
1,<environment.Job instance at 0x7fda58c913c0>,119,16,[5 1],120,-1,405,-1,389
1,<environment.Job instance at 0x7fda5961aa00>,104,25,[8 2],105,-1,414,-1,389
1,<environment.Job instance at 0x7fda58c916e0>,124,2,[2 8],125,-1,391,-1,389
1,<environment.Job instance at 0x7fda58c91820>,126,1,[1 5],127,-1,390,-1,389
1,<environment.Job instance at 0x7fda58c91500>,121,12,[4 8],122,-1,401,-1,389
1,<environment.Job instance at 0x7fda58c91960>,128,14,[3 7],129,-1,403,-1,389
1,<environment.Job instance at 0x7fda59168aa0>,129,27,[5 8],130,-1,416,-1,389
1,<environment.Job instance at 0x7fda58c918c0>,127,2,[10  1],128,-1,391,-1,389
1,<environment.Job instance at 0x7fda5862fcd0>,131,12,[10  5],132,-1,401,-1,389
1,<environment.Job instance at 0x7fda5961a960>,103,27,[9 4],104,-1,416,-1,389
1,<environment.Job instance at 0x7fda597a2320>,130,13,[5 8],131,-1,402,-1,389
1,<environment.Job instance at 0x7fda585f1370>,132,15,[ 5 10],133,-1,404,-1,389
1,<environment.Job instance at 0x7fda58c91780>,125,22,[9 4],126,-1,411,-1,389
1,<environment.Job instance at 0x7fda5860c500>,137,14,[6 2],138,-1,403,-1,389
1,<environment.Job instance at 0x7fda58f45910>,135,12,[3 5],136,-1,403,-1,391
1,<environment.Job instance at 0x7fda596174b0>,146,12,[3 8],147,-1,404,-1,392
1,<environment.Job instance at 0x7fda596170f0>,148,17,[3 7],149,-1,409,-1,392
1,<environment.Job instance at 0x7fda596172d0>,149,12,[ 5 10],150,-1,404,-1,392
1,<environment.Job instance at 0x7fda59617190>,150,18,[9 4],151,-1,410,-1,392
1,<environment.Job instance at 0x7fda596173c0>,147,3,[6 4],148,-1,395,-1,392
1,<environment.Job instance at 0x7fda5860ebe0>,136,22,[3 8],137,-1,414,-1,392
1,<environment.Job instance at 0x7fda5961e500>,154,17,[14  4],155,-1,410,-1,393
1,<environment.Job instance at 0x7fda59600320>,151,12,[ 4 10],152,-1,405,-1,393
1,<environment.Job instance at 0x7fda58c91eb0>,166,24,[13  3],167,-1,494,-1,470
1,<environment.Job instance at 0x7fda58ca5b40>,13,2,[12  1],14,-1,26,-1,24
1,<environment.Job instance at 0x7fda58ca5e10>,14,1,[ 5 14],15,-1,25,-1,24
1,<environment.Job instance at 0x7fda58ca5af0>,18,28,[8 3],19,-1,57,-1,29
1,<environment.Job instance at 0x7fda58c86370>,26,13,[ 5 11],27,-1,72,-1,59
1,<environment.Job instance at 0x7fda58c86820>,27,2,[13  1],28,-1,61,-1,59
1,<environment.Job instance at 0x7fda58ca3140>,34,1,[11  3],35,-1,102,-1,101
1,<environment.Job instance at 0x7fda58cb4140>,41,13,[ 1 13],42,-1,145,-1,132
1,<environment.Job instance at 0x7fda58ca3b40>,42,27,[9 1],43,-1,177,-1,150
1,<environment.Job instance at 0x7fda58cb4dc0>,46,21,[12  2],47,-1,173,-1,152
1,<environment.Job instance at 0x7fda58cb4be0>,48,14,[ 1 14],49,-1,166,-1,152
1,<environment.Job instance at 0x7fda59604410>,50,15,[12  3],51,-1,168,-1,153
1,<environment.Job instance at 0x7fda5852aaf0>,56,2,[12  3],57,-1,170,-1,168
1,<environment.Job instance at 0x7fda5852a5f0>,61,23,[5 9],62,-1,207,-1,184
1,<environment.Job instance at 0x7fda58b12d70>,65,15,[ 4 12],66,-1,207,-1,192
1,<environment.Job instance at 0x7fda58b12af0>,69,3,[ 4 11],70,-1,206,-1,203
1,<environment.Job instance at 0x7fda58b126e0>,71,26,[7 2],72,-1,237,-1,211
1,<environment.Job instance at 0x7fda58b12550>,72,2,[ 2 13],73,-1,213,-1,211
1,<environment.Job instance at 0x7fda58b120a0>,76,12,[11  2],77,-1,227,-1,215
1,<environment.Job instance at 0x7fda58b12320>,77,1,[14  5],78,-1,216,-1,215
1,<environment.Job instance at 0x7fda58b12870>,78,19,[ 5 11],79,-1,234,-1,215
1,<environment.Job instance at 0x7fda61c8c690>,88,1,[ 4 13],89,-1,255,-1,254
1,<environment.Job instance at 0x7fda597040f0>,92,2,[ 3 14],93,-1,259,-1,257
1,<environment.Job instance at 0x7fda5823bcd0>,94,23,[8 3],95,-1,288,-1,265
1,<environment.Job instance at 0x7fda582bf280>,99,1,[11  4],100,-1,268,-1,267
1,<environment.Job instance at 0x7fda58b44af0>,103,27,[9 4],104,-1,308,-1,281
1,<environment.Job instance at 0x7fda58b44e10>,104,25,[8 2],105,-1,306,-1,281
1,<environment.Job instance at 0x7fda5907d500>,110,12,[ 4 12],111,-1,299,-1,287
1,<environment.Job instance at 0x7fda57f40eb0>,129,27,[5 8],130,-1,396,-1,369
1,<environment.Job instance at 0x7fda583f2960>,145,15,[13  3],146,-1,450,-1,435
1,<environment.Job instance at 0x7fda57fa50a0>,152,1,[14  1],153,-1,451,-1,450
1,<environment.Job instance at 0x7fda57fe2280>,154,17,[14  4],155,-1,476,-1,459
1,<environment.Job instance at 0x7fda59128a50>,158,24,[8 2],159,-1,505,-1,481
1,<environment.Job instance at 0x7fda58241550>,159,27,[ 3 13],160,-1,508,-1,481
1,<environment.Job instance at 0x7fda57f42410>,160,18,[ 2 12],161,-1,499,-1,481
1,<environment.Job instance at 0x7fda5823feb0>,166,24,[13  3],167,-1,521,-1,497
1,<environment.Job instance at 0x7fda594678c0>,1,17,[3 7],2,-1,19,-1,2
1,<environment.Job instance at 0x7fda61d115f0>,3,14,[4 6],4,-1,18,-1,4
1,<environment.Job instance at 0x7fda61d110a0>,4,15,[9 2],5,-1,20,-1,5
1,<environment.Job instance at 0x7fda59060370>,6,12,[5 8],7,-1,19,-1,7
1,<environment.Job instance at 0x7fda5892bf00>,9,15,[4 6],10,-1,25,-1,10
1,<environment.Job instance at 0x7fda5892b730>,12,14,[9 2],13,-1,28,-1,14
1,<environment.Job instance at 0x7fda58911780>,15,16,[5 1],16,-1,32,-1,16
1,<environment.Job instance at 0x7fda58911aa0>,18,12,[9 4],19,-1,31,-1,19
1,<environment.Job instance at 0x7fda589111e0>,20,20,[7 1],21,-1,41,-1,21
1,<environment.Job instance at 0x7fda58dc7500>,21,14,[9 4],22,-1,36,-1,22
1,<environment.Job instance at 0x7fda58dc70a0>,23,17,[3 7],24,-1,41,-1,24
1,<environment.Job instance at 0x7fda5818c4b0>,31,16,[9 2],32,-1,52,-1,36
1,<environment.Job instance at 0x7fda5818c500>,35,13,[10  4],36,-1,49,-1,36
1,<environment.Job instance at 0x7fda588c9910>,43,17,[7 2],44,-1,67,-1,50
1,<environment.Job instance at 0x7fda588c90f0>,45,24,[7 4],46,-1,107,-1,83
1,<environment.Job instance at 0x7fda586985f0>,53,18,[8 3],54,-1,101,-1,83
1,<environment.Job instance at 0x7fda58ec4050>,59,18,[ 1 10],60,-1,112,-1,94
1,<environment.Job instance at 0x7fda621e9910>,13,14,[9 2],14,-1,108,-1,94
1,<environment.Job instance at 0x7fda581408c0>,65,18,[4 5],66,-1,112,-1,94
1,<environment.Job instance at 0x7fda5818c820>,33,14,[ 4 10],34,-1,108,-1,94
1,<environment.Job instance at 0x7fda61d1c5f0>,55,25,[6 2],56,-1,122,-1,97
1,<environment.Job instance at 0x7fda58e65230>,67,17,[8 3],68,-1,114,-1,97
1,<environment.Job instance at 0x7fda582630a0>,72,21,[9 5],73,-1,140,-1,119
1,<environment.Job instance at 0x7fda596c75f0>,66,26,[10  2],67,-1,146,-1,120
1,<environment.Job instance at 0x7fda58eecaf0>,84,18,[9 2],85,-1,174,-1,156
1,<environment.Job instance at 0x7fda59161fa0>,90,15,[10  5],91,-1,186,-1,171
1,<environment.Job instance at 0x7fda58a1eaa0>,87,15,[5 9],88,-1,186,-1,171
1,<environment.Job instance at 0x7fda58a1e230>,85,18,[10  4],86,-1,190,-1,172
1,<environment.Job instance at 0x7fda5823edc0>,97,17,[2 7],98,-1,200,-1,183
1,<environment.Job instance at 0x7fda5860d730>,10,26,[2 8],11,-1,54,-1,28
1,<environment.Job instance at 0x7fda5918d7d0>,19,17,[12  4],20,-1,76,-1,59
1,<environment.Job instance at 0x7fda5918d780>,25,17,[ 1 11],26,-1,91,-1,74
1,<environment.Job instance at 0x7fda58f6f370>,27,13,[12  4],28,-1,87,-1,74
1,<environment.Job instance at 0x7fda58dc7c30>,40,24,[ 4 14],41,-1,154,-1,130
1,<environment.Job instance at 0x7fda589117d0>,44,14,[ 1 11],45,-1,146,-1,132
1,<environment.Job instance at 0x7fda588c5820>,45,24,[7 4],46,-1,171,-1,147
1,<environment.Job instance at 0x7fda57fa5e10>,55,25,[6 2],56,-1,207,-1,182
1,<environment.Job instance at 0x7fda588f5370>,56,2,[ 1 13],57,-1,184,-1,182
1,<environment.Job instance at 0x7fda58b12730>,66,26,[10  2],67,-1,245,-1,219
1,<environment.Job instance at 0x7fda58cb4be0>,74,1,[12  5],75,-1,251,-1,250
1,<environment.Job instance at 0x7fda58b12b90>,75,1,[ 2 14],76,-1,251,-1,250
1,<environment.Job instance at 0x7fda58cb4870>,77,2,[14  3],78,-1,252,-1,250
1,<environment.Job instance at 0x7fda58c864b0>,88,28,[ 2 11],89,-1,316,-1,288
1,<environment.Job instance at 0x7fda58c866e0>,96,15,[ 2 12],97,-1,346,-1,331
1,<environment.Job instance at 0x7fda58ca50f0>,100,12,[ 1 11],101,-1,352,-1,340
1,<environment.Job instance at 0x7fda58ca53c0>,103,15,[ 5 12],104,-1,369,-1,354
1,<environment.Job instance at 0x7fda5818c320>,120,17,[11  3],121,-1,449,-1,432
1,<environment.Job instance at 0x7fda58538aa0>,137,24,[8 1],138,-1,525,-1,501
1,<environment.Job instance at 0x7fda58a1ee60>,141,28,[5 9],142,-1,536,-1,508
1,<environment.Job instance at 0x7fda57e4a3c0>,143,28,[6 1],144,-1,543,-1,515
1,<environment.Job instance at 0x7fda58b4d550>,148,23,[ 3 10],149,-1,557,-1,534
1,<environment.Job instance at 0x7fda592d1960>,153,18,[ 5 11],154,-1,569,-1,551
1,<environment.Job instance at 0x7fda591acd70>,163,1,[13  4],164,-1,576,-1,575
1,<environment.Job instance at 0x7fda591ac870>,164,17,[12  2],165,-1,592,-1,575
1,<environment.Job instance at 0x7fda59538500>,179,16,[ 4 14],186,-1,647,-1,631
1,<environment.Job instance at 0x7fda593244b0>,1,16,[6 2],2,-1,18,-1,2
1,<environment.Job instance at 0x7fda5856d1e0>,2,20,[1 9],3,-1,23,-1,3
1,<environment.Job instance at 0x7fda5856d0f0>,3,18,[3 7],4,-1,22,-1,4
1,<environment.Job instance at 0x7fda5856d500>,6,18,[3 6],7,-1,25,-1,7
1,<environment.Job instance at 0x7fda5856dd70>,18,22,[10  5],19,-1,49,-1,27
1,<environment.Job instance at 0x7fda58551140>,23,12,[10  3],24,-1,40,-1,28
1,<environment.Job instance at 0x7fda585511e0>,24,25,[9 4],25,-1,53,-1,28
1,<environment.Job instance at 0x7fda58551a50>,30,25,[9 5],31,-1,56,-1,31
1,<environment.Job instance at 0x7fda5856dfa0>,20,17,[2 7],21,-1,52,-1,35
1,<environment.Job instance at 0x7fda58551f00>,35,22,[6 4],36,-1,58,-1,36
1,<environment.Job instance at 0x7fda585330a0>,36,15,[7 3],37,-1,57,-1,42
1,<environment.Job instance at 0x7fda5856d910>,14,18,[2 9],15,-1,60,-1,42
1,<environment.Job instance at 0x7fda58533230>,38,13,[2 8],39,-1,55,-1,42
1,<environment.Job instance at 0x7fda58533370>,40,26,[10  1],41,-1,68,-1,42
1,<environment.Job instance at 0x7fda58533410>,41,16,[ 2 10],42,-1,58,-1,42
1,<environment.Job instance at 0x7fda58533140>,42,22,[2 7],43,-1,65,-1,43
1,<environment.Job instance at 0x7fda58551cd0>,37,15,[5 4],38,-1,61,-1,46
1,<environment.Job instance at 0x7fda5856da50>,15,26,[5 5],16,-1,72,-1,46
1,<environment.Job instance at 0x7fda585331e0>,45,16,[10  3],46,-1,62,-1,46
1,<environment.Job instance at 0x7fda58533640>,43,13,[5 1],44,-1,60,-1,47
1,<environment.Job instance at 0x7fda58533af0>,49,17,[1 9],50,-1,67,-1,50
1,<environment.Job instance at 0x7fda58533c80>,50,15,[9 4],51,-1,66,-1,51
1,<environment.Job instance at 0x7fda58533730>,46,18,[8 3],47,-1,75,-1,57
1,<environment.Job instance at 0x7fda58533500>,44,12,[1 9],45,-1,74,-1,62
1,<environment.Job instance at 0x7fda58533eb0>,55,27,[5 8],56,-1,90,-1,63
1,<environment.Job instance at 0x7fda585339b0>,52,17,[9 5],53,-1,80,-1,63
1,<environment.Job instance at 0x7fda58533fa0>,54,18,[6 4],55,-1,81,-1,63
1,<environment.Job instance at 0x7fda585467d0>,63,18,[10  5],64,-1,82,-1,64
1,<environment.Job instance at 0x7fda58546640>,65,12,[9 4],66,-1,81,-1,69
1,<environment.Job instance at 0x7fda58546af0>,71,21,[4 7],72,-1,93,-1,72
1,<environment.Job instance at 0x7fda585461e0>,57,25,[6 4],58,-1,106,-1,81
1,<environment.Job instance at 0x7fda585307d0>,80,18,[7 3],81,-1,104,-1,86
1,<environment.Job instance at 0x7fda58530aa0>,81,26,[5 4],82,-1,112,-1,86
1,<environment.Job instance at 0x7fda585460a0>,56,16,[6 4],57,-1,102,-1,86
1,<environment.Job instance at 0x7fda585305f0>,77,13,[ 2 10],78,-1,99,-1,86
1,<environment.Job instance at 0x7fda58546280>,59,25,[10  1],60,-1,111,-1,86
1,<environment.Job instance at 0x7fda58530b90>,86,17,[5 2],87,-1,105,-1,88
1,<environment.Job instance at 0x7fda5853c140>,88,26,[ 3 10],89,-1,115,-1,89
1,<environment.Job instance at 0x7fda5853c280>,90,22,[ 3 10],91,-1,113,-1,91
1,<environment.Job instance at 0x7fda58530be0>,87,18,[1 7],88,-1,122,-1,104
1,<environment.Job instance at 0x7fda5853c5f0>,93,12,[5 8],94,-1,116,-1,104
1,<environment.Job instance at 0x7fda5853cb90>,101,16,[5 4],102,-1,125,-1,109
1,<environment.Job instance at 0x7fda5853caf0>,102,18,[2 9],103,-1,128,-1,110
1,<environment.Job instance at 0x7fda58530460>,75,17,[4 6],76,-1,127,-1,110
1,<environment.Job instance at 0x7fda5853caa0>,103,14,[3 7],104,-1,124,-1,110
1,<environment.Job instance at 0x7fda590d6cd0>,105,13,[6 3],106,-1,123,-1,110
1,<environment.Job instance at 0x7fda58545050>,109,13,[3 8],110,-1,124,-1,111
1,<environment.Job instance at 0x7fda57ef52d0>,111,18,[ 3 14],112,-1,133,-1,115
1,<environment.Job instance at 0x7fda58564cd0>,113,18,[5 5],114,-1,133,-1,115
1,<environment.Job instance at 0x7fda58564c30>,115,13,[4 8],116,-1,130,-1,117
1,<environment.Job instance at 0x7fda585645a0>,116,16,[5 6],117,-1,136,-1,120
1,<environment.Job instance at 0x7fda58564d20>,114,16,[10  2],115,-1,139,-1,123
1,<environment.Job instance at 0x7fda57f2fd70>,119,13,[4 7],120,-1,136,-1,123
1,<environment.Job instance at 0x7fda57f1d280>,125,14,[5 8],126,-1,144,-1,130
1,<environment.Job instance at 0x7fda57f21a00>,126,14,[5 5],127,-1,144,-1,130
1,<environment.Job instance at 0x7fda5860e550>,128,16,[7 5],129,-1,146,-1,130
1,<environment.Job instance at 0x7fda5860e230>,129,20,[5 5],130,-1,156,-1,136
1,<environment.Job instance at 0x7fda58533e60>,7,26,[ 2 12],8,-1,39,-1,13
1,<environment.Job instance at 0x7fda585465f0>,9,1,[ 3 12],10,-1,14,-1,13
1,<environment.Job instance at 0x7fda58546910>,12,3,[11  1],13,-1,19,-1,16
1,<environment.Job instance at 0x7fda58530b40>,15,26,[5 5],16,-1,56,-1,30
1,<environment.Job instance at 0x7fda58564fa0>,24,25,[9 4],25,-1,74,-1,49
1,<environment.Job instance at 0x7fda59538a50>,31,3,[11  1],32,-1,62,-1,59
1,<environment.Job instance at 0x7fda595383c0>,32,3,[12  5],33,-1,62,-1,59
1,<environment.Job instance at 0x7fda595382d0>,30,25,[9 5],31,-1,90,-1,65
1,<environment.Job instance at 0x7fda591acc80>,40,26,[10  1],41,-1,131,-1,105
1,<environment.Job instance at 0x7fda61cc9b40>,55,27,[5 8],56,-1,200,-1,173
1,<environment.Job instance at 0x7fda58d74a50>,57,25,[6 4],58,-1,199,-1,174
1,<environment.Job instance at 0x7fda57e4ac30>,60,14,[ 1 14],61,-1,188,-1,174
1,<environment.Job instance at 0x7fda58d74410>,59,25,[10  1],60,-1,201,-1,176
1,<environment.Job instance at 0x7fda5818cd20>,81,26,[5 4],82,-1,269,-1,243
1,<environment.Job instance at 0x7fda595ec280>,88,26,[ 3 10],89,-1,286,-1,260
1,<environment.Job instance at 0x7fda58c868c0>,107,3,[ 5 11],108,-1,335,-1,332
1,<environment.Job instance at 0x7fda58ca30f0>,111,18,[ 3 14],112,-1,354,-1,336
1,<environment.Job instance at 0x7fda58ca33c0>,118,13,[14  3],119,-1,380,-1,367
1,<environment.Job instance at 0x7fda582bf690>,137,2,[13  4],138,-1,455,-1,453
1,<environment.Job instance at 0x7fda57f42e60>,146,13,[13  5],147,-1,498,-1,485
1,<environment.Job instance at 0x7fda5823f7d0>,147,28,[8 2],148,-1,528,-1,500
1,<environment.Job instance at 0x7fda588c58c0>,150,17,[14  5],151,-1,517,-1,500
1,<environment.Job instance at 0x7fda58911dc0>,151,14,[13  2],152,-1,514,-1,500
1,<environment.Job instance at 0x7fda62182780>,162,27,[8 4],163,-1,573,-1,546
1,<environment.Job instance at 0x7fda596e4d70>,172,1,[ 1 13],173,-1,568,-1,567
1,<environment.Job instance at 0x7fda5918d780>,173,25,[ 4 10],174,-1,595,-1,570
1,<environment.Job instance at 0x7fda5918d7d0>,175,17,[11  2],176,-1,587,-1,570
1,<environment.Job instance at 0x7fda585f52d0>,179,21,[14  3],180,-1,594,-1,573
1,<environment.Job instance at 0x7fda5954d0f0>,5,16,[5 5],6,-1,22,-1,6
1,<environment.Job instance at 0x7fda5954dc30>,6,20,[5 3],7,-1,27,-1,7
1,<environment.Job instance at 0x7fda5954d190>,8,12,[9 1],9,-1,23,-1,11
1,<environment.Job instance at 0x7fda582d99b0>,11,13,[6 3],12,-1,25,-1,12
1,<environment.Job instance at 0x7fda582d95f0>,12,18,[9 2],13,-1,31,-1,13
1,<environment.Job instance at 0x7fda582d9c30>,10,21,[5 4],11,-1,35,-1,14
1,<environment.Job instance at 0x7fda582d9410>,16,16,[5 8],17,-1,33,-1,17
1,<environment.Job instance at 0x7fda587024b0>,20,17,[10  5],21,-1,38,-1,21
1,<environment.Job instance at 0x7fda58702410>,24,13,[10  2],25,-1,38,-1,25
1,<environment.Job instance at 0x7fda58702230>,25,17,[9 4],26,-1,44,-1,27
1,<environment.Job instance at 0x7fda58702af0>,26,16,[10  4],27,-1,44,-1,28
1,<environment.Job instance at 0x7fda58702320>,28,14,[10  3],29,-1,43,-1,29
1,<environment.Job instance at 0x7fda58702b40>,31,12,[3 5],32,-1,45,-1,33
1,<environment.Job instance at 0x7fda588c5aa0>,33,16,[5 8],34,-1,50,-1,34
1,<environment.Job instance at 0x7fda58702460>,32,18,[3 6],33,-1,53,-1,35
1,<environment.Job instance at 0x7fda588c52d0>,38,18,[2 8],39,-1,57,-1,39
1,<environment.Job instance at 0x7fda588c5b40>,40,15,[5 9],41,-1,56,-1,41
1,<environment.Job instance at 0x7fda58f3daa0>,41,18,[8 4],42,-1,60,-1,42
1,<environment.Job instance at 0x7fda58f3d640>,42,17,[5 3],43,-1,60,-1,43
1,<environment.Job instance at 0x7fda58f3d370>,43,18,[4 6],44,-1,62,-1,44
1,<environment.Job instance at 0x7fda58f3db40>,46,16,[7 4],47,-1,63,-1,47
1,<environment.Job instance at 0x7fda58f3d960>,49,14,[ 5 10],50,-1,65,-1,51
1,<environment.Job instance at 0x7fda58e10460>,55,28,[5 5],56,-1,84,-1,56
1,<environment.Job instance at 0x7fda58e10b40>,58,14,[3 7],59,-1,73,-1,59
1,<environment.Job instance at 0x7fda58e106e0>,59,18,[1 5],60,-1,78,-1,60
1,<environment.Job instance at 0x7fda58e10870>,61,21,[4 8],62,-1,83,-1,62
1,<environment.Job instance at 0x7fda58365690>,62,14,[1 7],63,-1,77,-1,63
1,<environment.Job instance at 0x7fda583651e0>,63,16,[10  5],64,-1,80,-1,64
1,<environment.Job instance at 0x7fda58365af0>,66,17,[7 1],67,-1,84,-1,67
1,<environment.Job instance at 0x7fda58365550>,70,21,[6 2],71,-1,92,-1,71
1,<environment.Job instance at 0x7fda58559eb0>,73,13,[10  4],74,-1,87,-1,74
1,<environment.Job instance at 0x7fda5815c820>,78,22,[4 8],79,-1,101,-1,79
1,<environment.Job instance at 0x7fda5815c3c0>,79,16,[ 4 11],80,-1,96,-1,80
1,<environment.Job instance at 0x7fda5815c5a0>,80,28,[4 7],81,-1,109,-1,81
1,<environment.Job instance at 0x7fda5931e910>,83,14,[ 3 11],84,-1,98,-1,84
1,<environment.Job instance at 0x7fda5815c960>,84,14,[ 1 10],85,-1,99,-1,85
1,<environment.Job instance at 0x7fda57ec1be0>,91,15,[4 5],92,-1,107,-1,92
1,<environment.Job instance at 0x7fda580392d0>,92,16,[10  5],93,-1,109,-1,93
1,<environment.Job instance at 0x7fda620448c0>,95,15,[10  3],96,-1,114,-1,99
1,<environment.Job instance at 0x7fda58472be0>,98,18,[2 9],99,-1,117,-1,99
1,<environment.Job instance at 0x7fda58fe4a50>,99,17,[6 4],100,-1,117,-1,100
1,<environment.Job instance at 0x7fda59322b90>,97,17,[ 4 14],98,-1,118,-1,101
1,<environment.Job instance at 0x7fda58e10af0>,60,12,[ 4 14],61,-1,113,-1,101
1,<environment.Job instance at 0x7fda581ae0f0>,101,16,[ 4 10],102,-1,118,-1,102
1,<environment.Job instance at 0x7fda593c6280>,106,16,[7 1],107,-1,123,-1,107
1,<environment.Job instance at 0x7fda582285a0>,107,13,[5 5],108,-1,121,-1,108
1,<environment.Job instance at 0x7fda593c6c80>,109,15,[7 2],110,-1,127,-1,112
1,<environment.Job instance at 0x7fda58228e60>,108,17,[ 1 10],109,-1,129,-1,112
1,<environment.Job instance at 0x7fda593bd3c0>,121,16,[6 5],122,-1,139,-1,123
1,<environment.Job instance at 0x7fda593bd8c0>,124,17,[4 9],125,-1,144,-1,127
1,<environment.Job instance at 0x7fda593bd2d0>,125,17,[ 5 10],126,-1,144,-1,127
1,<environment.Job instance at 0x7fda590c2140>,128,2,[6 4],129,-1,132,-1,130
1,<environment.Job instance at 0x7fda590c2e10>,129,18,[9 4],130,-1,156,-1,138
1,<environment.Job instance at 0x7fda59332780>,139,16,[4 9],140,-1,156,-1,140
1,<environment.Job instance at 0x7fda58702aa0>,7,1,[ 2 11],8,-1,9,-1,8
1,<environment.Job instance at 0x7fda57f87820>,14,17,[11  1],15,-1,37,-1,20
1,<environment.Job instance at 0x7fda59332d20>,27,3,[ 5 11],28,-1,79,-1,76
1,<environment.Job instance at 0x7fda62182be0>,44,12,[13  3],45,-1,175,-1,163
1,<environment.Job instance at 0x7fda57f42dc0>,55,28,[5 5],56,-1,232,-1,204
1,<environment.Job instance at 0x7fda58b120a0>,60,12,[ 4 14],61,-1,230,-1,218
1,<environment.Job instance at 0x7fda58b12d70>,68,1,[ 1 11],69,-1,249,-1,248
1,<environment.Job instance at 0x7fda58c86370>,79,16,[ 4 11],80,-1,293,-1,277
1,<environment.Job instance at 0x7fda58c864b0>,80,28,[4 7],81,-1,305,-1,277
1,<environment.Job instance at 0x7fda58c86fa0>,81,15,[ 5 14],82,-1,292,-1,277
1,<environment.Job instance at 0x7fda58c86820>,83,14,[ 3 11],84,-1,291,-1,277
1,<environment.Job instance at 0x7fda5961f8c0>,97,17,[ 4 14],98,-1,338,-1,321
1,<environment.Job instance at 0x7fda590d6550>,131,16,[14  3],132,-1,464,-1,448
1,<environment.Job instance at 0x7fda595ff050>,132,3,[ 1 14],133,-1,451,-1,448
1,<environment.Job instance at 0x7fda59538190>,146,3,[ 5 11],147,-1,495,-1,492
1,<environment.Job instance at 0x7fda5856d0a0>,154,24,[8 1],155,-1,580,-1,556
1,<environment.Job instance at 0x7fda58564fa0>,156,25,[6 2],157,-1,581,-1,556
1,<environment.Job instance at 0x7fda57ddcd70>,1,16,[5 9],2,-1,18,-1,2
1,<environment.Job instance at 0x7fda57ddc820>,2,17,[7 4],3,-1,20,-1,3
1,<environment.Job instance at 0x7fda57dea9b0>,6,17,[10  4],7,-1,24,-1,7
1,<environment.Job instance at 0x7fda57deab40>,8,14,[ 5 11],9,-1,23,-1,9
1,<environment.Job instance at 0x7fda57deadc0>,9,17,[1 7],10,-1,27,-1,10
1,<environment.Job instance at 0x7fda57deaf50>,10,14,[2 6],11,-1,25,-1,11
1,<environment.Job instance at 0x7fda57deaa50>,12,18,[ 1 10],13,-1,31,-1,13
1,<environment.Job instance at 0x7fda57deaa00>,13,15,[1 5],14,-1,29,-1,14
1,<environment.Job instance at 0x7fda57deaaf0>,14,12,[9 4],15,-1,28,-1,16
1,<environment.Job instance at 0x7fda57ddc960>,15,18,[6 1],16,-1,34,-1,16
1,<environment.Job instance at 0x7fda57dea4b0>,16,15,[4 7],17,-1,32,-1,17
1,<environment.Job instance at 0x7fda57dea7d0>,18,17,[9 3],19,-1,36,-1,19
1,<environment.Job instance at 0x7fda58baf3c0>,22,18,[10  1],23,-1,42,-1,24
1,<environment.Job instance at 0x7fda57dea910>,23,15,[7 2],24,-1,39,-1,24
1,<environment.Job instance at 0x7fda587b5640>,28,17,[3 6],29,-1,46,-1,29
1,<environment.Job instance at 0x7fda587b5eb0>,32,15,[4 7],33,-1,49,-1,34
1,<environment.Job instance at 0x7fda587b50a0>,33,14,[9 2],34,-1,48,-1,34
1,<environment.Job instance at 0x7fda587b5780>,36,16,[1 9],37,-1,54,-1,38
1,<environment.Job instance at 0x7fda587b5cd0>,41,18,[4 6],42,-1,60,-1,42
1,<environment.Job instance at 0x7fda58687b90>,44,14,[1 7],45,-1,59,-1,45
1,<environment.Job instance at 0x7fda58687af0>,45,13,[10  4],46,-1,59,-1,46
1,<environment.Job instance at 0x7fda58687cd0>,46,19,[5 4],47,-1,66,-1,47
1,<environment.Job instance at 0x7fda58687be0>,47,17,[1 8],48,-1,65,-1,48
1,<environment.Job instance at 0x7fda58687050>,48,18,[4 6],49,-1,67,-1,49
1,<environment.Job instance at 0x7fda586872d0>,53,18,[10  1],54,-1,72,-1,54
1,<environment.Job instance at 0x7fda58687e10>,54,15,[9 3],55,-1,70,-1,55
1,<environment.Job instance at 0x7fda58687370>,55,16,[ 5 13],56,-1,72,-1,56
1,<environment.Job instance at 0x7fda586873c0>,49,13,[8 2],50,-1,70,-1,57
1,<environment.Job instance at 0x7fda587def00>,61,16,[9 3],62,-1,78,-1,62
1,<environment.Job instance at 0x7fda587dec80>,62,15,[ 2 12],63,-1,80,-1,65
1,<environment.Job instance at 0x7fda587de3c0>,65,13,[7 3],66,-1,79,-1,66
1,<environment.Job instance at 0x7fda587ded20>,59,16,[ 1 13],60,-1,84,-1,68
1,<environment.Job instance at 0x7fda587de0f0>,66,17,[11  2],67,-1,88,-1,71
1,<environment.Job instance at 0x7fda587de4b0>,69,23,[9 3],70,-1,94,-1,71
1,<environment.Job instance at 0x7fda587de370>,68,12,[4 5],69,-1,83,-1,71
1,<environment.Job instance at 0x7fda587deaa0>,56,17,[ 2 10],57,-1,89,-1,72
1,<environment.Job instance at 0x7fda58ba99b0>,71,15,[7 4],72,-1,88,-1,73
1,<environment.Job instance at 0x7fda58ba9280>,72,16,[7 2],73,-1,89,-1,73
1,<environment.Job instance at 0x7fda58ba9be0>,77,18,[2 7],78,-1,96,-1,78
1,<environment.Job instance at 0x7fda57eab9b0>,81,28,[1 5],82,-1,117,-1,89
1,<environment.Job instance at 0x7fda58ba9050>,79,15,[8 5],80,-1,104,-1,89
1,<environment.Job instance at 0x7fda58ba9500>,78,12,[ 1 13],79,-1,102,-1,90
1,<environment.Job instance at 0x7fda58ba9c80>,80,22,[9 3],81,-1,113,-1,91
1,<environment.Job instance at 0x7fda58ba6500>,86,14,[11  1],87,-1,106,-1,92
1,<environment.Job instance at 0x7fda58ba6c80>,82,12,[ 4 14],83,-1,104,-1,92
1,<environment.Job instance at 0x7fda58ba66e0>,87,22,[7 3],88,-1,114,-1,92
1,<environment.Job instance at 0x7fda58ba6aa0>,84,15,[7 5],85,-1,107,-1,92
1,<environment.Job instance at 0x7fda58ba6910>,89,14,[6 4],90,-1,106,-1,92
1,<environment.Job instance at 0x7fda58b9d550>,96,18,[12  4],97,-1,115,-1,97
1,<environment.Job instance at 0x7fda58b9db40>,98,14,[5 9],99,-1,113,-1,99
1,<environment.Job instance at 0x7fda58ba67d0>,90,18,[1 7],91,-1,118,-1,100
1,<environment.Job instance at 0x7fda58b9dfa0>,99,18,[5 9],100,-1,120,-1,102
1,<environment.Job instance at 0x7fda58b9da50>,101,27,[6 5],102,-1,129,-1,102
1,<environment.Job instance at 0x7fda58b9d320>,100,18,[4 5],101,-1,124,-1,106
1,<environment.Job instance at 0x7fda57e29eb0>,104,17,[7 2],105,-1,123,-1,106
1,<environment.Job instance at 0x7fda587be410>,106,16,[ 1 12],107,-1,124,-1,108
1,<environment.Job instance at 0x7fda587beaa0>,108,25,[10  1],109,-1,134,-1,109
1,<environment.Job instance at 0x7fda587be550>,109,23,[4 9],110,-1,133,-1,110
1,<environment.Job instance at 0x7fda587befa0>,107,16,[6 5],108,-1,128,-1,112
1,<environment.Job instance at 0x7fda587be5f0>,111,15,[10  3],112,-1,127,-1,112
1,<environment.Job instance at 0x7fda587be780>,115,16,[1 9],116,-1,135,-1,119
1,<environment.Job instance at 0x7fda589edaa0>,117,25,[1 9],118,-1,144,-1,119
1,<environment.Job instance at 0x7fda5924a870>,121,28,[6 2],122,-1,151,-1,123
1,<environment.Job instance at 0x7fda591584b0>,129,15,[8 4],130,-1,146,-1,131
1,<environment.Job instance at 0x7fda59692190>,134,12,[8 5],135,-1,152,-1,140
1,<environment.Job instance at 0x7fda58ba61e0>,85,14,[7 4],86,-1,154,-1,140
1,<environment.Job instance at 0x7fda596925a0>,137,13,[7 4],138,-1,153,-1,140
1,<environment.Job instance at 0x7fda581e0d20>,119,27,[9 3],120,-1,167,-1,140
1,<environment.Job instance at 0x7fda59559230>,140,13,[8 5],141,-1,154,-1,141
1,<environment.Job instance at 0x7fda58dfe320>,150,3,[4 7],151,-1,154,-1,151
1,<environment.Job instance at 0x7fda586e5280>,148,12,[9 4],149,-1,163,-1,151
1,<environment.Job instance at 0x7fda58979c80>,156,15,[9 4],157,-1,172,-1,157
1,<environment.Job instance at 0x7fda58460190>,157,18,[5 9],158,-1,176,-1,158
1,<environment.Job instance at 0x7fda58460280>,158,25,[3 6],159,-1,184,-1,159
1,<environment.Job instance at 0x7fda593c33c0>,153,12,[ 1 14],154,-1,171,-1,159
1,<environment.Job instance at 0x7fda58460dc0>,159,13,[3 8],160,-1,173,-1,160
1,<environment.Job instance at 0x7fda58979910>,160,17,[8 5],161,-1,179,-1,162
1,<environment.Job instance at 0x7fda58460870>,162,13,[3 8],163,-1,176,-1,163
1,<environment.Job instance at 0x7fda58ce9460>,163,12,[5 7],164,-1,176,-1,164
1,<environment.Job instance at 0x7fda59158d70>,130,12,[4 9],131,-1,181,-1,169
1,<environment.Job instance at 0x7fda593c3e10>,154,15,[2 8],155,-1,184,-1,169
1,<environment.Job instance at 0x7fda581ec460>,168,15,[5 5],169,-1,185,-1,170
1,<environment.Job instance at 0x7fda581b63c0>,172,20,[3 6],173,-1,199,-1,179
1,<environment.Job instance at 0x7fda581d24b0>,176,21,[10  4],177,-1,200,-1,179
1,<environment.Job instance at 0x7fda57dfd960>,174,2,[10  3],175,-1,181,-1,179
1,<environment.Job instance at 0x7fda581d25a0>,177,15,[3 8],178,-1,194,-1,179
1,<environment.Job instance at 0x7fda57dfdfa0>,173,17,[10  4],174,-1,197,-1,180
1,<environment.Job instance at 0x7fda581d2370>,179,15,[14  4],180,-1,195,-1,180
1,<environment.Job instance at 0x7fda586875a0>,52,14,[5 6],53,-1,195,-1,181
1,<environment.Job instance at 0x7fda57e14aa0>,175,2,[2 9],176,-1,183,-1,181
1,<environment.Job instance at 0x7fda587e3c80>,181,18,[3 7],182,-1,200,-1,182
1,<environment.Job instance at 0x7fda587e3500>,182,3,[10  1],183,-1,186,-1,183
1,<environment.Job instance at 0x7fda57e1ec30>,183,13,[5 5],184,-1,197,-1,184
1,<environment.Job instance at 0x7fda587e3370>,180,16,[10  1],181,-1,200,-1,184
1,<environment.Job instance at 0x7fda587dea00>,8,14,[ 5 11],9,-1,32,-1,18
1,<environment.Job instance at 0x7fda58fb5730>,24,27,[1 7],25,-1,124,-1,97
1,<environment.Job instance at 0x7fda588c58c0>,55,16,[ 5 13],56,-1,243,-1,227
1,<environment.Job instance at 0x7fda593c6730>,59,16,[ 1 13],60,-1,261,-1,245
1,<environment.Job instance at 0x7fda583f2cd0>,62,15,[ 2 12],63,-1,263,-1,248
1,<environment.Job instance at 0x7fda58f3d190>,66,17,[11  2],67,-1,281,-1,264
1,<environment.Job instance at 0x7fda58702be0>,69,23,[9 3],70,-1,305,-1,282
1,<environment.Job instance at 0x7fda581eb0f0>,78,12,[ 1 13],79,-1,315,-1,303
1,<environment.Job instance at 0x7fda57dd3b40>,82,12,[ 4 14],83,-1,333,-1,321
1,<environment.Job instance at 0x7fda581cd820>,81,28,[1 5],82,-1,349,-1,321
1,<environment.Job instance at 0x7fda57dd3eb0>,86,14,[11  1],87,-1,335,-1,321
1,<environment.Job instance at 0x7fda581ea1e0>,94,2,[14  4],95,-1,355,-1,353
1,<environment.Job instance at 0x7fda57dd3190>,95,3,[14  3],96,-1,356,-1,353
1,<environment.Job instance at 0x7fda581daaa0>,96,18,[12  4],97,-1,371,-1,353
1,<environment.Job instance at 0x7fda581dafa0>,97,3,[ 4 13],98,-1,356,-1,353
1,<environment.Job instance at 0x7fda581da7d0>,101,27,[6 5],102,-1,409,-1,382
1,<environment.Job instance at 0x7fda581da320>,103,3,[ 1 13],104,-1,385,-1,382
1,<environment.Job instance at 0x7fda581da1e0>,106,16,[ 1 12],107,-1,399,-1,383
1,<environment.Job instance at 0x7fda581dae60>,109,23,[4 9],110,-1,427,-1,404
1,<environment.Job instance at 0x7fda581da5a0>,108,25,[10  1],109,-1,440,-1,415
1,<environment.Job instance at 0x7fda57dc7d20>,117,25,[1 9],118,-1,455,-1,430
1,<environment.Job instance at 0x7fda57dc7910>,119,27,[9 3],120,-1,458,-1,431
1,<environment.Job instance at 0x7fda57dc7050>,121,28,[6 2],122,-1,461,-1,433
1,<environment.Job instance at 0x7fda58bbaf50>,143,1,[ 4 14],144,-1,497,-1,496
1,<environment.Job instance at 0x7fda57f99c80>,153,12,[ 1 14],154,-1,529,-1,517
1,<environment.Job instance at 0x7fda57f99a00>,158,25,[3 6],159,-1,558,-1,533
1,<environment.Job instance at 0x7fda592b7280>,3,14,[5 2],4,-1,18,-1,4
1,<environment.Job instance at 0x7fda592b7690>,4,17,[7 2],5,-1,22,-1,5
1,<environment.Job instance at 0x7fda587e8dc0>,7,14,[3 8],8,-1,22,-1,8
1,<environment.Job instance at 0x7fda587e8eb0>,12,15,[9 5],13,-1,28,-1,13
1,<environment.Job instance at 0x7fda59145780>,17,17,[3 5],18,-1,35,-1,18
1,<environment.Job instance at 0x7fda59145a50>,20,13,[4 7],21,-1,34,-1,21
1,<environment.Job instance at 0x7fda59145be0>,21,20,[5 5],22,-1,42,-1,22
1,<environment.Job instance at 0x7fda59145c80>,23,22,[2 8],24,-1,46,-1,24
1,<environment.Job instance at 0x7fda59145e10>,24,14,[2 5],25,-1,39,-1,25
1,<environment.Job instance at 0x7fda59131370>,32,20,[ 1 10],33,-1,55,-1,35
1,<environment.Job instance at 0x7fda58b87140>,42,21,[9 2],43,-1,64,-1,43
1,<environment.Job instance at 0x7fda58b870f0>,44,18,[2 6],45,-1,63,-1,45
1,<environment.Job instance at 0x7fda58b87500>,45,13,[ 4 14],46,-1,69,-1,56
1,<environment.Job instance at 0x7fda59131c80>,38,17,[ 3 13],39,-1,74,-1,57
1,<environment.Job instance at 0x7fda58b87640>,47,3,[7 2],48,-1,60,-1,57
1,<environment.Job instance at 0x7fda58b87960>,52,25,[3 6],53,-1,82,-1,57
1,<environment.Job instance at 0x7fda58b873c0>,51,19,[6 5],52,-1,77,-1,58
1,<environment.Job instance at 0x7fda58b87be0>,55,16,[4 8],56,-1,74,-1,58
1,<environment.Job instance at 0x7fda58b917d0>,65,13,[4 8],66,-1,82,-1,69
1,<environment.Job instance at 0x7fda58b915a0>,67,16,[8 2],68,-1,87,-1,71
1,<environment.Job instance at 0x7fda590e1640>,69,1,[5 8],70,-1,73,-1,72
1,<environment.Job instance at 0x7fda5910ecd0>,71,13,[8 5],72,-1,86,-1,73
1,<environment.Job instance at 0x7fda58b87a00>,53,2,[ 3 10],54,-1,77,-1,75
1,<environment.Job instance at 0x7fda5910ec80>,73,17,[13  3],74,-1,94,-1,77
1,<environment.Job instance at 0x7fda5910e190>,72,18,[ 5 10],73,-1,96,-1,78
1,<environment.Job instance at 0x7fda5910ef00>,76,13,[6 4],77,-1,91,-1,78
1,<environment.Job instance at 0x7fda5910ee10>,77,13,[12  4],78,-1,91,-1,78
1,<environment.Job instance at 0x7fda57dddaa0>,70,16,[ 4 10],71,-1,105,-1,89
1,<environment.Job instance at 0x7fda57f24fa0>,81,16,[ 5 10],82,-1,106,-1,90
1,<environment.Job instance at 0x7fda581e0f00>,86,1,[ 2 10],87,-1,91,-1,90
1,<environment.Job instance at 0x7fda58e1fb90>,87,18,[ 3 12],88,-1,108,-1,90
1,<environment.Job instance at 0x7fda57f2e500>,85,21,[3 8],86,-1,111,-1,90
1,<environment.Job instance at 0x7fda58e5d3c0>,90,19,[5 1],91,-1,110,-1,91
1,<environment.Job instance at 0x7fda589be1e0>,84,13,[9 1],85,-1,105,-1,92
1,<environment.Job instance at 0x7fda59439410>,92,21,[1 8],93,-1,117,-1,96
1,<environment.Job instance at 0x7fda58e39f00>,94,17,[10  1],95,-1,113,-1,96
1,<environment.Job instance at 0x7fda591ac2d0>,93,13,[3 6],94,-1,110,-1,97
1,<environment.Job instance at 0x7fda589792d0>,96,17,[10  2],97,-1,114,-1,97
1,<environment.Job instance at 0x7fda58aa8140>,97,22,[7 5],98,-1,120,-1,98
1,<environment.Job instance at 0x7fda58aa8c80>,98,18,[7 1],99,-1,117,-1,99
1,<environment.Job instance at 0x7fda59439c30>,91,18,[5 2],92,-1,120,-1,102
1,<environment.Job instance at 0x7fda58e6b320>,101,16,[ 1 11],102,-1,122,-1,106
1,<environment.Job instance at 0x7fda58b875a0>,46,17,[3 9],47,-1,125,-1,108
1,<environment.Job instance at 0x7fda58aa82d0>,102,15,[5 7],103,-1,123,-1,108
1,<environment.Job instance at 0x7fda58aaa730>,110,18,[6 2],111,-1,131,-1,113
1,<environment.Job instance at 0x7fda57f14410>,103,12,[6 4],104,-1,126,-1,114
1,<environment.Job instance at 0x7fda58aaa4b0>,107,16,[6 1],108,-1,130,-1,114
1,<environment.Job instance at 0x7fda5920db40>,112,15,[4 8],113,-1,130,-1,115
1,<environment.Job instance at 0x7fda58aa1820>,114,18,[ 3 10],115,-1,135,-1,117
1,<environment.Job instance at 0x7fda58aa11e0>,113,18,[12  1],114,-1,271,-1,253
1,<environment.Job instance at 0x7fda58a78370>,143,26,[7 3],144,-1,309,-1,283
1,<environment.Job instance at 0x7fda58a786e0>,145,15,[3 7],146,-1,298,-1,283
1,<environment.Job instance at 0x7fda58edb050>,156,12,[8 5],157,-1,295,-1,283
1,<environment.Job instance at 0x7fda58325d20>,157,24,[9 3],158,-1,307,-1,283
1,<environment.Job instance at 0x7fda58325eb0>,159,15,[10  1],160,-1,298,-1,283
1,<environment.Job instance at 0x7fda5912d550>,160,18,[8 5],161,-1,301,-1,283
1,<environment.Job instance at 0x7fda5912d7d0>,162,14,[8 4],163,-1,297,-1,283
1,<environment.Job instance at 0x7fda5830ea00>,155,12,[5 5],156,-1,295,-1,283
1,<environment.Job instance at 0x7fda58f7daf0>,164,1,[12  4],165,-1,284,-1,283
1,<environment.Job instance at 0x7fda5914e190>,163,15,[3 5],164,-1,298,-1,283
1,<environment.Job instance at 0x7fda58f7dd20>,166,25,[10  1],167,-1,308,-1,283
1,<environment.Job instance at 0x7fda591355a0>,168,15,[7 3],169,-1,312,-1,297
1,<environment.Job instance at 0x7fda58f4e5a0>,171,14,[12  1],172,-1,311,-1,297
1,<environment.Job instance at 0x7fda58a78cd0>,147,14,[ 4 10],148,-1,312,-1,298
1,<environment.Job instance at 0x7fda59135960>,170,24,[ 4 13],171,-1,325,-1,301
1,<environment.Job instance at 0x7fda582fd910>,174,17,[9 3],175,-1,318,-1,301
1,<environment.Job instance at 0x7fda582fdf00>,173,27,[4 5],174,-1,328,-1,301
1,<environment.Job instance at 0x7fda58f4e370>,172,14,[6 4],173,-1,317,-1,303
1,<environment.Job instance at 0x7fda5952e550>,181,17,[ 5 10],182,-1,329,-1,312
1,<environment.Job instance at 0x7fda58a782d0>,144,18,[5 8],145,-1,334,-1,316
1,<environment.Job instance at 0x7fda582fd140>,175,20,[5 6],176,-1,341,-1,321
1,<environment.Job instance at 0x7fda58e093c0>,182,17,[6 5],183,-1,338,-1,321
1,<environment.Job instance at 0x7fda58e091e0>,184,16,[ 2 11],185,-1,341,-1,325
1,<environment.Job instance at 0x7fda58b9c460>,186,19,[5 9],187,-1,345,-1,326
1,<environment.Job instance at 0x7fda59131140>,6,1,[12  5],7,-1,8,-1,7
1,<environment.Job instance at 0x7fda58b87370>,9,16,[13  2],10,-1,30,-1,14
1,<environment.Job instance at 0x7fda58b91d70>,35,13,[13  1],36,-1,87,-1,74
1,<environment.Job instance at 0x7fda57f99b90>,38,17,[ 3 13],39,-1,94,-1,77
1,<environment.Job instance at 0x7fda57f99230>,45,13,[ 4 14],46,-1,105,-1,92
1,<environment.Job instance at 0x7fda58bbaaa0>,52,25,[3 6],53,-1,136,-1,111
1,<environment.Job instance at 0x7fda58bba910>,58,3,[ 1 13],59,-1,136,-1,133
1,<environment.Job instance at 0x7fda57dc7fa0>,73,17,[13  3],74,-1,181,-1,164
1,<environment.Job instance at 0x7fda581da730>,77,13,[12  4],78,-1,181,-1,168
1,<environment.Job instance at 0x7fda581dab40>,87,18,[ 3 12],88,-1,234,-1,216
1,<environment.Job instance at 0x7fda582d9320>,101,16,[ 1 11],102,-1,288,-1,272
1,<environment.Job instance at 0x7fda588c9aa0>,113,18,[12  1],114,-1,342,-1,324
1,<environment.Job instance at 0x7fda57ddc0a0>,122,26,[8 2],123,-1,399,-1,373
1,<environment.Job instance at 0x7fda58f265f0>,126,27,[5 8],127,-1,408,-1,381
1,<environment.Job instance at 0x7fda58535af0>,140,3,[ 3 12],141,-1,416,-1,413
1,<environment.Job instance at 0x7fda588c5370>,143,26,[7 3],144,-1,447,-1,421
1,<environment.Job instance at 0x7fda58fa0dc0>,157,24,[9 3],158,-1,531,-1,507
1,<environment.Job instance at 0x7fda58f12640>,164,1,[12  4],165,-1,521,-1,520
1,<environment.Job instance at 0x7fda57ea78c0>,166,25,[10  1],167,-1,559,-1,534
1,<environment.Job instance at 0x7fda5954cfa0>,170,24,[ 4 13],171,-1,561,-1,537
1,<environment.Job instance at 0x7fda5964abe0>,171,14,[12  1],172,-1,551,-1,537
1,<environment.Job instance at 0x7fda583b4910>,173,27,[4 5],174,-1,579,-1,552
1,<environment.Job instance at 0x7fda583c0c30>,184,16,[ 2 11],185,-1,615,-1,599
1,<environment.Job instance at 0x7fda59515500>,0,16,[4 9],1,-1,17,-1,1
1,<environment.Job instance at 0x7fda6214b690>,4,13,[9 2],5,-1,20,-1,7
1,<environment.Job instance at 0x7fda57dddf00>,7,17,[3 8],8,-1,25,-1,8
1,<environment.Job instance at 0x7fda57ddd2d0>,8,18,[5 5],9,-1,27,-1,9
1,<environment.Job instance at 0x7fda57dddaf0>,12,18,[5 7],13,-1,31,-1,13
1,<environment.Job instance at 0x7fda6214bdc0>,13,20,[2 6],14,-1,34,-1,14
1,<environment.Job instance at 0x7fda58bd1280>,16,15,[8 4],17,-1,32,-1,17
1,<environment.Job instance at 0x7fda58bd1550>,18,18,[5 3],19,-1,37,-1,19
1,<environment.Job instance at 0x7fda58bd1960>,19,18,[8 4],20,-1,38,-1,20
1,<environment.Job instance at 0x7fda58bd1c30>,20,15,[1 8],21,-1,36,-1,21
1,<environment.Job instance at 0x7fda58bd1820>,21,28,[7 5],22,-1,50,-1,22
1,<environment.Job instance at 0x7fda58bd1f50>,23,15,[10  2],24,-1,39,-1,24
1,<environment.Job instance at 0x7fda58987960>,25,17,[2 9],26,-1,43,-1,26
1,<environment.Job instance at 0x7fda59193af0>,29,18,[4 6],30,-1,48,-1,30
1,<environment.Job instance at 0x7fda6214bf50>,6,15,[2 9],7,-1,45,-1,30
1,<environment.Job instance at 0x7fda58c4d5a0>,32,17,[9 3],33,-1,50,-1,33
1,<environment.Job instance at 0x7fda57fde190>,34,14,[2 9],35,-1,49,-1,35
1,<environment.Job instance at 0x7fda57fde690>,36,18,[9 5],37,-1,55,-1,37
1,<environment.Job instance at 0x7fda57fdee10>,37,15,[10  2],38,-1,55,-1,40
1,<environment.Job instance at 0x7fda57e38820>,41,14,[10  4],42,-1,56,-1,42
1,<environment.Job instance at 0x7fda57e387d0>,43,15,[ 4 10],44,-1,59,-1,44
1,<environment.Job instance at 0x7fda584f0b90>,48,13,[4 5],49,-1,62,-1,49
1,<environment.Job instance at 0x7fda584f00f0>,49,13,[3 6],50,-1,63,-1,50
1,<environment.Job instance at 0x7fda584f0a00>,50,13,[9 1],51,-1,64,-1,51
1,<environment.Job instance at 0x7fda5916fdc0>,53,17,[ 4 10],54,-1,71,-1,54
1,<environment.Job instance at 0x7fda58c19820>,56,16,[ 1 10],57,-1,73,-1,57
1,<environment.Job instance at 0x7fda58c19320>,57,18,[ 3 11],58,-1,76,-1,58
1,<environment.Job instance at 0x7fda58683230>,60,18,[7 5],61,-1,79,-1,61
1,<environment.Job instance at 0x7fda58683320>,61,16,[5 5],62,-1,78,-1,62
1,<environment.Job instance at 0x7fda58683640>,62,13,[5 5],63,-1,76,-1,63
1,<environment.Job instance at 0x7fda58dfd870>,64,12,[ 5 10],65,-1,77,-1,65
1,<environment.Job instance at 0x7fda58dfd050>,65,19,[5 1],66,-1,85,-1,66
1,<environment.Job instance at 0x7fda58683190>,66,24,[5 3],67,-1,91,-1,67
1,<environment.Job instance at 0x7fda58668910>,67,13,[2 9],68,-1,81,-1,68
1,<environment.Job instance at 0x7fda59695f50>,70,16,[1 7],71,-1,87,-1,71
1,<environment.Job instance at 0x7fda59695640>,71,18,[6 5],72,-1,90,-1,72
1,<environment.Job instance at 0x7fda59695e10>,75,15,[ 4 12],76,-1,91,-1,76
1,<environment.Job instance at 0x7fda59695af0>,76,17,[6 1],77,-1,94,-1,77
1,<environment.Job instance at 0x7fda59695aa0>,79,17,[8 3],80,-1,97,-1,80
1,<environment.Job instance at 0x7fda59695500>,81,18,[ 5 10],82,-1,100,-1,82
1,<environment.Job instance at 0x7fda59695780>,83,18,[2 7],84,-1,102,-1,84
1,<environment.Job instance at 0x7fda59695cd0>,85,15,[10  1],86,-1,101,-1,86
1,<environment.Job instance at 0x7fda58558050>,89,14,[8 2],90,-1,104,-1,90
1,<environment.Job instance at 0x7fda58558d70>,92,25,[2 8],93,-1,118,-1,93
1,<environment.Job instance at 0x7fda58558370>,93,17,[ 1 10],94,-1,111,-1,94
1,<environment.Job instance at 0x7fda58558500>,94,19,[3 6],95,-1,114,-1,95
1,<environment.Job instance at 0x7fda58558820>,98,12,[9 5],99,-1,111,-1,99
1,<environment.Job instance at 0x7fda58558fa0>,100,15,[ 4 10],101,-1,116,-1,101
1,<environment.Job instance at 0x7fda57fde730>,39,16,[ 2 10],40,-1,117,-1,101
1,<environment.Job instance at 0x7fda58211a00>,102,15,[7 5],103,-1,121,-1,106
1,<environment.Job instance at 0x7fda58211d20>,105,16,[9 5],106,-1,122,-1,106
1,<environment.Job instance at 0x7fda58211be0>,106,18,[6 5],107,-1,133,-1,115
1,<environment.Job instance at 0x7fda58b66f50>,115,21,[ 2 10],116,-1,137,-1,116
1,<environment.Job instance at 0x7fda58b667d0>,114,12,[10  4],115,-1,128,-1,116
1,<environment.Job instance at 0x7fda58b660f0>,116,15,[8 4],117,-1,136,-1,121
1,<environment.Job instance at 0x7fda58b66c80>,123,12,[9 4],124,-1,136,-1,124
1,<environment.Job instance at 0x7fda58b66410>,120,13,[7 3],121,-1,138,-1,125
1,<environment.Job instance at 0x7fda587cefa0>,135,20,[5 4],136,-1,157,-1,137
1,<environment.Job instance at 0x7fda58aab7d0>,140,15,[3 9],141,-1,156,-1,141
1,<environment.Job instance at 0x7fda58aab910>,141,17,[5 8],142,-1,159,-1,142
1,<environment.Job instance at 0x7fda58aab370>,143,25,[4 6],144,-1,169,-1,144
1,<environment.Job instance at 0x7fda58aab460>,144,16,[ 5 10],145,-1,161,-1,145
1,<environment.Job instance at 0x7fda58aab820>,146,13,[9 4],147,-1,160,-1,147
1,<environment.Job instance at 0x7fda58aabaf0>,147,22,[10  3],148,-1,170,-1,148
1,<environment.Job instance at 0x7fda58aabc30>,148,21,[1 6],149,-1,170,-1,149
1,<environment.Job instance at 0x7fda58aaba50>,150,17,[2 8],151,-1,168,-1,151
1,<environment.Job instance at 0x7fda58a11550>,151,14,[ 5 10],152,-1,166,-1,152
1,<environment.Job instance at 0x7fda58112c80>,161,16,[10  5],162,-1,187,-1,171
1,<environment.Job instance at 0x7fda587579b0>,155,16,[7 5],156,-1,191,-1,175
1,<environment.Job instance at 0x7fda587ce370>,136,24,[ 1 10],137,-1,199,-1,175
1,<environment.Job instance at 0x7fda58499c80>,166,17,[7 1],167,-1,193,-1,176
1,<environment.Job instance at 0x7fda58dfd280>,167,2,[5 1],168,-1,178,-1,176
1,<environment.Job instance at 0x7fda58112320>,164,16,[2 6],165,-1,192,-1,176
1,<environment.Job instance at 0x7fda5823b0a0>,171,17,[9 1],172,-1,194,-1,177
1,<environment.Job instance at 0x7fda5823b280>,172,15,[1 7],173,-1,192,-1,177
1,<environment.Job instance at 0x7fda585580f0>,96,26,[ 1 12],97,-1,203,-1,177
1,<environment.Job instance at 0x7fda5823b8c0>,175,17,[6 3],176,-1,194,-1,177
1,<environment.Job instance at 0x7fda5823b960>,176,18,[5 9],177,-1,195,-1,177
1,<environment.Job instance at 0x7fda5823b870>,177,19,[ 4 10],178,-1,197,-1,178
1,<environment.Job instance at 0x7fda5823be10>,173,13,[10  5],174,-1,193,-1,180
1,<environment.Job instance at 0x7fda58112460>,160,15,[9 1],161,-1,201,-1,186
1,<environment.Job instance at 0x7fda59534230>,187,13,[4 9],188,-1,203,-1,190
1,<environment.Job instance at 0x7fda57e38500>,9,16,[13  5],10,-1,33,-1,17
1,<environment.Job instance at 0x7fda59695050>,17,1,[ 3 11],18,-1,37,-1,36
1,<environment.Job instance at 0x7fda58558870>,21,28,[7 5],22,-1,96,-1,68
1,<environment.Job instance at 0x7fda5864f960>,47,1,[ 2 11],48,-1,181,-1,180
1,<environment.Job instance at 0x7fda5856d370>,55,3,[ 4 12],56,-1,210,-1,207
1,<environment.Job instance at 0x7fda58f3d0f0>,57,18,[ 3 11],58,-1,225,-1,207
1,<environment.Job instance at 0x7fda58f3d190>,58,2,[14  5],59,-1,209,-1,207
1,<environment.Job instance at 0x7fda57dd3500>,66,24,[5 3],67,-1,266,-1,242
1,<environment.Job instance at 0x7fda581dac80>,74,28,[10  4],75,-1,305,-1,277
1,<environment.Job instance at 0x7fda581da7d0>,75,15,[ 4 12],76,-1,292,-1,277
1,<environment.Job instance at 0x7fda57dc7820>,87,2,[ 5 12],88,-1,319,-1,317
1,<environment.Job instance at 0x7fda57dc7550>,92,25,[2 8],93,-1,353,-1,328
1,<environment.Job instance at 0x7fda57f996e0>,96,26,[ 1 12],97,-1,368,-1,342
1,<environment.Job instance at 0x7fda57f99eb0>,103,2,[11  4],104,-1,374,-1,372
1,<environment.Job instance at 0x7fda58b91960>,107,2,[11  1],108,-1,387,-1,385
1,<environment.Job instance at 0x7fda58aaa190>,119,2,[ 3 11],120,-1,426,-1,424
1,<environment.Job instance at 0x7fda59131af0>,130,24,[2 5],131,-1,474,-1,450
1,<environment.Job instance at 0x7fda61ce6dc0>,137,3,[13  1],138,-1,471,-1,468
1,<environment.Job instance at 0x7fda59145960>,136,24,[ 1 10],137,-1,502,-1,478
1,<environment.Job instance at 0x7fda61ce63c0>,143,25,[4 6],144,-1,509,-1,484
1,<environment.Job instance at 0x7fda61ce6410>,153,18,[ 5 12],154,-1,549,-1,531
1,<environment.Job instance at 0x7fda593a5730>,159,16,[14  3],160,-1,576,-1,560
1,<environment.Job instance at 0x7fda5960c140>,3,15,[ 5 10],4,-1,20,-1,5
1,<environment.Job instance at 0x7fda5960ca00>,4,18,[8 1],5,-1,23,-1,5
1,<environment.Job instance at 0x7fda58356cd0>,7,12,[10  3],8,-1,22,-1,10
1,<environment.Job instance at 0x7fda583563c0>,10,18,[5 7],11,-1,29,-1,11
1,<environment.Job instance at 0x7fda58356280>,11,13,[ 3 10],12,-1,25,-1,12
1,<environment.Job instance at 0x7fda58356820>,9,14,[ 5 10],10,-1,26,-1,12
1,<environment.Job instance at 0x7fda583561e0>,12,18,[6 5],13,-1,31,-1,13
1,<environment.Job instance at 0x7fda58356230>,14,16,[9 5],15,-1,34,-1,18
1,<environment.Job instance at 0x7fda58356b40>,18,14,[5 7],19,-1,33,-1,19
1,<environment.Job instance at 0x7fda621f19b0>,26,17,[10  5],27,-1,44,-1,27
1,<environment.Job instance at 0x7fda621f16e0>,29,21,[7 5],30,-1,51,-1,30
1,<environment.Job instance at 0x7fda621f1cd0>,34,18,[1 8],35,-1,53,-1,35
1,<environment.Job instance at 0x7fda621f18c0>,35,21,[6 2],36,-1,57,-1,36
1,<environment.Job instance at 0x7fda58c66230>,39,17,[9 1],40,-1,57,-1,40
1,<environment.Job instance at 0x7fda621ecf50>,42,17,[5 5],43,-1,60,-1,43
1,<environment.Job instance at 0x7fda7e510c80>,44,15,[5 9],45,-1,60,-1,45
1,<environment.Job instance at 0x7fda583970f0>,46,17,[7 1],47,-1,64,-1,47
1,<environment.Job instance at 0x7fda58adcc30>,49,16,[9 2],50,-1,66,-1,50
1,<environment.Job instance at 0x7fda58adc690>,53,17,[2 7],54,-1,71,-1,54
1,<environment.Job instance at 0x7fda58adc8c0>,56,17,[ 2 10],57,-1,74,-1,57
1,<environment.Job instance at 0x7fda582e4dc0>,57,16,[3 9],58,-1,74,-1,58
1,<environment.Job instance at 0x7fda58edce60>,58,14,[3 5],59,-1,73,-1,59
1,<environment.Job instance at 0x7fda58edccd0>,59,16,[6 3],60,-1,76,-1,60
1,<environment.Job instance at 0x7fda58edcf50>,60,14,[7 4],61,-1,75,-1,61
1,<environment.Job instance at 0x7fda57d758c0>,63,18,[5 3],64,-1,82,-1,64
1,<environment.Job instance at 0x7fda57d75cd0>,64,14,[7 5],65,-1,79,-1,65
1,<environment.Job instance at 0x7fda57d75e60>,65,14,[5 5],66,-1,80,-1,66
1,<environment.Job instance at 0x7fda5945f0f0>,66,22,[8 4],67,-1,89,-1,67
1,<environment.Job instance at 0x7fda58ed9050>,67,20,[5 5],68,-1,88,-1,68
1,<environment.Job instance at 0x7fda57eea550>,69,14,[ 2 10],70,-1,84,-1,70
1,<environment.Job instance at 0x7fda621dd050>,70,17,[11  3],71,-1,88,-1,71
1,<environment.Job instance at 0x7fda595284b0>,72,15,[6 5],73,-1,88,-1,73
1,<environment.Job instance at 0x7fda58c87140>,81,12,[8 3],82,-1,94,-1,82
1,<environment.Job instance at 0x7fda58c87870>,82,12,[10  2],83,-1,95,-1,83
1,<environment.Job instance at 0x7fda58c87d70>,83,13,[3 6],84,-1,97,-1,84
1,<environment.Job instance at 0x7fda58c87320>,84,17,[5 1],85,-1,102,-1,85
1,<environment.Job instance at 0x7fda58c87e10>,87,23,[2 9],88,-1,111,-1,88
1,<environment.Job instance at 0x7fda58c87690>,89,16,[7 1],90,-1,113,-1,97
1,<environment.Job instance at 0x7fda61c95a50>,96,15,[10  3],97,-1,113,-1,98
1,<environment.Job instance at 0x7fda59518eb0>,99,18,[4 9],100,-1,119,-1,101
1,<environment.Job instance at 0x7fda593a59b0>,13,24,[ 5 11],14,-1,47,-1,23
1,<environment.Job instance at 0x7fda61ce62d0>,24,16,[12  5],25,-1,84,-1,68
1,<environment.Job instance at 0x7fda61ce6eb0>,31,19,[14  4],32,-1,103,-1,84
1,<environment.Job instance at 0x7fda61ce66e0>,37,3,[ 5 11],38,-1,101,-1,98
1,<environment.Job instance at 0x7fda69c87190>,38,1,[11  4],39,-1,99,-1,98
1,<environment.Job instance at 0x7fda592f8190>,70,17,[11  3],71,-1,228,-1,211
1,<environment.Job instance at 0x7fda5930e870>,75,1,[ 5 14],76,-1,226,-1,225
1,<environment.Job instance at 0x7fda59505500>,87,23,[2 9],88,-1,290,-1,267
1,<environment.Job instance at 0x7fda592f35f0>,88,2,[ 1 11],89,-1,269,-1,267
1,<environment.Job instance at 0x7fda5901d5a0>,111,23,[10  2],112,-1,377,-1,354
1,<environment.Job instance at 0x7fda59706780>,131,26,[14  5],132,-1,475,-1,449
1,<environment.Job instance at 0x7fda58aac960>,140,17,[ 5 11],141,-1,492,-1,475
1,<environment.Job instance at 0x7fda5853b410>,154,3,[13  3],155,-1,519,-1,516
1,<environment.Job instance at 0x7fda592e3730>,171,25,[12  4],172,-1,622,-1,597
1,<environment.Job instance at 0x7fda592e34b0>,9,18,[7 1],10,-1,30,-1,12
1,<environment.Job instance at 0x7fda592e3e10>,11,18,[7 5],12,-1,30,-1,12
1,<environment.Job instance at 0x7fda592e33c0>,16,17,[6 5],17,-1,34,-1,17
1,<environment.Job instance at 0x7fda592e35f0>,17,18,[9 5],18,-1,36,-1,18
1,<environment.Job instance at 0x7fda592e3050>,18,13,[10  3],19,-1,35,-1,22
1,<environment.Job instance at 0x7fda58c22960>,21,14,[5 2],22,-1,36,-1,22
1,<environment.Job instance at 0x7fda58c229b0>,24,17,[9 4],25,-1,42,-1,25
1,<environment.Job instance at 0x7fda58c22f50>,26,23,[ 4 10],27,-1,50,-1,27
1,<environment.Job instance at 0x7fda57fe2d70>,27,15,[10  1],28,-1,43,-1,28
1,<environment.Job instance at 0x7fda57fe2190>,29,16,[3 8],30,-1,46,-1,30
1,<environment.Job instance at 0x7fda57fe2dc0>,38,12,[9 2],39,-1,51,-1,39
1,<environment.Job instance at 0x7fda57fe25f0>,39,17,[10  5],40,-1,57,-1,40
1,<environment.Job instance at 0x7fda594f2f50>,8,16,[ 4 12],9,-1,25,-1,9
1,<environment.Job instance at 0x7fda586344b0>,12,3,[12  2],13,-1,16,-1,13
1,<environment.Job instance at 0x7fda596d54b0>,13,18,[13  1],14,-1,32,-1,14
1,<environment.Job instance at 0x7fda58f11050>,26,23,[ 4 10],27,-1,90,-1,67
1,<environment.Job instance at 0x7fda62398c30>,31,28,[9 4],32,-1,102,-1,74
1,<environment.Job instance at 0x7fda5946e3c0>,32,25,[12  5],33,-1,99,-1,74
1,<environment.Job instance at 0x7fda596f1af0>,44,25,[1 6],45,-1,149,-1,124
1,<environment.Job instance at 0x7fda58a90550>,62,24,[3 5],63,-1,232,-1,208
1,<environment.Job instance at 0x7fda592e5af0>,65,27,[1 5],66,-1,249,-1,222
1,<environment.Job instance at 0x7fda593137d0>,73,14,[11  5],74,-1,254,-1,240
1,<environment.Job instance at 0x7fda585493c0>,104,16,[ 2 11],105,-1,368,-1,352
1,<environment.Job instance at 0x7fda57f14320>,106,2,[11  2],107,-1,356,-1,354
1,<environment.Job instance at 0x7fda5965b7d0>,116,15,[13  1],117,-1,402,-1,387
1,<environment.Job instance at 0x7fda5890feb0>,132,1,[11  5],133,-1,424,-1,423
1,<environment.Job instance at 0x7fda589271e0>,141,3,[11  1],142,-1,449,-1,446
1,<environment.Job instance at 0x7fda58927460>,142,2,[11  5],143,-1,448,-1,446
1,<environment.Job instance at 0x7fda58927910>,145,26,[9 2],146,-1,488,-1,462
1,<environment.Job instance at 0x7fda58927050>,140,28,[6 4],141,-1,490,-1,462
1,<environment.Job instance at 0x7fda58fa3410>,151,23,[4 5],152,-1,502,-1,479
1,<environment.Job instance at 0x7fda58fa35f0>,155,3,[ 3 11],156,-1,498,-1,495
1,<environment.Job instance at 0x7fda58fa3730>,156,17,[14  5],157,-1,512,-1,495
1,<environment.Job instance at 0x7fda61cd43c0>,168,26,[1 5],169,-1,558,-1,532
1,<environment.Job instance at 0x7fda61cd4780>,172,2,[ 4 13],173,-1,548,-1,546
1,<environment.Job instance at 0x7fda5945fd20>,178,16,[ 1 14],180,-1,574,-1,558
1,<environment.Job instance at 0x7fda58f9ce60>,4,12,[3 8],5,-1,17,-1,5
1,<environment.Job instance at 0x7fda58f9c0a0>,11,12,[5 4],12,-1,24,-1,12
1,<environment.Job instance at 0x7fda586c21e0>,14,20,[ 1 10],15,-1,35,-1,15
1,<environment.Job instance at 0x7fda586c2b90>,15,18,[5 5],16,-1,34,-1,16
1,<environment.Job instance at 0x7fda586c2140>,16,15,[5 3],17,-1,33,-1,18
1,<environment.Job instance at 0x7fda586c2e10>,19,17,[5 7],20,-1,37,-1,20
1,<environment.Job instance at 0x7fda586c2640>,23,13,[ 1 11],24,-1,37,-1,24
1,<environment.Job instance at 0x7fda586c2190>,24,15,[4 7],25,-1,40,-1,25
1,<environment.Job instance at 0x7fda586c2d70>,25,16,[7 4],26,-1,42,-1,26
1,<environment.Job instance at 0x7fda586c2460>,27,13,[7 2],28,-1,41,-1,28
1,<environment.Job instance at 0x7fda586c20a0>,17,18,[6 1],18,-1,46,-1,28
1,<environment.Job instance at 0x7fda582e4a00>,30,17,[1 6],31,-1,48,-1,31
1,<environment.Job instance at 0x7fda57ee1aa0>,34,16,[6 1],35,-1,52,-1,36
1,<environment.Job instance at 0x7fda57ee1370>,35,16,[10  3],36,-1,52,-1,36
1,<environment.Job instance at 0x7fda57ee1910>,36,15,[7 3],37,-1,53,-1,38
1,<environment.Job instance at 0x7fda57ee18c0>,38,17,[5 7],39,-1,56,-1,39
1,<environment.Job instance at 0x7fda57ee1dc0>,39,15,[8 1],40,-1,55,-1,40
1,<environment.Job instance at 0x7fda57ee1b90>,40,14,[10  4],41,-1,55,-1,41
1,<environment.Job instance at 0x7fda57ee14b0>,43,25,[6 2],44,-1,69,-1,44
1,<environment.Job instance at 0x7fda57ee15a0>,44,15,[10  3],45,-1,60,-1,45
1,<environment.Job instance at 0x7fda57ee10f0>,37,21,[1 8],38,-1,77,-1,56
1,<environment.Job instance at 0x7fda57ee1500>,48,15,[10  5],49,-1,72,-1,57
1,<environment.Job instance at 0x7fda5831f5f0>,56,15,[8 3],57,-1,72,-1,57
1,<environment.Job instance at 0x7fda586c2780>,21,18,[12  2],22,-1,78,-1,60
1,<environment.Job instance at 0x7fda5831fb40>,61,18,[14  2],62,-1,83,-1,65
1,<environment.Job instance at 0x7fda5831f870>,63,17,[10  5],64,-1,83,-1,66
1,<environment.Job instance at 0x7fda58229140>,65,17,[13  3],66,-1,83,-1,66
1,<environment.Job instance at 0x7fda5831fd20>,64,17,[1 9],65,-1,83,-1,66
1,<environment.Job instance at 0x7fda5831fcd0>,59,16,[5 4],60,-1,85,-1,69
1,<environment.Job instance at 0x7fda58229b90>,71,17,[1 7],72,-1,89,-1,72
1,<environment.Job instance at 0x7fda582299b0>,72,16,[8 4],73,-1,91,-1,75
1,<environment.Job instance at 0x7fda59287b90>,81,16,[2 6],82,-1,98,-1,82
1,<environment.Job instance at 0x7fda59287a00>,82,19,[2 9],83,-1,102,-1,83
1,<environment.Job instance at 0x7fda59287730>,83,18,[8 4],84,-1,102,-1,84
1,<environment.Job instance at 0x7fda59287410>,84,22,[9 1],85,-1,108,-1,86
1,<environment.Job instance at 0x7fda58229eb0>,68,14,[10  4],69,-1,101,-1,87
1,<environment.Job instance at 0x7fda59287c80>,87,12,[5 5],88,-1,100,-1,88
1,<environment.Job instance at 0x7fda59287870>,76,28,[5 5],77,-1,116,-1,88
1,<environment.Job instance at 0x7fda59287f00>,88,13,[6 4],89,-1,102,-1,89
1,<environment.Job instance at 0x7fda59287820>,89,18,[6 3],90,-1,108,-1,90
1,<environment.Job instance at 0x7fda59287af0>,91,18,[5 6],92,-1,114,-1,96
1,<environment.Job instance at 0x7fda59287500>,93,17,[3 6],94,-1,116,-1,99
1,<environment.Job instance at 0x7fda57fb4820>,97,14,[9 5],98,-1,113,-1,99
1,<environment.Job instance at 0x7fda592875f0>,80,24,[8 2],81,-1,123,-1,99
1,<environment.Job instance at 0x7fda58750910>,101,22,[10  3],102,-1,135,-1,113
1,<environment.Job instance at 0x7fda585f3dc0>,103,16,[ 4 10],104,-1,138,-1,122
1,<environment.Job instance at 0x7fda585f3e10>,104,18,[6 5],105,-1,140,-1,122
1,<environment.Job instance at 0x7fda57f42a50>,117,17,[6 5],118,-1,205,-1,188
1,<environment.Job instance at 0x7fda57ee1be0>,46,20,[ 5 11],47,-1,208,-1,188
1,<environment.Job instance at 0x7fda594d01e0>,119,15,[10  3],120,-1,210,-1,195
1,<environment.Job instance at 0x7fda5923d960>,100,25,[ 5 10],101,-1,220,-1,195
1,<environment.Job instance at 0x7fda5843c640>,120,15,[9 4],121,-1,210,-1,195
1,<environment.Job instance at 0x7fda58db1410>,124,16,[9 4],125,-1,211,-1,195
1,<environment.Job instance at 0x7fda592d95f0>,122,17,[10  3],123,-1,214,-1,197
1,<environment.Job instance at 0x7fda58da8be0>,121,18,[5 7],122,-1,216,-1,198
1,<environment.Job instance at 0x7fda57e4f190>,127,15,[9 4],128,-1,219,-1,204
1,<environment.Job instance at 0x7fda57e4f5a0>,126,25,[8 2],127,-1,230,-1,205
1,<environment.Job instance at 0x7fda58d9f230>,132,17,[12  2],133,-1,234,-1,217
1,<environment.Job instance at 0x7fda57e25f00>,137,14,[3 6],138,-1,234,-1,220
1,<environment.Job instance at 0x7fda58f3d280>,138,18,[5 7],139,-1,242,-1,224
1,<environment.Job instance at 0x7fda57e25d20>,135,16,[1 9],136,-1,240,-1,224
1,<environment.Job instance at 0x7fda58f3d0f0>,140,18,[6 3],141,-1,242,-1,224
1,<environment.Job instance at 0x7fda57f86f00>,123,17,[10  4],124,-1,241,-1,224
1,<environment.Job instance at 0x7fda58f3dd70>,145,22,[5 8],146,-1,246,-1,224
1,<environment.Job instance at 0x7fda58f3db90>,146,15,[ 5 13],147,-1,239,-1,224
1,<environment.Job instance at 0x7fda57e259b0>,136,16,[5 5],137,-1,240,-1,224
1,<environment.Job instance at 0x7fda58f3d820>,144,15,[3 8],145,-1,239,-1,224
1,<environment.Job instance at 0x7fda589d73c0>,151,18,[10  2],152,-1,242,-1,224
1,<environment.Job instance at 0x7fda61d1b2d0>,152,18,[1 8],153,-1,242,-1,224
1,<environment.Job instance at 0x7fda61c8cc80>,155,17,[ 1 10],156,-1,243,-1,226
1,<environment.Job instance at 0x7fda59064eb0>,167,16,[9 2],168,-1,271,-1,255
1,<environment.Job instance at 0x7fda585f3870>,111,24,[10  4],112,-1,306,-1,282
1,<environment.Job instance at 0x7fda5823bf00>,180,21,[5 9],181,-1,305,-1,284
1,<environment.Job instance at 0x7fda5823bd70>,182,18,[9 2],183,-1,305,-1,287
1,<environment.Job instance at 0x7fda582e4c80>,1,14,[ 4 14],2,-1,16,-1,2
1,<environment.Job instance at 0x7fda582294b0>,9,15,[ 5 13],10,-1,31,-1,16
1,<environment.Job instance at 0x7fda58229aa0>,10,3,[13  2],11,-1,19,-1,16
1,<environment.Job instance at 0x7fda5827bdc0>,21,18,[12  2],22,-1,56,-1,38
1,<environment.Job instance at 0x7fda5806e2d0>,22,2,[ 2 13],23,-1,40,-1,38
1,<environment.Job instance at 0x7fda61d11c30>,23,13,[ 1 11],24,-1,51,-1,38
1,<environment.Job instance at 0x7fda592383c0>,31,24,[10  2],32,-1,94,-1,70
1,<environment.Job instance at 0x7fda58f9c550>,43,25,[6 2],44,-1,145,-1,120
1,<environment.Job instance at 0x7fda61cd4aa0>,46,20,[ 5 11],47,-1,141,-1,121
1,<environment.Job instance at 0x7fda58fa35f0>,61,18,[14  2],62,-1,218,-1,200
1,<environment.Job instance at 0x7fda588f7780>,65,17,[13  3],66,-1,229,-1,212
1,<environment.Job instance at 0x7fda58809a00>,70,2,[13  1],71,-1,231,-1,229
1,<environment.Job instance at 0x7fda5921e3c0>,75,1,[11  2],76,-1,246,-1,245
1,<environment.Job instance at 0x7fda5890feb0>,76,28,[5 5],77,-1,275,-1,247
1,<environment.Job instance at 0x7fda58efcd70>,80,24,[8 2],81,-1,285,-1,261
1,<environment.Job instance at 0x7fda5965b7d0>,92,3,[ 3 14],93,-1,307,-1,304
1,<environment.Job instance at 0x7fda57d7df00>,100,25,[ 5 10],101,-1,369,-1,344
1,<environment.Job instance at 0x7fda5853e0a0>,107,12,[ 3 12],108,-1,376,-1,364
1,<environment.Job instance at 0x7fda5853eeb0>,108,3,[11  2],109,-1,367,-1,364
1,<environment.Job instance at 0x7fda5853e1e0>,109,26,[14  4],110,-1,390,-1,364
1,<environment.Job instance at 0x7fda5853e370>,111,24,[10  4],112,-1,408,-1,384
1,<environment.Job instance at 0x7fda61c9c0a0>,113,2,[ 3 14],114,-1,386,-1,384
1,<environment.Job instance at 0x7fda5930e5f0>,126,25,[8 2],127,-1,491,-1,466
1,<environment.Job instance at 0x7fda59313050>,130,13,[ 3 13],131,-1,494,-1,481
1,<environment.Job instance at 0x7fda59021230>,132,17,[12  2],133,-1,498,-1,481
1,<environment.Job instance at 0x7fda592fc190>,146,15,[ 5 13],147,-1,583,-1,568
1,<environment.Job instance at 0x7fda58a74b40>,150,1,[ 3 11],151,-1,584,-1,583
1,<environment.Job instance at 0x7fda596d47d0>,156,3,[ 2 13],157,-1,608,-1,605
1,<environment.Job instance at 0x7fda62049410>,159,18,[14  4],160,-1,627,-1,609
1,<environment.Job instance at 0x7fda584242d0>,162,2,[13  5],163,-1,625,-1,623
1,<environment.Job instance at 0x7fda58424050>,163,17,[11  2],164,-1,640,-1,623
1,<environment.Job instance at 0x7fda5946e3c0>,166,18,[14  1],167,-1,645,-1,627
1,<environment.Job instance at 0x7fda592e3e60>,169,2,[12  1],170,-1,632,-1,630
1,<environment.Job instance at 0x7fda592e3b40>,170,13,[ 1 11],171,-1,643,-1,630
1,<environment.Job instance at 0x7fda592e3af0>,172,13,[13  2],173,-1,644,-1,631
1,<environment.Job instance at 0x7fda57fea190>,0,17,[5 6],1,-1,18,-1,1
1,<environment.Job instance at 0x7fda58fa3460>,10,19,[8 1],11,-1,30,-1,11
1,<environment.Job instance at 0x7fda588bec80>,13,14,[10  5],14,-1,28,-1,14
1,<environment.Job instance at 0x7fda588be280>,15,15,[1 7],16,-1,31,-1,16
1,<environment.Job instance at 0x7fda588be5a0>,17,18,[9 5],18,-1,36,-1,18
1,<environment.Job instance at 0x7fda588becd0>,20,16,[9 2],21,-1,37,-1,21
1,<environment.Job instance at 0x7fda588be780>,23,18,[6 2],24,-1,43,-1,25
1,<environment.Job instance at 0x7fda588be230>,24,25,[9 4],25,-1,50,-1,25
1,<environment.Job instance at 0x7fda57dd3c80>,29,18,[8 4],30,-1,48,-1,30
1,<environment.Job instance at 0x7fda57dd38c0>,31,21,[2 6],32,-1,53,-1,32
1,<environment.Job instance at 0x7fda57dd3b40>,32,16,[1 6],33,-1,49,-1,33
1,<environment.Job instance at 0x7fda57dd3f50>,33,15,[5 3],34,-1,49,-1,34
1,<environment.Job instance at 0x7fda57dd3320>,35,14,[5 2],36,-1,50,-1,36
1,<environment.Job instance at 0x7fda58f30d20>,38,17,[1 7],39,-1,56,-1,39
1,<environment.Job instance at 0x7fda58f300f0>,40,15,[8 2],41,-1,56,-1,41
1,<environment.Job instance at 0x7fda58d41820>,50,16,[2 5],51,-1,67,-1,51
1,<environment.Job instance at 0x7fda58d8d640>,54,17,[6 2],55,-1,72,-1,55
1,<environment.Job instance at 0x7fda58d8d780>,55,12,[10  3],56,-1,69,-1,57
1,<environment.Job instance at 0x7fda58d8dd20>,56,26,[7 5],57,-1,83,-1,57
1,<environment.Job instance at 0x7fda589e9960>,58,12,[7 4],59,-1,72,-1,60
1,<environment.Job instance at 0x7fda58cf3d70>,60,14,[4 9],61,-1,75,-1,61
1,<environment.Job instance at 0x7fda58cf3b90>,61,16,[1 7],62,-1,78,-1,62
1,<environment.Job instance at 0x7fda58cf3410>,62,25,[1 9],63,-1,88,-1,63
1,<environment.Job instance at 0x7fda59676050>,63,18,[6 3],64,-1,82,-1,64
1,<environment.Job instance at 0x7fda58ca7730>,65,18,[6 5],66,-1,84,-1,66
1,<environment.Job instance at 0x7fda589ea820>,59,12,[7 5],60,-1,80,-1,68
1,<environment.Job instance at 0x7fda58a77a50>,70,24,[5 4],71,-1,95,-1,71
1,<environment.Job instance at 0x7fda589ba500>,71,13,[3 7],72,-1,85,-1,72
1,<environment.Job instance at 0x7fda61cfa730>,76,17,[10  4],77,-1,95,-1,78
1,<environment.Job instance at 0x7fda59168050>,78,18,[10  5],79,-1,97,-1,79
1,<environment.Job instance at 0x7fda59168690>,79,13,[6 3],80,-1,93,-1,80
1,<environment.Job instance at 0x7fda59168e60>,80,15,[7 3],81,-1,96,-1,81
1,<environment.Job instance at 0x7fda5821ea00>,82,17,[7 5],83,-1,100,-1,83
1,<environment.Job instance at 0x7fda589c6780>,77,16,[10  2],78,-1,100,-1,84
1,<environment.Job instance at 0x7fda61cf9cd0>,85,16,[9 5],86,-1,103,-1,87
1,<environment.Job instance at 0x7fda593b6050>,87,16,[2 8],88,-1,104,-1,88
1,<environment.Job instance at 0x7fda581fe4b0>,88,27,[9 1],89,-1,116,-1,89
1,<environment.Job instance at 0x7fda581fe730>,89,16,[1 7],90,-1,106,-1,90
1,<environment.Job instance at 0x7fda581d6730>,96,14,[5 5],97,-1,111,-1,97
1,<environment.Job instance at 0x7fda581d6e60>,98,15,[8 3],99,-1,114,-1,99
1,<environment.Job instance at 0x7fda596d5b90>,103,16,[8 3],104,-1,120,-1,104
1,<environment.Job instance at 0x7fda596d5140>,104,12,[ 2 10],105,-1,117,-1,105
1,<environment.Job instance at 0x7fda596d5c80>,105,21,[1 5],106,-1,127,-1,106
1,<environment.Job instance at 0x7fda581c85f0>,112,12,[9 4],113,-1,128,-1,116
1,<environment.Job instance at 0x7fda581c85a0>,111,17,[2 7],112,-1,133,-1,116
1,<environment.Job instance at 0x7fda58363af0>,117,16,[2 8],118,-1,134,-1,118
1,<environment.Job instance at 0x7fda583635f0>,114,15,[9 3],115,-1,138,-1,123
1,<environment.Job instance at 0x7fda58c13320>,121,18,[8 2],122,-1,141,-1,123
1,<environment.Job instance at 0x7fda58c13d20>,122,18,[5 9],123,-1,144,-1,126
1,<environment.Job instance at 0x7fda58363280>,115,28,[5 2],116,-1,155,-1,127
1,<environment.Job instance at 0x7fda581c7910>,126,15,[7 5],127,-1,143,-1,128
1,<environment.Job instance at 0x7fda58ac8aa0>,127,20,[5 5],128,-1,150,-1,130
1,<environment.Job instance at 0x7fda5946eaa0>,130,27,[5 7],131,-1,159,-1,132
1,<environment.Job instance at 0x7fda58ac8500>,131,15,[8 3],132,-1,148,-1,133
1,<environment.Job instance at 0x7fda58cb5780>,129,12,[10  4],130,-1,148,-1,136
1,<environment.Job instance at 0x7fda59679280>,133,23,[9 1],134,-1,159,-1,136
1,<environment.Job instance at 0x7fda58c13d70>,128,15,[6 3],129,-1,151,-1,136
1,<environment.Job instance at 0x7fda5974b280>,137,17,[9 5],138,-1,155,-1,138
1,<environment.Job instance at 0x7fda595bee60>,145,15,[14  1],146,-1,161,-1,146
1,<environment.Job instance at 0x7fda5832c690>,143,16,[10  1],144,-1,162,-1,146
1,<environment.Job instance at 0x7fda586825a0>,146,20,[8 3],147,-1,167,-1,147
1,<environment.Job instance at 0x7fda5868bb90>,144,12,[8 3],145,-1,160,-1,148
1,<environment.Job instance at 0x7fda583468c0>,73,28,[1 9],74,-1,176,-1,148
1,<environment.Job instance at 0x7fda57e0c780>,148,17,[4 8],149,-1,166,-1,149
1,<environment.Job instance at 0x7fda5869ddc0>,151,13,[ 5 10],152,-1,168,-1,155
1,<environment.Job instance at 0x7fda586ce7d0>,150,25,[ 1 12],151,-1,180,-1,155
1,<environment.Job instance at 0x7fda58cfd280>,156,12,[7 5],157,-1,170,-1,158
1,<environment.Job instance at 0x7fda5969a870>,159,18,[3 9],160,-1,178,-1,160
1,<environment.Job instance at 0x7fda5969a190>,158,13,[ 2 11],159,-1,173,-1,160
1,<environment.Job instance at 0x7fda58cfd190>,160,18,[6 2],161,-1,179,-1,161
1,<environment.Job instance at 0x7fda586da870>,162,17,[2 6],163,-1,180,-1,163
1,<environment.Job instance at 0x7fda58cfd230>,154,12,[8 5],155,-1,177,-1,165
1,<environment.Job instance at 0x7fda586b8780>,164,16,[5 4],165,-1,181,-1,165
1,<environment.Job instance at 0x7fda596816e0>,165,13,[8 1],166,-1,179,-1,166
1,<environment.Job instance at 0x7fda59681280>,168,15,[7 4],169,-1,185,-1,170
1,<environment.Job instance at 0x7fda59080820>,170,13,[10  3],171,-1,184,-1,171
1,<environment.Job instance at 0x7fda59080370>,173,15,[10  3],174,-1,191,-1,176
1,<environment.Job instance at 0x7fda595af320>,177,15,[10  1],178,-1,193,-1,178
1,<environment.Job instance at 0x7fda595af410>,178,17,[1 8],179,-1,196,-1,179
1,<environment.Job instance at 0x7fda622c6050>,169,14,[3 7],170,-1,194,-1,180
1,<environment.Job instance at 0x7fda58d8da50>,182,14,[6 1],183,-1,197,-1,183
1,<environment.Job instance at 0x7fda5974b690>,136,26,[ 2 10],137,-1,209,-1,183
1,<environment.Job instance at 0x7fda59080f00>,175,17,[10  3],176,-1,208,-1,191
1,<environment.Job instance at 0x7fda58d418c0>,2,16,[12  1],3,-1,19,-1,3
1,<environment.Job instance at 0x7fda59136550>,5,24,[5 2],6,-1,30,-1,6
1,<environment.Job instance at 0x7fda58a77780>,6,17,[ 3 14],7,-1,24,-1,7
1,<environment.Job instance at 0x7fda58c137d0>,24,25,[9 4],25,-1,78,-1,53
1,<environment.Job instance at 0x7fda5831f0f0>,41,1,[ 4 13],42,-1,93,-1,92
1,<environment.Job instance at 0x7fda58361460>,56,26,[7 5],57,-1,158,-1,132
1,<environment.Job instance at 0x7fda58bdecd0>,62,25,[1 9],63,-1,188,-1,163
1,<environment.Job instance at 0x7fda58be4f00>,70,24,[5 4],71,-1,208,-1,184
1,<environment.Job instance at 0x7fda5825b050>,73,28,[1 9],74,-1,240,-1,212
1,<environment.Job instance at 0x7fda5836ceb0>,88,27,[9 1],89,-1,312,-1,285
1,<environment.Job instance at 0x7fda57f20960>,107,28,[9 2],108,-1,356,-1,328
1,<environment.Job instance at 0x7fda58331410>,109,3,[13  5],110,-1,331,-1,328
1,<environment.Job instance at 0x7fda584470a0>,113,16,[ 1 13],114,-1,360,-1,344
1,<environment.Job instance at 0x7fda58bcd230>,115,28,[5 2],116,-1,384,-1,356
1,<environment.Job instance at 0x7fda58431a00>,130,27,[5 7],131,-1,455,-1,428
1,<environment.Job instance at 0x7fda58cee500>,133,23,[9 1],134,-1,466,-1,443
1,<environment.Job instance at 0x7fda5846d500>,136,26,[ 2 10],137,-1,475,-1,449
1,<environment.Job instance at 0x7fda5833fd70>,145,15,[14  1],146,-1,475,-1,460
1,<environment.Job instance at 0x7fda5833f0f0>,147,3,[13  4],148,-1,475,-1,472
1,<environment.Job instance at 0x7fda58455be0>,150,25,[ 1 12],151,-1,499,-1,474
1,<environment.Job instance at 0x7fda582151e0>,158,13,[ 2 11],159,-1,517,-1,504
1,<environment.Job instance at 0x7fda583460f0>,163,3,[ 5 13],164,-1,538,-1,535
1,<environment.Job instance at 0x7fda58352410>,183,18,[ 2 12],184,-1,636,-1,618
1,<environment.Job instance at 0x7fda595b82d0>,1,17,[8 2],2,-1,21,-1,4
1,<environment.Job instance at 0x7fda595b8730>,5,14,[3 9],6,-1,20,-1,6
1,<environment.Job instance at 0x7fda595b8af0>,6,18,[5 5],7,-1,25,-1,7
1,<environment.Job instance at 0x7fda595b85f0>,3,15,[ 1 10],4,-1,24,-1,9
1,<environment.Job instance at 0x7fda595b8eb0>,9,18,[9 3],10,-1,29,-1,11
1,<environment.Job instance at 0x7fda595b87d0>,10,13,[9 5],11,-1,24,-1,11
1,<environment.Job instance at 0x7fda595b8140>,13,18,[9 4],14,-1,33,-1,15
1,<environment.Job instance at 0x7fda5822e190>,16,17,[4 8],17,-1,34,-1,17
1,<environment.Job instance at 0x7fda5822e870>,17,20,[7 1],18,-1,39,-1,19
1,<environment.Job instance at 0x7fda5822e0a0>,19,17,[8 1],20,-1,37,-1,20
1,<environment.Job instance at 0x7fda5822e6e0>,20,12,[9 5],21,-1,33,-1,21
1,<environment.Job instance at 0x7fda5822e690>,22,13,[1 9],23,-1,36,-1,23
1,<environment.Job instance at 0x7fda5822e050>,23,16,[9 2],24,-1,40,-1,24
1,<environment.Job instance at 0x7fda5822e780>,24,13,[5 9],25,-1,38,-1,25
1,<environment.Job instance at 0x7fda5822e550>,26,16,[7 5],27,-1,43,-1,27
1,<environment.Job instance at 0x7fda5820b230>,34,18,[ 5 10],35,-1,53,-1,35
1,<environment.Job instance at 0x7fda58226cd0>,45,27,[9 2],46,-1,79,-1,52
1,<environment.Job instance at 0x7fda58226140>,40,14,[13  5],41,-1,66,-1,52
1,<environment.Job instance at 0x7fda58226c80>,37,26,[9 1],38,-1,79,-1,53
1,<environment.Job instance at 0x7fda581fcaa0>,49,17,[ 4 10],50,-1,70,-1,53
1,<environment.Job instance at 0x7fda581fc320>,51,18,[10  3],52,-1,71,-1,53
1,<environment.Job instance at 0x7fda58226550>,44,15,[9 1],45,-1,69,-1,54
1,<environment.Job instance at 0x7fda581fc9b0>,54,19,[5 8],55,-1,77,-1,58
1,<environment.Job instance at 0x7fda581fce10>,53,15,[5 8],54,-1,80,-1,65
1,<environment.Job instance at 0x7fda5820fc80>,60,14,[4 9],61,-1,79,-1,65
1,<environment.Job instance at 0x7fda581fcaf0>,48,16,[2 9],49,-1,83,-1,67
1,<environment.Job instance at 0x7fda5820fdc0>,63,16,[7 5],64,-1,83,-1,67
1,<environment.Job instance at 0x7fda5820ff50>,62,21,[1 8],63,-1,88,-1,67
1,<environment.Job instance at 0x7fda5820f910>,65,17,[9 4],66,-1,86,-1,69
1,<environment.Job instance at 0x7fda58215eb0>,71,15,[7 3],72,-1,87,-1,72
1,<environment.Job instance at 0x7fda58215b40>,72,18,[8 1],73,-1,95,-1,77
1,<environment.Job instance at 0x7fda58215f00>,74,16,[4 8],75,-1,93,-1,77
1,<environment.Job instance at 0x7fda5820f2d0>,64,13,[7 3],65,-1,90,-1,77
1,<environment.Job instance at 0x7fda58215730>,76,22,[5 9],77,-1,100,-1,78
1,<environment.Job instance at 0x7fda58cee870>,80,2,[3 6],81,-1,91,-1,89
1,<environment.Job instance at 0x7fda58cee3c0>,83,16,[8 4],84,-1,106,-1,90
1,<environment.Job instance at 0x7fda581fcc30>,50,14,[8 2],51,-1,104,-1,90
1,<environment.Job instance at 0x7fda58cee5a0>,82,18,[5 4],83,-1,108,-1,90
1,<environment.Job instance at 0x7fda58cee190>,79,13,[7 1],80,-1,103,-1,90
1,<environment.Job instance at 0x7fda58cee050>,86,2,[2 6],87,-1,92,-1,90
1,<environment.Job instance at 0x7fda58cee550>,84,12,[5 7],85,-1,102,-1,90
1,<environment.Job instance at 0x7fda5821af50>,97,28,[1 7],98,-1,126,-1,98
1,<environment.Job instance at 0x7fda5821ab90>,99,16,[9 1],100,-1,120,-1,104
1,<environment.Job instance at 0x7fda581fe050>,103,17,[2 6],104,-1,122,-1,105
1,<environment.Job instance at 0x7fda581fe140>,104,17,[ 1 12],105,-1,124,-1,107
1,<environment.Job instance at 0x7fda58226370>,42,20,[ 5 10],43,-1,128,-1,108
1,<environment.Job instance at 0x7fda5820dcd0>,92,19,[14  1],93,-1,137,-1,118
1,<environment.Job instance at 0x7fda58f45730>,108,18,[6 3],109,-1,137,-1,119
1,<environment.Job instance at 0x7fda581fe230>,107,12,[10  4],108,-1,131,-1,119
1,<environment.Job instance at 0x7fda5863b910>,115,18,[4 5],116,-1,139,-1,121
1,<environment.Job instance at 0x7fda5821a230>,101,18,[4 7],102,-1,140,-1,122
1,<environment.Job instance at 0x7fda593a1190>,117,16,[7 5],118,-1,138,-1,122
1,<environment.Job instance at 0x7fda5820fcd0>,8,2,[ 5 14],9,-1,11,-1,9
1,<environment.Job instance at 0x7fda57f0f320>,29,26,[ 3 11],30,-1,120,-1,94
1,<environment.Job instance at 0x7fda58567d20>,36,23,[3 6],37,-1,135,-1,112
1,<environment.Job instance at 0x7fda623e8190>,37,26,[9 1],38,-1,138,-1,112
1,<environment.Job instance at 0x7fda5880a3c0>,40,14,[13  5],41,-1,129,-1,115
1,<environment.Job instance at 0x7fda58ce7320>,45,27,[9 2],46,-1,169,-1,142
1,<environment.Job instance at 0x7fda586d2370>,57,3,[ 1 13],58,-1,193,-1,190
1,<environment.Job instance at 0x7fda5869d5a0>,77,1,[11  1],78,-1,273,-1,272
1,<environment.Job instance at 0x7fda58cf3aa0>,92,19,[14  1],93,-1,329,-1,310
1,<environment.Job instance at 0x7fda58ada820>,97,28,[1 7],98,-1,345,-1,317
1,<environment.Job instance at 0x7fda58cdc320>,104,17,[ 1 12],105,-1,356,-1,339
1,<environment.Job instance at 0x7fda5873d500>,112,17,[14  3],113,-1,393,-1,376
1,<environment.Job instance at 0x7fda58315f00>,122,1,[ 2 11],123,-1,425,-1,424
1,<environment.Job instance at 0x7fda61cd35a0>,137,24,[5 6],138,-1,512,-1,488
1,<environment.Job instance at 0x7fda58ad5140>,145,3,[ 3 12],146,-1,508,-1,505
1,<environment.Job instance at 0x7fda586acaa0>,155,23,[5 1],156,-1,589,-1,566
1,<environment.Job instance at 0x7fda58656730>,164,15,[ 4 14],165,-1,603,-1,588
1,<environment.Job instance at 0x7fda58d41dc0>,1,13,[10  5],2,-1,17,-1,4
1,<environment.Job instance at 0x7fda58987730>,4,13,[2 9],5,-1,18,-1,5
1,<environment.Job instance at 0x7fda58987d70>,5,17,[7 2],6,-1,23,-1,6
1,<environment.Job instance at 0x7fda589871e0>,6,16,[11  1],7,-1,23,-1,7
1,<environment.Job instance at 0x7fda589872d0>,7,14,[4 7],8,-1,22,-1,8
1,<environment.Job instance at 0x7fda58987870>,3,14,[6 5],4,-1,22,-1,8
1,<environment.Job instance at 0x7fda58987f00>,9,17,[7 3],10,-1,27,-1,10
1,<environment.Job instance at 0x7fda5890f0a0>,13,24,[12  2],14,-1,38,-1,14
1,<environment.Job instance at 0x7fda58987820>,11,18,[9 1],12,-1,35,-1,17
1,<environment.Job instance at 0x7fda5890f230>,18,14,[8 3],19,-1,33,-1,19
1,<environment.Job instance at 0x7fda5890f550>,19,17,[5 9],20,-1,37,-1,20
1,<environment.Job instance at 0x7fda5890f410>,20,24,[5 5],21,-1,45,-1,21
1,<environment.Job instance at 0x7fda5890f320>,21,18,[1 7],22,-1,40,-1,22
1,<environment.Job instance at 0x7fda5890f9b0>,22,21,[5 1],23,-1,44,-1,23
1,<environment.Job instance at 0x7fda5890f7d0>,23,21,[6 1],24,-1,45,-1,24
1,<environment.Job instance at 0x7fda5890fe60>,24,18,[4 8],25,-1,43,-1,25
1,<environment.Job instance at 0x7fda5890f730>,25,18,[8 3],26,-1,44,-1,26
1,<environment.Job instance at 0x7fda5890f960>,27,23,[5 9],28,-1,51,-1,28
1,<environment.Job instance at 0x7fda5890f500>,30,16,[6 4],31,-1,47,-1,31
1,<environment.Job instance at 0x7fda5890fbe0>,31,16,[10  3],32,-1,48,-1,32
1,<environment.Job instance at 0x7fda5890f5f0>,32,15,[7 5],33,-1,48,-1,33
1,<environment.Job instance at 0x7fda59554500>,38,15,[4 7],39,-1,54,-1,39
1,<environment.Job instance at 0x7fda59554eb0>,42,17,[2 6],43,-1,60,-1,43
1,<environment.Job instance at 0x7fda591a0820>,49,14,[2 9],50,-1,64,-1,50
1,<environment.Job instance at 0x7fda591a01e0>,50,12,[3 9],51,-1,63,-1,51
1,<environment.Job instance at 0x7fda58305a50>,51,18,[2 5],52,-1,70,-1,52
1,<environment.Job instance at 0x7fda58305140>,59,15,[8 4],60,-1,76,-1,61
1,<environment.Job instance at 0x7fda58305d70>,62,16,[3 6],63,-1,79,-1,63
1,<environment.Job instance at 0x7fda584e9780>,64,18,[5 2],65,-1,88,-1,70
1,<environment.Job instance at 0x7fda59554820>,44,13,[14  5],45,-1,83,-1,70
1,<environment.Job instance at 0x7fda584e93c0>,66,14,[11  5],67,-1,84,-1,70
1,<environment.Job instance at 0x7fda584e9be0>,70,26,[6 5],71,-1,99,-1,73
1,<environment.Job instance at 0x7fda590e5280>,82,16,[10  2],83,-1,108,-1,92
1,<environment.Job instance at 0x7fda590e5780>,83,18,[5 4],84,-1,110,-1,92
1,<environment.Job instance at 0x7fda590e58c0>,87,17,[9 5],88,-1,111,-1,94
1,<environment.Job instance at 0x7fda584e9370>,68,12,[ 1 11],69,-1,111,-1,99
1,<environment.Job instance at 0x7fda5920d6e0>,93,17,[10  1],94,-1,123,-1,106
1,<environment.Job instance at 0x7fda59554e10>,41,18,[3 9],42,-1,125,-1,107
1,<environment.Job instance at 0x7fda5920d2d0>,95,16,[6 5],96,-1,123,-1,107
1,<environment.Job instance at 0x7fda5920d9b0>,96,12,[2 6],97,-1,119,-1,107
1,<environment.Job instance at 0x7fda5920d0a0>,94,16,[1 5],95,-1,123,-1,107
1,<environment.Job instance at 0x7fda5920ddc0>,98,18,[10  3],99,-1,125,-1,107
1,<environment.Job instance at 0x7fda591ee5f0>,99,15,[5 3],100,-1,122,-1,107
1,<environment.Job instance at 0x7fda584e99b0>,65,13,[3 8],66,-1,120,-1,107
1,<environment.Job instance at 0x7fda58fb0fa0>,100,22,[3 8],101,-1,130,-1,108
1,<environment.Job instance at 0x7fda59074c80>,102,18,[4 6],103,-1,127,-1,109
1,<environment.Job instance at 0x7fda5814dfa0>,104,18,[3 6],105,-1,127,-1,109
1,<environment.Job instance at 0x7fda57d96f00>,111,17,[7 3],112,-1,144,-1,127
1,<environment.Job instance at 0x7fda592c80a0>,112,12,[5 7],113,-1,139,-1,127
1,<environment.Job instance at 0x7fda594342d0>,113,17,[ 5 10],114,-1,147,-1,130
1,<environment.Job instance at 0x7fda58fb0370>,101,2,[6 5],102,-1,143,-1,141
1,<environment.Job instance at 0x7fda581b64b0>,115,18,[5 7],116,-1,161,-1,143
1,<environment.Job instance at 0x7fda581b6dc0>,116,3,[5 2],117,-1,146,-1,143
1,<environment.Job instance at 0x7fda583425a0>,117,17,[5 9],118,-1,161,-1,144
1,<environment.Job instance at 0x7fda58e75550>,122,21,[8 1],123,-1,188,-1,167
1,<environment.Job instance at 0x7fda581d6820>,125,17,[2 6],126,-1,184,-1,167
1,<environment.Job instance at 0x7fda581d6960>,124,21,[5 7],125,-1,188,-1,167
1,<environment.Job instance at 0x7fda590e51e0>,81,27,[1 8],82,-1,194,-1,167
1,<environment.Job instance at 0x7fda586e86e0>,130,15,[10  5],131,-1,182,-1,167
1,<environment.Job instance at 0x7fda57e95050>,126,19,[8 4],127,-1,186,-1,167
1,<environment.Job instance at 0x7fda622b4460>,134,16,[9 4],135,-1,184,-1,168
1,<environment.Job instance at 0x7fda622b4230>,135,12,[1 9],136,-1,184,-1,172
1,<environment.Job instance at 0x7fda5972c370>,140,18,[5 5],141,-1,193,-1,175
1,<environment.Job instance at 0x7fda5972c7d0>,141,17,[ 2 10],142,-1,192,-1,175
1,<environment.Job instance at 0x7fda622b44b0>,138,12,[8 1],139,-1,187,-1,175
1,<environment.Job instance at 0x7fda5972cf50>,144,12,[9 4],145,-1,190,-1,178
1,<environment.Job instance at 0x7fda5972c780>,146,12,[ 5 10],147,-1,190,-1,178
1,<environment.Job instance at 0x7fda5972cb40>,142,13,[6 5],143,-1,191,-1,178
1,<environment.Job instance at 0x7fda61c8bf00>,149,14,[9 4],150,-1,192,-1,178
1,<environment.Job instance at 0x7fda61c8beb0>,151,13,[5 8],152,-1,191,-1,178
1,<environment.Job instance at 0x7fda596810f0>,150,16,[6 2],151,-1,194,-1,178
1,<environment.Job instance at 0x7fda59243e10>,155,13,[2 6],156,-1,191,-1,178
1,<environment.Job instance at 0x7fda592435f0>,157,25,[10  1],158,-1,204,-1,179
1,<environment.Job instance at 0x7fda59243910>,153,15,[5 8],154,-1,194,-1,179
1,<environment.Job instance at 0x7fda592437d0>,158,13,[2 7],159,-1,193,-1,180
1,<environment.Job instance at 0x7fda5820baa0>,163,14,[2 6],164,-1,194,-1,180
1,<environment.Job instance at 0x7fda5820bf00>,164,18,[3 8],165,-1,198,-1,180
1,<environment.Job instance at 0x7fda590728c0>,165,17,[6 3],166,-1,197,-1,180
1,<environment.Job instance at 0x7fda591a0d70>,6,16,[11  1],7,-1,23,-1,7
1,<environment.Job instance at 0x7fda58b9c5a0>,10,25,[7 3],11,-1,43,-1,18
1,<environment.Job instance at 0x7fda584e9550>,13,24,[12  2],14,-1,53,-1,29
1,<environment.Job instance at 0x7fda581b6820>,20,24,[5 5],21,-1,74,-1,50
1,<environment.Job instance at 0x7fda59679e10>,28,18,[11  3],29,-1,97,-1,79
1,<environment.Job instance at 0x7fda59679140>,27,23,[5 9],28,-1,119,-1,96
1,<environment.Job instance at 0x7fda58cfd5f0>,35,12,[ 2 11],36,-1,124,-1,112
1,<environment.Job instance at 0x7fda58ac8e60>,44,13,[14  5],45,-1,158,-1,145
1,<environment.Job instance at 0x7fda5849aaf0>,66,14,[11  5],67,-1,229,-1,215
1,<environment.Job instance at 0x7fda621f0550>,68,12,[ 1 11],69,-1,230,-1,218
1,<environment.Job instance at 0x7fda57f00c30>,70,26,[6 5],71,-1,260,-1,234
1,<environment.Job instance at 0x7fda591e44b0>,81,27,[1 8],82,-1,279,-1,252
1,<environment.Job instance at 0x7fda588c9af0>,90,3,[ 2 13],91,-1,276,-1,273
1,<environment.Job instance at 0x7fda58215780>,107,3,[ 2 11],108,-1,346,-1,343
1,<environment.Job instance at 0x7fda58215d20>,108,3,[12  4],109,-1,346,-1,343
1,<environment.Job instance at 0x7fda57e3d280>,123,1,[13  2],124,-1,422,-1,421
1,<environment.Job instance at 0x7fda5865fd70>,127,28,[14  5],128,-1,464,-1,436
1,<environment.Job instance at 0x7fda57e22460>,145,17,[13  2],146,-1,521,-1,504
1,<environment.Job instance at 0x7fda588f6410>,157,25,[10  1],158,-1,578,-1,553
1,<environment.Job instance at 0x7fda588f6d70>,159,23,[1 5],160,-1,584,-1,561
1,<environment.Job instance at 0x7f4e8c13c910>,0,18,[ 2 10],1,-1,20,-1,2
1,<environment.Job instance at 0x7f4e82b57140>,3,18,[ 3 10],4,-1,22,-1,4
1,<environment.Job instance at 0x7f4e82b572d0>,4,18,[10  4],5,-1,23,-1,5
1,<environment.Job instance at 0x7f4e82b571e0>,5,13,[5 9],6,-1,19,-1,6
1,<environment.Job instance at 0x7f4e82b57370>,6,12,[11  4],7,-1,19,-1,7
1,<environment.Job instance at 0x7f4e82b574b0>,8,17,[ 2 10],9,-1,26,-1,9
1,<environment.Job instance at 0x7f4e82b57640>,9,17,[ 4 10],10,-1,27,-1,10
1,<environment.Job instance at 0x7f4e82b57960>,13,13,[1 8],14,-1,27,-1,14
1,<environment.Job instance at 0x7f4e82b57dc0>,18,16,[8 5],19,-1,35,-1,19
1,<environment.Job instance at 0x7f4e82b57f00>,19,17,[12  3],20,-1,37,-1,20
1,<environment.Job instance at 0x7f4e82b5a280>,23,18,[5 2],24,-1,42,-1,24
1,<environment.Job instance at 0x7f4e82b5a5a0>,26,22,[2 9],27,-1,49,-1,27
1,<environment.Job instance at 0x7f4e82b5aa00>,31,17,[4 9],32,-1,49,-1,32
1,<environment.Job instance at 0x7f4e82b5a8c0>,32,17,[9 3],33,-1,50,-1,33
1,<environment.Job instance at 0x7f4e82b5af50>,35,16,[8 1],36,-1,52,-1,36
1,<environment.Job instance at 0x7f4e82b5c050>,37,14,[5 5],38,-1,52,-1,38
1,<environment.Job instance at 0x7f4e82b5c230>,38,12,[3 6],39,-1,51,-1,39
1,<environment.Job instance at 0x7f4e82b5c1e0>,39,18,[5 8],40,-1,58,-1,40
1,<environment.Job instance at 0x7f4e82b5c460>,42,14,[8 4],43,-1,57,-1,43
1,<environment.Job instance at 0x7f4e82b5c730>,43,28,[6 4],44,-1,72,-1,44
1,<environment.Job instance at 0x7f4e8c13caf0>,1,15,[ 1 14],2,-1,155,-1,140
1,<environment.Job instance at 0x7f4e82b57820>,1,15,[ 1 14],2,-1,17,-1,2
1,<environment.Job instance at 0x7f4e82b5a640>,6,12,[11  4],7,-1,19,-1,7
1,<environment.Job instance at 0x7f4e82b5e500>,19,17,[12  3],20,-1,67,-1,50
1,<environment.Job instance at 0x7f4e82b5e730>,22,2,[12  3],23,-1,62,-1,60
1,<environment.Job instance at 0x7f4e82b62690>,43,28,[6 4],44,-1,166,-1,138
1,<environment.Job instance at 0x7f4e82b626e0>,44,17,[ 5 12],45,-1,155,-1,138
1,<environment.Job instance at 0x7f4e822755a0>,2,3,[ 3 11],3,-1,7,-1,4
1,<environment.Job instance at 0x7f4e82b5e0a0>,3,18,[ 4 12],4,-1,22,-1,4
1,<environment.Job instance at 0x7f4e82275f50>,4,14,[1 7],5,-1,20,-1,6
1,<environment.Job instance at 0x7f4e822996e0>,6,18,[4 5],7,-1,25,-1,7
1,<environment.Job instance at 0x7f4e822750a0>,5,17,[4 7],6,-1,24,-1,7
1,<environment.Job instance at 0x7f4e82299780>,10,24,[ 3 10],11,-1,35,-1,11
1,<environment.Job instance at 0x7f4e822995a0>,12,20,[9 1],13,-1,33,-1,13
1,<environment.Job instance at 0x7f4e822960f0>,15,13,[3 5],16,-1,29,-1,16
1,<environment.Job instance at 0x7f4e82296190>,17,26,[5 4],18,-1,44,-1,18
1,<environment.Job instance at 0x7f4e82296a50>,18,22,[5 6],19,-1,41,-1,19
1,<environment.Job instance at 0x7f4e82296af0>,20,18,[5 5],21,-1,39,-1,21
1,<environment.Job instance at 0x7f4e82299280>,9,14,[ 2 10],10,-1,35,-1,21
1,<environment.Job instance at 0x7f4e82296e10>,22,14,[9 1],23,-1,37,-1,23
1,<environment.Job instance at 0x7f4e82298b40>,27,15,[4 7],28,-1,43,-1,28
1,<environment.Job instance at 0x7f4e82298dc0>,28,19,[8 4],29,-1,48,-1,29
1,<environment.Job instance at 0x7f4e82298fa0>,29,17,[2 7],30,-1,47,-1,30
1,<environment.Job instance at 0x7f4e821018c0>,38,12,[3 5],39,-1,51,-1,39
1,<environment.Job instance at 0x7f4e82a2f910>,39,13,[7 2],40,-1,53,-1,40
1,<environment.Job instance at 0x7f4e82101500>,41,16,[5 8],42,-1,58,-1,42
1,<environment.Job instance at 0x7f4e8216c370>,43,12,[4 9],44,-1,56,-1,44
1,<environment.Job instance at 0x7f4e8216c4b0>,45,23,[3 7],46,-1,69,-1,46
1,<environment.Job instance at 0x7f4e82b62550>,0,27,[9 1],1,-1,28,-1,1
1,<environment.Job instance at 0x7f4e82b622d0>,2,3,[ 3 11],3,-1,6,-1,3
1,<environment.Job instance at 0x7f4e82b623c0>,3,18,[ 4 12],4,-1,22,-1,4
1,<environment.Job instance at 0x7f4e82b5eaf0>,10,24,[ 3 10],11,-1,47,-1,23
1,<environment.Job instance at 0x7f4e82b5e6e0>,17,26,[5 4],18,-1,51,-1,25
1,<environment.Job instance at 0x7f4e822ee1e0>,31,17,[ 4 14],32,-1,89,-1,72
1,<environment.Job instance at 0x7f4e8235e4b0>,35,19,[14  4],36,-1,96,-1,77
1,<environment.Job instance at 0x7f4e822f5320>,45,23,[3 7],46,-1,126,-1,103
1,<environment.Job instance at 0x7f4e821d0cd0>,0,18,[7 5],1,-1,19,-1,1
1,<environment.Job instance at 0x7f4e821d0190>,3,17,[5 6],4,-1,21,-1,4
1,<environment.Job instance at 0x7f4e821d0d70>,4,17,[5 4],5,-1,25,-1,8
1,<environment.Job instance at 0x7f4e821d0b90>,8,20,[5 7],9,-1,29,-1,9
1,<environment.Job instance at 0x7f4e821d02d0>,10,20,[5 7],11,-1,31,-1,11
1,<environment.Job instance at 0x7f4e821d0460>,15,14,[9 1],16,-1,31,-1,17
1,<environment.Job instance at 0x7f4e820fa500>,19,16,[1 8],20,-1,36,-1,20
1,<environment.Job instance at 0x7f4e821e2a50>,34,15,[10  5],35,-1,50,-1,35
1,<environment.Job instance at 0x7f4e820fa7d0>,24,15,[9 1],25,-1,51,-1,36
1,<environment.Job instance at 0x7f4e821e2870>,36,18,[1 6],37,-1,55,-1,37
1,<environment.Job instance at 0x7f4e821e23c0>,2,27,[ 3 13],3,-1,30,-1,3
1,<environment.Job instance at 0x7f4e821d0c30>,11,18,[ 3 13],12,-1,38,-1,20
1,<environment.Job instance at 0x7f4e821c3af0>,17,18,[ 3 12],18,-1,41,-1,23
1,<environment.Job instance at 0x7f4e821c3f00>,21,18,[11  5],22,-1,47,-1,29
1,<environment.Job instance at 0x7f4e821c3320>,22,14,[14  1],23,-1,43,-1,29
1,<environment.Job instance at 0x7f4e820f04b0>,35,15,[ 3 14],36,-1,84,-1,69
1,<environment.Job instance at 0x7f4e820f0910>,37,12,[14  5],38,-1,84,-1,72
1,<environment.Job instance at 0x7f4e825ebd70>,1,16,[1 9],2,-1,18,-1,2
1,<environment.Job instance at 0x7f4e8260a730>,5,14,[3 8],6,-1,20,-1,6
1,<environment.Job instance at 0x7f4e8260a780>,7,17,[3 8],8,-1,25,-1,8
1,<environment.Job instance at 0x7f4e8260a500>,8,16,[3 9],9,-1,25,-1,9
1,<environment.Job instance at 0x7f4e8264bcd0>,14,13,[1 9],15,-1,28,-1,15
1,<environment.Job instance at 0x7f4e8264b4b0>,17,18,[5 2],18,-1,36,-1,18
1,<environment.Job instance at 0x7f4e8264bd70>,18,18,[4 6],19,-1,37,-1,19
1,<environment.Job instance at 0x7f4e8264b280>,19,16,[3 5],20,-1,36,-1,20
1,<environment.Job instance at 0x7f4e826a2a00>,23,12,[1 7],24,-1,36,-1,24
1,<environment.Job instance at 0x7f4e826a2960>,25,25,[3 9],26,-1,51,-1,26
1,<environment.Job instance at 0x7f4e826a23c0>,27,13,[ 4 10],28,-1,41,-1,28
1,<environment.Job instance at 0x7f4e821430f0>,28,14,[4 7],29,-1,43,-1,29
1,<environment.Job instance at 0x7f4e821434b0>,29,23,[2 8],30,-1,53,-1,30
1,<environment.Job instance at 0x7f4e822b4d70>,35,17,[10  5],36,-1,53,-1,36
1,<environment.Job instance at 0x7f4e822b4320>,38,14,[8 5],39,-1,53,-1,39
1,<environment.Job instance at 0x7f4e822b4a00>,39,17,[9 2],40,-1,58,-1,41
1,<environment.Job instance at 0x7f4e82270910>,42,14,[8 4],43,-1,57,-1,43
1,<environment.Job instance at 0x7f4e82270d20>,44,17,[10  5],45,-1,62,-1,45
1,<environment.Job instance at 0x7f4e82270230>,45,16,[ 3 10],46,-1,62,-1,46
1,<environment.Job instance at 0x7f4e82270d70>,46,23,[5 8],47,-1,70,-1,47
1,<environment.Job instance at 0x7f4e822b4c30>,40,18,[5 1],41,-1,85,-1,67
1,<environment.Job instance at 0x7f4e820f0910>,16,22,[11  3],17,-1,57,-1,35
1,<environment.Job instance at 0x7f4e82270140>,25,25,[3 9],26,-1,106,-1,81
1,<environment.Job instance at 0x7f4e822706e0>,29,23,[2 8],30,-1,104,-1,81
1,<environment.Job instance at 0x7f4e8255bd70>,36,26,[9 1],37,-1,128,-1,102
1,<environment.Job instance at 0x7f4e8255b690>,46,23,[5 8],47,-1,172,-1,149
1,<environment.Job instance at 0x7f4e82f9e910>,2,14,[9 2],3,-1,18,-1,4
1,<environment.Job instance at 0x7f4e82f9ea50>,4,17,[10  2],5,-1,22,-1,5
1,<environment.Job instance at 0x7f4e820f0be0>,3,27,[5 3],4,-1,32,-1,5
1,<environment.Job instance at 0x7f4e82f9ef00>,5,17,[5 9],6,-1,23,-1,6
1,<environment.Job instance at 0x7f4e82fb37d0>,8,22,[9 2],9,-1,33,-1,11
1,<environment.Job instance at 0x7f4e82fb39b0>,10,17,[2 9],11,-1,28,-1,11
1,<environment.Job instance at 0x7f4e82fb34b0>,12,17,[10  4],13,-1,31,-1,14
1,<environment.Job instance at 0x7f4e82f8be60>,14,13,[5 9],15,-1,28,-1,15
1,<environment.Job instance at 0x7f4e82f8b960>,15,17,[8 1],16,-1,33,-1,16
1,<environment.Job instance at 0x7f4e82f8b5a0>,16,16,[7 2],17,-1,33,-1,17
1,<environment.Job instance at 0x7f4e82f8b500>,17,18,[ 1 10],18,-1,36,-1,18
1,<environment.Job instance at 0x7f4e82f8b3c0>,18,28,[7 4],19,-1,47,-1,19
1,<environment.Job instance at 0x7f4e82773780>,23,15,[5 6],24,-1,39,-1,24
1,<environment.Job instance at 0x7f4e82fa11e0>,25,17,[3 5],26,-1,43,-1,26
1,<environment.Job instance at 0x7f4e82fa1500>,26,15,[ 5 10],27,-1,42,-1,27
1,<environment.Job instance at 0x7f4e822611e0>,32,16,[8 5],33,-1,49,-1,33
1,<environment.Job instance at 0x7f4e82fa1f00>,34,14,[8 5],35,-1,49,-1,35
1,<environment.Job instance at 0x7f4e825812d0>,38,18,[3 8],39,-1,57,-1,39
1,<environment.Job instance at 0x7f4e82781820>,39,16,[9 4],40,-1,56,-1,40
1,<environment.Job instance at 0x7f4e82781780>,40,28,[7 3],41,-1,69,-1,41
1,<environment.Job instance at 0x7f4e82781f50>,41,16,[7 4],42,-1,58,-1,42
1,<environment.Job instance at 0x7f4e82240960>,43,18,[1 6],44,-1,62,-1,44
1,<environment.Job instance at 0x7f4e8225fb40>,44,15,[9 5],45,-1,60,-1,45
1,<environment.Job instance at 0x7f4e82572550>,46,17,[2 6],47,-1,64,-1,47
1,<environment.Job instance at 0x7f4e82572500>,47,16,[2 8],48,-1,64,-1,48
1,<environment.Job instance at 0x7f4e82fa1140>,1,2,[12  1],2,-1,4,-1,2
1,<environment.Job instance at 0x7f4e82fb3af0>,3,27,[5 3],4,-1,31,-1,4
1,<environment.Job instance at 0x7f4e8255b410>,9,3,[ 4 12],10,-1,13,-1,10
1,<environment.Job instance at 0x7f4e8255b2d0>,11,18,[ 5 11],12,-1,35,-1,17
1,<environment.Job instance at 0x7f4e8c2b7690>,18,28,[7 4],19,-1,75,-1,47
1,<environment.Job instance at 0x7f4e82270960>,24,28,[9 1],25,-1,92,-1,64
1,<environment.Job instance at 0x7f4e820fa230>,28,16,[14  3],29,-1,86,-1,70
1,<environment.Job instance at 0x7f4e820f0780>,40,28,[7 3],41,-1,160,-1,132
1,<environment.Job instance at 0x7f4e829cf410>,0,18,[8 5],1,-1,19,-1,1
1,<environment.Job instance at 0x7f4e8278a230>,4,17,[1 9],5,-1,22,-1,5
1,<environment.Job instance at 0x7f4e8278a2d0>,13,21,[9 5],14,-1,36,-1,15
1,<environment.Job instance at 0x7f4e8278a960>,15,12,[12  4],16,-1,28,-1,16
1,<environment.Job instance at 0x7f4e83682550>,16,22,[6 1],17,-1,39,-1,17
1,<environment.Job instance at 0x7f4e836824b0>,17,14,[3 5],18,-1,32,-1,18
1,<environment.Job instance at 0x7f4e83682f00>,18,21,[5 1],19,-1,40,-1,19
1,<environment.Job instance at 0x7f4e83682140>,22,17,[8 2],23,-1,40,-1,23
1,<environment.Job instance at 0x7f4e83682c80>,23,18,[7 5],24,-1,42,-1,24
1,<environment.Job instance at 0x7f4e83682aa0>,26,14,[5 4],27,-1,41,-1,27
1,<environment.Job instance at 0x7f4e83682280>,27,14,[4 7],28,-1,42,-1,28
1,<environment.Job instance at 0x7f4e836820f0>,29,13,[5 7],30,-1,43,-1,30
1,<environment.Job instance at 0x7f4e83682960>,31,16,[6 2],32,-1,48,-1,32
1,<environment.Job instance at 0x7f4e8255b870>,14,18,[10  2],15,-1,53,-1,35
1,<environment.Job instance at 0x7f4e8369d410>,44,18,[ 5 10],45,-1,63,-1,45
1,<environment.Job instance at 0x7f4e8369d3c0>,46,16,[5 7],47,-1,63,-1,47
1,<environment.Job instance at 0x7f4e8369deb0>,48,15,[2 5],49,-1,64,-1,49
1,<environment.Job instance at 0x7f4e822708c0>,8,12,[12  2],9,-1,21,-1,9
1,<environment.Job instance at 0x7f4e822705a0>,11,19,[ 3 14],12,-1,38,-1,19
1,<environment.Job instance at 0x7f4e82573820>,12,2,[14  5],13,-1,21,-1,19
1,<environment.Job instance at 0x7f4e8255b8c0>,15,12,[12  4],16,-1,32,-1,20
1,<environment.Job instance at 0x7f4e82fb3cd0>,21,18,[ 5 14],22,-1,40,-1,22
1,<environment.Job instance at 0x7f4e8369d370>,28,1,[ 5 14],29,-1,42,-1,41
1,<environment.Job instance at 0x7f4e8369d730>,33,3,[14  5],34,-1,76,-1,73
1,<environment.Job instance at 0x7f4e836800f0>,38,17,[12  1],39,-1,94,-1,77
1,<environment.Job instance at 0x7f4e83680b90>,42,1,[13  3],43,-1,95,-1,94
1,<environment.Job instance at 0x7f4e827977d0>,0,17,[4 5],1,-1,18,-1,1
1,<environment.Job instance at 0x7f4e828f5690>,5,18,[9 5],6,-1,24,-1,6
1,<environment.Job instance at 0x7f4e828f5550>,7,17,[7 5],8,-1,25,-1,8
1,<environment.Job instance at 0x7f4e82270140>,9,1,[8 5],10,-1,11,-1,10
1,<environment.Job instance at 0x7f4e828f5960>,10,14,[2 8],11,-1,25,-1,11
1,<environment.Job instance at 0x7f4e828f5a00>,11,15,[10  3],12,-1,28,-1,13
1,<environment.Job instance at 0x7f4e828f5c80>,14,16,[8 3],15,-1,33,-1,17
1,<environment.Job instance at 0x7f4e8290e2d0>,19,17,[4 8],20,-1,37,-1,20
1,<environment.Job instance at 0x7f4e8290e370>,20,14,[ 3 10],21,-1,35,-1,21
1,<environment.Job instance at 0x7f4e8290e4b0>,23,15,[7 4],24,-1,42,-1,27
1,<environment.Job instance at 0x7f4e8290ed20>,31,16,[2 8],32,-1,48,-1,32
1,<environment.Job instance at 0x7f4e8290edc0>,33,13,[2 5],34,-1,47,-1,34
1,<environment.Job instance at 0x7f4e828ef4b0>,38,14,[10  4],39,-1,55,-1,41
1,<environment.Job instance at 0x7f4e828ef820>,41,15,[3 5],42,-1,57,-1,42
1,<environment.Job instance at 0x7f4e828ef730>,42,20,[7 3],43,-1,63,-1,43
1,<environment.Job instance at 0x7f4e828efa00>,45,17,[6 3],46,-1,63,-1,46
1,<environment.Job instance at 0x7f4e828efbe0>,46,20,[6 2],47,-1,68,-1,48
1,<environment.Job instance at 0x7f4e828efd20>,48,17,[2 8],49,-1,66,-1,49
1,<environment.Job instance at 0x7f4e828ef550>,40,18,[11  4],41,-1,1093,-1,1075
1,<environment.Job instance at 0x7f4e828f5370>,2,27,[ 2 13],3,-1,30,-1,3
1,<environment.Job instance at 0x7f4e83680b40>,8,1,[12  5],9,-1,10,-1,9
1,<environment.Job instance at 0x7f4e82773aa0>,21,18,[ 4 13],22,-1,68,-1,50
1,<environment.Job instance at 0x7f4e825814b0>,27,16,[ 5 13],28,-1,83,-1,67
1,<environment.Job instance at 0x7f4e8255b3c0>,34,18,[13  2],35,-1,115,-1,97
1,<environment.Job instance at 0x7f4e82270690>,40,18,[11  4],41,-1,125,-1,107
1,<environment.Job instance at 0x7f4e825470a0>,5,16,[2 6],6,-1,22,-1,6
1,<environment.Job instance at 0x7f4e82974e10>,6,15,[10  5],7,-1,22,-1,7
1,<environment.Job instance at 0x7f4e824eccd0>,7,16,[ 3 10],8,-1,24,-1,8
1,<environment.Job instance at 0x7f4e824ec0a0>,8,16,[3 6],9,-1,25,-1,9
1,<environment.Job instance at 0x7f4e824ec370>,9,22,[1 6],10,-1,32,-1,10
1,<environment.Job instance at 0x7f4e824ec410>,11,25,[10  4],12,-1,37,-1,12
1,<environment.Job instance at 0x7f4e824ec230>,14,22,[1 9],15,-1,37,-1,15
1,<environment.Job instance at 0x7f4e824ec870>,15,12,[2 5],16,-1,28,-1,16
1,<environment.Job instance at 0x7f4e824ecf50>,17,13,[ 1 10],18,-1,31,-1,18
1,<environment.Job instance at 0x7f4e83455c80>,19,18,[ 2 10],20,-1,38,-1,20
1,<environment.Job instance at 0x7f4e83455d70>,20,17,[7 1],21,-1,39,-1,22
1,<environment.Job instance at 0x7f4e83455aa0>,21,18,[3 8],22,-1,41,-1,23
1,<environment.Job instance at 0x7f4e83455960>,23,24,[3 6],24,-1,48,-1,24
1,<environment.Job instance at 0x7f4e83455910>,25,20,[3 8],26,-1,46,-1,26
1,<environment.Job instance at 0x7f4e83455d20>,26,15,[4 9],27,-1,42,-1,27
1,<environment.Job instance at 0x7f4e834550a0>,27,27,[9 5],28,-1,56,-1,29
1,<environment.Job instance at 0x7f4e83455e60>,30,18,[4 8],31,-1,49,-1,31
1,<environment.Job instance at 0x7f4e82bc6b90>,35,18,[ 3 10],36,-1,54,-1,36
1,<environment.Job instance at 0x7f4e82bc6f00>,36,21,[6 1],37,-1,58,-1,37
1,<environment.Job instance at 0x7f4e82bc69b0>,37,13,[4 9],38,-1,51,-1,38
1,<environment.Job instance at 0x7f4e82e1d730>,38,12,[8 2],39,-1,51,-1,39
1,<environment.Job instance at 0x7f4e82e1d690>,42,17,[9 1],43,-1,60,-1,43
1,<environment.Job instance at 0x7f4e82e1d280>,43,18,[8 1],44,-1,62,-1,44
1,<environment.Job instance at 0x7f4e82e1dcd0>,45,27,[5 5],46,-1,73,-1,46
1,<environment.Job instance at 0x7f4e830592d0>,46,22,[2 8],47,-1,69,-1,47
1,<environment.Job instance at 0x7f4e83059be0>,47,20,[5 2],48,-1,68,-1,48
1,<environment.Job instance at 0x7f4e8225f960>,11,25,[10  4],12,-1,48,-1,23
1,<environment.Job instance at 0x7f4e828f51e0>,23,24,[3 6],24,-1,87,-1,63
1,<environment.Job instance at 0x7f4e8290eaa0>,27,27,[9 5],28,-1,106,-1,79
1,<environment.Job instance at 0x7f4e830afbe0>,33,2,[ 3 14],34,-1,87,-1,85
1,<environment.Job instance at 0x7f4e83092190>,44,3,[ 3 12],45,-1,135,-1,132
1,<environment.Job instance at 0x7f4e83092640>,45,27,[5 5],46,-1,165,-1,138
1,<environment.Job instance at 0x7f4e830928c0>,48,13,[14  4],49,-1,152,-1,139
1,<environment.Job instance at 0x7f4e8bced5a0>,0,16,[1 9],1,-1,17,-1,1
1,<environment.Job instance at 0x7f4e8bcedcd0>,2,17,[4 6],3,-1,20,-1,3
1,<environment.Job instance at 0x7f4e8bced0f0>,3,27,[7 5],4,-1,31,-1,4
1,<environment.Job instance at 0x7f4e831b4aa0>,11,18,[5 7],12,-1,30,-1,12
1,<environment.Job instance at 0x7f4e831b4690>,12,13,[8 1],13,-1,26,-1,13
1,<environment.Job instance at 0x7f4e831b4eb0>,13,16,[3 5],14,-1,30,-1,14
1,<environment.Job instance at 0x7f4e831b4a00>,15,25,[3 7],16,-1,41,-1,16
1,<environment.Job instance at 0x7f4e831b4dc0>,17,14,[10  3],18,-1,32,-1,18
1,<environment.Job instance at 0x7f4e831b4050>,18,13,[8 2],19,-1,32,-1,19
1,<environment.Job instance at 0x7f4e831b4280>,22,13,[3 9],23,-1,39,-1,26
1,<environment.Job instance at 0x7f4e831b4550>,26,13,[8 4],27,-1,40,-1,27
1,<environment.Job instance at 0x7f4e82539460>,27,14,[9 1],28,-1,42,-1,28
1,<environment.Job instance at 0x7f4e82539820>,28,21,[9 5],29,-1,50,-1,29
1,<environment.Job instance at 0x7f4e82539e60>,30,17,[9 4],31,-1,52,-1,35
1,<environment.Job instance at 0x7f4e831b4c30>,25,16,[10  5],26,-1,52,-1,36
1,<environment.Job instance at 0x7f4e82539500>,37,16,[2 6],38,-1,54,-1,38
1,<environment.Job instance at 0x7f4e82539410>,36,13,[7 1],37,-1,52,-1,39
1,<environment.Job instance at 0x7f4e82d41a50>,43,17,[1 8],44,-1,61,-1,44
1,<environment.Job instance at 0x7f4e82539dc0>,4,13,[14  5],5,-1,18,-1,5
1,<environment.Job instance at 0x7f4e825393c0>,3,27,[7 5],4,-1,44,-1,17
1,<environment.Job instance at 0x7f4e825b38c0>,15,25,[3 7],16,-1,60,-1,35
1,<environment.Job instance at 0x7f4e825b36e0>,20,1,[ 4 12],21,-1,49,-1,48
1,<environment.Job instance at 0x7f4e825b3780>,24,12,[13  3],25,-1,76,-1,64
1,<environment.Job instance at 0x7f4e832ee050>,29,3,[12  1],30,-1,81,-1,78
1,<environment.Job instance at 0x7f4e82c27e10>,39,16,[ 5 13],40,-1,132,-1,116
1,<environment.Job instance at 0x7f4e82c274b0>,44,14,[ 3 14],45,-1,140,-1,126
1,<environment.Job instance at 0x7f4e82c27cd0>,45,24,[3 9],46,-1,167,-1,143
1,<environment.Job instance at 0x7f4e8374de60>,2,17,[10  3],3,-1,21,-1,4
1,<environment.Job instance at 0x7f4e825b3960>,3,13,[9 5],4,-1,17,-1,4
1,<environment.Job instance at 0x7f4e8374d370>,4,15,[ 1 10],5,-1,26,-1,11
1,<environment.Job instance at 0x7f4e832d4b90>,12,27,[5 5],13,-1,40,-1,13
1,<environment.Job instance at 0x7f4e832d44b0>,14,25,[1 7],15,-1,40,-1,15
1,<environment.Job instance at 0x7f4e832d4730>,16,15,[ 5 10],17,-1,32,-1,17
1,<environment.Job instance at 0x7f4e832d4280>,19,14,[2 6],20,-1,34,-1,20
1,<environment.Job instance at 0x7f4e832d4e10>,21,14,[1 9],22,-1,36,-1,22
1,<environment.Job instance at 0x7f4e832d4c80>,22,12,[4 9],23,-1,35,-1,23
1,<environment.Job instance at 0x7f4e832d43c0>,23,18,[4 8],24,-1,42,-1,24
1,<environment.Job instance at 0x7f4e832d4640>,24,17,[7 4],25,-1,42,-1,25
1,<environment.Job instance at 0x7f4e832d4960>,26,27,[5 8],27,-1,54,-1,27
1,<environment.Job instance at 0x7f4e831dfcd0>,31,24,[4 8],32,-1,56,-1,32
1,<environment.Job instance at 0x7f4e831df1e0>,35,19,[7 5],36,-1,55,-1,36
1,<environment.Job instance at 0x7f4e82e1daa0>,36,14,[8 1],37,-1,51,-1,37
1,<environment.Job instance at 0x7f4e82e1d910>,37,12,[10  4],38,-1,50,-1,38
1,<environment.Job instance at 0x7f4e82e1dcd0>,40,14,[ 4 10],41,-1,55,-1,41
1,<environment.Job instance at 0x7f4e82e1d1e0>,42,17,[2 5],43,-1,60,-1,43
1,<environment.Job instance at 0x7f4e82e1d190>,43,14,[8 2],44,-1,58,-1,44
1,<environment.Job instance at 0x7f4e82e1d280>,46,18,[8 2],47,-1,65,-1,47
1,<environment.Job instance at 0x7f4e82e1db40>,47,18,[6 2],48,-1,66,-1,48
1,<environment.Job instance at 0x7f4e831dfc80>,5,1,[12  4],6,-1,7,-1,6
1,<environment.Job instance at 0x7f4e825b3730>,11,15,[14  1],12,-1,33,-1,18
1,<environment.Job instance at 0x7f4e825b36e0>,12,27,[5 5],13,-1,47,-1,20
1,<environment.Job instance at 0x7f4e825b3d20>,14,25,[1 7],15,-1,45,-1,20
1,<environment.Job instance at 0x7f4e82a4fc80>,26,27,[5 8],27,-1,92,-1,65
1,<environment.Job instance at 0x7f4e82a4faa0>,31,24,[4 8],32,-1,105,-1,81
1,<environment.Job instance at 0x7f4e834acb90>,41,1,[11  1],42,-1,102,-1,101
1,<environment.Job instance at 0x7f4e82feed20>,0,19,[2 7],1,-1,20,-1,1
1,<environment.Job instance at 0x7f4e829efdc0>,7,23,[10  4],8,-1,31,-1,8
1,<environment.Job instance at 0x7f4e8c037b40>,8,14,[3 8],9,-1,23,-1,9
1,<environment.Job instance at 0x7f4e831bb780>,11,17,[5 7],12,-1,29,-1,12
1,<environment.Job instance at 0x7f4e82718c80>,14,13,[1 9],15,-1,29,-1,16
1,<environment.Job instance at 0x7f4e82c9dc30>,18,1,[5 3],19,-1,20,-1,19
1,<environment.Job instance at 0x7f4e82de27d0>,19,17,[ 5 10],20,-1,37,-1,20
1,<environment.Job instance at 0x7f4e8bf255f0>,20,18,[4 6],21,-1,39,-1,21
1,<environment.Job instance at 0x7f4e834f6820>,21,15,[3 5],22,-1,37,-1,22
1,<environment.Job instance at 0x7f4e82718e10>,15,16,[4 5],16,-1,38,-1,22
1,<environment.Job instance at 0x7f4e830b6a50>,25,24,[10  2],26,-1,50,-1,26
1,<environment.Job instance at 0x7f4e834f6870>,26,14,[ 5 10],27,-1,41,-1,27
1,<environment.Job instance at 0x7f4e834f6b40>,27,18,[1 7],28,-1,46,-1,28
1,<environment.Job instance at 0x7f4e82aa3a00>,28,19,[1 6],29,-1,48,-1,29
1,<environment.Job instance at 0x7f4e8239e4b0>,22,17,[ 2 12],23,-1,47,-1,30
1,<environment.Job instance at 0x7f4e8c0c62d0>,33,20,[5 7],34,-1,54,-1,34
1,<environment.Job instance at 0x7f4e837384b0>,36,27,[4 5],37,-1,65,-1,38
1,<environment.Job instance at 0x7f4e83738f00>,38,15,[5 9],39,-1,55,-1,40
1,<environment.Job instance at 0x7f4e83738dc0>,40,14,[8 4],41,-1,56,-1,42
1,<environment.Job instance at 0x7f4e82ad06e0>,35,12,[11  5],36,-1,56,-1,44
1,<environment.Job instance at 0x7f4e83738460>,43,18,[6 1],44,-1,62,-1,44
1,<environment.Job instance at 0x7f4e831bb0a0>,1,24,[1 9],2,-1,44,-1,20
1,<environment.Job instance at 0x7f4e829e8be0>,7,23,[10  4],8,-1,44,-1,21
1,<environment.Job instance at 0x7f4e834ac870>,13,3,[ 5 13],14,-1,26,-1,23
1,<environment.Job instance at 0x7f4e834aca00>,16,17,[13  2],17,-1,43,-1,26
1,<environment.Job instance at 0x7f4e82e1dd20>,17,1,[11  4],18,-1,27,-1,26
1,<environment.Job instance at 0x7f4e825b3190>,22,17,[ 2 12],23,-1,68,-1,51
1,<environment.Job instance at 0x7f4e825b3b40>,25,24,[10  2],26,-1,89,-1,65
1,<environment.Job instance at 0x7f4e831df4b0>,29,27,[14  1],30,-1,112,-1,85
1,<environment.Job instance at 0x7f4e82640b90>,32,2,[11  4],33,-1,87,-1,85
1,<environment.Job instance at 0x7f4e836ad1e0>,35,12,[11  5],36,-1,111,-1,99
1,<environment.Job instance at 0x7f4e836ad230>,36,27,[4 5],37,-1,126,-1,99
1,<environment.Job instance at 0x7f4e83291410>,42,3,[11  3],43,-1,115,-1,112
1,<environment.Job instance at 0x7f4e823f84b0>,6,16,[2 6],7,-1,24,-1,8
1,<environment.Job instance at 0x7f4e8203d8c0>,10,18,[5 9],11,-1,29,-1,11
1,<environment.Job instance at 0x7f4e8203dbe0>,13,18,[ 1 10],14,-1,32,-1,14
1,<environment.Job instance at 0x7f4e8203d0f0>,14,14,[7 5],15,-1,29,-1,15
1,<environment.Job instance at 0x7f4e82f823c0>,19,14,[9 5],20,-1,34,-1,20
1,<environment.Job instance at 0x7f4e8358fd70>,25,17,[ 5 10],26,-1,46,-1,29
1,<environment.Job instance at 0x7f4e82e9c8c0>,1,15,[ 2 14],2,-1,17,-1,2
1,<environment.Job instance at 0x7f4e82706aa0>,5,12,[ 3 13],6,-1,18,-1,6
1,<environment.Job instance at 0x7f4e82259cd0>,21,17,[14  3],22,-1,57,-1,40
1,<environment.Job instance at 0x7f4e8369aa50>,24,15,[ 2 13],25,-1,58,-1,43
1,<environment.Job instance at 0x7f4e8369b0f0>,27,3,[12  4],28,-1,56,-1,53
1,<environment.Job instance at 0x7f4e82261c80>,29,28,[1 8],30,-1,90,-1,62
1,<environment.Job instance at 0x7f4e83671d70>,38,18,[13  3],39,-1,104,-1,86
1,<environment.Job instance at 0x7f4e836832d0>,45,24,[8 3],46,-1,142,-1,118
1,<environment.Job instance at 0x7f4e8254f6e0>,0,18,[8 1],1,-1,24,-1,6
1,<environment.Job instance at 0x7f4e8254f460>,6,18,[9 4],7,-1,25,-1,7
1,<environment.Job instance at 0x7f4e8254fb40>,7,17,[3 5],8,-1,25,-1,8
1,<environment.Job instance at 0x7f4e8254f780>,8,17,[2 6],9,-1,26,-1,9
1,<environment.Job instance at 0x7f4e82530cd0>,12,15,[10  1],13,-1,29,-1,14
1,<environment.Job instance at 0x7f4e82530910>,14,24,[4 5],15,-1,39,-1,15
1,<environment.Job instance at 0x7f4e825300a0>,15,13,[8 5],16,-1,29,-1,16
1,<environment.Job instance at 0x7f4e825303c0>,16,13,[3 9],17,-1,30,-1,17
1,<environment.Job instance at 0x7f4e82530be0>,18,16,[6 5],19,-1,35,-1,19
1,<environment.Job instance at 0x7f4e82543a00>,22,15,[2 5],23,-1,38,-1,23
1,<environment.Job instance at 0x7f4e82543690>,23,14,[4 8],24,-1,38,-1,24
1,<environment.Job instance at 0x7f4e82543960>,24,16,[9 2],25,-1,41,-1,25
1,<environment.Job instance at 0x7f4e825436e0>,26,15,[9 1],27,-1,42,-1,27
1,<environment.Job instance at 0x7f4e825435a0>,32,13,[ 5 10],33,-1,46,-1,33
1,<environment.Job instance at 0x7f4e82ff6a50>,38,17,[7 2],39,-1,56,-1,39
1,<environment.Job instance at 0x7f4e82ff6960>,39,16,[10  2],40,-1,56,-1,40
1,<environment.Job instance at 0x7f4e82ff6730>,40,15,[5 6],41,-1,56,-1,41
1,<environment.Job instance at 0x7f4e82fe05f0>,44,15,[7 3],45,-1,60,-1,45
1,<environment.Job instance at 0x7f4e82fe0a00>,45,12,[10  3],46,-1,58,-1,46
1,<environment.Job instance at 0x7f4e8314fc80>,46,14,[5 4],47,-1,61,-1,47
1,<environment.Job instance at 0x7f4e8bcad3c0>,47,15,[10  1],48,-1,63,-1,48
1,<environment.Job instance at 0x7f4e8243af50>,11,13,[12  4],12,-1,32,-1,19
1,<environment.Job instance at 0x7f4e81e0bf50>,14,24,[4 5],15,-1,53,-1,29
1,<environment.Job instance at 0x7f4e82533820>,0,17,[2 6],1,-1,19,-1,2
1,<environment.Job instance at 0x7f4e8369db40>,9,21,[1 9],10,-1,32,-1,11
1,<environment.Job instance at 0x7f4e8369d0a0>,10,27,[6 4],11,-1,38,-1,11
1,<environment.Job instance at 0x7f4e81d4b230>,12,15,[10  1],13,-1,29,-1,14
1,<environment.Job instance at 0x7f4e81d4b550>,14,13,[1 8],15,-1,28,-1,15
1,<environment.Job instance at 0x7f4e81d4b370>,15,3,[10  4],16,-1,19,-1,16
1,<environment.Job instance at 0x7f4e81d4bfa0>,16,14,[1 7],17,-1,31,-1,17
1,<environment.Job instance at 0x7f4e81ebfcd0>,13,13,[7 5],14,-1,30,-1,17
1,<environment.Job instance at 0x7f4e82ebb410>,18,22,[7 5],19,-1,41,-1,19
1,<environment.Job instance at 0x7f4e81d4bcd0>,20,18,[ 5 10],21,-1,39,-1,21
1,<environment.Job instance at 0x7f4e81d3deb0>,22,24,[1 6],23,-1,47,-1,23
1,<environment.Job instance at 0x7f4e81d3dd70>,23,16,[8 5],24,-1,40,-1,24
1,<environment.Job instance at 0x7f4e81d3df00>,24,16,[9 4],25,-1,41,-1,25
1,<environment.Job instance at 0x7f4e8331d7d0>,26,15,[10  4],27,-1,43,-1,28
1,<environment.Job instance at 0x7f4e8246f690>,28,17,[3 9],29,-1,46,-1,29
1,<environment.Job instance at 0x7f4e8253a9b0>,30,14,[1 8],31,-1,45,-1,31
1,<environment.Job instance at 0x7f4e8253a780>,31,12,[5 6],32,-1,44,-1,32
1,<environment.Job instance at 0x7f4e81e49a50>,33,13,[5 1],34,-1,47,-1,34
1,<environment.Job instance at 0x7f4e83673d20>,27,13,[ 4 10],28,-1,49,-1,36
1,<environment.Job instance at 0x7f4e82246780>,38,14,[9 1],39,-1,54,-1,40
1,<environment.Job instance at 0x7f4e82246b90>,40,1,[9 4],41,-1,42,-1,41
1,<environment.Job instance at 0x7f4e822466e0>,39,17,[1 9],40,-1,58,-1,41
1,<environment.Job instance at 0x7f4e82702a50>,48,18,[6 5],49,-1,67,-1,49
1,<environment.Job instance at 0x7f4e82897730>,10,27,[6 4],11,-1,38,-1,11
1,<environment.Job instance at 0x7f4e82847230>,11,1,[11  4],12,-1,13,-1,12
1,<environment.Job instance at 0x7f4e82702aa0>,22,24,[1 6],23,-1,58,-1,34
1,<environment.Job instance at 0x7f4e83653140>,34,3,[ 2 12],35,-1,83,-1,80
1,<environment.Job instance at 0x7f4e82df8aa0>,41,2,[ 3 14],42,-1,101,-1,99
1,<environment.Job instance at 0x7f4e83581910>,46,13,[12  4],47,-1,129,-1,116
1,<environment.Job instance at 0x7f4e83581dc0>,47,27,[9 3],48,-1,144,-1,117
1,<environment.Job instance at 0x7f4e83704910>,5,15,[ 1 10],6,-1,21,-1,6
1,<environment.Job instance at 0x7f4e83704aa0>,8,24,[4 7],9,-1,33,-1,9
1,<environment.Job instance at 0x7f4e83704d20>,12,17,[9 4],13,-1,35,-1,18
1,<environment.Job instance at 0x7f4e83705140>,17,15,[4 6],18,-1,33,-1,18
1,<environment.Job instance at 0x7f4e83704f50>,14,18,[ 4 11],15,-1,36,-1,18
1,<environment.Job instance at 0x7f4e83705640>,20,20,[4 6],21,-1,41,-1,21
1,<environment.Job instance at 0x7f4e83705aa0>,25,16,[ 2 11],26,-1,44,-1,28
1,<environment.Job instance at 0x7f4e83704eb0>,15,16,[9 4],16,-1,44,-1,28
1,<environment.Job instance at 0x7f4e83705b40>,26,3,[8 3],27,-1,31,-1,28
1,<environment.Job instance at 0x7f4e837059b0>,28,2,[13  3],29,-1,31,-1,29
1,<environment.Job instance at 0x7f4e83705dc0>,29,1,[5 1],30,-1,31,-1,30
1,<environment.Job instance at 0x7f4e83705e60>,30,12,[1 7],31,-1,43,-1,31
1,<environment.Job instance at 0x7f4e83705f00>,31,3,[6 4],32,-1,35,-1,32
1,<environment.Job instance at 0x7f4e83705fa0>,32,17,[ 2 10],33,-1,50,-1,33
1,<environment.Job instance at 0x7f4e83705b90>,27,1,[10  5],28,-1,34,-1,33
1,<environment.Job instance at 0x7f4e83705d20>,33,15,[5 5],34,-1,49,-1,34
1,<environment.Job instance at 0x7f4e83712140>,34,12,[9 1],35,-1,47,-1,35
1,<environment.Job instance at 0x7f4e83712280>,36,13,[4 7],37,-1,50,-1,37
1,<environment.Job instance at 0x7f4e83712320>,38,20,[3 8],39,-1,59,-1,39
1,<environment.Job instance at 0x7f4e837125f0>,39,13,[7 4],40,-1,53,-1,40
1,<environment.Job instance at 0x7f4e83712370>,40,24,[10  4],41,-1,65,-1,41
1,<environment.Job instance at 0x7f4e83705910>,24,16,[4 5],25,-1,57,-1,41
1,<environment.Job instance at 0x7f4e83712640>,41,21,[4 7],42,-1,63,-1,42
1,<environment.Job instance at 0x7f4e837052d0>,6,12,[ 2 11],7,-1,19,-1,7
1,<environment.Job instance at 0x7f4e835819b0>,8,24,[4 7],9,-1,38,-1,14
1,<environment.Job instance at 0x7f4e82df8960>,14,18,[ 4 11],15,-1,38,-1,20
1,<environment.Job instance at 0x7f4e81d57640>,19,3,[14  1],20,-1,37,-1,34
1,<environment.Job instance at 0x7f4e8200c320>,23,14,[ 1 11],24,-1,52,-1,38
1,<environment.Job instance at 0x7f4e82702d70>,25,16,[ 2 11],26,-1,56,-1,40
1,<environment.Job instance at 0x7f4e8238ffa0>,28,2,[13  3],29,-1,45,-1,43
1,<environment.Job instance at 0x7f4e8246f0f0>,40,24,[10  4],41,-1,116,-1,92
1,<environment.Job instance at 0x7f4e81d4bc80>,42,17,[ 2 11],43,-1,109,-1,92
1,<environment.Job instance at 0x7f4e82aa52d0>,44,1,[ 2 11],45,-1,93,-1,92
1,<environment.Job instance at 0x7f4e82117460>,0,15,[10  4],1,-1,17,-1,2
1,<environment.Job instance at 0x7f4e82117aa0>,2,15,[4 8],3,-1,18,-1,3
1,<environment.Job instance at 0x7f4e82117dc0>,3,3,[8 4],4,-1,7,-1,4
1,<environment.Job instance at 0x7f4e821177d0>,4,14,[3 8],5,-1,19,-1,5
1,<environment.Job instance at 0x7f4e82117e10>,5,12,[10  1],6,-1,18,-1,6
1,<environment.Job instance at 0x7f4e821179b0>,6,12,[2 7],7,-1,19,-1,7
1,<environment.Job instance at 0x7f4e82117a50>,7,14,[ 4 10],8,-1,22,-1,8
1,<environment.Job instance at 0x7f4e82117c30>,8,18,[4 6],9,-1,27,-1,9
1,<environment.Job instance at 0x7f4e82117cd0>,9,1,[ 5 14],10,-1,11,-1,10
1,<environment.Job instance at 0x7f4e82117f50>,10,2,[5 1],11,-1,13,-1,11
1,<environment.Job instance at 0x7f4e821173c0>,1,18,[4 8],2,-1,29,-1,11
1,<environment.Job instance at 0x7f4e82117910>,12,16,[3 8],13,-1,29,-1,13
1,<environment.Job instance at 0x7f4e8211c550>,16,18,[10  2],17,-1,36,-1,18
1,<environment.Job instance at 0x7f4e820ea190>,18,17,[9 5],19,-1,36,-1,19
1,<environment.Job instance at 0x7f4e820eac80>,19,16,[7 2],20,-1,36,-1,20
1,<environment.Job instance at 0x7f4e820eabe0>,20,16,[ 3 10],21,-1,37,-1,21
1,<environment.Job instance at 0x7f4e820eacd0>,21,16,[5 7],22,-1,38,-1,22
1,<environment.Job instance at 0x7f4e820ebc30>,35,12,[8 5],36,-1,48,-1,36
1,<environment.Job instance at 0x7f4e820ebb90>,36,14,[6 4],37,-1,51,-1,37
1,<environment.Job instance at 0x7f4e836e2c30>,38,17,[3 7],39,-1,56,-1,39
1,<environment.Job instance at 0x7f4e836e2eb0>,39,1,[8 2],40,-1,42,-1,41
1,<environment.Job instance at 0x7f4e836e25a0>,41,17,[2 7],42,-1,59,-1,42
1,<environment.Job instance at 0x7f4e836e2960>,42,17,[6 4],43,-1,60,-1,43
1,<environment.Job instance at 0x7f4e82117320>,9,1,[ 5 14],10,-1,21,-1,20
1,<environment.Job instance at 0x7f4e821037d0>,27,27,[ 2 11],28,-1,129,-1,102
1,<environment.Job instance at 0x7f4e82103870>,29,3,[11  2],30,-1,106,-1,103
1,<environment.Job instance at 0x7f4e82bebaa0>,32,1,[12  5],33,-1,109,-1,108
1,<environment.Job instance at 0x7f4e835be050>,2,16,[ 3 10],3,-1,19,-1,3
1,<environment.Job instance at 0x7f4e835be320>,3,18,[5 5],4,-1,22,-1,4
1,<environment.Job instance at 0x7f4e835beeb0>,4,16,[5 5],5,-1,21,-1,5
1,<environment.Job instance at 0x7f4e835be0a0>,5,17,[ 3 10],6,-1,23,-1,6
1,<environment.Job instance at 0x7f4e835beb90>,8,18,[1 5],9,-1,27,-1,9
1,<environment.Job instance at 0x7f4e835be0f0>,9,18,[9 5],10,-1,28,-1,10
1,<environment.Job instance at 0x7f4e835bea50>,10,19,[4 5],11,-1,30,-1,11
1,<environment.Job instance at 0x7f4e835be1e0>,12,13,[9 4],13,-1,27,-1,14
1,<environment.Job instance at 0x7f4e8229ac80>,14,16,[2 7],15,-1,31,-1,15
1,<environment.Job instance at 0x7f4e8229ac30>,16,13,[5 5],17,-1,30,-1,17
1,<environment.Job instance at 0x7f4e8229abe0>,18,16,[8 3],19,-1,35,-1,19
1,<environment.Job instance at 0x7f4e8229a0a0>,20,23,[9 4],21,-1,44,-1,21
1,<environment.Job instance at 0x7f4e8229ab40>,21,21,[8 2],22,-1,43,-1,22
1,<environment.Job instance at 0x7f4e8229a4b0>,22,21,[5 7],23,-1,44,-1,23
1,<environment.Job instance at 0x7f4e8229a690>,24,17,[9 2],25,-1,42,-1,25
1,<environment.Job instance at 0x7f4e8229ae10>,25,18,[5 5],26,-1,44,-1,26
1,<environment.Job instance at 0x7f4e8223f050>,32,18,[4 7],33,-1,51,-1,33
1,<environment.Job instance at 0x7f4e8223f9b0>,33,18,[7 1],34,-1,52,-1,34
1,<environment.Job instance at 0x7f4e8223f140>,36,18,[8 3],37,-1,55,-1,37
1,<environment.Job instance at 0x7f4e82942730>,45,18,[1 8],46,-1,67,-1,49
1,<environment.Job instance at 0x7f4e83098dc0>,20,23,[9 4],21,-1,92,-1,69
1,<environment.Job instance at 0x7f4e83098a50>,28,28,[10  4],29,-1,115,-1,87
1,<environment.Job instance at 0x7f4e824c0640>,38,17,[12  1],39,-1,137,-1,120
1,<environment.Job instance at 0x7f4e824c0910>,40,26,[4 9],41,-1,152,-1,126
1,<environment.Job instance at 0x7f4e824c08c0>,42,16,[13  1],43,-1,142,-1,126
1,<environment.Job instance at 0x7f4e82bb5280>,47,23,[5 3],48,-1,164,-1,141
1,<environment.Job instance at 0x7f4e82b04050>,6,18,[7 4],7,-1,25,-1,7
1,<environment.Job instance at 0x7f4e82b04910>,7,19,[1 5],8,-1,27,-1,8
1,<environment.Job instance at 0x7f4e82b11500>,9,18,[6 4],10,-1,28,-1,10
1,<environment.Job instance at 0x7f4e82b240f0>,20,14,[10  1],21,-1,35,-1,21
1,<environment.Job instance at 0x7f4e82bcc500>,5,14,[ 1 10],6,-1,38,-1,24
1,<environment.Job instance at 0x7f4e82b05730>,17,16,[ 3 12],18,-1,42,-1,26
1,<environment.Job instance at 0x7f4e82b24690>,24,18,[5 6],25,-1,45,-1,27
1,<environment.Job instance at 0x7f4e82b04e60>,3,24,[ 5 11],4,-1,53,-1,29
1,<environment.Job instance at 0x7f4e82b243c0>,23,22,[5 2],24,-1,53,-1,31
1,<environment.Job instance at 0x7f4e82b15460>,28,12,[ 4 10],29,-1,45,-1,33
1,<environment.Job instance at 0x7f4e82b16780>,30,16,[ 2 10],31,-1,49,-1,33
1,<environment.Job instance at 0x7f4e8277de60>,25,17,[3 6],26,-1,50,-1,33
1,<environment.Job instance at 0x7f4e82678370>,32,15,[5 9],33,-1,48,-1,33
1,<environment.Job instance at 0x7f4e8267c7d0>,35,18,[ 5 10],36,-1,54,-1,36
1,<environment.Job instance at 0x7f4e82b05190>,18,15,[7 3],19,-1,52,-1,37
1,<environment.Job instance at 0x7f4e828c0a00>,36,25,[6 3],37,-1,62,-1,37
1,<environment.Job instance at 0x7f4e8276c690>,34,14,[6 4],35,-1,54,-1,40
1,<environment.Job instance at 0x7f4e827a45f0>,47,18,[3 8],48,-1,67,-1,49
1,<environment.Job instance at 0x7f4e82b05be0>,1,18,[11  2],2,-1,20,-1,2
1,<environment.Job instance at 0x7f4e82b056e0>,2,12,[ 5 13],3,-1,15,-1,3
1,<environment.Job instance at 0x7f4e82b24050>,3,24,[ 5 11],4,-1,28,-1,4
1,<environment.Job instance at 0x7f4e8267c730>,10,13,[11  2],11,-1,24,-1,11
1,<environment.Job instance at 0x7f4e824c0460>,17,16,[ 3 12],18,-1,46,-1,30
1,<environment.Job instance at 0x7f4e830980a0>,36,25,[6 3],37,-1,136,-1,111
1,<environment.Job instance at 0x7f4e82942a00>,43,2,[14  3],44,-1,124,-1,122
1,<environment.Job instance at 0x7f4e82942c80>,44,1,[14  5],45,-1,123,-1,122
1,<environment.Job instance at 0x7f4e81fe54b0>,1,18,[10  5],2,-1,20,-1,2
1,<environment.Job instance at 0x7f4e81fbda50>,5,18,[9 2],6,-1,26,-1,8
1,<environment.Job instance at 0x7f4e81fbdc80>,7,20,[1 8],8,-1,28,-1,8
1,<environment.Job instance at 0x7f4e81fbd780>,11,21,[4 9],12,-1,33,-1,12
1,<environment.Job instance at 0x7f4e81fb3820>,13,16,[8 1],14,-1,32,-1,16
1,<environment.Job instance at 0x7f4e81fb38c0>,15,23,[8 4],16,-1,39,-1,16
1,<environment.Job instance at 0x7f4e81fb3910>,17,20,[5 7],18,-1,38,-1,18
1,<environment.Job instance at 0x7f4e81fb3c80>,18,16,[4 8],19,-1,35,-1,19
1,<environment.Job instance at 0x7f4e81fb35f0>,20,15,[2 8],21,-1,36,-1,21
1,<environment.Job instance at 0x7f4e83119e10>,25,16,[10  5],26,-1,44,-1,28
1,<environment.Job instance at 0x7f4e831197d0>,29,18,[2 7],30,-1,48,-1,30
1,<environment.Job instance at 0x7f4e8313ba00>,30,15,[4 7],31,-1,46,-1,31
1,<environment.Job instance at 0x7f4e8313b0f0>,33,16,[9 4],34,-1,50,-1,34
1,<environment.Job instance at 0x7f4e82017a50>,40,24,[7 2],41,-1,65,-1,41
1,<environment.Job instance at 0x7f4e82017320>,42,15,[ 2 10],43,-1,58,-1,43
1,<environment.Job instance at 0x7f4e82017550>,44,17,[8 1],45,-1,62,-1,45
1,<environment.Job instance at 0x7f4e82017f50>,46,19,[2 9],47,-1,66,-1,47
1,<environment.Job instance at 0x7f4e82017c30>,48,20,[ 1 10],49,-1,69,-1,49
1,<environment.Job instance at 0x7f4e81fb3960>,3,1,[12  4],4,-1,5,-1,4
1,<environment.Job instance at 0x7f4e81fe5410>,10,2,[ 2 12],11,-1,13,-1,11
1,<environment.Job instance at 0x7f4e830982d0>,15,23,[8 4],16,-1,49,-1,26
1,<environment.Job instance at 0x7f4e824c0780>,24,15,[11  1],25,-1,60,-1,45
1,<environment.Job instance at 0x7f4e828a2d20>,31,20,[ 5 13],32,-1,87,-1,67
1,<environment.Job instance at 0x7f4e82017af0>,40,24,[7 2],41,-1,121,-1,97
1,<environment.Job instance at 0x7f4e81ff5aa0>,45,15,[ 1 12],46,-1,131,-1,116
1,<environment.Job instance at 0x7f4e832b3460>,1,18,[3 8],2,-1,20,-1,2
1,<environment.Job instance at 0x7f4e82a63b90>,3,14,[ 4 10],4,-1,18,-1,4
1,<environment.Job instance at 0x7f4e82a63f00>,6,16,[1 6],7,-1,23,-1,7
1,<environment.Job instance at 0x7f4e82a4c280>,9,17,[ 1 10],10,-1,27,-1,10
1,<environment.Job instance at 0x7f4e82a4c190>,11,28,[5 1],12,-1,40,-1,12
1,<environment.Job instance at 0x7f4e82a4c640>,15,15,[3 5],16,-1,31,-1,16
1,<environment.Job instance at 0x7f4e82a63f50>,13,12,[3 8],14,-1,29,-1,17
1,<environment.Job instance at 0x7f4e82a4c550>,17,13,[9 1],18,-1,31,-1,18
1,<environment.Job instance at 0x7f4e82a390a0>,26,12,[9 5],27,-1,40,-1,28
1,<environment.Job instance at 0x7f4e82a39230>,29,15,[2 6],30,-1,45,-1,30
1,<environment.Job instance at 0x7f4e82a39410>,30,2,[5 5],31,-1,33,-1,31
1,<environment.Job instance at 0x7f4e82a394b0>,31,14,[9 4],32,-1,46,-1,32
1,<environment.Job instance at 0x7f4e82a39190>,27,17,[10  4],28,-1,49,-1,32
1,<environment.Job instance at 0x7f4e82a63eb0>,8,2,[ 1 13],9,-1,11,-1,9
1,<environment.Job instance at 0x7f4e82017b40>,10,28,[ 2 14],11,-1,48,-1,20
1,<environment.Job instance at 0x7f4e82017960>,11,28,[5 1],12,-1,48,-1,20
1,<environment.Job instance at 0x7f4e824c08c0>,23,23,[7 4],24,-1,85,-1,62
1,<environment.Job instance at 0x7f4e824c0780>,28,18,[13  5],29,-1,89,-1,71
1,<environment.Job instance at 0x7f4e824c05f0>,33,3,[13  5],34,-1,92,-1,89
1,<environment.Job instance at 0x7f4e83098dc0>,36,27,[5 2],37,-1,129,-1,102
1,<environment.Job instance at 0x7f4e83098be0>,37,14,[ 3 14],38,-1,116,-1,102
1,<environment.Job instance at 0x7f9b9a7058c0>,0,18,[ 2 10],1,-1,20,-1,2
1,<environment.Job instance at 0x7f9b9111d0f0>,3,18,[ 3 10],4,-1,22,-1,4
1,<environment.Job instance at 0x7f9b9111d280>,4,18,[10  4],5,-1,23,-1,5
1,<environment.Job instance at 0x7f9b9111d190>,5,13,[5 9],6,-1,19,-1,6
1,<environment.Job instance at 0x7f9b9111d320>,6,12,[11  4],7,-1,19,-1,7
1,<environment.Job instance at 0x7f9b9111d460>,8,17,[ 2 10],9,-1,26,-1,9
1,<environment.Job instance at 0x7f9b9111d5f0>,9,17,[ 4 10],10,-1,27,-1,10
1,<environment.Job instance at 0x7f9b9111d910>,13,13,[1 8],14,-1,27,-1,14
1,<environment.Job instance at 0x7f9b9111dd70>,18,16,[8 5],19,-1,35,-1,19
1,<environment.Job instance at 0x7f9b911215f0>,26,22,[2 9],27,-1,49,-1,27
1,<environment.Job instance at 0x7f9b91121aa0>,32,17,[9 3],33,-1,50,-1,33
1,<environment.Job instance at 0x7f9b91121f00>,35,16,[8 1],36,-1,52,-1,36
1,<environment.Job instance at 0x7f9b9a705aa0>,1,15,[ 1 14],2,-1,53,-1,38
1,<environment.Job instance at 0x7f9b91123410>,39,18,[5 8],40,-1,58,-1,40
1,<environment.Job instance at 0x7f9b91121af0>,31,17,[4 9],32,-1,61,-1,44
1,<environment.Job instance at 0x7f9b911230a0>,37,14,[5 5],38,-1,58,-1,44
1,<environment.Job instance at 0x7f9b91123730>,44,17,[ 5 12],45,-1,62,-1,45
1,<environment.Job instance at 0x7f9b911232d0>,45,16,[6 2],46,-1,62,-1,46
1,<environment.Job instance at 0x7f9b91123a00>,48,13,[6 1],49,-1,62,-1,49
1,<environment.Job instance at 0x7f9b91123be0>,47,1,[2 6],48,-1,50,-1,49
1,<environment.Job instance at 0x7f9b91123d20>,50,27,[9 1],51,-1,78,-1,51
1,<environment.Job instance at 0x7f9b911250a0>,53,18,[ 4 12],54,-1,72,-1,54
1,<environment.Job instance at 0x7f9b911251e0>,54,14,[1 7],55,-1,69,-1,55
1,<environment.Job instance at 0x7f9b911235f0>,43,28,[6 4],44,-1,84,-1,56
1,<environment.Job instance at 0x7f9b91125140>,55,17,[4 7],56,-1,73,-1,56
1,<environment.Job instance at 0x7f9b91125230>,56,18,[4 5],57,-1,75,-1,57
1,<environment.Job instance at 0x7f9b9111d7d0>,1,15,[ 1 14],2,-1,17,-1,2
1,<environment.Job instance at 0x7f9b911212d0>,6,12,[11  4],7,-1,19,-1,7
1,<environment.Job instance at 0x7f9b91125c80>,19,17,[12  3],20,-1,67,-1,50
1,<environment.Job instance at 0x7f9b91125f50>,22,2,[12  3],23,-1,62,-1,60
1,<environment.Job instance at 0x7f9b91128e10>,43,28,[6 4],44,-1,166,-1,138
1,<environment.Job instance at 0x7f9b9a74e280>,44,17,[ 5 12],45,-1,155,-1,138
1,<environment.Job instance at 0x7f9b911b6320>,50,27,[9 1],51,-1,179,-1,152
1,<environment.Job instance at 0x7f9b91178730>,52,3,[ 3 11],53,-1,155,-1,152
1,<environment.Job instance at 0x7f9b91178aa0>,53,18,[ 4 12],54,-1,170,-1,152
1,<environment.Job instance at 0x7f9b90861b40>,2,20,[9 1],3,-1,26,-1,6
1,<environment.Job instance at 0x7f9b908619b0>,7,26,[5 4],8,-1,34,-1,8
1,<environment.Job instance at 0x7f9b90861190>,8,22,[5 6],9,-1,31,-1,9
1,<environment.Job instance at 0x7f9b90861f50>,10,18,[5 5],11,-1,29,-1,11
1,<environment.Job instance at 0x7f9b908620f0>,12,14,[9 1],13,-1,27,-1,13
1,<environment.Job instance at 0x7f9b9085e140>,17,15,[4 7],18,-1,33,-1,18
1,<environment.Job instance at 0x7f9b9085e1e0>,18,19,[8 4],19,-1,38,-1,19
1,<environment.Job instance at 0x7f9b9085e4b0>,19,17,[2 7],20,-1,37,-1,20
1,<environment.Job instance at 0x7f9b90856d70>,24,12,[3 5],25,-1,37,-1,25
1,<environment.Job instance at 0x7f9b908614b0>,5,13,[3 5],6,-1,39,-1,26
1,<environment.Job instance at 0x7f9b9085baf0>,29,13,[7 2],30,-1,43,-1,30
1,<environment.Job instance at 0x7f9b90996050>,31,16,[5 8],32,-1,48,-1,32
1,<environment.Job instance at 0x7f9b906c6050>,35,23,[3 7],36,-1,59,-1,36
1,<environment.Job instance at 0x7f9b907338c0>,38,12,[10  1],39,-1,51,-1,39
1,<environment.Job instance at 0x7f9b906ce4b0>,40,18,[7 5],41,-1,59,-1,41
1,<environment.Job instance at 0x7f9b907a8a50>,43,17,[5 6],44,-1,61,-1,44
1,<environment.Job instance at 0x7f9b907a8410>,44,17,[5 4],45,-1,62,-1,45
1,<environment.Job instance at 0x7f9b90800b40>,48,20,[5 7],49,-1,69,-1,49
1,<environment.Job instance at 0x7f9b9070a0a0>,50,20,[5 7],51,-1,71,-1,51
1,<environment.Job instance at 0x7f9b90716cd0>,55,14,[9 1],56,-1,71,-1,57
1,<environment.Job instance at 0x7f9b9083ce10>,56,15,[9 2],57,-1,72,-1,57
1,<environment.Job instance at 0x7f9b91128b40>,0,24,[ 3 10],1,-1,25,-1,1
1,<environment.Job instance at 0x7f9b91128370>,7,26,[5 4],8,-1,45,-1,19
1,<environment.Job instance at 0x7f9b91125a00>,21,17,[ 4 14],22,-1,59,-1,42
1,<environment.Job instance at 0x7f9b911230f0>,25,19,[14  4],26,-1,68,-1,49
1,<environment.Job instance at 0x7f9b909c4dc0>,35,23,[3 7],36,-1,96,-1,73
1,<environment.Job instance at 0x7f9b908b8a00>,42,27,[ 3 13],43,-1,114,-1,87
1,<environment.Job instance at 0x7f9b908bf3c0>,51,18,[ 3 13],52,-1,131,-1,113
1,<environment.Job instance at 0x7f9b908cb190>,57,18,[ 3 12],58,-1,143,-1,125
1,<environment.Job instance at 0x7f9b90749320>,10,16,[9 3],11,-1,27,-1,11
1,<environment.Job instance at 0x7f9b90796730>,14,15,[10  5],15,-1,37,-1,22
1,<environment.Job instance at 0x7f9b90796050>,16,18,[1 6],17,-1,49,-1,31
1,<environment.Job instance at 0x7f9b90749050>,15,15,[ 3 14],16,-1,46,-1,31
1,<environment.Job instance at 0x7f9b907962d0>,20,17,[3 8],21,-1,48,-1,31
1,<environment.Job instance at 0x7f9b90796550>,21,16,[5 4],22,-1,47,-1,31
1,<environment.Job instance at 0x7f9b907964b0>,25,15,[6 2],26,-1,46,-1,31
1,<environment.Job instance at 0x7f9b907961e0>,30,13,[2 6],31,-1,44,-1,31
1,<environment.Job instance at 0x7f9b9070af00>,31,16,[1 9],32,-1,48,-1,32
1,<environment.Job instance at 0x7f9b90796a00>,28,12,[3 9],29,-1,45,-1,33
1,<environment.Job instance at 0x7f9b9070a820>,32,16,[6 2],33,-1,61,-1,45
1,<environment.Job instance at 0x7f9b90796230>,26,15,[6 2],27,-1,60,-1,45
1,<environment.Job instance at 0x7f9b9070ac80>,37,17,[3 8],38,-1,62,-1,45
1,<environment.Job instance at 0x7f9b90705c30>,43,15,[4 8],44,-1,68,-1,53
1,<environment.Job instance at 0x7f9b90705140>,44,13,[1 9],45,-1,66,-1,53
1,<environment.Job instance at 0x7f9b907055a0>,46,22,[11  3],47,-1,76,-1,54
1,<environment.Job instance at 0x7f9b90705960>,47,18,[5 2],48,-1,73,-1,55
1,<environment.Job instance at 0x7f9b90705550>,48,18,[4 6],49,-1,73,-1,55
1,<environment.Job instance at 0x7f9b90705a50>,51,14,[5 3],52,-1,71,-1,57
1,<environment.Job instance at 0x7f9b90705f00>,49,16,[3 5],50,-1,76,-1,60
1,<environment.Job instance at 0x7f9b907052d0>,38,16,[3 9],39,-1,76,-1,60
1,<environment.Job instance at 0x7f9b90796b90>,1,18,[11  5],2,-1,20,-1,2
1,<environment.Job instance at 0x7f9b9070a0f0>,2,14,[14  1],3,-1,17,-1,3
1,<environment.Job instance at 0x7f9b91128dc0>,15,15,[ 3 14],16,-1,39,-1,24
1,<environment.Job instance at 0x7f9b911281e0>,17,12,[14  5],18,-1,37,-1,25
1,<environment.Job instance at 0x7f9b906fb550>,46,22,[11  3],47,-1,157,-1,135
1,<environment.Job instance at 0x7f9b9079a780>,55,25,[3 9],56,-1,217,-1,192
1,<environment.Job instance at 0x7f9b9088beb0>,5,17,[10  5],6,-1,23,-1,6
1,<environment.Job instance at 0x7f9b9088bc30>,6,26,[9 1],7,-1,33,-1,7
1,<environment.Job instance at 0x7f9b9088b190>,8,14,[8 5],9,-1,23,-1,9
1,<environment.Job instance at 0x7f9b9088b0a0>,9,17,[9 2],10,-1,28,-1,11
1,<environment.Job instance at 0x7f9b9082d230>,10,18,[5 1],11,-1,29,-1,11
1,<environment.Job instance at 0x7f9b90bf5820>,12,14,[8 4],13,-1,29,-1,15
1,<environment.Job instance at 0x7f9b90bf5960>,15,16,[ 3 10],16,-1,42,-1,26
1,<environment.Job instance at 0x7f9b90bf5a50>,16,23,[5 8],17,-1,63,-1,40
1,<environment.Job instance at 0x7f9b90bf5eb0>,25,17,[5 9],26,-1,84,-1,67
1,<environment.Job instance at 0x7f9b90bf5550>,22,14,[9 2],23,-1,81,-1,67
1,<environment.Job instance at 0x7f9b90bf53c0>,14,17,[10  5],15,-1,85,-1,68
1,<environment.Job instance at 0x7f9b906ff7d0>,26,13,[5 1],27,-1,82,-1,69
1,<environment.Job instance at 0x7f9b906ff6e0>,32,17,[10  4],33,-1,88,-1,71
1,<environment.Job instance at 0x7f9b906ff500>,31,18,[ 5 11],32,-1,89,-1,71
1,<environment.Job instance at 0x7f9b90b97d70>,35,17,[8 1],36,-1,91,-1,74
1,<environment.Job instance at 0x7f9b907018c0>,36,16,[7 2],37,-1,91,-1,75
1,<environment.Job instance at 0x7f9b906ff640>,28,22,[9 2],29,-1,98,-1,76
1,<environment.Job instance at 0x7f9b90701730>,37,18,[ 1 10],38,-1,98,-1,80
1,<environment.Job instance at 0x7f9b90701640>,38,28,[7 4],39,-1,108,-1,80
1,<environment.Job instance at 0x7f9b90701be0>,44,28,[9 1],45,-1,111,-1,83
1,<environment.Job instance at 0x7f9b90701cd0>,45,17,[3 5],46,-1,113,-1,96
1,<environment.Job instance at 0x7f9b90bf5780>,23,27,[5 3],24,-1,123,-1,96
1,<environment.Job instance at 0x7f9b90701410>,43,15,[5 6],44,-1,111,-1,96
1,<environment.Job instance at 0x7f9b907010f0>,49,12,[5 4],50,-1,109,-1,97
1,<environment.Job instance at 0x7f9b90701140>,50,15,[7 4],51,-1,112,-1,97
1,<environment.Job instance at 0x7f9b90701960>,51,13,[3 6],52,-1,110,-1,97
1,<environment.Job instance at 0x7f9b90701820>,52,16,[8 5],53,-1,113,-1,97
1,<environment.Job instance at 0x7f9b90701aa0>,46,15,[ 5 10],47,-1,113,-1,98
1,<environment.Job instance at 0x7f9b91047eb0>,54,14,[8 5],55,-1,113,-1,99
1,<environment.Job instance at 0x7f9b90701550>,48,16,[14  3],49,-1,115,-1,99
1,<environment.Job instance at 0x7f9b90c42960>,58,18,[3 8],59,-1,117,-1,99
1,<environment.Job instance at 0x7f9b90bf5af0>,6,26,[9 1],7,-1,39,-1,13
1,<environment.Job instance at 0x7f9b906ffd20>,16,23,[5 8],17,-1,62,-1,39
1,<environment.Job instance at 0x7f9b90d5fd70>,21,2,[12  1],22,-1,48,-1,46
1,<environment.Job instance at 0x7f9b90d5faf0>,23,27,[5 3],24,-1,87,-1,60
1,<environment.Job instance at 0x7f9b91050280>,29,3,[ 4 12],30,-1,79,-1,76
1,<environment.Job instance at 0x7f9b91050cd0>,31,18,[ 5 11],32,-1,96,-1,78
1,<environment.Job instance at 0x7f9b9082d280>,38,28,[7 4],39,-1,152,-1,124
1,<environment.Job instance at 0x7f9b906fb5f0>,44,28,[9 1],45,-1,173,-1,145
1,<environment.Job instance at 0x7f9b906fb4b0>,48,16,[14  3],49,-1,161,-1,145
1,<environment.Job instance at 0x7f9b90866a50>,0,28,[7 3],1,-1,29,-1,1
1,<environment.Job instance at 0x7f9b90866910>,1,16,[7 4],2,-1,19,-1,3
1,<environment.Job instance at 0x7f9b90a9a1e0>,3,18,[1 6],4,-1,22,-1,4
1,<environment.Job instance at 0x7f9b91567910>,4,15,[9 5],5,-1,22,-1,7
1,<environment.Job instance at 0x7f9b91583e60>,6,17,[2 6],7,-1,24,-1,7
1,<environment.Job instance at 0x7f9b91567c80>,7,16,[2 8],8,-1,24,-1,8
1,<environment.Job instance at 0x7f9b91583be0>,8,12,[9 2],9,-1,23,-1,11
1,<environment.Job instance at 0x7f9b91583cd0>,10,18,[8 5],11,-1,29,-1,11
1,<environment.Job instance at 0x7f9b91566870>,14,17,[1 9],15,-1,32,-1,15
1,<environment.Job instance at 0x7f9b91556aa0>,23,21,[9 5],24,-1,46,-1,25
1,<environment.Job instance at 0x7f9b915442d0>,25,12,[12  4],26,-1,38,-1,26
1,<environment.Job instance at 0x7f9b91544640>,26,22,[6 1],27,-1,49,-1,27
1,<environment.Job instance at 0x7f9b91544730>,27,14,[3 5],28,-1,42,-1,28
1,<environment.Job instance at 0x7f9b90e20190>,24,18,[10  2],25,-1,50,-1,32
1,<environment.Job instance at 0x7f9b9153a410>,32,17,[8 2],33,-1,51,-1,34
1,<environment.Job instance at 0x7f9b90f7f780>,36,14,[5 4],37,-1,51,-1,37
1,<environment.Job instance at 0x7f9b90f85c30>,37,14,[4 7],38,-1,52,-1,38
1,<environment.Job instance at 0x7f9b90b48cd0>,39,13,[5 7],40,-1,53,-1,40
1,<environment.Job instance at 0x7f9b90b5f500>,41,16,[6 2],42,-1,58,-1,42
1,<environment.Job instance at 0x7f9b90f132d0>,46,13,[3 6],47,-1,60,-1,47
1,<environment.Job instance at 0x7f9b90f6e370>,49,14,[5 7],50,-1,64,-1,50
1,<environment.Job instance at 0x7f9b90f6e460>,50,13,[7 4],51,-1,64,-1,51
1,<environment.Job instance at 0x7f9b91583f50>,0,28,[7 3],1,-1,29,-1,1
1,<environment.Job instance at 0x7f9b906fb5f0>,18,12,[12  2],19,-1,51,-1,39
1,<environment.Job instance at 0x7f9b906fb820>,21,19,[ 3 14],22,-1,71,-1,52
1,<environment.Job instance at 0x7f9b906fbaf0>,22,2,[14  5],23,-1,54,-1,52
1,<environment.Job instance at 0x7f9b91049e60>,25,12,[12  4],26,-1,66,-1,54
1,<environment.Job instance at 0x7f9b910502d0>,31,18,[ 5 14],32,-1,86,-1,68
1,<environment.Job instance at 0x7f9b90d5fd20>,38,1,[ 5 14],39,-1,90,-1,89
1,<environment.Job instance at 0x7f9b906ff230>,43,3,[14  5],44,-1,107,-1,104
1,<environment.Job instance at 0x7f9b906ffc30>,48,17,[12  1],49,-1,138,-1,121
1,<environment.Job instance at 0x7f9b9088bd20>,52,1,[13  3],53,-1,125,-1,124
1,<environment.Job instance at 0x7f9b90e04e10>,0,17,[4 5],1,-1,18,-1,1
1,<environment.Job instance at 0x7f9b90b59960>,5,18,[9 5],6,-1,24,-1,6
1,<environment.Job instance at 0x7f9b90b59690>,7,17,[7 5],8,-1,25,-1,8
1,<environment.Job instance at 0x7f9b90efe780>,3,13,[8 3],4,-1,23,-1,10
1,<environment.Job instance at 0x7f9b90b592d0>,11,15,[10  3],12,-1,30,-1,15
1,<environment.Job instance at 0x7f9b90b591e0>,14,16,[8 3],15,-1,31,-1,15
1,<environment.Job instance at 0x7f9b90b59a00>,15,2,[4 6],16,-1,18,-1,16
1,<environment.Job instance at 0x7f9b90b595f0>,17,14,[7 1],18,-1,33,-1,19
1,<environment.Job instance at 0x7f9b90b2f690>,19,17,[4 8],20,-1,37,-1,20
1,<environment.Job instance at 0x7f9b90b2ff00>,20,14,[ 3 10],21,-1,35,-1,21
1,<environment.Job instance at 0x7f9b90b2f910>,23,15,[7 4],24,-1,43,-1,28
1,<environment.Job instance at 0x7f9b90b2fa00>,27,16,[ 5 13],28,-1,46,-1,30
1,<environment.Job instance at 0x7f9b90b5fb90>,34,18,[13  2],35,-1,58,-1,40
1,<environment.Job instance at 0x7f9b90b2fcd0>,31,16,[2 8],32,-1,56,-1,40
1,<environment.Job instance at 0x7f9b90b5faa0>,40,18,[11  4],41,-1,59,-1,41
1,<environment.Job instance at 0x7f9b90b5ff00>,41,15,[3 5],42,-1,57,-1,42
1,<environment.Job instance at 0x7f9b90b5f140>,42,20,[7 3],43,-1,65,-1,45
1,<environment.Job instance at 0x7f9b90ba5820>,45,17,[6 3],46,-1,64,-1,47
1,<environment.Job instance at 0x7f9b90b2f460>,21,18,[ 4 13],22,-1,67,-1,49
1,<environment.Job instance at 0x7f9b90ba5190>,48,17,[2 8],49,-1,66,-1,49
1,<environment.Job instance at 0x7f9b90ba50a0>,51,14,[3 6],52,-1,66,-1,52
1,<environment.Job instance at 0x7f9b90ba53c0>,52,15,[7 3],53,-1,68,-1,53
1,<environment.Job instance at 0x7f9b90ba5be0>,55,16,[2 6],56,-1,72,-1,56
1,<environment.Job instance at 0x7f9b90ba5e60>,56,15,[10  5],57,-1,72,-1,57
1,<environment.Job instance at 0x7f9b90ba5780>,57,16,[ 3 10],58,-1,74,-1,58
1,<environment.Job instance at 0x7f9b90a8e7d0>,58,16,[3 6],59,-1,75,-1,59
1,<environment.Job instance at 0x7f9b90b59820>,4,1,[3 8],5,-1,581,-1,580
1,<environment.Job instance at 0x7f9b90b59050>,2,27,[ 2 13],3,-1,30,-1,3
1,<environment.Job instance at 0x7f9b906fff00>,8,1,[12  5],9,-1,10,-1,9
1,<environment.Job instance at 0x7f9b90ba5e10>,21,18,[ 4 13],22,-1,68,-1,50
1,<environment.Job instance at 0x7f9b90b5fb40>,27,16,[ 5 13],28,-1,83,-1,67
1,<environment.Job instance at 0x7f9b90a8e2d0>,34,18,[13  2],35,-1,115,-1,97
1,<environment.Job instance at 0x7f9b90a8e0f0>,40,18,[11  4],41,-1,125,-1,107
1,<environment.Job instance at 0x7f9b90a80aa0>,4,22,[1 9],5,-1,27,-1,5
1,<environment.Job instance at 0x7f9b90a80d70>,7,13,[ 1 10],8,-1,21,-1,8
1,<environment.Job instance at 0x7f9b90a80cd0>,9,18,[ 2 10],10,-1,28,-1,10
1,<environment.Job instance at 0x7f9b906ff690>,3,12,[8 5],4,-1,22,-1,10
1,<environment.Job instance at 0x7f9b90a80b90>,11,18,[3 8],12,-1,30,-1,12
1,<environment.Job instance at 0x7f9b90a97280>,13,24,[3 6],14,-1,38,-1,14
1,<environment.Job instance at 0x7f9b90a973c0>,15,20,[3 8],16,-1,37,-1,17
1,<environment.Job instance at 0x7f9b90a97550>,17,27,[9 5],18,-1,45,-1,18
1,<environment.Job instance at 0x7f9b90a977d0>,20,18,[4 8],21,-1,39,-1,21
1,<environment.Job instance at 0x7f9b90a97dc0>,25,18,[ 3 10],26,-1,44,-1,26
1,<environment.Job instance at 0x7f9b90a97f00>,26,21,[6 1],27,-1,48,-1,27
1,<environment.Job instance at 0x7f9b90a97c30>,27,13,[4 9],28,-1,41,-1,28
1,<environment.Job instance at 0x7f9b90a944b0>,32,17,[9 1],33,-1,50,-1,33
1,<environment.Job instance at 0x7f9b90a94640>,33,18,[8 1],34,-1,52,-1,34
1,<environment.Job instance at 0x7f9b90a946e0>,35,27,[5 5],36,-1,63,-1,36
1,<environment.Job instance at 0x7f9b90a94870>,36,22,[2 8],37,-1,59,-1,37
1,<environment.Job instance at 0x7f9b90a94730>,37,20,[5 2],38,-1,58,-1,38
1,<environment.Job instance at 0x7f9b90a94a00>,39,17,[2 6],40,-1,57,-1,40
1,<environment.Job instance at 0x7f9b90a94aa0>,40,16,[1 9],41,-1,57,-1,41
1,<environment.Job instance at 0x7f9b90a94be0>,42,17,[4 6],43,-1,60,-1,43
1,<environment.Job instance at 0x7f9b90a94d70>,43,27,[7 5],44,-1,71,-1,44
1,<environment.Job instance at 0x7f9b90aa30a0>,47,13,[4 6],48,-1,61,-1,48
1,<environment.Job instance at 0x7f9b90aa31e0>,48,14,[2 7],49,-1,63,-1,49
1,<environment.Job instance at 0x7f9b90aa30f0>,49,17,[5 1],50,-1,67,-1,50
1,<environment.Job instance at 0x7f9b90aa33c0>,51,18,[5 7],52,-1,70,-1,52
1,<environment.Job instance at 0x7f9b90aa3230>,53,16,[3 5],54,-1,70,-1,54
1,<environment.Job instance at 0x7f9b90aa3410>,55,25,[3 7],56,-1,81,-1,56
1,<environment.Job instance at 0x7f9b90aa3820>,57,14,[10  3],58,-1,72,-1,58
1,<environment.Job instance at 0x7f9b90aa39b0>,58,13,[8 2],59,-1,72,-1,59
1,<environment.Job instance at 0x7f9b90a97780>,1,25,[10  4],2,-1,27,-1,2
1,<environment.Job instance at 0x7f9b90b43eb0>,13,24,[3 6],14,-1,54,-1,30
1,<environment.Job instance at 0x7f9b90b43500>,17,27,[9 5],18,-1,60,-1,33
1,<environment.Job instance at 0x7f9b90a8e0a0>,23,2,[ 3 14],24,-1,52,-1,50
1,<environment.Job instance at 0x7f9b91566b90>,34,3,[ 3 12],35,-1,86,-1,83
1,<environment.Job instance at 0x7f9b90b5fd70>,35,27,[5 5],36,-1,127,-1,100
1,<environment.Job instance at 0x7f9b90f7fc30>,38,13,[14  4],39,-1,114,-1,101
1,<environment.Job instance at 0x7f9b90f7daa0>,43,27,[7 5],44,-1,147,-1,120
1,<environment.Job instance at 0x7f9b910494b0>,44,13,[14  5],45,-1,133,-1,120
1,<environment.Job instance at 0x7f9b90b2faf0>,55,25,[3 7],56,-1,202,-1,177
1,<environment.Job instance at 0x7f9b908fb370>,5,16,[10  5],6,-1,23,-1,7
1,<environment.Job instance at 0x7f9b908fb910>,7,14,[9 1],8,-1,22,-1,8
1,<environment.Job instance at 0x7f9b908fb500>,8,21,[9 5],9,-1,30,-1,9
1,<environment.Job instance at 0x7f9b908820a0>,10,17,[9 4],11,-1,28,-1,11
1,<environment.Job instance at 0x7f9b908b10f0>,6,13,[8 4],7,-1,29,-1,16
1,<environment.Job instance at 0x7f9b90d66eb0>,17,16,[2 6],18,-1,34,-1,18
1,<environment.Job instance at 0x7f9b90d667d0>,23,17,[1 8],24,-1,41,-1,24
1,<environment.Job instance at 0x7f9b90d66690>,27,3,[10  3],28,-1,37,-1,34
1,<environment.Job instance at 0x7f9b909b5820>,32,17,[10  3],33,-1,51,-1,34
1,<environment.Job instance at 0x7f9b909b57d0>,33,13,[9 5],34,-1,48,-1,35
1,<environment.Job instance at 0x7f9b90b1f0f0>,44,25,[1 7],45,-1,126,-1,101
1,<environment.Job instance at 0x7f9b90d14af0>,54,17,[7 4],55,-1,118,-1,101
1,<environment.Job instance at 0x7f9b90d142d0>,56,27,[5 8],57,-1,128,-1,101
1,<environment.Job instance at 0x7f9b90882d20>,0,1,[ 4 12],1,-1,2,-1,1
1,<environment.Job instance at 0x7f9b90d66af0>,4,12,[13  3],5,-1,17,-1,5
1,<environment.Job instance at 0x7f9b90a60370>,9,3,[12  1],10,-1,13,-1,10
1,<environment.Job instance at 0x7f9b90f6ecd0>,19,16,[ 5 13],20,-1,53,-1,37
1,<environment.Job instance at 0x7f9b90ba56e0>,24,14,[ 3 14],25,-1,67,-1,53
1,<environment.Job instance at 0x7f9b90ba5910>,25,24,[3 9],26,-1,79,-1,55
1,<environment.Job instance at 0x7f9b90a8e500>,35,1,[12  4],36,-1,91,-1,90
1,<environment.Job instance at 0x7f9b90b43a00>,41,15,[14  1],42,-1,115,-1,100
1,<environment.Job instance at 0x7f9b90b43c30>,42,27,[5 5],43,-1,128,-1,101
1,<environment.Job instance at 0x7f9b90b43460>,44,25,[1 7],45,-1,138,-1,113
1,<environment.Job instance at 0x7f9b9087f2d0>,56,27,[5 8],57,-1,198,-1,171
1,<environment.Job instance at 0x7f9b93d4b640>,5,19,[7 5],6,-1,26,-1,7
1,<environment.Job instance at 0x7f9b93d4b280>,7,12,[10  4],8,-1,20,-1,8
1,<environment.Job instance at 0x7f9b93d4b730>,10,14,[ 4 10],11,-1,25,-1,11
1,<environment.Job instance at 0x7f9b93d4b5a0>,12,17,[2 5],13,-1,30,-1,13
1,<environment.Job instance at 0x7f9b911afc30>,16,18,[8 2],17,-1,35,-1,17
1,<environment.Job instance at 0x7f9b90f67730>,19,18,[5 8],20,-1,38,-1,20
1,<environment.Job instance at 0x7f9b90f67be0>,20,19,[2 7],21,-1,40,-1,21
1,<environment.Job instance at 0x7f9b90f67690>,21,24,[1 9],22,-1,46,-1,22
1,<environment.Job instance at 0x7f9b91059fa0>,6,14,[8 1],7,-1,36,-1,22
1,<environment.Job instance at 0x7f9b90f67eb0>,24,1,[2 5],25,-1,26,-1,25
1,<environment.Job instance at 0x7f9b90f67820>,26,14,[7 5],27,-1,41,-1,27
1,<environment.Job instance at 0x7f9b917b9780>,27,23,[10  4],28,-1,51,-1,28
1,<environment.Job instance at 0x7f9b917b92d0>,28,14,[3 8],29,-1,43,-1,29
1,<environment.Job instance at 0x7f9b917b9b40>,31,17,[5 7],32,-1,49,-1,32
1,<environment.Job instance at 0x7f9b917b99b0>,34,13,[1 9],35,-1,49,-1,36
1,<environment.Job instance at 0x7f9b90f4c9b0>,39,17,[ 5 10],40,-1,57,-1,40
1,<environment.Job instance at 0x7f9b90f4c370>,40,18,[4 6],41,-1,59,-1,41
1,<environment.Job instance at 0x7f9b90f4c050>,41,15,[3 5],42,-1,57,-1,42
1,<environment.Job instance at 0x7f9b90f4c140>,44,15,[5 7],45,-1,60,-1,45
1,<environment.Job instance at 0x7f9b90f4c460>,47,18,[1 7],48,-1,66,-1,48
1,<environment.Job instance at 0x7f9b90f4ceb0>,48,19,[1 6],49,-1,68,-1,49
1,<environment.Job instance at 0x7f9b90c94320>,53,20,[5 7],54,-1,79,-1,59
1,<environment.Job instance at 0x7f9b90f4c320>,1,24,[4 8],2,-1,26,-1,2
1,<environment.Job instance at 0x7f9b916bffa0>,11,1,[11  1],12,-1,13,-1,12
1,<environment.Job instance at 0x7f9b90a7e500>,21,24,[1 9],22,-1,76,-1,52
1,<environment.Job instance at 0x7f9b90ec60a0>,27,23,[10  4],28,-1,85,-1,62
1,<environment.Job instance at 0x7f9b91966a50>,33,3,[ 5 13],34,-1,82,-1,79
1,<environment.Job instance at 0x7f9b915b2e10>,36,17,[13  2],37,-1,108,-1,91
1,<environment.Job instance at 0x7f9b915b29b0>,37,1,[11  4],38,-1,92,-1,91
1,<environment.Job instance at 0x7f9b913a8500>,42,17,[ 2 12],43,-1,120,-1,103
1,<environment.Job instance at 0x7f9b913a8aa0>,45,24,[10  2],46,-1,143,-1,119
1,<environment.Job instance at 0x7f9b90a61460>,49,27,[14  1],50,-1,173,-1,146
1,<environment.Job instance at 0x7f9b91c7ea00>,52,2,[11  4],53,-1,148,-1,146
1,<environment.Job instance at 0x7f9b90c3b320>,55,12,[11  5],56,-1,159,-1,147
1,<environment.Job instance at 0x7f9b90c3b140>,56,27,[4 5],57,-1,175,-1,148
1,<environment.Job instance at 0x7f9b91714690>,0,14,[8 4],1,-1,16,-1,2
1,<environment.Job instance at 0x7f9b91714730>,3,18,[6 1],4,-1,22,-1,4
1,<environment.Job instance at 0x7f9b912c1910>,4,12,[4 7],5,-1,17,-1,5
1,<environment.Job instance at 0x7f9b913e25a0>,6,14,[10  4],7,-1,21,-1,7
1,<environment.Job instance at 0x7f9b917c1140>,13,12,[ 2 10],14,-1,26,-1,14
1,<environment.Job instance at 0x7f9b911aed70>,1,12,[5 9],2,-1,27,-1,15
1,<environment.Job instance at 0x7f9b917c1c80>,16,16,[2 6],17,-1,34,-1,18
1,<environment.Job instance at 0x7f9b917c1730>,20,18,[5 9],21,-1,39,-1,21
1,<environment.Job instance at 0x7f9b90887320>,23,18,[ 1 10],24,-1,42,-1,24
1,<environment.Job instance at 0x7f9b9117f370>,29,14,[9 5],30,-1,44,-1,30
1,<environment.Job instance at 0x7f9b917c1eb0>,17,18,[3 6],18,-1,51,-1,33
1,<environment.Job instance at 0x7f9b90edacd0>,35,17,[ 5 10],36,-1,53,-1,36
1,<environment.Job instance at 0x7f9b90eda410>,36,17,[ 1 10],37,-1,54,-1,37
1,<environment.Job instance at 0x7f9b91215730>,2,3,[11  3],3,-1,6,-1,3
1,<environment.Job instance at 0x7f9b90e36dc0>,11,15,[ 2 14],12,-1,31,-1,16
1,<environment.Job instance at 0x7f9b905d7be0>,15,12,[ 3 13],16,-1,29,-1,17
1,<environment.Job instance at 0x7f9b90a7ea00>,31,17,[14  3],32,-1,79,-1,62
1,<environment.Job instance at 0x7f9b91c5f870>,34,15,[ 2 13],35,-1,79,-1,64
1,<environment.Job instance at 0x7f9b91c5faa0>,37,3,[12  4],38,-1,82,-1,79
1,<environment.Job instance at 0x7f9b90b1fbe0>,39,28,[1 8],40,-1,124,-1,96
1,<environment.Job instance at 0x7f9b91387f50>,48,18,[13  3],49,-1,132,-1,114
1,<environment.Job instance at 0x7f9b90324fa0>,55,24,[8 3],56,-1,186,-1,162
1,<environment.Job instance at 0x7f9b9123f190>,0,18,[8 1],1,-1,24,-1,6
1,<environment.Job instance at 0x7f9b9094b0a0>,6,18,[9 4],7,-1,25,-1,7
1,<environment.Job instance at 0x7f9b9094b690>,7,17,[3 5],8,-1,25,-1,8
1,<environment.Job instance at 0x7f9b9094bbe0>,8,17,[2 6],9,-1,26,-1,9
1,<environment.Job instance at 0x7f9b9094bd20>,12,15,[10  1],13,-1,29,-1,14
1,<environment.Job instance at 0x7f9b90856e60>,14,24,[4 5],15,-1,39,-1,15
1,<environment.Job instance at 0x7f9b908563c0>,16,13,[3 9],17,-1,30,-1,17
1,<environment.Job instance at 0x7f9b91cfddc0>,18,16,[6 5],19,-1,35,-1,19
1,<environment.Job instance at 0x7f9b91b31910>,22,15,[2 5],23,-1,38,-1,23
1,<environment.Job instance at 0x7f9b9155e280>,23,14,[4 8],24,-1,38,-1,24
1,<environment.Job instance at 0x7f9b9155ef50>,24,16,[9 2],25,-1,41,-1,25
1,<environment.Job instance at 0x7f9b9a7aff00>,26,15,[9 1],27,-1,42,-1,27
1,<environment.Job instance at 0x7f9b90b0ec80>,29,13,[1 8],30,-1,43,-1,30
1,<environment.Job instance at 0x7f9b90b16fa0>,13,17,[5 3],14,-1,47,-1,30
1,<environment.Job instance at 0x7f9b90a31be0>,33,15,[6 1],34,-1,49,-1,34
1,<environment.Job instance at 0x7f9b917f8780>,34,3,[7 4],35,-1,38,-1,35
1,<environment.Job instance at 0x7f9b912fb5a0>,35,3,[9 4],36,-1,39,-1,36
1,<environment.Job instance at 0x7f9b90c3b050>,36,2,[5 5],37,-1,39,-1,37
1,<environment.Job instance at 0x7f9b91369370>,38,17,[7 2],39,-1,56,-1,39
1,<environment.Job instance at 0x7f9b91143370>,39,16,[10  2],40,-1,56,-1,40
1,<environment.Job instance at 0x7f9b911438c0>,40,15,[5 6],41,-1,56,-1,41
1,<environment.Job instance at 0x7f9b91143cd0>,44,15,[7 3],45,-1,60,-1,45
1,<environment.Job instance at 0x7f9b91b29820>,45,12,[10  3],46,-1,58,-1,46
1,<environment.Job instance at 0x7f9b91b29e60>,46,14,[5 4],47,-1,61,-1,47
1,<environment.Job instance at 0x7f9b91b29fa0>,47,15,[10  1],48,-1,63,-1,48
1,<environment.Job instance at 0x7f9b91b29c30>,49,23,[6 5],50,-1,73,-1,50
1,<environment.Job instance at 0x7f9b91b292d0>,50,17,[2 6],51,-1,68,-1,51
1,<environment.Job instance at 0x7f9b90c388c0>,11,13,[12  4],12,-1,32,-1,19
1,<environment.Job instance at 0x7f9b912fb050>,14,24,[4 5],15,-1,53,-1,29
1,<environment.Job instance at 0x7f9b9a286f50>,49,23,[6 5],50,-1,195,-1,172
1,<environment.Job instance at 0x7f9b911289b0>,0,27,[6 4],1,-1,28,-1,1
1,<environment.Job instance at 0x7f9b9a639690>,2,15,[10  1],3,-1,19,-1,4
1,<environment.Job instance at 0x7f9b90e36640>,4,13,[1 8],5,-1,18,-1,5
1,<environment.Job instance at 0x7f9b90e36730>,6,14,[1 7],7,-1,21,-1,7
1,<environment.Job instance at 0x7f9b90e36f50>,8,22,[7 5],9,-1,31,-1,9
1,<environment.Job instance at 0x7f9b90e36910>,9,16,[5 3],10,-1,26,-1,10
1,<environment.Job instance at 0x7f9b90e36550>,10,18,[ 5 10],11,-1,29,-1,11
1,<environment.Job instance at 0x7f9b90e36cd0>,12,24,[1 6],13,-1,37,-1,13
1,<environment.Job instance at 0x7f9b90e365a0>,13,16,[8 5],14,-1,30,-1,14
1,<environment.Job instance at 0x7f9b90e36230>,14,16,[9 4],15,-1,31,-1,15
1,<environment.Job instance at 0x7f9b912a4500>,3,13,[7 5],4,-1,28,-1,15
1,<environment.Job instance at 0x7f9b91164280>,16,15,[10  4],17,-1,33,-1,18
1,<environment.Job instance at 0x7f9b90e36e60>,18,17,[3 9],19,-1,36,-1,19
1,<environment.Job instance at 0x7f9b915b4500>,20,14,[1 8],21,-1,35,-1,21
1,<environment.Job instance at 0x7f9b90c027d0>,21,12,[5 6],22,-1,34,-1,22
1,<environment.Job instance at 0x7f9b903145f0>,23,13,[5 1],24,-1,37,-1,24
1,<environment.Job instance at 0x7f9b91aa4f50>,28,14,[9 1],29,-1,43,-1,29
1,<environment.Job instance at 0x7f9b91aa40a0>,29,17,[1 9],30,-1,47,-1,30
1,<environment.Job instance at 0x7f9b90310a50>,17,13,[ 4 10],18,-1,45,-1,32
1,<environment.Job instance at 0x7f9b9070c0a0>,39,18,[ 5 10],40,-1,60,-1,42
1,<environment.Job instance at 0x7f9b91a8fd20>,48,24,[4 7],49,-1,73,-1,49
1,<environment.Job instance at 0x7f9b9072b960>,41,12,[1 8],42,-1,69,-1,57
1,<environment.Job instance at 0x7f9b910409b0>,52,17,[9 4],53,-1,77,-1,60
1,<environment.Job instance at 0x7f9b910405f0>,54,18,[ 4 11],55,-1,79,-1,61
1,<environment.Job instance at 0x7f9b91040190>,55,16,[9 4],56,-1,77,-1,61
1,<environment.Job instance at 0x7f9b9071a320>,57,15,[4 6],58,-1,77,-1,62
1,<environment.Job instance at 0x7f9b9072b370>,0,27,[6 4],1,-1,28,-1,1
1,<environment.Job instance at 0x7f9b91a8ff50>,1,1,[11  4],2,-1,3,-1,2
1,<environment.Job instance at 0x7f9b91c8a5f0>,12,24,[1 6],13,-1,45,-1,21
1,<environment.Job instance at 0x7f9b91c8dc80>,24,3,[ 2 12],25,-1,70,-1,67
1,<environment.Job instance at 0x7f9b91c64190>,31,2,[ 3 14],32,-1,87,-1,85
1,<environment.Job instance at 0x7f9b913ec190>,36,13,[12  4],37,-1,114,-1,101
1,<environment.Job instance at 0x7f9b913ecc30>,37,27,[9 3],38,-1,129,-1,102
1,<environment.Job instance at 0x7f9b913cf640>,46,12,[ 2 11],47,-1,142,-1,130
1,<environment.Job instance at 0x7f9b913cf780>,48,24,[4 7],49,-1,169,-1,145
1,<environment.Job instance at 0x7f9b913c6820>,54,18,[ 4 11],55,-1,175,-1,157
1,<environment.Job instance at 0x7f9b91b03280>,0,20,[4 6],1,-1,21,-1,1
1,<environment.Job instance at 0x7f9b90c9b320>,12,17,[ 2 10],13,-1,31,-1,14
1,<environment.Job instance at 0x7f9b90c9b870>,14,12,[9 1],15,-1,27,-1,15
1,<environment.Job instance at 0x7f9b90c9bbe0>,18,20,[3 8],19,-1,39,-1,19
1,<environment.Job instance at 0x7f9b90c9b820>,19,13,[7 4],20,-1,33,-1,20
1,<environment.Job instance at 0x7f9b903ec3c0>,21,21,[4 7],22,-1,43,-1,22
1,<environment.Job instance at 0x7f9b903ecc80>,23,15,[4 9],24,-1,39,-1,24
1,<environment.Job instance at 0x7f9b903ec050>,26,18,[6 3],27,-1,45,-1,27
1,<environment.Job instance at 0x7f9b903ecfa0>,27,1,[2 6],28,-1,29,-1,28
1,<environment.Job instance at 0x7f9b903ec9b0>,29,19,[5 5],30,-1,49,-1,30
1,<environment.Job instance at 0x7f9b903eceb0>,30,15,[10  4],31,-1,46,-1,31
1,<environment.Job instance at 0x7f9b903ec4b0>,31,18,[4 8],32,-1,50,-1,32
1,<environment.Job instance at 0x7f9b903ec5f0>,32,15,[4 8],33,-1,48,-1,33
1,<environment.Job instance at 0x7f9b903ec910>,34,14,[3 8],35,-1,49,-1,35
1,<environment.Job instance at 0x7f9b903ec820>,35,12,[10  1],36,-1,55,-1,43
1,<environment.Job instance at 0x7f9b91338460>,42,16,[3 8],43,-1,59,-1,43
1,<environment.Job instance at 0x7f9b91291550>,48,17,[9 5],49,-1,66,-1,49
1,<environment.Job instance at 0x7f9b91a221e0>,49,16,[7 2],50,-1,66,-1,50
1,<environment.Job instance at 0x7f9b91a22aa0>,50,16,[ 3 10],51,-1,67,-1,51
1,<environment.Job instance at 0x7f9b903ec640>,38,18,[4 6],39,-1,70,-1,52
1,<environment.Job instance at 0x7f9b91291500>,46,18,[10  2],47,-1,70,-1,52
1,<environment.Job instance at 0x7f9b91a22780>,51,16,[5 7],52,-1,68,-1,52
1,<environment.Job instance at 0x7f9b91b03230>,3,14,[ 1 11],4,-1,18,-1,4
1,<environment.Job instance at 0x7f9b90a5daf0>,5,16,[ 2 11],6,-1,22,-1,6
1,<environment.Job instance at 0x7f9b90a47820>,8,2,[13  3],9,-1,11,-1,9
1,<environment.Job instance at 0x7f9b915110f0>,22,17,[ 2 11],23,-1,56,-1,39
1,<environment.Job instance at 0x7f9b91bad5f0>,24,1,[ 2 11],25,-1,40,-1,39
1,<environment.Job instance at 0x7f9b9101f8c0>,20,24,[10  4],21,-1,64,-1,40
1,<environment.Job instance at 0x7f9b90875d20>,39,1,[ 5 14],40,-1,95,-1,94
1,<environment.Job instance at 0x7f9b90fd85f0>,57,27,[ 2 11],58,-1,201,-1,174
1,<environment.Job instance at 0x7f9b9173c410>,8,17,[3 7],9,-1,26,-1,9
1,<environment.Job instance at 0x7f9b916db5f0>,11,17,[2 7],12,-1,29,-1,12
1,<environment.Job instance at 0x7f9b916db280>,12,17,[6 4],13,-1,30,-1,13
1,<environment.Job instance at 0x7f9b916db820>,13,12,[7 4],14,-1,27,-1,15
1,<environment.Job instance at 0x7f9b9153adc0>,18,12,[ 4 10],19,-1,31,-1,19
1,<environment.Job instance at 0x7f9b90b9be10>,20,14,[ 2 10],21,-1,37,-1,23
1,<environment.Job instance at 0x7f9b90e36d70>,22,16,[ 3 10],23,-1,39,-1,23
1,<environment.Job instance at 0x7f9b90b9bd20>,23,18,[5 5],24,-1,42,-1,24
1,<environment.Job instance at 0x7f9b90e368c0>,24,16,[5 5],25,-1,41,-1,25
1,<environment.Job instance at 0x7f9b90c42280>,25,17,[ 3 10],26,-1,43,-1,26
1,<environment.Job instance at 0x7f9b91a9db40>,28,18,[1 5],29,-1,47,-1,29
1,<environment.Job instance at 0x7f9b9153bcd0>,29,18,[9 5],30,-1,48,-1,30
1,<environment.Job instance at 0x7f9b9153bf50>,30,19,[4 5],31,-1,50,-1,31
1,<environment.Job instance at 0x7f9b915a06e0>,32,13,[9 4],33,-1,46,-1,33
1,<environment.Job instance at 0x7f9b90e36320>,33,12,[2 6],34,-1,46,-1,34
1,<environment.Job instance at 0x7f9b9095ab90>,34,16,[2 7],35,-1,51,-1,35
1,<environment.Job instance at 0x7f9b903effa0>,38,16,[8 3],39,-1,55,-1,39
1,<environment.Job instance at 0x7f9b903ef730>,40,23,[9 4],41,-1,64,-1,41
1,<environment.Job instance at 0x7f9b903ef3c0>,41,21,[8 2],42,-1,63,-1,42
1,<environment.Job instance at 0x7f9b91511190>,42,21,[5 7],43,-1,64,-1,43
1,<environment.Job instance at 0x7f9b91524cd0>,44,17,[9 2],45,-1,62,-1,45
1,<environment.Job instance at 0x7f9b915248c0>,45,18,[5 5],46,-1,64,-1,46
1,<environment.Job instance at 0x7f9b915240a0>,48,28,[10  4],49,-1,77,-1,49
1,<environment.Job instance at 0x7f9b91b7b320>,52,18,[4 7],53,-1,71,-1,53
1,<environment.Job instance at 0x7f9b91b7bd70>,53,18,[7 1],54,-1,72,-1,54
1,<environment.Job instance at 0x7f9b90bf05a0>,54,14,[9 1],55,-1,70,-1,56
1,<environment.Job instance at 0x7f9b91b7bfa0>,55,12,[7 1],56,-1,68,-1,56
1,<environment.Job instance at 0x7f9b90bf0370>,56,18,[8 3],57,-1,75,-1,57
1,<environment.Job instance at 0x7f9b9173cd20>,2,1,[12  5],3,-1,4,-1,3
1,<environment.Job instance at 0x7f9b9171f370>,40,23,[9 4],41,-1,158,-1,135
1,<environment.Job instance at 0x7f9b91cb9230>,48,28,[10  4],49,-1,181,-1,153
1,<environment.Job instance at 0x7f9b915ca5f0>,58,17,[12  1],59,-1,202,-1,185
1,<environment.Job instance at 0x7f9b91a931e0>,0,26,[4 9],1,-1,27,-1,1
1,<environment.Job instance at 0x7f9b90e0be60>,5,18,[1 8],6,-1,25,-1,7
1,<environment.Job instance at 0x7f9b90e0bf50>,7,23,[5 3],8,-1,31,-1,8
1,<environment.Job instance at 0x7f9b90dfd050>,8,16,[9 4],9,-1,25,-1,9
1,<environment.Job instance at 0x7f9b90dfd0f0>,9,15,[5 7],10,-1,25,-1,10
1,<environment.Job instance at 0x7f9b90dfd190>,10,14,[1 5],11,-1,25,-1,11
1,<environment.Job instance at 0x7f9b90dfd230>,11,18,[11  2],12,-1,30,-1,12
1,<environment.Job instance at 0x7f9b90dfd780>,19,18,[6 4],20,-1,39,-1,21
1,<environment.Job instance at 0x7f9b90dfd8c0>,20,13,[11  2],21,-1,34,-1,21
1,<environment.Job instance at 0x7f9b91535be0>,6,13,[9 3],7,-1,34,-1,21
1,<environment.Job instance at 0x7f9b90dfd5a0>,18,14,[1 7],19,-1,37,-1,23
1,<environment.Job instance at 0x7f9b90dfd9b0>,21,13,[6 3],22,-1,36,-1,23
1,<environment.Job instance at 0x7f9b90dfde10>,27,16,[ 3 12],28,-1,44,-1,28
1,<environment.Job instance at 0x7f9b90dfddc0>,28,15,[7 3],29,-1,44,-1,29
1,<environment.Job instance at 0x7f9b90e0c050>,29,17,[9 2],30,-1,47,-1,30
1,<environment.Job instance at 0x7f9b90e0c0f0>,30,14,[10  1],31,-1,46,-1,32
1,<environment.Job instance at 0x7f9b90e0c3c0>,33,22,[5 2],34,-1,56,-1,34
1,<environment.Job instance at 0x7f9b90e0c500>,34,18,[5 6],35,-1,53,-1,35
1,<environment.Job instance at 0x7f9b90e0c280>,35,17,[3 6],36,-1,53,-1,36
1,<environment.Job instance at 0x7f9b90e0c5f0>,36,13,[8 2],37,-1,52,-1,39
1,<environment.Job instance at 0x7f9b90e0c7d0>,40,16,[ 2 10],41,-1,57,-1,41
1,<environment.Job instance at 0x7f9b90e0cbe0>,42,15,[5 9],43,-1,58,-1,43
1,<environment.Job instance at 0x7f9b90e0cc30>,44,14,[6 4],45,-1,60,-1,46
1,<environment.Job instance at 0x7f9b90e0caf0>,46,25,[6 3],47,-1,72,-1,47
1,<environment.Job instance at 0x7f9b90e0cdc0>,45,18,[ 5 10],46,-1,65,-1,47
1,<environment.Job instance at 0x7f9b90e2b500>,57,18,[3 8],58,-1,76,-1,58
1,<environment.Job instance at 0x7f9b90dfd910>,0,26,[4 9],1,-1,27,-1,1
1,<environment.Job instance at 0x7f9b906ff500>,2,16,[13  1],3,-1,19,-1,3
1,<environment.Job instance at 0x7f9b915cad20>,11,18,[11  2],12,-1,30,-1,12
1,<environment.Job instance at 0x7f9b915ca550>,12,12,[ 5 13],13,-1,25,-1,13
1,<environment.Job instance at 0x7f9b90e0bb90>,13,24,[ 5 11],14,-1,38,-1,14
1,<environment.Job instance at 0x7f9b90e2b280>,7,23,[5 3],8,-1,41,-1,18
1,<environment.Job instance at 0x7f9b91cb9dc0>,20,13,[11  2],21,-1,49,-1,36
1,<environment.Job instance at 0x7f9b91cb9a50>,27,16,[ 3 12],28,-1,88,-1,72
1,<environment.Job instance at 0x7f9b916f9b90>,46,25,[6 3],47,-1,166,-1,141
1,<environment.Job instance at 0x7f9b91511730>,53,2,[14  3],54,-1,161,-1,159
1,<environment.Job instance at 0x7f9b91b7b820>,54,1,[14  5],55,-1,160,-1,159
1,<environment.Job instance at 0x7f9b907cb370>,1,18,[10  5],2,-1,20,-1,2
1,<environment.Job instance at 0x7f9b907cb500>,5,18,[9 2],6,-1,24,-1,6
1,<environment.Job instance at 0x7f9b907c10a0>,7,20,[1 8],8,-1,28,-1,8
1,<environment.Job instance at 0x7f9b907c1a00>,11,21,[4 9],12,-1,33,-1,12
1,<environment.Job instance at 0x7f9b907c1870>,13,16,[8 1],14,-1,32,-1,16
1,<environment.Job instance at 0x7f9b907c1eb0>,15,23,[8 4],16,-1,39,-1,16
1,<environment.Job instance at 0x7f9b907c1e60>,17,20,[5 7],18,-1,38,-1,18
1,<environment.Job instance at 0x7f9b907c1140>,18,16,[4 8],19,-1,35,-1,19
1,<environment.Job instance at 0x7f9b907c1500>,20,15,[2 8],21,-1,36,-1,21
1,<environment.Job instance at 0x7f9b907e5e60>,25,16,[10  5],26,-1,44,-1,28
1,<environment.Job instance at 0x7f9b907e54b0>,29,18,[2 7],30,-1,48,-1,30
1,<environment.Job instance at 0x7f9b907e5be0>,30,15,[4 7],31,-1,46,-1,31
1,<environment.Job instance at 0x7f9b907e5730>,33,16,[9 4],34,-1,50,-1,34
1,<environment.Job instance at 0x7f9b90e26370>,40,24,[7 2],41,-1,65,-1,41
1,<environment.Job instance at 0x7f9b90e26550>,42,15,[ 2 10],43,-1,58,-1,43
1,<environment.Job instance at 0x7f9b907e5410>,27,16,[1 7],28,-1,60,-1,44
1,<environment.Job instance at 0x7f9b904fe4b0>,46,19,[2 9],47,-1,68,-1,49
1,<environment.Job instance at 0x7f9b904fe640>,49,18,[2 7],50,-1,68,-1,50
1,<environment.Job instance at 0x7f9b904fe6e0>,51,18,[3 8],52,-1,70,-1,52
1,<environment.Job instance at 0x7f9b904fe050>,53,14,[ 4 10],54,-1,68,-1,54
1,<environment.Job instance at 0x7f9b904fe5f0>,54,15,[4 8],55,-1,70,-1,55
1,<environment.Job instance at 0x7f9b904fe9b0>,56,16,[1 6],57,-1,73,-1,57
1,<environment.Job instance at 0x7f9b904fef00>,57,15,[7 4],58,-1,73,-1,58
1,<environment.Job instance at 0x7f9b907e52d0>,3,1,[12  4],4,-1,5,-1,4
1,<environment.Job instance at 0x7f9b907cb0a0>,10,2,[ 2 12],11,-1,13,-1,11
1,<environment.Job instance at 0x7f9b904fe690>,15,23,[8 4],16,-1,49,-1,26
1,<environment.Job instance at 0x7f9b90519d20>,24,15,[11  1],25,-1,60,-1,45
1,<environment.Job instance at 0x7f9b905042d0>,31,20,[ 5 13],32,-1,87,-1,67
1,<environment.Job instance at 0x7f9b905b1550>,40,24,[7 2],41,-1,121,-1,97
1,<environment.Job instance at 0x7f9b905b1050>,45,15,[ 1 12],46,-1,131,-1,116
1,<environment.Job instance at 0x7f9b905b1f50>,58,2,[ 1 13],59,-1,170,-1,168
1,<environment.Job instance at 0x7f9b91b4b460>,1,28,[5 1],2,-1,30,-1,2
1,<environment.Job instance at 0x7f9b90e0c690>,5,15,[3 5],6,-1,21,-1,6
1,<environment.Job instance at 0x7f9b91b4b1e0>,7,13,[9 1],8,-1,21,-1,8
1,<environment.Job instance at 0x7f9b9a2a0d20>,9,2,[5 1],10,-1,14,-1,12
1,<environment.Job instance at 0x7f9b9a2a0050>,12,13,[9 1],13,-1,26,-1,13
1,<environment.Job instance at 0x7f9b9a2a09b0>,13,23,[7 4],14,-1,37,-1,14
1,<environment.Job instance at 0x7f9b9a2a03c0>,16,12,[9 5],17,-1,30,-1,18
1,<environment.Job instance at 0x7f9b9a2a0460>,17,17,[10  4],18,-1,35,-1,18
1,<environment.Job instance at 0x7f9b9034e230>,25,18,[7 5],26,-1,44,-1,26
1,<environment.Job instance at 0x7f9b9034ee60>,26,27,[5 2],27,-1,54,-1,27
1,<environment.Job instance at 0x7f9b9a2a0fa0>,0,28,[ 2 14],1,-1,29,-1,1
1,<environment.Job instance at 0x7f9b9034e4b0>,1,28,[5 1],2,-1,30,-1,2
1,<environment.Job instance at 0x7f9b91213d20>,13,23,[7 4],14,-1,38,-1,15
1,<environment.Job instance at 0x7f9b91b4b8c0>,18,18,[13  5],19,-1,37,-1,19
1,<environment.Job instance at 0x7f9b905b1640>,23,3,[13  5],24,-1,47,-1,44
1,<environment.Job instance at 0x7f9b905b1be0>,26,27,[5 2],27,-1,75,-1,48
1,<environment.Job instance at 0x7f9b905b1370>,27,14,[ 3 14],28,-1,62,-1,48
1,<environment.Job instance at 0x7f9b912c1820>,44,28,[4 5],45,-1,140,-1,112
1,<environment.Job instance at 0x7f9b912c19b0>,47,2,[ 5 13],48,-1,115,-1,113
1,<environment.Job instance at 0x7f9b90919640>,51,25,[10  1],52,-1,167,-1,142
1,<environment.Job instance at 0x7f9b91420230>,0,16,[7 5],1,-1,17,-1,1
1,<environment.Job instance at 0x7f9b90ebe050>,3,17,[5 9],4,-1,21,-1,4
1,<environment.Job instance at 0x7f9b90ebe320>,5,21,[9 3],6,-1,27,-1,6
1,<environment.Job instance at 0x7f9b90ebee10>,7,25,[9 4],8,-1,33,-1,8
1,<environment.Job instance at 0x7f9b90e0c230>,10,12,[10  1],11,-1,26,-1,14
1,<environment.Job instance at 0x7f9b90eada50>,14,17,[1 9],15,-1,33,-1,16
1,<environment.Job instance at 0x7f9b90ead320>,16,18,[8 1],17,-1,35,-1,17
1,<environment.Job instance at 0x7f9b90ead550>,18,2,[10  5],19,-1,21,-1,19
1,<environment.Job instance at 0x7f9b90eade60>,12,16,[9 4],13,-1,35,-1,19
1,<environment.Job instance at 0x7f9b90ead4b0>,19,28,[6 1],20,-1,48,-1,20
1,<environment.Job instance at 0x7f9b9141ba50>,21,13,[7 4],22,-1,36,-1,23
1,<environment.Job instance at 0x7f9b905c1d20>,24,18,[5 5],25,-1,43,-1,25
1,<environment.Job instance at 0x7f9b90a8e9b0>,26,17,[2 6],27,-1,44,-1,27
1,<environment.Job instance at 0x7f9b91415af0>,28,18,[5 3],29,-1,47,-1,29
1,<environment.Job instance at 0x7f9b91419fa0>,29,12,[4 6],30,-1,42,-1,30
1,<environment.Job instance at 0x7f9b91baf910>,31,13,[10  4],32,-1,45,-1,32
1,<environment.Job instance at 0x7f9b9091e460>,32,15,[8 4],33,-1,48,-1,33
1,<environment.Job instance at 0x7f9b905e5c80>,33,24,[5 3],34,-1,58,-1,34
1,<environment.Job instance at 0x7f9b9143b780>,34,15,[5 6],35,-1,50,-1,35
1,<environment.Job instance at 0x7f9b91bc9fa0>,36,17,[2 5],37,-1,54,-1,37
1,<environment.Job instance at 0x7f9b9090f5f0>,38,12,[9 3],39,-1,51,-1,39
1,<environment.Job instance at 0x7f9b90eb0910>,39,13,[6 4],40,-1,53,-1,40
1,<environment.Job instance at 0x7f9b91bd6730>,41,28,[9 4],42,-1,70,-1,42
1,<environment.Job instance at 0x7f9b90ee8550>,44,12,[9 1],45,-1,57,-1,45
1,<environment.Job instance at 0x7f9b90ee8500>,45,15,[3 9],46,-1,61,-1,46
1,<environment.Job instance at 0x7f9b91bd90f0>,22,18,[ 2 12],23,-1,64,-1,46
1,<environment.Job instance at 0x7f9b90ee83c0>,47,17,[1 9],48,-1,66,-1,49
1,<environment.Job instance at 0x7f9b90ecb280>,48,19,[ 3 11],49,-1,68,-1,49
1,<environment.Job instance at 0x7f9b90ecb1e0>,49,18,[7 5],50,-1,68,-1,50
1,<environment.Job instance at 0x7f9b90ecb5a0>,50,17,[10  1],51,-1,69,-1,52
1,<environment.Job instance at 0x7f9b90ec3410>,52,13,[7 2],53,-1,66,-1,53
1,<environment.Job instance at 0x7f9b90ecb7d0>,51,14,[5 8],52,-1,68,-1,54
1,<environment.Job instance at 0x7f9b90ec3cd0>,56,21,[5 5],57,-1,78,-1,57
1,<environment.Job instance at 0x7f9b90ec3c30>,58,13,[4 6],59,-1,72,-1,59
1,<environment.Job instance at 0x7f9b90ee8730>,7,25,[9 4],8,-1,42,-1,17
1,<environment.Job instance at 0x7f9b912c1a50>,19,28,[6 1],20,-1,76,-1,48
1,<environment.Job instance at 0x7f9b912c19b0>,22,18,[ 2 12],23,-1,68,-1,50
1,<environment.Job instance at 0x7f9b905b1870>,33,24,[5 3],34,-1,127,-1,103
1,<environment.Job instance at 0x7f9b905b1320>,37,2,[11  4],38,-1,109,-1,107
1,<environment.Job instance at 0x7f9b905b1230>,41,28,[9 4],42,-1,163,-1,135
1,<environment.Job instance at 0x7f9b91b4bc80>,43,16,[ 1 12],44,-1,151,-1,135
1,<environment.Job instance at 0x7f9b91bdde60>,48,19,[ 3 11],49,-1,168,-1,149
1,<environment.Job instance at 0x7f9b9049e730>,4,16,[7 4],5,-1,21,-1,5
1,<environment.Job instance at 0x7f9b9049efa0>,8,17,[9 5],9,-1,26,-1,9
1,<environment.Job instance at 0x7f9b9049ec30>,11,18,[4 7],12,-1,30,-1,12
1,<environment.Job instance at 0x7f9b9049ee60>,13,17,[9 1],14,-1,31,-1,14
1,<environment.Job instance at 0x7f9b9049e230>,14,22,[4 9],15,-1,37,-1,15
1,<environment.Job instance at 0x7f9b9049e690>,16,21,[5 5],17,-1,38,-1,17
1,<environment.Job instance at 0x7f9b9049e550>,19,15,[3 9],20,-1,35,-1,20
1,<environment.Job instance at 0x7f9b91bb9a50>,22,12,[ 1 10],23,-1,35,-1,23
1,<environment.Job instance at 0x7f9b91bb9780>,24,15,[10  2],25,-1,41,-1,26
1,<environment.Job instance at 0x7f9b91bb9dc0>,27,15,[6 2],28,-1,43,-1,28
1,<environment.Job instance at 0x7f9b91bb9e60>,32,20,[ 5 10],33,-1,53,-1,33
1,<environment.Job instance at 0x7f9b91bb9a00>,25,25,[1 6],26,-1,59,-1,34
1,<environment.Job instance at 0x7f9b913a1be0>,35,24,[8 3],36,-1,60,-1,36
1,<environment.Job instance at 0x7f9b913a19b0>,36,14,[6 4],37,-1,51,-1,37
1,<environment.Job instance at 0x7f9b913a1d70>,38,2,[6 3],39,-1,41,-1,39
1,<environment.Job instance at 0x7f9b913a1e60>,39,2,[1 9],40,-1,42,-1,40
1,<environment.Job instance at 0x7f9b913a12d0>,40,12,[5 6],41,-1,53,-1,41
1,<environment.Job instance at 0x7f9b913a1230>,41,16,[3 9],42,-1,58,-1,42
1,<environment.Job instance at 0x7f9b913a1f50>,44,13,[2 7],45,-1,58,-1,45
1,<environment.Job instance at 0x7f9b913a15f0>,45,17,[10  3],46,-1,63,-1,46
1,<environment.Job instance at 0x7f9b913a1820>,46,18,[6 4],47,-1,65,-1,47
1,<environment.Job instance at 0x7f9b913a1cd0>,47,24,[5 9],48,-1,72,-1,48
1,<environment.Job instance at 0x7f9b913a1870>,48,14,[6 4],49,-1,63,-1,49
1,<environment.Job instance at 0x7f9b913a10a0>,52,14,[ 4 10],53,-1,70,-1,56
1,<environment.Job instance at 0x7f9b913b5410>,56,12,[8 4],57,-1,69,-1,57
1,<environment.Job instance at 0x7f9b913b5370>,57,16,[1 8],58,-1,74,-1,58
1,<environment.Job instance at 0x7f9b913b5050>,55,16,[7 3],56,-1,76,-1,60
1,<environment.Job instance at 0x7f9b91bb9c80>,7,13,[14  4],8,-1,21,-1,8
1,<environment.Job instance at 0x7f9b9a4e2730>,23,2,[13  2],24,-1,55,-1,53
1,<environment.Job instance at 0x7f9b90eb01e0>,25,25,[1 6],26,-1,90,-1,65
1,<environment.Job instance at 0x7f9b90ebed20>,30,27,[11  2],31,-1,110,-1,83
1,<environment.Job instance at 0x7f9b913b5fa0>,35,24,[8 3],36,-1,114,-1,90
1,<environment.Job instance at 0x7f9b90e1faf0>,47,24,[5 9],48,-1,157,-1,133
1,<environment.Job instance at 0x7f9b90e1f4b0>,51,28,[3 6],52,-1,166,-1,138
1,<environment.Job instance at 0x7f9b90e08a00>,0,20,[9 3],1,-1,22,-1,2
1,<environment.Job instance at 0x7f9b915bd190>,2,14,[9 2],3,-1,17,-1,3
1,<environment.Job instance at 0x7f9b902f3820>,1,15,[8 4],2,-1,18,-1,3
1,<environment.Job instance at 0x7f9b915bd6e0>,8,26,[8 2],9,-1,35,-1,9
1,<environment.Job instance at 0x7f9b915bd870>,10,13,[4 6],11,-1,24,-1,11
1,<environment.Job instance at 0x7f9b915bd9b0>,12,16,[9 2],13,-1,29,-1,13
1,<environment.Job instance at 0x7f9b915bdaf0>,13,18,[4 6],14,-1,32,-1,14
1,<environment.Job instance at 0x7f9b915bdb90>,14,13,[2 8],15,-1,29,-1,16
1,<environment.Job instance at 0x7f9b915bd8c0>,16,17,[3 7],17,-1,34,-1,17
1,<environment.Job instance at 0x7f9b915bdd20>,17,12,[1 6],18,-1,30,-1,18
1,<environment.Job instance at 0x7f9b915bddc0>,18,3,[10  2],19,-1,22,-1,19
1,<environment.Job instance at 0x7f9b915bde60>,19,17,[5 7],20,-1,37,-1,20
1,<environment.Job instance at 0x7f9b915bdfa0>,21,3,[ 4 13],22,-1,25,-1,22
1,<environment.Job instance at 0x7f9b915be190>,22,18,[7 4],23,-1,41,-1,23
1,<environment.Job instance at 0x7f9b915be0a0>,23,14,[ 2 10],24,-1,38,-1,24
1,<environment.Job instance at 0x7f9b915be640>,29,15,[3 9],30,-1,45,-1,30
1,<environment.Job instance at 0x7f9b915bdc30>,15,25,[ 3 14],16,-1,56,-1,31
1,<environment.Job instance at 0x7f9b915be8c0>,33,16,[3 8],34,-1,50,-1,34
1,<environment.Job instance at 0x7f9b915bec80>,34,13,[10  5],35,-1,48,-1,35
1,<environment.Job instance at 0x7f9b915beaa0>,35,19,[1 5],36,-1,55,-1,36
1,<environment.Job instance at 0x7f9b915beb40>,38,16,[3 8],39,-1,55,-1,39
1,<environment.Job instance at 0x7f9b915be460>,32,14,[ 2 10],33,-1,54,-1,40
1,<environment.Job instance at 0x7f9b9158c2d0>,40,18,[9 2],41,-1,61,-1,43
1,<environment.Job instance at 0x7f9b9158c1e0>,42,17,[9 4],43,-1,60,-1,43
1,<environment.Job instance at 0x7f9b9158c500>,43,3,[3 9],44,-1,47,-1,44
1,<environment.Job instance at 0x7f9b9158c3c0>,44,27,[6 1],45,-1,72,-1,45
1,<environment.Job instance at 0x7f9b9158c5a0>,45,14,[4 8],46,-1,60,-1,46
1,<environment.Job instance at 0x7f9b9158c640>,46,17,[ 5 11],47,-1,64,-1,47
1,<environment.Job instance at 0x7f9b915bd0a0>,7,1,[ 1 13],8,-1,21,-1,20
1,<environment.Job instance at 0x7f9b915bd050>,8,26,[8 2],9,-1,47,-1,21
1,<environment.Job instance at 0x7f9b90e1fbe0>,15,25,[ 3 14],16,-1,59,-1,34
1,<environment.Job instance at 0x7f9b90e1f0f0>,21,3,[ 4 13],22,-1,57,-1,54
1,<environment.Job instance at 0x7f9b913b5780>,24,27,[13  3],25,-1,91,-1,64
1,<environment.Job instance at 0x7f9b90919fa0>,44,27,[6 1],45,-1,181,-1,154
1,<environment.Job instance at 0x7f9b90919640>,46,17,[ 5 11],47,-1,171,-1,154
1,<environment.Job instance at 0x7f9b90df2960>,51,24,[14  3],52,-1,193,-1,169
1,<environment.Job instance at 0x7f9b91bdd8c0>,53,24,[10  2],54,-1,209,-1,185
1,<environment.Job instance at 0x7f69543e46e0>,0,18,[ 2 10],1,-1,20,-1,2
1,<environment.Job instance at 0x7f694adf4a50>,3,18,[ 3 10],4,-1,22,-1,4
1,<environment.Job instance at 0x7f694adf4be0>,4,18,[10  4],5,-1,23,-1,5
1,<environment.Job instance at 0x7f694adf4af0>,5,13,[5 9],6,-1,19,-1,6
1,<environment.Job instance at 0x7f694adf4c80>,6,12,[11  4],7,-1,19,-1,7
1,<environment.Job instance at 0x7f694adf4dc0>,8,17,[ 2 10],9,-1,26,-1,9
1,<environment.Job instance at 0x7f694adf4f00>,9,17,[ 4 10],10,-1,27,-1,10
1,<environment.Job instance at 0x7f694adf75a0>,16,12,[1 8],17,-1,29,-1,17
1,<environment.Job instance at 0x7f69543e48c0>,1,15,[ 1 14],2,-1,33,-1,18
1,<environment.Job instance at 0x7f69543e4730>,18,16,[8 5],19,-1,35,-1,19
1,<environment.Job instance at 0x7f694adf7cd0>,25,3,[1 6],26,-1,29,-1,26
1,<environment.Job instance at 0x7f694adf7eb0>,26,22,[2 9],27,-1,49,-1,27
1,<environment.Job instance at 0x7f694adfa140>,29,13,[1 6],30,-1,43,-1,30
1,<environment.Job instance at 0x7f694adfa1e0>,31,17,[4 9],32,-1,49,-1,32
1,<environment.Job instance at 0x7f694adfa3c0>,32,17,[9 3],33,-1,50,-1,33
1,<environment.Job instance at 0x7f694adf7c30>,24,3,[5 9],25,-1,38,-1,35
1,<environment.Job instance at 0x7f694adfa7d0>,37,14,[5 5],38,-1,52,-1,38
1,<environment.Job instance at 0x7f694adfaa00>,39,18,[5 8],40,-1,58,-1,40
1,<environment.Job instance at 0x7f694adfab90>,41,14,[6 1],42,-1,57,-1,43
1,<environment.Job instance at 0x7f694adfaf00>,43,28,[6 4],44,-1,72,-1,44
1,<environment.Job instance at 0x7f694adfafa0>,44,17,[ 5 12],45,-1,62,-1,45
1,<environment.Job instance at 0x7f694adfadc0>,42,14,[8 4],43,-1,59,-1,45
1,<environment.Job instance at 0x7f694adfca00>,54,14,[1 7],55,-1,69,-1,55
1,<environment.Job instance at 0x7f694adfcaf0>,55,17,[4 7],56,-1,73,-1,56
1,<environment.Job instance at 0x7f694adfc910>,56,18,[4 5],57,-1,75,-1,57
1,<environment.Job instance at 0x7f694adfce10>,59,14,[ 2 10],60,-1,74,-1,60
1,<environment.Job instance at 0x7f694ae000a0>,62,20,[9 1],63,-1,83,-1,63
1,<environment.Job instance at 0x7f694ae005f0>,67,26,[5 4],68,-1,94,-1,68
1,<environment.Job instance at 0x7f694ae007d0>,68,22,[5 6],69,-1,91,-1,69
1,<environment.Job instance at 0x7f694adf7370>,1,15,[ 1 14],2,-1,17,-1,2
1,<environment.Job instance at 0x7f694adfa4b0>,6,12,[11  4],7,-1,19,-1,7
1,<environment.Job instance at 0x7f694ae00d70>,19,17,[12  3],20,-1,67,-1,50
1,<environment.Job instance at 0x7f694ae00f00>,22,2,[12  3],23,-1,62,-1,60
1,<environment.Job instance at 0x7f694ae86730>,43,28,[6 4],44,-1,166,-1,138
1,<environment.Job instance at 0x7f694ae57910>,44,17,[ 5 12],45,-1,155,-1,138
1,<environment.Job instance at 0x7f694ae855f0>,50,27,[9 1],51,-1,179,-1,152
1,<environment.Job instance at 0x7f694af545f0>,52,3,[ 3 11],53,-1,155,-1,152
1,<environment.Job instance at 0x7f694ae9e1e0>,53,18,[ 4 12],54,-1,170,-1,152
1,<environment.Job instance at 0x7f694ae877d0>,60,24,[ 3 10],61,-1,209,-1,185
1,<environment.Job instance at 0x7f694af17230>,67,26,[5 4],68,-1,226,-1,200
1,<environment.Job instance at 0x7f694a537460>,0,18,[5 5],1,-1,19,-1,1
1,<environment.Job instance at 0x7f694a519370>,2,14,[9 1],3,-1,22,-1,8
1,<environment.Job instance at 0x7f694a53d870>,8,19,[8 4],9,-1,28,-1,9
1,<environment.Job instance at 0x7f694a53d230>,9,17,[2 7],10,-1,27,-1,10
1,<environment.Job instance at 0x7f694a53d7d0>,7,15,[4 7],8,-1,29,-1,14
1,<environment.Job instance at 0x7f694a531780>,21,16,[5 8],22,-1,47,-1,31
1,<environment.Job instance at 0x7f694a584640>,33,17,[5 6],34,-1,51,-1,34
1,<environment.Job instance at 0x7f694a3a7050>,34,17,[5 4],35,-1,52,-1,35
1,<environment.Job instance at 0x7f694a5318c0>,25,23,[3 7],26,-1,85,-1,62
1,<environment.Job instance at 0x7f694a536140>,30,18,[7 5],31,-1,82,-1,64
1,<environment.Job instance at 0x7f694a487b90>,46,15,[9 2],47,-1,79,-1,64
1,<environment.Job instance at 0x7f694a3dce10>,51,18,[11  5],52,-1,84,-1,66
1,<environment.Job instance at 0x7f694a4fceb0>,49,16,[1 8],50,-1,82,-1,66
1,<environment.Job instance at 0x7f694a5e0370>,11,17,[ 4 14],12,-1,35,-1,18
1,<environment.Job instance at 0x7f694a5937d0>,15,19,[14  4],16,-1,42,-1,23
1,<environment.Job instance at 0x7f694a6076e0>,25,23,[3 7],26,-1,72,-1,49
1,<environment.Job instance at 0x7f694a5961e0>,32,27,[ 3 13],33,-1,82,-1,55
1,<environment.Job instance at 0x7f694a5b21e0>,41,18,[ 3 13],42,-1,101,-1,83
1,<environment.Job instance at 0x7f694a59ac80>,47,18,[ 3 12],48,-1,119,-1,101
1,<environment.Job instance at 0x7f694a5b8910>,51,18,[11  5],52,-1,123,-1,105
1,<environment.Job instance at 0x7f694a5b8280>,52,14,[14  1],53,-1,119,-1,105
1,<environment.Job instance at 0x7f694a5af8c0>,65,15,[ 3 14],66,-1,175,-1,160
1,<environment.Job instance at 0x7f694a58f8c0>,67,12,[14  5],68,-1,172,-1,160
1,<environment.Job instance at 0x7f694a39dc30>,0,17,[3 8],1,-1,18,-1,1
1,<environment.Job instance at 0x7f694a39ddc0>,5,15,[6 2],6,-1,21,-1,6
1,<environment.Job instance at 0x7f694a39db90>,10,13,[2 6],11,-1,24,-1,11
1,<environment.Job instance at 0x7f694a3f0e10>,11,16,[1 9],12,-1,28,-1,12
1,<environment.Job instance at 0x7f694a3f0780>,12,16,[6 2],13,-1,29,-1,13
1,<environment.Job instance at 0x7f694a3f0a50>,15,14,[3 8],16,-1,30,-1,16
1,<environment.Job instance at 0x7f694a3f05f0>,17,17,[3 8],18,-1,35,-1,18
1,<environment.Job instance at 0x7f694a3f00a0>,18,16,[3 9],19,-1,35,-1,19
1,<environment.Job instance at 0x7f694a3eee10>,20,12,[6 3],21,-1,33,-1,21
1,<environment.Job instance at 0x7f694a3eeaf0>,23,15,[4 8],24,-1,39,-1,24
1,<environment.Job instance at 0x7f694a3ee0f0>,24,13,[1 9],25,-1,38,-1,25
1,<environment.Job instance at 0x7f694a3f1690>,27,18,[5 2],28,-1,47,-1,29
1,<environment.Job instance at 0x7f694a3f15a0>,29,16,[3 5],30,-1,46,-1,30
1,<environment.Job instance at 0x7f694a3f1910>,31,14,[5 3],32,-1,46,-1,32
1,<environment.Job instance at 0x7f694a3f1e60>,33,12,[1 7],34,-1,46,-1,34
1,<environment.Job instance at 0x7f694a3f1870>,28,18,[4 6],29,-1,52,-1,34
1,<environment.Job instance at 0x7f694a3f1c30>,37,13,[ 4 10],38,-1,51,-1,38
1,<environment.Job instance at 0x7f694a427eb0>,39,23,[2 8],40,-1,63,-1,40
1,<environment.Job instance at 0x7f694a4289b0>,44,12,[5 7],45,-1,57,-1,45
1,<environment.Job instance at 0x7f694a428fa0>,45,17,[10  5],46,-1,63,-1,46
1,<environment.Job instance at 0x7f694a428960>,46,26,[9 1],47,-1,73,-1,47
1,<environment.Job instance at 0x7f694a424d70>,48,14,[8 5],49,-1,63,-1,49
1,<environment.Job instance at 0x7f694a424280>,49,17,[9 2],50,-1,67,-1,50
1,<environment.Job instance at 0x7f694a424b90>,52,14,[8 4],53,-1,67,-1,53
1,<environment.Job instance at 0x7f694a424e10>,54,17,[10  5],55,-1,72,-1,55
1,<environment.Job instance at 0x7f694a4240a0>,55,16,[ 3 10],56,-1,72,-1,56
1,<environment.Job instance at 0x7f694a424fa0>,56,23,[5 8],57,-1,80,-1,57
1,<environment.Job instance at 0x7f694a3e7b40>,62,14,[9 2],63,-1,77,-1,63
1,<environment.Job instance at 0x7f694a3e7c30>,63,27,[5 3],64,-1,91,-1,64
1,<environment.Job instance at 0x7f694a3e7a00>,64,17,[10  2],65,-1,82,-1,65
1,<environment.Job instance at 0x7f694a3e7cd0>,65,17,[5 9],66,-1,83,-1,66
1,<environment.Job instance at 0x7f694a3e77d0>,68,22,[9 2],69,-1,91,-1,69
1,<environment.Job instance at 0x7f694a3e52d0>,26,22,[11  3],27,-1,97,-1,75
1,<environment.Job instance at 0x7f694a3e1140>,35,25,[3 9],36,-1,157,-1,132
1,<environment.Job instance at 0x7f694a3e18c0>,39,23,[2 8],40,-1,156,-1,133
1,<environment.Job instance at 0x7f694a3e1be0>,46,26,[9 1],47,-1,183,-1,157
1,<environment.Job instance at 0x7f694a3dc640>,56,23,[5 8],57,-1,221,-1,198
1,<environment.Job instance at 0x7f694a3dc190>,61,2,[12  1],62,-1,209,-1,207
1,<environment.Job instance at 0x7f694a3d9fa0>,63,27,[5 3],64,-1,246,-1,219
1,<environment.Job instance at 0x7f694aea2dc0>,0,17,[2 9],1,-1,19,-1,2
1,<environment.Job instance at 0x7f694aea2410>,2,17,[10  4],3,-1,20,-1,3
1,<environment.Job instance at 0x7f694add7910>,3,12,[5 1],4,-1,16,-1,4
1,<environment.Job instance at 0x7f694add7960>,4,13,[5 9],5,-1,18,-1,5
1,<environment.Job instance at 0x7f694add7e60>,5,17,[8 1],6,-1,23,-1,6
1,<environment.Job instance at 0x7f694a4fceb0>,1,18,[ 5 11],2,-1,24,-1,6
1,<environment.Job instance at 0x7f694add7c80>,7,18,[ 1 10],8,-1,28,-1,10
1,<environment.Job instance at 0x7f694add7460>,8,28,[7 4],9,-1,38,-1,10
1,<environment.Job instance at 0x7f694aeba370>,15,17,[3 5],16,-1,34,-1,17
1,<environment.Job instance at 0x7f694add73c0>,16,15,[ 5 10],17,-1,32,-1,17
1,<environment.Job instance at 0x7f694aebaa00>,18,16,[14  3],19,-1,35,-1,19
1,<environment.Job instance at 0x7f694aebaaf0>,20,15,[7 4],21,-1,36,-1,21
1,<environment.Job instance at 0x7f694aebaa50>,21,13,[3 6],22,-1,35,-1,22
1,<environment.Job instance at 0x7f694aeba780>,22,16,[8 5],23,-1,39,-1,23
1,<environment.Job instance at 0x7f694aeba5f0>,23,12,[3 8],24,-1,36,-1,24
1,<environment.Job instance at 0x7f694aeba820>,24,14,[8 5],25,-1,39,-1,25
1,<environment.Job instance at 0x7f694aebac80>,19,12,[5 4],20,-1,39,-1,27
1,<environment.Job instance at 0x7f694af213c0>,28,18,[3 8],29,-1,47,-1,29
1,<environment.Job instance at 0x7f694af21190>,29,16,[9 4],30,-1,46,-1,30
1,<environment.Job instance at 0x7f694af210f0>,30,28,[7 3],31,-1,59,-1,31
1,<environment.Job instance at 0x7f694af21aa0>,31,16,[7 4],32,-1,49,-1,33
1,<environment.Job instance at 0x7f694af21e60>,33,18,[1 6],34,-1,52,-1,34
1,<environment.Job instance at 0x7f694af21a50>,34,15,[9 5],35,-1,50,-1,35
1,<environment.Job instance at 0x7f694af21c30>,36,17,[2 6],37,-1,54,-1,37
1,<environment.Job instance at 0x7f694af21550>,37,16,[2 8],38,-1,54,-1,38
1,<environment.Job instance at 0x7f694aeb1550>,53,21,[9 5],54,-1,76,-1,55
1,<environment.Job instance at 0x7f694af3e690>,44,17,[1 9],45,-1,76,-1,59
1,<environment.Job instance at 0x7f694aeb1320>,58,21,[5 1],59,-1,84,-1,63
1,<environment.Job instance at 0x7f694aea9730>,61,18,[ 5 14],62,-1,83,-1,65
1,<environment.Job instance at 0x7f694aeb1eb0>,51,19,[ 3 14],52,-1,84,-1,65
1,<environment.Job instance at 0x7f694aea98c0>,62,17,[8 2],63,-1,84,-1,67
1,<environment.Job instance at 0x7f694aeba910>,1,18,[ 5 11],2,-1,20,-1,2
1,<environment.Job instance at 0x7f694af3e730>,8,28,[7 4],9,-1,48,-1,20
1,<environment.Job instance at 0x7f694aea2d20>,14,28,[9 1],15,-1,66,-1,38
1,<environment.Job instance at 0x7f694a3e7280>,18,16,[14  3],19,-1,55,-1,39
1,<environment.Job instance at 0x7f694aeb6690>,30,28,[7 3],31,-1,139,-1,111
1,<environment.Job instance at 0x7f695440cbe0>,48,12,[12  2],49,-1,199,-1,187
1,<environment.Job instance at 0x7f695440c0f0>,51,19,[ 3 14],52,-1,208,-1,189
1,<environment.Job instance at 0x7f695440ce60>,52,2,[14  5],53,-1,191,-1,189
1,<environment.Job instance at 0x7f695440ccd0>,55,12,[12  4],56,-1,203,-1,191
1,<environment.Job instance at 0x7f695440cc30>,61,18,[ 5 14],62,-1,229,-1,211
1,<environment.Job instance at 0x7f694b1e9460>,68,1,[ 5 14],69,-1,232,-1,231
1,<environment.Job instance at 0x7f694ac77410>,9,14,[5 7],10,-1,24,-1,10
1,<environment.Job instance at 0x7f694ac77d20>,13,18,[9 2],14,-1,32,-1,14
1,<environment.Job instance at 0x7f694ac77640>,14,18,[ 5 10],15,-1,33,-1,15
1,<environment.Job instance at 0x7f694ac800a0>,16,16,[5 7],17,-1,33,-1,17
1,<environment.Job instance at 0x7f694b91f5a0>,18,15,[2 5],19,-1,34,-1,19
1,<environment.Job instance at 0x7f694ac80870>,19,15,[7 4],20,-1,35,-1,20
1,<environment.Job instance at 0x7f694ac7c370>,20,17,[4 5],21,-1,38,-1,21
1,<environment.Job instance at 0x7f694b242e10>,25,18,[9 5],26,-1,44,-1,26
1,<environment.Job instance at 0x7f694b242b90>,27,17,[7 5],28,-1,45,-1,28
1,<environment.Job instance at 0x7f694b939050>,30,14,[2 8],31,-1,45,-1,31
1,<environment.Job instance at 0x7f694b9015a0>,31,15,[10  3],32,-1,47,-1,32
1,<environment.Job instance at 0x7f694aa232d0>,34,16,[8 3],35,-1,51,-1,35
1,<environment.Job instance at 0x7f694aa368c0>,40,14,[ 3 10],41,-1,55,-1,41
1,<environment.Job instance at 0x7f694aa11190>,43,15,[7 4],44,-1,59,-1,44
1,<environment.Job instance at 0x7f694aa29640>,46,15,[6 2],47,-1,63,-1,48
1,<environment.Job instance at 0x7f694aa29b40>,50,13,[ 4 10],51,-1,64,-1,51
1,<environment.Job instance at 0x7f694aa29e10>,51,16,[2 8],52,-1,68,-1,52
1,<environment.Job instance at 0x7f694abcb1e0>,58,14,[10  4],59,-1,73,-1,59
1,<environment.Job instance at 0x7f694abcb3c0>,59,16,[1 7],60,-1,76,-1,60
1,<environment.Job instance at 0x7f694ac801e0>,3,3,[14  5],4,-1,7,-1,4
1,<environment.Job instance at 0x7f694aa36550>,8,17,[12  1],9,-1,26,-1,9
1,<environment.Job instance at 0x7f694aa292d0>,12,1,[13  3],13,-1,14,-1,13
1,<environment.Job instance at 0x7f695440c5f0>,22,27,[ 2 13],23,-1,65,-1,38
1,<environment.Job instance at 0x7f695440c960>,28,1,[12  5],29,-1,60,-1,59
1,<environment.Job instance at 0x7f694b51c190>,41,18,[ 4 13],42,-1,128,-1,110
1,<environment.Job instance at 0x7f694a8ce3c0>,47,16,[ 5 13],48,-1,143,-1,127
1,<environment.Job instance at 0x7f694aeb6140>,54,18,[13  2],55,-1,173,-1,155
1,<environment.Job instance at 0x7f694a3e7320>,60,18,[11  4],61,-1,186,-1,168
1,<environment.Job instance at 0x7f694b91f730>,5,16,[2 6],6,-1,22,-1,6
1,<environment.Job instance at 0x7f694b91f190>,6,15,[10  5],7,-1,22,-1,7
1,<environment.Job instance at 0x7f694b91f910>,7,16,[ 3 10],8,-1,24,-1,8
1,<environment.Job instance at 0x7f694b91f820>,8,16,[3 6],9,-1,25,-1,9
1,<environment.Job instance at 0x7f694b91f050>,9,22,[1 6],10,-1,32,-1,10
1,<environment.Job instance at 0x7f694b91ffa0>,11,25,[10  4],12,-1,37,-1,12
1,<environment.Job instance at 0x7f694b91f9b0>,14,22,[1 9],15,-1,37,-1,15
1,<environment.Job instance at 0x7f694b91f320>,15,12,[2 5],16,-1,28,-1,16
1,<environment.Job instance at 0x7f694b91f500>,17,13,[ 1 10],18,-1,31,-1,18
1,<environment.Job instance at 0x7f694b92fb90>,19,18,[ 2 10],20,-1,38,-1,20
1,<environment.Job instance at 0x7f694b92f9b0>,20,17,[7 1],21,-1,38,-1,21
1,<environment.Job instance at 0x7f694b92f820>,21,18,[3 8],22,-1,40,-1,22
1,<environment.Job instance at 0x7f694b92feb0>,23,24,[3 6],24,-1,48,-1,24
1,<environment.Job instance at 0x7f694b92f370>,25,20,[3 8],26,-1,46,-1,26
1,<environment.Job instance at 0x7f694b92f280>,26,15,[4 9],27,-1,42,-1,27
1,<environment.Job instance at 0x7f694b92faf0>,27,27,[9 5],28,-1,57,-1,30
1,<environment.Job instance at 0x7f694b92ff00>,30,18,[4 8],31,-1,49,-1,31
1,<environment.Job instance at 0x7f694b217550>,35,18,[ 3 10],36,-1,54,-1,36
1,<environment.Job instance at 0x7f694b2171e0>,36,21,[6 1],37,-1,58,-1,37
1,<environment.Job instance at 0x7f694b217d20>,37,13,[4 9],38,-1,51,-1,38
1,<environment.Job instance at 0x7f694b92fb40>,28,14,[3 6],29,-1,52,-1,38
1,<environment.Job instance at 0x7f694b217820>,42,17,[9 1],43,-1,60,-1,43
1,<environment.Job instance at 0x7f694b217690>,43,18,[8 1],44,-1,62,-1,44
1,<environment.Job instance at 0x7f694b217cd0>,45,27,[5 5],46,-1,73,-1,46
1,<environment.Job instance at 0x7f694b91ee60>,46,22,[2 8],47,-1,69,-1,47
1,<environment.Job instance at 0x7f694b91eb40>,47,20,[5 2],48,-1,68,-1,48
1,<environment.Job instance at 0x7f694b91ed20>,49,17,[2 6],50,-1,67,-1,50
1,<environment.Job instance at 0x7f694b91e2d0>,50,16,[1 9],51,-1,67,-1,51
1,<environment.Job instance at 0x7f694b91e960>,53,27,[7 5],54,-1,81,-1,54
1,<environment.Job instance at 0x7f694b91ebe0>,59,17,[5 1],60,-1,77,-1,60
1,<environment.Job instance at 0x7f694a881730>,61,18,[5 7],62,-1,80,-1,62
1,<environment.Job instance at 0x7f694a881b90>,62,13,[8 1],63,-1,76,-1,63
1,<environment.Job instance at 0x7f694a8811e0>,63,16,[3 5],64,-1,80,-1,64
1,<environment.Job instance at 0x7f694a881280>,65,25,[3 7],66,-1,91,-1,66
1,<environment.Job instance at 0x7f694a8810a0>,67,14,[10  3],68,-1,82,-1,68
1,<environment.Job instance at 0x7f694a8810f0>,68,13,[8 2],69,-1,82,-1,69
1,<environment.Job instance at 0x7f694b901cd0>,11,25,[10  4],12,-1,48,-1,23
1,<environment.Job instance at 0x7f694abe0eb0>,23,24,[3 6],24,-1,87,-1,63
1,<environment.Job instance at 0x7f694aa23230>,27,27,[9 5],28,-1,106,-1,79
1,<environment.Job instance at 0x7f694ac74690>,33,2,[ 3 14],34,-1,87,-1,85
1,<environment.Job instance at 0x7f694a881f00>,44,3,[ 3 12],45,-1,135,-1,132
1,<environment.Job instance at 0x7f694b250b40>,45,27,[5 5],46,-1,165,-1,138
1,<environment.Job instance at 0x7f694b2502d0>,48,13,[14  4],49,-1,152,-1,139
1,<environment.Job instance at 0x7f694b2505f0>,53,27,[7 5],54,-1,194,-1,167
1,<environment.Job instance at 0x7f694b250730>,54,13,[14  5],55,-1,180,-1,167
1,<environment.Job instance at 0x7f694b21deb0>,65,25,[3 7],66,-1,234,-1,209
1,<environment.Job instance at 0x7f694a546230>,5,16,[10  5],6,-1,23,-1,7
1,<environment.Job instance at 0x7f694a546a50>,7,14,[9 1],8,-1,22,-1,8
1,<environment.Job instance at 0x7f694a689500>,8,21,[9 5],9,-1,30,-1,9
1,<environment.Job instance at 0x7f694a547370>,10,17,[9 4],11,-1,28,-1,11
1,<environment.Job instance at 0x7f694a5478c0>,15,15,[5 7],16,-1,31,-1,16
1,<environment.Job instance at 0x7f694a547dc0>,17,16,[2 6],18,-1,34,-1,18
1,<environment.Job instance at 0x7f694a72caf0>,23,17,[1 8],24,-1,41,-1,24
1,<environment.Job instance at 0x7f694a52b140>,25,24,[3 9],26,-1,50,-1,26
1,<environment.Job instance at 0x7f694a716af0>,26,17,[9 1],27,-1,44,-1,27
1,<environment.Job instance at 0x7f694a51caa0>,29,16,[1 8],30,-1,46,-1,30
1,<environment.Job instance at 0x7f694b288a50>,32,17,[10  3],33,-1,50,-1,33
1,<environment.Job instance at 0x7f694b292640>,33,13,[9 5],34,-1,47,-1,34
1,<environment.Job instance at 0x7f694ac22550>,34,15,[ 1 10],35,-1,50,-1,35
1,<environment.Job instance at 0x7f694a52a640>,42,27,[5 5],43,-1,70,-1,43
1,<environment.Job instance at 0x7f694a52aa50>,44,25,[1 7],45,-1,70,-1,45
1,<environment.Job instance at 0x7f694b2820f0>,46,15,[ 5 10],47,-1,62,-1,47
1,<environment.Job instance at 0x7f694b282d20>,51,14,[1 9],52,-1,66,-1,52
1,<environment.Job instance at 0x7f694b282eb0>,52,12,[4 9],53,-1,65,-1,53
1,<environment.Job instance at 0x7f694b2825f0>,53,18,[4 8],54,-1,72,-1,54
1,<environment.Job instance at 0x7f694b282fa0>,54,17,[7 4],55,-1,72,-1,55
1,<environment.Job instance at 0x7f694b282dc0>,55,14,[7 3],56,-1,70,-1,56
1,<environment.Job instance at 0x7f694b1e24b0>,56,27,[5 8],57,-1,84,-1,57
1,<environment.Job instance at 0x7f694b1e2b40>,58,12,[5 6],59,-1,71,-1,59
1,<environment.Job instance at 0x7f694b1e2cd0>,61,24,[4 8],62,-1,86,-1,62
1,<environment.Job instance at 0x7f694b220370>,65,19,[7 5],66,-1,85,-1,66
1,<environment.Job instance at 0x7f694b220500>,66,14,[8 1],67,-1,81,-1,67
1,<environment.Job instance at 0x7f694a547550>,0,1,[ 4 12],1,-1,2,-1,1
1,<environment.Job instance at 0x7f694adae550>,4,12,[13  3],5,-1,17,-1,5
1,<environment.Job instance at 0x7f694a7165f0>,9,3,[12  1],10,-1,13,-1,10
1,<environment.Job instance at 0x7f694aac9460>,19,16,[ 5 13],20,-1,53,-1,37
1,<environment.Job instance at 0x7f69541c9500>,24,14,[ 3 14],25,-1,67,-1,53
1,<environment.Job instance at 0x7f69543e42d0>,25,24,[3 9],26,-1,79,-1,55
1,<environment.Job instance at 0x7f694aa23230>,35,1,[12  4],36,-1,91,-1,90
1,<environment.Job instance at 0x7f694ab4ed20>,41,15,[14  1],42,-1,115,-1,100
1,<environment.Job instance at 0x7f694a730190>,42,27,[5 5],43,-1,128,-1,101
1,<environment.Job instance at 0x7f694b92fd20>,44,25,[1 7],45,-1,138,-1,113
1,<environment.Job instance at 0x7f694aacfd70>,56,27,[5 8],57,-1,198,-1,171
1,<environment.Job instance at 0x7f694aa2c820>,61,24,[4 8],62,-1,209,-1,185
1,<environment.Job instance at 0x7f694a881b90>,0,14,[ 4 10],1,-1,15,-1,1
1,<environment.Job instance at 0x7f694aae2460>,6,18,[8 2],7,-1,25,-1,7
1,<environment.Job instance at 0x7f694aae2500>,7,18,[6 2],8,-1,26,-1,8
1,<environment.Job instance at 0x7f694aae2fa0>,9,18,[5 8],10,-1,28,-1,10
1,<environment.Job instance at 0x7f694aae2e10>,10,19,[2 7],11,-1,30,-1,11
1,<environment.Job instance at 0x7f694aae2eb0>,11,24,[1 9],12,-1,36,-1,12
1,<environment.Job instance at 0x7f694aae2410>,13,15,[6 5],14,-1,29,-1,14
1,<environment.Job instance at 0x7f694adcb2d0>,16,14,[7 5],17,-1,31,-1,17
1,<environment.Job instance at 0x7f694adcb230>,17,23,[10  4],18,-1,41,-1,18
1,<environment.Job instance at 0x7f694adcb460>,21,17,[5 7],22,-1,39,-1,22
1,<environment.Job instance at 0x7f694adcb910>,24,13,[1 9],25,-1,38,-1,25
1,<environment.Job instance at 0x7f694adcb780>,25,16,[4 5],26,-1,42,-1,26
1,<environment.Job instance at 0x7f694b0bfa50>,29,17,[ 5 10],30,-1,47,-1,30
1,<environment.Job instance at 0x7f694b0bfe60>,30,18,[4 6],31,-1,49,-1,31
1,<environment.Job instance at 0x7f694b0bfdc0>,34,15,[5 7],35,-1,50,-1,35
1,<environment.Job instance at 0x7f694b0bfc30>,36,14,[ 5 10],37,-1,52,-1,38
1,<environment.Job instance at 0x7f694b0bfeb0>,38,19,[1 6],39,-1,58,-1,39
1,<environment.Job instance at 0x7f694b0bf410>,43,20,[5 7],44,-1,64,-1,44
1,<environment.Job instance at 0x7f69543e4280>,46,27,[4 5],47,-1,80,-1,53
1,<environment.Job instance at 0x7f69543e48c0>,47,12,[5 5],48,-1,69,-1,57
1,<environment.Job instance at 0x7f69543e49b0>,54,12,[4 7],55,-1,69,-1,57
1,<environment.Job instance at 0x7f694b0bf190>,35,24,[10  2],36,-1,81,-1,57
1,<environment.Job instance at 0x7f69543e4960>,49,12,[9 1],50,-1,69,-1,57
1,<environment.Job instance at 0x7f69543e4a00>,50,14,[8 4],51,-1,72,-1,58
1,<environment.Job instance at 0x7f694b289550>,56,14,[10  4],57,-1,75,-1,61
1,<environment.Job instance at 0x7f694b2894b0>,61,15,[ 2 14],62,-1,90,-1,75
1,<environment.Job instance at 0x7f694a4d0550>,68,14,[6 4],69,-1,90,-1,76
1,<environment.Job instance at 0x7f694adcbb40>,1,1,[11  1],2,-1,3,-1,2
1,<environment.Job instance at 0x7f694b65e3c0>,11,24,[1 9],12,-1,44,-1,20
1,<environment.Job instance at 0x7f694aae29b0>,17,23,[10  4],18,-1,61,-1,38
1,<environment.Job instance at 0x7f694a52aa50>,23,3,[ 5 13],24,-1,55,-1,52
1,<environment.Job instance at 0x7f694b8ae320>,26,17,[13  2],27,-1,83,-1,66
1,<environment.Job instance at 0x7f694a52b960>,27,1,[11  4],28,-1,67,-1,66
1,<environment.Job instance at 0x7f694a547550>,32,17,[ 2 12],33,-1,101,-1,84
1,<environment.Job instance at 0x7f694a4d0410>,35,24,[10  2],36,-1,123,-1,99
1,<environment.Job instance at 0x7f694a4d0960>,39,27,[14  1],40,-1,143,-1,116
1,<environment.Job instance at 0x7f694a4d0fa0>,42,2,[11  4],43,-1,119,-1,117
1,<environment.Job instance at 0x7f694a4d02d0>,45,12,[11  5],46,-1,141,-1,129
1,<environment.Job instance at 0x7f694a4d0a50>,46,27,[4 5],47,-1,157,-1,130
1,<environment.Job instance at 0x7f694ab639b0>,52,3,[11  3],53,-1,157,-1,154
1,<environment.Job instance at 0x7f694ab63a00>,61,15,[ 2 14],62,-1,195,-1,180
1,<environment.Job instance at 0x7f694ab63b90>,65,12,[ 3 13],66,-1,202,-1,190
1,<environment.Job instance at 0x7f694a9e16e0>,0,18,[5 9],1,-1,19,-1,1
1,<environment.Job instance at 0x7f694a9e18c0>,3,18,[ 1 10],4,-1,22,-1,4
1,<environment.Job instance at 0x7f694a253e10>,9,14,[9 5],10,-1,24,-1,10
1,<environment.Job instance at 0x7f694a2539b0>,15,17,[ 5 10],16,-1,34,-1,17
1,<environment.Job instance at 0x7f694a253d20>,18,16,[9 2],19,-1,35,-1,19
1,<environment.Job instance at 0x7f694a253c30>,19,28,[1 8],20,-1,48,-1,20
1,<environment.Job instance at 0x7f694a253550>,21,13,[1 9],22,-1,35,-1,22
1,<environment.Job instance at 0x7f694a183be0>,26,14,[9 2],27,-1,41,-1,27
1,<environment.Job instance at 0x7f694a183dc0>,27,17,[3 8],28,-1,45,-1,28
1,<environment.Job instance at 0x7f694a183190>,30,13,[10  4],31,-1,44,-1,31
1,<environment.Job instance at 0x7f694a183b90>,31,15,[1 9],32,-1,47,-1,32
1,<environment.Job instance at 0x7f694a183230>,32,17,[2 5],33,-1,50,-1,33
1,<environment.Job instance at 0x7f694a183640>,35,24,[8 3],36,-1,60,-1,36
1,<environment.Job instance at 0x7f694a183410>,38,17,[2 7],39,-1,56,-1,39
1,<environment.Job instance at 0x7f694a183690>,39,14,[4 9],40,-1,54,-1,40
1,<environment.Job instance at 0x7f694a1830f0>,40,18,[8 1],41,-1,59,-1,41
1,<environment.Job instance at 0x7f694a0cbaa0>,45,13,[3 9],46,-1,59,-1,46
1,<environment.Job instance at 0x7f694a0cb3c0>,46,18,[9 4],47,-1,65,-1,47
1,<environment.Job instance at 0x7f694a0cbc30>,47,17,[3 5],48,-1,65,-1,48
1,<environment.Job instance at 0x7f694a127c30>,48,17,[2 6],49,-1,66,-1,49
1,<environment.Job instance at 0x7f694a127870>,52,15,[10  1],53,-1,71,-1,56
1,<environment.Job instance at 0x7f694a253500>,16,17,[ 1 10],17,-1,73,-1,56
1,<environment.Job instance at 0x7f694a1270f0>,55,13,[8 5],56,-1,72,-1,59
1,<environment.Job instance at 0x7f694a127cd0>,57,14,[2 5],58,-1,73,-1,59
1,<environment.Job instance at 0x7f694a127230>,58,16,[6 5],59,-1,77,-1,61
1,<environment.Job instance at 0x7f694ad7f6e0>,64,16,[9 2],65,-1,83,-1,67
1,<environment.Job instance at 0x7f694a9e14b0>,11,17,[14  3],12,-1,38,-1,21
1,<environment.Job instance at 0x7f694a9e1dc0>,14,15,[ 2 13],15,-1,37,-1,22
1,<environment.Job instance at 0x7f694a8a8cd0>,17,3,[12  4],18,-1,26,-1,23
1,<environment.Job instance at 0x7f694a7d0cd0>,19,28,[1 8],20,-1,63,-1,35
1,<environment.Job instance at 0x7f694a7dcb90>,28,18,[13  3],29,-1,75,-1,57
1,<environment.Job instance at 0x7f694a804230>,35,24,[8 3],36,-1,130,-1,106
1,<environment.Job instance at 0x7f694ad67c80>,51,13,[12  4],52,-1,170,-1,157
1,<environment.Job instance at 0x7f694a4e8050>,54,24,[4 5],55,-1,183,-1,159
1,<environment.Job instance at 0x7f694b8f33c0>,8,17,[7 2],9,-1,26,-1,9
1,<environment.Job instance at 0x7f694b8f31e0>,9,16,[10  2],10,-1,26,-1,10
1,<environment.Job instance at 0x7f694b8f3eb0>,10,15,[5 6],11,-1,26,-1,11
1,<environment.Job instance at 0x7f694b8f3fa0>,14,15,[7 3],15,-1,31,-1,16
1,<environment.Job instance at 0x7f694b8f3820>,15,12,[10  3],16,-1,28,-1,16
1,<environment.Job instance at 0x7f694b8f3be0>,17,15,[10  1],18,-1,35,-1,20
1,<environment.Job instance at 0x7f694a5c7a50>,20,17,[2 6],21,-1,38,-1,21
1,<environment.Job instance at 0x7f694a5c70f0>,19,23,[6 5],20,-1,44,-1,21
1,<environment.Job instance at 0x7f694a5c7190>,29,21,[1 9],30,-1,51,-1,30
1,<environment.Job instance at 0x7f694a5c7730>,30,27,[6 4],31,-1,58,-1,31
1,<environment.Job instance at 0x7f694a481690>,32,15,[10  1],33,-1,48,-1,33
1,<environment.Job instance at 0x7f694a481e60>,33,13,[7 5],34,-1,47,-1,34
1,<environment.Job instance at 0x7f694a481190>,34,13,[1 8],35,-1,48,-1,35
1,<environment.Job instance at 0x7f694a481640>,36,14,[1 7],37,-1,51,-1,37
1,<environment.Job instance at 0x7f694a481280>,38,22,[7 5],39,-1,61,-1,39
1,<environment.Job instance at 0x7f694a481140>,39,16,[5 3],40,-1,56,-1,40
1,<environment.Job instance at 0x7f694a481c30>,40,18,[ 5 10],41,-1,59,-1,41
1,<environment.Job instance at 0x7f694a481aa0>,42,24,[1 6],43,-1,67,-1,43
1,<environment.Job instance at 0x7f694a4815a0>,43,16,[8 5],44,-1,60,-1,44
1,<environment.Job instance at 0x7f694a481910>,44,16,[9 4],45,-1,61,-1,45
1,<environment.Job instance at 0x7f694a481b90>,46,15,[10  4],47,-1,63,-1,48
1,<environment.Job instance at 0x7f694aad3870>,48,17,[3 9],49,-1,66,-1,49
1,<environment.Job instance at 0x7f694aad3550>,47,13,[ 4 10],48,-1,63,-1,50
1,<environment.Job instance at 0x7f694aad3500>,58,14,[9 1],59,-1,73,-1,59
1,<environment.Job instance at 0x7f694aad3910>,59,17,[1 9],60,-1,77,-1,60
1,<environment.Job instance at 0x7f694aa0bf50>,62,15,[6 2],63,-1,78,-1,63
1,<environment.Job instance at 0x7f694aa0b2d0>,68,18,[6 5],69,-1,87,-1,69
1,<environment.Job instance at 0x7f694ad74b40>,19,23,[6 5],20,-1,72,-1,49
1,<environment.Job instance at 0x7f694a4d5d70>,30,27,[6 4],31,-1,100,-1,73
1,<environment.Job instance at 0x7f694a4d5f50>,31,1,[11  4],32,-1,74,-1,73
1,<environment.Job instance at 0x7f694a804230>,42,24,[1 6],43,-1,129,-1,105
1,<environment.Job instance at 0x7f694a8a8cd0>,54,3,[ 2 12],55,-1,165,-1,162
1,<environment.Job instance at 0x7f694a9e1230>,61,2,[ 3 14],62,-1,186,-1,184
1,<environment.Job instance at 0x7f694b31e4b0>,66,13,[12  4],67,-1,214,-1,201
1,<environment.Job instance at 0x7f694a9e14b0>,67,27,[9 3],68,-1,229,-1,202
1,<environment.Job instance at 0x7f694a72f4b0>,5,15,[ 1 10],6,-1,22,-1,7
1,<environment.Job instance at 0x7f694a72f7d0>,8,24,[4 7],9,-1,33,-1,9
1,<environment.Job instance at 0x7f694a72f690>,9,12,[4 6],10,-1,22,-1,10
1,<environment.Job instance at 0x7f694a72fa00>,10,13,[5 3],11,-1,24,-1,11
1,<environment.Job instance at 0x7f694a72f550>,12,17,[9 4],13,-1,30,-1,13
1,<environment.Job instance at 0x7f694b4389b0>,14,18,[ 4 11],15,-1,33,-1,15
1,<environment.Job instance at 0x7f694b438690>,15,16,[9 4],16,-1,32,-1,16
1,<environment.Job instance at 0x7f694b438e60>,17,15,[4 6],18,-1,33,-1,18
1,<environment.Job instance at 0x7f694a7c7230>,20,20,[4 6],21,-1,41,-1,21
1,<environment.Job instance at 0x7f694b34b320>,23,14,[ 1 11],24,-1,38,-1,24
1,<environment.Job instance at 0x7f694b34b820>,24,16,[4 5],25,-1,41,-1,25
1,<environment.Job instance at 0x7f694b34b190>,25,16,[ 2 11],26,-1,42,-1,26
1,<environment.Job instance at 0x7f694b34bfa0>,30,12,[1 7],31,-1,43,-1,31
1,<environment.Job instance at 0x7f694b34bbe0>,32,17,[ 2 10],33,-1,50,-1,33
1,<environment.Job instance at 0x7f694b34b6e0>,33,15,[5 5],34,-1,49,-1,34
1,<environment.Job instance at 0x7f694b34beb0>,34,12,[9 1],35,-1,49,-1,37
1,<environment.Job instance at 0x7f694aff34b0>,38,20,[3 8],39,-1,59,-1,39
1,<environment.Job instance at 0x7f694b4a72d0>,39,13,[7 4],40,-1,53,-1,40
1,<environment.Job instance at 0x7f694aff3b90>,36,13,[4 7],37,-1,53,-1,40
1,<environment.Job instance at 0x7f694b4a7820>,40,24,[10  4],41,-1,65,-1,41
1,<environment.Job instance at 0x7f694b4a7690>,41,21,[4 7],42,-1,63,-1,42
1,<environment.Job instance at 0x7f694b4c7780>,49,19,[5 5],50,-1,70,-1,51
1,<environment.Job instance at 0x7f694b4c72d0>,50,15,[10  4],51,-1,66,-1,51
1,<environment.Job instance at 0x7f694b4c7870>,51,18,[4 8],52,-1,71,-1,53
1,<environment.Job instance at 0x7f694b4c78c0>,54,14,[3 8],55,-1,69,-1,55
1,<environment.Job instance at 0x7f694b4c7320>,55,12,[10  1],56,-1,68,-1,56
1,<environment.Job instance at 0x7f694b865eb0>,57,14,[ 4 10],58,-1,72,-1,58
1,<environment.Job instance at 0x7f694b865690>,58,18,[4 6],59,-1,77,-1,59
1,<environment.Job instance at 0x7f694b865f00>,62,16,[3 8],63,-1,79,-1,63
1,<environment.Job instance at 0x7f694b865b90>,63,13,[7 4],64,-1,77,-1,64
1,<environment.Job instance at 0x7f694b865140>,64,3,[7 4],65,-1,68,-1,65
1,<environment.Job instance at 0x7f694b8652d0>,66,18,[10  2],67,-1,85,-1,67
1,<environment.Job instance at 0x7f694b80d6e0>,68,17,[9 5],69,-1,86,-1,69
1,<environment.Job instance at 0x7f694aff3cd0>,6,12,[ 2 11],7,-1,19,-1,7
1,<environment.Job instance at 0x7f694b865af0>,8,24,[4 7],9,-1,38,-1,14
1,<environment.Job instance at 0x7f694a72f190>,14,18,[ 4 11],15,-1,38,-1,20
1,<environment.Job instance at 0x7f694a7d0a00>,19,3,[14  1],20,-1,37,-1,34
1,<environment.Job instance at 0x7f694a7e9af0>,23,14,[ 1 11],24,-1,52,-1,38
1,<environment.Job instance at 0x7f694a7d8aa0>,25,16,[ 2 11],26,-1,56,-1,40
1,<environment.Job instance at 0x7f694a4e0050>,28,2,[13  3],29,-1,45,-1,43
1,<environment.Job instance at 0x7f694a4d5f00>,40,24,[10  4],41,-1,116,-1,92
1,<environment.Job instance at 0x7f694a4d5d20>,42,17,[ 2 11],43,-1,109,-1,92
1,<environment.Job instance at 0x7f694ad67af0>,44,1,[ 2 11],45,-1,93,-1,92
1,<environment.Job instance at 0x7f694a481fa0>,59,1,[ 5 14],60,-1,157,-1,156
1,<environment.Job instance at 0x7f694a472d20>,0,16,[ 3 10],1,-1,18,-1,2
1,<environment.Job instance at 0x7f694a472190>,3,13,[5 5],4,-1,17,-1,4
1,<environment.Job instance at 0x7f694a4725f0>,1,16,[5 7],2,-1,21,-1,5
1,<environment.Job instance at 0x7f694b753190>,18,17,[3 7],19,-1,36,-1,19
1,<environment.Job instance at 0x7f694aa00280>,21,17,[2 7],22,-1,39,-1,22
1,<environment.Job instance at 0x7f694aa009b0>,22,17,[6 4],23,-1,40,-1,23
1,<environment.Job instance at 0x7f694aa00eb0>,23,12,[7 4],24,-1,36,-1,24
1,<environment.Job instance at 0x7f694aa00780>,28,12,[ 4 10],29,-1,45,-1,33
1,<environment.Job instance at 0x7f694ac38e10>,33,18,[5 5],34,-1,52,-1,34
1,<environment.Job instance at 0x7f694ac38d70>,34,16,[5 5],35,-1,51,-1,35
1,<environment.Job instance at 0x7f694ac38a00>,35,17,[ 3 10],36,-1,53,-1,36
1,<environment.Job instance at 0x7f694ac380a0>,36,13,[3 9],37,-1,50,-1,37
1,<environment.Job instance at 0x7f694ac388c0>,38,18,[1 5],39,-1,57,-1,39
1,<environment.Job instance at 0x7f694b8957d0>,39,18,[9 5],40,-1,58,-1,40
1,<environment.Job instance at 0x7f694b895870>,40,19,[4 5],41,-1,60,-1,41
1,<environment.Job instance at 0x7f694b895a00>,42,13,[9 4],43,-1,56,-1,43
1,<environment.Job instance at 0x7f694b8958c0>,43,12,[2 6],44,-1,56,-1,44
1,<environment.Job instance at 0x7f694b8956e0>,44,16,[2 7],45,-1,61,-1,45
1,<environment.Job instance at 0x7f694b895140>,46,13,[5 5],47,-1,60,-1,47
1,<environment.Job instance at 0x7f694af3e140>,48,16,[8 3],49,-1,65,-1,49
1,<environment.Job instance at 0x7f694ac382d0>,32,16,[ 3 10],33,-1,66,-1,50
1,<environment.Job instance at 0x7f694af3eaf0>,55,18,[5 5],56,-1,93,-1,75
1,<environment.Job instance at 0x7f694af3e6e0>,58,28,[10  4],59,-1,103,-1,75
1,<environment.Job instance at 0x7f694af3eb90>,51,21,[8 2],52,-1,97,-1,76
1,<environment.Job instance at 0x7f694b417410>,66,18,[8 3],67,-1,97,-1,79
1,<environment.Job instance at 0x7f694af3e280>,50,23,[9 4],51,-1,102,-1,79
1,<environment.Job instance at 0x7f694af3ef50>,52,21,[5 7],53,-1,100,-1,79
1,<environment.Job instance at 0x7f694ac38640>,7,27,[ 2 11],8,-1,44,-1,17
1,<environment.Job instance at 0x7f694a77b2d0>,9,3,[11  2],10,-1,20,-1,17
1,<environment.Job instance at 0x7f694a77baf0>,12,1,[12  5],13,-1,19,-1,18
1,<environment.Job instance at 0x7f694b4910a0>,50,23,[9 4],51,-1,184,-1,161
1,<environment.Job instance at 0x7f694a54c820>,58,28,[10  4],59,-1,207,-1,179
1,<environment.Job instance at 0x7f694a74ae10>,68,17,[12  1],69,-1,228,-1,211
1,<environment.Job instance at 0x7f694ab4c4b0>,0,26,[4 9],1,-1,27,-1,1
1,<environment.Job instance at 0x7f694b8f54b0>,5,18,[1 8],6,-1,24,-1,6
1,<environment.Job instance at 0x7f694b8f50a0>,7,23,[5 3],8,-1,32,-1,9
1,<environment.Job instance at 0x7f694b4a0c30>,8,16,[9 4],9,-1,25,-1,9
1,<environment.Job instance at 0x7f694b8f5730>,10,14,[1 5],11,-1,25,-1,11
1,<environment.Job instance at 0x7f694b8f5550>,15,14,[ 1 10],16,-1,31,-1,17
1,<environment.Job instance at 0x7f694b8f55f0>,17,19,[1 5],18,-1,37,-1,18
1,<environment.Job instance at 0x7f694b8f51e0>,19,18,[6 4],20,-1,38,-1,20
1,<environment.Job instance at 0x7f694b8f5b40>,20,13,[11  2],21,-1,34,-1,21
1,<environment.Job instance at 0x7f694b8f5af0>,22,14,[3 9],23,-1,37,-1,23
1,<environment.Job instance at 0x7f694ab737d0>,24,14,[5 3],25,-1,39,-1,25
1,<environment.Job instance at 0x7f694ab73be0>,29,17,[9 2],30,-1,55,-1,38
1,<environment.Job instance at 0x7f694ab73f50>,35,17,[3 6],36,-1,55,-1,38
1,<environment.Job instance at 0x7f694b8f5910>,16,18,[7 4],17,-1,64,-1,46
1,<environment.Job instance at 0x7f694b23dc30>,38,12,[ 4 10],39,-1,58,-1,46
1,<environment.Job instance at 0x7f694ab73e10>,34,18,[5 6],35,-1,68,-1,50
1,<environment.Job instance at 0x7f694b23d820>,42,15,[5 9],43,-1,66,-1,51
1,<environment.Job instance at 0x7f694b23dcd0>,40,16,[ 2 10],41,-1,67,-1,51
1,<environment.Job instance at 0x7f694ab73780>,27,16,[ 3 12],28,-1,116,-1,100
1,<environment.Job instance at 0x7f694b546e10>,61,18,[10  5],62,-1,119,-1,101
1,<environment.Job instance at 0x7f694b5464b0>,57,18,[3 8],58,-1,119,-1,101
1,<environment.Job instance at 0x7f694b546870>,58,16,[7 2],59,-1,117,-1,101
1,<environment.Job instance at 0x7f694b546af0>,65,18,[9 2],66,-1,119,-1,101
1,<environment.Job instance at 0x7f694ab731e0>,33,22,[5 2],34,-1,124,-1,102
1,<environment.Job instance at 0x7f694b23df00>,46,25,[6 3],47,-1,127,-1,102
1,<environment.Job instance at 0x7f694b8f5c80>,0,26,[4 9],1,-1,27,-1,1
1,<environment.Job instance at 0x7f694b23d320>,2,16,[13  1],3,-1,19,-1,3
1,<environment.Job instance at 0x7f694ab4cd70>,11,18,[11  2],12,-1,30,-1,12
1,<environment.Job instance at 0x7f694ad39190>,12,12,[ 5 13],13,-1,25,-1,13
1,<environment.Job instance at 0x7f694ad39730>,13,24,[ 5 11],14,-1,38,-1,14
1,<environment.Job instance at 0x7f694b5465f0>,7,23,[5 3],8,-1,41,-1,18
1,<environment.Job instance at 0x7f694ad39640>,20,13,[11  2],21,-1,49,-1,36
1,<environment.Job instance at 0x7f694b570fa0>,27,16,[ 3 12],28,-1,88,-1,72
1,<environment.Job instance at 0x7f694b570d20>,46,25,[6 3],47,-1,166,-1,141
1,<environment.Job instance at 0x7f694ab78fa0>,53,2,[14  3],54,-1,161,-1,159
1,<environment.Job instance at 0x7f694ab78b90>,54,1,[14  5],55,-1,160,-1,159
1,<environment.Job instance at 0x7f694ab78280>,63,1,[12  4],64,-1,183,-1,182
1,<environment.Job instance at 0x7f694ab58af0>,1,21,[4 9],2,-1,23,-1,2
1,<environment.Job instance at 0x7f694ab58e60>,3,16,[8 1],4,-1,22,-1,6
1,<environment.Job instance at 0x7f694b2eaf50>,5,23,[8 4],6,-1,29,-1,6
1,<environment.Job instance at 0x7f694ab58d70>,7,20,[5 7],8,-1,28,-1,8
1,<environment.Job instance at 0x7f694ab78910>,8,16,[4 8],9,-1,25,-1,9
1,<environment.Job instance at 0x7f694aac00f0>,12,12,[6 1],13,-1,25,-1,13
1,<environment.Job instance at 0x7f694aac0230>,15,16,[10  5],16,-1,32,-1,16
1,<environment.Job instance at 0x7f694aac0500>,17,16,[1 7],18,-1,34,-1,18
1,<environment.Job instance at 0x7f694aac06e0>,19,18,[2 7],20,-1,38,-1,20
1,<environment.Job instance at 0x7f694aac0820>,20,15,[4 7],21,-1,36,-1,21
1,<environment.Job instance at 0x7f694ad2edc0>,23,16,[9 4],24,-1,41,-1,25
1,<environment.Job instance at 0x7f694ad2eb90>,30,24,[7 2],31,-1,55,-1,31
1,<environment.Job instance at 0x7f694ad2e870>,32,15,[ 2 10],33,-1,49,-1,34
1,<environment.Job instance at 0x7f694ad91910>,34,17,[8 1],35,-1,52,-1,35
1,<environment.Job instance at 0x7f694ad91500>,36,19,[2 9],37,-1,56,-1,37
1,<environment.Job instance at 0x7f694ad91280>,39,18,[2 7],40,-1,58,-1,40
1,<environment.Job instance at 0x7f694a3f0cd0>,41,18,[3 8],42,-1,60,-1,42
1,<environment.Job instance at 0x7f694a3f0730>,43,14,[ 4 10],44,-1,58,-1,44
1,<environment.Job instance at 0x7f694a3f0f50>,44,15,[4 8],45,-1,60,-1,45
1,<environment.Job instance at 0x7f694a8a41e0>,46,16,[1 6],47,-1,63,-1,47
1,<environment.Job instance at 0x7f694a8a48c0>,47,15,[7 4],48,-1,63,-1,48
1,<environment.Job instance at 0x7f694a8a40f0>,49,17,[ 1 10],50,-1,67,-1,50
1,<environment.Job instance at 0x7f694a8a4370>,57,13,[9 1],58,-1,72,-1,59
1,<environment.Job instance at 0x7f694b30acd0>,67,17,[10  4],68,-1,104,-1,87
1,<environment.Job instance at 0x7f694aac0550>,0,2,[ 2 12],1,-1,3,-1,1
1,<environment.Job instance at 0x7f694ad2e280>,5,23,[8 4],6,-1,43,-1,20
1,<environment.Job instance at 0x7f694ab58050>,14,15,[11  1],15,-1,44,-1,29
1,<environment.Job instance at 0x7f694ab78730>,21,20,[ 5 13],22,-1,67,-1,47
1,<environment.Job instance at 0x7f694b570910>,30,24,[7 2],31,-1,100,-1,76
1,<environment.Job instance at 0x7f694b570c80>,35,15,[ 1 12],36,-1,111,-1,96
1,<environment.Job instance at 0x7f694b546320>,48,2,[ 1 13],49,-1,141,-1,139
1,<environment.Job instance at 0x7f694b546a50>,50,28,[ 2 14],51,-1,180,-1,152
1,<environment.Job instance at 0x7f694b30a820>,51,28,[5 1],52,-1,180,-1,152
1,<environment.Job instance at 0x7f695441a2d0>,63,23,[7 4],64,-1,231,-1,208
1,<environment.Job instance at 0x7f695441a280>,68,18,[13  5],69,-1,226,-1,208
1,<environment.Job instance at 0x7f694a0bdcd0>,1,14,[9 4],2,-1,17,-1,3
1,<environment.Job instance at 0x7f694a0bd870>,5,18,[7 5],6,-1,24,-1,6
1,<environment.Job instance at 0x7f694a0bdfa0>,6,27,[5 2],7,-1,34,-1,7
1,<environment.Job instance at 0x7f694a0bdd70>,9,18,[ 2 10],10,-1,28,-1,10
1,<environment.Job instance at 0x7f694a0bd4b0>,10,22,[2 5],11,-1,33,-1,11
1,<environment.Job instance at 0x7f694a1a7190>,14,18,[10  2],15,-1,36,-1,18
1,<environment.Job instance at 0x7f694a3e6c30>,17,15,[5 8],18,-1,33,-1,18
1,<environment.Job instance at 0x7f694b49d4b0>,18,18,[5 8],19,-1,38,-1,20
1,<environment.Job instance at 0x7f694b49d1e0>,19,17,[2 6],20,-1,37,-1,20
1,<environment.Job instance at 0x7f694b49dd70>,24,28,[4 5],25,-1,53,-1,25
1,<environment.Job instance at 0x7f694b499c30>,28,15,[5 8],29,-1,44,-1,29
1,<environment.Job instance at 0x7f694a1c26e0>,29,1,[4 5],30,-1,31,-1,30
1,<environment.Job instance at 0x7f694a1c24b0>,30,13,[5 6],31,-1,44,-1,31
1,<environment.Job instance at 0x7f694a1c2b40>,31,25,[10  1],32,-1,57,-1,32
1,<environment.Job instance at 0x7f694a1c2cd0>,32,12,[10  4],33,-1,45,-1,33
1,<environment.Job instance at 0x7f694a1c2a50>,34,13,[ 5 10],35,-1,48,-1,35
1,<environment.Job instance at 0x7f694a1c2190>,35,15,[8 1],36,-1,54,-1,39
1,<environment.Job instance at 0x7f6953fa9d70>,38,18,[5 5],39,-1,57,-1,39
1,<environment.Job instance at 0x7f694b1d7640>,40,16,[7 5],41,-1,57,-1,41
1,<environment.Job instance at 0x7f694b1d7e10>,43,17,[5 9],44,-1,62,-1,45
1,<environment.Job instance at 0x7f694b1d7fa0>,44,17,[2 5],45,-1,62,-1,45
1,<environment.Job instance at 0x7f694aff8730>,45,21,[9 3],46,-1,68,-1,47
1,<environment.Job instance at 0x7f694aff8af0>,47,25,[9 4],48,-1,73,-1,48
1,<environment.Job instance at 0x7f694b490280>,50,12,[10  1],51,-1,63,-1,51
1,<environment.Job instance at 0x7f694b9280a0>,52,16,[9 4],53,-1,69,-1,53
1,<environment.Job instance at 0x7f694b490eb0>,53,12,[10  1],54,-1,66,-1,54
1,<environment.Job instance at 0x7f694b95b0a0>,54,17,[1 9],55,-1,72,-1,55
1,<environment.Job instance at 0x7f694aff89b0>,46,15,[3 5],47,-1,71,-1,56
1,<environment.Job instance at 0x7f694d9d2050>,56,18,[8 1],57,-1,78,-1,60
1,<environment.Job instance at 0x7f694b789a50>,59,28,[6 1],60,-1,88,-1,60
1,<environment.Job instance at 0x7f694a97b550>,64,18,[5 5],65,-1,83,-1,65
1,<environment.Job instance at 0x7f694b585f00>,66,17,[2 6],67,-1,84,-1,67
1,<environment.Job instance at 0x7f694b585e10>,68,18,[5 3],69,-1,87,-1,69
1,<environment.Job instance at 0x7f694b499f00>,3,3,[13  5],4,-1,7,-1,4
1,<environment.Job instance at 0x7f694a3e6d70>,7,14,[ 3 14],8,-1,22,-1,8
1,<environment.Job instance at 0x7f694b814af0>,6,27,[5 2],7,-1,43,-1,16
1,<environment.Job instance at 0x7f694ac80cd0>,24,28,[4 5],25,-1,83,-1,55
1,<environment.Job instance at 0x7f694b996d70>,27,2,[ 5 13],28,-1,58,-1,56
1,<environment.Job instance at 0x7f694b9a1c80>,31,25,[10  1],32,-1,108,-1,83
1,<environment.Job instance at 0x7f694a11c5f0>,47,25,[9 4],48,-1,175,-1,150
1,<environment.Job instance at 0x7f694ac6a1e0>,59,28,[6 1],60,-1,227,-1,199
1,<environment.Job instance at 0x7f694ac5a3c0>,62,18,[ 2 12],63,-1,219,-1,201
1,<environment.Job instance at 0x7f694b969640>,1,13,[10  4],2,-1,16,-1,3
1,<environment.Job instance at 0x7f694a6e3be0>,3,24,[5 3],4,-1,28,-1,4
1,<environment.Job instance at 0x7f694a6e3a50>,4,15,[5 6],5,-1,20,-1,5
1,<environment.Job instance at 0x7f694a6e3140>,5,1,[5 9],6,-1,7,-1,6
1,<environment.Job instance at 0x7f694a6e3af0>,6,17,[2 5],7,-1,24,-1,7
1,<environment.Job instance at 0x7f694a6e3e60>,7,2,[11  4],8,-1,10,-1,8
1,<environment.Job instance at 0x7f694a6e3fa0>,8,12,[9 3],9,-1,21,-1,9
1,<environment.Job instance at 0x7f694b969910>,2,15,[8 4],3,-1,24,-1,9
1,<environment.Job instance at 0x7f694a6e3410>,11,28,[9 4],12,-1,40,-1,12
1,<environment.Job instance at 0x7f694a6e3230>,17,17,[1 9],18,-1,36,-1,19
1,<environment.Job instance at 0x7f694a300fa0>,19,18,[7 5],20,-1,38,-1,20
1,<environment.Job instance at 0x7f694a3006e0>,20,17,[10  1],21,-1,39,-1,22
1,<environment.Job instance at 0x7f694a300f50>,22,13,[7 2],23,-1,36,-1,23
1,<environment.Job instance at 0x7f694a3004b0>,24,17,[7 2],25,-1,42,-1,25
1,<environment.Job instance at 0x7f694a6dcaf0>,26,21,[5 5],27,-1,48,-1,27
1,<environment.Job instance at 0x7f694a6dc0f0>,29,15,[10  2],30,-1,45,-1,30
1,<environment.Job instance at 0x7f694a6dc960>,33,15,[3 9],34,-1,49,-1,34
1,<environment.Job instance at 0x7f694a6dc410>,34,16,[7 4],35,-1,51,-1,35
1,<environment.Job instance at 0x7f694a113c80>,38,17,[9 5],39,-1,56,-1,39
1,<environment.Job instance at 0x7f694a6e3e10>,18,19,[ 3 11],19,-1,59,-1,40
1,<environment.Job instance at 0x7f694a113640>,40,15,[5 3],41,-1,57,-1,42
1,<environment.Job instance at 0x7f694a1131e0>,42,14,[4 6],43,-1,57,-1,43
1,<environment.Job instance at 0x7f694a113870>,43,17,[9 1],44,-1,61,-1,44
1,<environment.Job instance at 0x7f694a1133c0>,44,22,[4 9],45,-1,67,-1,45
1,<environment.Job instance at 0x7f694a113460>,46,21,[5 5],47,-1,68,-1,47
1,<environment.Job instance at 0x7f694a113320>,49,15,[3 9],50,-1,65,-1,50
1,<environment.Job instance at 0x7f694a113e60>,50,15,[5 5],51,-1,66,-1,51
1,<environment.Job instance at 0x7f694a113f00>,52,12,[ 1 10],53,-1,65,-1,53
1,<environment.Job instance at 0x7f694a113690>,41,18,[4 7],42,-1,72,-1,54
1,<environment.Job instance at 0x7f694b9695a0>,7,2,[11  4],8,-1,10,-1,8
1,<environment.Job instance at 0x7f694a6dc5f0>,3,24,[5 3],4,-1,39,-1,15
1,<environment.Job instance at 0x7f694b9a5500>,13,16,[ 1 12],14,-1,35,-1,19
1,<environment.Job instance at 0x7f694add83c0>,11,28,[9 4],12,-1,59,-1,31
1,<environment.Job instance at 0x7f694b9a9e60>,18,19,[ 3 11],19,-1,51,-1,32
1,<environment.Job instance at 0x7f694b9be910>,37,13,[14  4],38,-1,128,-1,115
1,<environment.Job instance at 0x7f694b5d4e10>,53,2,[13  2],54,-1,172,-1,170
1,<environment.Job instance at 0x7f694b5d4f50>,55,25,[1 6],56,-1,207,-1,182
1,<environment.Job instance at 0x7f694b5d4050>,60,27,[11  2],61,-1,225,-1,198
1,<environment.Job instance at 0x7f694b5d4640>,65,24,[8 3],66,-1,235,-1,211
1,<environment.Job instance at 0x7f694a527eb0>,1,16,[3 9],2,-1,18,-1,2
1,<environment.Job instance at 0x7f694ab89230>,5,17,[10  3],6,-1,24,-1,7
1,<environment.Job instance at 0x7f694abc4050>,7,24,[5 9],8,-1,32,-1,8
1,<environment.Job instance at 0x7f694abc40f0>,8,14,[6 4],9,-1,23,-1,9
1,<environment.Job instance at 0x7f694ab89b90>,6,18,[6 4],7,-1,27,-1,9
1,<environment.Job instance at 0x7f694abc4370>,11,28,[3 6],12,-1,40,-1,12
1,<environment.Job instance at 0x7f694abc4460>,12,14,[ 4 10],13,-1,27,-1,13
1,<environment.Job instance at 0x7f694abc4690>,15,16,[7 3],16,-1,33,-1,17
1,<environment.Job instance at 0x7f694abc4730>,17,16,[1 8],18,-1,34,-1,18
1,<environment.Job instance at 0x7f694abc4640>,16,12,[8 4],17,-1,31,-1,19
1,<environment.Job instance at 0x7f694abc4a50>,20,20,[9 3],21,-1,42,-1,22
1,<environment.Job instance at 0x7f694abc4910>,21,15,[8 4],22,-1,37,-1,22
1,<environment.Job instance at 0x7f694abc4aa0>,22,14,[9 2],23,-1,46,-1,32
1,<environment.Job instance at 0x7f694abb16e0>,32,16,[9 2],33,-1,49,-1,33
1,<environment.Job instance at 0x7f694abb1690>,33,18,[4 6],34,-1,52,-1,34
1,<environment.Job instance at 0x7f694abb1320>,35,25,[ 3 14],36,-1,62,-1,37
1,<environment.Job instance at 0x7f694abb1f00>,42,18,[7 4],43,-1,66,-1,48
1,<environment.Job instance at 0x7f694abc4d20>,25,17,[5 3],26,-1,65,-1,48
1,<environment.Job instance at 0x7f694abb10f0>,28,26,[8 2],29,-1,77,-1,51
1,<environment.Job instance at 0x7f694abb1c80>,39,17,[5 7],40,-1,68,-1,51
1,<environment.Job instance at 0x7f694abb1820>,36,17,[3 7],37,-1,72,-1,55
1,<environment.Job instance at 0x7f694abb1fa0>,43,14,[ 2 10],44,-1,73,-1,59
1,<environment.Job instance at 0x7f694ab8b870>,53,16,[3 8],54,-1,79,-1,63
1,<environment.Job instance at 0x7f694ab8b5f0>,54,13,[10  5],55,-1,76,-1,63
1,<environment.Job instance at 0x7f694ab8b0a0>,44,27,[13  3],45,-1,91,-1,64
1,<environment.Job instance at 0x7f694ab8bdc0>,60,18,[9 2],61,-1,86,-1,68
1,<environment.Job instance at 0x7f694ab8b3c0>,49,15,[3 9],50,-1,83,-1,68
1,<environment.Job instance at 0x7f694ab8ba00>,55,19,[1 5],56,-1,87,-1,68
1,<environment.Job instance at 0x7f694ab8bf00>,62,17,[9 4],63,-1,86,-1,69
1,<environment.Job instance at 0x7f694ab8b8c0>,52,14,[ 2 10],53,-1,83,-1,69
1,<environment.Job instance at 0x7f694a255e60>,66,17,[ 5 11],67,-1,87,-1,70
1,<environment.Job instance at 0x7f694abc62d0>,64,27,[6 1],65,-1,97,-1,70
1,<environment.Job instance at 0x7f694a255370>,67,12,[1 6],68,-1,82,-1,70
1,<environment.Job instance at 0x7f694ab897d0>,7,24,[5 9],8,-1,42,-1,18
1,<environment.Job instance at 0x7f694b5d4460>,11,28,[3 6],12,-1,47,-1,19
1,<environment.Job instance at 0x7f694b5d4820>,19,26,[2 6],20,-1,79,-1,53
1,<environment.Job instance at 0x7f694b5d41e0>,27,1,[ 1 13],28,-1,77,-1,76
1,<environment.Job instance at 0x7f694b9be140>,28,26,[8 2],29,-1,111,-1,85
1,<environment.Job instance at 0x7f694b9bec80>,35,25,[ 3 14],36,-1,125,-1,100
1,<environment.Job instance at 0x7f694b9be050>,41,3,[ 4 13],42,-1,126,-1,123
1,<environment.Job instance at 0x7f694b9bebe0>,44,27,[13  3],45,-1,153,-1,126
1,<environment.Job instance at 0x7f694a113a50>,64,27,[6 1],65,-1,248,-1,221
1,<environment.Job instance at 0x7f694a6e3910>,66,17,[ 5 11],67,-1,238,-1,221
1,<environment.Job instance at 0x7f694b41d690>,8,18,[5 9],9,-1,27,-1,9
1,<environment.Job instance at 0x7f694b41dd70>,10,18,[6 4],11,-1,34,-1,16
1,<environment.Job instance at 0x7f6953f1b690>,20,13,[12  1],21,-1,48,-1,35
1,<environment.Job instance at 0x7f694b41da50>,13,13,[8 4],14,-1,49,-1,36
1,<environment.Job instance at 0x7f6953f1bf00>,30,17,[9 2],31,-1,53,-1,36
1,<environment.Job instance at 0x7f6953f1bc30>,21,16,[ 5 11],22,-1,52,-1,36
1,<environment.Job instance at 0x7f694a6da230>,32,14,[7 3],33,-1,50,-1,36
1,<environment.Job instance at 0x7f6953f1b370>,25,27,[4 5],26,-1,67,-1,40
1,<environment.Job instance at 0x7f694a6da960>,36,25,[7 3],37,-1,65,-1,40
1,<environment.Job instance at 0x7f694aec60a0>,39,18,[6 2],40,-1,64,-1,46
1,<environment.Job instance at 0x7f694aec6f50>,40,26,[6 4],41,-1,72,-1,46
1,<environment.Job instance at 0x7f694aec6dc0>,45,14,[5 7],46,-1,66,-1,52
1,<environment.Job instance at 0x7f694aec6140>,46,16,[9 2],47,-1,71,-1,55
1,<environment.Job instance at 0x7f694aec6cd0>,47,21,[9 4],48,-1,76,-1,55
1,<environment.Job instance at 0x7f694aec6820>,48,21,[5 1],49,-1,76,-1,55
1,<environment.Job instance at 0x7f6953fb2af0>,52,12,[1 9],53,-1,67,-1,55
1,<environment.Job instance at 0x7f694b383460>,55,16,[4 9],56,-1,72,-1,56
1,<environment.Job instance at 0x7f6953fb2730>,56,18,[5 5],57,-1,75,-1,57
1,<environment.Job instance at 0x7f694a7ecbe0>,59,20,[5 9],60,-1,80,-1,60
1,<environment.Job instance at 0x7f694a7ec230>,60,17,[ 5 10],61,-1,78,-1,61
1,<environment.Job instance at 0x7f694a7ec4b0>,61,14,[10  1],62,-1,77,-1,63
1,<environment.Job instance at 0x7f694a7ec6e0>,62,18,[3 8],63,-1,81,-1,63
1,<environment.Job instance at 0x7f694b41d870>,1,24,[14  3],2,-1,26,-1,2
1,<environment.Job instance at 0x7f694b41d7d0>,3,24,[10  2],4,-1,28,-1,4
1,<environment.Job instance at 0x7f694b991f00>,20,13,[12  1],21,-1,45,-1,32
1,<environment.Job instance at 0x7f694add83c0>,21,16,[ 5 11],22,-1,48,-1,32
1,<environment.Job instance at 0x7f694a11cf50>,25,27,[4 5],26,-1,78,-1,51
1,<environment.Job instance at 0x7f694a11c780>,26,1,[12  2],27,-1,52,-1,51
1,<environment.Job instance at 0x7f694b9be460>,36,25,[7 3],37,-1,107,-1,82
1,<environment.Job instance at 0x7f694b9be820>,40,26,[6 4],41,-1,117,-1,91
1,<environment.Job instance at 0x7f694a015fa0>,2,18,[3 7],3,-1,21,-1,3
1,<environment.Job instance at 0x7f694b8da730>,5,13,[9 1],6,-1,21,-1,8
1,<environment.Job instance at 0x7f694b8da9b0>,8,14,[ 1 10],9,-1,23,-1,9
1,<environment.Job instance at 0x7f694b8da960>,7,15,[3 6],8,-1,25,-1,10
1,<environment.Job instance at 0x7f694b8dac80>,10,25,[5 3],11,-1,36,-1,11
1,<environment.Job instance at 0x7f694a579e60>,18,16,[10  3],19,-1,35,-1,19
1,<environment.Job instance at 0x7f694b483dc0>,19,28,[3 9],20,-1,48,-1,20
1,<environment.Job instance at 0x7f694b4839b0>,22,23,[3 7],23,-1,46,-1,23
1,<environment.Job instance at 0x7f694a569f00>,24,17,[2 7],25,-1,42,-1,25
1,<environment.Job instance at 0x7f694a66edc0>,27,16,[5 4],28,-1,44,-1,28
1,<environment.Job instance at 0x7f694a66ed70>,28,17,[6 5],29,-1,46,-1,29
1,<environment.Job instance at 0x7f694a66e9b0>,29,18,[5 1],30,-1,49,-1,31
1,<environment.Job instance at 0x7f6953f80e60>,31,12,[2 6],32,-1,44,-1,32
1,<environment.Job instance at 0x7f6953f80dc0>,32,17,[6 4],33,-1,50,-1,33
1,<environment.Job instance at 0x7f694a570050>,36,15,[5 6],37,-1,52,-1,37
1,<environment.Job instance at 0x7f694a570960>,39,12,[3 9],40,-1,52,-1,40
1,<environment.Job instance at 0x7f694b9545a0>,40,15,[1 8],41,-1,56,-1,41
1,<environment.Job instance at 0x7f694b954f50>,41,16,[5 5],42,-1,58,-1,42
1,<environment.Job instance at 0x7f694b3ce0a0>,42,18,[2 5],43,-1,61,-1,43
1,<environment.Job instance at 0x7f694b3ce960>,44,14,[ 3 10],45,-1,59,-1,45
1,<environment.Job instance at 0x7f694b483e10>,30,16,[1 7],31,-1,66,-1,50
1,<environment.Job instance at 0x7f694adb0870>,53,20,[ 5 12],54,-1,101,-1,81
1,<environment.Job instance at 0x7f694adfab90>,63,18,[4 5],64,-1,102,-1,84
1,<environment.Job instance at 0x7f694af6ed20>,68,13,[8 2],69,-1,97,-1,84
1,<environment.Job instance at 0x7f694b483690>,4,1,[13  5],5,-1,6,-1,5
1,<environment.Job instance at 0x7f694adb0280>,10,25,[5 3],11,-1,42,-1,17
1,<environment.Job instance at 0x7f694a579500>,11,16,[11  2],12,-1,33,-1,17
1,<environment.Job instance at 0x7f694b5d4910>,19,28,[3 9],20,-1,73,-1,45
1,<environment.Job instance at 0x7f694b5d4b40>,22,23,[3 7],23,-1,71,-1,48
1,<environment.Job instance at 0x7f694b9bea50>,26,3,[ 5 14],27,-1,54,-1,51
1,<environment.Job instance at 0x7f694b9be2d0>,37,16,[11  1],38,-1,100,-1,84
1,<environment.Job instance at 0x7f6954009a50>,47,16,[ 5 13],48,-1,146,-1,130
1,<environment.Job instance at 0x7f694af3c5a0>,49,2,[13  4],50,-1,133,-1,131
1,<environment.Job instance at 0x7f694af3c280>,53,20,[ 5 12],54,-1,153,-1,133
1,<environment.Job instance at 0x7f694af3caa0>,54,2,[ 5 11],55,-1,135,-1,133
1,<environment.Job instance at 0x7f694b25d1e0>,61,2,[ 5 11],62,-1,155,-1,153
1,<environment.Job instance at 0x7f694b8e2e10>,1,16,[4 6],2,-1,18,-1,2
1,<environment.Job instance at 0x7f694b5e4820>,7,15,[10  4],8,-1,24,-1,9
1,<environment.Job instance at 0x7f694b4b3c80>,12,14,[3 7],13,-1,27,-1,13
1,<environment.Job instance at 0x7f69542dc820>,8,16,[ 5 10],9,-1,30,-1,14
1,<environment.Job instance at 0x7f694b3c3a00>,18,18,[ 5 10],19,-1,37,-1,19
1,<environment.Job instance at 0x7f6953f91dc0>,19,18,[10  2],20,-1,39,-1,21
1,<environment.Job instance at 0x7f6953f91190>,22,22,[8 1],23,-1,45,-1,23
1,<environment.Job instance at 0x7f694b3c3140>,20,13,[2 8],21,-1,39,-1,26
1,<environment.Job instance at 0x7f694ae6d5a0>,28,16,[9 1],29,-1,48,-1,32
1,<environment.Job instance at 0x7f694a623730>,33,1,[1 7],34,-1,35,-1,34
1,<environment.Job instance at 0x7f694aff8640>,31,27,[8 5],32,-1,61,-1,34
1,<environment.Job instance at 0x7f694af02dc0>,42,18,[10  5],43,-1,71,-1,53
1,<environment.Job instance at 0x7f694aed7af0>,44,17,[10  5],45,-1,70,-1,53
1,<environment.Job instance at 0x7f694af13be0>,38,16,[13  2],39,-1,69,-1,53
1,<environment.Job instance at 0x7f694af02be0>,45,18,[5 6],46,-1,71,-1,53
1,<environment.Job instance at 0x7f694aefc6e0>,6,16,[13  1],7,-1,23,-1,7
1,<environment.Job instance at 0x7f694b25d1e0>,16,27,[2 9],17,-1,52,-1,25
1,<environment.Job instance at 0x7f694b40a8c0>,23,14,[14  4],24,-1,70,-1,56
1,<environment.Job instance at 0x7f694af3c0a0>,25,3,[ 1 13],26,-1,59,-1,56
1,<environment.Job instance at 0x7f694af3c5a0>,26,2,[14  2],27,-1,58,-1,56
1,<environment.Job instance at 0x7f694af3ce60>,27,15,[ 5 12],28,-1,71,-1,56
1,<environment.Job instance at 0x7f6954009b90>,30,2,[14  4],31,-1,67,-1,65
1,<environment.Job instance at 0x7f6954009460>,31,27,[8 5],32,-1,99,-1,72
1,<environment.Job instance at 0x7f6953f1b410>,34,16,[11  4],35,-1,90,-1,74
1,<environment.Job instance at 0x7f694b9be960>,38,16,[13  2],39,-1,94,-1,78
1,<environment.Job instance at 0x7f694b9be2d0>,41,14,[ 2 12],42,-1,106,-1,92
1,<environment.Job instance at 0x7f694b9bea00>,43,26,[7 1],44,-1,135,-1,109
1,<environment.Job instance at 0x7f6cbdfb66e0>,0,18,[ 2 10],1,-1,20,-1,2
1,<environment.Job instance at 0x7f6cb49c6a50>,3,18,[ 3 10],4,-1,22,-1,4
1,<environment.Job instance at 0x7f6cb49c6be0>,4,18,[10  4],5,-1,23,-1,5
1,<environment.Job instance at 0x7f6cb49c6af0>,5,13,[5 9],6,-1,19,-1,6
1,<environment.Job instance at 0x7f6cb49c6dc0>,8,17,[ 2 10],9,-1,26,-1,9
1,<environment.Job instance at 0x7f6cb49c6f00>,9,17,[ 4 10],10,-1,27,-1,10
1,<environment.Job instance at 0x7f6cb49c9780>,18,16,[8 5],19,-1,35,-1,19
1,<environment.Job instance at 0x7f6cb49c9c30>,23,18,[5 2],24,-1,49,-1,31
1,<environment.Job instance at 0x7f6cb49cc2d0>,31,17,[4 9],32,-1,49,-1,32
1,<environment.Job instance at 0x7f6cb49cc500>,32,17,[9 3],33,-1,50,-1,33
1,<environment.Job instance at 0x7f6cb49c9370>,1,15,[ 1 14],2,-1,17,-1,2
1,<environment.Job instance at 0x7f6cb49cc7d0>,6,12,[11  4],7,-1,19,-1,7
1,<environment.Job instance at 0x7f6cb4ad1d20>,19,17,[12  3],20,-1,67,-1,50
1,<environment.Job instance at 0x7f6cb49bdc30>,22,2,[12  3],23,-1,62,-1,60
1,<environment.Job instance at 0x7f6cb4a34320>,43,28,[6 4],44,-1,166,-1,138
1,<environment.Job instance at 0x7f6cb4aee230>,44,17,[ 5 12],45,-1,155,-1,138
1,<environment.Job instance at 0x7f6cb49ee4b0>,50,27,[9 1],51,-1,179,-1,152
1,<environment.Job instance at 0x7f6cb49ee960>,52,3,[ 3 11],53,-1,155,-1,152
1,<environment.Job instance at 0x7f6cb49eecd0>,53,18,[ 4 12],54,-1,170,-1,152
1,<environment.Job instance at 0x7f6cb49eea50>,60,24,[ 3 10],61,-1,209,-1,185
1,<environment.Job instance at 0x7f6cb4ad5af0>,67,26,[5 4],68,-1,226,-1,200
1,<environment.Job instance at 0x7f6cb41102d0>,15,23,[3 7],16,-1,39,-1,16
1,<environment.Job instance at 0x7f6cb4110eb0>,18,12,[10  1],19,-1,33,-1,21
1,<environment.Job instance at 0x7f6cb410e960>,23,17,[5 6],24,-1,41,-1,24
1,<environment.Job instance at 0x7f6cb410e7d0>,24,17,[5 4],25,-1,44,-1,27
1,<environment.Job instance at 0x7f6cb410ac30>,28,20,[5 7],29,-1,49,-1,29
1,<environment.Job instance at 0x7f6cb40b41e0>,37,18,[ 3 12],38,-1,61,-1,43
1,<environment.Job instance at 0x7f6cb410e3c0>,20,18,[7 5],21,-1,61,-1,43
1,<environment.Job instance at 0x7f6cb410aeb0>,30,20,[5 7],31,-1,63,-1,43
1,<environment.Job instance at 0x7f6cb4058280>,41,18,[11  5],42,-1,66,-1,48
1,<environment.Job instance at 0x7f6cb410e190>,22,27,[ 3 13],23,-1,75,-1,48
1,<environment.Job instance at 0x7f6cb4058780>,39,16,[1 8],40,-1,64,-1,48
1,<environment.Job instance at 0x7f6cb40589b0>,44,15,[9 1],45,-1,63,-1,48
1,<environment.Job instance at 0x7f6cbe19bfa0>,42,14,[14  1],43,-1,64,-1,50
1,<environment.Job instance at 0x7f6cbe19c230>,48,16,[7 1],49,-1,66,-1,50
1,<environment.Job instance at 0x7f6cbdff87d0>,50,16,[9 3],51,-1,67,-1,51
1,<environment.Job instance at 0x7f6cb40b4460>,36,15,[9 2],37,-1,70,-1,55
1,<environment.Job instance at 0x7f6cb3f9afa0>,54,15,[10  5],55,-1,70,-1,55
1,<environment.Job instance at 0x7f6cb3fc4c80>,56,18,[1 6],57,-1,76,-1,58
1,<environment.Job instance at 0x7f6cb410ae10>,31,18,[ 3 13],32,-1,82,-1,64
1,<environment.Job instance at 0x7f6cb41106e0>,60,17,[3 8],61,-1,81,-1,64
1,<environment.Job instance at 0x7f6cb3ff9320>,63,16,[6 4],64,-1,80,-1,64
1,<environment.Job instance at 0x7f6cb4160910>,61,16,[5 4],62,-1,80,-1,64
1,<environment.Job instance at 0x7f6cb3fbfeb0>,57,12,[14  5],58,-1,84,-1,72
1,<environment.Job instance at 0x7f6cb3f5e410>,71,16,[1 9],72,-1,88,-1,72
1,<environment.Job instance at 0x7f6cb3f5d7d0>,75,14,[3 8],76,-1,91,-1,77
1,<environment.Job instance at 0x7f6cb3f5d370>,77,17,[3 8],78,-1,97,-1,80
1,<environment.Job instance at 0x7f6cb3f5d910>,78,16,[3 9],79,-1,96,-1,80
1,<environment.Job instance at 0x7f6cb4058d70>,1,17,[ 4 14],2,-1,19,-1,2
1,<environment.Job instance at 0x7f6cb41ab910>,5,19,[14  4],6,-1,25,-1,6
1,<environment.Job instance at 0x7f6cb4165f50>,15,23,[3 7],16,-1,40,-1,17
1,<environment.Job instance at 0x7f6cb4167d70>,22,27,[ 3 13],23,-1,56,-1,29
1,<environment.Job instance at 0x7f6cb41856e0>,31,18,[ 3 13],32,-1,68,-1,50
1,<environment.Job instance at 0x7f6cb42114b0>,37,18,[ 3 12],38,-1,81,-1,63
1,<environment.Job instance at 0x7f6cb4186050>,41,18,[11  5],42,-1,87,-1,69
1,<environment.Job instance at 0x7f6cb418fd70>,42,14,[14  1],43,-1,83,-1,69
1,<environment.Job instance at 0x7f6cb4193d20>,55,15,[ 3 14],56,-1,137,-1,122
1,<environment.Job instance at 0x7f6cb4219460>,57,12,[14  5],58,-1,134,-1,122
1,<environment.Job instance at 0x7f6cb3f71500>,7,18,[5 2],8,-1,26,-1,8
1,<environment.Job instance at 0x7f6cb3f71820>,8,18,[4 6],9,-1,27,-1,9
1,<environment.Job instance at 0x7f6cb3f71a50>,9,16,[3 5],10,-1,26,-1,10
1,<environment.Job instance at 0x7f6cbe11fd20>,13,12,[1 7],14,-1,26,-1,14
1,<environment.Job instance at 0x7f6cbe11f3c0>,15,25,[3 9],16,-1,41,-1,16
1,<environment.Job instance at 0x7f6cbe11f960>,17,13,[ 4 10],18,-1,31,-1,18
1,<environment.Job instance at 0x7f6cbe130280>,19,23,[2 8],20,-1,43,-1,20
1,<environment.Job instance at 0x7f6cbe130d70>,21,1,[5 1],22,-1,23,-1,22
1,<environment.Job instance at 0x7f6cbe130320>,25,17,[10  5],26,-1,43,-1,26
1,<environment.Job instance at 0x7f6cbe1305f0>,26,26,[9 1],27,-1,53,-1,27
1,<environment.Job instance at 0x7f6cbe1304b0>,28,14,[8 5],29,-1,43,-1,29
1,<environment.Job instance at 0x7f6cbe130960>,29,17,[9 2],30,-1,47,-1,30
1,<environment.Job instance at 0x7f6cbe130b90>,30,18,[5 1],31,-1,49,-1,31
1,<environment.Job instance at 0x7f6cb404aaa0>,32,14,[8 4],33,-1,47,-1,33
1,<environment.Job instance at 0x7f6cb404a730>,34,17,[10  5],35,-1,52,-1,35
1,<environment.Job instance at 0x7f6cb404a410>,35,16,[ 3 10],36,-1,52,-1,36
1,<environment.Job instance at 0x7f6cb404a0f0>,36,23,[5 8],37,-1,60,-1,37
1,<environment.Job instance at 0x7f6cb404ab90>,42,14,[9 2],43,-1,57,-1,43
1,<environment.Job instance at 0x7f6cb404a780>,43,27,[5 3],44,-1,71,-1,44
1,<environment.Job instance at 0x7f6cb404adc0>,44,17,[10  2],45,-1,63,-1,46
1,<environment.Job instance at 0x7f6cbe121780>,46,13,[5 1],47,-1,60,-1,47
1,<environment.Job instance at 0x7f6cb404a2d0>,45,17,[5 9],46,-1,64,-1,47
1,<environment.Job instance at 0x7f6cbe121be0>,48,22,[9 2],49,-1,71,-1,49
1,<environment.Job instance at 0x7f6cbe1214b0>,50,17,[2 9],51,-1,69,-1,52
1,<environment.Job instance at 0x7f6cb404e320>,52,17,[10  4],53,-1,70,-1,53
1,<environment.Job instance at 0x7f6cb404e5a0>,54,13,[5 9],55,-1,68,-1,55
1,<environment.Job instance at 0x7f6cb404ea50>,55,17,[8 1],56,-1,73,-1,56
1,<environment.Job instance at 0x7f6cb404e5f0>,56,16,[7 2],57,-1,73,-1,57
1,<environment.Job instance at 0x7f6cb404e7d0>,57,18,[ 1 10],58,-1,76,-1,58
1,<environment.Job instance at 0x7f6cb404ef00>,58,28,[7 4],59,-1,87,-1,59
1,<environment.Job instance at 0x7f6cb404e3c0>,63,15,[5 6],64,-1,79,-1,64
1,<environment.Job instance at 0x7f6cb404e870>,64,28,[9 1],65,-1,93,-1,65
1,<environment.Job instance at 0x7f6cb404e730>,65,17,[3 5],66,-1,83,-1,66
1,<environment.Job instance at 0x7f6cbe121280>,51,18,[ 5 11],52,-1,84,-1,66
1,<environment.Job instance at 0x7f6cb404e0a0>,66,15,[ 5 10],67,-1,86,-1,71
1,<environment.Job instance at 0x7f6cbe12f960>,72,16,[8 5],73,-1,89,-1,73
1,<environment.Job instance at 0x7f6cbe12fa50>,74,14,[8 5],75,-1,89,-1,75
1,<environment.Job instance at 0x7f6cbe12fe60>,70,15,[7 4],71,-1,91,-1,76
1,<environment.Job instance at 0x7f6cbe05d730>,78,18,[3 8],79,-1,97,-1,79
1,<environment.Job instance at 0x7f6cb404ef50>,6,22,[11  3],7,-1,29,-1,7
1,<environment.Job instance at 0x7f6cb3f71730>,15,25,[3 9],16,-1,63,-1,38
1,<environment.Job instance at 0x7f6cb3f5b690>,19,23,[2 8],20,-1,61,-1,38
1,<environment.Job instance at 0x7f6cbe05d0f0>,26,26,[9 1],27,-1,83,-1,57
1,<environment.Job instance at 0x7f6cbe1269b0>,36,23,[5 8],37,-1,134,-1,111
1,<environment.Job instance at 0x7f6cbe11ea00>,41,2,[12  1],42,-1,118,-1,116
1,<environment.Job instance at 0x7f6cbe11e2d0>,43,27,[5 3],44,-1,151,-1,124
1,<environment.Job instance at 0x7f6cbe128b90>,49,3,[ 4 12],50,-1,142,-1,139
1,<environment.Job instance at 0x7f6cbe1286e0>,51,18,[ 5 11],52,-1,157,-1,139
1,<environment.Job instance at 0x7f6cb3fc2780>,58,28,[7 4],59,-1,224,-1,196
1,<environment.Job instance at 0x7f6cb3fc23c0>,64,28,[9 1],65,-1,243,-1,215
1,<environment.Job instance at 0x7f6cb3fbf550>,68,16,[14  3],69,-1,237,-1,221
1,<environment.Job instance at 0x7f6cbdbdba50>,0,28,[7 3],1,-1,29,-1,1
1,<environment.Job instance at 0x7f6cb44cf9b0>,1,16,[7 4],2,-1,18,-1,2
1,<environment.Job instance at 0x7f6cb44cf2d0>,3,18,[1 6],4,-1,22,-1,4
1,<environment.Job instance at 0x7f6cb44cf460>,4,15,[9 5],5,-1,22,-1,7
1,<environment.Job instance at 0x7f6cb44cfb40>,7,16,[2 8],8,-1,24,-1,8
1,<environment.Job instance at 0x7f6cb44cffa0>,8,12,[9 2],9,-1,21,-1,9
1,<environment.Job instance at 0x7f6cb44cfdc0>,6,17,[2 6],7,-1,27,-1,10
1,<environment.Job instance at 0x7f6cb44cf820>,10,18,[8 5],11,-1,29,-1,11
1,<environment.Job instance at 0x7f6ccc3771e0>,14,17,[1 9],15,-1,32,-1,15
1,<environment.Job instance at 0x7f6cb410c280>,23,21,[9 5],24,-1,46,-1,25
1,<environment.Job instance at 0x7f6cb4339a00>,24,18,[10  2],25,-1,43,-1,25
1,<environment.Job instance at 0x7f6cb4339230>,32,17,[8 2],33,-1,51,-1,34
1,<environment.Job instance at 0x7f6cb41053c0>,36,14,[5 4],37,-1,51,-1,37
1,<environment.Job instance at 0x7f6cb4622c30>,37,14,[4 7],38,-1,52,-1,38
1,<environment.Job instance at 0x7f6cb46225f0>,39,13,[5 7],40,-1,53,-1,40
1,<environment.Job instance at 0x7f6cb3f72a00>,41,16,[6 2],42,-1,58,-1,42
1,<environment.Job instance at 0x7f6cb3f726e0>,46,13,[3 6],47,-1,60,-1,47
1,<environment.Job instance at 0x7f6cb44b6320>,50,13,[7 4],51,-1,64,-1,51
1,<environment.Job instance at 0x7f6cb44b6dc0>,53,18,[9 2],54,-1,72,-1,54
1,<environment.Job instance at 0x7f6cb44b6780>,54,18,[ 5 10],55,-1,73,-1,55
1,<environment.Job instance at 0x7f6cb44b66e0>,56,16,[5 7],57,-1,73,-1,57
1,<environment.Job instance at 0x7f6cb4652b90>,65,18,[9 5],66,-1,85,-1,67
1,<environment.Job instance at 0x7f6cb410cb40>,0,28,[7 3],1,-1,29,-1,1
1,<environment.Job instance at 0x7f6cb4920550>,18,12,[12  2],19,-1,51,-1,39
1,<environment.Job instance at 0x7f6cb44cf8c0>,21,19,[ 3 14],22,-1,71,-1,52
1,<environment.Job instance at 0x7f6cb3fbf320>,22,2,[14  5],23,-1,54,-1,52
1,<environment.Job instance at 0x7f6cb3fbfe60>,25,12,[12  4],26,-1,66,-1,54
1,<environment.Job instance at 0x7f6cbe1280f0>,31,18,[ 5 14],32,-1,86,-1,68
1,<environment.Job instance at 0x7f6cbe1268c0>,38,1,[ 5 14],39,-1,90,-1,89
1,<environment.Job instance at 0x7f6cbe126c30>,43,3,[14  5],44,-1,107,-1,104
1,<environment.Job instance at 0x7f6cb4180c30>,48,17,[12  1],49,-1,138,-1,121
1,<environment.Job instance at 0x7f6cb4662e10>,52,1,[13  3],53,-1,125,-1,124
1,<environment.Job instance at 0x7f6cb44a0410>,62,27,[ 2 13],63,-1,199,-1,172
1,<environment.Job instance at 0x7f6cb44a0e60>,68,1,[12  5],69,-1,192,-1,191
1,<environment.Job instance at 0x7f6cb4dd24b0>,11,16,[2 8],12,-1,28,-1,12
1,<environment.Job instance at 0x7f6cb4df7f50>,18,14,[10  4],19,-1,33,-1,19
1,<environment.Job instance at 0x7f6cb4db6370>,19,16,[1 7],20,-1,36,-1,20
1,<environment.Job instance at 0x7f6cb4df1870>,20,18,[11  4],21,-1,39,-1,21
1,<environment.Job instance at 0x7f6cb4df1a50>,21,15,[3 5],22,-1,37,-1,22
1,<environment.Job instance at 0x7f6cb4df1910>,22,20,[7 3],23,-1,43,-1,23
1,<environment.Job instance at 0x7f6cb4db6af0>,25,17,[6 3],26,-1,43,-1,26
1,<environment.Job instance at 0x7f6cb46cbf50>,14,18,[13  2],15,-1,45,-1,27
1,<environment.Job instance at 0x7f6cb4408eb0>,28,17,[2 8],29,-1,46,-1,29
1,<environment.Job instance at 0x7f6cb43e0dc0>,31,14,[3 6],32,-1,46,-1,32
1,<environment.Job instance at 0x7f6cb43de780>,32,15,[7 3],33,-1,50,-1,35
1,<environment.Job instance at 0x7f6cb43f3af0>,35,16,[2 6],36,-1,52,-1,36
1,<environment.Job instance at 0x7f6cb43f3460>,36,15,[10  5],37,-1,52,-1,37
1,<environment.Job instance at 0x7f6cb4338370>,37,16,[ 3 10],38,-1,54,-1,38
1,<environment.Job instance at 0x7f6cb43512d0>,38,16,[3 6],39,-1,55,-1,39
1,<environment.Job instance at 0x7f6cb48400f0>,39,22,[1 6],40,-1,62,-1,40
1,<environment.Job instance at 0x7f6cb43e4d20>,43,12,[8 5],44,-1,57,-1,45
1,<environment.Job instance at 0x7f6cb43e4780>,45,12,[2 5],46,-1,58,-1,46
1,<environment.Job instance at 0x7f6cb43e4dc0>,47,13,[ 1 10],48,-1,61,-1,48
1,<environment.Job instance at 0x7f6cb43eb730>,49,18,[ 2 10],50,-1,68,-1,50
1,<environment.Job instance at 0x7f6cb43ec140>,50,17,[7 1],51,-1,68,-1,51
1,<environment.Job instance at 0x7f6cb43ec230>,51,18,[3 8],52,-1,70,-1,52
1,<environment.Job instance at 0x7f6cb43ec410>,53,24,[3 6],54,-1,78,-1,54
1,<environment.Job instance at 0x7f6cb43ec370>,55,20,[3 8],56,-1,76,-1,56
1,<environment.Job instance at 0x7f6cb43ec870>,56,15,[4 9],57,-1,72,-1,57
1,<environment.Job instance at 0x7f6cb4dfe5a0>,60,18,[4 8],61,-1,81,-1,63
1,<environment.Job instance at 0x7f6cb4dfebe0>,65,18,[ 3 10],66,-1,85,-1,67
1,<environment.Job instance at 0x7f6cb4dfef00>,67,13,[4 9],68,-1,81,-1,68
1,<environment.Job instance at 0x7f6cb4e03370>,72,17,[9 1],73,-1,90,-1,73
1,<environment.Job instance at 0x7f6cb4e03500>,73,18,[8 1],74,-1,92,-1,74
1,<environment.Job instance at 0x7f6cb4e035a0>,75,27,[5 5],76,-1,103,-1,76
1,<environment.Job instance at 0x7f6cb4e03730>,76,22,[2 8],77,-1,99,-1,77
1,<environment.Job instance at 0x7f6cb4e035f0>,77,20,[5 2],78,-1,98,-1,78
1,<environment.Job instance at 0x7f6cb4dd2140>,1,18,[ 4 13],2,-1,20,-1,2
1,<environment.Job instance at 0x7f6cb43e2dc0>,7,16,[ 5 13],8,-1,24,-1,8
1,<environment.Job instance at 0x7f6cb4dc3e60>,14,18,[13  2],15,-1,38,-1,20
1,<environment.Job instance at 0x7f6cb44a0fa0>,20,18,[11  4],21,-1,54,-1,36
1,<environment.Job instance at 0x7f6cbe126370>,41,25,[10  4],42,-1,143,-1,118
1,<environment.Job instance at 0x7f6cbe128fa0>,53,24,[3 6],54,-1,172,-1,148
1,<environment.Job instance at 0x7f6cbe1280a0>,57,27,[9 5],58,-1,189,-1,162
1,<environment.Job instance at 0x7f6cb40b2190>,63,2,[ 3 14],64,-1,181,-1,179
1,<environment.Job instance at 0x7f6cb3f72e10>,74,3,[ 3 12],75,-1,234,-1,231
1,<environment.Job instance at 0x7f6cb4631b90>,75,27,[5 5],76,-1,258,-1,231
1,<environment.Job instance at 0x7f6cb46317d0>,78,13,[14  4],79,-1,262,-1,249
1,<environment.Job instance at 0x7f6cb47a8410>,0,16,[1 9],1,-1,17,-1,1
1,<environment.Job instance at 0x7f6cb47a80a0>,2,17,[4 6],3,-1,20,-1,3
1,<environment.Job instance at 0x7f6cb47a83c0>,3,27,[7 5],4,-1,31,-1,4
1,<environment.Job instance at 0x7f6cb5509aa0>,9,17,[5 1],10,-1,27,-1,10
1,<environment.Job instance at 0x7f6cb5509460>,11,18,[5 7],12,-1,30,-1,12
1,<environment.Job instance at 0x7f6cb441f460>,12,13,[8 1],13,-1,27,-1,14
1,<environment.Job instance at 0x7f6cb441f730>,15,25,[3 7],16,-1,41,-1,16
1,<environment.Job instance at 0x7f6cb441fe60>,17,14,[10  3],18,-1,32,-1,18
1,<environment.Job instance at 0x7f6cb441f7d0>,22,13,[3 9],23,-1,36,-1,23
1,<environment.Job instance at 0x7f6cb441f5a0>,25,16,[10  5],26,-1,42,-1,26
1,<environment.Job instance at 0x7f6cb46ad460>,28,21,[9 5],29,-1,52,-1,31
1,<environment.Job instance at 0x7f6cb46ad1e0>,26,13,[8 4],27,-1,47,-1,34
1,<environment.Job instance at 0x7f6cb46ad370>,32,12,[8 5],33,-1,46,-1,34
1,<environment.Job instance at 0x7f6cb441faf0>,27,14,[9 1],28,-1,50,-1,36
1,<environment.Job instance at 0x7f6cb46ad0f0>,35,15,[5 7],36,-1,51,-1,36
1,<environment.Job instance at 0x7f6cb5507eb0>,37,16,[2 6],38,-1,54,-1,38
1,<environment.Job instance at 0x7f6cb55078c0>,39,16,[ 5 13],40,-1,56,-1,40
1,<environment.Job instance at 0x7f6cb5507c30>,36,13,[7 1],37,-1,57,-1,44
1,<environment.Job instance at 0x7f6cb433f960>,46,17,[9 1],47,-1,64,-1,47
1,<environment.Job instance at 0x7f6cb433f910>,49,16,[1 8],50,-1,66,-1,50
1,<environment.Job instance at 0x7f6cb433fc30>,52,17,[10  3],53,-1,70,-1,53
1,<environment.Job instance at 0x7f6cb433f6e0>,53,13,[9 5],54,-1,67,-1,54
1,<environment.Job instance at 0x7f6cb433fd70>,54,15,[ 1 10],55,-1,70,-1,55
1,<environment.Job instance at 0x7f6cb4351cd0>,60,13,[3 8],61,-1,74,-1,61
1,<environment.Job instance at 0x7f6cb441f410>,4,13,[14  5],5,-1,18,-1,5
1,<environment.Job instance at 0x7f6cb5507780>,3,27,[7 5],4,-1,44,-1,17
1,<environment.Job instance at 0x7f6cb47a8f50>,15,25,[3 7],16,-1,60,-1,35
1,<environment.Job instance at 0x7f6cb433ca00>,20,1,[ 4 12],21,-1,49,-1,48
1,<environment.Job instance at 0x7f6cb433c5a0>,24,12,[13  3],25,-1,76,-1,64
1,<environment.Job instance at 0x7f6cb43ec780>,29,3,[12  1],30,-1,81,-1,78
1,<environment.Job instance at 0x7f6cb4323960>,39,16,[ 5 13],40,-1,132,-1,116
1,<environment.Job instance at 0x7f6cb4323f00>,44,14,[ 3 14],45,-1,140,-1,126
1,<environment.Job instance at 0x7f6cb43234b0>,45,24,[3 9],46,-1,167,-1,143
1,<environment.Job instance at 0x7f6cb4323d70>,55,1,[12  4],56,-1,170,-1,169
1,<environment.Job instance at 0x7f6cb434dfa0>,61,15,[14  1],62,-1,201,-1,186
1,<environment.Job instance at 0x7f6cb434d4b0>,62,27,[5 5],63,-1,214,-1,187
1,<environment.Job instance at 0x7f6cb434d460>,64,25,[1 7],65,-1,214,-1,189
1,<environment.Job instance at 0x7f6cb434df00>,76,27,[5 8],77,-1,272,-1,245
1,<environment.Job instance at 0x7f6cb43479b0>,5,19,[7 5],6,-1,26,-1,7
1,<environment.Job instance at 0x7f6cb558b9b0>,7,12,[10  4],8,-1,20,-1,8
1,<environment.Job instance at 0x7f6cb4358c80>,10,14,[ 4 10],11,-1,25,-1,11
1,<environment.Job instance at 0x7f6cb558b4b0>,12,17,[2 5],13,-1,30,-1,13
1,<environment.Job instance at 0x7f6cb4359af0>,16,18,[8 2],17,-1,35,-1,17
1,<environment.Job instance at 0x7f6cb4359b90>,17,18,[6 2],18,-1,36,-1,18
1,<environment.Job instance at 0x7f6cb4359550>,19,18,[5 8],20,-1,38,-1,20
1,<environment.Job instance at 0x7f6cb4359500>,20,19,[2 7],21,-1,40,-1,21
1,<environment.Job instance at 0x7f6cb4114640>,21,24,[1 9],22,-1,46,-1,22
1,<environment.Job instance at 0x7f6cb42270a0>,6,14,[8 1],7,-1,37,-1,23
1,<environment.Job instance at 0x7f6cb4353780>,27,23,[10  4],28,-1,51,-1,28
1,<environment.Job instance at 0x7f6cb43535a0>,29,3,[3 6],30,-1,33,-1,30
1,<environment.Job instance at 0x7f6cb4353cd0>,30,3,[7 3],31,-1,34,-1,31
1,<environment.Job instance at 0x7f6cb53e2fa0>,31,17,[5 7],32,-1,49,-1,32
1,<environment.Job instance at 0x7f6cb53e2370>,32,12,[3 8],33,-1,45,-1,33
1,<environment.Job instance at 0x7f6cb486b910>,34,13,[1 9],35,-1,48,-1,35
1,<environment.Job instance at 0x7f6cb5378c30>,35,16,[4 5],36,-1,52,-1,36
1,<environment.Job instance at 0x7f6cb53f3640>,39,17,[ 5 10],40,-1,57,-1,40
1,<environment.Job instance at 0x7f6cb53537d0>,40,18,[4 6],41,-1,59,-1,41
1,<environment.Job instance at 0x7f6cb534e3c0>,44,15,[5 7],45,-1,60,-1,45
1,<environment.Job instance at 0x7f6cb535d370>,45,24,[10  2],46,-1,70,-1,46
1,<environment.Job instance at 0x7f6cb535daf0>,46,14,[ 5 10],47,-1,61,-1,47
1,<environment.Job instance at 0x7f6cb535d320>,47,18,[1 7],48,-1,66,-1,48
1,<environment.Job instance at 0x7f6cb535d1e0>,48,19,[1 6],49,-1,68,-1,49
1,<environment.Job instance at 0x7f6cb535b690>,53,20,[5 7],54,-1,74,-1,54
1,<environment.Job instance at 0x7f6cb535b5a0>,55,12,[11  5],56,-1,68,-1,56
1,<environment.Job instance at 0x7f6cb535b6e0>,56,27,[4 5],57,-1,84,-1,57
1,<environment.Job instance at 0x7f6cb535bb90>,58,15,[5 9],59,-1,74,-1,59
1,<environment.Job instance at 0x7f6cb4f450f0>,60,14,[8 4],61,-1,75,-1,61
1,<environment.Job instance at 0x7f6cb4f45280>,61,12,[5 9],62,-1,74,-1,62
1,<environment.Job instance at 0x7f6cb4f453c0>,63,18,[6 1],64,-1,82,-1,64
1,<environment.Job instance at 0x7f6cb4f45550>,64,12,[4 7],65,-1,77,-1,65
1,<environment.Job instance at 0x7f6cb4f45640>,66,14,[10  4],67,-1,81,-1,67
1,<environment.Job instance at 0x7f6cb4f45cd0>,73,12,[ 2 10],74,-1,86,-1,74
1,<environment.Job instance at 0x7f6cb53d47d0>,1,24,[4 8],2,-1,26,-1,2
1,<environment.Job instance at 0x7f6cb41808c0>,11,1,[11  1],12,-1,13,-1,12
1,<environment.Job instance at 0x7f6cb432f640>,21,24,[1 9],22,-1,76,-1,52
1,<environment.Job instance at 0x7f6cb5331820>,27,23,[10  4],28,-1,85,-1,62
1,<environment.Job instance at 0x7f6cb47a9af0>,33,3,[ 5 13],34,-1,82,-1,79
1,<environment.Job instance at 0x7f6cb4d980a0>,36,17,[13  2],37,-1,108,-1,91
1,<environment.Job instance at 0x7f6cb4d985a0>,37,1,[11  4],38,-1,92,-1,91
1,<environment.Job instance at 0x7f6cb3f1ae10>,42,17,[ 2 12],43,-1,120,-1,103
1,<environment.Job instance at 0x7f6cb4bfa5a0>,45,24,[10  2],46,-1,143,-1,119
1,<environment.Job instance at 0x7f6cb4732be0>,49,27,[14  1],50,-1,173,-1,146
1,<environment.Job instance at 0x7f6cb42040a0>,52,2,[11  4],53,-1,148,-1,146
1,<environment.Job instance at 0x7f6cb47fcb40>,55,12,[11  5],56,-1,159,-1,147
1,<environment.Job instance at 0x7f6cb3f44500>,56,27,[4 5],57,-1,175,-1,148
1,<environment.Job instance at 0x7f6cb4fe8640>,62,3,[11  3],63,-1,178,-1,175
1,<environment.Job instance at 0x7f6cb4830910>,71,15,[ 2 14],72,-1,221,-1,206
1,<environment.Job instance at 0x7f6cb46b6dc0>,75,12,[ 3 13],76,-1,223,-1,211
1,<environment.Job instance at 0x7f6cb43067d0>,0,18,[5 9],1,-1,19,-1,1
1,<environment.Job instance at 0x7f6cb4306550>,3,18,[ 1 10],4,-1,22,-1,4
1,<environment.Job instance at 0x7f6cb4306280>,9,14,[9 5],10,-1,24,-1,10
1,<environment.Job instance at 0x7f6cb4737af0>,15,17,[ 5 10],16,-1,34,-1,17
1,<environment.Job instance at 0x7f6cb4737410>,18,16,[9 2],19,-1,35,-1,19
1,<environment.Job instance at 0x7f6cb4737550>,26,14,[9 2],27,-1,42,-1,28
1,<environment.Job instance at 0x7f6cbe12f780>,28,18,[13  3],29,-1,47,-1,29
1,<environment.Job instance at 0x7f6cb4737320>,16,17,[ 1 10],17,-1,46,-1,29
1,<environment.Job instance at 0x7f6cbe12faa0>,30,13,[10  4],31,-1,44,-1,31
1,<environment.Job instance at 0x7f6cbe12fbe0>,31,15,[1 9],32,-1,47,-1,32
1,<environment.Job instance at 0x7f6cbe12fa50>,32,17,[2 5],33,-1,50,-1,33
1,<environment.Job instance at 0x7f6cb5463f50>,38,17,[2 7],39,-1,57,-1,40
1,<environment.Job instance at 0x7f6cb5463e60>,47,17,[3 5],48,-1,65,-1,48
1,<environment.Job instance at 0x7f6cb5463230>,39,14,[4 9],40,-1,67,-1,53
1,<environment.Job instance at 0x7f6cb4737910>,19,28,[1 8],20,-1,81,-1,53
1,<environment.Job instance at 0x7f6cb5463a00>,48,17,[2 6],49,-1,75,-1,58
1,<environment.Job instance at 0x7f6cb54630f0>,51,13,[12  4],52,-1,73,-1,60
1,<environment.Job instance at 0x7f6cb4bab190>,54,24,[4 5],55,-1,84,-1,60
1,<environment.Job instance at 0x7f6cb5463910>,40,18,[8 1],41,-1,78,-1,60
1,<environment.Job instance at 0x7f6cb4babbe0>,55,13,[8 5],56,-1,73,-1,60
1,<environment.Job instance at 0x7f6cb4babeb0>,53,17,[5 3],54,-1,85,-1,68
1,<environment.Job instance at 0x7f6cb4bab960>,58,16,[6 5],59,-1,84,-1,68
1,<environment.Job instance at 0x7f6cb4babc30>,63,14,[4 8],64,-1,85,-1,71
1,<environment.Job instance at 0x7f6cb4babd20>,64,16,[9 2],65,-1,87,-1,71
1,<environment.Job instance at 0x7f6cb5463640>,46,18,[9 4],47,-1,89,-1,71
1,<environment.Job instance at 0x7f6cb4bab320>,66,15,[9 1],67,-1,88,-1,73
1,<environment.Job instance at 0x7f6cb4babcd0>,59,3,[5 9],60,-1,76,-1,73
1,<environment.Job instance at 0x7f6cbdb3e460>,72,13,[ 5 10],73,-1,86,-1,73
1,<environment.Job instance at 0x7f6cbdb3e5a0>,73,15,[6 1],74,-1,89,-1,74
1,<environment.Job instance at 0x7f6cbdb3e1e0>,71,13,[6 5],72,-1,87,-1,74
1,<environment.Job instance at 0x7f6cb5463a50>,52,15,[10  1],53,-1,89,-1,74
1,<environment.Job instance at 0x7f6cb4bab9b0>,69,13,[1 8],70,-1,87,-1,74
1,<environment.Job instance at 0x7f6cb4306460>,11,17,[14  3],12,-1,38,-1,21
1,<environment.Job instance at 0x7f6cb4306c80>,14,15,[ 2 13],15,-1,37,-1,22
1,<environment.Job instance at 0x7f6cb4306780>,17,3,[12  4],18,-1,26,-1,23
1,<environment.Job instance at 0x7f6cb4351780>,19,28,[1 8],20,-1,63,-1,35
1,<environment.Job instance at 0x7f6cb432fe60>,28,18,[13  3],29,-1,75,-1,57
1,<environment.Job instance at 0x7f6cb5194aa0>,35,24,[8 3],36,-1,130,-1,106
1,<environment.Job instance at 0x7f6cb430d9b0>,51,13,[12  4],52,-1,170,-1,157
1,<environment.Job instance at 0x7f6cb430daa0>,54,24,[4 5],55,-1,183,-1,159
1,<environment.Job instance at 0x7f6cb3d27f00>,5,12,[10  3],6,-1,19,-1,7
1,<environment.Job instance at 0x7f6cb3d27b40>,7,15,[10  1],8,-1,23,-1,8
1,<environment.Job instance at 0x7f6cb3d27410>,9,23,[6 5],10,-1,33,-1,10
1,<environment.Job instance at 0x7f6cb3d273c0>,10,17,[2 6],11,-1,28,-1,11
1,<environment.Job instance at 0x7f6cb3d27f50>,12,1,[4 6],13,-1,14,-1,13
1,<environment.Job instance at 0x7f6cb3d27af0>,13,1,[4 9],14,-1,15,-1,14
1,<environment.Job instance at 0x7f6cb3d277d0>,14,12,[3 5],15,-1,27,-1,15
1,<environment.Job instance at 0x7f6cb3d48c30>,19,21,[1 9],20,-1,41,-1,20
1,<environment.Job instance at 0x7f6cb3d48370>,20,27,[6 4],21,-1,48,-1,21
1,<environment.Job instance at 0x7f6cb3d9e1e0>,6,14,[5 4],7,-1,36,-1,22
1,<environment.Job instance at 0x7f6cb3d48190>,22,15,[10  1],23,-1,39,-1,24
1,<environment.Job instance at 0x7f6cb3dc12d0>,24,13,[1 8],25,-1,38,-1,25
1,<environment.Job instance at 0x7f6cb3dc1960>,25,3,[10  4],26,-1,29,-1,26
1,<environment.Job instance at 0x7f6cb3dc11e0>,26,14,[1 7],27,-1,41,-1,27
1,<environment.Job instance at 0x7f6cb3dc1fa0>,27,2,[ 2 10],28,-1,30,-1,28
1,<environment.Job instance at 0x7f6cb3dc1140>,28,22,[7 5],29,-1,51,-1,29
1,<environment.Job instance at 0x7f6cb3d48230>,23,13,[7 5],24,-1,42,-1,29
1,<environment.Job instance at 0x7f6cb3dc1730>,30,18,[ 5 10],31,-1,49,-1,31
1,<environment.Job instance at 0x7f6cb3dc1a50>,33,16,[8 5],34,-1,51,-1,35
1,<environment.Job instance at 0x7f6cb3dc1870>,34,16,[9 4],35,-1,51,-1,35
1,<environment.Job instance at 0x7f6cb3dc1190>,36,15,[10  4],37,-1,56,-1,41
1,<environment.Job instance at 0x7f6cb3dc1b90>,38,17,[3 9],39,-1,67,-1,50
1,<environment.Job instance at 0x7f6cb3dc14b0>,40,14,[1 8],41,-1,64,-1,50
1,<environment.Job instance at 0x7f6cb3d7ac30>,46,12,[1 5],47,-1,66,-1,54
1,<environment.Job instance at 0x7f6cb3d7af00>,49,17,[1 9],50,-1,72,-1,55
1,<environment.Job instance at 0x7f6cb3d38b90>,59,18,[ 5 10],60,-1,78,-1,60
1,<environment.Job instance at 0x7f6cb3d38d20>,58,18,[6 5],59,-1,78,-1,60
1,<environment.Job instance at 0x7f6cb3d38190>,57,27,[9 3],58,-1,87,-1,60
1,<environment.Job instance at 0x7f6cb4f7f870>,61,12,[1 8],62,-1,76,-1,64
1,<environment.Job instance at 0x7f6cb47742d0>,64,17,[5 1],65,-1,82,-1,65
1,<environment.Job instance at 0x7f6cb4774fa0>,65,15,[ 1 10],66,-1,81,-1,66
1,<environment.Job instance at 0x7f6cb4a0be10>,72,17,[9 4],73,-1,94,-1,77
1,<environment.Job instance at 0x7f6cb4a0b050>,74,18,[ 4 11],75,-1,95,-1,77
1,<environment.Job instance at 0x7f6cb4a0baf0>,75,16,[9 4],76,-1,102,-1,86
1,<environment.Job instance at 0x7f6cb49b4c30>,77,15,[4 6],78,-1,101,-1,86
1,<environment.Job instance at 0x7f6cb4b50a50>,9,23,[6 5],10,-1,39,-1,16
1,<environment.Job instance at 0x7f6cb4bab5a0>,20,27,[6 4],21,-1,67,-1,40
1,<environment.Job instance at 0x7f6cb4737370>,21,1,[11  4],22,-1,41,-1,40
1,<environment.Job instance at 0x7f6cb4d09910>,32,24,[1 6],33,-1,96,-1,72
1,<environment.Job instance at 0x7f6cb480f690>,44,3,[ 2 12],45,-1,126,-1,123
1,<environment.Job instance at 0x7f6cb4d1b960>,51,2,[ 3 14],52,-1,143,-1,141
1,<environment.Job instance at 0x7f6cb4d05a50>,56,13,[12  4],57,-1,170,-1,157
1,<environment.Job instance at 0x7f6cb4d05a00>,57,27,[9 3],58,-1,185,-1,158
1,<environment.Job instance at 0x7f6cb4d3baa0>,66,12,[ 2 11],67,-1,198,-1,186
1,<environment.Job instance at 0x7f6cb3f1d550>,68,24,[4 7],69,-1,225,-1,201
1,<environment.Job instance at 0x7f6cb3f33690>,74,18,[ 4 11],75,-1,231,-1,213
1,<environment.Job instance at 0x7f6cb51333c0>,0,20,[4 6],1,-1,21,-1,1
1,<environment.Job instance at 0x7f6cb5133320>,12,17,[ 2 10],13,-1,31,-1,14
1,<environment.Job instance at 0x7f6cb51331e0>,14,12,[9 1],15,-1,27,-1,15
1,<environment.Job instance at 0x7f6cb3f5a0a0>,16,13,[4 7],17,-1,30,-1,17
1,<environment.Job instance at 0x7f6cb3f5a820>,18,20,[3 8],19,-1,39,-1,19
1,<environment.Job instance at 0x7f6cb3f5a500>,21,21,[4 7],22,-1,43,-1,22
1,<environment.Job instance at 0x7f6cb3f5a190>,23,15,[4 9],24,-1,39,-1,24
1,<environment.Job instance at 0x7f6cb3f5a690>,26,18,[6 3],27,-1,45,-1,27
1,<environment.Job instance at 0x7f6cb51330f0>,13,15,[5 5],14,-1,43,-1,28
1,<environment.Job instance at 0x7f6cb412c6e0>,29,19,[5 5],30,-1,50,-1,31
1,<environment.Job instance at 0x7f6cb412cfa0>,30,15,[10  4],31,-1,46,-1,31
1,<environment.Job instance at 0x7f6cb412c280>,46,18,[10  2],47,-1,287,-1,269
1,<environment.Job instance at 0x7f6cb5238d20>,57,27,[ 2 11],58,-1,296,-1,269
1,<environment.Job instance at 0x7f6cb412c730>,48,17,[9 5],49,-1,316,-1,299
1,<environment.Job instance at 0x7f6cb52382d0>,68,17,[3 7],69,-1,316,-1,299
1,<environment.Job instance at 0x7f6cb5238320>,64,13,[5 3],65,-1,312,-1,299
1,<environment.Job instance at 0x7f6cb5238780>,71,17,[2 7],72,-1,316,-1,299
1,<environment.Job instance at 0x7f6cb412c230>,49,16,[7 2],50,-1,315,-1,299
1,<environment.Job instance at 0x7f6cb5238960>,70,13,[5 3],71,-1,312,-1,299
1,<environment.Job instance at 0x7f6cb5238910>,72,17,[6 4],73,-1,316,-1,299
1,<environment.Job instance at 0x7f6cbe129960>,77,2,[7 2],78,-1,301,-1,299
1,<environment.Job instance at 0x7f6cbe129aa0>,78,12,[ 4 10],79,-1,311,-1,299
1,<environment.Job instance at 0x7f6cb3f5a3c0>,3,14,[ 1 11],4,-1,18,-1,4
1,<environment.Job instance at 0x7f6cbe129870>,5,16,[ 2 11],6,-1,22,-1,6
1,<environment.Job instance at 0x7f6cb4cbdb40>,8,2,[13  3],9,-1,11,-1,9
1,<environment.Job instance at 0x7f6cb5133dc0>,22,17,[ 2 11],23,-1,56,-1,39
1,<environment.Job instance at 0x7f6cb4d3bb90>,24,1,[ 2 11],25,-1,40,-1,39
1,<environment.Job instance at 0x7f6cb5133af0>,20,24,[10  4],21,-1,64,-1,40
1,<environment.Job instance at 0x7f6cb4d05280>,39,1,[ 5 14],40,-1,95,-1,94
1,<environment.Job instance at 0x7f6cb41103c0>,57,27,[ 2 11],58,-1,201,-1,174
1,<environment.Job instance at 0x7f6cbe12fe10>,59,3,[11  2],60,-1,182,-1,179
1,<environment.Job instance at 0x7f6cb4fa3d70>,62,1,[12  5],63,-1,185,-1,184
1,<environment.Job instance at 0x7f6cbdb7d820>,2,16,[ 3 10],3,-1,19,-1,3
1,<environment.Job instance at 0x7f6cbdb7d230>,3,18,[5 5],4,-1,22,-1,4
1,<environment.Job instance at 0x7f6cbdb7deb0>,4,16,[5 5],5,-1,21,-1,5
1,<environment.Job instance at 0x7f6cbdb7d140>,5,17,[ 3 10],6,-1,23,-1,6
1,<environment.Job instance at 0x7f6cbdb7df00>,8,18,[1 5],9,-1,27,-1,9
1,<environment.Job instance at 0x7f6cbdb7d3c0>,9,18,[9 5],10,-1,28,-1,10
1,<environment.Job instance at 0x7f6cbdb7daf0>,10,19,[4 5],11,-1,30,-1,11
1,<environment.Job instance at 0x7f6cbdb7dc30>,12,13,[9 4],13,-1,26,-1,13
1,<environment.Job instance at 0x7f6cbdb7d370>,14,16,[2 7],15,-1,31,-1,15
1,<environment.Job instance at 0x7f6cbdb7d410>,18,16,[8 3],19,-1,35,-1,19
1,<environment.Job instance at 0x7f6cb50df0f0>,20,23,[9 4],21,-1,44,-1,21
1,<environment.Job instance at 0x7f6cb50df960>,21,21,[8 2],22,-1,44,-1,23
1,<environment.Job instance at 0x7f6cb50df690>,23,1,[10  1],24,-1,25,-1,24
1,<environment.Job instance at 0x7f6cb50df410>,24,17,[9 2],25,-1,42,-1,25
1,<environment.Job instance at 0x7f6cb50df320>,25,18,[5 5],26,-1,44,-1,26
1,<environment.Job instance at 0x7f6cb50df910>,26,2,[5 9],27,-1,29,-1,27
1,<environment.Job instance at 0x7f6cb50dfe10>,27,2,[10  3],28,-1,30,-1,28
1,<environment.Job instance at 0x7f6cb50df460>,28,28,[10  4],29,-1,57,-1,29
1,<environment.Job instance at 0x7f6cb50dff50>,29,14,[5 1],30,-1,44,-1,30
1,<environment.Job instance at 0x7f6cb50df190>,30,3,[5 7],31,-1,34,-1,31
1,<environment.Job instance at 0x7f6cb50df5f0>,31,1,[7 3],32,-1,33,-1,32
1,<environment.Job instance at 0x7f6cb50dfe60>,32,18,[4 7],33,-1,51,-1,33
1,<environment.Job instance at 0x7f6cb50df820>,33,18,[7 1],34,-1,52,-1,34
1,<environment.Job instance at 0x7f6cb50df870>,34,14,[9 1],35,-1,49,-1,35
1,<environment.Job instance at 0x7f6cb50dffa0>,35,12,[7 1],36,-1,48,-1,36
1,<environment.Job instance at 0x7f6cb50dfa50>,36,18,[8 3],37,-1,55,-1,37
1,<environment.Job instance at 0x7f6cb50dfa00>,22,21,[5 7],23,-1,59,-1,38
1,<environment.Job instance at 0x7f6cb50e4460>,47,23,[5 3],48,-1,71,-1,48
1,<environment.Job instance at 0x7f6cb50e4cd0>,48,16,[9 4],49,-1,65,-1,49
1,<environment.Job instance at 0x7f6cb50e4370>,49,15,[5 7],50,-1,66,-1,51
1,<environment.Job instance at 0x7f6cb50e4910>,51,18,[11  2],52,-1,70,-1,52
1,<environment.Job instance at 0x7f6cb50e4a50>,55,14,[ 1 10],56,-1,79,-1,65
1,<environment.Job instance at 0x7f6cb50a2460>,62,14,[3 9],63,-1,83,-1,69
1,<environment.Job instance at 0x7f6cb50a2af0>,56,18,[7 4],57,-1,87,-1,69
1,<environment.Job instance at 0x7f6cbdaf0e60>,20,23,[9 4],21,-1,92,-1,69
1,<environment.Job instance at 0x7f6cb3dc1c80>,28,28,[10  4],29,-1,115,-1,87
1,<environment.Job instance at 0x7f6cb480f820>,38,17,[12  1],39,-1,137,-1,120
1,<environment.Job instance at 0x7f6cb480f550>,40,26,[4 9],41,-1,152,-1,126
1,<environment.Job instance at 0x7f6cb480f870>,42,16,[13  1],43,-1,142,-1,126
1,<environment.Job instance at 0x7f6cb4d1ba50>,47,23,[5 3],48,-1,164,-1,141
1,<environment.Job instance at 0x7f6cb4d1b9b0>,51,18,[11  2],52,-1,174,-1,156
1,<environment.Job instance at 0x7f6cb4d05960>,52,12,[ 5 13],53,-1,168,-1,156
1,<environment.Job instance at 0x7f6cb4d052d0>,53,24,[ 5 11],54,-1,180,-1,156
1,<environment.Job instance at 0x7f6cb3f1de10>,60,13,[11  2],61,-1,197,-1,184
1,<environment.Job instance at 0x7f6cb5133af0>,67,16,[ 3 12],68,-1,232,-1,216
1,<environment.Job instance at 0x7f6cb50711e0>,0,16,[ 2 10],1,-1,19,-1,3
1,<environment.Job instance at 0x7f6cb50710a0>,3,2,[3 5],4,-1,6,-1,4
1,<environment.Job instance at 0x7f6cb5071c80>,4,14,[6 4],5,-1,19,-1,5
1,<environment.Job instance at 0x7f6cb5071a00>,5,18,[ 5 10],6,-1,24,-1,6
1,<environment.Job instance at 0x7f6cb5071370>,6,25,[6 3],7,-1,32,-1,7
1,<environment.Job instance at 0x7f6cb5071eb0>,8,2,[2 8],9,-1,11,-1,9
1,<environment.Job instance at 0x7f6cb50710f0>,9,12,[9 4],10,-1,22,-1,10
1,<environment.Job instance at 0x7f6cb5071d70>,10,2,[5 4],11,-1,13,-1,11
1,<environment.Job instance at 0x7f6cb50717d0>,12,1,[6 3],13,-1,14,-1,13
1,<environment.Job instance at 0x7f6cb5071910>,2,15,[5 9],3,-1,29,-1,14
1,<environment.Job instance at 0x7f6cb523f0a0>,17,18,[3 8],18,-1,36,-1,18
1,<environment.Job instance at 0x7f6cb523f1e0>,21,18,[10  5],22,-1,40,-1,22
1,<environment.Job instance at 0x7f6cb523fa00>,25,18,[9 2],26,-1,46,-1,28
1,<environment.Job instance at 0x7f6cb51b7e60>,27,20,[1 8],28,-1,49,-1,29
1,<environment.Job instance at 0x7f6cb51b7e10>,33,16,[8 1],34,-1,50,-1,34
1,<environment.Job instance at 0x7f6cb51b73c0>,34,3,[2 7],35,-1,38,-1,35
1,<environment.Job instance at 0x7f6cb51b7640>,35,23,[8 4],36,-1,59,-1,36
1,<environment.Job instance at 0x7f6cb51b7dc0>,36,12,[3 9],37,-1,49,-1,37
1,<environment.Job instance at 0x7f6cb51b75a0>,37,20,[5 7],38,-1,58,-1,38
1,<environment.Job instance at 0x7f6cb51b7aa0>,38,16,[4 8],39,-1,55,-1,39
1,<environment.Job instance at 0x7f6cb51b7af0>,39,18,[6 1],40,-1,58,-1,40
1,<environment.Job instance at 0x7f6cb3d893c0>,40,15,[2 8],41,-1,56,-1,41
1,<environment.Job instance at 0x7f6cb3d89e10>,45,16,[10  5],46,-1,62,-1,46
1,<environment.Job instance at 0x7f6cb3d89d20>,47,16,[1 7],48,-1,64,-1,48
1,<environment.Job instance at 0x7f6cb3d89eb0>,49,18,[2 7],50,-1,68,-1,50
1,<environment.Job instance at 0x7f6cb4bca500>,50,15,[4 7],51,-1,66,-1,51
1,<environment.Job instance at 0x7f6cb4bcaa00>,53,16,[9 4],54,-1,71,-1,55
1,<environment.Job instance at 0x7f6cbdeac280>,62,15,[ 2 10],63,-1,78,-1,63
1,<environment.Job instance at 0x7f6cb5529eb0>,64,17,[8 1],65,-1,82,-1,65
1,<environment.Job instance at 0x7f6cb4a52730>,66,19,[2 9],67,-1,86,-1,67
1,<environment.Job instance at 0x7f6cb4faf410>,68,20,[ 1 10],69,-1,89,-1,69
1,<environment.Job instance at 0x7f6cb539b140>,69,18,[2 7],70,-1,88,-1,70
1,<environment.Job instance at 0x7f6cb5394a50>,71,18,[3 8],72,-1,90,-1,72
1,<environment.Job instance at 0x7f6cb4cbaa00>,73,14,[ 4 10],74,-1,88,-1,74
1,<environment.Job instance at 0x7f6cb5394eb0>,74,15,[4 8],75,-1,90,-1,75
1,<environment.Job instance at 0x7f6cb53dc0a0>,76,16,[1 6],77,-1,93,-1,77
1,<environment.Job instance at 0x7f6cb4fbc8c0>,6,25,[6 3],7,-1,42,-1,17
1,<environment.Job instance at 0x7f6cb4424f00>,13,2,[14  3],14,-1,22,-1,20
1,<environment.Job instance at 0x7f6cb5071f00>,14,1,[14  5],15,-1,21,-1,20
1,<environment.Job instance at 0x7f6cb444b820>,23,1,[12  4],24,-1,37,-1,36
1,<environment.Job instance at 0x7f6cb445e140>,30,2,[ 2 12],31,-1,49,-1,47
1,<environment.Job instance at 0x7f6cb448baa0>,35,23,[8 4],36,-1,92,-1,69
1,<environment.Job instance at 0x7f6cb447c2d0>,44,15,[11  1],45,-1,108,-1,93
1,<environment.Job instance at 0x7f6cb44850f0>,51,20,[ 5 13],52,-1,144,-1,124
1,<environment.Job instance at 0x7f6cb4cf1d20>,60,24,[7 2],61,-1,176,-1,152
1,<environment.Job instance at 0x7f6cb44746e0>,65,15,[ 1 12],66,-1,185,-1,170
1,<environment.Job instance at 0x7f6cb4757910>,78,2,[ 1 13],79,-1,222,-1,220
1,<environment.Job instance at 0x7f6cb4b5ec30>,1,28,[5 1],2,-1,30,-1,2
1,<environment.Job instance at 0x7f6cb4b5e500>,7,13,[9 1],8,-1,21,-1,8
1,<environment.Job instance at 0x7f6cb4b5e4b0>,12,13,[9 1],13,-1,27,-1,14
1,<environment.Job instance at 0x7f6cb4b5e280>,13,23,[7 4],14,-1,37,-1,14
1,<environment.Job instance at 0x7f6cb4b71140>,15,12,[2 8],16,-1,29,-1,17
1,<environment.Job instance at 0x7f6cb4b71410>,17,17,[10  4],18,-1,35,-1,18
1,<environment.Job instance at 0x7f6cb4b71d20>,16,12,[9 5],17,-1,31,-1,19
1,<environment.Job instance at 0x7f6cb4b71fa0>,21,14,[9 4],22,-1,39,-1,25
1,<environment.Job instance at 0x7f6cb4b71a00>,25,18,[7 5],26,-1,44,-1,26
1,<environment.Job instance at 0x7f6cb4b3e280>,26,27,[5 2],27,-1,54,-1,27
1,<environment.Job instance at 0x7f6cb4b3e690>,28,13,[1 5],29,-1,42,-1,29
1,<environment.Job instance at 0x7f6cb4b3e500>,29,18,[ 2 10],30,-1,48,-1,30
1,<environment.Job instance at 0x7f6cb4b3e410>,30,22,[2 5],31,-1,53,-1,31
1,<environment.Job instance at 0x7f6cb4b41f00>,38,18,[5 8],39,-1,63,-1,45
1,<environment.Job instance at 0x7f6cb4b41320>,46,17,[3 5],47,-1,67,-1,50
1,<environment.Job instance at 0x7f6cb4b728c0>,48,15,[5 8],49,-1,66,-1,51
1,<environment.Job instance at 0x7f6cb4b413c0>,44,28,[4 5],45,-1,81,-1,53
1,<environment.Job instance at 0x7f6cb4b71820>,18,18,[13  5],19,-1,76,-1,58
1,<environment.Job instance at 0x7f6cb4b726e0>,50,13,[5 6],51,-1,71,-1,58
1,<environment.Job instance at 0x7f6cb4b725a0>,54,13,[ 5 10],55,-1,72,-1,59
1,<environment.Job instance at 0x7f6cb4b72be0>,55,15,[8 1],56,-1,74,-1,59
1,<environment.Job instance at 0x7f6cb4b72a50>,51,25,[10  1],52,-1,84,-1,59
1,<environment.Job instance at 0x7f6cb4b72960>,58,18,[5 5],59,-1,77,-1,59
1,<environment.Job instance at 0x7f6cb5066870>,60,16,[7 5],61,-1,80,-1,64
1,<environment.Job instance at 0x7f6cb4b41af0>,43,14,[ 5 10],44,-1,79,-1,65
1,<environment.Job instance at 0x7f6cb5066780>,64,17,[2 5],65,-1,89,-1,72
1,<environment.Job instance at 0x7f6cb5066cd0>,66,15,[3 5],67,-1,88,-1,73
1,<environment.Job instance at 0x7f6cb5066640>,63,17,[5 9],64,-1,91,-1,74
1,<environment.Job instance at 0x7f6cb5066140>,67,25,[9 4],68,-1,103,-1,78
1,<environment.Job instance at 0x7f6cb50665f0>,65,21,[9 3],66,-1,99,-1,78
1,<environment.Job instance at 0x7f6cb5066c80>,73,12,[10  1],74,-1,90,-1,78
1,<environment.Job instance at 0x7f6cb5066fa0>,72,16,[9 4],73,-1,94,-1,78
1,<environment.Job instance at 0x7f6cb5066f50>,76,18,[8 1],77,-1,105,-1,87
1,<environment.Job instance at 0x7f6cb4b5e2d0>,0,28,[ 2 14],1,-1,29,-1,1
1,<environment.Job instance at 0x7f6cb4b71aa0>,1,28,[5 1],2,-1,30,-1,2
1,<environment.Job instance at 0x7f6cb46d3870>,13,23,[7 4],14,-1,38,-1,15
1,<environment.Job instance at 0x7f6cb4acf2d0>,18,18,[13  5],19,-1,37,-1,19
1,<environment.Job instance at 0x7f6cb4acf140>,23,3,[13  5],24,-1,47,-1,44
1,<environment.Job instance at 0x7f6cb551b050>,26,27,[5 2],27,-1,75,-1,48
1,<environment.Job instance at 0x7f6cb551bc30>,27,14,[ 3 14],28,-1,62,-1,48
1,<environment.Job instance at 0x7f6cb4e71eb0>,44,28,[4 5],45,-1,140,-1,112
1,<environment.Job instance at 0x7f6cb4e715a0>,47,2,[ 5 13],48,-1,115,-1,113
1,<environment.Job instance at 0x7f6cb4e71190>,51,25,[10  1],52,-1,167,-1,142
1,<environment.Job instance at 0x7f6cb4e4c3c0>,67,25,[9 4],68,-1,233,-1,208
1,<environment.Job instance at 0x7f6cb5066b40>,6,17,[2 6],7,-1,25,-1,8
1,<environment.Job instance at 0x7f6cb42e5a00>,8,18,[5 3],9,-1,27,-1,9
1,<environment.Job instance at 0x7f6cb42e5730>,10,13,[2 6],11,-1,24,-1,11
1,<environment.Job instance at 0x7f6cb42e5460>,11,13,[10  4],12,-1,25,-1,12
1,<environment.Job instance at 0x7f6cb42e5f50>,12,15,[8 4],13,-1,28,-1,13
1,<environment.Job instance at 0x7f6cb42e5f00>,13,24,[5 3],14,-1,38,-1,14
1,<environment.Job instance at 0x7f6cb42e5550>,14,15,[5 6],15,-1,30,-1,15
1,<environment.Job instance at 0x7f6cb42e5af0>,18,12,[9 3],19,-1,34,-1,22
1,<environment.Job instance at 0x7f6cb42e5640>,24,12,[9 1],25,-1,37,-1,25
1,<environment.Job instance at 0x7f6cb430d690>,25,15,[3 9],26,-1,41,-1,26
1,<environment.Job instance at 0x7f6cb4da3e60>,27,17,[1 9],28,-1,45,-1,28
1,<environment.Job instance at 0x7f6cb4fd1e10>,29,18,[7 5],30,-1,48,-1,30
1,<environment.Job instance at 0x7f6cb4fd1f00>,30,17,[10  1],31,-1,49,-1,32
1,<environment.Job instance at 0x7f6cb4fd1cd0>,32,13,[7 2],33,-1,46,-1,33
1,<environment.Job instance at 0x7f6cb42e5c30>,21,28,[9 4],22,-1,61,-1,33
1,<environment.Job instance at 0x7f6cb4fd14b0>,39,15,[10  2],40,-1,55,-1,40
1,<environment.Job instance at 0x7f6cb4da3fa0>,28,19,[ 3 11],29,-1,61,-1,42
1,<environment.Job instance at 0x7f6cb4fd1e60>,40,12,[7 4],41,-1,54,-1,42
1,<environment.Job instance at 0x7f6cb4fd1be0>,41,1,[4 5],42,-1,43,-1,42
1,<environment.Job instance at 0x7f6cb4d88a50>,43,15,[3 9],44,-1,59,-1,44
1,<environment.Job instance at 0x7f6cb4fd1b40>,44,16,[7 4],45,-1,61,-1,45
1,<environment.Job instance at 0x7f6cb4a5e410>,48,17,[9 5],49,-1,66,-1,49
1,<environment.Job instance at 0x7f6cb4a5e1e0>,47,13,[14  4],48,-1,68,-1,55
1,<environment.Job instance at 0x7f6cb4599d70>,51,18,[4 7],52,-1,73,-1,55
1,<environment.Job instance at 0x7f6cb4599c80>,53,17,[9 1],54,-1,72,-1,55
1,<environment.Job instance at 0x7f6cb45998c0>,54,22,[4 9],55,-1,77,-1,55
1,<environment.Job instance at 0x7f6cb4599b90>,56,21,[5 5],57,-1,78,-1,57
1,<environment.Job instance at 0x7f6cb4599f50>,59,15,[3 9],60,-1,75,-1,60
1,<environment.Job instance at 0x7f6cb45990f0>,60,15,[5 5],61,-1,77,-1,62
1,<environment.Job instance at 0x7f6cb4599780>,52,14,[4 6],53,-1,77,-1,63
1,<environment.Job instance at 0x7f6cb3c2e8c0>,64,15,[10  2],65,-1,80,-1,65
1,<environment.Job instance at 0x7f6cb3c2e190>,65,25,[1 6],66,-1,94,-1,69
1,<environment.Job instance at 0x7f6cb3c2e780>,72,20,[ 5 10],73,-1,93,-1,73
1,<environment.Job instance at 0x7f6cb3c2e7d0>,74,12,[9 1],75,-1,88,-1,76
1,<environment.Job instance at 0x7f6cb3c2efa0>,75,24,[8 3],76,-1,101,-1,77
1,<environment.Job instance at 0x7f6cb3d40aa0>,77,12,[5 9],78,-1,90,-1,78
1,<environment.Job instance at 0x7f6cb42e56e0>,2,18,[ 2 12],3,-1,21,-1,3
1,<environment.Job instance at 0x7f6cb4e49730>,13,24,[5 3],14,-1,50,-1,26
1,<environment.Job instance at 0x7f6cb4e4c280>,17,2,[11  4],18,-1,40,-1,38
1,<environment.Job instance at 0x7f6cb4e4cf00>,21,28,[9 4],22,-1,81,-1,53
1,<environment.Job instance at 0x7f6cb4e4c9b0>,23,16,[ 1 12],24,-1,69,-1,53
1,<environment.Job instance at 0x7f6cb4e710f0>,28,19,[ 3 11],29,-1,83,-1,64
1,<environment.Job instance at 0x7f6cb4b40280>,47,13,[14  4],48,-1,160,-1,147
1,<environment.Job instance at 0x7f6cb4b3e5a0>,63,2,[13  2],64,-1,209,-1,207
1,<environment.Job instance at 0x7f6cb3cd4c80>,65,25,[1 6],66,-1,244,-1,219
1,<environment.Job instance at 0x7f6cb3cd4fa0>,70,27,[11  2],71,-1,262,-1,235
1,<environment.Job instance at 0x7f6cb3cd4370>,75,24,[8 3],76,-1,270,-1,246
1,<environment.Job instance at 0x7f6cb3cbfa00>,1,16,[3 9],2,-1,18,-1,2
1,<environment.Job instance at 0x7f6cb3cd35f0>,5,17,[10  3],6,-1,24,-1,7
1,<environment.Job instance at 0x7f6cb3cbf3c0>,6,18,[6 4],7,-1,25,-1,7
1,<environment.Job instance at 0x7f6cb3cd3320>,7,24,[5 9],8,-1,32,-1,8
1,<environment.Job instance at 0x7f6cb4775f00>,11,28,[3 6],12,-1,40,-1,12
1,<environment.Job instance at 0x7f6cb3cd3140>,12,14,[ 4 10],13,-1,27,-1,13
1,<environment.Job instance at 0x7f6cb3cbdaf0>,15,16,[7 3],16,-1,32,-1,16
1,<environment.Job instance at 0x7f6cb3cbdd70>,17,16,[1 8],18,-1,34,-1,18
1,<environment.Job instance at 0x7f6cb3cbdaa0>,19,26,[2 6],20,-1,46,-1,20
1,<environment.Job instance at 0x7f6cb43e6550>,20,20,[9 3],21,-1,41,-1,21
1,<environment.Job instance at 0x7f6cb43e6640>,21,15,[8 4],22,-1,37,-1,22
1,<environment.Job instance at 0x7f6cb43e69b0>,22,14,[9 2],23,-1,37,-1,23
1,<environment.Job instance at 0x7f6cb43e6eb0>,23,16,[2 6],24,-1,40,-1,24
1,<environment.Job instance at 0x7f6cb4761640>,25,17,[5 3],26,-1,43,-1,26
1,<environment.Job instance at 0x7f6cb4761d20>,28,26,[8 2],29,-1,55,-1,29
1,<environment.Job instance at 0x7f6cb4761320>,32,16,[9 2],33,-1,49,-1,33
1,<environment.Job instance at 0x7f6cbdc17280>,33,18,[4 6],34,-1,52,-1,34
1,<environment.Job instance at 0x7f6cbdc17820>,34,13,[2 8],35,-1,48,-1,35
1,<environment.Job instance at 0x7f6cb4fa0c80>,36,17,[3 7],37,-1,54,-1,37
1,<environment.Job instance at 0x7f6cb4fa0280>,37,12,[1 6],38,-1,50,-1,38
1,<environment.Job instance at 0x7f6cb4fa0dc0>,39,17,[5 7],40,-1,57,-1,40
1,<environment.Job instance at 0x7f6cb5095190>,42,18,[7 4],43,-1,61,-1,43
1,<environment.Job instance at 0x7f6cb5095780>,49,15,[3 9],50,-1,65,-1,50
1,<environment.Job instance at 0x7f6cb3ceeaa0>,53,16,[3 8],54,-1,70,-1,54
1,<environment.Job instance at 0x7f6cb43e09b0>,52,14,[ 2 10],53,-1,69,-1,55
1,<environment.Job instance at 0x7f6cb43e0d20>,54,13,[10  5],55,-1,68,-1,55
1,<environment.Job instance at 0x7f6cb43e0410>,55,19,[1 5],56,-1,76,-1,57
1,<environment.Job instance at 0x7f6cb3e404b0>,58,16,[3 8],59,-1,75,-1,59
1,<environment.Job instance at 0x7f6cb43e0d70>,60,18,[9 2],61,-1,79,-1,61
1,<environment.Job instance at 0x7f6cb4399410>,62,17,[9 4],63,-1,80,-1,63
1,<environment.Job instance at 0x7f6cb3cf1500>,64,27,[6 1],65,-1,92,-1,65
1,<environment.Job instance at 0x7f6cb436d730>,65,14,[4 8],66,-1,80,-1,66
1,<environment.Job instance at 0x7f6cb54f3910>,66,17,[ 5 11],67,-1,84,-1,67
1,<environment.Job instance at 0x7f6cb518a6e0>,69,16,[10  5],70,-1,86,-1,70
1,<environment.Job instance at 0x7f6cb51520f0>,70,12,[4 8],71,-1,83,-1,71
1,<environment.Job instance at 0x7f6cb4191b40>,7,24,[5 9],8,-1,42,-1,18
1,<environment.Job instance at 0x7f6cb4194c80>,11,28,[3 6],12,-1,47,-1,19
1,<environment.Job instance at 0x7f6cb4eb7320>,19,26,[2 6],20,-1,79,-1,53
1,<environment.Job instance at 0x7f6cb4c69b90>,27,1,[ 1 13],28,-1,77,-1,76
1,<environment.Job instance at 0x7f6cb3f70b40>,28,26,[8 2],29,-1,111,-1,85
1,<environment.Job instance at 0x7f6cb4190d70>,35,25,[ 3 14],36,-1,125,-1,100
1,<environment.Job instance at 0x7f6cb4f2ad20>,41,3,[ 4 13],42,-1,126,-1,123
1,<environment.Job instance at 0x7f6cb4d44be0>,44,27,[13  3],45,-1,153,-1,126
1,<environment.Job instance at 0x7f6cb4d61a00>,64,27,[6 1],65,-1,248,-1,221
1,<environment.Job instance at 0x7f6cb4d6ff50>,66,17,[ 5 11],67,-1,238,-1,221
1,<environment.Job instance at 0x7f6cb45d9370>,71,24,[14  3],72,-1,260,-1,236
1,<environment.Job instance at 0x7f6cb4a6b5a0>,73,24,[10  2],74,-1,276,-1,252
1,<environment.Job instance at 0x7f6cb4a6ba00>,0,18,[6 4],1,-1,19,-1,1
1,<environment.Job instance at 0x7f6cb53355a0>,5,16,[7 3],6,-1,22,-1,6
1,<environment.Job instance at 0x7f6cb5335280>,7,13,[10  4],8,-1,22,-1,9
1,<environment.Job instance at 0x7f6cb3cfef50>,9,13,[8 2],10,-1,23,-1,10
1,<environment.Job instance at 0x7f6cb3cfe550>,10,13,[12  1],11,-1,27,-1,14
1,<environment.Job instance at 0x7f6cb3cfe140>,11,16,[ 5 11],12,-1,30,-1,14
1,<environment.Job instance at 0x7f6cb3cfe640>,14,3,[10  2],15,-1,18,-1,15
1,<environment.Job instance at 0x7f6cb3cfe870>,15,27,[4 5],16,-1,43,-1,16
1,<environment.Job instance at 0x7f6cb3cfe960>,16,1,[12  2],17,-1,18,-1,17
1,<environment.Job instance at 0x7f6cb3cfe0f0>,17,18,[1 6],18,-1,37,-1,19
1,<environment.Job instance at 0x7f6cb3cfed70>,12,16,[5 4],13,-1,35,-1,19
1,<environment.Job instance at 0x7f6cb3cfe500>,20,17,[9 2],21,-1,39,-1,22
1,<environment.Job instance at 0x7f6cb4f25c80>,26,25,[7 3],27,-1,52,-1,27
1,<environment.Job instance at 0x7f6cb4f25320>,29,18,[6 2],30,-1,48,-1,30
1,<environment.Job instance at 0x7f6cb4f25960>,30,26,[6 4],31,-1,57,-1,31
1,<environment.Job instance at 0x7f6cb4f25a50>,32,13,[ 3 10],33,-1,46,-1,33
1,<environment.Job instance at 0x7f6cb4f259b0>,33,14,[ 4 10],34,-1,48,-1,34
1,<environment.Job instance at 0x7f6cb4f25370>,35,14,[5 7],36,-1,50,-1,36
1,<environment.Job instance at 0x7f6cb4f25410>,36,16,[9 2],37,-1,53,-1,37
1,<environment.Job instance at 0x7f6cb4f25730>,37,21,[9 4],38,-1,59,-1,38
1,<environment.Job instance at 0x7f6cb4ed48c0>,38,21,[5 1],39,-1,60,-1,39
1,<environment.Job instance at 0x7f6cb4ed4820>,45,16,[4 9],46,-1,62,-1,46
1,<environment.Job instance at 0x7f6cb4ed4870>,46,18,[5 5],47,-1,65,-1,47
1,<environment.Job instance at 0x7f6cb4ed4280>,49,20,[5 9],50,-1,70,-1,50
1,<environment.Job instance at 0x7f6cb54e3640>,50,17,[ 5 10],51,-1,68,-1,51
1,<environment.Job instance at 0x7f6cb54e3dc0>,51,14,[10  1],52,-1,67,-1,53
1,<environment.Job instance at 0x7f6cb4ed4730>,52,18,[3 8],53,-1,73,-1,55
1,<environment.Job instance at 0x7f6cb3f7dbe0>,62,18,[3 7],63,-1,81,-1,63
1,<environment.Job instance at 0x7f6cb3f7d190>,65,13,[9 1],66,-1,81,-1,68
1,<environment.Job instance at 0x7f6cb3f7d6e0>,68,14,[ 1 10],69,-1,83,-1,69
1,<environment.Job instance at 0x7f6cb3f7dd70>,70,25,[5 3],71,-1,96,-1,71
1,<environment.Job instance at 0x7f6cb3f7d870>,71,16,[11  2],72,-1,88,-1,72
1,<environment.Job instance at 0x7f6cb3f7db40>,73,13,[5 6],74,-1,87,-1,74
1,<environment.Job instance at 0x7f6cb3f7d320>,74,13,[3 6],75,-1,88,-1,75
1,<environment.Job instance at 0x7f6cb3cfdfa0>,76,13,[8 1],77,-1,90,-1,77
1,<environment.Job instance at 0x7f6cb3cfd6e0>,78,16,[10  3],79,-1,95,-1,79
1,<environment.Job instance at 0x7f6cb4d43730>,10,13,[12  1],11,-1,34,-1,21
1,<environment.Job instance at 0x7f6cb4ee0190>,11,16,[ 5 11],12,-1,37,-1,21
1,<environment.Job instance at 0x7f6cb5374050>,15,27,[4 5],16,-1,57,-1,30
1,<environment.Job instance at 0x7f6cb4c429b0>,16,1,[12  2],17,-1,31,-1,30
1,<environment.Job instance at 0x7f6cb3d0a730>,26,25,[7 3],27,-1,82,-1,57
1,<environment.Job instance at 0x7f6cb4f25eb0>,30,26,[6 4],31,-1,102,-1,76
1,<environment.Job instance at 0x7f6cb4edab40>,64,1,[13  5],65,-1,175,-1,174
1,<environment.Job instance at 0x7f6cb4c65d20>,70,25,[5 3],71,-1,219,-1,194
1,<environment.Job instance at 0x7f6cb4c650a0>,71,16,[11  2],72,-1,210,-1,194
1,<environment.Job instance at 0x7f6cb42d5b40>,4,17,[2 7],5,-1,23,-1,6
1,<environment.Job instance at 0x7f6cb42d5640>,7,16,[5 4],8,-1,24,-1,8
1,<environment.Job instance at 0x7f6cb42d5d70>,8,17,[6 5],9,-1,26,-1,9
1,<environment.Job instance at 0x7f6cb42d5cd0>,9,18,[5 1],10,-1,28,-1,10
1,<environment.Job instance at 0x7f6cb42d5e60>,10,16,[1 7],11,-1,27,-1,11
1,<environment.Job instance at 0x7f6cb42d5fa0>,12,17,[6 4],13,-1,30,-1,13
1,<environment.Job instance at 0x7f6cb44ee460>,16,15,[5 6],17,-1,32,-1,17
1,<environment.Job instance at 0x7f6cb44ffc30>,39,17,[9 4],40,-1,57,-1,40
1,<environment.Job instance at 0x7f6cb44ff6e0>,35,16,[10  3],36,-1,64,-1,48
1,<environment.Job instance at 0x7f6cb44ee690>,2,23,[3 7],3,-1,27,-1,4
1,<environment.Job instance at 0x7f6cb44ff0f0>,6,3,[ 5 14],7,-1,10,-1,7
1,<environment.Job instance at 0x7f6cb4c65e10>,17,16,[11  1],18,-1,53,-1,37
1,<environment.Job instance at 0x7f6cb3cfd0f0>,27,16,[ 5 13],28,-1,85,-1,69
1,<environment.Job instance at 0x7f6cb3cfdc80>,29,2,[13  4],30,-1,72,-1,70
1,<environment.Job instance at 0x7f6cb54e3b40>,33,20,[ 5 12],34,-1,93,-1,73
1,<environment.Job instance at 0x7f6cb54e34b0>,34,2,[ 5 11],35,-1,75,-1,73
1,<environment.Job instance at 0x7f6cb4f251e0>,41,2,[ 5 11],42,-1,94,-1,92
1,<environment.Job instance at 0x7f6cb5374050>,49,13,[ 4 14],50,-1,135,-1,122
1,<environment.Job instance at 0x7f6cb4d6f410>,56,16,[13  1],57,-1,155,-1,139
1,<environment.Job instance at 0x7f6cb4498b90>,66,27,[2 9],67,-1,204,-1,177
1,<environment.Job instance at 0x7f6cb4bff6e0>,73,14,[14  4],74,-1,218,-1,204
1,<environment.Job instance at 0x7f6cb4bfff50>,75,3,[ 1 13],76,-1,207,-1,204
1,<environment.Job instance at 0x7f6cb4bff780>,76,2,[14  2],77,-1,206,-1,204
1,<environment.Job instance at 0x7f6cb4bf3050>,77,15,[ 5 12],78,-1,219,-1,204
1,<environment.Job instance at 0x7f6cb4662a00>,1,27,[8 5],2,-1,30,-1,3
1,<environment.Job instance at 0x7f6cb4deafa0>,7,18,[1 9],8,-1,27,-1,9
1,<environment.Job instance at 0x7f6cb3c9c320>,8,16,[13  2],9,-1,25,-1,9
1,<environment.Job instance at 0x7f6cb4dea320>,12,18,[10  5],13,-1,32,-1,14
1,<environment.Job instance at 0x7f6cb4dea280>,14,17,[10  5],15,-1,32,-1,15
1,<environment.Job instance at 0x7f6cb4dea500>,15,18,[5 6],16,-1,34,-1,16
1,<environment.Job instance at 0x7f6cb4dea140>,17,15,[ 4 10],18,-1,33,-1,18
1,<environment.Job instance at 0x7f6cb4dea550>,13,26,[7 1],14,-1,44,-1,18
1,<environment.Job instance at 0x7f6cb47bd5f0>,22,18,[9 1],23,-1,42,-1,24
1,<environment.Job instance at 0x7f6cb47bd9b0>,26,13,[1 6],27,-1,40,-1,27
1,<environment.Job instance at 0x7f6cb47bdb40>,29,12,[5 8],30,-1,42,-1,30
1,<environment.Job instance at 0x7f6cb47bd410>,30,12,[4 6],31,-1,43,-1,31
1,<environment.Job instance at 0x7f6cb47bdeb0>,32,18,[1 9],33,-1,51,-1,33
1,<environment.Job instance at 0x7f6cb47bdc80>,34,18,[7 1],35,-1,53,-1,35
1,<environment.Job instance at 0x7f6cb4dae0a0>,38,15,[3 8],39,-1,54,-1,39
1,<environment.Job instance at 0x7f6cb4daefa0>,39,25,[3 6],40,-1,65,-1,40
1,<environment.Job instance at 0x7f6cb4daecd0>,44,17,[8 5],45,-1,62,-1,45
1,<environment.Job instance at 0x7f6cb4dae4b0>,46,16,[1 5],47,-1,63,-1,47
1,<environment.Job instance at 0x7f6cb4dae320>,48,13,[10  4],49,-1,62,-1,49
1,<environment.Job instance at 0x7f6cb4dae7d0>,49,19,[2 5],50,-1,69,-1,50
1,<environment.Job instance at 0x7f6cb472b050>,54,18,[ 4 10],55,-1,73,-1,55
1,<environment.Job instance at 0x7f6cb472be60>,56,15,[ 3 10],57,-1,72,-1,57
1,<environment.Job instance at 0x7f6cb472b140>,63,18,[9 2],64,-1,83,-1,65
1,<environment.Job instance at 0x7f6cb472b500>,64,15,[6 2],65,-1,82,-1,67
1,<environment.Job instance at 0x7f6cb4dae5f0>,41,16,[ 5 12],42,-1,83,-1,67
1,<environment.Job instance at 0x7f6cb472bb90>,59,12,[7 5],60,-1,79,-1,67
1,<environment.Job instance at 0x7f6cb472b8c0>,66,16,[5 9],67,-1,83,-1,67
1,<environment.Job instance at 0x7f6cb3cc5190>,68,24,[5 6],69,-1,93,-1,69
1,<environment.Job instance at 0x7f6cb3cc5140>,71,17,[5 8],72,-1,89,-1,72
1,<environment.Job instance at 0x7f6cb4dea820>,0,2,[14  4],1,-1,3,-1,1
1,<environment.Job instance at 0x7f6cb4deaf00>,1,27,[8 5],2,-1,29,-1,2
1,<environment.Job instance at 0x7f6cb47bd140>,4,16,[11  4],5,-1,21,-1,5
1,<environment.Job instance at 0x7f6cb47bd5a0>,8,16,[13  2],9,-1,25,-1,9
1,<environment.Job instance at 0x7f6cb472bf00>,11,14,[ 2 12],12,-1,26,-1,12
1,<environment.Job instance at 0x7f6cb3c9cbe0>,13,26,[7 1],14,-1,46,-1,20
1,<environment.Job instance at 0x7f6cb54e3b40>,39,25,[3 6],40,-1,134,-1,109
1,<environment.Job instance at 0x7f6cb4c65d20>,41,16,[ 5 12],42,-1,125,-1,109
1,<environment.Job instance at 0x7f6cb4c657d0>,43,17,[13  5],44,-1,128,-1,111
1,<environment.Job instance at 0x7f6cb44eed20>,55,2,[ 3 11],56,-1,158,-1,156
1,<environment.Job instance at 0x7f6cb3cc5fa0>,62,3,[ 4 11],63,-1,185,-1,182
1,<environment.Job instance at 0x7f6cb3d33730>,68,24,[5 6],69,-1,236,-1,212
1,<environment.Job instance at 0x7f6cb3d33410>,70,3,[ 3 12],71,-1,215,-1,212
1,<environment.Job instance at 0x7f6cb3d33870>,72,14,[14  5],73,-1,238,-1,224
1,<environment.Job instance at 0x7f6cb50cccd0>,0,20,[ 4 10],1,-1,21,-1,1
1,<environment.Job instance at 0x7f6cb50cc960>,3,14,[ 4 10],4,-1,18,-1,4
1,<environment.Job instance at 0x7f6cb41fae60>,6,24,[4 5],7,-1,31,-1,7
1,<environment.Job instance at 0x7f6cb41fae10>,7,24,[4 8],8,-1,32,-1,8
1,<environment.Job instance at 0x7f6cb3eb4550>,16,16,[4 9],17,-1,33,-1,17
1,<environment.Job instance at 0x7f6cb3eb4690>,17,18,[6 1],18,-1,36,-1,18
1,<environment.Job instance at 0x7f6cb3eb4780>,19,15,[6 4],20,-1,35,-1,20
1,<environment.Job instance at 0x7f6cb3eb45f0>,22,23,[6 2],23,-1,46,-1,23
1,<environment.Job instance at 0x7f6cb3eb4b40>,26,17,[1 6],27,-1,44,-1,27
1,<environment.Job instance at 0x7f6cb3eb4f00>,27,13,[9 4],28,-1,42,-1,29
1,<environment.Job instance at 0x7f6cb415d910>,32,18,[6 5],33,-1,51,-1,33
1,<environment.Job instance at 0x7f6cb415d4b0>,34,14,[ 5 10],35,-1,49,-1,35
1,<environment.Job instance at 0x7f6cb415d690>,36,16,[4 8],37,-1,53,-1,37
1,<environment.Job instance at 0x7f6cb415daf0>,37,15,[4 8],38,-1,53,-1,38
1,<environment.Job instance at 0x7f6cb415d2d0>,38,15,[1 6],39,-1,54,-1,39
1,<environment.Job instance at 0x7f6cb415df50>,43,14,[ 2 11],44,-1,61,-1,47
1,<environment.Job instance at 0x7f6cb5106b90>,46,17,[4 6],47,-1,64,-1,47
1,<environment.Job instance at 0x7f6cb5106c80>,48,18,[10  1],49,-1,69,-1,51
1,<environment.Job instance at 0x7f6cb5106c30>,52,17,[ 1 10],53,-1,70,-1,53
1,<environment.Job instance at 0x7f6cb51064b0>,53,15,[8 4],54,-1,69,-1,54
1,<environment.Job instance at 0x7f6cb51067d0>,55,24,[5 2],56,-1,80,-1,56
1,<environment.Job instance at 0x7f6cb51065f0>,56,12,[3 5],57,-1,69,-1,57
1,<environment.Job instance at 0x7f6cb51069b0>,50,15,[4 7],51,-1,73,-1,58
1,<environment.Job instance at 0x7f6cb3f669b0>,61,17,[9 4],62,-1,83,-1,66
1,<environment.Job instance at 0x7f6cb404b050>,68,18,[10  4],69,-1,87,-1,69
1,<environment.Job instance at 0x7f6cb3df6d70>,71,13,[9 3],72,-1,85,-1,72
1,<environment.Job instance at 0x7f6cbdd97410>,76,16,[ 1 10],77,-1,94,-1,78
1,<environment.Job instance at 0x7f6cb47ba0f0>,60,25,[6 2],61,-1,103,-1,78
1,<environment.Job instance at 0x7f6cb4a138c0>,70,25,[5 5],71,-1,103,-1,78
1,<environment.Job instance at 0x7f6cb427e820>,75,19,[2 8],76,-1,97,-1,78
1,<environment.Job instance at 0x7f6cb415d500>,6,24,[4 5],7,-1,44,-1,20
1,<environment.Job instance at 0x7f6cb415d7d0>,7,24,[4 8],8,-1,45,-1,21
1,<environment.Job instance at 0x7f6cb43ee0a0>,22,23,[6 2],23,-1,67,-1,44
1,<environment.Job instance at 0x7f6cb3da1730>,24,3,[ 1 12],25,-1,47,-1,44
1,<environment.Job instance at 0x7f6cb43eef50>,25,14,[12  1],26,-1,58,-1,44
1,<environment.Job instance at 0x7f6cb507f910>,33,1,[11  3],34,-1,63,-1,62
1,<environment.Job instance at 0x7f6cb4c87d70>,35,28,[ 4 12],36,-1,91,-1,63
1,<environment.Job instance at 0x7f6cb4ca87d0>,39,1,[ 4 13],40,-1,91,-1,90
1,<environment.Job instance at 0x7f6cb421dcd0>,43,14,[ 2 11],44,-1,119,-1,105
1,<environment.Job instance at 0x7f6cb427cc30>,55,24,[5 2],56,-1,183,-1,159
1,<environment.Job instance at 0x7f6cb4a22820>,60,25,[6 2],61,-1,211,-1,186
1,<environment.Job instance at 0x7f6cb50487d0>,69,13,[ 1 11],70,-1,218,-1,205
1,<environment.Job instance at 0x7f6cb5048b40>,70,25,[5 5],71,-1,233,-1,208
1,<environment.Job instance at 0x7f6cb45c22d0>,73,3,[ 4 11],74,-1,211,-1,208
1,<environment.Job instance at 0x7f6cbdb62050>,1,17,[ 2 10],2,-1,20,-1,3
1,<environment.Job instance at 0x7f6cbdb62730>,3,12,[3 9],4,-1,16,-1,4
1,<environment.Job instance at 0x7f6cb52d5fa0>,5,18,[4 6],6,-1,24,-1,6
1,<environment.Job instance at 0x7f6cbdb62fa0>,6,15,[5 9],7,-1,22,-1,7
1,<environment.Job instance at 0x7f6cb521c1e0>,9,17,[ 1 10],10,-1,27,-1,10
1,<environment.Job instance at 0x7f6cb521c050>,10,15,[8 4],11,-1,26,-1,11
1,<environment.Job instance at 0x7f6cb45d0550>,14,19,[ 5 10],15,-1,34,-1,15
1,<environment.Job instance at 0x7f6cb5527460>,16,15,[3 9],17,-1,32,-1,17
1,<environment.Job instance at 0x7f6cb5527640>,17,27,[8 5],18,-1,45,-1,18
1,<environment.Job instance at 0x7f6cb5527910>,20,13,[8 3],21,-1,34,-1,21
1,<environment.Job instance at 0x7f6cb43040f0>,30,20,[8 5],31,-1,51,-1,31
1,<environment.Job instance at 0x7f6cb43e4780>,34,16,[5 8],35,-1,51,-1,35
1,<environment.Job instance at 0x7f6cbdb62f00>,2,16,[2 8],3,-1,52,-1,36
1,<environment.Job instance at 0x7f6cb43e44b0>,35,25,[4 5],36,-1,63,-1,38
1,<environment.Job instance at 0x7f6cb43e4af0>,41,15,[3 7],42,-1,64,-1,49
1,<environment.Job instance at 0x7f6cb4ae0320>,52,18,[4 8],53,-1,72,-1,54
1,<environment.Job instance at 0x7f6cb4ae0460>,53,15,[ 2 10],54,-1,69,-1,54
1,<environment.Job instance at 0x7f6cb4bca500>,58,12,[10  4],59,-1,80,-1,68
1,<environment.Job instance at 0x7f6cb442b960>,71,17,[7 4],72,-1,98,-1,81
1,<environment.Job instance at 0x7f6cb4bcae60>,59,12,[5 8],60,-1,93,-1,81
1,<environment.Job instance at 0x7f6cb442bb40>,73,14,[ 5 10],74,-1,95,-1,81
1,<environment.Job instance at 0x7f6cb442b500>,76,16,[3 8],77,-1,97,-1,81
1,<environment.Job instance at 0x7f6cb43e4cd0>,8,16,[14  4],9,-1,35,-1,19
1,<environment.Job instance at 0x7f6cb4e543c0>,17,27,[8 5],18,-1,90,-1,63
1,<environment.Job instance at 0x7f6cb442b0a0>,19,3,[ 1 12],20,-1,66,-1,63
1,<environment.Job instance at 0x7f6cb5048b40>,23,17,[13  3],24,-1,84,-1,67
1,<environment.Job instance at 0x7f6cb43360f0>,24,3,[13  1],25,-1,70,-1,67
1,<environment.Job instance at 0x7f6cb4285320>,35,25,[4 5],36,-1,128,-1,103
1,<environment.Job instance at 0x7f6cb4a22eb0>,38,1,[ 4 14],39,-1,107,-1,106
1,<environment.Job instance at 0x7f6cb539ec80>,50,2,[13  2],51,-1,141,-1,139
1,<environment.Job instance at 0x7f6cb50e66e0>,54,1,[12  5],55,-1,144,-1,143
1,<environment.Job instance at 0x7f6cb3da1b90>,57,26,[ 3 10],58,-1,187,-1,161
1,<environment.Job instance at 0x7f6cbdfa3410>,61,3,[12  2],62,-1,179,-1,176
1,<environment.Job instance at 0x7f6cb4bcd500>,74,3,[14  3],75,-1,206,-1,203
1,<environment.Job instance at 0x7f22875106e0>,0,18,[ 2 10],1,-1,20,-1,2
1,<environment.Job instance at 0x7f227df20a50>,3,18,[ 3 10],4,-1,22,-1,4
1,<environment.Job instance at 0x7f227df20be0>,4,18,[10  4],5,-1,23,-1,5
1,<environment.Job instance at 0x7f227df20af0>,5,13,[5 9],6,-1,19,-1,6
1,<environment.Job instance at 0x7f227df20c80>,6,12,[11  4],7,-1,19,-1,7
1,<environment.Job instance at 0x7f227df20dc0>,8,17,[ 2 10],9,-1,26,-1,9
1,<environment.Job instance at 0x7f227df20f00>,9,17,[ 4 10],10,-1,27,-1,10
1,<environment.Job instance at 0x7f227df235a0>,16,12,[1 8],17,-1,29,-1,17
1,<environment.Job instance at 0x7f227df230f0>,18,16,[8 5],19,-1,35,-1,19
1,<environment.Job instance at 0x7f227df23870>,19,17,[12  3],20,-1,37,-1,20
1,<environment.Job instance at 0x7f227df23b90>,23,18,[5 2],24,-1,42,-1,24
1,<environment.Job instance at 0x7f227df23eb0>,26,22,[2 9],27,-1,49,-1,27
1,<environment.Job instance at 0x7f227df261e0>,29,13,[1 6],30,-1,43,-1,30
1,<environment.Job instance at 0x7f227df262d0>,31,17,[4 9],32,-1,49,-1,32
1,<environment.Job instance at 0x7f227df26410>,32,17,[9 3],33,-1,50,-1,33
1,<environment.Job instance at 0x7f227df26820>,35,16,[8 1],36,-1,52,-1,36
1,<environment.Job instance at 0x7f227df26c80>,39,18,[5 8],40,-1,58,-1,40
1,<environment.Job instance at 0x7f227df26c30>,41,14,[6 1],42,-1,56,-1,42
1,<environment.Job instance at 0x7f227df26e10>,42,14,[8 4],43,-1,57,-1,43
1,<environment.Job instance at 0x7f227df26eb0>,43,28,[6 4],44,-1,72,-1,44
1,<environment.Job instance at 0x7f227df280a0>,44,17,[ 5 12],45,-1,62,-1,45
1,<environment.Job instance at 0x7f227df28140>,45,16,[6 2],46,-1,62,-1,46
1,<environment.Job instance at 0x7f22875108c0>,1,15,[ 1 14],2,-1,64,-1,49
1,<environment.Job instance at 0x7f227df28730>,52,3,[ 3 11],53,-1,56,-1,53
1,<environment.Job instance at 0x7f227df28aa0>,55,17,[4 7],56,-1,73,-1,56
1,<environment.Job instance at 0x7f227df28b40>,56,18,[4 5],57,-1,75,-1,57
1,<environment.Job instance at 0x7f227df28eb0>,60,24,[ 3 10],61,-1,85,-1,61
1,<environment.Job instance at 0x7f227df2c140>,62,20,[9 1],63,-1,83,-1,63
1,<environment.Job instance at 0x7f227df2c280>,63,15,[1 5],64,-1,79,-1,64
1,<environment.Job instance at 0x7f227df2c3c0>,65,13,[3 5],66,-1,79,-1,66
1,<environment.Job instance at 0x7f227df2c410>,67,26,[5 4],68,-1,94,-1,68
1,<environment.Job instance at 0x7f227df2c730>,68,22,[5 6],69,-1,91,-1,69
1,<environment.Job instance at 0x7f227df2c690>,69,13,[7 2],70,-1,83,-1,70
1,<environment.Job instance at 0x7f227df2c820>,70,18,[5 5],71,-1,89,-1,71
1,<environment.Job instance at 0x7f227df2c960>,72,14,[9 1],73,-1,87,-1,73
1,<environment.Job instance at 0x7f227df2cf50>,77,15,[4 7],78,-1,93,-1,78
1,<environment.Job instance at 0x7f227df2e0a0>,78,19,[8 4],79,-1,98,-1,79
1,<environment.Job instance at 0x7f227df2e140>,79,17,[2 7],80,-1,97,-1,80
1,<environment.Job instance at 0x7f227df1a3c0>,1,15,[ 1 14],2,-1,17,-1,2
1,<environment.Job instance at 0x7f227df17c80>,6,12,[11  4],7,-1,19,-1,7
1,<environment.Job instance at 0x7f227e028be0>,19,17,[12  3],20,-1,67,-1,50
1,<environment.Job instance at 0x7f227e0c9910>,22,2,[12  3],23,-1,62,-1,60
1,<environment.Job instance at 0x7f227e0435f0>,43,28,[6 4],44,-1,166,-1,138
1,<environment.Job instance at 0x7f227df48c30>,44,17,[ 5 12],45,-1,155,-1,138
1,<environment.Job instance at 0x7f227df48550>,50,27,[9 1],51,-1,179,-1,152
1,<environment.Job instance at 0x7f227df480f0>,52,3,[ 3 11],53,-1,155,-1,152
1,<environment.Job instance at 0x7f227e154cd0>,53,18,[ 4 12],54,-1,170,-1,152
1,<environment.Job instance at 0x7f227e012dc0>,60,24,[ 3 10],61,-1,209,-1,185
1,<environment.Job instance at 0x7f227dfd03c0>,67,26,[5 4],68,-1,226,-1,200
1,<environment.Job instance at 0x7f227dfcfa50>,81,17,[ 4 14],82,-1,256,-1,239
1,<environment.Job instance at 0x7f227dfcf870>,85,19,[14  4],86,-1,260,-1,241
1,<environment.Job instance at 0x7f227d6666e0>,1,16,[5 8],2,-1,18,-1,2
1,<environment.Job instance at 0x7f227d66b140>,5,23,[3 7],6,-1,29,-1,6
1,<environment.Job instance at 0x7f227d66bfa0>,10,18,[7 5],11,-1,29,-1,11
1,<environment.Job instance at 0x7f227d66c190>,18,20,[5 7],19,-1,39,-1,19
1,<environment.Job instance at 0x7f227d66c050>,20,20,[5 7],21,-1,41,-1,21
1,<environment.Job instance at 0x7f227d665d70>,25,14,[9 1],26,-1,40,-1,26
1,<environment.Job instance at 0x7f227d665b90>,26,15,[9 2],27,-1,42,-1,27
1,<environment.Job instance at 0x7f227d74d280>,29,16,[1 8],30,-1,46,-1,30
1,<environment.Job instance at 0x7f227d4bfaf0>,5,23,[3 7],6,-1,30,-1,7
1,<environment.Job instance at 0x7f227d4cbfa0>,12,27,[ 3 13],13,-1,40,-1,13
1,<environment.Job instance at 0x7f227d6c2c30>,21,18,[ 3 13],22,-1,50,-1,32
1,<environment.Job instance at 0x7f227d72d6e0>,27,18,[ 3 12],28,-1,55,-1,37
1,<environment.Job instance at 0x7f227d757500>,31,18,[11  5],32,-1,70,-1,52
1,<environment.Job instance at 0x7f227d72daa0>,32,14,[14  1],33,-1,66,-1,52
1,<environment.Job instance at 0x7f227d6daeb0>,45,15,[ 3 14],46,-1,110,-1,95
1,<environment.Job instance at 0x7f227d6c9550>,47,12,[14  5],48,-1,107,-1,95
1,<environment.Job instance at 0x7f227d6ed370>,76,22,[11  3],77,-1,236,-1,214
1,<environment.Job instance at 0x7f227d722190>,85,25,[3 9],86,-1,287,-1,262
1,<environment.Job instance at 0x7f227d5b2190>,5,17,[10  5],6,-1,23,-1,6
1,<environment.Job instance at 0x7f227d5b26e0>,9,17,[9 2],10,-1,27,-1,10
1,<environment.Job instance at 0x7f227d5b2aa0>,10,18,[5 1],11,-1,29,-1,11
1,<environment.Job instance at 0x7f227d5b2be0>,12,14,[8 4],13,-1,29,-1,15
1,<environment.Job instance at 0x7f227d5b2dc0>,14,17,[10  5],15,-1,32,-1,15
1,<environment.Job instance at 0x7f227d5b2d70>,15,16,[ 3 10],16,-1,32,-1,16
1,<environment.Job instance at 0x7f227d5b2eb0>,16,23,[5 8],17,-1,40,-1,17
1,<environment.Job instance at 0x7f227d5a7460>,22,14,[9 2],23,-1,38,-1,24
1,<environment.Job instance at 0x7f227d5a7e10>,23,27,[5 3],24,-1,51,-1,24
1,<environment.Job instance at 0x7f227d5a7aa0>,24,17,[10  2],25,-1,43,-1,26
1,<environment.Job instance at 0x7f227d5a7730>,25,17,[5 9],26,-1,43,-1,26
1,<environment.Job instance at 0x7f227d5a7fa0>,28,22,[9 2],29,-1,52,-1,30
1,<environment.Job instance at 0x7f227d5a7d70>,30,17,[2 9],31,-1,48,-1,31
1,<environment.Job instance at 0x7f2287689cd0>,32,17,[10  4],33,-1,52,-1,35
1,<environment.Job instance at 0x7f2287689c30>,35,17,[8 1],36,-1,53,-1,36
1,<environment.Job instance at 0x7f22876895a0>,36,16,[7 2],37,-1,53,-1,37
1,<environment.Job instance at 0x7f22876898c0>,37,18,[ 1 10],38,-1,56,-1,38
1,<environment.Job instance at 0x7f22876896e0>,38,28,[7 4],39,-1,67,-1,39
1,<environment.Job instance at 0x7f227d4b58c0>,43,15,[5 6],44,-1,59,-1,44
1,<environment.Job instance at 0x7f227d4b5b90>,44,28,[9 1],45,-1,73,-1,45
1,<environment.Job instance at 0x7f227d4b5820>,45,17,[3 5],46,-1,63,-1,46
1,<environment.Job instance at 0x7f227d4b5050>,46,15,[ 5 10],47,-1,62,-1,47
1,<environment.Job instance at 0x7f227d4b5190>,50,15,[7 4],51,-1,66,-1,51
1,<environment.Job instance at 0x7f227d4b5370>,52,16,[8 5],53,-1,69,-1,53
1,<environment.Job instance at 0x7f228765b780>,54,14,[8 5],55,-1,69,-1,55
1,<environment.Job instance at 0x7f228767e6e0>,58,18,[3 8],59,-1,77,-1,59
1,<environment.Job instance at 0x7f228767e190>,59,16,[9 4],60,-1,76,-1,60
1,<environment.Job instance at 0x7f228767e280>,60,28,[7 3],61,-1,89,-1,61
1,<environment.Job instance at 0x7f228767e050>,61,16,[7 4],62,-1,78,-1,62
1,<environment.Job instance at 0x7f228767eb90>,63,18,[1 6],64,-1,82,-1,64
1,<environment.Job instance at 0x7f2287678190>,64,15,[9 5],65,-1,80,-1,65
1,<environment.Job instance at 0x7f2287678eb0>,66,17,[2 6],67,-1,84,-1,67
1,<environment.Job instance at 0x7f2287678910>,67,16,[2 8],68,-1,84,-1,68
1,<environment.Job instance at 0x7f22876782d0>,70,18,[8 5],71,-1,89,-1,71
1,<environment.Job instance at 0x7f227d4dfc30>,73,14,[3 5],74,-1,88,-1,74
1,<environment.Job instance at 0x7f227d4df190>,74,17,[1 9],75,-1,92,-1,75
1,<environment.Job instance at 0x7f228765be60>,6,26,[9 1],7,-1,39,-1,13
1,<environment.Job instance at 0x7f227d52c190>,16,23,[5 8],17,-1,62,-1,39
1,<environment.Job instance at 0x7f227d532a00>,21,2,[12  1],22,-1,48,-1,46
1,<environment.Job instance at 0x7f227d532be0>,23,27,[5 3],24,-1,87,-1,60
1,<environment.Job instance at 0x7f227d611730>,29,3,[ 4 12],30,-1,79,-1,76
1,<environment.Job instance at 0x7f227d611640>,31,18,[ 5 11],32,-1,96,-1,78
1,<environment.Job instance at 0x7f228778d320>,38,28,[7 4],39,-1,152,-1,124
1,<environment.Job instance at 0x7f227dcf6aa0>,44,28,[9 1],45,-1,173,-1,145
1,<environment.Job instance at 0x7f227dcf6910>,48,16,[14  3],49,-1,161,-1,145
1,<environment.Job instance at 0x7f227dcf6140>,60,28,[7 3],61,-1,247,-1,219
1,<environment.Job instance at 0x7f227d4c6370>,78,12,[12  2],79,-1,302,-1,290
1,<environment.Job instance at 0x7f22876f6be0>,81,19,[ 3 14],82,-1,325,-1,306
1,<environment.Job instance at 0x7f22876f65a0>,82,2,[14  5],83,-1,308,-1,306
1,<environment.Job instance at 0x7f22876f69b0>,85,12,[12  4],86,-1,321,-1,309
1,<environment.Job instance at 0x7f227e2173c0>,2,17,[8 2],3,-1,21,-1,4
1,<environment.Job instance at 0x7f227d878eb0>,3,18,[7 5],4,-1,22,-1,4
1,<environment.Job instance at 0x7f227e217050>,11,16,[6 2],12,-1,28,-1,12
1,<environment.Job instance at 0x7f227db02960>,23,18,[9 2],24,-1,43,-1,25
1,<environment.Job instance at 0x7f227db02e60>,18,17,[12  1],19,-1,42,-1,25
1,<environment.Job instance at 0x7f227db025a0>,19,14,[5 7],20,-1,39,-1,25
1,<environment.Job instance at 0x7f227db02280>,26,16,[5 7],27,-1,43,-1,27
1,<environment.Job instance at 0x7f227e080280>,33,13,[8 3],34,-1,50,-1,37
1,<environment.Job instance at 0x7f227db02190>,24,18,[ 5 10],25,-1,55,-1,37
1,<environment.Job instance at 0x7f227e080780>,35,18,[9 5],36,-1,56,-1,38
1,<environment.Job instance at 0x7f227e080910>,32,27,[ 2 13],33,-1,65,-1,38
1,<environment.Job instance at 0x7f227e0800f0>,37,17,[7 5],38,-1,58,-1,41
1,<environment.Job instance at 0x7f227e080870>,36,15,[7 3],37,-1,56,-1,41
1,<environment.Job instance at 0x7f227e0802d0>,41,15,[10  3],42,-1,57,-1,42
1,<environment.Job instance at 0x7f227e080190>,44,16,[8 3],45,-1,68,-1,52
1,<environment.Job instance at 0x7f227db96690>,53,15,[7 4],54,-1,69,-1,54
1,<environment.Job instance at 0x7f227db02be0>,20,13,[7 4],21,-1,70,-1,57
1,<environment.Job instance at 0x7f227db96a00>,56,15,[6 2],57,-1,72,-1,57
1,<environment.Job instance at 0x7f227dbaf050>,50,14,[ 3 10],51,-1,71,-1,57
1,<environment.Job instance at 0x7f227db96640>,61,16,[2 8],62,-1,78,-1,62
1,<environment.Job instance at 0x7f227db96910>,60,13,[ 4 10],61,-1,77,-1,64
1,<environment.Job instance at 0x7f227e3d37d0>,68,14,[10  4],69,-1,90,-1,76
1,<environment.Job instance at 0x7f227e3d3550>,70,18,[11  4],71,-1,97,-1,79
1,<environment.Job instance at 0x7f227e3d3280>,72,20,[7 3],73,-1,100,-1,80
1,<environment.Job instance at 0x7f227daaa640>,76,20,[6 2],77,-1,100,-1,80
1,<environment.Job instance at 0x7f227dbafe10>,49,17,[4 8],50,-1,97,-1,80
1,<environment.Job instance at 0x7f227e3d3640>,75,17,[6 3],76,-1,97,-1,80
1,<environment.Job instance at 0x7f227daaa5f0>,78,17,[2 8],79,-1,97,-1,80
1,<environment.Job instance at 0x7f227dbafe60>,51,18,[ 4 13],52,-1,103,-1,85
1,<environment.Job instance at 0x7f227d6105a0>,84,12,[2 9],85,-1,97,-1,85
1,<environment.Job instance at 0x7f227da14230>,85,16,[2 6],86,-1,102,-1,86
1,<environment.Job instance at 0x7f227db02050>,30,17,[4 5],31,-1,104,-1,87
1,<environment.Job instance at 0x7f227d6100f0>,82,15,[7 3],83,-1,102,-1,87
1,<environment.Job instance at 0x7f227daaaf00>,81,14,[3 6],82,-1,101,-1,87
1,<environment.Job instance at 0x7f227da140f0>,87,16,[ 3 10],88,-1,104,-1,88
1,<environment.Job instance at 0x7f227da14f50>,88,16,[3 6],89,-1,105,-1,89
1,<environment.Job instance at 0x7f227db02410>,1,18,[ 5 14],2,-1,20,-1,2
1,<environment.Job instance at 0x7f227dbafd70>,8,1,[ 5 14],9,-1,10,-1,9
1,<environment.Job instance at 0x7f227e3d3820>,13,3,[14  5],14,-1,26,-1,23
1,<environment.Job instance at 0x7f227e217640>,18,17,[12  1],19,-1,46,-1,29
1,<environment.Job instance at 0x7f227d611140>,22,1,[13  3],23,-1,47,-1,46
1,<environment.Job instance at 0x7f227d532e10>,32,27,[ 2 13],33,-1,104,-1,77
1,<environment.Job instance at 0x7f227da14370>,38,1,[12  5],39,-1,98,-1,97
1,<environment.Job instance at 0x7f228768a5a0>,51,18,[ 4 13],52,-1,165,-1,147
1,<environment.Job instance at 0x7f227d9fcb90>,57,16,[ 5 13],58,-1,194,-1,178
1,<environment.Job instance at 0x7f227d9fcb40>,64,18,[13  2],65,-1,215,-1,197
1,<environment.Job instance at 0x7f227d668c30>,70,18,[11  4],71,-1,228,-1,210
1,<environment.Job instance at 0x7f227ea34cd0>,4,22,[1 9],5,-1,27,-1,5
1,<environment.Job instance at 0x7f227ea34c30>,7,13,[ 1 10],8,-1,21,-1,8
1,<environment.Job instance at 0x7f227ea34910>,9,18,[ 2 10],10,-1,28,-1,10
1,<environment.Job instance at 0x7f227d6115a0>,3,12,[8 5],4,-1,22,-1,10
1,<environment.Job instance at 0x7f227ea5c550>,11,18,[3 8],12,-1,30,-1,12
1,<environment.Job instance at 0x7f227ea65f50>,13,24,[3 6],14,-1,38,-1,14
1,<environment.Job instance at 0x7f227ea65af0>,15,20,[3 8],16,-1,37,-1,17
1,<environment.Job instance at 0x7f227ea65820>,17,27,[9 5],18,-1,45,-1,18
1,<environment.Job instance at 0x7f227ea653c0>,18,14,[3 6],19,-1,33,-1,19
1,<environment.Job instance at 0x7f227ea67d70>,20,18,[4 8],21,-1,39,-1,21
1,<environment.Job instance at 0x7f227d5fe820>,25,18,[ 3 10],26,-1,44,-1,26
1,<environment.Job instance at 0x7f227d974c30>,27,13,[4 9],28,-1,41,-1,28
1,<environment.Job instance at 0x7f227ea65a50>,16,15,[4 9],17,-1,43,-1,28
1,<environment.Job instance at 0x7f227e598be0>,32,17,[9 1],33,-1,50,-1,33
1,<environment.Job instance at 0x7f227d9adeb0>,33,18,[8 1],34,-1,52,-1,34
1,<environment.Job instance at 0x7f227d9a8140>,35,27,[5 5],36,-1,63,-1,36
1,<environment.Job instance at 0x7f227d99bdc0>,36,22,[2 8],37,-1,59,-1,37
1,<environment.Job instance at 0x7f227d992820>,37,20,[5 2],38,-1,58,-1,38
1,<environment.Job instance at 0x7f227d9a7690>,38,13,[14  4],39,-1,52,-1,39
1,<environment.Job instance at 0x7f227d9a7aa0>,39,17,[2 6],40,-1,57,-1,40
1,<environment.Job instance at 0x7f227e5c6550>,40,16,[1 9],41,-1,60,-1,44
1,<environment.Job instance at 0x7f227dc18f50>,43,27,[7 5],44,-1,75,-1,48
1,<environment.Job instance at 0x7f227d978370>,48,14,[2 7],49,-1,64,-1,50
1,<environment.Job instance at 0x7f227d978c80>,51,18,[5 7],52,-1,70,-1,52
1,<environment.Job instance at 0x7f227d98a050>,57,14,[10  3],58,-1,93,-1,79
1,<environment.Job instance at 0x7f227dc18370>,42,17,[4 6],43,-1,96,-1,79
1,<environment.Job instance at 0x7f227dc1bd70>,64,12,[13  3],65,-1,92,-1,80
1,<environment.Job instance at 0x7f227dc1bf00>,65,16,[10  5],66,-1,96,-1,80
1,<environment.Job instance at 0x7f227dc1be60>,68,21,[9 5],69,-1,101,-1,80
1,<environment.Job instance at 0x7f227dc193c0>,70,17,[9 4],71,-1,97,-1,80
1,<environment.Job instance at 0x7f227dc1beb0>,66,13,[8 4],67,-1,93,-1,80
1,<environment.Job instance at 0x7f227dc19190>,69,3,[12  1],70,-1,84,-1,81
1,<environment.Job instance at 0x7f227dc197d0>,75,15,[5 7],76,-1,100,-1,85
1,<environment.Job instance at 0x7f227dc19870>,76,13,[7 1],77,-1,98,-1,85
1,<environment.Job instance at 0x7f227dc19cd0>,79,16,[ 5 13],80,-1,107,-1,91
1,<environment.Job instance at 0x7f227dc19f50>,83,17,[1 8],84,-1,109,-1,92
1,<environment.Job instance at 0x7f227d5fe3c0>,1,25,[10  4],2,-1,27,-1,2
1,<environment.Job instance at 0x7f227d8aea00>,13,24,[3 6],14,-1,54,-1,30
1,<environment.Job instance at 0x7f227d51c190>,17,27,[9 5],18,-1,60,-1,33
1,<environment.Job instance at 0x7f227d668870>,23,2,[ 3 14],24,-1,52,-1,50
1,<environment.Job instance at 0x7f227dbaec30>,34,3,[ 3 12],35,-1,86,-1,83
1,<environment.Job instance at 0x7f227d9fcb40>,35,27,[5 5],36,-1,127,-1,100
1,<environment.Job instance at 0x7f227d9fc3c0>,38,13,[14  4],39,-1,114,-1,101
1,<environment.Job instance at 0x7f227d9fc5a0>,43,27,[7 5],44,-1,147,-1,120
1,<environment.Job instance at 0x7f227d9fc500>,44,13,[14  5],45,-1,133,-1,120
1,<environment.Job instance at 0x7f227da14aa0>,55,25,[3 7],56,-1,202,-1,177
1,<environment.Job instance at 0x7f227d4b82d0>,60,1,[ 4 12],61,-1,192,-1,191
1,<environment.Job instance at 0x7f227d532b90>,64,12,[13  3],65,-1,207,-1,195
1,<environment.Job instance at 0x7f227d611550>,69,3,[12  1],70,-1,225,-1,222
1,<environment.Job instance at 0x7f227e3d3b90>,79,16,[ 5 13],80,-1,264,-1,248
1,<environment.Job instance at 0x7f227dbafd70>,84,14,[ 3 14],85,-1,280,-1,266
1,<environment.Job instance at 0x7f227db96190>,85,24,[3 9],86,-1,293,-1,269
1,<environment.Job instance at 0x7f227e37b500>,2,17,[10  3],3,-1,21,-1,4
1,<environment.Job instance at 0x7f227e37b0f0>,4,15,[ 1 10],5,-1,20,-1,5
1,<environment.Job instance at 0x7f228778d320>,3,13,[9 5],4,-1,19,-1,6
1,<environment.Job instance at 0x7f227e5bfaa0>,12,27,[5 5],13,-1,40,-1,13
1,<environment.Job instance at 0x7f227e5bfc30>,16,15,[ 5 10],17,-1,33,-1,18
1,<environment.Job instance at 0x7f227e5bfb40>,21,14,[1 9],22,-1,36,-1,22
1,<environment.Job instance at 0x7f227e5bf550>,23,18,[4 8],24,-1,42,-1,24
1,<environment.Job instance at 0x7f227e5bfd70>,24,17,[7 4],25,-1,42,-1,25
1,<environment.Job instance at 0x7f227e5bf140>,25,14,[7 3],26,-1,40,-1,26
1,<environment.Job instance at 0x7f227e5aa730>,26,27,[5 8],27,-1,54,-1,27
1,<environment.Job instance at 0x7f227e5aae10>,31,24,[4 8],32,-1,56,-1,32
1,<environment.Job instance at 0x7f227e5aa0a0>,35,19,[7 5],36,-1,55,-1,36
1,<environment.Job instance at 0x7f227e5aa050>,36,14,[8 1],37,-1,51,-1,37
1,<environment.Job instance at 0x7f227e5aac30>,37,12,[10  4],38,-1,50,-1,38
1,<environment.Job instance at 0x7f227e5c6aa0>,40,14,[ 4 10],41,-1,55,-1,41
1,<environment.Job instance at 0x7f227e5c6780>,42,17,[2 5],43,-1,60,-1,43
1,<environment.Job instance at 0x7f227e5c6690>,46,18,[8 2],47,-1,65,-1,47
1,<environment.Job instance at 0x7f227e5c6eb0>,47,18,[6 2],48,-1,66,-1,48
1,<environment.Job instance at 0x7f227e5c60f0>,49,18,[5 8],50,-1,68,-1,50
1,<environment.Job instance at 0x7f227e5c6960>,50,19,[2 7],51,-1,70,-1,51
1,<environment.Job instance at 0x7f227e5c6410>,51,24,[1 9],52,-1,76,-1,52
1,<environment.Job instance at 0x7f227e5a7870>,53,15,[6 5],54,-1,69,-1,54
1,<environment.Job instance at 0x7f227e5a7e60>,56,14,[7 5],57,-1,71,-1,57
1,<environment.Job instance at 0x7f227e5a75a0>,57,23,[10  4],58,-1,85,-1,62
1,<environment.Job instance at 0x7f227e5a7820>,62,12,[3 8],63,-1,75,-1,63
1,<environment.Job instance at 0x7f227e5a7f50>,64,13,[1 9],65,-1,78,-1,65
1,<environment.Job instance at 0x7f227e5a7d70>,65,16,[4 5],66,-1,82,-1,66
1,<environment.Job instance at 0x7f227e5a70a0>,61,17,[5 7],62,-1,84,-1,67
1,<environment.Job instance at 0x7f227e5ad460>,69,17,[ 5 10],70,-1,87,-1,70
1,<environment.Job instance at 0x7f227e5ad230>,70,18,[4 6],71,-1,89,-1,71
1,<environment.Job instance at 0x7f227e5adb90>,71,15,[3 5],72,-1,88,-1,73
1,<environment.Job instance at 0x7f227e5adbe0>,74,15,[5 7],75,-1,90,-1,75
1,<environment.Job instance at 0x7f227e5ad2d0>,83,20,[5 7],84,-1,104,-1,84
1,<environment.Job instance at 0x7f227e5aa2d0>,5,1,[12  4],6,-1,7,-1,6
1,<environment.Job instance at 0x7f227e5c6af0>,11,15,[14  1],12,-1,33,-1,18
1,<environment.Job instance at 0x7f227e5a71e0>,12,27,[5 5],13,-1,47,-1,20
1,<environment.Job instance at 0x7f227e5a7e10>,14,25,[1 7],15,-1,45,-1,20
1,<environment.Job instance at 0x7f227da14550>,26,27,[5 8],27,-1,92,-1,65
1,<environment.Job instance at 0x7f227d668960>,31,24,[4 8],32,-1,105,-1,81
1,<environment.Job instance at 0x7f227dc195a0>,41,1,[11  1],42,-1,102,-1,101
1,<environment.Job instance at 0x7f227ea34aa0>,51,24,[1 9],52,-1,164,-1,140
1,<environment.Job instance at 0x7f227d942f00>,57,23,[10  4],58,-1,195,-1,172
1,<environment.Job instance at 0x7f227d9424b0>,63,3,[ 5 13],64,-1,181,-1,178
1,<environment.Job instance at 0x7f227d942a00>,66,17,[13  2],67,-1,207,-1,190
1,<environment.Job instance at 0x7f227d874fa0>,67,1,[11  4],68,-1,191,-1,190
1,<environment.Job instance at 0x7f227d8745f0>,72,17,[ 2 12],73,-1,221,-1,204
1,<environment.Job instance at 0x7f227d874c80>,75,24,[10  2],76,-1,257,-1,233
1,<environment.Job instance at 0x7f227d874320>,79,27,[14  1],80,-1,261,-1,234
1,<environment.Job instance at 0x7f227d874550>,82,2,[11  4],83,-1,237,-1,235
1,<environment.Job instance at 0x7f227d8746e0>,85,12,[11  5],86,-1,257,-1,245
1,<environment.Job instance at 0x7f227d88b550>,86,27,[4 5],87,-1,273,-1,246
1,<environment.Job instance at 0x7f227d940c80>,0,14,[8 4],1,-1,16,-1,2
1,<environment.Job instance at 0x7f227e2171e0>,1,12,[5 9],2,-1,15,-1,3
1,<environment.Job instance at 0x7f227ddba550>,6,14,[10  4],7,-1,26,-1,12
1,<environment.Job instance at 0x7f227e5b4f00>,13,12,[ 2 10],14,-1,26,-1,14
1,<environment.Job instance at 0x7f227ddefd70>,17,18,[3 6],18,-1,36,-1,18
1,<environment.Job instance at 0x7f227dac7730>,20,18,[5 9],21,-1,39,-1,21
1,<environment.Job instance at 0x7f227e673eb0>,23,18,[ 1 10],24,-1,42,-1,24
1,<environment.Job instance at 0x7f227e673b90>,24,14,[7 5],25,-1,39,-1,25
1,<environment.Job instance at 0x7f227e069e60>,29,14,[9 5],30,-1,44,-1,30
1,<environment.Job instance at 0x7f227e5a02d0>,35,17,[ 5 10],36,-1,56,-1,39
1,<environment.Job instance at 0x7f227e5bef00>,2,3,[11  3],3,-1,6,-1,3
1,<environment.Job instance at 0x7f227e66d4b0>,11,15,[ 2 14],12,-1,31,-1,16
1,<environment.Job instance at 0x7f227e66d550>,15,12,[ 3 13],16,-1,29,-1,17
1,<environment.Job instance at 0x7f227d942c80>,31,17,[14  3],32,-1,79,-1,62
1,<environment.Job instance at 0x7f227d942e60>,34,15,[ 2 13],35,-1,79,-1,64
1,<environment.Job instance at 0x7f227ea4c6e0>,37,3,[12  4],38,-1,82,-1,79
1,<environment.Job instance at 0x7f227d942eb0>,39,28,[1 8],40,-1,124,-1,96
1,<environment.Job instance at 0x7f227d6680f0>,48,18,[13  3],49,-1,132,-1,114
1,<environment.Job instance at 0x7f22875953c0>,55,24,[8 3],56,-1,186,-1,162
1,<environment.Job instance at 0x7f227ea34320>,71,13,[12  4],72,-1,219,-1,206
1,<environment.Job instance at 0x7f227ea345a0>,74,24,[4 5],75,-1,246,-1,222
1,<environment.Job instance at 0x7f227dd91a00>,8,17,[7 2],9,-1,26,-1,9
1,<environment.Job instance at 0x7f227dd91e10>,9,16,[10  2],10,-1,26,-1,10
1,<environment.Job instance at 0x7f227dd91aa0>,10,15,[5 6],11,-1,26,-1,11
1,<environment.Job instance at 0x7f227dd91960>,14,15,[7 3],15,-1,31,-1,16
1,<environment.Job instance at 0x7f227dd91fa0>,15,12,[10  3],16,-1,28,-1,16
1,<environment.Job instance at 0x7f227dd0e7d0>,17,15,[10  1],18,-1,33,-1,18
1,<environment.Job instance at 0x7f227dd0eb40>,19,23,[6 5],20,-1,43,-1,20
1,<environment.Job instance at 0x7f227dd0ed70>,20,17,[2 6],21,-1,38,-1,21
1,<environment.Job instance at 0x7f228726e2d0>,29,21,[1 9],30,-1,51,-1,30
1,<environment.Job instance at 0x7f228726e1e0>,30,27,[6 4],31,-1,58,-1,31
1,<environment.Job instance at 0x7f227e810a00>,32,15,[10  1],33,-1,48,-1,33
1,<environment.Job instance at 0x7f227e8103c0>,33,13,[7 5],34,-1,48,-1,35
1,<environment.Job instance at 0x7f227e810190>,36,14,[1 7],37,-1,51,-1,37
1,<environment.Job instance at 0x7f227e8100f0>,34,13,[1 8],35,-1,50,-1,37
1,<environment.Job instance at 0x7f227e810b40>,38,22,[7 5],39,-1,61,-1,39
1,<environment.Job instance at 0x7f227e810910>,39,16,[5 3],40,-1,56,-1,40
1,<environment.Job instance at 0x7f227e810500>,40,18,[ 5 10],41,-1,59,-1,41
1,<environment.Job instance at 0x7f227e810aa0>,42,24,[1 6],43,-1,67,-1,43
1,<environment.Job instance at 0x7f227e8109b0>,43,16,[8 5],44,-1,60,-1,44
1,<environment.Job instance at 0x7f227e8100a0>,44,16,[9 4],45,-1,61,-1,45
1,<environment.Job instance at 0x7f228723a460>,46,15,[10  4],47,-1,63,-1,48
1,<environment.Job instance at 0x7f228723a8c0>,48,17,[3 9],49,-1,66,-1,49
1,<environment.Job instance at 0x7f228723a550>,50,14,[1 8],51,-1,65,-1,51
1,<environment.Job instance at 0x7f228723a690>,47,13,[ 4 10],48,-1,64,-1,51
1,<environment.Job instance at 0x7f227d83a140>,58,14,[9 1],59,-1,73,-1,59
1,<environment.Job instance at 0x7f227d83a370>,59,17,[1 9],60,-1,77,-1,60
1,<environment.Job instance at 0x7f227d83a320>,62,15,[6 2],63,-1,78,-1,63
1,<environment.Job instance at 0x7f227d83a960>,68,18,[6 5],69,-1,88,-1,70
1,<environment.Job instance at 0x7f22872e03c0>,71,12,[1 8],72,-1,84,-1,72
1,<environment.Job instance at 0x7f227e9de280>,73,16,[5 3],74,-1,90,-1,74
1,<environment.Job instance at 0x7f227d83afa0>,69,18,[ 5 10],70,-1,92,-1,74
1,<environment.Job instance at 0x7f227e9dec30>,78,24,[4 7],79,-1,103,-1,79
1,<environment.Job instance at 0x7f227e9de230>,79,12,[4 6],80,-1,92,-1,80
1,<environment.Job instance at 0x7f227e9de050>,80,13,[5 3],81,-1,94,-1,81
1,<environment.Job instance at 0x7f227e9de910>,82,17,[9 4],83,-1,100,-1,83
1,<environment.Job instance at 0x7f227e9de140>,85,16,[9 4],86,-1,102,-1,86
1,<environment.Job instance at 0x7f22875955f0>,19,23,[6 5],20,-1,72,-1,49
1,<environment.Job instance at 0x7f227d874690>,30,27,[6 4],31,-1,100,-1,73
1,<environment.Job instance at 0x7f227d874f50>,31,1,[11  4],32,-1,74,-1,73
1,<environment.Job instance at 0x7f227e66df50>,42,24,[1 6],43,-1,129,-1,105
1,<environment.Job instance at 0x7f227e676b90>,54,3,[ 2 12],55,-1,165,-1,162
1,<environment.Job instance at 0x7f227db67050>,61,2,[ 3 14],62,-1,186,-1,184
1,<environment.Job instance at 0x7f227db67e10>,66,13,[12  4],67,-1,214,-1,201
1,<environment.Job instance at 0x7f227db67140>,67,27,[9 3],68,-1,229,-1,202
1,<environment.Job instance at 0x7f227db670f0>,76,12,[ 2 11],77,-1,234,-1,222
1,<environment.Job instance at 0x7f227db67230>,78,24,[4 7],79,-1,273,-1,249
1,<environment.Job instance at 0x7f227db36230>,84,18,[ 4 11],85,-1,270,-1,252
1,<environment.Job instance at 0x7f227d31afa0>,0,20,[4 6],1,-1,21,-1,1
1,<environment.Job instance at 0x7f227d31da00>,12,17,[ 2 10],13,-1,31,-1,14
1,<environment.Job instance at 0x7f227d31d9b0>,14,12,[9 1],15,-1,27,-1,15
1,<environment.Job instance at 0x7f227d35ca50>,16,13,[4 7],17,-1,30,-1,17
1,<environment.Job instance at 0x7f227d35c190>,18,20,[3 8],19,-1,39,-1,19
1,<environment.Job instance at 0x7f227d35c870>,21,21,[4 7],22,-1,43,-1,22
1,<environment.Job instance at 0x7f227d35c7d0>,23,15,[4 9],24,-1,39,-1,24
1,<environment.Job instance at 0x7f227d31a0a0>,13,15,[5 5],14,-1,41,-1,26
1,<environment.Job instance at 0x7f227d35ce10>,29,19,[5 5],30,-1,61,-1,42
1,<environment.Job instance at 0x7f227d94f0f0>,35,12,[10  1],36,-1,54,-1,42
1,<environment.Job instance at 0x7f227d94fa50>,38,18,[4 6],39,-1,60,-1,42
1,<environment.Job instance at 0x7f227d35c550>,20,24,[10  4],21,-1,66,-1,42
1,<environment.Job instance at 0x7f227d94f820>,39,1,[ 5 14],40,-1,43,-1,42
1,<environment.Job instance at 0x7f227d94fb90>,37,14,[ 4 10],38,-1,56,-1,42
1,<environment.Job instance at 0x7f227d94f910>,40,2,[5 1],41,-1,44,-1,42
1,<environment.Job instance at 0x7f227d94fbe0>,42,16,[3 8],43,-1,59,-1,43
1,<environment.Job instance at 0x7f227d94fe60>,43,13,[7 4],44,-1,57,-1,44
1,<environment.Job instance at 0x7f227d35cf00>,31,18,[4 8],32,-1,67,-1,49
1,<environment.Job instance at 0x7f227d2ffcd0>,48,17,[9 5],49,-1,66,-1,49
1,<environment.Job instance at 0x7f227d94f550>,41,12,[5 5],42,-1,62,-1,50
1,<environment.Job instance at 0x7f227d2ffaf0>,46,18,[10  2],47,-1,68,-1,50
1,<environment.Job instance at 0x7f227d2ff9b0>,50,16,[ 3 10],51,-1,67,-1,51
1,<environment.Job instance at 0x7f227d2ff8c0>,51,16,[5 7],52,-1,68,-1,52
1,<environment.Job instance at 0x7f227d2ffe60>,55,14,[4 6],56,-1,70,-1,56
1,<environment.Job instance at 0x7f227d4cbb90>,68,17,[3 7],69,-1,86,-1,69
1,<environment.Job instance at 0x7f227e153c30>,64,13,[5 3],65,-1,93,-1,80
1,<environment.Job instance at 0x7f227dd54410>,72,17,[6 4],73,-1,97,-1,80
1,<environment.Job instance at 0x7f227d35c410>,30,15,[10  4],31,-1,95,-1,80
1,<environment.Job instance at 0x7f227e8945f0>,71,17,[2 7],72,-1,97,-1,80
1,<environment.Job instance at 0x7f227d94feb0>,3,14,[ 1 11],4,-1,18,-1,4
1,<environment.Job instance at 0x7f227d31d5f0>,5,16,[ 2 11],6,-1,22,-1,6
1,<environment.Job instance at 0x7f227d2ff230>,8,2,[13  3],9,-1,11,-1,9
1,<environment.Job instance at 0x7f22872e0320>,22,17,[ 2 11],23,-1,56,-1,39
1,<environment.Job instance at 0x7f227dd91820>,24,1,[ 2 11],25,-1,40,-1,39
1,<environment.Job instance at 0x7f22875955f0>,20,24,[10  4],21,-1,64,-1,40
1,<environment.Job instance at 0x7f227dc17460>,39,1,[ 5 14],40,-1,95,-1,94
1,<environment.Job instance at 0x7f227d6c80a0>,57,27,[ 2 11],58,-1,201,-1,174
1,<environment.Job instance at 0x7f227d6c8aa0>,59,3,[11  2],60,-1,182,-1,179
1,<environment.Job instance at 0x7f227d6c2820>,62,1,[12  5],63,-1,185,-1,184
1,<environment.Job instance at 0x7f227e6ca820>,0,19,[4 5],1,-1,20,-1,1
1,<environment.Job instance at 0x7f227e6cab40>,2,13,[9 4],3,-1,17,-1,4
1,<environment.Job instance at 0x7f227e6cae10>,4,16,[2 7],5,-1,21,-1,5
1,<environment.Job instance at 0x7f227e16c730>,8,16,[8 3],9,-1,25,-1,9
1,<environment.Job instance at 0x7f227e16c0f0>,10,23,[9 4],11,-1,34,-1,11
1,<environment.Job instance at 0x7f227e16c3c0>,11,21,[8 2],12,-1,33,-1,12
1,<environment.Job instance at 0x7f227e16ca50>,12,21,[5 7],13,-1,34,-1,13
1,<environment.Job instance at 0x7f227e16c780>,14,17,[9 2],15,-1,32,-1,15
1,<environment.Job instance at 0x7f227e16ce10>,15,18,[5 5],16,-1,34,-1,16
1,<environment.Job instance at 0x7f227e16cdc0>,18,28,[10  4],19,-1,47,-1,19
1,<environment.Job instance at 0x7f227e16c5a0>,22,18,[4 7],23,-1,41,-1,23
1,<environment.Job instance at 0x7f227e16cd70>,23,18,[7 1],24,-1,42,-1,24
1,<environment.Job instance at 0x7f227ea65e60>,24,14,[9 1],25,-1,39,-1,25
1,<environment.Job instance at 0x7f227ea65eb0>,26,18,[8 3],27,-1,45,-1,27
1,<environment.Job instance at 0x7f227ea65d70>,30,26,[4 9],31,-1,57,-1,31
1,<environment.Job instance at 0x7f227ea65dc0>,35,18,[1 8],36,-1,54,-1,36
1,<environment.Job instance at 0x7f227ea650a0>,37,23,[5 3],38,-1,61,-1,38
1,<environment.Job instance at 0x7f227ea65910>,38,16,[9 4],39,-1,55,-1,39
1,<environment.Job instance at 0x7f227e389410>,40,14,[1 5],41,-1,55,-1,41
1,<environment.Job instance at 0x7f22875464b0>,49,18,[6 4],50,-1,71,-1,53
1,<environment.Job instance at 0x7f227d4a6a00>,10,23,[9 4],11,-1,43,-1,20
1,<environment.Job instance at 0x7f227e3c7640>,18,28,[10  4],19,-1,55,-1,27
1,<environment.Job instance at 0x7f227d6e5280>,28,17,[12  1],29,-1,78,-1,61
1,<environment.Job instance at 0x7f227d6d9be0>,32,16,[13  1],33,-1,93,-1,77
1,<environment.Job instance at 0x7f227d6dc730>,37,23,[5 3],38,-1,119,-1,96
1,<environment.Job instance at 0x7f227e1f6be0>,30,26,[4 9],31,-1,126,-1,100
1,<environment.Job instance at 0x7f227d6c8aa0>,41,18,[11  2],42,-1,118,-1,100
1,<environment.Job instance at 0x7f227d6c80a0>,42,12,[ 5 13],43,-1,112,-1,100
1,<environment.Job instance at 0x7f227d6c8960>,43,24,[ 5 11],44,-1,124,-1,100
1,<environment.Job instance at 0x7f227d6c0050>,50,13,[11  2],51,-1,141,-1,128
1,<environment.Job instance at 0x7f227dc17500>,57,16,[ 3 12],58,-1,174,-1,158
1,<environment.Job instance at 0x7f227d35cb40>,76,25,[6 3],77,-1,269,-1,244
1,<environment.Job instance at 0x7f227eaa5eb0>,83,2,[14  3],84,-1,264,-1,262
1,<environment.Job instance at 0x7f227eaa52d0>,84,1,[14  5],85,-1,263,-1,262
1,<environment.Job instance at 0x7f227dad6a00>,1,18,[10  5],2,-1,20,-1,2
1,<environment.Job instance at 0x7f227dad6370>,5,18,[9 2],6,-1,26,-1,8
1,<environment.Job instance at 0x7f227dad6230>,7,20,[1 8],8,-1,30,-1,10
1,<environment.Job instance at 0x7f227e531730>,11,21,[4 9],12,-1,34,-1,13
1,<environment.Job instance at 0x7f227e531b90>,13,16,[8 1],14,-1,32,-1,16
1,<environment.Job instance at 0x7f227e531550>,15,23,[8 4],16,-1,39,-1,16
1,<environment.Job instance at 0x7f227e5310f0>,17,20,[5 7],18,-1,38,-1,18
1,<environment.Job instance at 0x7f227e531aa0>,18,16,[4 8],19,-1,35,-1,19
1,<environment.Job instance at 0x7f227e5318c0>,20,15,[2 8],21,-1,36,-1,21
1,<environment.Job instance at 0x7f227e6811e0>,25,16,[10  5],26,-1,42,-1,26
1,<environment.Job instance at 0x7f227e681550>,27,16,[1 7],28,-1,44,-1,28
1,<environment.Job instance at 0x7f227e681cd0>,29,18,[2 7],30,-1,48,-1,30
1,<environment.Job instance at 0x7f227e681460>,33,16,[9 4],34,-1,51,-1,35
1,<environment.Job instance at 0x7f227ddbd0f0>,40,24,[7 2],41,-1,65,-1,41
1,<environment.Job instance at 0x7f227ddbd5f0>,42,15,[ 2 10],43,-1,58,-1,43
1,<environment.Job instance at 0x7f227ddbd780>,44,17,[8 1],45,-1,62,-1,45
1,<environment.Job instance at 0x7f227ddbdbe0>,46,19,[2 9],47,-1,66,-1,47
1,<environment.Job instance at 0x7f227ddbd870>,48,20,[ 1 10],49,-1,69,-1,49
1,<environment.Job instance at 0x7f227ddbd5a0>,49,18,[2 7],50,-1,68,-1,50
1,<environment.Job instance at 0x7f227ddbd820>,51,18,[3 8],52,-1,70,-1,52
1,<environment.Job instance at 0x7f227e6603c0>,54,15,[4 8],55,-1,70,-1,55
1,<environment.Job instance at 0x7f227e660140>,56,16,[1 6],57,-1,73,-1,57
1,<environment.Job instance at 0x7f227e660dc0>,57,15,[7 4],58,-1,73,-1,58
1,<environment.Job instance at 0x7f227e6601e0>,59,17,[ 1 10],60,-1,77,-1,60
1,<environment.Job instance at 0x7f227e660f50>,61,28,[5 1],62,-1,90,-1,62
1,<environment.Job instance at 0x7f227d3786e0>,67,13,[9 1],68,-1,81,-1,68
1,<environment.Job instance at 0x7f227d3784b0>,73,23,[7 4],74,-1,97,-1,74
1,<environment.Job instance at 0x7f227d378730>,77,17,[10  4],78,-1,96,-1,79
1,<environment.Job instance at 0x7f227e681eb0>,3,1,[12  4],4,-1,5,-1,4
1,<environment.Job instance at 0x7f227d378e60>,10,2,[ 2 12],11,-1,13,-1,11
1,<environment.Job instance at 0x7f227e8a3aa0>,15,23,[8 4],16,-1,49,-1,26
1,<environment.Job instance at 0x7f227eaa5a00>,24,15,[11  1],25,-1,60,-1,45
1,<environment.Job instance at 0x7f227e918d70>,31,20,[ 5 13],32,-1,87,-1,67
1,<environment.Job instance at 0x7f227da2aeb0>,40,24,[7 2],41,-1,121,-1,97
1,<environment.Job instance at 0x7f227d6c0050>,45,15,[ 1 12],46,-1,131,-1,116
1,<environment.Job instance at 0x7f227d6dc640>,58,2,[ 1 13],59,-1,170,-1,168
1,<environment.Job instance at 0x7f227d6d9be0>,60,28,[ 2 14],61,-1,202,-1,174
1,<environment.Job instance at 0x7f227d6d9140>,61,28,[5 1],62,-1,202,-1,174
1,<environment.Job instance at 0x7f22875467d0>,73,23,[7 4],74,-1,236,-1,213
1,<environment.Job instance at 0x7f227d4a6370>,78,18,[13  5],79,-1,244,-1,226
1,<environment.Job instance at 0x7f227ea81190>,83,3,[13  5],84,-1,253,-1,250
1,<environment.Job instance at 0x7f227ea65550>,86,27,[5 2],87,-1,290,-1,263
1,<environment.Job instance at 0x7f227ea65320>,87,14,[ 3 14],88,-1,277,-1,263
1,<environment.Job instance at 0x7f227dc01690>,4,18,[10  2],5,-1,26,-1,8
1,<environment.Job instance at 0x7f227dc01730>,7,15,[5 8],8,-1,23,-1,8
1,<environment.Job instance at 0x7f227dc015a0>,8,18,[5 8],9,-1,27,-1,9
1,<environment.Job instance at 0x7f227dea5460>,9,17,[2 6],10,-1,27,-1,10
1,<environment.Job instance at 0x7f227dea5aa0>,13,14,[ 5 10],14,-1,29,-1,15
1,<environment.Job instance at 0x7f227dea50a0>,14,28,[4 5],15,-1,43,-1,15
1,<environment.Job instance at 0x7f227dea55a0>,16,17,[3 5],17,-1,36,-1,19
1,<environment.Job instance at 0x7f227d34e2d0>,19,1,[4 5],20,-1,21,-1,20
1,<environment.Job instance at 0x7f227d34e0a0>,20,13,[5 6],21,-1,34,-1,21
1,<environment.Job instance at 0x7f227d34ebe0>,21,25,[10  1],22,-1,47,-1,22
1,<environment.Job instance at 0x7f227d34e050>,22,12,[10  4],23,-1,35,-1,23
1,<environment.Job instance at 0x7f227d34edc0>,18,15,[5 8],19,-1,38,-1,23
1,<environment.Job instance at 0x7f227d34e500>,25,15,[8 1],26,-1,44,-1,29
1,<environment.Job instance at 0x7f227df7a730>,29,15,[6 2],30,-1,45,-1,30
1,<environment.Job instance at 0x7f227df7aaa0>,30,16,[7 5],31,-1,47,-1,31
1,<environment.Job instance at 0x7f227df7aa00>,31,15,[5 4],32,-1,47,-1,32
1,<environment.Job instance at 0x7f227df7a550>,32,2,[1 7],33,-1,35,-1,33
1,<environment.Job instance at 0x7f227df7a8c0>,28,18,[5 5],29,-1,51,-1,33
1,<environment.Job instance at 0x7f227df7aaf0>,33,17,[5 9],34,-1,51,-1,34
1,<environment.Job instance at 0x7f227df7af50>,34,17,[2 5],35,-1,52,-1,35
1,<environment.Job instance at 0x7f227df7adc0>,35,21,[9 3],36,-1,58,-1,37
1,<environment.Job instance at 0x7f227df7a0f0>,37,25,[9 4],38,-1,63,-1,38
1,<environment.Job instance at 0x7f227df7a910>,39,14,[5 4],40,-1,54,-1,40
1,<environment.Job instance at 0x7f227df7a780>,40,12,[10  1],41,-1,53,-1,41
1,<environment.Job instance at 0x7f227df7a7d0>,42,16,[9 4],43,-1,59,-1,43
1,<environment.Job instance at 0x7f227df7acd0>,43,12,[10  1],44,-1,56,-1,44
1,<environment.Job instance at 0x7f227df7a690>,44,17,[1 9],45,-1,62,-1,45
1,<environment.Job instance at 0x7f227d2f8d70>,46,18,[8 1],47,-1,65,-1,47
1,<environment.Job instance at 0x7f227d2f8500>,49,28,[6 1],50,-1,78,-1,50
1,<environment.Job instance at 0x7f227d2f87d0>,51,13,[7 4],52,-1,65,-1,52
1,<environment.Job instance at 0x7f227d2f8aa0>,54,18,[5 5],55,-1,73,-1,55
1,<environment.Job instance at 0x7f227e710fa0>,56,17,[2 6],57,-1,74,-1,57
1,<environment.Job instance at 0x7f227e710d70>,58,18,[5 3],59,-1,77,-1,59
1,<environment.Job instance at 0x7f227e710460>,61,13,[10  4],62,-1,75,-1,62
1,<environment.Job instance at 0x7f227e710320>,62,15,[8 4],63,-1,78,-1,63
1,<environment.Job instance at 0x7f227e710e60>,63,24,[5 3],64,-1,88,-1,64
1,<environment.Job instance at 0x7f2287682190>,64,15,[5 6],65,-1,80,-1,65
1,<environment.Job instance at 0x7f2287682eb0>,66,17,[2 5],67,-1,84,-1,67
1,<environment.Job instance at 0x7f227df5eaf0>,71,28,[9 4],72,-1,100,-1,72
1,<environment.Job instance at 0x7f227ea5c140>,75,15,[3 9],76,-1,91,-1,76
1,<environment.Job instance at 0x7f227e30b460>,77,17,[1 9],78,-1,95,-1,78
1,<environment.Job instance at 0x7f227e46f640>,78,19,[ 3 11],79,-1,98,-1,79
1,<environment.Job instance at 0x7f227dcd1500>,79,18,[7 5],80,-1,98,-1,80
1,<environment.Job instance at 0x7f227e4af0a0>,80,17,[10  1],81,-1,98,-1,81
1,<environment.Job instance at 0x7f227e4fed20>,81,14,[5 8],82,-1,96,-1,82
1,<environment.Job instance at 0x7f227ea5c3c0>,84,17,[7 2],85,-1,102,-1,85
1,<environment.Job instance at 0x7f227e6ffbe0>,86,21,[5 5],87,-1,108,-1,87
1,<environment.Job instance at 0x7f227dc01780>,14,28,[4 5],15,-1,55,-1,27
1,<environment.Job instance at 0x7f227e6edf00>,17,2,[ 5 13],18,-1,30,-1,28
1,<environment.Job instance at 0x7f227e701190>,21,25,[10  1],22,-1,67,-1,42
1,<environment.Job instance at 0x7f227e629dc0>,37,25,[9 4],38,-1,138,-1,113
1,<environment.Job instance at 0x7f227daa1af0>,49,28,[6 1],50,-1,194,-1,166
1,<environment.Job instance at 0x7f227daa1aa0>,52,18,[ 2 12],53,-1,184,-1,166
1,<environment.Job instance at 0x7f227e6f86e0>,63,24,[5 3],64,-1,227,-1,203
1,<environment.Job instance at 0x7f227e2e1690>,67,2,[11  4],68,-1,220,-1,218
1,<environment.Job instance at 0x7f227e2df460>,71,28,[9 4],72,-1,271,-1,243
1,<environment.Job instance at 0x7f227daa8050>,73,16,[ 1 12],74,-1,259,-1,243
1,<environment.Job instance at 0x7f227e6513c0>,78,19,[ 3 11],79,-1,272,-1,253
1,<environment.Job instance at 0x7f227db2af50>,4,16,[7 4],5,-1,21,-1,5
1,<environment.Job instance at 0x7f227d9d3730>,8,17,[9 5],9,-1,28,-1,11
1,<environment.Job instance at 0x7f227d9d3e60>,11,18,[4 7],12,-1,30,-1,12
1,<environment.Job instance at 0x7f227d9d35f0>,12,14,[4 6],13,-1,27,-1,13
1,<environment.Job instance at 0x7f227d9d36e0>,13,17,[9 1],14,-1,31,-1,14
1,<environment.Job instance at 0x7f227d9d39b0>,14,22,[4 9],15,-1,37,-1,15
1,<environment.Job instance at 0x7f227d9d3690>,16,21,[5 5],17,-1,38,-1,17
1,<environment.Job instance at 0x7f227e38d500>,19,15,[3 9],20,-1,35,-1,20
1,<environment.Job instance at 0x7f227e38d910>,22,12,[ 1 10],23,-1,35,-1,23
1,<environment.Job instance at 0x7f227e38dc80>,24,15,[10  2],25,-1,40,-1,25
1,<environment.Job instance at 0x7f227e38da00>,25,25,[1 6],26,-1,51,-1,26
1,<environment.Job instance at 0x7f227e3beeb0>,32,20,[ 5 10],33,-1,53,-1,33
1,<environment.Job instance at 0x7f227e3bec30>,34,12,[9 1],35,-1,47,-1,35
1,<environment.Job instance at 0x7f227e3be410>,35,24,[8 3],36,-1,60,-1,36
1,<environment.Job instance at 0x7f227e39deb0>,40,12,[5 6],41,-1,53,-1,41
1,<environment.Job instance at 0x7f227e39df50>,41,16,[3 9],42,-1,58,-1,42
1,<environment.Job instance at 0x7f227e39d7d0>,44,13,[2 7],45,-1,58,-1,45
1,<environment.Job instance at 0x7f227e39d460>,45,17,[10  3],46,-1,63,-1,46
1,<environment.Job instance at 0x7f227e39d050>,46,18,[6 4],47,-1,65,-1,47
1,<environment.Job instance at 0x7f227e39d8c0>,47,24,[5 9],48,-1,72,-1,48
1,<environment.Job instance at 0x7f227e39dbe0>,48,14,[6 4],49,-1,63,-1,49
1,<environment.Job instance at 0x7f227e39d550>,51,28,[3 6],52,-1,80,-1,52
1,<environment.Job instance at 0x7f227e3a74b0>,52,14,[ 4 10],53,-1,67,-1,53
1,<environment.Job instance at 0x7f227e3a7c30>,55,16,[7 3],56,-1,72,-1,56
1,<environment.Job instance at 0x7f227e3a7320>,57,16,[1 8],58,-1,74,-1,58
1,<environment.Job instance at 0x7f227e3a7af0>,59,26,[2 6],60,-1,86,-1,60
1,<environment.Job instance at 0x7f227e3c4870>,60,20,[9 3],61,-1,81,-1,61
1,<environment.Job instance at 0x7f227e3c4820>,61,15,[8 4],62,-1,77,-1,62
1,<environment.Job instance at 0x7f227e3c4280>,62,14,[9 2],63,-1,77,-1,63
1,<environment.Job instance at 0x7f227e3c4e60>,63,16,[2 6],64,-1,80,-1,64
1,<environment.Job instance at 0x7f227e3c4a00>,65,17,[5 3],66,-1,83,-1,66
1,<environment.Job instance at 0x7f227e3c4140>,68,26,[8 2],69,-1,95,-1,69
1,<environment.Job instance at 0x7f227e3c45f0>,70,13,[4 6],71,-1,84,-1,71
1,<environment.Job instance at 0x7f227e3923c0>,72,16,[9 2],73,-1,89,-1,73
1,<environment.Job instance at 0x7f227e3925a0>,73,18,[4 6],74,-1,92,-1,74
1,<environment.Job instance at 0x7f227e392e10>,76,17,[3 7],77,-1,94,-1,77
1,<environment.Job instance at 0x7f227e392b90>,79,17,[5 7],80,-1,97,-1,80
1,<environment.Job instance at 0x7f227e3924b0>,82,18,[7 4],83,-1,101,-1,83
1,<environment.Job instance at 0x7f227d4ea140>,83,14,[ 2 10],84,-1,98,-1,84
1,<environment.Job instance at 0x7f227d9d3c80>,10,15,[5 3],11,-1,422,-1,407
1,<environment.Job instance at 0x7f227e3a70f0>,7,13,[14  4],8,-1,21,-1,8
1,<environment.Job instance at 0x7f227d4ea6e0>,23,2,[13  2],24,-1,55,-1,53
1,<environment.Job instance at 0x7f227d4ea4b0>,25,25,[1 6],26,-1,90,-1,65
1,<environment.Job instance at 0x7f227e0c15a0>,30,27,[11  2],31,-1,110,-1,83
1,<environment.Job instance at 0x7f227e0c14b0>,35,24,[8 3],36,-1,114,-1,90
1,<environment.Job instance at 0x7f227dd06140>,47,24,[5 9],48,-1,157,-1,133
1,<environment.Job instance at 0x7f227dd06910>,51,28,[3 6],52,-1,166,-1,138
1,<environment.Job instance at 0x7f227dcfb320>,59,26,[2 6],60,-1,198,-1,172
1,<environment.Job instance at 0x7f227dcfb050>,67,1,[ 1 13],68,-1,196,-1,195
1,<environment.Job instance at 0x7f227dcfb500>,68,26,[8 2],69,-1,235,-1,209
1,<environment.Job instance at 0x7f227dcfbd70>,75,25,[ 3 14],76,-1,251,-1,226
1,<environment.Job instance at 0x7f227d4f8f50>,81,3,[ 4 13],82,-1,249,-1,246
1,<environment.Job instance at 0x7f227d4f8b90>,84,27,[13  3],85,-1,283,-1,256
1,<environment.Job instance at 0x7f227df7a410>,3,16,[3 8],4,-1,20,-1,4
1,<environment.Job instance at 0x7f227df7ad70>,4,13,[10  5],5,-1,18,-1,5
1,<environment.Job instance at 0x7f227df7adc0>,5,19,[1 5],6,-1,25,-1,6
1,<environment.Job instance at 0x7f227df7a960>,7,1,[10  2],8,-1,9,-1,8
1,<environment.Job instance at 0x7f227df7a910>,8,16,[3 8],9,-1,25,-1,9
1,<environment.Job instance at 0x7f227df7a140>,10,18,[9 2],11,-1,29,-1,11
1,<environment.Job instance at 0x7f227df7a7d0>,12,17,[9 4],13,-1,30,-1,13
1,<environment.Job instance at 0x7f227df7a0a0>,14,27,[6 1],15,-1,42,-1,15
1,<environment.Job instance at 0x7f227df7afa0>,15,14,[4 8],16,-1,30,-1,16
1,<environment.Job instance at 0x7f227df7af00>,16,17,[ 5 11],17,-1,34,-1,17
1,<environment.Job instance at 0x7f227df7a870>,19,16,[10  5],20,-1,36,-1,20
1,<environment.Job instance at 0x7f227e03d870>,20,12,[4 8],21,-1,33,-1,21
1,<environment.Job instance at 0x7f2287683190>,28,18,[5 9],29,-1,47,-1,29
1,<environment.Job instance at 0x7f2287683960>,29,3,[10  1],30,-1,33,-1,30
1,<environment.Job instance at 0x7f2287683c30>,30,18,[6 4],31,-1,49,-1,31
1,<environment.Job instance at 0x7f227e564410>,33,13,[8 4],34,-1,47,-1,34
1,<environment.Job instance at 0x7f227e5649b0>,35,16,[7 3],36,-1,52,-1,36
1,<environment.Job instance at 0x7f227e564730>,37,13,[10  4],38,-1,52,-1,39
1,<environment.Job instance at 0x7f227e564b40>,41,16,[ 5 11],42,-1,58,-1,42
1,<environment.Job instance at 0x7f227e564fa0>,42,16,[5 4],43,-1,59,-1,43
1,<environment.Job instance at 0x7f227dc82eb0>,45,27,[4 5],46,-1,73,-1,46
1,<environment.Job instance at 0x7f227dc82e10>,47,18,[1 6],48,-1,66,-1,48
1,<environment.Job instance at 0x7f227e4af0a0>,50,17,[9 2],51,-1,68,-1,51
1,<environment.Job instance at 0x7f227e173e60>,52,14,[7 3],53,-1,67,-1,53
1,<environment.Job instance at 0x7f227e3c5050>,56,25,[7 3],57,-1,82,-1,57
1,<environment.Job instance at 0x7f227e3c5230>,59,18,[6 2],60,-1,78,-1,60
1,<environment.Job instance at 0x7f227e3c5640>,60,26,[6 4],61,-1,87,-1,61
1,<environment.Job instance at 0x7f227e3c5370>,62,13,[ 3 10],63,-1,76,-1,63
1,<environment.Job instance at 0x7f227e3c5870>,63,14,[ 4 10],64,-1,78,-1,64
1,<environment.Job instance at 0x7f227e3c5280>,65,14,[5 7],66,-1,80,-1,66
1,<environment.Job instance at 0x7f22870dc410>,66,16,[9 2],67,-1,83,-1,67
1,<environment.Job instance at 0x7f22870dc5f0>,67,21,[9 4],68,-1,89,-1,68
1,<environment.Job instance at 0x7f22870dc460>,68,21,[5 1],69,-1,90,-1,69
1,<environment.Job instance at 0x7f22870dc3c0>,72,12,[1 9],73,-1,85,-1,73
1,<environment.Job instance at 0x7f227d593320>,75,16,[4 9],76,-1,92,-1,76
1,<environment.Job instance at 0x7f227d593c30>,76,18,[5 5],77,-1,95,-1,77
1,<environment.Job instance at 0x7f227db24c30>,79,20,[5 9],80,-1,100,-1,80
1,<environment.Job instance at 0x7f227db24e10>,80,17,[ 5 10],81,-1,98,-1,81
1,<environment.Job instance at 0x7f227db243c0>,81,14,[10  1],82,-1,96,-1,82
1,<environment.Job instance at 0x7f227db24280>,82,18,[3 8],83,-1,101,-1,83
1,<environment.Job instance at 0x7f227d593460>,14,27,[6 1],15,-1,59,-1,32
1,<environment.Job instance at 0x7f227d8cba50>,16,17,[ 5 11],17,-1,49,-1,32
1,<environment.Job instance at 0x7f227d4f8be0>,21,24,[14  3],22,-1,77,-1,53
1,<environment.Job instance at 0x7f227e3c5c80>,23,24,[10  2],24,-1,101,-1,77
1,<environment.Job instance at 0x7f227dcfb320>,40,13,[12  1],41,-1,132,-1,119
1,<environment.Job instance at 0x7f227dcfbb40>,41,16,[ 5 11],42,-1,135,-1,119
1,<environment.Job instance at 0x7f227e3b2f50>,45,27,[4 5],46,-1,165,-1,138
1,<environment.Job instance at 0x7f227e3b2690>,46,1,[12  2],47,-1,139,-1,138
1,<environment.Job instance at 0x7f227e3bed70>,56,25,[7 3],57,-1,197,-1,172
1,<environment.Job instance at 0x7f227e1dbaa0>,60,26,[6 4],61,-1,207,-1,181
1,<environment.Job instance at 0x7f227e941410>,2,18,[3 7],3,-1,21,-1,3
1,<environment.Job instance at 0x7f227e9419b0>,5,13,[9 1],6,-1,21,-1,8
1,<environment.Job instance at 0x7f227e941870>,8,14,[ 1 10],9,-1,23,-1,9
1,<environment.Job instance at 0x7f227e941b90>,7,15,[3 6],8,-1,25,-1,10
1,<environment.Job instance at 0x7f227e941c30>,10,25,[5 3],11,-1,36,-1,11
1,<environment.Job instance at 0x7f227e040910>,18,16,[10  3],19,-1,35,-1,19
1,<environment.Job instance at 0x7f227d219c80>,19,28,[3 9],20,-1,48,-1,20
1,<environment.Job instance at 0x7f227d852460>,22,23,[3 7],23,-1,46,-1,23
1,<environment.Job instance at 0x7f227d852aa0>,24,17,[2 7],25,-1,42,-1,25
1,<environment.Job instance at 0x7f227e6cdaa0>,27,16,[5 4],28,-1,44,-1,28
1,<environment.Job instance at 0x7f227d852410>,28,17,[6 5],29,-1,46,-1,29
1,<environment.Job instance at 0x7f227dad61e0>,29,18,[5 1],30,-1,48,-1,30
1,<environment.Job instance at 0x7f227d201280>,30,16,[1 7],31,-1,47,-1,31
1,<environment.Job instance at 0x7f227d201370>,31,12,[2 6],32,-1,44,-1,32
1,<environment.Job instance at 0x7f227d201960>,32,17,[6 4],33,-1,50,-1,33
1,<environment.Job instance at 0x7f227e531190>,36,15,[5 6],37,-1,52,-1,37
1,<environment.Job instance at 0x7f227d20ad70>,40,15,[1 8],41,-1,56,-1,41
1,<environment.Job instance at 0x7f227d20a7d0>,41,16,[5 5],42,-1,58,-1,42
1,<environment.Job instance at 0x7f227d20af00>,42,18,[2 5],43,-1,61,-1,43
1,<environment.Job instance at 0x7f227d20a820>,44,14,[ 3 10],45,-1,59,-1,45
1,<environment.Job instance at 0x7f227d255140>,57,2,[10  2],58,-1,60,-1,58
1,<environment.Job instance at 0x7f227e781eb0>,55,16,[10  3],56,-1,74,-1,58
1,<environment.Job instance at 0x7f227d1f59b0>,59,17,[9 4],60,-1,80,-1,63
1,<environment.Job instance at 0x7f227db6f320>,63,18,[4 5],64,-1,82,-1,64
1,<environment.Job instance at 0x7f227d9bb320>,66,16,[5 6],67,-1,83,-1,67
1,<environment.Job instance at 0x7f227d20a280>,47,16,[ 5 13],48,-1,88,-1,72
1,<environment.Job instance at 0x7f227d7e4190>,68,13,[8 2],69,-1,85,-1,72
1,<environment.Job instance at 0x7f227d255690>,53,20,[ 5 12],54,-1,93,-1,73
1,<environment.Job instance at 0x7f227d6fb7d0>,71,16,[4 6],72,-1,89,-1,73
1,<environment.Job instance at 0x7f227db460a0>,77,15,[10  4],78,-1,94,-1,79
1,<environment.Job instance at 0x7f227db46690>,78,16,[ 5 10],79,-1,97,-1,81
1,<environment.Job instance at 0x7f227e6c3370>,86,27,[2 9],87,-1,116,-1,89
1,<environment.Job instance at 0x7f227e6c3500>,88,18,[ 5 10],89,-1,107,-1,89
1,<environment.Job instance at 0x7f227db46500>,4,1,[13  5],5,-1,6,-1,5
1,<environment.Job instance at 0x7f227e947640>,10,25,[5 3],11,-1,42,-1,17
1,<environment.Job instance at 0x7f227e04c910>,11,16,[11  2],12,-1,33,-1,17
1,<environment.Job instance at 0x7f227e078a00>,19,28,[3 9],20,-1,73,-1,45
1,<environment.Job instance at 0x7f227eb20690>,22,23,[3 7],23,-1,71,-1,48
1,<environment.Job instance at 0x7f227e8aa1e0>,26,3,[ 5 14],27,-1,54,-1,51
1,<environment.Job instance at 0x7f227e35b460>,37,16,[11  1],38,-1,100,-1,84
1,<environment.Job instance at 0x7f227e5da140>,47,16,[ 5 13],48,-1,146,-1,130
1,<environment.Job instance at 0x7f227e06a3c0>,49,2,[13  4],50,-1,133,-1,131
1,<environment.Job instance at 0x7f227d609fa0>,53,20,[ 5 12],54,-1,153,-1,133
1,<environment.Job instance at 0x7f227e07c050>,54,2,[ 5 11],55,-1,135,-1,133
1,<environment.Job instance at 0x7f227da69640>,61,2,[ 5 11],62,-1,155,-1,153
1,<environment.Job instance at 0x7f227e5fbe10>,69,13,[ 4 14],70,-1,187,-1,174
1,<environment.Job instance at 0x7f227da471e0>,76,16,[13  1],77,-1,217,-1,201
1,<environment.Job instance at 0x7f227da36410>,86,27,[2 9],87,-1,266,-1,239
1,<environment.Job instance at 0x7f227d3ede10>,2,22,[8 1],3,-1,26,-1,4
1,<environment.Job instance at 0x7f227d3edd70>,3,14,[14  4],4,-1,18,-1,4
1,<environment.Job instance at 0x7f227d3ed960>,8,16,[9 1],9,-1,28,-1,12
1,<environment.Job instance at 0x7f227d3ed500>,11,27,[8 5],12,-1,39,-1,12
1,<environment.Job instance at 0x7f227e5da2d0>,17,18,[1 9],18,-1,36,-1,18
1,<environment.Job instance at 0x7f227dc6c0a0>,22,18,[10  5],23,-1,41,-1,23
1,<environment.Job instance at 0x7f227dc6c690>,24,17,[10  5],25,-1,43,-1,26
1,<environment.Job instance at 0x7f227dc6cbe0>,27,15,[ 4 10],28,-1,43,-1,28
1,<environment.Job instance at 0x7f227dc6c460>,32,18,[9 1],33,-1,51,-1,33
1,<environment.Job instance at 0x7f227d64f6e0>,42,18,[1 9],43,-1,65,-1,47
1,<environment.Job instance at 0x7f227d64ffa0>,44,18,[7 1],45,-1,65,-1,47
1,<environment.Job instance at 0x7f227da486e0>,3,14,[14  4],4,-1,18,-1,4
1,<environment.Job instance at 0x7f227da4c910>,5,3,[ 1 13],6,-1,9,-1,6
1,<environment.Job instance at 0x7f227da48690>,6,2,[14  2],7,-1,9,-1,7
1,<environment.Job instance at 0x7f227da471e0>,7,15,[ 5 12],8,-1,23,-1,8
1,<environment.Job instance at 0x7f227da47230>,10,2,[14  4],11,-1,13,-1,11
1,<environment.Job instance at 0x7f227da47eb0>,11,27,[8 5],12,-1,52,-1,25
1,<environment.Job instance at 0x7f227dc6c820>,14,16,[11  4],15,-1,41,-1,25
1,<environment.Job instance at 0x7f227dc6c910>,18,16,[13  2],19,-1,43,-1,27
1,<environment.Job instance at 0x7f227da69640>,21,14,[ 2 12],22,-1,44,-1,30
1,<environment.Job instance at 0x7f227e06e0a0>,23,26,[7 1],24,-1,59,-1,33
1,<environment.Job instance at 0x7f227d531f50>,49,25,[3 6],50,-1,165,-1,140
1,<environment.Job instance at 0x7f227d6521e0>,51,16,[ 5 12],52,-1,156,-1,140
1,<environment.Job instance at 0x7f227e372c30>,53,17,[13  5],54,-1,159,-1,142
1,<environment.Job instance at 0x7f227d3c21e0>,65,2,[ 3 11],66,-1,193,-1,191
1,<environment.Job instance at 0x7f227dc63fa0>,72,3,[ 4 11],73,-1,212,-1,209
1,<environment.Job instance at 0x7f227dc63cd0>,80,3,[ 3 12],81,-1,249,-1,246
1,<environment.Job instance at 0x7f227dc63af0>,78,24,[5 6],79,-1,278,-1,254
1,<environment.Job instance at 0x7f227dc63d20>,82,14,[14  5],83,-1,268,-1,254
1,<environment.Job instance at 0x7f227d8245f0>,0,20,[ 4 10],1,-1,21,-1,1
1,<environment.Job instance at 0x7f227e553c80>,3,14,[ 4 10],4,-1,18,-1,4
1,<environment.Job instance at 0x7f227e553eb0>,6,24,[4 5],7,-1,31,-1,7
1,<environment.Job instance at 0x7f227e553fa0>,7,24,[4 8],8,-1,32,-1,8
1,<environment.Job instance at 0x7f227e549820>,16,16,[4 9],17,-1,33,-1,17
1,<environment.Job instance at 0x7f227e5499b0>,17,18,[6 1],18,-1,36,-1,18
1,<environment.Job instance at 0x7f227e549a50>,19,15,[6 4],20,-1,35,-1,20
1,<environment.Job instance at 0x7f227e549e10>,22,23,[6 2],23,-1,46,-1,23
1,<environment.Job instance at 0x7f227e548190>,26,17,[1 6],27,-1,45,-1,28
1,<environment.Job instance at 0x7f227e548370>,29,3,[4 5],30,-1,33,-1,30
1,<environment.Job instance at 0x7f227e548230>,30,2,[1 5],31,-1,33,-1,31
1,<environment.Job instance at 0x7f227e548410>,31,1,[3 6],32,-1,33,-1,32
1,<environment.Job instance at 0x7f227e5485f0>,32,18,[6 5],33,-1,51,-1,33
1,<environment.Job instance at 0x7f227e548730>,34,14,[ 5 10],35,-1,49,-1,35
1,<environment.Job instance at 0x7f227e5487d0>,36,16,[4 8],37,-1,53,-1,37
1,<environment.Job instance at 0x7f227e5489b0>,37,15,[4 8],38,-1,53,-1,38
1,<environment.Job instance at 0x7f227e548a50>,38,15,[1 6],39,-1,54,-1,39
1,<environment.Job instance at 0x7f227e544140>,44,17,[1 6],45,-1,62,-1,45
1,<environment.Job instance at 0x7f227e5440a0>,45,14,[3 8],46,-1,60,-1,46
1,<environment.Job instance at 0x7f227e544230>,46,17,[4 6],47,-1,64,-1,47
1,<environment.Job instance at 0x7f227e548050>,27,13,[9 4],28,-1,79,-1,66
1,<environment.Job instance at 0x7f227e548500>,35,28,[ 4 12],36,-1,97,-1,69
1,<environment.Job instance at 0x7f227e544d70>,56,12,[3 5],57,-1,82,-1,70
1,<environment.Job instance at 0x7f227e544eb0>,61,17,[9 4],62,-1,89,-1,72
1,<environment.Job instance at 0x7f227e544780>,52,17,[ 1 10],53,-1,90,-1,73
1,<environment.Job instance at 0x7f227e5449b0>,55,24,[5 2],56,-1,99,-1,75
1,<environment.Job instance at 0x7f227e5464b0>,66,12,[9 1],67,-1,87,-1,75
1,<environment.Job instance at 0x7f227e542a50>,68,18,[10  4],69,-1,93,-1,75
1,<environment.Job instance at 0x7f227e542a00>,69,13,[ 1 11],70,-1,88,-1,75
1,<environment.Job instance at 0x7f227e542b90>,70,25,[5 5],71,-1,100,-1,75
1,<environment.Job instance at 0x7f227e542aa0>,71,13,[9 3],72,-1,88,-1,75
1,<environment.Job instance at 0x7f227e544e10>,60,25,[6 2],61,-1,100,-1,75
1,<environment.Job instance at 0x7f227e542730>,75,19,[2 8],76,-1,96,-1,77
1,<environment.Job instance at 0x7f227d4dc500>,79,15,[ 5 10],80,-1,95,-1,80
1,<environment.Job instance at 0x7f227e6cb1e0>,81,17,[ 2 10],82,-1,99,-1,82
1,<environment.Job instance at 0x7f227de8df50>,82,16,[2 8],83,-1,99,-1,83
1,<environment.Job instance at 0x7f227e5423c0>,76,16,[ 1 10],77,-1,100,-1,84
1,<environment.Job instance at 0x7f227de8d230>,85,18,[4 6],86,-1,104,-1,86
1,<environment.Job instance at 0x7f227da133c0>,86,15,[5 9],87,-1,102,-1,87
1,<environment.Job instance at 0x7f227e544640>,6,24,[4 5],7,-1,44,-1,20
1,<environment.Job instance at 0x7f227e5483c0>,7,24,[4 8],8,-1,45,-1,21
1,<environment.Job instance at 0x7f227dc63730>,22,23,[6 2],23,-1,67,-1,44
1,<environment.Job instance at 0x7f227dc63be0>,24,3,[ 1 12],25,-1,47,-1,44
1,<environment.Job instance at 0x7f227dc63e10>,25,14,[12  1],26,-1,58,-1,44
1,<environment.Job instance at 0x7f227dc63960>,33,1,[11  3],34,-1,63,-1,62
1,<environment.Job instance at 0x7f227d3c29b0>,35,28,[ 4 12],36,-1,91,-1,63
1,<environment.Job instance at 0x7f227d3c2be0>,39,1,[ 4 13],40,-1,91,-1,90
1,<environment.Job instance at 0x7f227d3c2870>,43,14,[ 2 11],44,-1,119,-1,105
1,<environment.Job instance at 0x7f227d510370>,55,24,[5 2],56,-1,183,-1,159
1,<environment.Job instance at 0x7f227d61b410>,60,25,[6 2],61,-1,211,-1,186
1,<environment.Job instance at 0x7f227d609fa0>,69,13,[ 1 11],70,-1,218,-1,205
1,<environment.Job instance at 0x7f227d609b40>,70,25,[5 5],71,-1,233,-1,208
1,<environment.Job instance at 0x7f227e06e280>,73,3,[ 4 11],74,-1,211,-1,208
1,<environment.Job instance at 0x7f227da47230>,88,16,[14  4],89,-1,286,-1,270
1,<environment.Job instance at 0x7f227e6b9820>,0,15,[8 4],1,-1,17,-1,2
1,<environment.Job instance at 0x7f227e5a0e60>,4,19,[ 5 10],5,-1,24,-1,5
1,<environment.Job instance at 0x7f227e5a0690>,6,15,[3 9],7,-1,22,-1,7
1,<environment.Job instance at 0x7f227e5a0dc0>,7,27,[8 5],8,-1,35,-1,8
1,<environment.Job instance at 0x7f227da36a50>,1,12,[8 1],2,-1,21,-1,9
1,<environment.Job instance at 0x7f227d4e1730>,15,15,[10  1],16,-1,32,-1,17
1,<environment.Job instance at 0x7f227e55cdc0>,20,20,[8 5],21,-1,41,-1,21
1,<environment.Job instance at 0x7f227e55ceb0>,24,16,[5 8],25,-1,41,-1,25
1,<environment.Job instance at 0x7f227e55c0f0>,25,25,[4 5],26,-1,51,-1,26
1,<environment.Job instance at 0x7f227d6728c0>,30,18,[3 5],31,-1,49,-1,31
1,<environment.Job instance at 0x7f227d672f00>,31,15,[3 7],32,-1,47,-1,32
1,<environment.Job instance at 0x7f227d4e10a0>,16,13,[ 2 10],17,-1,52,-1,39
1,<environment.Job instance at 0x7f227e1af500>,41,13,[3 5],42,-1,55,-1,42
1,<environment.Job instance at 0x7f227e1af870>,42,18,[4 8],43,-1,61,-1,43
1,<environment.Job instance at 0x7f227dafe7d0>,43,15,[ 2 10],44,-1,59,-1,44
1,<environment.Job instance at 0x7f227dafe5a0>,46,13,[6 4],47,-1,61,-1,48
1,<environment.Job instance at 0x7f227dafe190>,48,12,[10  4],49,-1,61,-1,49
1,<environment.Job instance at 0x7f227dafe870>,49,12,[5 8],50,-1,62,-1,50
1,<environment.Job instance at 0x7f22871352d0>,61,17,[7 4],62,-1,79,-1,62
1,<environment.Job instance at 0x7f227dafe140>,47,26,[ 3 10],48,-1,89,-1,63
1,<environment.Job instance at 0x7f2287135640>,63,14,[ 5 10],64,-1,78,-1,64
1,<environment.Job instance at 0x7f2287135c80>,65,13,[7 4],66,-1,80,-1,67
1,<environment.Job instance at 0x7f227e06fd70>,70,15,[5 5],71,-1,86,-1,71
1,<environment.Job instance at 0x7f227e06fe10>,72,17,[5 7],73,-1,90,-1,73
1,<environment.Job instance at 0x7f227d50fcd0>,74,12,[7 1],75,-1,87,-1,75
1,<environment.Job instance at 0x7f227da98b40>,80,18,[9 3],81,-1,99,-1,81
1,<environment.Job instance at 0x7f227da98050>,81,17,[9 4],82,-1,99,-1,82
1,<environment.Job instance at 0x7f227da98d20>,86,17,[4 8],87,-1,104,-1,87
1,<environment.Job instance at 0x7f227da980a0>,87,14,[5 6],88,-1,102,-1,88
1,<environment.Job instance at 0x7f227da98690>,88,16,[8 4],89,-1,105,-1,89
1,<environment.Job instance at 0x7f227e55cfa0>,7,27,[8 5],8,-1,43,-1,16
1,<environment.Job instance at 0x7f227e1af3c0>,9,3,[ 1 12],10,-1,19,-1,16
1,<environment.Job instance at 0x7f22871350a0>,13,17,[13  3],14,-1,36,-1,19
1,<environment.Job instance at 0x7f2287135190>,14,3,[13  1],15,-1,22,-1,19
1,<environment.Job instance at 0x7f227dc6cfa0>,25,25,[4 5],26,-1,66,-1,41
1,<environment.Job instance at 0x7f227dc6c410>,28,1,[ 4 14],29,-1,47,-1,46
1,<environment.Job instance at 0x7f227e5dac80>,40,2,[13  2],41,-1,76,-1,74
1,<environment.Job instance at 0x7f227d533b90>,44,1,[12  5],45,-1,86,-1,85
1,<environment.Job instance at 0x7f227d531b40>,47,26,[ 3 10],48,-1,129,-1,103
1,<environment.Job instance at 0x7f227e372460>,51,3,[12  2],52,-1,121,-1,118
1,<environment.Job instance at 0x7f227dc635a0>,64,3,[14  3],65,-1,144,-1,141
1,<environment.Job instance at 0x7f227e542690>,76,1,[11  3],77,-1,177,-1,176
1,<environment.Job instance at 0x7f227e544cd0>,83,14,[14  1],84,-1,215,-1,201
1,<environment.Job instance at 0x7f227e2a36e0>,11,18,[7 1],12,-1,31,-1,13
1,<environment.Job instance at 0x7f22870bff00>,15,16,[3 5],16,-1,32,-1,16
1,<environment.Job instance at 0x7f227d580dc0>,19,14,[7 3],20,-1,38,-1,24
1,<environment.Job instance at 0x7f227d580820>,22,17,[1 5],23,-1,44,-1,27
1,<environment.Job instance at 0x7f227dd6b730>,24,18,[4 8],25,-1,45,-1,27
1,<environment.Job instance at 0x7f227dd6b780>,26,12,[5 3],27,-1,39,-1,27
1,<environment.Job instance at 0x7f227dd6baf0>,27,15,[6 1],28,-1,43,-1,28
1,<environment.Job instance at 0x7f2287680d20>,28,15,[10  2],29,-1,44,-1,29
1,<environment.Job instance at 0x7f2287680d70>,29,13,[4 7],30,-1,43,-1,30
1,<environment.Job instance at 0x7f227da58410>,31,23,[5 9],32,-1,55,-1,32
1,<environment.Job instance at 0x7f227da58fa0>,32,14,[5 2],33,-1,53,-1,39
1,<environment.Job instance at 0x7f227dda45f0>,37,22,[2 9],38,-1,63,-1,41
1,<environment.Job instance at 0x7f227df0c1e0>,40,13,[5 8],41,-1,56,-1,43
1,<environment.Job instance at 0x7f227d156190>,13,15,[ 2 12],14,-1,59,-1,44
1,<environment.Job instance at 0x7f227df0ce10>,43,15,[ 3 10],44,-1,59,-1,44
1,<environment.Job instance at 0x7f227df0ceb0>,41,16,[5 2],42,-1,63,-1,47
1,<environment.Job instance at 0x7f227d9ed1e0>,47,16,[8 4],48,-1,64,-1,48
1,<environment.Job instance at 0x7f227d5fd780>,45,14,[7 5],46,-1,63,-1,49
1,<environment.Job instance at 0x7f227d9edd20>,50,15,[10  5],51,-1,66,-1,51
1,<environment.Job instance at 0x7f227d580c80>,21,26,[7 2],22,-1,79,-1,53
1,<environment.Job instance at 0x7f227d5fd8c0>,46,20,[8 2],47,-1,76,-1,56
1,<environment.Job instance at 0x7f227d89c730>,59,20,[ 3 11],60,-1,81,-1,61
1,<environment.Job instance at 0x7f227d9ed370>,48,26,[2 5],49,-1,88,-1,62
1,<environment.Job instance at 0x7f227e8a61e0>,61,16,[8 4],62,-1,80,-1,64
1,<environment.Job instance at 0x7f227e5b72d0>,65,15,[9 1],66,-1,88,-1,73
1,<environment.Job instance at 0x7f227e5b71e0>,67,16,[8 4],68,-1,89,-1,73
1,<environment.Job instance at 0x7f227dfff960>,56,24,[2 9],57,-1,101,-1,77
1,<environment.Job instance at 0x7f227d9bb910>,73,13,[10  3],74,-1,90,-1,77
1,<environment.Job instance at 0x7f227e2fccd0>,77,14,[4 7],78,-1,92,-1,78
1,<environment.Job instance at 0x7f227d580f00>,2,17,[ 5 14],3,-1,20,-1,3
1,<environment.Job instance at 0x7f227d507640>,13,15,[ 2 12],14,-1,31,-1,16
1,<environment.Job instance at 0x7f227e127230>,18,2,[13  1],19,-1,44,-1,42
1,<environment.Job instance at 0x7f227d290d20>,21,26,[7 2],22,-1,85,-1,59
1,<environment.Job instance at 0x7f227d7d37d0>,33,3,[ 1 14],34,-1,98,-1,95
1,<environment.Job instance at 0x7f227d7d35f0>,36,1,[ 3 13],37,-1,100,-1,99
1,<environment.Job instance at 0x7f227d3d10f0>,31,23,[5 9],32,-1,140,-1,117
1,<environment.Job instance at 0x7f227d7d32d0>,48,26,[2 5],49,-1,163,-1,137
1,<environment.Job instance at 0x7f227e040be0>,56,24,[2 9],57,-1,196,-1,172
1,<environment.Job instance at 0x7f227e040050>,57,12,[ 2 12],58,-1,184,-1,172
1,<environment.Job instance at 0x7f227e0400f0>,58,14,[13  4],59,-1,186,-1,172
1,<environment.Job instance at 0x7f227e040c30>,59,20,[ 3 11],60,-1,192,-1,172
1,<environment.Job instance at 0x7f227da66230>,76,1,[ 3 11],77,-1,224,-1,223
1,<environment.Job instance at 0x7f227da66410>,81,23,[1 8],82,-1,262,-1,239
1,<environment.Job instance at 0x7f227da66cd0>,86,13,[ 5 11],87,-1,270,-1,257
1,<environment.Job instance at 0x7f228753aa00>,4,2,[1 5],5,-1,7,-1,5
1,<environment.Job instance at 0x7f228753a050>,6,25,[8 1],7,-1,32,-1,7
1,<environment.Job instance at 0x7f228753a280>,7,18,[ 1 10],8,-1,26,-1,8
1,<environment.Job instance at 0x7f227ea01c80>,13,16,[9 5],14,-1,30,-1,14
1,<environment.Job instance at 0x7f227ea013c0>,14,28,[7 4],15,-1,43,-1,15
1,<environment.Job instance at 0x7f227ea01730>,15,20,[7 2],16,-1,36,-1,16
1,<environment.Job instance at 0x7f227ea010a0>,16,14,[10  3],17,-1,31,-1,17
1,<environment.Job instance at 0x7f227e6cdbe0>,17,17,[5 6],18,-1,35,-1,18
1,<environment.Job instance at 0x7f227e9d70f0>,19,17,[5 2],20,-1,37,-1,20
1,<environment.Job instance at 0x7f227e5c2d20>,21,17,[9 3],22,-1,39,-1,22
1,<environment.Job instance at 0x7f227e9d7460>,23,15,[2 7],24,-1,39,-1,24
1,<environment.Job instance at 0x7f227d92b730>,24,19,[1 8],25,-1,44,-1,25
1,<environment.Job instance at 0x7f227e9d7190>,26,17,[8 4],27,-1,44,-1,27
1,<environment.Job instance at 0x7f227e926320>,30,13,[8 4],31,-1,44,-1,31
1,<environment.Job instance at 0x7f227e4d1370>,32,12,[7 3],33,-1,45,-1,33
1,<environment.Job instance at 0x7f227deb3820>,33,20,[4 5],34,-1,54,-1,34
1,<environment.Job instance at 0x7f22870bceb0>,35,20,[5 5],36,-1,56,-1,36
1,<environment.Job instance at 0x7f227de7a140>,36,18,[7 3],37,-1,55,-1,37
1,<environment.Job instance at 0x7f227e9535f0>,38,18,[1 5],39,-1,57,-1,39
1,<environment.Job instance at 0x7f227e4b65f0>,40,16,[ 2 10],41,-1,57,-1,41
1,<environment.Job instance at 0x7f227e4b6640>,41,18,[3 9],42,-1,60,-1,42
1,<environment.Job instance at 0x7f227e4caf50>,48,13,[8 5],49,-1,63,-1,50
1,<environment.Job instance at 0x7f227e4bd320>,51,25,[1 6],52,-1,77,-1,52
1,<environment.Job instance at 0x7f227e4bd1e0>,54,17,[5 5],55,-1,72,-1,55
1,<environment.Job instance at 0x7f227e4bd690>,55,24,[4 7],56,-1,80,-1,56
1,<environment.Job instance at 0x7f227e4bd140>,57,15,[1 8],58,-1,73,-1,58
1,<environment.Job instance at 0x7f227e4ba0f0>,59,15,[9 1],60,-1,75,-1,60
1,<environment.Job instance at 0x7f227e4ba320>,60,12,[10  4],61,-1,73,-1,61
1,<environment.Job instance at 0x7f227e4ba2d0>,61,15,[10  4],62,-1,77,-1,62
1,<environment.Job instance at 0x7f227e4ba9b0>,67,28,[7 2],68,-1,96,-1,68
1,<environment.Job instance at 0x7f227e4a4050>,75,17,[9 3],76,-1,94,-1,77
1,<environment.Job instance at 0x7f227e4a45f0>,79,12,[5 1],80,-1,102,-1,90
1,<environment.Job instance at 0x7f227e4a4500>,77,20,[10  2],78,-1,110,-1,90
1,<environment.Job instance at 0x7f227e4baeb0>,72,26,[9 1],73,-1,116,-1,90
1,<environment.Job instance at 0x7f227e4a4820>,83,3,[8 4],84,-1,93,-1,90
1,<environment.Job instance at 0x7f227e4ca820>,49,15,[4 6],50,-1,105,-1,90
1,<environment.Job instance at 0x7f227e4a4960>,85,3,[ 1 10],86,-1,93,-1,90
1,<environment.Job instance at 0x7f227e4baa50>,69,27,[ 3 10],70,-1,118,-1,91
1,<environment.Job instance at 0x7f227e4a4780>,87,27,[9 4],88,-1,119,-1,92
1,<environment.Job instance at 0x7f227e4d1fa0>,6,25,[8 1],7,-1,42,-1,17
1,<environment.Job instance at 0x7f227e4ba870>,14,28,[7 4],15,-1,51,-1,23
1,<environment.Job instance at 0x7f227e2a7c80>,37,13,[14  1],38,-1,112,-1,99
1,<environment.Job instance at 0x7f227e040140>,46,2,[14  1],47,-1,134,-1,132
1,<environment.Job instance at 0x7f227e040a00>,51,25,[1 6],52,-1,173,-1,148
1,<environment.Job instance at 0x7f227d7d3910>,52,12,[12  2],53,-1,160,-1,148
1,<environment.Job instance at 0x7f227e0400a0>,53,26,[10  4],54,-1,177,-1,151
1,<environment.Job instance at 0x7f227d7d3eb0>,55,24,[4 7],56,-1,183,-1,159
1,<environment.Job instance at 0x7f227d7d3cd0>,64,13,[ 5 11],65,-1,206,-1,193
1,<environment.Job instance at 0x7f227d6cb7d0>,67,28,[7 2],68,-1,240,-1,212
1,<environment.Job instance at 0x7f227d4d55f0>,69,27,[ 3 10],70,-1,243,-1,216
1,<environment.Job instance at 0x7f227e1a9370>,72,26,[9 1],73,-1,256,-1,230
1,<environment.Job instance at 0x7f22871354b0>,76,3,[ 2 14],77,-1,233,-1,230
1,<environment.Job instance at 0x7f227d5fd2d0>,87,27,[9 4],88,-1,291,-1,264
1,<environment.Job instance at 0x7f77eefc06e0>,0,18,[ 2 10],1,-1,20,-1,2
1,<environment.Job instance at 0x7f77e59d0a50>,3,18,[ 3 10],4,-1,22,-1,4
1,<environment.Job instance at 0x7f77e59d0be0>,4,18,[10  4],5,-1,23,-1,5
1,<environment.Job instance at 0x7f77e59d0af0>,5,13,[5 9],6,-1,19,-1,6
1,<environment.Job instance at 0x7f77e59d0c80>,6,12,[11  4],7,-1,19,-1,7
1,<environment.Job instance at 0x7f77e59d0dc0>,8,17,[ 2 10],9,-1,26,-1,9
1,<environment.Job instance at 0x7f77e59d0f00>,9,17,[ 4 10],10,-1,27,-1,10
1,<environment.Job instance at 0x7f77e59d32d0>,13,13,[1 8],14,-1,27,-1,14
1,<environment.Job instance at 0x7f77e59d3550>,16,12,[1 8],17,-1,29,-1,17
1,<environment.Job instance at 0x7f77e59d34b0>,18,16,[8 5],19,-1,35,-1,19
1,<environment.Job instance at 0x7f77e59d3820>,19,17,[12  3],20,-1,37,-1,20
1,<environment.Job instance at 0x7f77eefc08c0>,1,15,[ 1 14],2,-1,36,-1,21
1,<environment.Job instance at 0x7f77e59d3e10>,26,22,[2 9],27,-1,49,-1,27
1,<environment.Job instance at 0x7f77e59d6370>,31,17,[4 9],32,-1,49,-1,32
1,<environment.Job instance at 0x7f77e59d6410>,32,17,[9 3],33,-1,53,-1,36
1,<environment.Job instance at 0x7f77e59d6730>,37,14,[5 5],38,-1,52,-1,38
1,<environment.Job instance at 0x7f77e59d6910>,39,18,[5 8],40,-1,58,-1,40
1,<environment.Job instance at 0x7f77e59d6b40>,41,14,[6 1],42,-1,56,-1,42
1,<environment.Job instance at 0x7f77e59d6d20>,42,14,[8 4],43,-1,57,-1,43
1,<environment.Job instance at 0x7f77e59d6c80>,43,28,[6 4],44,-1,72,-1,44
1,<environment.Job instance at 0x7f77e59d66e0>,35,16,[8 1],36,-1,60,-1,44
1,<environment.Job instance at 0x7f77e59d88c0>,55,17,[4 7],56,-1,73,-1,56
1,<environment.Job instance at 0x7f77e59d8d20>,56,18,[4 5],57,-1,75,-1,57
1,<environment.Job instance at 0x7f77e59d8f50>,59,14,[ 2 10],60,-1,75,-1,61
1,<environment.Job instance at 0x7f77e59dc1e0>,62,20,[9 1],63,-1,83,-1,63
1,<environment.Job instance at 0x7f77e59dc3c0>,63,15,[1 5],64,-1,79,-1,64
1,<environment.Job instance at 0x7f77e59dc280>,64,12,[6 1],65,-1,77,-1,65
1,<environment.Job instance at 0x7f77e59dc460>,65,13,[3 5],66,-1,79,-1,66
1,<environment.Job instance at 0x7f77e59dc5a0>,67,26,[5 4],68,-1,94,-1,68
1,<environment.Job instance at 0x7f77e59dc730>,68,22,[5 6],69,-1,91,-1,69
1,<environment.Job instance at 0x7f77e59dc690>,69,13,[7 2],70,-1,83,-1,70
1,<environment.Job instance at 0x7f77e59dc820>,70,18,[5 5],71,-1,89,-1,71
1,<environment.Job instance at 0x7f77e59dc960>,72,14,[9 1],73,-1,87,-1,73
1,<environment.Job instance at 0x7f77e59dca00>,74,1,[6 2],75,-1,76,-1,75
1,<environment.Job instance at 0x7f77e59dcbe0>,76,13,[1 5],77,-1,90,-1,77
1,<environment.Job instance at 0x7f77e59dceb0>,77,15,[4 7],78,-1,93,-1,78
1,<environment.Job instance at 0x7f77e59d8fa0>,60,24,[ 3 10],61,-1,102,-1,78
1,<environment.Job instance at 0x7f77e59d3280>,1,15,[ 1 14],2,-1,17,-1,2
1,<environment.Job instance at 0x7f77e59d60a0>,6,12,[11  4],7,-1,19,-1,7
1,<environment.Job instance at 0x7f77e5a15640>,19,17,[12  3],20,-1,67,-1,50
1,<environment.Job instance at 0x7f77e5af5a00>,22,2,[12  3],23,-1,62,-1,60
1,<environment.Job instance at 0x7f77e5a7a7d0>,43,28,[6 4],44,-1,166,-1,138
1,<environment.Job instance at 0x7f77e5af1aa0>,44,17,[ 5 12],45,-1,155,-1,138
1,<environment.Job instance at 0x7f77e5adb4b0>,50,27,[9 1],51,-1,179,-1,152
1,<environment.Job instance at 0x7f77e5adbd70>,52,3,[ 3 11],53,-1,155,-1,152
1,<environment.Job instance at 0x7f77e5ad2140>,53,18,[ 4 12],54,-1,170,-1,152
1,<environment.Job instance at 0x7f77e59f8eb0>,60,24,[ 3 10],61,-1,209,-1,185
1,<environment.Job instance at 0x7f77e59f8af0>,67,26,[5 4],68,-1,226,-1,200
1,<environment.Job instance at 0x7f77e5a80190>,81,17,[ 4 14],82,-1,256,-1,239
1,<environment.Job instance at 0x7f77e5a80870>,85,19,[14  4],86,-1,260,-1,241
1,<environment.Job instance at 0x7f77e5af70f0>,95,23,[3 7],96,-1,294,-1,271
1,<environment.Job instance at 0x7f77e511c640>,0,18,[7 5],1,-1,19,-1,1
1,<environment.Job instance at 0x7f77e511a140>,3,17,[5 6],4,-1,21,-1,4
1,<environment.Job instance at 0x7f77e511ad70>,8,20,[5 7],9,-1,29,-1,9
1,<environment.Job instance at 0x7f77e511a640>,9,3,[5 3],10,-1,14,-1,11
1,<environment.Job instance at 0x7f77e5968320>,10,20,[5 7],11,-1,33,-1,13
1,<environment.Job instance at 0x7f77e511b730>,15,14,[9 1],16,-1,31,-1,17
1,<environment.Job instance at 0x7f77e511bf50>,19,16,[1 8],20,-1,36,-1,20
1,<environment.Job instance at 0x7f77e511a460>,16,15,[9 2],17,-1,35,-1,20
1,<environment.Job instance at 0x7f77e53445a0>,34,15,[10  5],35,-1,53,-1,38
1,<environment.Job instance at 0x7f77e4f8e1e0>,40,17,[3 8],41,-1,58,-1,41
1,<environment.Job instance at 0x7f77e4f9d320>,37,12,[14  5],38,-1,54,-1,42
1,<environment.Job instance at 0x7f77e5054fa0>,41,16,[5 4],42,-1,66,-1,50
1,<environment.Job instance at 0x7f77e4ff0370>,43,16,[6 4],44,-1,66,-1,50
1,<environment.Job instance at 0x7f77e4ff0690>,45,15,[6 2],46,-1,67,-1,52
1,<environment.Job instance at 0x7f77e511efa0>,50,13,[2 6],51,-1,65,-1,52
1,<environment.Job instance at 0x7f77e4fe68c0>,51,16,[1 9],52,-1,68,-1,52
1,<environment.Job instance at 0x7f77e58d7280>,52,16,[6 2],53,-1,69,-1,53
1,<environment.Job instance at 0x7f77e4fc37d0>,55,14,[3 8],56,-1,72,-1,58
1,<environment.Job instance at 0x7f77e5022320>,58,16,[3 9],59,-1,75,-1,59
1,<environment.Job instance at 0x7f77e4ff0280>,46,15,[6 2],47,-1,80,-1,65
1,<environment.Job instance at 0x7f77e516f690>,57,17,[3 8],58,-1,83,-1,66
1,<environment.Job instance at 0x7f77e4f6b190>,66,22,[11  3],67,-1,89,-1,67
1,<environment.Job instance at 0x7f77e4f6a730>,68,18,[4 6],69,-1,88,-1,70
1,<environment.Job instance at 0x7f77e4f6a230>,69,16,[3 5],70,-1,86,-1,70
1,<environment.Job instance at 0x7f77e511b9b0>,17,18,[ 3 12],18,-1,380,-1,362
1,<environment.Job instance at 0x7f77e4f65910>,96,23,[5 8],97,-1,385,-1,362
1,<environment.Job instance at 0x7f77e4ff0780>,2,27,[ 3 13],3,-1,30,-1,3
1,<environment.Job instance at 0x7f77e4f7ee60>,11,18,[ 3 13],12,-1,38,-1,20
1,<environment.Job instance at 0x7f77e51c4fa0>,17,18,[ 3 12],18,-1,41,-1,23
1,<environment.Job instance at 0x7f77e5320050>,21,18,[11  5],22,-1,47,-1,29
1,<environment.Job instance at 0x7f77e5272b40>,22,14,[14  1],23,-1,43,-1,29
1,<environment.Job instance at 0x7f77e5179cd0>,35,15,[ 3 14],36,-1,84,-1,69
1,<environment.Job instance at 0x7f77e5189910>,37,12,[14  5],38,-1,84,-1,72
1,<environment.Job instance at 0x7f77e51d2960>,66,22,[11  3],67,-1,211,-1,189
1,<environment.Job instance at 0x7f77e51c81e0>,79,23,[2 8],80,-1,277,-1,254
1,<environment.Job instance at 0x7f77e52a7320>,75,25,[3 9],76,-1,286,-1,261
1,<environment.Job instance at 0x7f77e51dfb90>,86,26,[9 1],87,-1,289,-1,263
1,<environment.Job instance at 0x7f77e514a820>,96,23,[5 8],97,-1,332,-1,309
1,<environment.Job instance at 0x7f77e4fce1e0>,2,14,[9 2],3,-1,18,-1,4
1,<environment.Job instance at 0x7f77e59d8c30>,3,27,[5 3],4,-1,31,-1,4
1,<environment.Job instance at 0x7f77e4fce230>,4,17,[10  2],5,-1,23,-1,6
1,<environment.Job instance at 0x7f77e4fd0460>,6,13,[5 1],7,-1,20,-1,7
1,<environment.Job instance at 0x7f77e4fd0910>,7,1,[1 6],8,-1,9,-1,8
1,<environment.Job instance at 0x7f77e4fd0410>,8,22,[9 2],9,-1,31,-1,9
1,<environment.Job instance at 0x7f77e4fd00a0>,5,17,[5 9],6,-1,27,-1,10
1,<environment.Job instance at 0x7f77e4fd0190>,10,17,[2 9],11,-1,28,-1,11
1,<environment.Job instance at 0x7f77e4fd0730>,12,17,[10  4],13,-1,31,-1,14
1,<environment.Job instance at 0x7f77e4fd0640>,14,13,[5 9],15,-1,28,-1,15
1,<environment.Job instance at 0x7f77e4fd0f50>,15,17,[8 1],16,-1,33,-1,16
1,<environment.Job instance at 0x7f77e4fd0eb0>,16,16,[7 2],17,-1,33,-1,17
1,<environment.Job instance at 0x7f77e4fd0e10>,17,18,[ 1 10],18,-1,36,-1,18
1,<environment.Job instance at 0x7f77e4fd0d70>,18,28,[7 4],19,-1,47,-1,19
1,<environment.Job instance at 0x7f77e4ff78c0>,23,15,[5 6],24,-1,39,-1,24
1,<environment.Job instance at 0x7f77e4ff7460>,25,17,[3 5],26,-1,43,-1,26
1,<environment.Job instance at 0x7f77e4ff7280>,26,15,[ 5 10],27,-1,42,-1,27
1,<environment.Job instance at 0x7f77e4ff7a50>,32,16,[8 5],33,-1,49,-1,33
1,<environment.Job instance at 0x7f77e4ff7f50>,34,14,[8 5],35,-1,49,-1,35
1,<environment.Job instance at 0x7f77e5058820>,35,12,[2 6],36,-1,48,-1,36
1,<environment.Job instance at 0x7f77e50583c0>,38,18,[3 8],39,-1,57,-1,39
1,<environment.Job instance at 0x7f77e5058f00>,39,16,[9 4],40,-1,56,-1,40
1,<environment.Job instance at 0x7f77e5058e60>,44,15,[9 5],45,-1,67,-1,52
1,<environment.Job instance at 0x7f77e5058a50>,50,18,[8 5],51,-1,70,-1,52
1,<environment.Job instance at 0x7f77e5058af0>,43,18,[1 6],44,-1,79,-1,61
1,<environment.Job instance at 0x7f77e4feb550>,53,14,[3 5],54,-1,78,-1,64
1,<environment.Job instance at 0x7f77e4ff75a0>,24,28,[9 1],25,-1,94,-1,66
1,<environment.Job instance at 0x7f77e50582d0>,40,28,[7 3],41,-1,95,-1,67
1,<environment.Job instance at 0x7f77e4febcd0>,58,12,[12  2],59,-1,79,-1,67
1,<environment.Job instance at 0x7f77e4feb4b0>,54,17,[1 9],55,-1,84,-1,67
1,<environment.Job instance at 0x7f77e4feb320>,63,21,[9 5],64,-1,88,-1,67
1,<environment.Job instance at 0x7f77e4febb90>,64,18,[10  2],65,-1,85,-1,67
1,<environment.Job instance at 0x7f77e5006050>,68,21,[5 1],69,-1,94,-1,73
1,<environment.Job instance at 0x7f77e4fc6b90>,71,18,[ 5 14],72,-1,92,-1,74
1,<environment.Job instance at 0x7f77e4fc63c0>,72,17,[8 2],73,-1,96,-1,79
1,<environment.Job instance at 0x7f77e5006690>,66,22,[6 1],67,-1,101,-1,79
1,<environment.Job instance at 0x7f77e5006fa0>,67,14,[3 5],68,-1,98,-1,84
1,<environment.Job instance at 0x7f77e4feb370>,59,12,[1 8],60,-1,100,-1,88
1,<environment.Job instance at 0x7f77e4fc6500>,77,14,[4 7],78,-1,103,-1,89
1,<environment.Job instance at 0x7f77e4fc6780>,79,13,[5 7],80,-1,102,-1,89
1,<environment.Job instance at 0x7f77e4fc6c80>,73,18,[7 5],74,-1,109,-1,91
1,<environment.Job instance at 0x7f77e4febe10>,61,19,[ 3 14],62,-1,113,-1,94
1,<environment.Job instance at 0x7f77e4fc0910>,90,13,[7 4],91,-1,107,-1,94
1,<environment.Job instance at 0x7f77e4fc6140>,81,16,[6 2],82,-1,111,-1,95
1,<environment.Job instance at 0x7f77e4fc3aa0>,89,14,[5 7],90,-1,109,-1,95
1,<environment.Job instance at 0x7f77e4fc0be0>,94,18,[ 5 10],95,-1,115,-1,97
1,<environment.Job instance at 0x7f77e4ff7be0>,1,2,[12  1],2,-1,4,-1,2
1,<environment.Job instance at 0x7f77e5058cd0>,3,27,[5 3],4,-1,31,-1,4
1,<environment.Job instance at 0x7f77e5006820>,9,3,[ 4 12],10,-1,13,-1,10
1,<environment.Job instance at 0x7f77e4fc6870>,11,18,[ 5 11],12,-1,35,-1,17
1,<environment.Job instance at 0x7f77e4fce0a0>,18,28,[7 4],19,-1,75,-1,47
1,<environment.Job instance at 0x7f77e59d8140>,24,28,[9 1],25,-1,92,-1,64
1,<environment.Job instance at 0x7f77e4f6dbe0>,28,16,[14  3],29,-1,86,-1,70
1,<environment.Job instance at 0x7f77e4fbb140>,40,28,[7 3],41,-1,160,-1,132
1,<environment.Job instance at 0x7f77e4fb88c0>,58,12,[12  2],59,-1,222,-1,210
1,<environment.Job instance at 0x7f77e4fb8780>,61,19,[ 3 14],62,-1,232,-1,213
1,<environment.Job instance at 0x7f77e4fb6910>,62,2,[14  5],63,-1,215,-1,213
1,<environment.Job instance at 0x7f77e4fb6dc0>,65,12,[12  4],66,-1,227,-1,215
1,<environment.Job instance at 0x7f77e4fb6140>,71,18,[ 5 14],72,-1,251,-1,233
1,<environment.Job instance at 0x7f77e5002cd0>,78,1,[ 5 14],79,-1,258,-1,257
1,<environment.Job instance at 0x7f77e5002d70>,83,3,[14  5],84,-1,280,-1,277
1,<environment.Job instance at 0x7f77e4fa6050>,88,17,[12  1],89,-1,307,-1,290
1,<environment.Job instance at 0x7f77e4fa6410>,92,1,[13  3],93,-1,304,-1,303
1,<environment.Job instance at 0x7f77e5e154b0>,0,17,[4 5],1,-1,18,-1,1
1,<environment.Job instance at 0x7f77e5e15e10>,5,18,[9 5],6,-1,24,-1,6
1,<environment.Job instance at 0x7f77e5abe910>,7,17,[7 5],8,-1,25,-1,8
1,<environment.Job instance at 0x7f77e5e15500>,10,14,[2 8],11,-1,25,-1,11
1,<environment.Job instance at 0x7f77e5abea50>,11,15,[10  3],12,-1,30,-1,15
1,<environment.Job instance at 0x7f77e5abe870>,14,16,[8 3],15,-1,31,-1,15
1,<environment.Job instance at 0x7f77e5abeaf0>,19,17,[4 8],20,-1,38,-1,21
1,<environment.Job instance at 0x7f77e5abec80>,20,14,[ 3 10],21,-1,36,-1,22
1,<environment.Job instance at 0x7f77e5abe8c0>,21,18,[ 4 13],22,-1,41,-1,23
1,<environment.Job instance at 0x7f77e5e14280>,25,2,[2 6],26,-1,29,-1,27
1,<environment.Job instance at 0x7f77e5e14c80>,28,2,[1 7],29,-1,31,-1,29
1,<environment.Job instance at 0x7f77e5e14140>,30,13,[ 4 10],31,-1,44,-1,31
1,<environment.Job instance at 0x7f77e5e14910>,31,16,[2 8],32,-1,48,-1,32
1,<environment.Job instance at 0x7f77e5e14960>,38,14,[10  4],39,-1,55,-1,41
1,<environment.Job instance at 0x7f77e5f86f50>,42,20,[7 3],43,-1,65,-1,45
1,<environment.Job instance at 0x7f77e5f86a50>,45,17,[6 3],46,-1,64,-1,47
1,<environment.Job instance at 0x7f77e5f86960>,48,17,[2 8],49,-1,66,-1,49
1,<environment.Job instance at 0x7f77e5f86910>,51,14,[3 6],52,-1,66,-1,52
1,<environment.Job instance at 0x7f77e5f866e0>,52,15,[7 3],53,-1,69,-1,54
1,<environment.Job instance at 0x7f77ef133550>,55,16,[2 6],56,-1,74,-1,58
1,<environment.Job instance at 0x7f77e5f86fa0>,46,20,[6 2],47,-1,78,-1,58
1,<environment.Job instance at 0x7f77ef133370>,56,15,[10  5],57,-1,73,-1,58
1,<environment.Job instance at 0x7f77ef133f00>,58,16,[3 6],59,-1,75,-1,59
1,<environment.Job instance at 0x7f77ef1330f0>,59,22,[1 6],60,-1,82,-1,60
1,<environment.Job instance at 0x7f77ef133870>,57,16,[ 3 10],58,-1,89,-1,73
1,<environment.Job instance at 0x7f77e5e14500>,27,16,[ 5 13],28,-1,102,-1,86
1,<environment.Job instance at 0x7f77e5e16140>,69,18,[ 2 10],70,-1,104,-1,86
1,<environment.Job instance at 0x7f77e5e162d0>,71,18,[3 8],72,-1,104,-1,86
1,<environment.Job instance at 0x7f77e5e16230>,73,24,[3 6],74,-1,110,-1,86
1,<environment.Job instance at 0x7f77e5e166e0>,75,20,[3 8],76,-1,108,-1,88
1,<environment.Job instance at 0x7f77ef133fa0>,61,25,[10  4],62,-1,113,-1,88
1,<environment.Job instance at 0x7f77e5e161e0>,76,15,[4 9],77,-1,103,-1,88
1,<environment.Job instance at 0x7f77e5e169b0>,78,14,[3 6],79,-1,102,-1,88
1,<environment.Job instance at 0x7f77e5e16190>,80,18,[4 8],81,-1,106,-1,88
1,<environment.Job instance at 0x7f77e5b309b0>,85,18,[ 3 10],86,-1,108,-1,90
1,<environment.Job instance at 0x7f77e5b30fa0>,86,21,[6 1],87,-1,111,-1,90
1,<environment.Job instance at 0x7f77e5b30f00>,87,13,[4 9],88,-1,103,-1,90
1,<environment.Job instance at 0x7f77e5b30640>,88,12,[8 2],89,-1,102,-1,90
1,<environment.Job instance at 0x7f77e5b30280>,90,12,[1 5],91,-1,105,-1,93
1,<environment.Job instance at 0x7f77e5e165a0>,77,27,[9 5],78,-1,120,-1,93
1,<environment.Job instance at 0x7f77e5b30820>,92,17,[9 1],93,-1,112,-1,95
1,<environment.Job instance at 0x7f77e5d876e0>,95,27,[5 5],96,-1,126,-1,99
1,<environment.Job instance at 0x7f77e5d87280>,93,18,[8 1],94,-1,117,-1,99
1,<environment.Job instance at 0x7f77e5d87640>,96,22,[2 8],97,-1,121,-1,99
1,<environment.Job instance at 0x7f77e5e14410>,2,27,[ 2 13],3,-1,30,-1,3
1,<environment.Job instance at 0x7f77e5f86280>,8,1,[12  5],9,-1,10,-1,9
1,<environment.Job instance at 0x7f77e4f7e140>,21,18,[ 4 13],22,-1,68,-1,50
1,<environment.Job instance at 0x7f77e5de0140>,27,16,[ 5 13],28,-1,83,-1,67
1,<environment.Job instance at 0x7f77e60f8550>,34,18,[13  2],35,-1,115,-1,97
1,<environment.Job instance at 0x7f77e631f230>,40,18,[11  4],41,-1,125,-1,107
1,<environment.Job instance at 0x7f77e5cda9b0>,61,25,[10  4],62,-1,230,-1,205
1,<environment.Job instance at 0x7f77e5abd500>,73,24,[3 6],74,-1,257,-1,233
1,<environment.Job instance at 0x7f77e652f190>,77,27,[9 5],78,-1,273,-1,246
1,<environment.Job instance at 0x7f77e5ec99b0>,83,2,[ 3 14],84,-1,265,-1,263
1,<environment.Job instance at 0x7f77e5ad23c0>,94,3,[ 3 12],95,-1,323,-1,320
1,<environment.Job instance at 0x7f77e5ad2870>,95,27,[5 5],96,-1,347,-1,320
1,<environment.Job instance at 0x7f77e5ad2d70>,98,13,[14  4],99,-1,351,-1,338
1,<environment.Job instance at 0x7f77e5ab97d0>,0,16,[1 9],1,-1,17,-1,1
1,<environment.Job instance at 0x7f77e55e52d0>,2,17,[4 6],3,-1,20,-1,3
1,<environment.Job instance at 0x7f77e55e5e10>,3,27,[7 5],4,-1,31,-1,4
1,<environment.Job instance at 0x7f77e55eea00>,11,18,[5 7],12,-1,30,-1,12
1,<environment.Job instance at 0x7f77e55ee780>,12,13,[8 1],13,-1,26,-1,13
1,<environment.Job instance at 0x7f77e55ee6e0>,13,16,[3 5],14,-1,30,-1,14
1,<environment.Job instance at 0x7f77e55ee8c0>,15,25,[3 7],16,-1,41,-1,16
1,<environment.Job instance at 0x7f77e55eebe0>,17,14,[10  3],18,-1,33,-1,19
1,<environment.Job instance at 0x7f77e650ac30>,22,13,[3 9],23,-1,36,-1,23
1,<environment.Job instance at 0x7f77e56bc280>,25,16,[10  5],26,-1,43,-1,27
1,<environment.Job instance at 0x7f77e650a0f0>,27,14,[9 1],28,-1,42,-1,28
1,<environment.Job instance at 0x7f77e5df7730>,28,21,[9 5],29,-1,50,-1,29
1,<environment.Job instance at 0x7f77e5df7fa0>,30,17,[9 4],31,-1,48,-1,31
1,<environment.Job instance at 0x7f77e5617370>,32,12,[8 5],33,-1,52,-1,40
1,<environment.Job instance at 0x7f77e5dca140>,39,16,[ 5 13],40,-1,60,-1,44
1,<environment.Job instance at 0x7f77e5617410>,37,16,[2 6],38,-1,60,-1,44
1,<environment.Job instance at 0x7f77e5dd4dc0>,44,14,[ 3 14],45,-1,59,-1,45
1,<environment.Job instance at 0x7f77e5dd4410>,43,17,[1 8],44,-1,63,-1,46
1,<environment.Job instance at 0x7f77e5dd4500>,45,24,[3 9],46,-1,71,-1,47
1,<environment.Job instance at 0x7f77e5dd4d70>,46,17,[9 1],47,-1,70,-1,53
1,<environment.Job instance at 0x7f77e5dd8230>,53,13,[9 5],54,-1,67,-1,54
1,<environment.Job instance at 0x7f77e5dd8370>,52,17,[10  3],53,-1,72,-1,55
1,<environment.Job instance at 0x7f77e56ca5a0>,60,13,[3 8],61,-1,75,-1,62
1,<environment.Job instance at 0x7f77e56ca7d0>,62,27,[5 5],63,-1,90,-1,63
1,<environment.Job instance at 0x7f77e56ca870>,63,14,[3 6],64,-1,84,-1,70
1,<environment.Job instance at 0x7f77e56ca910>,64,25,[1 7],65,-1,95,-1,70
1,<environment.Job instance at 0x7f77e56ca410>,61,15,[14  1],62,-1,85,-1,70
1,<environment.Job instance at 0x7f77e56174b0>,35,15,[5 7],36,-1,85,-1,70
1,<environment.Job instance at 0x7f77e56caa50>,66,15,[ 5 10],67,-1,85,-1,70
1,<environment.Job instance at 0x7f77e56caf50>,72,12,[4 9],73,-1,96,-1,84
1,<environment.Job instance at 0x7f77e56e1280>,75,14,[7 3],76,-1,99,-1,85
1,<environment.Job instance at 0x7f77e56e1320>,76,27,[5 8],77,-1,112,-1,85
1,<environment.Job instance at 0x7f77e56caeb0>,73,18,[4 8],74,-1,104,-1,86
1,<environment.Job instance at 0x7f77e56e1c30>,90,14,[ 4 10],91,-1,136,-1,122
1,<environment.Job instance at 0x7f77e56ab230>,96,18,[8 2],97,-1,156,-1,138
1,<environment.Job instance at 0x7f77e650adc0>,4,13,[14  5],5,-1,18,-1,5
1,<environment.Job instance at 0x7f77e54741e0>,3,27,[7 5],4,-1,44,-1,17
1,<environment.Job instance at 0x7f77e56cab40>,15,25,[3 7],16,-1,60,-1,35
1,<environment.Job instance at 0x7f77e56ab280>,20,1,[ 4 12],21,-1,49,-1,48
1,<environment.Job instance at 0x7f77e5e26fa0>,24,12,[13  3],25,-1,76,-1,64
1,<environment.Job instance at 0x7f77e5ad23c0>,29,3,[12  1],30,-1,81,-1,78
1,<environment.Job instance at 0x7f77e5b5f870>,39,16,[ 5 13],40,-1,132,-1,116
1,<environment.Job instance at 0x7f77e5abd5a0>,44,14,[ 3 14],45,-1,140,-1,126
1,<environment.Job instance at 0x7f77e5abd2d0>,45,24,[3 9],46,-1,167,-1,143
1,<environment.Job instance at 0x7f77e5adb910>,55,1,[12  4],56,-1,170,-1,169
1,<environment.Job instance at 0x7f77e5a36f00>,61,15,[14  1],62,-1,201,-1,186
1,<environment.Job instance at 0x7f77e5a363c0>,62,27,[5 5],63,-1,214,-1,187
1,<environment.Job instance at 0x7f77e65566e0>,64,25,[1 7],65,-1,214,-1,189
1,<environment.Job instance at 0x7f77e5db5c30>,76,27,[5 8],77,-1,272,-1,245
1,<environment.Job instance at 0x7f77e60f8c80>,81,24,[4 8],82,-1,285,-1,261
1,<environment.Job instance at 0x7f77e5de0500>,91,1,[11  1],92,-1,283,-1,282
1,<environment.Job instance at 0x7f77e57b4f00>,0,19,[2 7],1,-1,21,-1,2
1,<environment.Job instance at 0x7f77e57b4280>,1,24,[1 9],2,-1,27,-1,3
1,<environment.Job instance at 0x7f77e53f67d0>,7,23,[10  4],8,-1,31,-1,8
1,<environment.Job instance at 0x7f77e53f6780>,8,14,[3 8],9,-1,23,-1,9
1,<environment.Job instance at 0x7f77e53f65f0>,11,17,[5 7],12,-1,29,-1,12
1,<environment.Job instance at 0x7f77e50e35a0>,14,13,[1 9],15,-1,28,-1,15
1,<environment.Job instance at 0x7f77e50e3550>,15,16,[4 5],16,-1,32,-1,16
1,<environment.Job instance at 0x7f77e50e3410>,19,17,[ 5 10],20,-1,37,-1,20
1,<environment.Job instance at 0x7f77e50e34b0>,20,18,[4 6],21,-1,39,-1,21
1,<environment.Job instance at 0x7f77e57bc730>,24,15,[5 7],25,-1,40,-1,25
1,<environment.Job instance at 0x7f77e57bccd0>,25,24,[10  2],26,-1,50,-1,26
1,<environment.Job instance at 0x7f77e57bc910>,26,14,[ 5 10],27,-1,41,-1,27
1,<environment.Job instance at 0x7f77e57bcbe0>,27,18,[1 7],28,-1,46,-1,28
1,<environment.Job instance at 0x7f77e57bc190>,28,19,[1 6],29,-1,48,-1,29
1,<environment.Job instance at 0x7f77e50e33c0>,22,17,[ 2 12],23,-1,48,-1,31
1,<environment.Job instance at 0x7f77e57bc4b0>,33,20,[5 7],34,-1,54,-1,34
1,<environment.Job instance at 0x7f77e57bce60>,36,27,[4 5],37,-1,64,-1,37
1,<environment.Job instance at 0x7f77e57bc370>,38,15,[5 9],39,-1,54,-1,39
1,<environment.Job instance at 0x7f77e533cf00>,40,14,[8 4],41,-1,55,-1,41
1,<environment.Job instance at 0x7f77e533c140>,43,18,[6 1],44,-1,62,-1,44
1,<environment.Job instance at 0x7f77e5e1fbe0>,57,18,[3 6],58,-1,77,-1,59
1,<environment.Job instance at 0x7f77e5e1fd20>,58,14,[6 4],59,-1,86,-1,72
1,<environment.Job instance at 0x7f77e5e1f0f0>,56,16,[2 6],57,-1,89,-1,73
1,<environment.Job instance at 0x7f77e5e37d70>,63,18,[ 1 10],64,-1,91,-1,73
1,<environment.Job instance at 0x7f77e5e37cd0>,64,14,[7 5],65,-1,87,-1,73
1,<environment.Job instance at 0x7f77e5e26140>,69,14,[9 5],70,-1,89,-1,75
1,<environment.Job instance at 0x7f77e53f6d70>,1,24,[1 9],2,-1,44,-1,20
1,<environment.Job instance at 0x7f77e533c190>,7,23,[10  4],8,-1,44,-1,21
1,<environment.Job instance at 0x7f77e5e37a50>,13,3,[ 5 13],14,-1,26,-1,23
1,<environment.Job instance at 0x7f77e541f820>,16,17,[13  2],17,-1,43,-1,26
1,<environment.Job instance at 0x7f77e57ae8c0>,17,1,[11  4],18,-1,27,-1,26
1,<environment.Job instance at 0x7f77e5355780>,22,17,[ 2 12],23,-1,68,-1,51
1,<environment.Job instance at 0x7f77e53553c0>,25,24,[10  2],26,-1,89,-1,65
1,<environment.Job instance at 0x7f77e56aba50>,29,27,[14  1],30,-1,112,-1,85
1,<environment.Job instance at 0x7f77e56ab320>,32,2,[11  4],33,-1,87,-1,85
1,<environment.Job instance at 0x7f77e56ca370>,35,12,[11  5],36,-1,111,-1,99
1,<environment.Job instance at 0x7f77e56cad20>,36,27,[4 5],37,-1,126,-1,99
1,<environment.Job instance at 0x7f77e5dd1370>,42,3,[11  3],43,-1,115,-1,112
1,<environment.Job instance at 0x7f77e56f84b0>,51,15,[ 2 14],52,-1,160,-1,145
1,<environment.Job instance at 0x7f77e64f1960>,55,12,[ 3 13],56,-1,164,-1,152
1,<environment.Job instance at 0x7f77e59b30f0>,71,17,[14  3],72,-1,220,-1,203
1,<environment.Job instance at 0x7f77e5d7fb90>,74,15,[ 2 13],75,-1,221,-1,206
1,<environment.Job instance at 0x7f77e64b6a00>,77,3,[12  4],78,-1,221,-1,218
1,<environment.Job instance at 0x7f77e5f0ea50>,79,28,[1 8],80,-1,263,-1,235
1,<environment.Job instance at 0x7f77e4eea730>,88,18,[13  3],89,-1,275,-1,257
1,<environment.Job instance at 0x7f77e4ee5050>,95,24,[8 3],96,-1,313,-1,289
1,<environment.Job instance at 0x7f77e57b85a0>,0,18,[8 1],1,-1,24,-1,6
1,<environment.Job instance at 0x7f77e56426e0>,6,18,[9 4],7,-1,25,-1,7
1,<environment.Job instance at 0x7f77e5642690>,7,17,[3 5],8,-1,25,-1,8
1,<environment.Job instance at 0x7f77e57aa320>,8,17,[2 6],9,-1,26,-1,9
1,<environment.Job instance at 0x7f77e57aa370>,12,15,[10  1],13,-1,29,-1,14
1,<environment.Job instance at 0x7f77e57aaaf0>,14,24,[4 5],15,-1,39,-1,15
1,<environment.Job instance at 0x7f77e57aa1e0>,15,13,[8 5],16,-1,29,-1,16
1,<environment.Job instance at 0x7f77e57aa730>,16,13,[3 9],17,-1,30,-1,17
1,<environment.Job instance at 0x7f77e5b13550>,17,14,[2 5],18,-1,32,-1,18
1,<environment.Job instance at 0x7f77e5b13190>,18,16,[6 5],19,-1,35,-1,19
1,<environment.Job instance at 0x7f77e57aa910>,13,17,[5 3],14,-1,36,-1,19
1,<environment.Job instance at 0x7f77e512d730>,24,16,[9 2],25,-1,43,-1,27
1,<environment.Job instance at 0x7f77e6198140>,30,3,[10  4],31,-1,34,-1,31
1,<environment.Job instance at 0x7f77e57d1910>,26,15,[9 1],27,-1,46,-1,31
1,<environment.Job instance at 0x7f77e51523c0>,32,13,[ 5 10],33,-1,46,-1,33
1,<environment.Job instance at 0x7f77e506e320>,33,15,[6 1],34,-1,49,-1,34
1,<environment.Job instance at 0x7f77e61c3cd0>,38,17,[7 2],39,-1,56,-1,39
1,<environment.Job instance at 0x7f77e5655a00>,39,16,[10  2],40,-1,56,-1,40
1,<environment.Job instance at 0x7f77e5655460>,40,15,[5 6],41,-1,56,-1,41
1,<environment.Job instance at 0x7f77e51390a0>,44,15,[7 3],45,-1,61,-1,46
1,<environment.Job instance at 0x7f77e563d370>,47,15,[10  1],48,-1,63,-1,48
1,<environment.Job instance at 0x7f77e563d280>,48,2,[4 5],49,-1,51,-1,49
1,<environment.Job instance at 0x7f77e563d690>,49,23,[6 5],50,-1,73,-1,50
1,<environment.Job instance at 0x7f77e563d460>,50,17,[2 6],51,-1,68,-1,51
1,<environment.Job instance at 0x7f77e51398c0>,45,12,[10  3],46,-1,63,-1,51
1,<environment.Job instance at 0x7f77e51580a0>,59,21,[1 9],60,-1,81,-1,60
1,<environment.Job instance at 0x7f77e51581e0>,60,27,[6 4],61,-1,88,-1,61
1,<environment.Job instance at 0x7f77e5158320>,62,15,[10  1],63,-1,79,-1,64
1,<environment.Job instance at 0x7f77e5158230>,64,13,[1 8],65,-1,78,-1,65
1,<environment.Job instance at 0x7f77e5158640>,66,14,[1 7],67,-1,81,-1,67
1,<environment.Job instance at 0x7f77e5158730>,68,22,[7 5],69,-1,91,-1,69
1,<environment.Job instance at 0x7f77e5158a00>,69,16,[5 3],70,-1,86,-1,70
1,<environment.Job instance at 0x7f77e5158870>,70,18,[ 5 10],71,-1,89,-1,71
1,<environment.Job instance at 0x7f77e5158b40>,72,24,[1 6],73,-1,97,-1,73
1,<environment.Job instance at 0x7f77e5158d20>,73,16,[8 5],74,-1,90,-1,74
1,<environment.Job instance at 0x7f77e5158be0>,74,16,[9 4],75,-1,91,-1,75
1,<environment.Job instance at 0x7f77e5158e60>,76,15,[10  4],77,-1,92,-1,77
1,<environment.Job instance at 0x7f77e5158f50>,77,13,[ 4 10],78,-1,91,-1,78
1,<environment.Job instance at 0x7f77e513d0a0>,78,17,[3 9],79,-1,96,-1,79
1,<environment.Job instance at 0x7f77e513d9b0>,86,12,[1 5],87,-1,99,-1,87
1,<environment.Job instance at 0x7f77e513da00>,88,14,[9 1],89,-1,103,-1,89
1,<environment.Job instance at 0x7f77e513dd20>,89,17,[1 9],90,-1,107,-1,90
1,<environment.Job instance at 0x7f77e51584b0>,63,13,[7 5],64,-1,104,-1,91
1,<environment.Job instance at 0x7f77e513d910>,11,13,[12  4],12,-1,32,-1,19
1,<environment.Job instance at 0x7f77e4ee5c80>,14,24,[4 5],15,-1,53,-1,29
1,<environment.Job instance at 0x7f77e56abb40>,49,23,[6 5],50,-1,195,-1,172
1,<environment.Job instance at 0x7f77e541f820>,61,1,[11  4],62,-1,196,-1,195
1,<environment.Job instance at 0x7f77e5c04a00>,60,27,[6 4],61,-1,222,-1,195
1,<environment.Job instance at 0x7f77e5e37c30>,72,24,[1 6],73,-1,249,-1,225
1,<environment.Job instance at 0x7f77e4fb8a00>,84,3,[ 2 12],85,-1,283,-1,280
1,<environment.Job instance at 0x7f77e5abdfa0>,91,2,[ 3 14],92,-1,296,-1,294
1,<environment.Job instance at 0x7f77eebe5960>,96,13,[12  4],97,-1,325,-1,312
1,<environment.Job instance at 0x7f77e58b4820>,97,27,[9 3],98,-1,340,-1,313
1,<environment.Job instance at 0x7f77e5757640>,5,15,[ 1 10],6,-1,21,-1,6
1,<environment.Job instance at 0x7f77eeb09230>,8,24,[4 7],9,-1,33,-1,9
1,<environment.Job instance at 0x7f77eeb09370>,20,20,[4 6],21,-1,41,-1,21
1,<environment.Job instance at 0x7f77eeb09c80>,14,18,[ 4 11],15,-1,41,-1,23
1,<environment.Job instance at 0x7f77e6480d20>,25,16,[ 2 11],26,-1,56,-1,40
1,<environment.Job instance at 0x7f77e6480af0>,30,12,[1 7],31,-1,53,-1,41
1,<environment.Job instance at 0x7f77e6480690>,24,16,[4 5],25,-1,57,-1,41
1,<environment.Job instance at 0x7f77e6480a50>,33,15,[5 5],34,-1,57,-1,42
1,<environment.Job instance at 0x7f77e64809b0>,32,17,[ 2 10],33,-1,60,-1,43
1,<environment.Job instance at 0x7f77e6480780>,23,14,[ 1 11],24,-1,57,-1,43
1,<environment.Job instance at 0x7f77e64802d0>,38,20,[3 8],39,-1,67,-1,47
1,<environment.Job instance at 0x7f77e6480870>,34,12,[9 1],35,-1,59,-1,47
1,<environment.Job instance at 0x7f77e6480730>,39,13,[7 4],40,-1,60,-1,47
1,<environment.Job instance at 0x7f77e64806e0>,36,13,[4 7],37,-1,64,-1,51
1,<environment.Job instance at 0x7f77e61c2550>,42,17,[ 2 11],43,-1,69,-1,52
1,<environment.Job instance at 0x7f77e61c2eb0>,41,21,[4 7],42,-1,76,-1,55
1,<environment.Job instance at 0x7f77e61c24b0>,43,15,[4 9],44,-1,70,-1,55
1,<environment.Job instance at 0x7f77e61c20f0>,45,2,[4 7],46,-1,57,-1,55
1,<environment.Job instance at 0x7f77e61c2d20>,46,18,[6 3],47,-1,73,-1,55
1,<environment.Job instance at 0x7f77e61c20a0>,49,19,[5 5],50,-1,74,-1,55
1,<environment.Job instance at 0x7f77e61c2a50>,50,15,[10  4],51,-1,70,-1,55
1,<environment.Job instance at 0x7f77e61c2730>,51,18,[4 8],52,-1,73,-1,55
1,<environment.Job instance at 0x7f77e61c2e60>,52,15,[4 8],53,-1,70,-1,55
1,<environment.Job instance at 0x7f77e61c2f50>,54,14,[3 8],55,-1,69,-1,55
1,<environment.Job instance at 0x7f77e61c2230>,55,12,[10  1],56,-1,69,-1,57
1,<environment.Job instance at 0x7f77e6480cd0>,31,3,[6 4],32,-1,60,-1,57
1,<environment.Job instance at 0x7f77e57ca410>,56,12,[2 7],57,-1,69,-1,57
1,<environment.Job instance at 0x7f77e57ca140>,57,14,[ 4 10],58,-1,72,-1,58
1,<environment.Job instance at 0x7f77e57cab40>,58,18,[4 6],59,-1,77,-1,59
1,<environment.Job instance at 0x7f77e57ca5a0>,62,16,[3 8],63,-1,79,-1,63
1,<environment.Job instance at 0x7f77e6480fa0>,40,24,[10  4],41,-1,88,-1,64
1,<environment.Job instance at 0x7f77e57cabe0>,66,18,[10  2],67,-1,87,-1,69
1,<environment.Job instance at 0x7f77e57cad20>,68,17,[9 5],69,-1,86,-1,69
1,<environment.Job instance at 0x7f77e57ca230>,69,16,[7 2],70,-1,87,-1,71
1,<environment.Job instance at 0x7f77e60a9a00>,71,16,[5 7],72,-1,88,-1,72
1,<environment.Job instance at 0x7f77e60a95f0>,73,13,[5 5],74,-1,87,-1,74
1,<environment.Job instance at 0x7f77e60a9280>,75,14,[4 6],76,-1,90,-1,76
1,<environment.Job instance at 0x7f77e60a9a50>,76,1,[5 1],77,-1,78,-1,77
1,<environment.Job instance at 0x7f77e57cae10>,70,16,[ 3 10],71,-1,94,-1,78
1,<environment.Job instance at 0x7f77e60a9af0>,85,12,[8 5],86,-1,99,-1,87
1,<environment.Job instance at 0x7f77e60a9640>,86,14,[6 4],87,-1,101,-1,87
1,<environment.Job instance at 0x7f77e5a096e0>,88,17,[3 7],89,-1,108,-1,91
1,<environment.Job instance at 0x7f77e5a091e0>,91,17,[2 7],92,-1,109,-1,92
1,<environment.Job instance at 0x7f77e5a090a0>,90,13,[5 3],91,-1,105,-1,92
1,<environment.Job instance at 0x7f77e5a09eb0>,92,17,[6 4],93,-1,110,-1,93
1,<environment.Job instance at 0x7f77e57ca0a0>,6,12,[ 2 11],7,-1,19,-1,7
1,<environment.Job instance at 0x7f77e57caf00>,8,24,[4 7],9,-1,38,-1,14
1,<environment.Job instance at 0x7f77e5757730>,14,18,[ 4 11],15,-1,38,-1,20
1,<environment.Job instance at 0x7f77e57d4e60>,19,3,[14  1],20,-1,37,-1,34
1,<environment.Job instance at 0x7f77e5008960>,23,14,[ 1 11],24,-1,52,-1,38
1,<environment.Job instance at 0x7f77e55fa910>,25,16,[ 2 11],26,-1,56,-1,40
1,<environment.Job instance at 0x7f77e6480b90>,28,2,[13  3],29,-1,45,-1,43
1,<environment.Job instance at 0x7f77e513d910>,40,24,[10  4],41,-1,116,-1,92
1,<environment.Job instance at 0x7f77e513d3c0>,42,17,[ 2 11],43,-1,109,-1,92
1,<environment.Job instance at 0x7f77e5631960>,44,1,[ 2 11],45,-1,93,-1,92
1,<environment.Job instance at 0x7f77e5343410>,59,1,[ 5 14],60,-1,157,-1,156
1,<environment.Job instance at 0x7f77e581f140>,77,27,[ 2 11],78,-1,267,-1,240
1,<environment.Job instance at 0x7f77e5386370>,79,3,[11  2],80,-1,243,-1,240
1,<environment.Job instance at 0x7f77eeeb27d0>,82,1,[12  5],83,-1,246,-1,245
1,<environment.Job instance at 0x7f77e4dcd6e0>,2,16,[ 3 10],3,-1,19,-1,3
1,<environment.Job instance at 0x7f77e4dcd2d0>,3,18,[5 5],4,-1,22,-1,4
1,<environment.Job instance at 0x7f77e4dcd960>,4,16,[5 5],5,-1,21,-1,5
1,<environment.Job instance at 0x7f77e4dcd0f0>,5,17,[ 3 10],6,-1,23,-1,6
1,<environment.Job instance at 0x7f77e4d5d320>,8,18,[1 5],9,-1,27,-1,9
1,<environment.Job instance at 0x7f77e4d5d640>,9,18,[9 5],10,-1,28,-1,10
1,<environment.Job instance at 0x7f77e4d5d2d0>,10,19,[4 5],11,-1,30,-1,11
1,<environment.Job instance at 0x7f77e4d5d5a0>,12,13,[9 4],13,-1,26,-1,13
1,<environment.Job instance at 0x7f77e4d5df50>,14,16,[2 7],15,-1,31,-1,15
1,<environment.Job instance at 0x7f77e4d5da50>,18,16,[8 3],19,-1,35,-1,19
1,<environment.Job instance at 0x7f77e4d5de10>,20,23,[9 4],21,-1,44,-1,21
1,<environment.Job instance at 0x7f77e4d5d460>,21,21,[8 2],22,-1,43,-1,22
1,<environment.Job instance at 0x7f77e4d5d910>,22,21,[5 7],23,-1,44,-1,23
1,<environment.Job instance at 0x7f77e4d5d3c0>,24,17,[9 2],25,-1,42,-1,25
1,<environment.Job instance at 0x7f77e4dcb910>,25,18,[5 5],26,-1,44,-1,26
1,<environment.Job instance at 0x7f77e4dcb5a0>,28,28,[10  4],29,-1,57,-1,29
1,<environment.Job instance at 0x7f77e4dcb960>,32,18,[4 7],33,-1,51,-1,33
1,<environment.Job instance at 0x7f77e4dcb690>,33,18,[7 1],34,-1,52,-1,34
1,<environment.Job instance at 0x7f77e4dcb5f0>,34,14,[9 1],35,-1,49,-1,35
1,<environment.Job instance at 0x7f77e4dcb230>,36,18,[8 3],37,-1,55,-1,37
1,<environment.Job instance at 0x7f77e4d482d0>,40,26,[4 9],41,-1,67,-1,41
1,<environment.Job instance at 0x7f77e4d48d70>,45,18,[1 8],46,-1,64,-1,46
1,<environment.Job instance at 0x7f77e4d48d20>,46,13,[9 3],47,-1,60,-1,47
1,<environment.Job instance at 0x7f77e4d48cd0>,47,23,[5 3],48,-1,71,-1,48
1,<environment.Job instance at 0x7f77e4d48370>,48,16,[9 4],49,-1,65,-1,49
1,<environment.Job instance at 0x7f77e4d48eb0>,49,15,[5 7],50,-1,65,-1,50
1,<environment.Job instance at 0x7f77e4d48690>,50,14,[1 5],51,-1,65,-1,51
1,<environment.Job instance at 0x7f77e5111190>,67,16,[ 3 12],68,-1,95,-1,79
1,<environment.Job instance at 0x7f77e4dfd1e0>,62,14,[3 9],63,-1,93,-1,79
1,<environment.Job instance at 0x7f77e5b5a7d0>,69,17,[9 2],70,-1,98,-1,81
1,<environment.Job instance at 0x7f77e5b5a0f0>,68,15,[7 3],69,-1,96,-1,81
1,<environment.Job instance at 0x7f77e5b5a460>,70,14,[10  1],71,-1,95,-1,81
1,<environment.Job instance at 0x7f77e5b5a730>,73,22,[5 2],74,-1,105,-1,83
1,<environment.Job instance at 0x7f77e5b5afa0>,75,17,[3 6],76,-1,104,-1,87
1,<environment.Job instance at 0x7f77e5b5a4b0>,74,18,[5 6],75,-1,105,-1,87
1,<environment.Job instance at 0x7f77e5b5a500>,78,12,[ 4 10],79,-1,102,-1,90
1,<environment.Job instance at 0x7f77e4d485a0>,53,24,[ 5 11],54,-1,114,-1,90
1,<environment.Job instance at 0x7f77e4d48280>,59,18,[6 4],60,-1,114,-1,96
1,<environment.Job instance at 0x7f77e4d487d0>,51,18,[11  2],52,-1,114,-1,96
1,<environment.Job instance at 0x7f77e4d821e0>,80,16,[ 2 10],81,-1,112,-1,96
1,<environment.Job instance at 0x7f77e5fb8d20>,82,15,[5 9],83,-1,125,-1,110
1,<environment.Job instance at 0x7f77ef139d70>,85,18,[ 5 10],86,-1,128,-1,110
1,<environment.Job instance at 0x7f77e4f66870>,97,18,[3 8],98,-1,131,-1,113
1,<environment.Job instance at 0x7f77e4ffb910>,20,23,[9 4],21,-1,92,-1,69
1,<environment.Job instance at 0x7f77e536df50>,28,28,[10  4],29,-1,115,-1,87
1,<environment.Job instance at 0x7f77e63e8870>,38,17,[12  1],39,-1,137,-1,120
1,<environment.Job instance at 0x7f77e63e8460>,40,26,[4 9],41,-1,152,-1,126
1,<environment.Job instance at 0x7f77e63e8a00>,42,16,[13  1],43,-1,142,-1,126
1,<environment.Job instance at 0x7f77e53796e0>,47,23,[5 3],48,-1,164,-1,141
1,<environment.Job instance at 0x7f77e537c1e0>,51,18,[11  2],52,-1,174,-1,156
1,<environment.Job instance at 0x7f77e537cd70>,52,12,[ 5 13],53,-1,168,-1,156
1,<environment.Job instance at 0x7f77e4f7c870>,53,24,[ 5 11],54,-1,180,-1,156
1,<environment.Job instance at 0x7f77e5394c30>,60,13,[11  2],61,-1,197,-1,184
1,<environment.Job instance at 0x7f77e536a640>,67,16,[ 3 12],68,-1,232,-1,216
1,<environment.Job instance at 0x7f77e5393910>,86,25,[6 3],87,-1,327,-1,302
1,<environment.Job instance at 0x7f77e56c0820>,93,2,[14  3],94,-1,318,-1,316
1,<environment.Job instance at 0x7f77e63d56e0>,94,1,[14  5],95,-1,317,-1,316
1,<environment.Job instance at 0x7f77e55f96e0>,1,18,[10  5],2,-1,20,-1,2
1,<environment.Job instance at 0x7f77e55f9cd0>,5,18,[9 2],6,-1,26,-1,8
1,<environment.Job instance at 0x7f77e55f92d0>,7,20,[1 8],8,-1,28,-1,8
1,<environment.Job instance at 0x7f77e55f9e60>,11,21,[4 9],12,-1,33,-1,12
1,<environment.Job instance at 0x7f77e55f9a00>,13,16,[8 1],14,-1,32,-1,16
1,<environment.Job instance at 0x7f77e55f9f50>,15,23,[8 4],16,-1,39,-1,16
1,<environment.Job instance at 0x7f77e5e18b90>,17,20,[5 7],18,-1,38,-1,18
1,<environment.Job instance at 0x7f77e5e18690>,18,16,[4 8],19,-1,35,-1,19
1,<environment.Job instance at 0x7f77e5e185a0>,22,12,[6 1],23,-1,35,-1,23
1,<environment.Job instance at 0x7f77e5e187d0>,24,15,[11  1],25,-1,40,-1,25
1,<environment.Job instance at 0x7f77e5e18280>,25,16,[10  5],26,-1,42,-1,26
1,<environment.Job instance at 0x7f77e5e184b0>,27,16,[1 7],28,-1,44,-1,28
1,<environment.Job instance at 0x7f77e5e18910>,29,18,[2 7],30,-1,48,-1,30
1,<environment.Job instance at 0x7f77e5e18e60>,30,15,[4 7],31,-1,46,-1,31
1,<environment.Job instance at 0x7f77e5e18eb0>,33,16,[9 4],34,-1,51,-1,35
1,<environment.Job instance at 0x7f77e58220f0>,34,13,[8 2],35,-1,51,-1,38
1,<environment.Job instance at 0x7f77e5822e60>,40,24,[7 2],41,-1,65,-1,41
1,<environment.Job instance at 0x7f77e5822e10>,39,1,[8 1],40,-1,42,-1,41
1,<environment.Job instance at 0x7f77e5822cd0>,42,15,[ 2 10],43,-1,59,-1,44
1,<environment.Job instance at 0x7f77e58225f0>,45,15,[ 1 12],46,-1,68,-1,53
1,<environment.Job instance at 0x7f77e5e34f00>,53,14,[ 4 10],54,-1,68,-1,54
1,<environment.Job instance at 0x7f77e5e34320>,51,18,[3 8],52,-1,73,-1,55
1,<environment.Job instance at 0x7f77e5e34280>,54,15,[4 8],55,-1,70,-1,55
1,<environment.Job instance at 0x7f77e5e340a0>,56,16,[1 6],57,-1,73,-1,57
1,<environment.Job instance at 0x7f77eeeae910>,61,28,[5 1],62,-1,90,-1,62
1,<environment.Job instance at 0x7f77eeeae0a0>,59,17,[ 1 10],60,-1,80,-1,63
1,<environment.Job instance at 0x7f77e5c61e10>,73,23,[7 4],74,-1,101,-1,78
1,<environment.Job instance at 0x7f77e5c61050>,72,13,[9 1],73,-1,91,-1,78
1,<environment.Job instance at 0x7f77e5c61aa0>,75,12,[2 8],76,-1,90,-1,78
1,<environment.Job instance at 0x7f77e5c61640>,76,12,[9 5],77,-1,90,-1,78
1,<environment.Job instance at 0x7f77e5c616e0>,77,17,[10  4],78,-1,95,-1,78
1,<environment.Job instance at 0x7f77e5c61410>,74,13,[4 8],75,-1,92,-1,79
1,<environment.Job instance at 0x7f77e5c61af0>,78,18,[13  5],79,-1,98,-1,80
1,<environment.Job instance at 0x7f77e5822aa0>,48,20,[ 1 10],49,-1,100,-1,80
1,<environment.Job instance at 0x7f77eeeae410>,65,15,[3 5],66,-1,96,-1,81
1,<environment.Job instance at 0x7f77e5c61500>,81,14,[9 4],82,-1,99,-1,85
1,<environment.Job instance at 0x7f77e5c61dc0>,83,3,[13  5],84,-1,89,-1,86
1,<environment.Job instance at 0x7f77e50bf690>,86,27,[5 2],87,-1,115,-1,88
1,<environment.Job instance at 0x7f77e50bfd20>,87,14,[ 3 14],88,-1,102,-1,88
1,<environment.Job instance at 0x7f77e50bf730>,85,18,[7 5],86,-1,106,-1,88
1,<environment.Job instance at 0x7f77e50bf050>,89,18,[ 2 10],90,-1,108,-1,90
1,<environment.Job instance at 0x7f77e50bf910>,97,15,[5 8],98,-1,113,-1,98
1,<environment.Job instance at 0x7f77e50bfd70>,90,22,[2 5],91,-1,121,-1,99
1,<environment.Job instance at 0x7f77e50bfb40>,94,18,[10  2],95,-1,117,-1,99
1,<environment.Job instance at 0x7f77e5822690>,3,1,[12  4],4,-1,5,-1,4
1,<environment.Job instance at 0x7f77e5c61e60>,10,2,[ 2 12],11,-1,13,-1,11
1,<environment.Job instance at 0x7f77e55f9eb0>,15,23,[8 4],16,-1,49,-1,26
1,<environment.Job instance at 0x7f77e63d59b0>,24,15,[11  1],25,-1,60,-1,45
1,<environment.Job instance at 0x7f77e4ffdf50>,31,20,[ 5 13],32,-1,87,-1,67
1,<environment.Job instance at 0x7f77eeeb8c80>,40,24,[7 2],41,-1,121,-1,97
1,<environment.Job instance at 0x7f77e536a280>,45,15,[ 1 12],46,-1,131,-1,116
1,<environment.Job instance at 0x7f77e537cc80>,58,2,[ 1 13],59,-1,170,-1,168
1,<environment.Job instance at 0x7f77e5379910>,60,28,[ 2 14],61,-1,202,-1,174
1,<environment.Job instance at 0x7f77e53798c0>,61,28,[5 1],62,-1,202,-1,174
1,<environment.Job instance at 0x7f77e4ff1410>,73,23,[7 4],74,-1,236,-1,213
1,<environment.Job instance at 0x7f77e536d640>,78,18,[13  5],79,-1,244,-1,226
1,<environment.Job instance at 0x7f77e4ffb6e0>,83,3,[13  5],84,-1,253,-1,250
1,<environment.Job instance at 0x7f77e4ffb050>,86,27,[5 2],87,-1,290,-1,263
1,<environment.Job instance at 0x7f77e50bfc80>,87,14,[ 3 14],88,-1,277,-1,263
1,<environment.Job instance at 0x7f77e579b190>,4,28,[4 5],5,-1,33,-1,5
1,<environment.Job instance at 0x7f77e579b5f0>,6,17,[3 5],7,-1,24,-1,7
1,<environment.Job instance at 0x7f77e579bb90>,8,15,[5 8],9,-1,24,-1,9
1,<environment.Job instance at 0x7f77e4c9f050>,15,15,[8 1],16,-1,32,-1,17
1,<environment.Job instance at 0x7f77e4c9fc30>,18,18,[5 5],19,-1,37,-1,19
1,<environment.Job instance at 0x7f77e4c9fd70>,20,16,[7 5],21,-1,38,-1,22
1,<environment.Job instance at 0x7f77e4c9f320>,23,17,[5 9],24,-1,41,-1,24
1,<environment.Job instance at 0x7f77e5b055a0>,24,17,[2 5],25,-1,42,-1,25
1,<environment.Job instance at 0x7f77e5b05be0>,25,21,[9 3],26,-1,47,-1,26
1,<environment.Job instance at 0x7f77e5b05dc0>,30,12,[10  1],31,-1,44,-1,32
1,<environment.Job instance at 0x7f77e5b05410>,32,16,[9 4],33,-1,49,-1,33
1,<environment.Job instance at 0x7f77e5b05140>,34,17,[1 9],35,-1,52,-1,35
1,<environment.Job instance at 0x7f77e5b05320>,36,18,[8 1],37,-1,55,-1,37
1,<environment.Job instance at 0x7f77e5b05c80>,39,28,[6 1],40,-1,68,-1,40
1,<environment.Job instance at 0x7f77e515b730>,44,18,[5 5],45,-1,63,-1,45
1,<environment.Job instance at 0x7f77e4c9f1e0>,21,15,[5 4],22,-1,66,-1,51
1,<environment.Job instance at 0x7f77e515bf50>,53,24,[5 3],54,-1,89,-1,65
1,<environment.Job instance at 0x7f77e515bd20>,4,28,[4 5],5,-1,33,-1,5
1,<environment.Job instance at 0x7f77e5be84b0>,7,2,[ 5 13],8,-1,10,-1,8
1,<environment.Job instance at 0x7f77e656f140>,11,25,[10  1],12,-1,43,-1,18
1,<environment.Job instance at 0x7f77e579b460>,27,25,[9 4],28,-1,113,-1,88
1,<environment.Job instance at 0x7f77e63fd230>,39,28,[6 1],40,-1,149,-1,121
1,<environment.Job instance at 0x7f77e63fd410>,42,18,[ 2 12],43,-1,139,-1,121
1,<environment.Job instance at 0x7f77e63e8870>,53,24,[5 3],54,-1,192,-1,168
1,<environment.Job instance at 0x7f77e53798c0>,57,2,[11  4],58,-1,181,-1,179
1,<environment.Job instance at 0x7f77e537cd20>,61,28,[9 4],62,-1,229,-1,201
1,<environment.Job instance at 0x7f77e5396af0>,63,16,[ 1 12],64,-1,217,-1,201
1,<environment.Job instance at 0x7f77e5394d70>,68,19,[ 3 11],69,-1,224,-1,205
1,<environment.Job instance at 0x7f77e56d9550>,87,13,[14  4],88,-1,304,-1,291
1,<environment.Job instance at 0x7f77eeb7daf0>,4,15,[10  2],5,-1,21,-1,6
1,<environment.Job instance at 0x7f77eeb7d050>,7,15,[6 2],8,-1,23,-1,8
1,<environment.Job instance at 0x7f77e5bddb40>,8,3,[ 1 10],9,-1,12,-1,9
1,<environment.Job instance at 0x7f77eeb7d2d0>,5,25,[1 6],6,-1,34,-1,9
1,<environment.Job instance at 0x7f77e5bdd5f0>,11,3,[1 8],12,-1,16,-1,13
1,<environment.Job instance at 0x7f77e5bdd870>,13,3,[3 8],14,-1,17,-1,14
1,<environment.Job instance at 0x7f77e5bdd960>,12,20,[ 5 10],13,-1,34,-1,14
1,<environment.Job instance at 0x7f77e5bddcd0>,14,12,[9 1],15,-1,27,-1,15
1,<environment.Job instance at 0x7f77e5bdd730>,15,24,[8 3],16,-1,40,-1,16
1,<environment.Job instance at 0x7f77e5e64af0>,21,16,[3 9],22,-1,38,-1,22
1,<environment.Job instance at 0x7f77e5e64320>,24,13,[2 7],25,-1,38,-1,25
1,<environment.Job instance at 0x7f77e5e64550>,25,17,[10  3],26,-1,43,-1,26
1,<environment.Job instance at 0x7f77e5e64870>,26,18,[6 4],27,-1,45,-1,27
1,<environment.Job instance at 0x7f77e5e64fa0>,27,24,[5 9],28,-1,52,-1,28
1,<environment.Job instance at 0x7f77e6226820>,31,28,[3 6],32,-1,60,-1,32
1,<environment.Job instance at 0x7f77e6226320>,32,14,[ 4 10],33,-1,47,-1,33
1,<environment.Job instance at 0x7f77e62267d0>,35,16,[7 3],36,-1,52,-1,36
1,<environment.Job instance at 0x7f77e65a8280>,39,26,[2 6],40,-1,68,-1,42
1,<environment.Job instance at 0x7f77e65a8690>,41,15,[8 4],42,-1,58,-1,43
1,<environment.Job instance at 0x7f77e65a85f0>,42,14,[9 2],43,-1,58,-1,44
1,<environment.Job instance at 0x7f77e65a8780>,43,16,[2 6],44,-1,60,-1,44
1,<environment.Job instance at 0x7f77e65a84b0>,45,17,[5 3],46,-1,63,-1,46
1,<environment.Job instance at 0x7f77e65a87d0>,40,20,[9 3],41,-1,71,-1,51
1,<environment.Job instance at 0x7f77e4ceca00>,50,13,[4 6],51,-1,66,-1,53
1,<environment.Job instance at 0x7f77e4cec6e0>,53,18,[4 6],54,-1,83,-1,65
1,<environment.Job instance at 0x7f77e4cec2d0>,52,16,[9 2],53,-1,81,-1,65
1,<environment.Job instance at 0x7f77e4cec0a0>,56,17,[3 7],57,-1,83,-1,66
1,<environment.Job instance at 0x7f77e65a8fa0>,49,2,[9 3],50,-1,69,-1,67
1,<environment.Job instance at 0x7f77e4cec9b0>,63,14,[ 2 10],64,-1,81,-1,67
1,<environment.Job instance at 0x7f77e4cec230>,64,27,[13  3],65,-1,95,-1,68
1,<environment.Job instance at 0x7f77e4cecaf0>,62,18,[7 4],63,-1,86,-1,68
1,<environment.Job instance at 0x7f77e517c230>,69,15,[3 9],70,-1,85,-1,70
1,<environment.Job instance at 0x7f77e4cec730>,59,17,[5 7],60,-1,89,-1,72
1,<environment.Job instance at 0x7f77e5aa4e10>,73,16,[3 8],74,-1,90,-1,74
1,<environment.Job instance at 0x7f77e5821d70>,72,14,[ 2 10],73,-1,89,-1,75
1,<environment.Job instance at 0x7f77e571ef00>,75,19,[1 5],76,-1,95,-1,76
1,<environment.Job instance at 0x7f77e4cd2fa0>,76,13,[5 7],77,-1,90,-1,77
1,<environment.Job instance at 0x7f77e554b4b0>,78,16,[3 8],79,-1,95,-1,79
1,<environment.Job instance at 0x7f77e5b14780>,80,18,[9 2],81,-1,99,-1,81
1,<environment.Job instance at 0x7f77e555cdc0>,74,13,[10  5],75,-1,95,-1,82
1,<environment.Job instance at 0x7f77e4d48b40>,82,17,[9 4],83,-1,101,-1,84
1,<environment.Job instance at 0x7f77e514d780>,84,27,[6 1],85,-1,113,-1,86
1,<environment.Job instance at 0x7f77e5a82d20>,86,17,[ 5 11],87,-1,104,-1,87
1,<environment.Job instance at 0x7f77e5e072d0>,85,14,[4 8],86,-1,102,-1,88
1,<environment.Job instance at 0x7f77e65a8550>,48,26,[8 2],49,-1,124,-1,98
1,<environment.Job instance at 0x7f77e5e17a50>,93,24,[10  2],94,-1,123,-1,99
1,<environment.Job instance at 0x7f77e5e17d20>,91,24,[14  3],92,-1,123,-1,99
1,<environment.Job instance at 0x7f77e51020f0>,98,18,[5 9],99,-1,120,-1,102
1,<environment.Job instance at 0x7f77e517cb40>,3,2,[13  2],4,-1,6,-1,4
1,<environment.Job instance at 0x7f77e65a8820>,5,25,[1 6],6,-1,42,-1,17
1,<environment.Job instance at 0x7f77eeb7d1e0>,10,27,[11  2],11,-1,44,-1,17
1,<environment.Job instance at 0x7f77eeb7d7d0>,15,24,[8 3],16,-1,44,-1,20
1,<environment.Job instance at 0x7f77e4fd93c0>,27,24,[5 9],28,-1,97,-1,73
1,<environment.Job instance at 0x7f77e4fd9f50>,31,28,[3 6],32,-1,101,-1,73
1,<environment.Job instance at 0x7f77e5678be0>,39,26,[2 6],40,-1,120,-1,94
1,<environment.Job instance at 0x7f77e569d8c0>,47,1,[ 1 13],48,-1,127,-1,126
1,<environment.Job instance at 0x7f77e5673140>,48,26,[8 2],49,-1,152,-1,126
1,<environment.Job instance at 0x7f77e5681230>,55,25,[ 3 14],56,-1,171,-1,146
1,<environment.Job instance at 0x7f77e5668c30>,61,3,[ 4 13],62,-1,170,-1,167
1,<environment.Job instance at 0x7f77e5670d20>,64,27,[13  3],65,-1,210,-1,183
1,<environment.Job instance at 0x7f77e4fce5f0>,84,27,[6 1],85,-1,295,-1,268
1,<environment.Job instance at 0x7f77e4ec4e60>,86,17,[ 5 11],87,-1,285,-1,268
1,<environment.Job instance at 0x7f77e52fcf00>,91,24,[14  3],92,-1,307,-1,283
1,<environment.Job instance at 0x7f77e5689230>,93,24,[10  2],94,-1,323,-1,299
1,<environment.Job instance at 0x7f77e4c4f5f0>,0,18,[6 4],1,-1,19,-1,1
1,<environment.Job instance at 0x7f77e4c4fe60>,5,16,[7 3],6,-1,22,-1,6
1,<environment.Job instance at 0x7f77e4c4f690>,7,13,[10  4],8,-1,22,-1,9
1,<environment.Job instance at 0x7f77e58310f0>,9,13,[8 2],10,-1,23,-1,10
1,<environment.Job instance at 0x7f77e58315f0>,10,13,[12  1],11,-1,24,-1,11
1,<environment.Job instance at 0x7f77e5831190>,11,16,[ 5 11],12,-1,28,-1,12
1,<environment.Job instance at 0x7f77e5831d70>,12,16,[5 4],13,-1,29,-1,13
1,<environment.Job instance at 0x7f77e58316e0>,13,3,[ 4 10],14,-1,17,-1,14
1,<environment.Job instance at 0x7f77e5831730>,14,3,[10  2],15,-1,18,-1,15
1,<environment.Job instance at 0x7f77e58319b0>,15,27,[4 5],16,-1,43,-1,16
1,<environment.Job instance at 0x7f77e5831eb0>,16,1,[12  2],17,-1,18,-1,17
1,<environment.Job instance at 0x7f77e5831af0>,17,18,[1 6],18,-1,36,-1,18
1,<environment.Job instance at 0x7f77e4c4faa0>,8,13,[8 5],9,-1,31,-1,18
1,<environment.Job instance at 0x7f77e5831410>,20,17,[9 2],21,-1,40,-1,23
1,<environment.Job instance at 0x7f77e58318c0>,22,14,[7 3],23,-1,40,-1,26
1,<environment.Job instance at 0x7f77e584be60>,30,26,[6 4],31,-1,57,-1,31
1,<environment.Job instance at 0x7f77e584bf50>,32,13,[ 3 10],33,-1,46,-1,33
1,<environment.Job instance at 0x7f77e584bb40>,33,14,[ 4 10],34,-1,48,-1,34
1,<environment.Job instance at 0x7f77e584b9b0>,36,16,[9 2],37,-1,53,-1,37
1,<environment.Job instance at 0x7f77e584b4b0>,37,21,[9 4],38,-1,59,-1,38
1,<environment.Job instance at 0x7f77e584b0f0>,38,21,[5 1],39,-1,60,-1,39
1,<environment.Job instance at 0x7f77e584ab90>,45,16,[4 9],46,-1,62,-1,46
1,<environment.Job instance at 0x7f77e584a0f0>,46,18,[5 5],47,-1,65,-1,47
1,<environment.Job instance at 0x7f77e584a140>,49,20,[5 9],50,-1,70,-1,50
1,<environment.Job instance at 0x7f77e584a050>,50,17,[ 5 10],51,-1,68,-1,51
1,<environment.Job instance at 0x7f77e584a690>,51,14,[10  1],52,-1,66,-1,52
1,<environment.Job instance at 0x7f77e584a550>,52,18,[3 8],53,-1,72,-1,54
1,<environment.Job instance at 0x7f77e636a3c0>,62,18,[3 7],63,-1,81,-1,63
1,<environment.Job instance at 0x7f77e636abe0>,65,13,[9 1],66,-1,79,-1,66
1,<environment.Job instance at 0x7f77e636a780>,68,14,[ 1 10],69,-1,83,-1,69
1,<environment.Job instance at 0x7f77e582cd70>,70,25,[5 3],71,-1,96,-1,71
1,<environment.Job instance at 0x7f77e582cc30>,74,13,[3 6],75,-1,88,-1,75
1,<environment.Job instance at 0x7f77e582caf0>,76,13,[8 1],77,-1,90,-1,77
1,<environment.Job instance at 0x7f77e582caa0>,78,16,[10  3],79,-1,95,-1,79
1,<environment.Job instance at 0x7f77e582c9b0>,79,28,[3 9],80,-1,108,-1,80
1,<environment.Job instance at 0x7f77e582c8c0>,82,23,[3 7],83,-1,106,-1,83
1,<environment.Job instance at 0x7f77e5e08370>,84,17,[2 7],85,-1,102,-1,85
1,<environment.Job instance at 0x7f77e5e08be0>,85,14,[7 2],86,-1,100,-1,86
1,<environment.Job instance at 0x7f77e5e080f0>,87,16,[5 4],88,-1,104,-1,88
1,<environment.Job instance at 0x7f77e5e08230>,88,17,[6 5],89,-1,106,-1,89
1,<environment.Job instance at 0x7f77e5e08b40>,89,18,[5 1],90,-1,108,-1,90
1,<environment.Job instance at 0x7f77e5e08910>,90,16,[1 7],91,-1,107,-1,91
1,<environment.Job instance at 0x7f77e5e08550>,92,17,[6 4],93,-1,110,-1,93
1,<environment.Job instance at 0x7f77e5e081e0>,96,15,[5 6],97,-1,112,-1,97
1,<environment.Job instance at 0x7f77e636aeb0>,10,13,[12  1],11,-1,34,-1,21
1,<environment.Job instance at 0x7f77e636a5a0>,11,16,[ 5 11],12,-1,37,-1,21
1,<environment.Job instance at 0x7f77e582cf00>,15,27,[4 5],16,-1,57,-1,30
1,<environment.Job instance at 0x7f77e4c4f4b0>,16,1,[12  2],17,-1,31,-1,30
1,<environment.Job instance at 0x7f77e5102870>,26,25,[7 3],27,-1,82,-1,57
1,<environment.Job instance at 0x7f77e5e08fa0>,30,26,[6 4],31,-1,102,-1,76
1,<environment.Job instance at 0x7f77e585c6e0>,64,1,[13  5],65,-1,175,-1,174
1,<environment.Job instance at 0x7f77e585c960>,70,25,[5 3],71,-1,219,-1,194
1,<environment.Job instance at 0x7f77e585cb90>,71,16,[11  2],72,-1,210,-1,194
1,<environment.Job instance at 0x7f77e5e398c0>,79,28,[3 9],80,-1,258,-1,230
1,<environment.Job instance at 0x7f77e5e39aa0>,82,23,[3 7],83,-1,254,-1,231
1,<environment.Job instance at 0x7f77e5e39910>,86,3,[ 5 14],87,-1,239,-1,236
1,<environment.Job instance at 0x7f77e5e13410>,97,16,[11  1],98,-1,295,-1,279
1,<environment.Job instance at 0x7f77e4eea140>,1,16,[5 5],2,-1,18,-1,2
1,<environment.Job instance at 0x7f77e4eea8c0>,4,14,[ 3 10],5,-1,22,-1,8
1,<environment.Job instance at 0x7f77ef20c6e0>,9,2,[13  4],10,-1,12,-1,10
1,<environment.Job instance at 0x7f77ef20c780>,10,2,[5 2],11,-1,13,-1,11
1,<environment.Job instance at 0x7f77ef20c050>,11,15,[5 2],12,-1,27,-1,12
1,<environment.Job instance at 0x7f77e5489460>,12,1,[2 9],13,-1,14,-1,13
1,<environment.Job instance at 0x7f77e54890f0>,13,20,[ 5 12],14,-1,34,-1,14
1,<environment.Job instance at 0x7f77e54895f0>,14,2,[ 5 11],15,-1,17,-1,15
1,<environment.Job instance at 0x7f77e4eea5f0>,7,16,[ 5 13],8,-1,31,-1,15
1,<environment.Job instance at 0x7f77e4eeae10>,15,16,[10  3],16,-1,36,-1,20
1,<environment.Job instance at 0x7f77e5489730>,19,17,[9 4],20,-1,37,-1,20
1,<environment.Job instance at 0x7f77e52d34b0>,26,16,[5 6],27,-1,43,-1,27
1,<environment.Job instance at 0x7f77e52d39b0>,31,16,[4 6],32,-1,48,-1,32
1,<environment.Job instance at 0x7f77e4f82aa0>,37,15,[10  4],38,-1,53,-1,38
1,<environment.Job instance at 0x7f77e4f82eb0>,38,16,[ 5 10],39,-1,55,-1,39
1,<environment.Job instance at 0x7f77e4f82fa0>,45,13,[5 4],46,-1,60,-1,47
1,<environment.Job instance at 0x7f77e57d6b40>,47,15,[2 6],48,-1,63,-1,48
1,<environment.Job instance at 0x7f77e57d6410>,46,27,[2 9],47,-1,75,-1,48
1,<environment.Job instance at 0x7f77e57d6370>,48,18,[ 5 10],49,-1,67,-1,49
1,<environment.Job instance at 0x7f77e57d69b0>,49,18,[10  2],50,-1,69,-1,51
1,<environment.Job instance at 0x7f77e57d6280>,52,22,[8 1],53,-1,75,-1,53
1,<environment.Job instance at 0x7f77e57d6c80>,61,27,[8 5],62,-1,97,-1,70
1,<environment.Job instance at 0x7f77e4f82b40>,7,16,[ 5 13],8,-1,24,-1,8
1,<environment.Job instance at 0x7f77e4f82280>,9,2,[13  4],10,-1,18,-1,16
1,<environment.Job instance at 0x7f77e54c4c80>,13,20,[ 5 12],14,-1,38,-1,18
1,<environment.Job instance at 0x7f77e52e6410>,14,2,[ 5 11],15,-1,20,-1,18
1,<environment.Job instance at 0x7f77e5e39910>,21,2,[ 5 11],22,-1,26,-1,24
1,<environment.Job instance at 0x7f77e5e398c0>,29,13,[ 4 14],30,-1,65,-1,52
1,<environment.Job instance at 0x7f77e585caf0>,36,16,[13  1],37,-1,87,-1,71
1,<environment.Job instance at 0x7f77e585cd70>,46,27,[2 9],47,-1,135,-1,108
1,<environment.Job instance at 0x7f77e585cb90>,53,14,[14  4],54,-1,151,-1,137
1,<environment.Job instance at 0x7f77e55316e0>,55,3,[ 1 13],56,-1,140,-1,137
1,<environment.Job instance at 0x7f77e55313c0>,56,2,[14  2],57,-1,139,-1,137
1,<environment.Job instance at 0x7f77e5531af0>,57,15,[ 5 12],58,-1,152,-1,137
1,<environment.Job instance at 0x7f77e5531a50>,60,2,[14  4],61,-1,155,-1,153
1,<environment.Job instance at 0x7f77e5531370>,61,27,[8 5],62,-1,182,-1,155
1,<environment.Job instance at 0x7f77e5531500>,64,16,[11  4],65,-1,173,-1,157
1,<environment.Job instance at 0x7f77e5531190>,68,16,[13  2],69,-1,181,-1,165
1,<environment.Job instance at 0x7f77e5531d20>,71,14,[ 2 12],72,-1,195,-1,181
1,<environment.Job instance at 0x7f77e5e083c0>,73,26,[7 1],74,-1,225,-1,199
1,<environment.Job instance at 0x7f77e4d86c30>,4,17,[8 5],5,-1,23,-1,6
1,<environment.Job instance at 0x7f77e4d86be0>,9,19,[2 5],10,-1,29,-1,10
1,<environment.Job instance at 0x7f77e5334cd0>,14,18,[ 4 10],15,-1,33,-1,15
1,<environment.Job instance at 0x7f77e5334870>,23,18,[9 2],24,-1,49,-1,31
1,<environment.Job instance at 0x7f77e53515f0>,26,16,[5 9],27,-1,47,-1,31
1,<environment.Job instance at 0x7f77e5351eb0>,28,24,[5 6],29,-1,55,-1,31
1,<environment.Job instance at 0x7f77eeb55730>,31,17,[5 8],32,-1,53,-1,36
1,<environment.Job instance at 0x7f77e62c0aa0>,33,14,[3 6],34,-1,50,-1,36
1,<environment.Job instance at 0x7f77e59e2dc0>,34,16,[8 2],35,-1,52,-1,36
1,<environment.Job instance at 0x7f77e64d5230>,36,14,[4 7],37,-1,51,-1,37
1,<environment.Job instance at 0x7f77e5332af0>,5,17,[1 7],6,-1,56,-1,39
1,<environment.Job instance at 0x7f77e4f4f190>,40,20,[ 4 10],41,-1,68,-1,48
1,<environment.Job instance at 0x7f77e5334e10>,19,12,[7 5],20,-1,79,-1,67
1,<environment.Job instance at 0x7f77e65a3e10>,46,24,[4 5],47,-1,91,-1,67
1,<environment.Job instance at 0x7f77e65a3f50>,56,16,[4 9],57,-1,88,-1,72
1,<environment.Job instance at 0x7f77eeeb8be0>,39,13,[10  4],40,-1,87,-1,74
1,<environment.Job instance at 0x7f77e65a3460>,58,14,[5 4],59,-1,88,-1,74
1,<environment.Job instance at 0x7f77e65a3b40>,59,15,[6 4],60,-1,89,-1,74
1,<environment.Job instance at 0x7f77e65a3fa0>,62,23,[6 2],63,-1,97,-1,74
1,<environment.Job instance at 0x7f77e65cd5a0>,43,14,[ 4 10],44,-1,88,-1,74
1,<environment.Job instance at 0x7f77e65a3550>,47,24,[4 8],48,-1,98,-1,74
1,<environment.Job instance at 0x7f77e4d96cd0>,65,14,[12  1],66,-1,88,-1,74
1,<environment.Job instance at 0x7f77e535b3c0>,66,17,[1 6],67,-1,91,-1,74
1,<environment.Job instance at 0x7f77e5351e10>,1,16,[ 5 12],2,-1,18,-1,2
1,<environment.Job instance at 0x7f77e5334370>,3,17,[13  5],4,-1,21,-1,4
1,<environment.Job instance at 0x7f77e50aec30>,15,2,[ 3 11],16,-1,23,-1,21
1,<environment.Job instance at 0x7f77e59543c0>,22,3,[ 4 11],23,-1,43,-1,40
1,<environment.Job instance at 0x7f77e579b0f0>,28,24,[5 6],29,-1,94,-1,70
1,<environment.Job instance at 0x7f77e5ff4f00>,30,3,[ 3 12],31,-1,73,-1,70
1,<environment.Job instance at 0x7f77e64182d0>,32,14,[14  5],33,-1,86,-1,72
1,<environment.Job instance at 0x7f77e593ac30>,47,24,[4 8],48,-1,170,-1,146
1,<environment.Job instance at 0x7f77e593aa00>,46,24,[4 5],47,-1,170,-1,146
1,<environment.Job instance at 0x7f77e60636e0>,64,3,[ 1 12],65,-1,179,-1,176
1,<environment.Job instance at 0x7f77e5fd96e0>,65,14,[12  1],66,-1,190,-1,176
1,<environment.Job instance at 0x7f77e5fd9050>,62,23,[6 2],63,-1,215,-1,192
1,<environment.Job instance at 0x7f77e5fe5d20>,73,1,[11  3],74,-1,207,-1,206
1,<environment.Job instance at 0x7f77e5fe5190>,75,28,[ 4 12],76,-1,234,-1,206
1,<environment.Job instance at 0x7f77e5408870>,79,1,[ 4 13],80,-1,227,-1,226
1,<environment.Job instance at 0x7f77e5fdb460>,83,14,[ 2 11],84,-1,254,-1,240
1,<environment.Job instance at 0x7f77e53f0780>,95,24,[5 2],96,-1,327,-1,303
1,<environment.Job instance at 0x7f77e63dd1e0>,0,25,[6 2],1,-1,26,-1,1
1,<environment.Job instance at 0x7f77e63ddaf0>,1,17,[9 4],2,-1,19,-1,2
1,<environment.Job instance at 0x7f77e5affe10>,8,18,[10  4],9,-1,27,-1,9
1,<environment.Job instance at 0x7f77e5affa50>,10,25,[5 5],11,-1,36,-1,11
1,<environment.Job instance at 0x7f77e5aff550>,11,13,[9 3],12,-1,29,-1,16
1,<environment.Job instance at 0x7f77e5affaf0>,15,19,[2 8],16,-1,35,-1,16
1,<environment.Job instance at 0x7f77e57d3050>,19,15,[ 5 10],20,-1,37,-1,22
1,<environment.Job instance at 0x7f77e57d3be0>,22,16,[2 8],23,-1,39,-1,23
1,<environment.Job instance at 0x7f77e57d35f0>,25,18,[4 6],26,-1,44,-1,26
1,<environment.Job instance at 0x7f77e57d3e60>,26,15,[5 9],27,-1,42,-1,27
1,<environment.Job instance at 0x7f77e57d3460>,29,17,[ 1 10],30,-1,47,-1,30
1,<environment.Job instance at 0x7f77e57d3320>,30,15,[8 4],31,-1,46,-1,31
1,<environment.Job instance at 0x7f77e57d3b40>,31,12,[8 1],32,-1,44,-1,32
1,<environment.Job instance at 0x7f77e6483690>,32,13,[5 3],33,-1,46,-1,33
1,<environment.Job instance at 0x7f77e64835f0>,34,19,[ 5 10],35,-1,54,-1,35
1,<environment.Job instance at 0x7f77e6483c30>,36,15,[3 9],37,-1,52,-1,37
1,<environment.Job instance at 0x7f77e6483230>,37,27,[8 5],38,-1,65,-1,38
1,<environment.Job instance at 0x7f77e6483640>,40,13,[8 3],41,-1,54,-1,41
1,<environment.Job instance at 0x7f77e6483a50>,45,15,[10  1],46,-1,63,-1,48
1,<environment.Job instance at 0x7f77e57d3190>,21,17,[ 2 10],22,-1,67,-1,50
1,<environment.Job instance at 0x7f77e5958910>,50,20,[8 5],51,-1,71,-1,51
1,<environment.Job instance at 0x7f77e5958730>,54,16,[5 8],55,-1,71,-1,55
1,<environment.Job instance at 0x7f77e59582d0>,55,25,[4 5],56,-1,95,-1,70
1,<environment.Job instance at 0x7f77e5422550>,71,13,[3 5],72,-1,85,-1,72
1,<environment.Job instance at 0x7f77e5422320>,72,18,[4 8],73,-1,97,-1,79
1,<environment.Job instance at 0x7f77e5ded870>,60,18,[3 5],61,-1,97,-1,79
1,<environment.Job instance at 0x7f77e5ded460>,65,1,[1 7],66,-1,80,-1,79
1,<environment.Job instance at 0x7f77e54223c0>,73,15,[ 2 10],74,-1,94,-1,79
1,<environment.Job instance at 0x7f77e54222d0>,76,13,[6 4],77,-1,92,-1,79
1,<environment.Job instance at 0x7f77e5422fa0>,77,26,[ 3 10],78,-1,105,-1,79
1,<environment.Job instance at 0x7f77e5422f00>,78,12,[10  4],79,-1,91,-1,79
1,<environment.Job instance at 0x7f77e5422500>,74,1,[12  5],75,-1,83,-1,82
1,<environment.Job instance at 0x7f77e5dd6a50>,90,12,[2 5],91,-1,103,-1,91
1,<environment.Job instance at 0x7f77e5dd6b90>,91,17,[7 4],92,-1,109,-1,92
1,<environment.Job instance at 0x7f77e5dd6be0>,93,14,[ 5 10],94,-1,109,-1,95
1,<environment.Job instance at 0x7f77e5422eb0>,79,12,[5 8],80,-1,108,-1,96
1,<environment.Job instance at 0x7f77e541a5f0>,96,16,[3 8],97,-1,113,-1,97
1,<environment.Job instance at 0x7f77e5df6960>,95,13,[7 4],96,-1,112,-1,99
1,<environment.Job instance at 0x7f77e5dedcd0>,0,25,[6 2],1,-1,26,-1,1
1,<environment.Job instance at 0x7f77e63dd4b0>,9,13,[ 1 11],10,-1,32,-1,19
1,<environment.Job instance at 0x7f77e63dd050>,10,25,[5 5],11,-1,45,-1,20
1,<environment.Job instance at 0x7f77e63dda50>,13,3,[ 4 11],14,-1,24,-1,21
1,<environment.Job instance at 0x7f77e60591e0>,28,16,[14  4],29,-1,86,-1,70
1,<environment.Job instance at 0x7f77e58c6690>,37,27,[8 5],38,-1,133,-1,106
1,<environment.Job instance at 0x7f77e58384b0>,39,3,[ 1 12],40,-1,109,-1,106
1,<environment.Job instance at 0x7f77e50b3190>,43,17,[13  3],44,-1,135,-1,118
1,<environment.Job instance at 0x7f77e50b39b0>,44,3,[13  1],45,-1,121,-1,118
1,<environment.Job instance at 0x7f77e658c6e0>,55,25,[4 5],56,-1,172,-1,147
1,<environment.Job instance at 0x7f77e58461e0>,58,1,[ 4 14],59,-1,164,-1,163
1,<environment.Job instance at 0x7f77e50c3500>,70,2,[13  2],71,-1,193,-1,191
1,<environment.Job instance at 0x7f77ef064190>,74,1,[12  5],75,-1,206,-1,205
1,<environment.Job instance at 0x7f77e501fc80>,77,26,[ 3 10],78,-1,236,-1,210
1,<environment.Job instance at 0x7f77e5cff5f0>,81,3,[12  2],82,-1,228,-1,225
1,<environment.Job instance at 0x7f77e5d3bbe0>,94,3,[14  3],95,-1,250,-1,247
1,<environment.Job instance at 0x7f77e5727280>,2,17,[5 7],3,-1,20,-1,3
1,<environment.Job instance at 0x7f77e5727960>,10,18,[9 3],11,-1,30,-1,12
1,<environment.Job instance at 0x7f77e5fdb550>,11,17,[9 4],12,-1,29,-1,12
1,<environment.Job instance at 0x7f77e5727eb0>,16,17,[4 8],17,-1,34,-1,17
1,<environment.Job instance at 0x7f77e5737050>,18,16,[8 4],19,-1,35,-1,19
1,<environment.Job instance at 0x7f77e5737190>,19,17,[5 6],20,-1,37,-1,20
1,<environment.Job instance at 0x7f77e5737140>,20,15,[3 7],21,-1,36,-1,21
1,<environment.Job instance at 0x7f77e57378c0>,27,13,[7 1],28,-1,41,-1,28
1,<environment.Job instance at 0x7f77e5737d20>,31,18,[7 1],32,-1,50,-1,32
1,<environment.Job instance at 0x7f77e5737e60>,32,15,[6 2],33,-1,48,-1,33
1,<environment.Job instance at 0x7f77e575a050>,35,16,[3 5],36,-1,52,-1,36
1,<environment.Job instance at 0x7f77e575a190>,36,14,[6 2],37,-1,52,-1,38
1,<environment.Job instance at 0x7f77e575a370>,39,14,[7 3],40,-1,54,-1,40
1,<environment.Job instance at 0x7f77e575a5a0>,42,17,[1 5],43,-1,62,-1,45
1,<environment.Job instance at 0x7f77e575aa50>,46,12,[5 3],47,-1,65,-1,53
1,<environment.Job instance at 0x7f77e575a5f0>,41,26,[7 2],42,-1,79,-1,53
1,<environment.Job instance at 0x7f77e575ab90>,48,15,[10  2],49,-1,68,-1,53
1,<environment.Job instance at 0x7f77e575ae10>,51,23,[5 9],52,-1,76,-1,53
1,<environment.Job instance at 0x7f77e575aaf0>,47,15,[6 1],48,-1,68,-1,53
1,<environment.Job instance at 0x7f77e63ddb90>,57,22,[2 9],58,-1,80,-1,58
1,<environment.Job instance at 0x7f77e530bb40>,63,15,[ 3 10],64,-1,97,-1,82
1,<environment.Job instance at 0x7f77e5204cd0>,66,20,[8 2],67,-1,102,-1,82
1,<environment.Job instance at 0x7f77e5e674b0>,67,16,[8 4],68,-1,98,-1,82
1,<environment.Job instance at 0x7f77e4ded460>,70,15,[10  5],71,-1,97,-1,82
1,<environment.Job instance at 0x7f77e58b0780>,65,14,[7 5],66,-1,115,-1,101
1,<environment.Job instance at 0x7f77e5737960>,6,1,[11  3],7,-1,8,-1,7
1,<environment.Job instance at 0x7f77e58bed20>,13,14,[14  1],14,-1,36,-1,22
1,<environment.Job instance at 0x7f77e5727640>,22,17,[ 5 14],23,-1,77,-1,60
1,<environment.Job instance at 0x7f77e5cff8c0>,33,15,[ 2 12],34,-1,107,-1,92
1,<environment.Job instance at 0x7f77ef064d20>,38,2,[13  1],39,-1,116,-1,114
1,<environment.Job instance at 0x7f77e50c3c30>,41,26,[7 2],42,-1,156,-1,130
1,<environment.Job instance at 0x7f77e4e905f0>,51,23,[5 9],52,-1,197,-1,174
1,<environment.Job instance at 0x7f77e653b280>,53,3,[ 1 14],54,-1,177,-1,174
1,<environment.Job instance at 0x7f77e4e6a050>,56,1,[ 3 13],57,-1,176,-1,175
1,<environment.Job instance at 0x7f77e5ea55f0>,68,26,[2 5],69,-1,245,-1,219
1,<environment.Job instance at 0x7f77e50ae690>,76,24,[2 9],77,-1,275,-1,251
1,<environment.Job instance at 0x7f77e6163d70>,77,12,[ 2 12],78,-1,263,-1,251
1,<environment.Job instance at 0x7f77e60591e0>,78,14,[13  4],79,-1,265,-1,251
1,<environment.Job instance at 0x7f77e50aee60>,79,20,[ 3 11],80,-1,271,-1,251
1,<environment.Job instance at 0x7f77e63dda50>,96,1,[ 3 11],97,-1,318,-1,317
1,<environment.Job instance at 0x7f77e5735dc0>,0,12,[9 4],1,-1,14,-1,2
1,<environment.Job instance at 0x7f77e5963910>,2,14,[3 7],3,-1,17,-1,3
1,<environment.Job instance at 0x7f77e5963410>,3,16,[ 5 10],4,-1,20,-1,4
1,<environment.Job instance at 0x7f77e59638c0>,4,17,[3 5],5,-1,22,-1,5
1,<environment.Job instance at 0x7f77e534feb0>,5,15,[ 1 10],6,-1,21,-1,6
1,<environment.Job instance at 0x7f77e534f780>,6,13,[ 5 11],7,-1,20,-1,7
1,<environment.Job instance at 0x7f77e534f960>,7,1,[7 5],8,-1,9,-1,8
1,<environment.Job instance at 0x7f77e5735730>,1,23,[1 8],2,-1,32,-1,9
1,<environment.Job instance at 0x7f77e534fb90>,16,25,[8 1],17,-1,42,-1,17
1,<environment.Job instance at 0x7f77e534f6e0>,17,18,[ 1 10],18,-1,36,-1,18
1,<environment.Job instance at 0x7f77e4d9e5a0>,23,16,[9 5],24,-1,40,-1,24
1,<environment.Job instance at 0x7f77e4d9e2d0>,24,28,[7 4],25,-1,53,-1,25
1,<environment.Job instance at 0x7f77e4d9e960>,25,20,[7 2],26,-1,46,-1,26
1,<environment.Job instance at 0x7f77e4d9e230>,26,14,[10  3],27,-1,41,-1,27
1,<environment.Job instance at 0x7f77e4d9eaa0>,27,17,[5 6],28,-1,45,-1,28
1,<environment.Job instance at 0x7f77e4d9e140>,29,17,[5 2],30,-1,47,-1,30
1,<environment.Job instance at 0x7f77e5549eb0>,31,17,[9 3],32,-1,49,-1,32
1,<environment.Job instance at 0x7f77e5549550>,33,15,[2 7],34,-1,49,-1,34
1,<environment.Job instance at 0x7f77e5549c30>,34,19,[1 8],35,-1,54,-1,35
1,<environment.Job instance at 0x7f77e55499b0>,36,17,[8 4],37,-1,54,-1,37
1,<environment.Job instance at 0x7f77e5549f00>,39,3,[5 3],40,-1,43,-1,40
1,<environment.Job instance at 0x7f77e5549820>,40,13,[8 4],41,-1,54,-1,41
1,<environment.Job instance at 0x7f77ef128640>,42,12,[7 3],43,-1,55,-1,43
1,<environment.Job instance at 0x7f77ef1285f0>,43,20,[4 5],44,-1,64,-1,44
1,<environment.Job instance at 0x7f77ef128500>,45,20,[5 5],46,-1,66,-1,46
1,<environment.Job instance at 0x7f77ef1282d0>,46,18,[7 3],47,-1,65,-1,47
1,<environment.Job instance at 0x7f77e60b04b0>,48,18,[1 5],49,-1,67,-1,49
1,<environment.Job instance at 0x7f77e60b0b90>,50,16,[ 2 10],51,-1,67,-1,51
1,<environment.Job instance at 0x7f77e60b0e10>,51,18,[3 9],52,-1,70,-1,52
1,<environment.Job instance at 0x7f77eeb981e0>,58,13,[8 5],59,-1,72,-1,59
1,<environment.Job instance at 0x7f77eeb98280>,59,15,[4 6],60,-1,75,-1,60
1,<environment.Job instance at 0x7f77eeb989b0>,61,25,[1 6],62,-1,87,-1,62
1,<environment.Job instance at 0x7f77eeb985a0>,64,17,[5 5],65,-1,83,-1,66
1,<environment.Job instance at 0x7f77ef067e10>,67,15,[1 8],68,-1,83,-1,68
1,<environment.Job instance at 0x7f77ef067e60>,69,15,[9 1],70,-1,85,-1,70
1,<environment.Job instance at 0x7f77ef067fa0>,70,12,[10  4],71,-1,83,-1,71
1,<environment.Job instance at 0x7f77ef0670f0>,71,15,[10  4],72,-1,87,-1,72
1,<environment.Job instance at 0x7f77ef067d20>,74,13,[ 5 11],75,-1,88,-1,75
1,<environment.Job instance at 0x7f77ef0678c0>,76,14,[9 2],77,-1,91,-1,77
1,<environment.Job instance at 0x7f77ef067dc0>,77,28,[7 2],78,-1,106,-1,78
1,<environment.Job instance at 0x7f77e5b7da00>,79,27,[ 3 10],80,-1,107,-1,80
1,<environment.Job instance at 0x7f77e5b7d9b0>,80,13,[3 7],81,-1,94,-1,81
1,<environment.Job instance at 0x7f77e5b7dcd0>,82,26,[9 1],83,-1,109,-1,83
1,<environment.Job instance at 0x7f77eeb987d0>,65,24,[4 7],66,-1,108,-1,84
1,<environment.Job instance at 0x7f77e5b7d730>,84,21,[10  5],85,-1,107,-1,86
1,<environment.Job instance at 0x7f77e5b7daf0>,85,17,[9 3],86,-1,103,-1,86
1,<environment.Job instance at 0x7f77e5b7d0f0>,87,20,[10  2],88,-1,118,-1,98
1,<environment.Job instance at 0x7f77e534fd70>,1,23,[1 8],2,-1,25,-1,2
1,<environment.Job instance at 0x7f77ef1286e0>,6,13,[ 5 11],7,-1,20,-1,7
1,<environment.Job instance at 0x7f77e6421c80>,16,25,[8 1],17,-1,58,-1,33
1,<environment.Job instance at 0x7f77e579b0f0>,24,28,[7 4],25,-1,83,-1,55
1,<environment.Job instance at 0x7f77e5903460>,47,13,[14  1],48,-1,148,-1,135
1,<environment.Job instance at 0x7f77e58bae10>,56,2,[14  1],57,-1,173,-1,171
1,<environment.Job instance at 0x7f77e53091e0>,61,25,[1 6],62,-1,211,-1,186
1,<environment.Job instance at 0x7f77e58beeb0>,62,12,[12  2],63,-1,198,-1,186
1,<environment.Job instance at 0x7f77e4de9eb0>,63,26,[10  4],64,-1,215,-1,189
1,<environment.Job instance at 0x7f77e4defcd0>,65,24,[4 7],66,-1,223,-1,199
1,<environment.Job instance at 0x7f77ef129500>,74,13,[ 5 11],75,-1,251,-1,238
1,<environment.Job instance at 0x7f77e5f963c0>,79,27,[ 3 10],80,-1,277,-1,250
1,<environment.Job instance at 0x7f77ef129a00>,77,28,[7 2],78,-1,283,-1,255
1,<environment.Job instance at 0x7f77e5f96dc0>,82,26,[9 1],83,-1,281,-1,255
1,<environment.Job instance at 0x7f77e5f962d0>,86,3,[ 2 14],87,-1,259,-1,256
1,<environment.Job instance at 0x7f77ef062e60>,97,27,[9 4],98,-1,328,-1,301
1,<environment.Job instance at 0x7f77e536e5a0>,2,18,[2 5],3,-1,21,-1,3
1,<environment.Job instance at 0x7f77e506baf0>,4,15,[10  1],5,-1,21,-1,6
1,<environment.Job instance at 0x7f77e506bf50>,6,14,[2 6],7,-1,21,-1,7
1,<environment.Job instance at 0x7f77e5e3eb40>,5,15,[8 4],6,-1,22,-1,7
1,<environment.Job instance at 0x7f77e506aaf0>,9,17,[5 4],10,-1,27,-1,10
1,<environment.Job instance at 0x7f77e506ad20>,10,16,[1 6],11,-1,27,-1,11
1,<environment.Job instance at 0x7f77e4e55230>,12,15,[10  3],13,-1,30,-1,15
1,<environment.Job instance at 0x7f77e4e556e0>,14,18,[9 3],15,-1,33,-1,15
1,<environment.Job instance at 0x7f77e4e55140>,15,16,[3 8],16,-1,33,-1,17
1,<environment.Job instance at 0x7f77e4e55960>,19,14,[4 7],20,-1,34,-1,20
1,<environment.Job instance at 0x7f77e50974b0>,27,17,[ 5 10],28,-1,45,-1,28
1,<environment.Job instance at 0x7f77e5097b40>,28,21,[2 5],29,-1,50,-1,29
1,<environment.Job instance at 0x7f77e5097730>,29,23,[5 7],30,-1,53,-1,30
1,<environment.Job instance at 0x7f77e4e4cbe0>,33,25,[ 1 10],34,-1,70,-1,45
1,<environment.Job instance at 0x7f77e5097d20>,30,15,[3 7],31,-1,60,-1,45
1,<environment.Job instance at 0x7f77e4bedaa0>,41,18,[9 3],42,-1,66,-1,48
1,<environment.Job instance at 0x7f77e6578a50>,42,14,[5 5],43,-1,95,-1,81
1,<environment.Job instance at 0x7f77e4c59960>,57,15,[8 5],58,-1,97,-1,82
1,<environment.Job instance at 0x7f77e4c59e10>,59,21,[7 2],60,-1,103,-1,82
1,<environment.Job instance at 0x7f77e4ed3910>,46,14,[9 3],47,-1,96,-1,82
1,<environment.Job instance at 0x7f77e4c59690>,60,13,[4 9],61,-1,96,-1,83
1,<environment.Job instance at 0x7f77e4e4c910>,37,19,[ 2 10],38,-1,103,-1,84
1,<environment.Job instance at 0x7f77e4c59e60>,64,14,[ 1 12],65,-1,98,-1,84
1,<environment.Job instance at 0x7f77e4c598c0>,58,2,[6 3],59,-1,86,-1,84
1,<environment.Job instance at 0x7f77e4c59c80>,62,16,[8 1],63,-1,100,-1,84
1,<environment.Job instance at 0x7f77e4c59dc0>,66,23,[ 5 12],67,-1,107,-1,84
1,<environment.Job instance at 0x7f77e6443af0>,53,13,[10  4],54,-1,97,-1,84
1,<environment.Job instance at 0x7f77e4c59870>,63,14,[6 1],64,-1,98,-1,84
1,<environment.Job instance at 0x7f77e4c59550>,65,2,[8 4],66,-1,86,-1,84
1,<environment.Job instance at 0x7f77e4e55aa0>,8,17,[13  5],9,-1,33,-1,16
1,<environment.Job instance at 0x7f77e4c5b190>,22,13,[13  5],23,-1,79,-1,66
1,<environment.Job instance at 0x7f77e5f17c30>,25,2,[ 2 12],26,-1,80,-1,78
1,<environment.Job instance at 0x7f77e5f178c0>,29,23,[5 7],30,-1,106,-1,83
1,<environment.Job instance at 0x7f77ef0628c0>,33,25,[ 1 10],34,-1,138,-1,113
1,<environment.Job instance at 0x7f77e53091e0>,36,12,[14  2],37,-1,125,-1,113
1,<environment.Job instance at 0x7f77e58bae10>,38,1,[ 5 14],39,-1,114,-1,113
1,<environment.Job instance at 0x7f77e6185640>,50,12,[ 1 13],51,-1,158,-1,146
1,<environment.Job instance at 0x7f77e5673820>,55,2,[11  4],56,-1,162,-1,160
1,<environment.Job instance at 0x7f77e5673410>,64,14,[ 1 12],65,-1,198,-1,184
1,<environment.Job instance at 0x7f77e5673af0>,66,23,[ 5 12],67,-1,215,-1,192
1,<environment.Job instance at 0x7f77e5673730>,72,1,[ 4 11],73,-1,210,-1,209
1,<environment.Job instance at 0x7f77e4c312d0>,84,3,[ 1 12],85,-1,244,-1,241
1,<environment.Job instance at 0x7f77eeb76a50>,90,25,[6 2],91,-1,296,-1,271
1,<environment.Job instance at 0x7f77eeb768c0>,92,3,[14  1],93,-1,274,-1,271
1,<environment.Job instance at 0x7f77e5213870>,93,1,[ 4 12],94,-1,272,-1,271
1,<environment.Job instance at 0x7f77e617ad70>,0,16,[5 9],1,-1,17,-1,1
1,<environment.Job instance at 0x7f77e59e26e0>,2,14,[10  5],3,-1,19,-1,5
1,<environment.Job instance at 0x7f77e57f81e0>,6,18,[1 8],7,-1,25,-1,7
1,<environment.Job instance at 0x7f77eeb09e60>,7,27,[4 8],8,-1,35,-1,8
1,<environment.Job instance at 0x7f77e6106050>,26,18,[4 9],27,-1,46,-1,28
1,<environment.Job instance at 0x7f77e62db0f0>,21,17,[7 1],22,-1,47,-1,30
1,<environment.Job instance at 0x7f77e60a2230>,29,13,[9 3],30,-1,52,-1,39
1,<environment.Job instance at 0x7f77e62ae780>,33,18,[ 5 13],34,-1,57,-1,39
1,<environment.Job instance at 0x7f77e598cf50>,10,15,[8 5],11,-1,69,-1,54
1,<environment.Job instance at 0x7f77e62dee60>,36,16,[2 7],37,-1,70,-1,54
1,<environment.Job instance at 0x7f77e53506e0>,39,17,[3 5],40,-1,71,-1,54
1,<environment.Job instance at 0x7f77e53503c0>,40,17,[5 8],41,-1,72,-1,55
1,<environment.Job instance at 0x7f77e60a2be0>,30,12,[2 6],31,-1,67,-1,55
1,<environment.Job instance at 0x7f77e59d8870>,34,13,[8 1],35,-1,68,-1,55
1,<environment.Job instance at 0x7f77e62e4960>,41,14,[7 5],42,-1,69,-1,55
1,<environment.Job instance at 0x7f77e62e4e60>,44,18,[6 5],45,-1,73,-1,55
1,<environment.Job instance at 0x7f77e6558320>,22,15,[9 5],23,-1,70,-1,55
1,<environment.Job instance at 0x7f77e62c8cd0>,46,17,[5 1],47,-1,74,-1,57
1,<environment.Job instance at 0x7f77e54f13c0>,52,17,[3 5],53,-1,74,-1,57
1,<environment.Job instance at 0x7f77e54f1aa0>,53,13,[2 7],54,-1,70,-1,57
1,<environment.Job instance at 0x7f77eeb09190>,1,18,[14  2],2,-1,20,-1,2
1,<environment.Job instance at 0x7f77e60a2280>,5,15,[12  5],6,-1,21,-1,6
1,<environment.Job instance at 0x7f77e5918c80>,8,20,[ 4 13],9,-1,29,-1,9
1,<environment.Job instance at 0x7f77e60a2780>,7,27,[4 8],8,-1,44,-1,17
1,<environment.Job instance at 0x7f77e5e02dc0>,33,18,[ 5 13],34,-1,103,-1,85
1,<environment.Job instance at 0x7f77e5771780>,67,14,[ 3 12],68,-1,228,-1,214
1,<environment.Job instance at 0x7f77e5309460>,75,23,[7 3],76,-1,261,-1,238
1,<environment.Job instance at 0x7f77e5f17960>,82,18,[ 3 13],83,-1,259,-1,241
1,<environment.Job instance at 0x7fe0cdabd6e0>,0,18,[ 2 10],1,-1,20,-1,2
1,<environment.Job instance at 0x7fe0c44cda50>,3,18,[ 3 10],4,-1,22,-1,4
1,<environment.Job instance at 0x7fe0c44cdbe0>,4,18,[10  4],5,-1,23,-1,5
1,<environment.Job instance at 0x7fe0c44cdaf0>,5,13,[5 9],6,-1,19,-1,6
1,<environment.Job instance at 0x7fe0c44cdc80>,6,12,[11  4],7,-1,19,-1,7
1,<environment.Job instance at 0x7fe0c44cddc0>,8,17,[ 2 10],9,-1,26,-1,9
1,<environment.Job instance at 0x7fe0c44cdf00>,9,17,[ 4 10],10,-1,27,-1,10
1,<environment.Job instance at 0x7fe0c44d05a0>,16,12,[1 8],17,-1,29,-1,17
1,<environment.Job instance at 0x7fe0c44d00f0>,18,16,[8 5],19,-1,35,-1,19
1,<environment.Job instance at 0x7fe0c44d0b90>,23,18,[5 2],24,-1,42,-1,24
1,<environment.Job instance at 0x7fe0c44d0eb0>,26,22,[2 9],27,-1,52,-1,30
1,<environment.Job instance at 0x7fe0c44d3050>,31,17,[4 9],32,-1,49,-1,32
1,<environment.Job instance at 0x7fe0c44d34b0>,32,17,[9 3],33,-1,51,-1,34
1,<environment.Job instance at 0x7fe0c44d3fa0>,44,17,[ 5 12],45,-1,62,-1,45
1,<environment.Job instance at 0x7fe0c44d3b90>,39,18,[5 8],40,-1,75,-1,57
1,<environment.Job instance at 0x7fe0cdabd8c0>,1,15,[ 1 14],2,-1,72,-1,57
1,<environment.Job instance at 0x7fe0c44d5190>,48,13,[6 1],49,-1,70,-1,57
1,<environment.Job instance at 0x7fe0c44d3f50>,43,28,[6 4],44,-1,85,-1,57
1,<environment.Job instance at 0x7fe0c44d5640>,49,2,[1 9],50,-1,59,-1,57
1,<environment.Job instance at 0x7fe0c44d5780>,51,2,[4 9],52,-1,59,-1,57
1,<environment.Job instance at 0x7fe0c44d5820>,52,3,[ 3 11],53,-1,60,-1,57
1,<environment.Job instance at 0x7fe0c44d58c0>,53,18,[ 4 12],54,-1,79,-1,61
1,<environment.Job instance at 0x7fe0c44d5960>,54,14,[1 7],55,-1,76,-1,62
1,<environment.Job instance at 0x7fe0c44d5a00>,55,17,[4 7],56,-1,81,-1,64
1,<environment.Job instance at 0x7fe0c44d5aa0>,56,18,[4 5],57,-1,82,-1,64
1,<environment.Job instance at 0x7fe0c44d5320>,46,3,[5 4],47,-1,67,-1,64
1,<environment.Job instance at 0x7fe0c44d5c80>,59,14,[ 2 10],60,-1,78,-1,64
1,<environment.Job instance at 0x7fe0c44d5b90>,60,24,[ 3 10],61,-1,88,-1,64
1,<environment.Job instance at 0x7fe0c44d5e60>,62,20,[9 1],63,-1,84,-1,64
1,<environment.Job instance at 0x7fe0c44d5d20>,63,15,[1 5],64,-1,79,-1,64
1,<environment.Job instance at 0x7fe0c44d9190>,64,12,[6 1],65,-1,77,-1,65
1,<environment.Job instance at 0x7fe0c44d55f0>,57,3,[8 4],58,-1,68,-1,65
1,<environment.Job instance at 0x7fe0c44d9280>,65,13,[3 5],66,-1,79,-1,66
1,<environment.Job instance at 0x7fe0c44d9320>,67,26,[5 4],68,-1,94,-1,68
1,<environment.Job instance at 0x7fe0c44d5500>,47,1,[2 6],48,-1,69,-1,68
1,<environment.Job instance at 0x7fe0c44d9500>,68,22,[5 6],69,-1,91,-1,69
1,<environment.Job instance at 0x7fe0c44d9410>,69,13,[7 2],70,-1,83,-1,70
1,<environment.Job instance at 0x7fe0c44d95a0>,70,18,[5 5],71,-1,89,-1,71
1,<environment.Job instance at 0x7fe0c44d96e0>,72,14,[9 1],73,-1,88,-1,74
1,<environment.Job instance at 0x7fe0c44d53c0>,45,16,[6 2],46,-1,94,-1,78
1,<environment.Job instance at 0x7fe0c44d9cd0>,77,15,[4 7],78,-1,93,-1,78
1,<environment.Job instance at 0x7fe0c44d9e10>,78,19,[8 4],79,-1,99,-1,80
1,<environment.Job instance at 0x7fe0c44d9d70>,79,17,[2 7],80,-1,98,-1,81
1,<environment.Job instance at 0x7fe0c44dbaf0>,91,16,[5 8],92,-1,108,-1,92
1,<environment.Job instance at 0x7fe0c44dbbe0>,93,12,[4 9],94,-1,107,-1,95
1,<environment.Job instance at 0x7fe0cdb03910>,95,23,[3 7],96,-1,119,-1,96
1,<environment.Job instance at 0x7fe0c44a4cd0>,98,12,[10  1],99,-1,112,-1,100
1,<environment.Job instance at 0x7fe0c44c4820>,100,18,[7 5],101,-1,119,-1,101
1,<environment.Job instance at 0x7fe0c44c4a50>,103,17,[5 6],104,-1,121,-1,104
1,<environment.Job instance at 0x7fe0c44c4910>,104,17,[5 4],105,-1,122,-1,105
1,<environment.Job instance at 0x7fe0c4582050>,108,20,[5 7],109,-1,129,-1,109
1,<environment.Job instance at 0x7fe0c44d0370>,1,15,[ 1 14],2,-1,17,-1,2
1,<environment.Job instance at 0x7fe0c44d3870>,6,12,[11  4],7,-1,19,-1,7
1,<environment.Job instance at 0x7fe0c44cd870>,19,17,[12  3],20,-1,67,-1,50
1,<environment.Job instance at 0x7fe0c4675140>,22,2,[12  3],23,-1,62,-1,60
1,<environment.Job instance at 0x7fe0c44f5050>,43,28,[6 4],44,-1,166,-1,138
1,<environment.Job instance at 0x7fe0c44f5730>,44,17,[ 5 12],45,-1,155,-1,138
1,<environment.Job instance at 0x7fe0c44f5230>,50,27,[9 1],51,-1,179,-1,152
1,<environment.Job instance at 0x7fe0c455e6e0>,52,3,[ 3 11],53,-1,155,-1,152
1,<environment.Job instance at 0x7fe0c45f0190>,53,18,[ 4 12],54,-1,170,-1,152
1,<environment.Job instance at 0x7fe0c45dbb40>,60,24,[ 3 10],61,-1,209,-1,185
1,<environment.Job instance at 0x7fe0c457d460>,67,26,[5 4],68,-1,226,-1,200
1,<environment.Job instance at 0x7fe0c457c7d0>,81,17,[ 4 14],82,-1,256,-1,239
1,<environment.Job instance at 0x7fe0c457c4b0>,85,19,[14  4],86,-1,260,-1,241
1,<environment.Job instance at 0x7fe0c4508aa0>,95,23,[3 7],96,-1,294,-1,271
1,<environment.Job instance at 0x7fe0c452e410>,102,27,[ 3 13],103,-1,316,-1,289
1,<environment.Job instance at 0x7fe0c3c1a0a0>,0,20,[5 7],1,-1,21,-1,1
1,<environment.Job instance at 0x7fe0c3c1aeb0>,5,14,[9 1],6,-1,21,-1,7
1,<environment.Job instance at 0x7fe0c4468af0>,6,15,[9 2],7,-1,22,-1,7
1,<environment.Job instance at 0x7fe0c3c1af50>,9,16,[1 8],10,-1,28,-1,12
1,<environment.Job instance at 0x7fe0c3c1b0f0>,11,18,[11  5],12,-1,30,-1,12
1,<environment.Job instance at 0x7fe0c3c18320>,14,15,[9 1],15,-1,31,-1,16
1,<environment.Job instance at 0x7fe0c3c18960>,18,16,[7 1],19,-1,35,-1,19
1,<environment.Job instance at 0x7fe0c3c18af0>,19,14,[8 1],20,-1,34,-1,20
1,<environment.Job instance at 0x7fe0c3c18820>,20,16,[9 3],21,-1,37,-1,21
1,<environment.Job instance at 0x7fe0c3c0fc30>,24,15,[10  5],25,-1,40,-1,25
1,<environment.Job instance at 0x7fe0c3c0fd70>,26,18,[1 6],27,-1,45,-1,27
1,<environment.Job instance at 0x7fe0c3c14e10>,30,17,[3 8],31,-1,58,-1,41
1,<environment.Job instance at 0x7fe0c3a900f0>,41,16,[1 9],42,-1,61,-1,45
1,<environment.Job instance at 0x7fe0c3ad0960>,56,22,[11  3],57,-1,237,-1,215
1,<environment.Job instance at 0x7fe0c3a68af0>,76,26,[9 1],77,-1,241,-1,215
1,<environment.Job instance at 0x7fe0c3c1adc0>,84,17,[10  5],85,-1,232,-1,215
1,<environment.Job instance at 0x7fe0c3a68550>,80,18,[5 1],81,-1,233,-1,215
1,<environment.Job instance at 0x7fe0c3aed4b0>,47,17,[3 8],48,-1,232,-1,215
1,<environment.Job instance at 0x7fe0c3c1aaa0>,85,16,[ 3 10],86,-1,231,-1,215
1,<environment.Job instance at 0x7fe0c3a689b0>,86,23,[5 8],87,-1,238,-1,215
1,<environment.Job instance at 0x7fe0c3a6ffa0>,93,27,[5 3],94,-1,250,-1,223
1,<environment.Job instance at 0x7fe0c3a67730>,95,17,[5 9],96,-1,240,-1,223
1,<environment.Job instance at 0x7fe0c3a67140>,98,22,[9 2],99,-1,266,-1,244
1,<environment.Job instance at 0x7fe0c3a66780>,102,17,[10  4],103,-1,261,-1,244
1,<environment.Job instance at 0x7fe0c3a679b0>,101,18,[ 5 11],102,-1,262,-1,244
1,<environment.Job instance at 0x7fe0c3a66e60>,104,13,[5 9],105,-1,257,-1,244
1,<environment.Job instance at 0x7fe0c3a63cd0>,105,17,[8 1],106,-1,262,-1,245
1,<environment.Job instance at 0x7fe0c3a66230>,103,12,[5 1],104,-1,257,-1,245
1,<environment.Job instance at 0x7fe0cdb34e10>,1,18,[ 3 13],2,-1,20,-1,2
1,<environment.Job instance at 0x7fe0c3a76550>,7,18,[ 3 12],8,-1,26,-1,8
1,<environment.Job instance at 0x7fe0c3a7c730>,11,18,[11  5],12,-1,30,-1,12
1,<environment.Job instance at 0x7fe0c3a692d0>,12,14,[14  1],13,-1,27,-1,13
1,<environment.Job instance at 0x7fe0c3c71960>,25,15,[ 3 14],26,-1,71,-1,56
1,<environment.Job instance at 0x7fe0c3c6fbe0>,27,12,[14  5],28,-1,68,-1,56
1,<environment.Job instance at 0x7fe0c3c979b0>,56,22,[11  3],57,-1,193,-1,171
1,<environment.Job instance at 0x7fe0c3c9d050>,69,23,[2 8],70,-1,260,-1,237
1,<environment.Job instance at 0x7fe0c3c81320>,65,25,[3 9],66,-1,269,-1,244
1,<environment.Job instance at 0x7fe0c3e0e550>,76,26,[9 1],77,-1,271,-1,245
1,<environment.Job instance at 0x7fe0c3c6b410>,86,23,[5 8],87,-1,315,-1,292
1,<environment.Job instance at 0x7fe0c3c6ba00>,91,2,[12  1],92,-1,299,-1,297
1,<environment.Job instance at 0x7fe0c3c6baf0>,93,27,[5 3],94,-1,326,-1,299
1,<environment.Job instance at 0x7fe0c3c6ba50>,99,3,[ 4 12],100,-1,331,-1,328
1,<environment.Job instance at 0x7fe0c3c24500>,101,18,[ 5 11],102,-1,346,-1,328
1,<environment.Job instance at 0x7fe0c3d6a0a0>,108,28,[7 4],109,-1,403,-1,375
1,<environment.Job instance at 0x7fe0c3a630f0>,4,28,[9 1],5,-1,33,-1,5
1,<environment.Job instance at 0x7fe0c3a631e0>,5,17,[3 5],6,-1,23,-1,6
1,<environment.Job instance at 0x7fe0c3a635f0>,6,15,[ 5 10],7,-1,22,-1,7
1,<environment.Job instance at 0x7fe0c3a636e0>,12,16,[8 5],13,-1,29,-1,13
1,<environment.Job instance at 0x7fe0c3a63dc0>,13,12,[3 8],14,-1,26,-1,14
1,<environment.Job instance at 0x7fe0c3a63fa0>,14,14,[8 5],15,-1,29,-1,15
1,<environment.Job instance at 0x7fe0cdc38320>,18,18,[3 8],19,-1,37,-1,19
1,<environment.Job instance at 0x7fe0cdc38280>,19,16,[9 4],20,-1,36,-1,20
1,<environment.Job instance at 0x7fe0c3a885f0>,20,28,[7 3],21,-1,49,-1,21
1,<environment.Job instance at 0x7fe0c3a88b90>,21,16,[7 4],22,-1,38,-1,22
1,<environment.Job instance at 0x7fe0c3a88f50>,23,18,[1 6],24,-1,42,-1,24
1,<environment.Job instance at 0x7fe0c3a88550>,24,15,[9 5],25,-1,40,-1,25
1,<environment.Job instance at 0x7fe0c3a881e0>,26,17,[2 6],27,-1,44,-1,27
1,<environment.Job instance at 0x7fe0c3a88d20>,27,16,[2 8],28,-1,44,-1,28
1,<environment.Job instance at 0x7fe0c3a88370>,30,18,[8 5],31,-1,49,-1,31
1,<environment.Job instance at 0x7fe0c3a88730>,33,14,[3 5],34,-1,48,-1,34
1,<environment.Job instance at 0x7fe0c3a887d0>,34,17,[1 9],35,-1,52,-1,35
1,<environment.Job instance at 0x7fe0c3ae15f0>,43,21,[9 5],44,-1,66,-1,45
1,<environment.Job instance at 0x7fe0c3ae1be0>,45,12,[12  4],46,-1,58,-1,46
1,<environment.Job instance at 0x7fe0c3ae1eb0>,46,22,[6 1],47,-1,70,-1,48
1,<environment.Job instance at 0x7fe0c3ae17d0>,44,18,[10  2],45,-1,71,-1,53
1,<environment.Job instance at 0x7fe0cdabd960>,52,17,[8 2],53,-1,71,-1,54
1,<environment.Job instance at 0x7fe0c3ae1f50>,48,21,[5 1],49,-1,75,-1,54
1,<environment.Job instance at 0x7fe0cdabd9b0>,51,18,[ 5 14],52,-1,76,-1,58
1,<environment.Job instance at 0x7fe0c3bbdaf0>,56,14,[5 4],57,-1,72,-1,58
1,<environment.Job instance at 0x7fe0c3ae14b0>,41,19,[ 3 14],42,-1,81,-1,62
1,<environment.Job instance at 0x7fe0c3bbd550>,59,13,[5 7],60,-1,75,-1,62
1,<environment.Job instance at 0x7fe0c3bbdaa0>,66,13,[3 6],67,-1,80,-1,67
1,<environment.Job instance at 0x7fe0c3a7b410>,69,14,[5 7],70,-1,84,-1,70
1,<environment.Job instance at 0x7fe0c3a7b8c0>,70,13,[7 4],71,-1,84,-1,71
1,<environment.Job instance at 0x7fe0c3a7b320>,73,18,[9 2],74,-1,92,-1,74
1,<environment.Job instance at 0x7fe0c3a7b460>,74,18,[ 5 10],75,-1,93,-1,75
1,<environment.Job instance at 0x7fe0c3a7b3c0>,76,16,[5 7],77,-1,93,-1,77
1,<environment.Job instance at 0x7fe0c3a7bcd0>,79,15,[7 4],80,-1,95,-1,80
1,<environment.Job instance at 0x7fe0c3a7b690>,80,17,[4 5],81,-1,98,-1,81
1,<environment.Job instance at 0x7fe0cdaff8c0>,85,18,[9 5],86,-1,104,-1,86
1,<environment.Job instance at 0x7fe0cdc37cd0>,91,15,[10  3],92,-1,111,-1,96
1,<environment.Job instance at 0x7fe0cdc37a50>,94,16,[8 3],95,-1,112,-1,96
1,<environment.Job instance at 0x7fe0cdc37050>,90,14,[2 8],91,-1,115,-1,101
1,<environment.Job instance at 0x7fe0c3bbdb90>,61,16,[6 2],62,-1,117,-1,101
1,<environment.Job instance at 0x7fe0c46b2640>,101,18,[ 4 13],102,-1,120,-1,102
1,<environment.Job instance at 0x7fe0c3ae15a0>,47,14,[3 5],48,-1,118,-1,104
1,<environment.Job instance at 0x7fe0cdc28fa0>,103,15,[7 4],104,-1,120,-1,105
1,<environment.Job instance at 0x7fe0cdca38c0>,100,14,[ 3 10],101,-1,121,-1,107
1,<environment.Job instance at 0x7fe0c3ae85f0>,107,16,[ 5 13],108,-1,124,-1,108
1,<environment.Job instance at 0x7fe0cdca3be0>,99,17,[4 8],100,-1,125,-1,108
1,<environment.Job instance at 0x7fe0cdca3dc0>,4,28,[9 1],5,-1,33,-1,5
1,<environment.Job instance at 0x7fe0c3f6f5f0>,8,16,[14  3],9,-1,25,-1,9
1,<environment.Job instance at 0x7fe0cdae5be0>,20,28,[7 3],21,-1,83,-1,55
1,<environment.Job instance at 0x7fe0c3ce49b0>,38,12,[12  2],39,-1,145,-1,133
1,<environment.Job instance at 0x7fe0c3d5b780>,41,19,[ 3 14],42,-1,157,-1,138
1,<environment.Job instance at 0x7fe0c3d5b640>,42,2,[14  5],43,-1,140,-1,138
1,<environment.Job instance at 0x7fe0c42c5e10>,45,12,[12  4],46,-1,152,-1,140
1,<environment.Job instance at 0x7fe0c3e4f190>,51,18,[ 5 14],52,-1,174,-1,156
1,<environment.Job instance at 0x7fe0c3daf550>,58,1,[ 5 14],59,-1,177,-1,176
1,<environment.Job instance at 0x7fe0c3d56460>,63,3,[14  5],64,-1,195,-1,192
1,<environment.Job instance at 0x7fe0c423f410>,68,17,[12  1],69,-1,212,-1,195
1,<environment.Job instance at 0x7fe0c423f460>,72,1,[13  3],73,-1,213,-1,212
1,<environment.Job instance at 0x7fe0c3d21e60>,82,27,[ 2 13],83,-1,289,-1,262
1,<environment.Job instance at 0x7fe0c3d31500>,88,1,[12  5],89,-1,282,-1,281
1,<environment.Job instance at 0x7fe0c3cc3b90>,101,18,[ 4 13],102,-1,351,-1,333
1,<environment.Job instance at 0x7fe0c3e28050>,107,16,[ 5 13],108,-1,366,-1,350
1,<environment.Job instance at 0x7fe0c3a9b0a0>,1,16,[2 8],2,-1,18,-1,2
1,<environment.Job instance at 0x7fe0c3a9bdc0>,8,14,[10  4],9,-1,23,-1,9
1,<environment.Job instance at 0x7fe0c3a9b4b0>,9,16,[1 7],10,-1,26,-1,10
1,<environment.Job instance at 0x7fe0c415c8c0>,15,17,[6 3],16,-1,33,-1,16
1,<environment.Job instance at 0x7fe0c415c280>,16,20,[6 2],17,-1,37,-1,17
1,<environment.Job instance at 0x7fe0c415caf0>,18,17,[2 8],19,-1,36,-1,19
1,<environment.Job instance at 0x7fe0c3c15c30>,21,14,[3 6],22,-1,36,-1,22
1,<environment.Job instance at 0x7fe0c3c156e0>,22,15,[7 3],23,-1,38,-1,23
1,<environment.Job instance at 0x7fe0c3c15f00>,25,16,[2 6],26,-1,42,-1,26
1,<environment.Job instance at 0x7fe0c3c15f50>,26,15,[10  5],27,-1,42,-1,27
1,<environment.Job instance at 0x7fe0c3c15cd0>,27,16,[ 3 10],28,-1,44,-1,28
1,<environment.Job instance at 0x7fe0c3c152d0>,28,16,[3 6],29,-1,45,-1,29
1,<environment.Job instance at 0x7fe0c3c15460>,29,22,[1 6],30,-1,52,-1,30
1,<environment.Job instance at 0x7fe0c3c15320>,31,25,[10  4],32,-1,57,-1,32
1,<environment.Job instance at 0x7fe0c3c15be0>,34,22,[1 9],35,-1,57,-1,35
1,<environment.Job instance at 0x7fe0c4189e10>,37,13,[ 1 10],38,-1,51,-1,38
1,<environment.Job instance at 0x7fe0c3fa9730>,39,18,[ 2 10],40,-1,58,-1,40
1,<environment.Job instance at 0x7fe0c3fa9960>,41,18,[3 8],42,-1,60,-1,42
1,<environment.Job instance at 0x7fe0c3fa9820>,43,24,[3 6],44,-1,68,-1,44
1,<environment.Job instance at 0x7fe0c3fa9f00>,45,20,[3 8],46,-1,66,-1,46
1,<environment.Job instance at 0x7fe0c3fac730>,46,15,[4 9],47,-1,62,-1,47
1,<environment.Job instance at 0x7fe0c3fac5a0>,47,27,[9 5],48,-1,75,-1,48
1,<environment.Job instance at 0x7fe0c3fac690>,48,14,[3 6],49,-1,63,-1,49
1,<environment.Job instance at 0x7fe0c3fac8c0>,50,18,[4 8],51,-1,69,-1,51
1,<environment.Job instance at 0x7fe0c3facfa0>,55,18,[ 3 10],56,-1,74,-1,56
1,<environment.Job instance at 0x7fe0c3be28c0>,56,21,[6 1],57,-1,78,-1,57
1,<environment.Job instance at 0x7fe0c3be2910>,57,13,[4 9],58,-1,71,-1,58
1,<environment.Job instance at 0x7fe0c3fcec30>,60,12,[1 5],61,-1,73,-1,61
1,<environment.Job instance at 0x7fe0c3fce730>,62,17,[9 1],63,-1,80,-1,63
1,<environment.Job instance at 0x7fe0c3fceb40>,63,18,[8 1],64,-1,82,-1,64
1,<environment.Job instance at 0x7fe0c3fcea00>,65,27,[5 5],66,-1,93,-1,66
1,<environment.Job instance at 0x7fe0c3fceb90>,66,22,[2 8],67,-1,89,-1,67
1,<environment.Job instance at 0x7fe0c3fcea50>,67,20,[5 2],68,-1,88,-1,68
1,<environment.Job instance at 0x7fe0c3fce320>,69,17,[2 6],70,-1,87,-1,70
1,<environment.Job instance at 0x7fe0c401f0a0>,70,16,[1 9],71,-1,87,-1,71
1,<environment.Job instance at 0x7fe0c401f910>,72,17,[4 6],73,-1,90,-1,73
1,<environment.Job instance at 0x7fe0c401fb40>,73,27,[7 5],74,-1,101,-1,74
1,<environment.Job instance at 0x7fe0c415dcd0>,81,18,[5 7],82,-1,100,-1,82
1,<environment.Job instance at 0x7fe0c415d460>,83,16,[3 5],84,-1,101,-1,85
1,<environment.Job instance at 0x7fe0c415d500>,85,25,[3 7],86,-1,111,-1,86
1,<environment.Job instance at 0x7fe0c415d2d0>,79,17,[5 1],80,-1,106,-1,89
1,<environment.Job instance at 0x7fe0c3bdbc30>,95,16,[10  5],96,-1,124,-1,108
1,<environment.Job instance at 0x7fe0c3f8e1e0>,87,14,[10  3],88,-1,122,-1,108
1,<environment.Job instance at 0x7fe0c3bdb410>,98,21,[9 5],99,-1,129,-1,108
1,<environment.Job instance at 0x7fe0c3f8e370>,88,13,[8 2],89,-1,121,-1,108
1,<environment.Job instance at 0x7fe0c3bdb0a0>,100,17,[9 4],101,-1,125,-1,108
1,<environment.Job instance at 0x7fe0c4189c30>,4,18,[13  2],5,-1,23,-1,5
1,<environment.Job instance at 0x7fe0c3fce6e0>,10,18,[11  4],11,-1,33,-1,15
1,<environment.Job instance at 0x7fe0c3e4fa50>,31,25,[10  4],32,-1,120,-1,95
1,<environment.Job instance at 0x7fe0c4b9fcd0>,43,24,[3 6],44,-1,165,-1,141
1,<environment.Job instance at 0x7fe0c3f62460>,47,27,[9 5],48,-1,173,-1,146
1,<environment.Job instance at 0x7fe0c4d1fbe0>,53,2,[ 3 14],54,-1,165,-1,163
1,<environment.Job instance at 0x7fe0c3bbd410>,64,3,[ 3 12],65,-1,215,-1,212
1,<environment.Job instance at 0x7fe0c3bf77d0>,65,27,[5 5],66,-1,239,-1,212
1,<environment.Job instance at 0x7fe0c3bf7b40>,68,13,[14  4],69,-1,243,-1,230
1,<environment.Job instance at 0x7fe0cd958690>,74,13,[14  5],75,-1,262,-1,249
1,<environment.Job instance at 0x7fe0c4560a50>,73,27,[7 5],74,-1,293,-1,266
1,<environment.Job instance at 0x7fe0c473a500>,85,25,[3 7],86,-1,323,-1,298
1,<environment.Job instance at 0x7fe0c4c94fa0>,90,1,[ 4 12],91,-1,312,-1,311
1,<environment.Job instance at 0x7fe0c4548b40>,94,12,[13  3],95,-1,336,-1,324
1,<environment.Job instance at 0x7fe0c4548550>,99,3,[12  1],100,-1,349,-1,346
1,<environment.Job instance at 0x7fe0c4920eb0>,3,17,[1 8],4,-1,21,-1,4
1,<environment.Job instance at 0x7fe0c492b2d0>,6,17,[9 1],7,-1,27,-1,10
1,<environment.Job instance at 0x7fe0c492ba50>,12,17,[10  3],13,-1,32,-1,15
1,<environment.Job instance at 0x7fe0c49227d0>,14,15,[ 1 10],15,-1,37,-1,22
1,<environment.Job instance at 0x7fe0c3e5ee60>,22,27,[5 5],23,-1,62,-1,35
1,<environment.Job instance at 0x7fe0c3e2b690>,24,25,[1 7],25,-1,60,-1,35
1,<environment.Job instance at 0x7fe0c492b370>,5,24,[3 9],6,-1,60,-1,36
1,<environment.Job instance at 0x7fe0c492b7d0>,13,13,[9 5],14,-1,49,-1,36
1,<environment.Job instance at 0x7fe0c4916be0>,29,14,[2 6],30,-1,50,-1,36
1,<environment.Job instance at 0x7fe0c41ca690>,26,15,[ 5 10],27,-1,51,-1,36
1,<environment.Job instance at 0x7fe0c4916af0>,31,14,[1 9],32,-1,50,-1,36
1,<environment.Job instance at 0x7fe0c4331eb0>,33,18,[4 8],34,-1,55,-1,37
1,<environment.Job instance at 0x7fe0c3ee51e0>,21,15,[14  1],22,-1,52,-1,37
1,<environment.Job instance at 0x7fe0c42a2320>,34,17,[7 4],35,-1,54,-1,37
1,<environment.Job instance at 0x7fe0c4353f50>,36,27,[5 8],37,-1,64,-1,37
1,<environment.Job instance at 0x7fe0c42b9870>,41,24,[4 8],42,-1,68,-1,44
1,<environment.Job instance at 0x7fe0c49169b0>,32,12,[4 9],33,-1,56,-1,44
1,<environment.Job instance at 0x7fe0c41d2f00>,45,19,[7 5],46,-1,65,-1,46
1,<environment.Job instance at 0x7fe0c41d20a0>,46,14,[8 1],47,-1,62,-1,48
1,<environment.Job instance at 0x7fe0c41d20f0>,47,12,[10  4],48,-1,61,-1,49
1,<environment.Job instance at 0x7fe0c42d32d0>,50,14,[ 4 10],51,-1,67,-1,53
1,<environment.Job instance at 0x7fe0c42d3190>,53,14,[8 2],54,-1,68,-1,54
1,<environment.Job instance at 0x7fe0c41de820>,56,18,[8 2],57,-1,75,-1,57
1,<environment.Job instance at 0x7fe0c41deaf0>,60,19,[2 7],61,-1,80,-1,61
1,<environment.Job instance at 0x7fe0c42d35f0>,52,17,[2 5],53,-1,80,-1,63
1,<environment.Job instance at 0x7fe0c42cd780>,35,14,[7 3],36,-1,79,-1,65
1,<environment.Job instance at 0x7fe0c41dec30>,61,24,[1 9],62,-1,89,-1,65
1,<environment.Job instance at 0x7fe0c3e5e5a0>,23,14,[3 6],24,-1,82,-1,68
1,<environment.Job instance at 0x7fe0c41defa0>,66,14,[7 5],67,-1,82,-1,68
1,<environment.Job instance at 0x7fe0c41a1320>,67,23,[10  4],68,-1,92,-1,69
1,<environment.Job instance at 0x7fe0c41a1370>,68,14,[3 8],69,-1,84,-1,70
1,<environment.Job instance at 0x7fe0c41a15f0>,71,17,[5 7],72,-1,89,-1,72
1,<environment.Job instance at 0x7fe0c41a1820>,74,13,[1 9],75,-1,90,-1,77
1,<environment.Job instance at 0x7fe0c41a1b90>,79,17,[ 5 10],80,-1,97,-1,80
1,<environment.Job instance at 0x7fe0c41a1d20>,80,18,[4 6],81,-1,99,-1,81
1,<environment.Job instance at 0x7fe0c41a19b0>,76,17,[13  2],77,-1,98,-1,81
1,<environment.Job instance at 0x7fe0c41a8140>,84,15,[5 7],85,-1,100,-1,85
1,<environment.Job instance at 0x7fe0c41a82d0>,85,24,[10  2],86,-1,111,-1,87
1,<environment.Job instance at 0x7fe0c41de960>,59,18,[5 8],60,-1,105,-1,87
1,<environment.Job instance at 0x7fe0c41a1e10>,82,17,[ 2 12],83,-1,104,-1,87
1,<environment.Job instance at 0x7fe0c41a8460>,86,14,[ 5 10],87,-1,102,-1,88
1,<environment.Job instance at 0x7fe0c41a8410>,89,27,[14  1],90,-1,124,-1,97
1,<environment.Job instance at 0x7fe0c41a80a0>,87,18,[1 7],88,-1,115,-1,97
1,<environment.Job instance at 0x7fe0c41a88c0>,95,12,[11  5],96,-1,110,-1,98
1,<environment.Job instance at 0x7fe0c41a8780>,93,20,[5 7],94,-1,118,-1,98
1,<environment.Job instance at 0x7fe0c41a8960>,96,27,[4 5],97,-1,125,-1,98
1,<environment.Job instance at 0x7fe0c41a8c30>,97,12,[5 5],98,-1,110,-1,98
1,<environment.Job instance at 0x7fe0c41a8dc0>,98,15,[5 9],99,-1,114,-1,99
1,<environment.Job instance at 0x7fe0c41a8d70>,100,14,[8 4],101,-1,118,-1,104
1,<environment.Job instance at 0x7fe0c41a8f00>,99,12,[9 1],100,-1,116,-1,104
1,<environment.Job instance at 0x7fe0c41a92d0>,103,18,[6 1],104,-1,122,-1,104
1,<environment.Job instance at 0x7fe0c41a9460>,106,14,[10  4],107,-1,121,-1,107
1,<environment.Job instance at 0x7fe0c491ccd0>,4,14,[ 3 14],5,-1,19,-1,5
1,<environment.Job instance at 0x7fe0c49220f0>,5,24,[3 9],6,-1,45,-1,21
1,<environment.Job instance at 0x7fe0c41a1050>,15,1,[12  4],16,-1,28,-1,27
1,<environment.Job instance at 0x7fe0c41a8d20>,21,15,[14  1],22,-1,51,-1,36
1,<environment.Job instance at 0x7fe0c46b9870>,22,27,[5 5],23,-1,64,-1,37
1,<environment.Job instance at 0x7fe0c46b9230>,24,25,[1 7],25,-1,74,-1,49
1,<environment.Job instance at 0x7fe0c45d5140>,36,27,[5 8],37,-1,134,-1,107
1,<environment.Job instance at 0x7fe0c473a140>,41,24,[4 8],42,-1,150,-1,126
1,<environment.Job instance at 0x7fe0c48c2cd0>,51,1,[11  1],52,-1,142,-1,141
1,<environment.Job instance at 0x7fe0c3bbd370>,61,24,[1 9],62,-1,214,-1,190
1,<environment.Job instance at 0x7fe0c4c5cbe0>,67,23,[10  4],68,-1,237,-1,214
1,<environment.Job instance at 0x7fe0c4e1c910>,73,3,[ 5 13],74,-1,217,-1,214
1,<environment.Job instance at 0x7fe0c49557d0>,76,17,[13  2],77,-1,243,-1,226
1,<environment.Job instance at 0x7fe0c4ff0f00>,77,1,[11  4],78,-1,227,-1,226
1,<environment.Job instance at 0x7fe0c3d5bf00>,82,17,[ 2 12],83,-1,257,-1,240
1,<environment.Job instance at 0x7fe0c3e4f780>,85,24,[10  2],86,-1,280,-1,256
1,<environment.Job instance at 0x7fe0c3e4f190>,89,27,[14  1],90,-1,310,-1,283
1,<environment.Job instance at 0x7fe0c3e6b0a0>,92,2,[11  4],93,-1,285,-1,283
1,<environment.Job instance at 0x7fe0c3e6b960>,95,12,[11  5],96,-1,296,-1,284
1,<environment.Job instance at 0x7fe0c3deef00>,96,27,[4 5],97,-1,312,-1,285
1,<environment.Job instance at 0x7fe0c40f9730>,102,3,[11  3],103,-1,315,-1,312
1,<environment.Job instance at 0x7fe0c3bd95f0>,7,18,[3 6],8,-1,27,-1,9
1,<environment.Job instance at 0x7fe0c3bd9910>,8,14,[6 4],9,-1,24,-1,10
1,<environment.Job instance at 0x7fe0c3bd9320>,10,18,[5 9],11,-1,29,-1,11
1,<environment.Job instance at 0x7fe0c3bd9b90>,13,18,[ 1 10],14,-1,33,-1,15
1,<environment.Job instance at 0x7fe0c3bd9c30>,14,14,[7 5],15,-1,32,-1,18
1,<environment.Job instance at 0x7fe0c3e35cd0>,19,14,[9 5],20,-1,36,-1,22
1,<environment.Job instance at 0x7fe0c3e35a50>,21,17,[14  3],22,-1,39,-1,22
1,<environment.Job instance at 0x7fe0c3e35e60>,25,17,[ 5 10],26,-1,44,-1,27
1,<environment.Job instance at 0x7fe0c3e35eb0>,28,16,[9 2],29,-1,45,-1,29
1,<environment.Job instance at 0x7fe0c3f0ce10>,31,13,[1 9],32,-1,45,-1,32
1,<environment.Job instance at 0x7fe0c3ba96e0>,36,14,[9 2],37,-1,51,-1,37
1,<environment.Job instance at 0x7fe0c3ba9640>,37,17,[3 8],38,-1,55,-1,38
1,<environment.Job instance at 0x7fe0c43365a0>,50,18,[8 1],51,-1,73,-1,55
1,<environment.Job instance at 0x7fe0c43364b0>,55,13,[3 9],56,-1,69,-1,56
1,<environment.Job instance at 0x7fe0c4336c80>,56,18,[9 4],57,-1,85,-1,67
1,<environment.Job instance at 0x7fe0c3f0c780>,1,15,[ 2 14],2,-1,17,-1,2
1,<environment.Job instance at 0x7fe0c3ba94b0>,5,12,[ 3 13],6,-1,18,-1,6
1,<environment.Job instance at 0x7fe0c3ee5960>,21,17,[14  3],22,-1,57,-1,40
1,<environment.Job instance at 0x7fe0c3b16780>,24,15,[ 2 13],25,-1,58,-1,43
1,<environment.Job instance at 0x7fe0c3bd98c0>,27,3,[12  4],28,-1,56,-1,53
1,<environment.Job instance at 0x7fe0c3bd90a0>,29,28,[1 8],30,-1,90,-1,62
1,<environment.Job instance at 0x7fe0c41a8b40>,38,18,[13  3],39,-1,104,-1,86
1,<environment.Job instance at 0x7fe0c3e5e7d0>,45,24,[8 3],46,-1,142,-1,118
1,<environment.Job instance at 0x7fe0c4ee16e0>,61,13,[12  4],62,-1,200,-1,187
1,<environment.Job instance at 0x7fe0c4441eb0>,64,24,[4 5],65,-1,226,-1,202
1,<environment.Job instance at 0x7fe0c48b13c0>,99,23,[6 5],100,-1,361,-1,338
1,<environment.Job instance at 0x7fe0c410ca00>,0,27,[6 4],1,-1,28,-1,1
1,<environment.Job instance at 0x7fe0c4ba9cd0>,2,15,[10  1],3,-1,19,-1,4
1,<environment.Job instance at 0x7fe0c4287aa0>,3,13,[7 5],4,-1,17,-1,4
1,<environment.Job instance at 0x7fe0c406f230>,8,22,[7 5],9,-1,31,-1,9
1,<environment.Job instance at 0x7fe0c406fb90>,10,18,[ 5 10],11,-1,29,-1,11
1,<environment.Job instance at 0x7fe0c406f370>,12,24,[1 6],13,-1,37,-1,13
1,<environment.Job instance at 0x7fe0c406f730>,13,16,[8 5],14,-1,30,-1,14
1,<environment.Job instance at 0x7fe0c406f2d0>,14,16,[9 4],15,-1,32,-1,16
1,<environment.Job instance at 0x7fe0c406fc80>,16,15,[10  4],17,-1,33,-1,18
1,<environment.Job instance at 0x7fe0c4506690>,18,17,[3 9],19,-1,36,-1,19
1,<environment.Job instance at 0x7fe0c451b190>,20,14,[1 8],21,-1,35,-1,21
1,<environment.Job instance at 0x7fe0c4093af0>,21,12,[5 6],22,-1,34,-1,22
1,<environment.Job instance at 0x7fe0c40939b0>,23,13,[5 1],24,-1,37,-1,24
1,<environment.Job instance at 0x7fe0c3dd9500>,26,12,[1 5],27,-1,39,-1,27
1,<environment.Job instance at 0x7fe0c4093d20>,28,14,[9 1],29,-1,43,-1,29
1,<environment.Job instance at 0x7fe0c452b140>,29,17,[1 9],30,-1,47,-1,30
1,<environment.Job instance at 0x7fe0c4958a50>,31,2,[ 3 14],32,-1,34,-1,32
1,<environment.Job instance at 0x7fe0c4086b40>,32,15,[6 2],33,-1,48,-1,33
1,<environment.Job instance at 0x7fe0c406f820>,17,13,[ 4 10],18,-1,47,-1,34
1,<environment.Job instance at 0x7fe0c3e46be0>,39,18,[ 5 10],40,-1,60,-1,42
1,<environment.Job instance at 0x7fe0c4bb7dc0>,41,12,[1 8],42,-1,68,-1,56
1,<environment.Job instance at 0x7fe0c3dacd70>,52,17,[9 4],53,-1,73,-1,56
1,<environment.Job instance at 0x7fe0c3dd5690>,54,18,[ 4 11],55,-1,74,-1,56
1,<environment.Job instance at 0x7fe0c3dd5820>,55,16,[9 4],56,-1,73,-1,57
1,<environment.Job instance at 0x7fe0c3dacd20>,47,12,[7 2],48,-1,70,-1,58
1,<environment.Job instance at 0x7fe0c3dd51e0>,57,15,[4 6],58,-1,73,-1,58
1,<environment.Job instance at 0x7fe0c4971500>,60,20,[4 6],61,-1,84,-1,64
1,<environment.Job instance at 0x7fe0c49719b0>,65,16,[ 2 11],66,-1,86,-1,70
1,<environment.Job instance at 0x7fe0c4971aa0>,64,16,[4 5],65,-1,86,-1,70
1,<environment.Job instance at 0x7fe0c3da18c0>,45,15,[ 1 10],46,-1,87,-1,72
1,<environment.Job instance at 0x7fe0c4971f50>,70,12,[1 7],71,-1,84,-1,72
1,<environment.Job instance at 0x7fe0c493c230>,72,17,[ 2 10],73,-1,92,-1,75
1,<environment.Job instance at 0x7fe0c493c190>,73,15,[5 5],74,-1,93,-1,78
1,<environment.Job instance at 0x7fe0c493c0f0>,74,12,[9 1],75,-1,90,-1,78
1,<environment.Job instance at 0x7fe0c493c690>,78,20,[3 8],79,-1,100,-1,80
1,<environment.Job instance at 0x7fe0c493c460>,76,13,[4 7],77,-1,93,-1,80
1,<environment.Job instance at 0x7fe0c493c780>,80,24,[10  4],81,-1,105,-1,81
1,<environment.Job instance at 0x7fe0c493ca00>,81,21,[4 7],82,-1,103,-1,82
1,<environment.Job instance at 0x7fe0c493caa0>,82,17,[ 2 11],83,-1,105,-1,88
1,<environment.Job instance at 0x7fe0c495d2d0>,89,19,[5 5],90,-1,109,-1,90
1,<environment.Job instance at 0x7fe0c4971b90>,67,1,[10  5],68,-1,92,-1,91
1,<environment.Job instance at 0x7fe0c495d280>,90,15,[10  4],91,-1,106,-1,91
1,<environment.Job instance at 0x7fe0c495d370>,91,18,[4 8],92,-1,113,-1,95
1,<environment.Job instance at 0x7fe0c493cb90>,83,15,[4 9],84,-1,114,-1,99
1,<environment.Job instance at 0x7fe0c495d6e0>,95,12,[10  1],96,-1,112,-1,100
1,<environment.Job instance at 0x7fe0c495d8c0>,98,18,[4 6],99,-1,122,-1,104
1,<environment.Job instance at 0x7fe0c495d820>,97,14,[ 4 10],98,-1,126,-1,112
1,<environment.Job instance at 0x7fe0c495dbe0>,103,13,[7 4],104,-1,125,-1,112
1,<environment.Job instance at 0x7fe0c493ccd0>,86,18,[6 3],87,-1,131,-1,113
1,<environment.Job instance at 0x7fe0c4950050>,108,17,[9 5],109,-1,130,-1,113
1,<environment.Job instance at 0x7fe0c495d320>,92,15,[4 8],93,-1,128,-1,113
1,<environment.Job instance at 0x7fe0c495daa0>,102,16,[3 8],103,-1,129,-1,113
1,<environment.Job instance at 0x7fe0c495df50>,106,18,[10  2],107,-1,147,-1,129
1,<environment.Job instance at 0x7fe0c4093870>,0,27,[6 4],1,-1,28,-1,1
1,<environment.Job instance at 0x7fe0c4093cd0>,1,1,[11  4],2,-1,3,-1,2
1,<environment.Job instance at 0x7fe0c48b1370>,12,24,[1 6],13,-1,45,-1,21
1,<environment.Job instance at 0x7fe0c3bdb190>,24,3,[ 2 12],25,-1,70,-1,67
1,<environment.Job instance at 0x7fe0c44415f0>,31,2,[ 3 14],32,-1,87,-1,85
1,<environment.Job instance at 0x7fe0c4441730>,36,13,[12  4],37,-1,114,-1,101
1,<environment.Job instance at 0x7fe0c407e0a0>,37,27,[9 3],38,-1,129,-1,102
1,<environment.Job instance at 0x7fe0c491c5a0>,46,12,[ 2 11],47,-1,142,-1,130
1,<environment.Job instance at 0x7fe0c41a8230>,48,24,[4 7],49,-1,169,-1,145
1,<environment.Job instance at 0x7fe0c3b16780>,54,18,[ 4 11],55,-1,175,-1,157
1,<environment.Job instance at 0x7fe0c433fd20>,59,3,[14  1],60,-1,179,-1,176
1,<environment.Job instance at 0x7fe0c42d3320>,63,14,[ 1 11],64,-1,194,-1,180
1,<environment.Job instance at 0x7fe0c4c5e410>,65,16,[ 2 11],66,-1,198,-1,182
1,<environment.Job instance at 0x7fe0c4bed280>,68,2,[13  3],69,-1,189,-1,187
1,<environment.Job instance at 0x7fe0c3ba9140>,80,24,[10  4],81,-1,268,-1,244
1,<environment.Job instance at 0x7fe0c44d3050>,82,17,[ 2 11],83,-1,261,-1,244
1,<environment.Job instance at 0x7fe0c3ba9280>,84,1,[ 2 11],85,-1,245,-1,244
1,<environment.Job instance at 0x7fe0c41d7aa0>,99,1,[ 5 14],100,-1,307,-1,306
1,<environment.Job instance at 0x7fe0c46fae60>,0,16,[ 3 10],1,-1,18,-1,2
1,<environment.Job instance at 0x7fe0c46fa410>,2,3,[4 8],3,-1,6,-1,3
1,<environment.Job instance at 0x7fe0c46fa500>,3,13,[5 5],4,-1,17,-1,4
1,<environment.Job instance at 0x7fe0c46fa780>,4,2,[1 6],5,-1,7,-1,5
1,<environment.Job instance at 0x7fe0c46fac30>,5,14,[4 6],6,-1,20,-1,6
1,<environment.Job instance at 0x7fe0c46fa460>,6,1,[5 1],7,-1,8,-1,7
1,<environment.Job instance at 0x7fe0c48b1690>,1,16,[5 7],2,-1,27,-1,11
1,<environment.Job instance at 0x7fe0c46fac80>,18,17,[3 7],19,-1,38,-1,21
1,<environment.Job instance at 0x7fe0c41053c0>,21,17,[2 7],22,-1,39,-1,22
1,<environment.Job instance at 0x7fe0c41058c0>,22,17,[6 4],23,-1,40,-1,23
1,<environment.Job instance at 0x7fe0c4105690>,28,12,[ 4 10],29,-1,41,-1,29
1,<environment.Job instance at 0x7fe0c41054b0>,30,14,[ 2 10],31,-1,46,-1,32
1,<environment.Job instance at 0x7fe0c4105a50>,32,16,[ 3 10],33,-1,49,-1,33
1,<environment.Job instance at 0x7fe0c4105be0>,33,18,[5 5],34,-1,52,-1,34
1,<environment.Job instance at 0x7fe0c4d370a0>,34,16,[5 5],35,-1,51,-1,35
1,<environment.Job instance at 0x7fe0c4d37dc0>,35,17,[ 3 10],36,-1,53,-1,36
1,<environment.Job instance at 0x7fe0c4d37640>,37,2,[ 3 10],38,-1,40,-1,38
1,<environment.Job instance at 0x7fe0c4d37370>,38,18,[1 5],39,-1,57,-1,39
1,<environment.Job instance at 0x7fe0c4d37a00>,39,18,[9 5],40,-1,58,-1,40
1,<environment.Job instance at 0x7fe0c4d377d0>,40,19,[4 5],41,-1,60,-1,41
1,<environment.Job instance at 0x7fe0c4d372d0>,42,13,[9 4],43,-1,58,-1,45
1,<environment.Job instance at 0x7fe0c4d37410>,46,13,[5 5],47,-1,60,-1,47
1,<environment.Job instance at 0x7fe0c4d37320>,48,16,[8 3],49,-1,65,-1,49
1,<environment.Job instance at 0x7fe0c4f91410>,50,23,[9 4],51,-1,74,-1,51
1,<environment.Job instance at 0x7fe0c4f91a50>,51,21,[8 2],52,-1,73,-1,52
1,<environment.Job instance at 0x7fe0c4f91690>,52,21,[5 7],53,-1,74,-1,53
1,<environment.Job instance at 0x7fe0c4f91e10>,54,17,[9 2],55,-1,72,-1,55
1,<environment.Job instance at 0x7fe0c4f91dc0>,55,18,[5 5],56,-1,74,-1,56
1,<environment.Job instance at 0x7fe0c4f91050>,62,18,[4 7],63,-1,81,-1,63
1,<environment.Job instance at 0x7fe0c4f918c0>,63,18,[7 1],64,-1,82,-1,64
1,<environment.Job instance at 0x7fe0c4f91320>,64,14,[9 1],65,-1,86,-1,72
1,<environment.Job instance at 0x7fe0c496c7d0>,68,17,[12  1],69,-1,93,-1,76
1,<environment.Job instance at 0x7fe0c496cf00>,75,18,[1 8],76,-1,95,-1,77
1,<environment.Job instance at 0x7fe0c496cf50>,77,23,[5 3],78,-1,101,-1,78
1,<environment.Job instance at 0x7fe0c496c550>,78,16,[9 4],79,-1,95,-1,79
1,<environment.Job instance at 0x7fe0c496c730>,79,15,[5 7],80,-1,95,-1,80
1,<environment.Job instance at 0x7fe0c489f6e0>,104,18,[5 6],105,-1,236,-1,218
1,<environment.Job instance at 0x7fe0c4f91870>,7,27,[ 2 11],8,-1,44,-1,17
1,<environment.Job instance at 0x7fe0c4f910a0>,9,3,[11  2],10,-1,20,-1,17
1,<environment.Job instance at 0x7fe0c496caa0>,12,1,[12  5],13,-1,19,-1,18
1,<environment.Job instance at 0x7fe0c4093cd0>,50,23,[9 4],51,-1,184,-1,161
1,<environment.Job instance at 0x7fe0c4a28640>,58,28,[10  4],59,-1,207,-1,179
1,<environment.Job instance at 0x7fe0e92a30f0>,68,17,[12  1],69,-1,228,-1,211
1,<environment.Job instance at 0x7fe0c48b2550>,72,16,[13  1],73,-1,234,-1,218
1,<environment.Job instance at 0x7fe0c49288c0>,70,26,[4 9],71,-1,256,-1,230
1,<environment.Job instance at 0x7fe0c3ef73c0>,77,23,[5 3],78,-1,267,-1,244
1,<environment.Job instance at 0x7fe0c3ef7190>,81,18,[11  2],82,-1,266,-1,248
1,<environment.Job instance at 0x7fe0c3ef7730>,82,12,[ 5 13],83,-1,260,-1,248
1,<environment.Job instance at 0x7fe0c3ef7780>,83,24,[ 5 11],84,-1,272,-1,248
1,<environment.Job instance at 0x7fe0c40cec80>,90,13,[11  2],91,-1,289,-1,276
1,<environment.Job instance at 0x7fe0c3bd62d0>,97,16,[ 3 12],98,-1,324,-1,308
1,<environment.Job instance at 0x7fe0c4300960>,0,16,[ 2 10],1,-1,18,-1,2
1,<environment.Job instance at 0x7fe0c391ec80>,5,18,[ 5 10],6,-1,24,-1,6
1,<environment.Job instance at 0x7fe0c391eb90>,6,25,[6 3],7,-1,32,-1,7
1,<environment.Job instance at 0x7fe0c3907e60>,9,12,[9 4],10,-1,25,-1,13
1,<environment.Job instance at 0x7fe0c39070f0>,17,18,[3 8],18,-1,37,-1,19
1,<environment.Job instance at 0x7fe0c39075f0>,18,16,[7 2],19,-1,35,-1,19
1,<environment.Job instance at 0x7fe0c3907cd0>,21,18,[10  5],22,-1,41,-1,23
1,<environment.Job instance at 0x7fe0c4181fa0>,25,18,[9 2],26,-1,46,-1,28
1,<environment.Job instance at 0x7fe0c4181a50>,27,20,[1 8],28,-1,48,-1,28
1,<environment.Job instance at 0x7fe0c4181c80>,31,21,[4 9],32,-1,53,-1,32
1,<environment.Job instance at 0x7fe0c4c90960>,33,16,[8 1],34,-1,52,-1,36
1,<environment.Job instance at 0x7fe0c4c907d0>,35,23,[8 4],36,-1,59,-1,36
1,<environment.Job instance at 0x7fe0c4c90dc0>,37,20,[5 7],38,-1,58,-1,38
1,<environment.Job instance at 0x7fe0c4c90870>,38,16,[4 8],39,-1,55,-1,39
1,<environment.Job instance at 0x7fe0c4c901e0>,39,18,[6 1],40,-1,58,-1,40
1,<environment.Job instance at 0x7fe0c4c902d0>,40,15,[2 8],41,-1,56,-1,41
1,<environment.Job instance at 0x7fe0c4ca1460>,45,16,[10  5],46,-1,62,-1,46
1,<environment.Job instance at 0x7fe0c4ca1370>,47,16,[1 7],48,-1,64,-1,48
1,<environment.Job instance at 0x7fe0c4ca1690>,49,18,[2 7],50,-1,68,-1,50
1,<environment.Job instance at 0x7fe0c4ca1af0>,53,16,[9 4],54,-1,71,-1,55
1,<environment.Job instance at 0x7fe0c4ad9230>,60,24,[7 2],61,-1,85,-1,61
1,<environment.Job instance at 0x7fe0c4bd2d20>,62,15,[ 2 10],63,-1,78,-1,63
1,<environment.Job instance at 0x7fe0c4bd28c0>,64,17,[8 1],65,-1,82,-1,65
1,<environment.Job instance at 0x7fe0c4bd2320>,66,19,[2 9],67,-1,86,-1,67
1,<environment.Job instance at 0x7fe0c4bd2c80>,68,20,[ 1 10],69,-1,89,-1,69
1,<environment.Job instance at 0x7fe0c38a7780>,69,18,[2 7],70,-1,88,-1,70
1,<environment.Job instance at 0x7fe0c38a7230>,71,18,[3 8],72,-1,90,-1,72
1,<environment.Job instance at 0x7fe0c38f8320>,73,14,[ 4 10],74,-1,88,-1,74
1,<environment.Job instance at 0x7fe0c402d690>,74,15,[4 8],75,-1,90,-1,75
1,<environment.Job instance at 0x7fe0c39c94b0>,79,17,[ 1 10],80,-1,97,-1,80
1,<environment.Job instance at 0x7fe0c42ea690>,81,28,[5 1],82,-1,110,-1,82
1,<environment.Job instance at 0x7fe0c3e116e0>,85,15,[3 5],86,-1,103,-1,88
1,<environment.Job instance at 0x7fe0c3e67f00>,92,13,[9 1],93,-1,106,-1,93
1,<environment.Job instance at 0x7fe0c3e67230>,93,23,[7 4],94,-1,117,-1,94
1,<environment.Job instance at 0x7fe0c46de500>,94,13,[4 8],95,-1,108,-1,95
1,<environment.Job instance at 0x7fe0cdb5ddc0>,97,17,[10  4],98,-1,116,-1,99
1,<environment.Job instance at 0x7fe0c4582280>,101,14,[9 4],102,-1,121,-1,107
1,<environment.Job instance at 0x7fe0c45826e0>,98,18,[13  5],99,-1,125,-1,107
1,<environment.Job instance at 0x7fe0c3ea4aa0>,96,12,[9 5],97,-1,119,-1,107
1,<environment.Job instance at 0x7fe0c45827d0>,102,13,[2 9],103,-1,120,-1,107
1,<environment.Job instance at 0x7fe0c45820a0>,106,27,[5 2],107,-1,134,-1,107
1,<environment.Job instance at 0x7fe0c4c90c30>,6,25,[6 3],7,-1,42,-1,17
1,<environment.Job instance at 0x7fe0c4582f00>,13,2,[14  3],14,-1,22,-1,20
1,<environment.Job instance at 0x7fe0c3ca1d70>,14,1,[14  5],15,-1,21,-1,20
1,<environment.Job instance at 0x7fe0c42f4b40>,23,1,[12  4],24,-1,37,-1,36
1,<environment.Job instance at 0x7fe0c4312500>,30,2,[ 2 12],31,-1,49,-1,47
1,<environment.Job instance at 0x7fe0c4312cd0>,35,23,[8 4],36,-1,92,-1,69
1,<environment.Job instance at 0x7fe0c43190f0>,44,15,[11  1],45,-1,108,-1,93
1,<environment.Job instance at 0x7fe0c48aceb0>,51,20,[ 5 13],52,-1,144,-1,124
1,<environment.Job instance at 0x7fe0c4897230>,60,24,[7 2],61,-1,176,-1,152
1,<environment.Job instance at 0x7fe0c4a15730>,65,15,[ 1 12],66,-1,185,-1,170
1,<environment.Job instance at 0x7fe0c4428eb0>,78,2,[ 1 13],79,-1,222,-1,220
1,<environment.Job instance at 0x7fe0c445fdc0>,80,28,[ 2 14],81,-1,254,-1,226
1,<environment.Job instance at 0x7fe0c445f9b0>,81,28,[5 1],82,-1,262,-1,234
1,<environment.Job instance at 0x7fe0c4db7b90>,93,23,[7 4],94,-1,294,-1,271
1,<environment.Job instance at 0x7fe0c4e8f4b0>,98,18,[13  5],99,-1,305,-1,287
1,<environment.Job instance at 0x7fe0c431b0a0>,103,3,[13  5],104,-1,305,-1,302
1,<environment.Job instance at 0x7fe0c4a5c320>,106,27,[5 2],107,-1,342,-1,315
1,<environment.Job instance at 0x7fe0c4ae3c80>,107,14,[ 3 14],108,-1,329,-1,315
1,<environment.Job instance at 0x7fe0c4d12050>,4,18,[10  2],5,-1,24,-1,6
1,<environment.Job instance at 0x7fe0c4d12dc0>,8,18,[5 8],9,-1,27,-1,9
1,<environment.Job instance at 0x7fe0c4d12b90>,9,17,[2 6],10,-1,27,-1,10
1,<environment.Job instance at 0x7fe0c4d12780>,13,14,[ 5 10],14,-1,28,-1,14
1,<environment.Job instance at 0x7fe0c4d129b0>,14,28,[4 5],15,-1,43,-1,15
1,<environment.Job instance at 0x7fe0c4d12500>,16,17,[3 5],17,-1,34,-1,17
1,<environment.Job instance at 0x7fe0c4fd1870>,18,15,[5 8],19,-1,34,-1,19
1,<environment.Job instance at 0x7fe0c4fd1be0>,21,25,[10  1],22,-1,47,-1,22
1,<environment.Job instance at 0x7fe0c4fd1f00>,22,12,[10  4],23,-1,37,-1,25
1,<environment.Job instance at 0x7fe0c4fd15f0>,25,15,[8 1],26,-1,41,-1,26
1,<environment.Job instance at 0x7fe0c4fd1960>,28,18,[5 5],29,-1,47,-1,29
1,<environment.Job instance at 0x7fe0c4fd1b40>,29,15,[6 2],30,-1,45,-1,30
1,<environment.Job instance at 0x7fe0c4fd1eb0>,30,16,[7 5],31,-1,47,-1,31
1,<environment.Job instance at 0x7fe0c4fd10f0>,31,15,[5 4],32,-1,47,-1,32
1,<environment.Job instance at 0x7fe0c3cf05a0>,32,2,[1 7],33,-1,35,-1,33
1,<environment.Job instance at 0x7fe0c3cf0eb0>,33,17,[5 9],34,-1,51,-1,34
1,<environment.Job instance at 0x7fe0c3cf06e0>,34,17,[2 5],35,-1,52,-1,35
1,<environment.Job instance at 0x7fe0c3cf02d0>,35,21,[9 3],36,-1,57,-1,36
1,<environment.Job instance at 0x7fe0c3cf07d0>,36,15,[3 5],37,-1,52,-1,37
1,<environment.Job instance at 0x7fe0c3cf09b0>,37,25,[9 4],38,-1,63,-1,38
1,<environment.Job instance at 0x7fe0c3cf01e0>,39,14,[5 4],40,-1,54,-1,40
1,<environment.Job instance at 0x7fe0c3cf0aa0>,40,12,[10  1],41,-1,53,-1,41
1,<environment.Job instance at 0x7fe0c3cf0500>,42,16,[9 4],43,-1,59,-1,43
1,<environment.Job instance at 0x7fe0c3cf0320>,43,12,[10  1],44,-1,56,-1,44
1,<environment.Job instance at 0x7fe0c3cf0c80>,44,17,[1 9],45,-1,62,-1,45
1,<environment.Job instance at 0x7fe0c4fd1050>,24,13,[ 5 10],25,-1,59,-1,46
1,<environment.Job instance at 0x7fe0c5015230>,46,18,[8 1],47,-1,68,-1,50
1,<environment.Job instance at 0x7fe0c50150a0>,49,28,[6 1],50,-1,78,-1,50
1,<environment.Job instance at 0x7fe0c5015b90>,56,17,[2 6],57,-1,75,-1,58
1,<environment.Job instance at 0x7fe0c4c1f050>,58,18,[5 3],59,-1,77,-1,59
1,<environment.Job instance at 0x7fe0c4c1f1e0>,61,13,[10  4],62,-1,75,-1,62
1,<environment.Job instance at 0x7fe0c4c1f6e0>,62,15,[8 4],63,-1,78,-1,63
1,<environment.Job instance at 0x7fe0c4c1fb40>,63,24,[5 3],64,-1,88,-1,64
1,<environment.Job instance at 0x7fe0c4c1f500>,64,15,[5 6],65,-1,80,-1,65
1,<environment.Job instance at 0x7fe0c4c1fcd0>,66,17,[2 5],67,-1,84,-1,67
1,<environment.Job instance at 0x7fe0c4d4ab40>,68,12,[9 3],69,-1,81,-1,69
1,<environment.Job instance at 0x7fe0c4d4a550>,69,13,[6 4],70,-1,83,-1,70
1,<environment.Job instance at 0x7fe0c4d4ac80>,71,28,[9 4],72,-1,100,-1,72
1,<environment.Job instance at 0x7fe0c4d4a5f0>,74,12,[9 1],75,-1,88,-1,76
1,<environment.Job instance at 0x7fe0c4d4ae60>,77,17,[1 9],78,-1,95,-1,78
1,<environment.Job instance at 0x7fe0c4d4a780>,79,18,[7 5],80,-1,98,-1,80
1,<environment.Job instance at 0x7fe0c4d4a4b0>,80,17,[10  1],81,-1,99,-1,82
1,<environment.Job instance at 0x7fe0c4d4a0a0>,82,13,[7 2],83,-1,96,-1,83
1,<environment.Job instance at 0x7fe0c3f4d550>,83,3,[8 2],84,-1,87,-1,84
1,<environment.Job instance at 0x7fe0c3f4d780>,84,17,[7 2],85,-1,102,-1,85
1,<environment.Job instance at 0x7fe0c3f4d0a0>,85,3,[5 3],86,-1,89,-1,86
1,<environment.Job instance at 0x7fe0c3f4d6e0>,86,21,[5 5],87,-1,108,-1,87
1,<environment.Job instance at 0x7fe0c3f4d410>,87,3,[1 9],88,-1,91,-1,88
1,<environment.Job instance at 0x7fe0c3f4dd70>,88,13,[4 6],89,-1,102,-1,89
1,<environment.Job instance at 0x7fe0c3f4dbe0>,89,15,[10  2],90,-1,105,-1,90
1,<environment.Job instance at 0x7fe0c3f4deb0>,90,12,[7 4],91,-1,103,-1,91
1,<environment.Job instance at 0x7fe0c3f4d2d0>,93,15,[3 9],94,-1,109,-1,94
1,<environment.Job instance at 0x7fe0c3f4d820>,94,16,[7 4],95,-1,111,-1,95
1,<environment.Job instance at 0x7fe0c3f4dfa0>,98,17,[9 5],99,-1,116,-1,99
1,<environment.Job instance at 0x7fe0c3f4d9b0>,101,18,[4 7],102,-1,120,-1,102
1,<environment.Job instance at 0x7fe0c4dd0d20>,103,17,[9 1],104,-1,121,-1,104
1,<environment.Job instance at 0x7fe0c4dd0640>,104,22,[4 9],105,-1,127,-1,105
1,<environment.Job instance at 0x7fe0c4dd0730>,106,21,[5 5],107,-1,128,-1,107
1,<environment.Job instance at 0x7fe0cdb610f0>,14,28,[4 5],15,-1,55,-1,27
1,<environment.Job instance at 0x7fe0c3c4f140>,17,2,[ 5 13],18,-1,30,-1,28
1,<environment.Job instance at 0x7fe0c3c4f5a0>,21,25,[10  1],22,-1,67,-1,42
1,<environment.Job instance at 0x7fe0c3edec30>,37,25,[9 4],38,-1,138,-1,113
1,<environment.Job instance at 0x7fe0c48ace10>,49,28,[6 1],50,-1,194,-1,166
1,<environment.Job instance at 0x7fe0c4a47410>,52,18,[ 2 12],53,-1,184,-1,166
1,<environment.Job instance at 0x7fe0c3e0e8c0>,63,24,[5 3],64,-1,227,-1,203
1,<environment.Job instance at 0x7fe0c3e0e910>,67,2,[11  4],68,-1,220,-1,218
1,<environment.Job instance at 0x7fe0c4c85960>,71,28,[9 4],72,-1,271,-1,243
1,<environment.Job instance at 0x7fe0c39241e0>,73,16,[ 1 12],74,-1,259,-1,243
1,<environment.Job instance at 0x7fe0c4897230>,78,19,[ 3 11],79,-1,272,-1,253
1,<environment.Job instance at 0x7fe0c42ea9b0>,97,13,[14  4],98,-1,350,-1,337
1,<environment.Job instance at 0x7fe0c4368be0>,4,15,[10  2],5,-1,22,-1,7
1,<environment.Job instance at 0x7fe0c43681e0>,7,15,[6 2],8,-1,23,-1,8
1,<environment.Job instance at 0x7fe0c4368fa0>,8,3,[ 1 10],9,-1,12,-1,9
1,<environment.Job instance at 0x7fe0c4368410>,9,3,[9 3],10,-1,13,-1,10
1,<environment.Job instance at 0x7fe0c431bd20>,5,25,[1 6],6,-1,35,-1,10
1,<environment.Job instance at 0x7fe0c43680f0>,6,1,[5 5],7,-1,13,-1,12
1,<environment.Job instance at 0x7fe0c4b861e0>,11,3,[1 8],12,-1,15,-1,12
1,<environment.Job instance at 0x7fe0c4b86370>,12,20,[ 5 10],13,-1,33,-1,13
1,<environment.Job instance at 0x7fe0c4b867d0>,14,12,[9 1],15,-1,27,-1,15
1,<environment.Job instance at 0x7fe0c4b86b90>,15,24,[8 3],16,-1,40,-1,16
1,<environment.Job instance at 0x7fe0c4b868c0>,16,14,[6 4],17,-1,31,-1,17
1,<environment.Job instance at 0x7fe0e91cedc0>,21,16,[3 9],22,-1,38,-1,22
1,<environment.Job instance at 0x7fe0c4b86730>,20,12,[5 6],21,-1,36,-1,24
1,<environment.Job instance at 0x7fe0c3ede5a0>,25,17,[10  3],26,-1,43,-1,26
1,<environment.Job instance at 0x7fe0c3edee10>,26,18,[6 4],27,-1,45,-1,27
1,<environment.Job instance at 0x7fe0c3ede460>,27,24,[5 9],28,-1,52,-1,28
1,<environment.Job instance at 0x7fe0c3ede410>,31,28,[3 6],32,-1,60,-1,32
1,<environment.Job instance at 0x7fe0c3ede3c0>,32,14,[ 4 10],33,-1,47,-1,33
1,<environment.Job instance at 0x7fe0cdc36f00>,35,16,[7 3],36,-1,52,-1,36
1,<environment.Job instance at 0x7fe0cdc36780>,37,16,[1 8],38,-1,54,-1,38
1,<environment.Job instance at 0x7fe0cdc36be0>,38,2,[4 6],39,-1,41,-1,39
1,<environment.Job instance at 0x7fe0cdc366e0>,39,26,[2 6],40,-1,66,-1,40
1,<environment.Job instance at 0x7fe0cdc36e10>,40,20,[9 3],41,-1,61,-1,41
1,<environment.Job instance at 0x7fe0c470fbe0>,41,15,[8 4],42,-1,57,-1,42
1,<environment.Job instance at 0x7fe0c470fdc0>,42,14,[9 2],43,-1,57,-1,43
1,<environment.Job instance at 0x7fe0c470fb40>,43,16,[2 6],44,-1,60,-1,44
1,<environment.Job instance at 0x7fe0c470f5f0>,45,17,[5 3],46,-1,64,-1,47
1,<environment.Job instance at 0x7fe0c470f6e0>,48,26,[8 2],49,-1,75,-1,49
1,<environment.Job instance at 0x7fe0c4a7bf00>,52,16,[9 2],53,-1,69,-1,53
1,<environment.Job instance at 0x7fe0c4a7b050>,53,18,[4 6],54,-1,72,-1,54
1,<environment.Job instance at 0x7fe0c470faf0>,46,12,[2 7],47,-1,66,-1,54
1,<environment.Job instance at 0x7fe0c4a7b910>,54,13,[2 8],55,-1,68,-1,55
1,<environment.Job instance at 0x7fe0c4a7b550>,59,17,[5 7],60,-1,77,-1,60
1,<environment.Job instance at 0x7fe0c4a7b690>,62,18,[7 4],63,-1,81,-1,63
1,<environment.Job instance at 0x7fe0c442b0f0>,69,15,[3 9],70,-1,85,-1,70
1,<environment.Job instance at 0x7fe0c442b690>,73,16,[3 8],74,-1,91,-1,75
1,<environment.Job instance at 0x7fe0c442b280>,72,14,[ 2 10],73,-1,89,-1,75
1,<environment.Job instance at 0x7fe0c4a7bdc0>,56,17,[3 7],57,-1,92,-1,75
1,<environment.Job instance at 0x7fe0c442b370>,75,19,[1 5],76,-1,96,-1,77
1,<environment.Job instance at 0x7fe0c442ba50>,78,16,[3 8],79,-1,95,-1,79
1,<environment.Job instance at 0x7fe0c442b3c0>,76,13,[5 7],77,-1,96,-1,83
1,<environment.Job instance at 0x7fe0c444abe0>,86,17,[ 5 11],87,-1,104,-1,87
1,<environment.Job instance at 0x7fe0c442b500>,74,13,[10  5],75,-1,104,-1,91
1,<environment.Job instance at 0x7fe0c444a730>,89,16,[10  5],90,-1,107,-1,91
1,<environment.Job instance at 0x7fe0c470fa00>,3,2,[13  2],4,-1,6,-1,4
1,<environment.Job instance at 0x7fe0c4a7bd20>,5,25,[1 6],6,-1,42,-1,17
1,<environment.Job instance at 0x7fe0c42f82d0>,10,27,[11  2],11,-1,44,-1,17
1,<environment.Job instance at 0x7fe0c3b41b90>,15,24,[8 3],16,-1,44,-1,20
1,<environment.Job instance at 0x7fe0cdb64b40>,27,24,[5 9],28,-1,97,-1,73
1,<environment.Job instance at 0x7fe0c43684b0>,31,28,[3 6],32,-1,101,-1,73
1,<environment.Job instance at 0x7fe0cd6a0f00>,39,26,[2 6],40,-1,120,-1,94
1,<environment.Job instance at 0x7fe0c3ede780>,47,1,[ 1 13],48,-1,127,-1,126
1,<environment.Job instance at 0x7fe0c5032550>,48,26,[8 2],49,-1,152,-1,126
1,<environment.Job instance at 0x7fe0c447cf00>,55,25,[ 3 14],56,-1,171,-1,146
1,<environment.Job instance at 0x7fe0c3c4f5a0>,61,3,[ 4 13],62,-1,170,-1,167
1,<environment.Job instance at 0x7fe0c3c4f7d0>,64,27,[13  3],65,-1,210,-1,183
1,<environment.Job instance at 0x7fe0c3e46f00>,84,27,[6 1],85,-1,295,-1,268
1,<environment.Job instance at 0x7fe0c3e46820>,86,17,[ 5 11],87,-1,285,-1,268
1,<environment.Job instance at 0x7fe0c38940a0>,91,24,[14  3],92,-1,307,-1,283
1,<environment.Job instance at 0x7fe0c507b820>,93,24,[10  2],94,-1,323,-1,299
1,<environment.Job instance at 0x7fe0c4524500>,10,17,[9 2],11,-1,28,-1,11
1,<environment.Job instance at 0x7fe0c4524870>,12,14,[7 3],13,-1,27,-1,13
1,<environment.Job instance at 0x7fe0c385e640>,20,26,[6 4],21,-1,47,-1,21
1,<environment.Job instance at 0x7fe0c385e1e0>,23,14,[ 4 10],24,-1,38,-1,24
1,<environment.Job instance at 0x7fe0c385ebe0>,25,14,[5 7],26,-1,40,-1,26
1,<environment.Job instance at 0x7fe0c385ecd0>,26,16,[9 2],27,-1,43,-1,27
1,<environment.Job instance at 0x7fe0c385ee60>,27,21,[9 4],28,-1,49,-1,28
1,<environment.Job instance at 0x7fe0c42ac140>,28,21,[5 1],29,-1,50,-1,29
1,<environment.Job instance at 0x7fe0c474b5a0>,35,16,[4 9],36,-1,52,-1,36
1,<environment.Job instance at 0x7fe0c474b460>,36,18,[5 5],37,-1,55,-1,37
1,<environment.Job instance at 0x7fe0c474baf0>,39,20,[5 9],40,-1,60,-1,40
1,<environment.Job instance at 0x7fe0c4389b40>,40,17,[ 5 10],41,-1,58,-1,41
1,<environment.Job instance at 0x7fe0c43890f0>,41,14,[10  1],42,-1,57,-1,43
1,<environment.Job instance at 0x7fe0c4389690>,49,2,[6 1],50,-1,52,-1,50
1,<environment.Job instance at 0x7fe0c46181e0>,50,2,[6 1],51,-1,53,-1,51
1,<environment.Job instance at 0x7fe0c4618190>,52,18,[3 7],53,-1,71,-1,53
1,<environment.Job instance at 0x7fe0c4618a50>,53,12,[5 4],54,-1,66,-1,54
1,<environment.Job instance at 0x7fe0c4618140>,54,1,[13  5],55,-1,56,-1,55
1,<environment.Job instance at 0x7fe0c4618500>,55,13,[9 1],56,-1,69,-1,56
1,<environment.Job instance at 0x7fe0c4618410>,57,15,[3 6],58,-1,73,-1,58
1,<environment.Job instance at 0x7fe0c4618b40>,58,14,[ 1 10],59,-1,73,-1,59
1,<environment.Job instance at 0x7fe0c4667dc0>,60,25,[5 3],61,-1,86,-1,61
1,<environment.Job instance at 0x7fe0c4c7ce10>,66,13,[8 1],67,-1,80,-1,67
1,<environment.Job instance at 0x7fe0c3935e60>,68,16,[10  3],69,-1,85,-1,69
1,<environment.Job instance at 0x7fe0c3935c30>,69,28,[3 9],70,-1,98,-1,70
1,<environment.Job instance at 0x7fe0cd652b40>,72,23,[3 7],73,-1,96,-1,73
1,<environment.Job instance at 0x7fe0c404bc80>,74,17,[2 7],75,-1,92,-1,75
1,<environment.Job instance at 0x7fe0c3a32410>,77,16,[5 4],78,-1,94,-1,78
1,<environment.Job instance at 0x7fe0c457bb90>,78,17,[6 5],79,-1,96,-1,79
1,<environment.Job instance at 0x7fe0c4389780>,42,18,[3 8],43,-1,112,-1,94
1,<environment.Job instance at 0x7fe0c379d230>,90,15,[1 8],91,-1,109,-1,94
1,<environment.Job instance at 0x7fe0c3e3feb0>,82,17,[6 4],83,-1,112,-1,95
1,<environment.Job instance at 0x7fe0cd9b3690>,92,18,[2 5],93,-1,113,-1,95
1,<environment.Job instance at 0x7fe0c45a2320>,91,16,[5 5],92,-1,111,-1,95
1,<environment.Job instance at 0x7fe0c46fea00>,5,27,[4 5],6,-1,122,-1,95
1,<environment.Job instance at 0x7fe0cd9b3c30>,94,14,[ 3 10],95,-1,109,-1,95
1,<environment.Job instance at 0x7fe0c4524730>,0,13,[12  1],1,-1,14,-1,1
1,<environment.Job instance at 0x7fe0c4524e60>,1,16,[ 5 11],2,-1,18,-1,2
1,<environment.Job instance at 0x7fe0c4389500>,5,27,[4 5],6,-1,34,-1,7
1,<environment.Job instance at 0x7fe0c4cab870>,6,1,[12  2],7,-1,8,-1,7
1,<environment.Job instance at 0x7fe0cdc2f190>,16,25,[7 3],17,-1,45,-1,20
1,<environment.Job instance at 0x7fe0c40b8780>,20,26,[6 4],21,-1,52,-1,26
1,<environment.Job instance at 0x7fe0c3ea6c80>,54,1,[13  5],55,-1,124,-1,123
1,<environment.Job instance at 0x7fe0c44f7820>,60,25,[5 3],61,-1,180,-1,155
1,<environment.Job instance at 0x7fe0c4370550>,61,16,[11  2],62,-1,171,-1,155
1,<environment.Job instance at 0x7fe0c4afe140>,69,28,[3 9],70,-1,219,-1,191
1,<environment.Job instance at 0x7fe0c4afe4b0>,72,23,[3 7],73,-1,215,-1,192
1,<environment.Job instance at 0x7fe0c3d2eeb0>,76,3,[ 5 14],77,-1,200,-1,197
1,<environment.Job instance at 0x7fe0c4adfb90>,87,16,[11  1],88,-1,256,-1,240
1,<environment.Job instance at 0x7fe0c4ff40a0>,97,16,[ 5 13],98,-1,294,-1,278
1,<environment.Job instance at 0x7fe0c4652b40>,99,2,[13  4],100,-1,281,-1,279
1,<environment.Job instance at 0x7fe0c401d280>,103,20,[ 5 12],104,-1,301,-1,281
1,<environment.Job instance at 0x7fe0c401d460>,104,2,[ 5 11],105,-1,283,-1,281
1,<environment.Job instance at 0x7fe0c5010b90>,6,16,[5 6],7,-1,23,-1,7
1,<environment.Job instance at 0x7fe0c5010e10>,11,16,[4 6],12,-1,28,-1,12
1,<environment.Job instance at 0x7fe0c4ff5b90>,17,15,[10  4],18,-1,34,-1,19
1,<environment.Job instance at 0x7fe0c4ff5820>,18,16,[ 5 10],19,-1,36,-1,20
1,<environment.Job instance at 0x7fe0c3b13690>,25,13,[5 4],26,-1,39,-1,26
1,<environment.Job instance at 0x7fe0c3b13140>,27,15,[2 6],28,-1,44,-1,29
1,<environment.Job instance at 0x7fe0c3b13730>,29,18,[10  2],30,-1,48,-1,30
1,<environment.Job instance at 0x7fe0c3b13500>,30,13,[2 8],31,-1,44,-1,31
1,<environment.Job instance at 0x7fe0c3b13960>,28,18,[ 5 10],29,-1,50,-1,32
1,<environment.Job instance at 0x7fe0c3b135f0>,32,22,[8 1],33,-1,56,-1,34
1,<environment.Job instance at 0x7fe0c3b13dc0>,33,14,[14  4],34,-1,48,-1,34
1,<environment.Job instance at 0x7fe0c3b0a1e0>,38,16,[9 1],39,-1,58,-1,42
1,<environment.Job instance at 0x7fe0c4fe5cd0>,41,27,[8 5],42,-1,70,-1,43
1,<environment.Job instance at 0x7fe0c4fe50f0>,49,14,[2 8],50,-1,64,-1,50
1,<environment.Job instance at 0x7fe0c3b0aa00>,37,15,[ 5 12],38,-1,73,-1,58
1,<environment.Job instance at 0x7fe0c4fe5af0>,44,16,[11  4],45,-1,75,-1,59
1,<environment.Job instance at 0x7fe0c4fe5410>,52,18,[10  5],53,-1,93,-1,75
1,<environment.Job instance at 0x7fe0c4fe5230>,48,16,[13  2],49,-1,91,-1,75
1,<environment.Job instance at 0x7fe0c4ff5230>,16,16,[13  1],17,-1,91,-1,75
1,<environment.Job instance at 0x7fe0c4fe55f0>,45,14,[1 7],46,-1,90,-1,76
1,<environment.Job instance at 0x7fe0c5014c30>,58,12,[ 1 10],59,-1,89,-1,77
1,<environment.Job instance at 0x7fe0c5014cd0>,55,18,[5 6],56,-1,99,-1,81
1,<environment.Job instance at 0x7fe0c50143c0>,59,1,[7 1],60,-1,82,-1,81
1,<environment.Job instance at 0x7fe0c50146e0>,63,13,[3 9],64,-1,94,-1,81
1,<environment.Job instance at 0x7fe0c5014a00>,62,18,[9 1],63,-1,101,-1,83
1,<environment.Job instance at 0x7fe0c5014320>,60,3,[5 1],61,-1,86,-1,83
1,<environment.Job instance at 0x7fe0c50144b0>,64,15,[2 7],65,-1,98,-1,83
1,<environment.Job instance at 0x7fe0c50141e0>,67,3,[1 8],68,-1,87,-1,84
1,<environment.Job instance at 0x7fe0c50142d0>,65,3,[6 4],66,-1,87,-1,84
1,<environment.Job instance at 0x7fe0c4ffbf50>,70,12,[4 6],71,-1,96,-1,84
1,<environment.Job instance at 0x7fe0c4ffb230>,69,12,[5 8],70,-1,97,-1,85
1,<environment.Job instance at 0x7fe0c4ffbd70>,72,18,[1 9],73,-1,104,-1,86
1,<environment.Job instance at 0x7fe0c4ffbeb0>,73,2,[2 6],74,-1,88,-1,86
1,<environment.Job instance at 0x7fe0c4ffba50>,74,18,[7 1],75,-1,104,-1,86
1,<environment.Job instance at 0x7fe0c4ffb870>,78,15,[3 8],79,-1,102,-1,87
1,<environment.Job instance at 0x7fe0c4ffb410>,79,25,[3 6],80,-1,113,-1,88
1,<environment.Job instance at 0x7fe0c4fe5050>,54,17,[10  5],55,-1,105,-1,88
1,<environment.Job instance at 0x7fe0c5013320>,80,13,[5 8],81,-1,101,-1,88
1,<environment.Job instance at 0x7fe0c5013f50>,83,17,[13  5],84,-1,105,-1,88
1,<environment.Job instance at 0x7fe0c5013960>,84,17,[8 5],85,-1,109,-1,92
1,<environment.Job instance at 0x7fe0c50138c0>,85,17,[1 7],86,-1,109,-1,92
1,<environment.Job instance at 0x7fe0c50136e0>,86,16,[1 5],87,-1,108,-1,92
1,<environment.Job instance at 0x7fe0c50131e0>,89,19,[2 5],90,-1,112,-1,93
1,<environment.Job instance at 0x7fe0c4ffe0a0>,91,12,[7 2],92,-1,105,-1,93
1,<environment.Job instance at 0x7fe0c4ffe8c0>,94,18,[ 4 10],95,-1,116,-1,98
1,<environment.Job instance at 0x7fe0c4ffe870>,96,15,[ 3 10],97,-1,113,-1,98
1,<environment.Job instance at 0x7fe0c5013140>,88,13,[10  4],89,-1,112,-1,99
1,<environment.Job instance at 0x7fe0c4ffe1e0>,98,13,[6 2],99,-1,118,-1,105
1,<environment.Job instance at 0x7fe0c4513410>,103,18,[9 2],104,-1,127,-1,109
1,<environment.Job instance at 0x7fe0c4513460>,104,15,[6 2],105,-1,125,-1,110
1,<environment.Job instance at 0x7fe0c4513910>,106,16,[5 9],107,-1,126,-1,110
1,<environment.Job instance at 0x7fe0c45136e0>,108,24,[5 6],109,-1,134,-1,110
1,<environment.Job instance at 0x7fe0c3b0a9b0>,1,2,[ 5 11],2,-1,4,-1,2
1,<environment.Job instance at 0x7fe0c423f730>,9,13,[ 4 14],10,-1,23,-1,10
1,<environment.Job instance at 0x7fe0c4acf140>,16,16,[13  1],17,-1,39,-1,23
1,<environment.Job instance at 0x7fe0c37c5140>,26,27,[2 9],27,-1,80,-1,53
1,<environment.Job instance at 0x7fe0cdb5f190>,33,14,[14  4],34,-1,99,-1,85
1,<environment.Job instance at 0x7fe0c3db5c30>,35,3,[ 1 13],36,-1,88,-1,85
1,<environment.Job instance at 0x7fe0c4454c80>,36,2,[14  2],37,-1,87,-1,85
1,<environment.Job instance at 0x7fe0c4670be0>,37,15,[ 5 12],38,-1,100,-1,85
1,<environment.Job instance at 0x7fe0c4e2cd20>,40,2,[14  4],41,-1,103,-1,101
1,<environment.Job instance at 0x7fe0c4e2ceb0>,41,27,[8 5],42,-1,130,-1,103
1,<environment.Job instance at 0x7fe0c445fe60>,44,16,[11  4],45,-1,119,-1,103
1,<environment.Job instance at 0x7fe0c37270f0>,48,16,[13  2],49,-1,125,-1,109
1,<environment.Job instance at 0x7fe0c3bb9e60>,51,14,[ 2 12],52,-1,137,-1,123
1,<environment.Job instance at 0x7fe0cd6514b0>,53,26,[7 1],54,-1,168,-1,142
1,<environment.Job instance at 0x7fe0c3aa4230>,79,25,[3 6],80,-1,256,-1,231
1,<environment.Job instance at 0x7fe0c3aa45a0>,81,16,[ 5 12],82,-1,255,-1,239
1,<environment.Job instance at 0x7fe0c4422190>,83,17,[13  5],84,-1,260,-1,243
1,<environment.Job instance at 0x7fe0c4509c80>,95,2,[ 3 11],96,-1,293,-1,291
1,<environment.Job instance at 0x7fe0c4548be0>,102,3,[ 4 11],103,-1,316,-1,313
1,<environment.Job instance at 0x7fe0c4bb7780>,108,24,[5 6],109,-1,367,-1,343
1,<environment.Job instance at 0x7fe0c5032b40>,1,17,[5 8],2,-1,19,-1,2
1,<environment.Job instance at 0x7fe0c5032d70>,8,12,[10  3],9,-1,22,-1,10
1,<environment.Job instance at 0x7fe0c5032230>,10,20,[ 4 10],11,-1,31,-1,11
1,<environment.Job instance at 0x7fe0cd9b3910>,9,13,[10  4],10,-1,24,-1,11
1,<environment.Job instance at 0x7fe0c50320a0>,13,14,[ 4 10],14,-1,30,-1,16
1,<environment.Job instance at 0x7fe0c50323c0>,16,24,[4 5],17,-1,41,-1,17
1,<environment.Job instance at 0x7fe0c5032140>,17,24,[4 8],18,-1,42,-1,18
1,<environment.Job instance at 0x7fe0c4891aa0>,26,16,[4 9],27,-1,43,-1,27
1,<environment.Job instance at 0x7fe0c48915a0>,27,18,[6 1],28,-1,46,-1,28
1,<environment.Job instance at 0x7fe0c48912d0>,28,14,[5 4],29,-1,43,-1,29
1,<environment.Job instance at 0x7fe0c4891780>,29,15,[6 4],30,-1,45,-1,30
1,<environment.Job instance at 0x7fe0c4891410>,32,23,[6 2],33,-1,56,-1,33
1,<environment.Job instance at 0x7fe0c44b5dc0>,36,17,[1 6],37,-1,54,-1,37
1,<environment.Job instance at 0x7fe0c44b56e0>,42,18,[6 5],43,-1,61,-1,43
1,<environment.Job instance at 0x7fe0c44b59b0>,44,14,[ 5 10],45,-1,59,-1,45
1,<environment.Job instance at 0x7fe0c4a83640>,46,16,[4 8],47,-1,63,-1,47
1,<environment.Job instance at 0x7fe0c4a83fa0>,47,15,[4 8],48,-1,82,-1,67
1,<environment.Job instance at 0x7fe0c4d34c30>,78,18,[10  4],79,-1,174,-1,156
1,<environment.Job instance at 0x7fe0c45dc140>,80,25,[5 5],81,-1,194,-1,169
1,<environment.Job instance at 0x7fe0c4891320>,0,3,[ 3 12],1,-1,4,-1,1
1,<environment.Job instance at 0x7fe0c48915f0>,2,14,[14  5],3,-1,17,-1,3
1,<environment.Job instance at 0x7fe0c48ac500>,16,24,[4 5],17,-1,61,-1,37
1,<environment.Job instance at 0x7fe0c48acaf0>,17,24,[4 8],18,-1,61,-1,37
1,<environment.Job instance at 0x7fe0c50325f0>,32,23,[6 2],33,-1,109,-1,86
1,<environment.Job instance at 0x7fe0c5032d20>,34,3,[ 1 12],35,-1,89,-1,86
1,<environment.Job instance at 0x7fe0c4509050>,35,14,[12  1],36,-1,100,-1,86
1,<environment.Job instance at 0x7fe0c3bb4280>,43,1,[11  3],44,-1,106,-1,105
1,<environment.Job instance at 0x7fe0c4422d70>,45,28,[ 4 12],46,-1,134,-1,106
1,<environment.Job instance at 0x7fe0c3aa45a0>,49,1,[ 4 13],50,-1,123,-1,122
1,<environment.Job instance at 0x7fe0c502ad70>,53,14,[ 2 11],54,-1,151,-1,137
1,<environment.Job instance at 0x7fe0c3bb95a0>,65,24,[5 2],66,-1,217,-1,193
1,<environment.Job instance at 0x7fe0c3727a00>,70,25,[6 2],71,-1,246,-1,221
1,<environment.Job instance at 0x7fe0c37c5140>,79,13,[ 1 11],80,-1,250,-1,237
1,<environment.Job instance at 0x7fe0c37c54b0>,80,25,[5 5],81,-1,271,-1,246
1,<environment.Job instance at 0x7fe0c4db0640>,83,3,[ 4 11],84,-1,254,-1,251
1,<environment.Job instance at 0x7fe0c4fe5aa0>,98,16,[14  4],99,-1,328,-1,312
1,<environment.Job instance at 0x7fe0c42f8280>,107,27,[8 5],108,-1,376,-1,349
1,<environment.Job instance at 0x7fe0c48c80a0>,5,15,[10  1],6,-1,23,-1,8
1,<environment.Job instance at 0x7fe0cd9fa960>,10,20,[8 5],11,-1,31,-1,11
1,<environment.Job instance at 0x7fe0cd66ac30>,14,16,[5 8],15,-1,31,-1,15
1,<environment.Job instance at 0x7fe0cd66afa0>,15,25,[4 5],16,-1,41,-1,16
1,<environment.Job instance at 0x7fe0cdc2d960>,20,18,[3 5],21,-1,39,-1,21
1,<environment.Job instance at 0x7fe0cd6818c0>,21,15,[3 7],22,-1,37,-1,22
1,<environment.Job instance at 0x7fe0c4c075a0>,36,13,[6 4],37,-1,51,-1,38
1,<environment.Job instance at 0x7fe0c4c079b0>,37,26,[ 3 10],38,-1,65,-1,39
1,<environment.Job instance at 0x7fe0c4c07fa0>,39,12,[5 8],40,-1,72,-1,60
1,<environment.Job instance at 0x7fe0cd681be0>,32,18,[4 8],33,-1,79,-1,61
1,<environment.Job instance at 0x7fe0cd69e0a0>,51,17,[7 4],52,-1,78,-1,61
1,<environment.Job instance at 0x7fe0cd69eb90>,52,1,[7 4],53,-1,62,-1,61
1,<environment.Job instance at 0x7fe0cd69ec30>,53,14,[ 5 10],54,-1,75,-1,61
1,<environment.Job instance at 0x7fe0c4c073c0>,33,15,[ 2 10],34,-1,80,-1,65
1,<environment.Job instance at 0x7fe0c4beb0f0>,55,13,[7 4],56,-1,78,-1,65
1,<environment.Job instance at 0x7fe0c45a1f50>,60,15,[5 5],61,-1,80,-1,65
1,<environment.Job instance at 0x7fe0c4577410>,62,17,[5 7],63,-1,82,-1,65
1,<environment.Job instance at 0x7fe0c41845f0>,56,16,[3 8],57,-1,85,-1,69
1,<environment.Job instance at 0x7fe0c4e46730>,64,12,[7 1],65,-1,81,-1,69
1,<environment.Job instance at 0x7fe0c3994640>,70,18,[9 3],71,-1,89,-1,71
1,<environment.Job instance at 0x7fe0c3cf7af0>,71,17,[9 4],72,-1,91,-1,74
1,<environment.Job instance at 0x7fe0c3cf7910>,73,14,[14  1],74,-1,89,-1,75
1,<environment.Job instance at 0x7fe0c3cf72d0>,76,17,[4 8],77,-1,94,-1,77
1,<environment.Job instance at 0x7fe0c3cf7690>,77,14,[5 6],78,-1,92,-1,78
1,<environment.Job instance at 0x7fe0c3cf77d0>,78,16,[8 4],79,-1,95,-1,79
1,<environment.Job instance at 0x7fe0c3cf7c30>,79,17,[5 6],80,-1,97,-1,80
1,<environment.Job instance at 0x7fe0c3cf7050>,80,15,[3 7],81,-1,96,-1,81
1,<environment.Job instance at 0x7fe0c3d1d190>,87,13,[7 1],88,-1,101,-1,88
1,<environment.Job instance at 0x7fe0c3d1d9b0>,84,13,[10  1],85,-1,102,-1,89
1,<environment.Job instance at 0x7fe0c41df3c0>,90,12,[3 8],91,-1,103,-1,91
1,<environment.Job instance at 0x7fe0c41df7d0>,91,18,[7 1],92,-1,110,-1,92
1,<environment.Job instance at 0x7fe0c41df0f0>,93,15,[ 2 12],94,-1,109,-1,94
1,<environment.Job instance at 0x7fe0c3d1d370>,86,15,[4 6],87,-1,118,-1,103
1,<environment.Job instance at 0x7fe0c3d160a0>,101,26,[7 2],102,-1,129,-1,103
1,<environment.Job instance at 0x7fe0c3d16fa0>,96,14,[6 2],97,-1,117,-1,103
1,<environment.Job instance at 0x7fe0c3d16a50>,99,14,[7 3],100,-1,117,-1,103
1,<environment.Job instance at 0x7fe0c41adb90>,95,16,[3 5],96,-1,122,-1,106
1,<environment.Job instance at 0x7fe0c3d79870>,100,14,[8 2],101,-1,120,-1,106
1,<environment.Job instance at 0x7fe0c3ce4a50>,104,18,[4 8],105,-1,125,-1,107
1,<environment.Job instance at 0x7fe0cd681a00>,3,17,[13  3],4,-1,21,-1,4
1,<environment.Job instance at 0x7fe0cd69e5a0>,4,3,[13  1],5,-1,8,-1,5
1,<environment.Job instance at 0x7fe0c4945eb0>,15,25,[4 5],16,-1,48,-1,23
1,<environment.Job instance at 0x7fe0c3e09460>,18,1,[ 4 14],19,-1,24,-1,23
1,<environment.Job instance at 0x7fe0c375a320>,30,2,[13  2],31,-1,54,-1,52
1,<environment.Job instance at 0x7fe0c4c861e0>,34,1,[12  5],35,-1,67,-1,66
1,<environment.Job instance at 0x7fe0c4958550>,37,26,[ 3 10],38,-1,98,-1,72
1,<environment.Job instance at 0x7fe0c3743500>,41,3,[12  2],42,-1,90,-1,87
1,<environment.Job instance at 0x7fe0c493a640>,54,3,[14  3],55,-1,113,-1,110
1,<environment.Job instance at 0x7fe0c4fa7be0>,66,1,[11  3],67,-1,157,-1,156
1,<environment.Job instance at 0x7fe0c45d9230>,73,14,[14  1],74,-1,191,-1,177
1,<environment.Job instance at 0x7fe0c45c4410>,82,17,[ 5 14],83,-1,234,-1,217
1,<environment.Job instance at 0x7fe0c496f4b0>,93,15,[ 2 12],94,-1,267,-1,252
1,<environment.Job instance at 0x7fe0c496f640>,98,2,[13  1],99,-1,281,-1,279
1,<environment.Job instance at 0x7fe0c45c60a0>,101,26,[7 2],102,-1,316,-1,290
1,<environment.Job instance at 0x7fe0c49fbcd0>,1,23,[5 9],2,-1,25,-1,2
1,<environment.Job instance at 0x7fe0c49fb5f0>,7,22,[2 9],8,-1,31,-1,9
1,<environment.Job instance at 0x7fe0c4c62be0>,11,16,[5 2],12,-1,28,-1,12
1,<environment.Job instance at 0x7fe0c4c629b0>,13,15,[ 3 10],14,-1,29,-1,14
1,<environment.Job instance at 0x7fe0c4c625a0>,15,14,[7 5],16,-1,30,-1,16
1,<environment.Job instance at 0x7fe0c4c620f0>,16,20,[8 2],17,-1,37,-1,17
1,<environment.Job instance at 0x7fe0c4c62230>,17,16,[8 4],18,-1,34,-1,18
1,<environment.Job instance at 0x7fe0c3e17960>,18,26,[2 5],19,-1,45,-1,19
1,<environment.Job instance at 0x7fe0c3e17280>,20,15,[10  5],21,-1,36,-1,21
1,<environment.Job instance at 0x7fe0c3e17d20>,23,12,[8 2],24,-1,39,-1,27
1,<environment.Job instance at 0x7fe0c3e17550>,27,12,[ 2 12],28,-1,40,-1,28
1,<environment.Job instance at 0x7fe0c4c508c0>,29,20,[ 3 11],30,-1,50,-1,30
1,<environment.Job instance at 0x7fe0c4c50cd0>,31,16,[8 4],32,-1,48,-1,32
1,<environment.Job instance at 0x7fe0c4c50af0>,35,15,[9 1],36,-1,51,-1,36
1,<environment.Job instance at 0x7fe0c4c505f0>,37,16,[8 4],38,-1,54,-1,38
1,<environment.Job instance at 0x7fe0c375a410>,43,13,[10  3],44,-1,57,-1,44
1,<environment.Job instance at 0x7fe0c375a7d0>,47,14,[4 7],48,-1,62,-1,48
1,<environment.Job instance at 0x7fe0c4609b90>,50,12,[9 4],51,-1,63,-1,51
1,<environment.Job instance at 0x7fe0c46096e0>,51,23,[1 8],52,-1,75,-1,52
1,<environment.Job instance at 0x7fe0c4609af0>,52,14,[3 7],53,-1,67,-1,53
1,<environment.Job instance at 0x7fe0c4609a00>,53,16,[ 5 10],54,-1,70,-1,54
1,<environment.Job instance at 0x7fe0c4609640>,54,17,[3 5],55,-1,72,-1,55
1,<environment.Job instance at 0x7fe0c4609eb0>,55,15,[ 1 10],56,-1,71,-1,56
1,<environment.Job instance at 0x7fe0c4609280>,56,13,[ 5 11],57,-1,70,-1,57
1,<environment.Job instance at 0x7fe0c4609fa0>,61,13,[5 8],62,-1,75,-1,62
1,<environment.Job instance at 0x7fe0c4a0b8c0>,66,25,[8 1],67,-1,92,-1,67
1,<environment.Job instance at 0x7fe0c4a0b3c0>,67,18,[ 1 10],68,-1,86,-1,68
1,<environment.Job instance at 0x7fe0c4a0ba50>,73,16,[9 5],74,-1,90,-1,74
1,<environment.Job instance at 0x7fe0c4a0b640>,74,28,[7 4],75,-1,103,-1,75
1,<environment.Job instance at 0x7fe0c461ff00>,75,20,[7 2],76,-1,96,-1,76
1,<environment.Job instance at 0x7fe0c461fbe0>,76,14,[10  3],77,-1,91,-1,77
1,<environment.Job instance at 0x7fe0c461f2d0>,77,17,[5 6],78,-1,95,-1,78
1,<environment.Job instance at 0x7fe0c461f1e0>,79,17,[5 2],80,-1,97,-1,80
1,<environment.Job instance at 0x7fe0c461f6e0>,81,17,[9 3],82,-1,102,-1,85
1,<environment.Job instance at 0x7fe0c461fb40>,84,19,[1 8],85,-1,104,-1,85
1,<environment.Job instance at 0x7fe0c461fe60>,86,17,[8 4],87,-1,104,-1,87
1,<environment.Job instance at 0x7fe0c3e17230>,26,24,[2 9],27,-1,115,-1,91
1,<environment.Job instance at 0x7fe0c461fa50>,88,12,[ 1 10],89,-1,107,-1,95
1,<environment.Job instance at 0x7fe0c45aad20>,95,20,[5 5],96,-1,116,-1,96
1,<environment.Job instance at 0x7fe0c4115b90>,96,18,[7 3],97,-1,115,-1,97
1,<environment.Job instance at 0x7fe0c40f7690>,100,16,[ 2 10],101,-1,119,-1,103
1,<environment.Job instance at 0x7fe0c45cec80>,104,2,[5 2],105,-1,107,-1,105
1,<environment.Job instance at 0x7fe0c40f7fa0>,101,18,[3 9],102,-1,123,-1,105
1,<environment.Job instance at 0x7fe0c461fc30>,90,13,[8 4],91,-1,118,-1,105
1,<environment.Job instance at 0x7fe0c45c2c80>,103,15,[1 5],104,-1,120,-1,105
1,<environment.Job instance at 0x7fe0c4609230>,1,23,[5 9],2,-1,25,-1,2
1,<environment.Job instance at 0x7fe0c40f6230>,3,3,[ 1 14],4,-1,7,-1,4
1,<environment.Job instance at 0x7fe0c4609c30>,6,1,[ 3 13],7,-1,8,-1,7
1,<environment.Job instance at 0x7fe0c45e6a50>,18,26,[2 5],19,-1,60,-1,34
1,<environment.Job instance at 0x7fe0c4a31320>,27,12,[ 2 12],28,-1,77,-1,65
1,<environment.Job instance at 0x7fe0c4c62140>,28,14,[13  4],29,-1,79,-1,65
1,<environment.Job instance at 0x7fe0c4c62550>,29,20,[ 3 11],30,-1,85,-1,65
1,<environment.Job instance at 0x7fe0c4a31370>,26,24,[2 9],27,-1,100,-1,76
1,<environment.Job instance at 0x7fe0c5019730>,46,1,[ 3 11],47,-1,102,-1,101
1,<environment.Job instance at 0x7fe0c3d79f00>,51,23,[1 8],52,-1,143,-1,120
1,<environment.Job instance at 0x7fe0c41a4640>,56,13,[ 5 11],57,-1,156,-1,143
1,<environment.Job instance at 0x7fe0c3f7a5a0>,66,25,[8 1],67,-1,213,-1,188
1,<environment.Job instance at 0x7fe0c3cd9d70>,74,28,[7 4],75,-1,226,-1,198
1,<environment.Job instance at 0x7fe0c5036280>,97,13,[14  1],98,-1,289,-1,276
1,<environment.Job instance at 0x7fe0c45a15a0>,106,2,[14  1],107,-1,321,-1,319
1,<environment.Job instance at 0x7fe0c45aaaf0>,1,25,[1 6],2,-1,27,-1,2
1,<environment.Job instance at 0x7fe0c4eb6e10>,9,15,[9 1],10,-1,26,-1,11
1,<environment.Job instance at 0x7fe0c4eb6c30>,11,15,[10  4],12,-1,27,-1,12
1,<environment.Job instance at 0x7fe0c4e8d230>,14,13,[ 5 11],15,-1,28,-1,15
1,<environment.Job instance at 0x7fe0c45ce050>,10,12,[10  4],11,-1,28,-1,16
1,<environment.Job instance at 0x7fe0c4eb6eb0>,16,14,[9 2],17,-1,32,-1,18
1,<environment.Job instance at 0x7fe0c4e8d190>,17,28,[7 2],18,-1,46,-1,18
1,<environment.Job instance at 0x7fe0c4e8d870>,24,21,[10  5],25,-1,47,-1,26
1,<environment.Job instance at 0x7fe0c4e8daa0>,25,17,[9 3],26,-1,43,-1,26
1,<environment.Job instance at 0x7fe0c4e8dc30>,27,20,[10  2],28,-1,57,-1,37
1,<environment.Job instance at 0x7fe0c4eab820>,37,27,[9 4],38,-1,65,-1,38
1,<environment.Job instance at 0x7fe0c4eab910>,39,15,[5 5],40,-1,55,-1,40
1,<environment.Job instance at 0x7fe0c4eabaa0>,40,15,[2 8],41,-1,56,-1,41
1,<environment.Job instance at 0x7fe0c4eabb90>,42,18,[2 5],43,-1,61,-1,43
1,<environment.Job instance at 0x7fe0c4eabc80>,44,15,[10  1],45,-1,60,-1,45
1,<environment.Job instance at 0x7fe0c4eabdc0>,45,15,[8 4],46,-1,61,-1,46
1,<environment.Job instance at 0x7fe0c4e950a0>,48,17,[13  5],49,-1,70,-1,53
1,<environment.Job instance at 0x7fe0c4e95190>,49,17,[5 4],50,-1,70,-1,53
1,<environment.Job instance at 0x7fe0c4e95370>,51,12,[2 8],52,-1,65,-1,53
1,<environment.Job instance at 0x7fe0c4e8d5a0>,22,26,[9 1],23,-1,86,-1,60
1,<environment.Job instance at 0x7fe0c4eb69b0>,5,24,[4 7],6,-1,85,-1,61
1,<environment.Job instance at 0x7fe0c4e95780>,55,16,[3 8],56,-1,77,-1,61
1,<environment.Job instance at 0x7fe0c4e95730>,54,18,[9 3],55,-1,79,-1,61
1,<environment.Job instance at 0x7fe0c4e95550>,52,15,[10  3],53,-1,76,-1,61
1,<environment.Job instance at 0x7fe0c49fb3c0>,60,14,[1 7],61,-1,75,-1,61
1,<environment.Job instance at 0x7fe0c4ea9960>,62,13,[13  5],63,-1,76,-1,63
1,<environment.Job instance at 0x7fe0c4a1b2d0>,64,14,[5 6],65,-1,81,-1,67
1,<environment.Job instance at 0x7fe0c4ea91e0>,67,17,[ 5 10],68,-1,87,-1,70
1,<environment.Job instance at 0x7fe0c4ea9050>,68,21,[2 5],69,-1,92,-1,71
1,<environment.Job instance at 0x7fe0c5098be0>,70,15,[3 7],71,-1,86,-1,71
1,<environment.Job instance at 0x7fe0c4ea9a50>,69,23,[5 7],70,-1,94,-1,71
1,<environment.Job instance at 0x7fe0c424ebe0>,74,14,[5 3],75,-1,91,-1,77
1,<environment.Job instance at 0x7fe0c424ec30>,77,19,[ 2 10],78,-1,97,-1,78
1,<environment.Job instance at 0x7fe0c39251e0>,81,18,[9 3],82,-1,100,-1,82
1,<environment.Job instance at 0x7fe0c5095e10>,86,14,[9 3],87,-1,103,-1,89
1,<environment.Job instance at 0x7fe0c4e95280>,50,16,[1 6],51,-1,106,-1,90
1,<environment.Job instance at 0x7fe0c50593c0>,89,14,[1 8],90,-1,106,-1,92
1,<environment.Job instance at 0x7fe0c5059a50>,88,18,[7 1],89,-1,111,-1,93
1,<environment.Job instance at 0x7fe0c424ed70>,76,12,[14  2],77,-1,105,-1,93
1,<environment.Job instance at 0x7fe0c4e95870>,56,14,[6 2],57,-1,107,-1,93
1,<environment.Job instance at 0x7fe0c4ea9370>,73,25,[ 1 10],74,-1,123,-1,98
1,<environment.Job instance at 0x7fe0c5059eb0>,93,13,[10  4],94,-1,111,-1,98
1,<environment.Job instance at 0x7fe0c5082fa0>,97,15,[8 5],98,-1,113,-1,98
1,<environment.Job instance at 0x7fe0c4232280>,99,21,[7 2],100,-1,121,-1,100
1,<environment.Job instance at 0x7fe0c5059960>,91,12,[4 6],92,-1,113,-1,101
1,<environment.Job instance at 0x7fe0c4232960>,102,16,[8 1],103,-1,119,-1,103
1,<environment.Job instance at 0x7fe0c42320f0>,103,14,[6 1],104,-1,118,-1,104
1,<environment.Job instance at 0x7fe0c4e8d730>,1,25,[1 6],2,-1,27,-1,2
1,<environment.Job instance at 0x7fe0c4e8dc80>,2,12,[12  2],3,-1,15,-1,3
1,<environment.Job instance at 0x7fe0c4eab0f0>,3,26,[10  4],4,-1,30,-1,4
1,<environment.Job instance at 0x7fe0c4eab640>,5,24,[4 7],6,-1,30,-1,6
1,<environment.Job instance at 0x7fe0c4ea9410>,14,13,[ 5 11],15,-1,35,-1,22
1,<environment.Job instance at 0x7fe0c4eb6690>,19,27,[ 3 10],20,-1,57,-1,30
1,<environment.Job instance at 0x7fe0c5059b40>,17,28,[7 2],18,-1,62,-1,34
1,<environment.Job instance at 0x7fe0c4eb6c80>,22,26,[9 1],23,-1,60,-1,34
1,<environment.Job instance at 0x7fe0c5036910>,26,3,[ 2 14],27,-1,38,-1,35
1,<environment.Job instance at 0x7fe0c466f230>,37,27,[9 4],38,-1,93,-1,66
1,<environment.Job instance at 0x7fe0c3cd9500>,48,17,[13  5],49,-1,119,-1,102
1,<environment.Job instance at 0x7fe0c41a4e60>,62,13,[13  5],63,-1,183,-1,170
1,<environment.Job instance at 0x7fe0c41b87d0>,65,2,[ 2 12],66,-1,174,-1,172
1,<environment.Job instance at 0x7fe0c4d16960>,69,23,[5 7],70,-1,209,-1,186
1,<environment.Job instance at 0x7fe0c3d1d870>,73,25,[ 1 10],74,-1,226,-1,201
1,<environment.Job instance at 0x7fe0c4c5cb40>,76,12,[14  2],77,-1,213,-1,201
1,<environment.Job instance at 0x7fe0c3e17e60>,78,1,[ 5 14],79,-1,202,-1,201
1,<environment.Job instance at 0x7fe0c4a0bc80>,90,12,[ 1 13],91,-1,260,-1,248
1,<environment.Job instance at 0x7fe0c45e6190>,95,2,[11  4],96,-1,267,-1,265
1,<environment.Job instance at 0x7fe0c45cee10>,104,14,[ 1 12],105,-1,310,-1,296
1,<environment.Job instance at 0x7fe0c45cec30>,106,23,[ 5 12],107,-1,322,-1,299
1,<environment.Job instance at 0x7fe0c3ec76e0>,5,12,[10  3],6,-1,19,-1,7
1,<environment.Job instance at 0x7fe0c4570550>,9,14,[2 5],10,-1,24,-1,10
1,<environment.Job instance at 0x7fe0c4570eb0>,10,12,[4 5],11,-1,23,-1,11
1,<environment.Job instance at 0x7fe0c4570dc0>,11,16,[1 5],12,-1,28,-1,12
1,<environment.Job instance at 0x7fe0c45705f0>,12,18,[1 5],13,-1,31,-1,13
1,<environment.Job instance at 0x7fe0c45701e0>,13,15,[2 8],14,-1,29,-1,14
1,<environment.Job instance at 0x7fe0c3ec7910>,6,16,[1 7],7,-1,30,-1,14
1,<environment.Job instance at 0x7fe0c4570370>,17,13,[ 5 10],18,-1,32,-1,19
1,<environment.Job instance at 0x7fe0c38b0460>,19,3,[9 3],20,-1,23,-1,20
1,<environment.Job instance at 0x7fe0c38b07d0>,20,25,[6 2],21,-1,46,-1,21
1,<environment.Job instance at 0x7fe0c38b0c80>,21,2,[5 2],22,-1,24,-1,22
1,<environment.Job instance at 0x7fe0c4570cd0>,18,16,[6 5],19,-1,39,-1,23
1,<environment.Job instance at 0x7fe0c38b0d70>,24,21,[5 2],25,-1,46,-1,25
1,<environment.Job instance at 0x7fe0c46176e0>,27,16,[1 7],28,-1,44,-1,28
1,<environment.Job instance at 0x7fe0c4617af0>,30,16,[5 9],31,-1,47,-1,31
1,<environment.Job instance at 0x7fe0c46177d0>,32,14,[10  5],33,-1,49,-1,35
1,<environment.Job instance at 0x7fe0c4617500>,36,18,[1 8],37,-1,55,-1,37
1,<environment.Job instance at 0x7fe0c4014550>,37,27,[4 8],38,-1,65,-1,38
1,<environment.Job instance at 0x7fe0c4617320>,40,15,[8 5],41,-1,67,-1,52
1,<environment.Job instance at 0x7fe0c40140a0>,48,18,[6 4],49,-1,70,-1,52
1,<environment.Job instance at 0x7fe0c3e32730>,52,15,[9 5],53,-1,68,-1,53
1,<environment.Job instance at 0x7fe0c3e32dc0>,59,13,[9 3],60,-1,73,-1,60
1,<environment.Job instance at 0x7fe0c4014c30>,43,15,[5 3],44,-1,75,-1,60
1,<environment.Job instance at 0x7fe0c40145f0>,38,20,[ 4 13],39,-1,80,-1,60
1,<environment.Job instance at 0x7fe0c3e32550>,56,18,[4 9],57,-1,86,-1,68
1,<environment.Job instance at 0x7fe0c3e32230>,62,16,[8 1],63,-1,85,-1,69
1,<environment.Job instance at 0x7fe0c3d0feb0>,69,17,[3 5],70,-1,87,-1,70
1,<environment.Job instance at 0x7fe0c3d0fcd0>,70,17,[5 8],71,-1,88,-1,71
1,<environment.Job instance at 0x7fe0c3d0f1e0>,71,14,[7 5],72,-1,86,-1,72
1,<environment.Job instance at 0x7fe0c3d0f320>,66,16,[2 7],67,-1,90,-1,74
1,<environment.Job instance at 0x7fe0c3e4e730>,74,18,[6 5],75,-1,95,-1,77
1,<environment.Job instance at 0x7fe0c3e4e550>,79,16,[5 5],80,-1,107,-1,91
1,<environment.Job instance at 0x7fe0c3e4e780>,76,17,[5 1],77,-1,108,-1,91
1,<environment.Job instance at 0x7fe0c3e4ef50>,85,18,[4 9],86,-1,109,-1,91
1,<environment.Job instance at 0x7fe0c3e4e9b0>,86,14,[8 5],87,-1,105,-1,91
1,<environment.Job instance at 0x7fe0c43832d0>,88,18,[6 5],89,-1,109,-1,91
1,<environment.Job instance at 0x7fe0c3e32820>,63,18,[ 5 13],64,-1,110,-1,92
1,<environment.Job instance at 0x7fe0c3e4eb40>,83,13,[2 7],84,-1,105,-1,92
1,<environment.Job instance at 0x7fe0c43830f0>,93,18,[6 1],94,-1,112,-1,94
1,<environment.Job instance at 0x7fe0c4383e10>,94,16,[1 6],95,-1,111,-1,95
1,<environment.Job instance at 0x7fe0c4383c80>,95,16,[10  1],96,-1,112,-1,96
1,<environment.Job instance at 0x7fe0c38b09b0>,2,1,[ 4 11],3,-1,4,-1,3
1,<environment.Job instance at 0x7fe0c3d0fd70>,14,3,[ 1 12],15,-1,33,-1,30
1,<environment.Job instance at 0x7fe0c3e4e320>,20,25,[6 2],21,-1,78,-1,53
1,<environment.Job instance at 0x7fe0c4383500>,22,3,[14  1],23,-1,56,-1,53
1,<environment.Job instance at 0x7fe0c40f6230>,23,1,[ 4 12],24,-1,54,-1,53
1,<environment.Job instance at 0x7fe0c45e6f00>,31,18,[14  2],32,-1,87,-1,69
1,<environment.Job instance at 0x7fe0c4a0be10>,35,15,[12  5],36,-1,101,-1,86
1,<environment.Job instance at 0x7fe0c4a31320>,37,27,[4 8],38,-1,133,-1,106
1,<environment.Job instance at 0x7fe0c4c960f0>,38,20,[ 4 13],39,-1,126,-1,106
1,<environment.Job instance at 0x7fe0cd63a9b0>,63,18,[ 5 13],64,-1,191,-1,173
1,<environment.Job instance at 0x7fe0c4eab960>,97,14,[ 3 12],98,-1,317,-1,303
1,<environment.Job instance at 0x7fe0c3d3a690>,105,23,[7 3],106,-1,350,-1,327
1,<environment.Job instance at 0x7fe0c43fa5f0>,1,16,[1 7],2,-1,18,-1,2
1,<environment.Job instance at 0x7fe0c47a59b0>,8,18,[5 9],9,-1,27,-1,9
1,<environment.Job instance at 0x7fe0c47a5dc0>,9,16,[8 4],10,-1,29,-1,13
1,<environment.Job instance at 0x7fe0c47a5eb0>,13,16,[5 9],14,-1,30,-1,14
1,<environment.Job instance at 0x7fe0c36e9780>,14,16,[3 5],15,-1,31,-1,15
1,<environment.Job instance at 0x7fe0c36e9820>,15,15,[ 3 10],16,-1,31,-1,16
1,<environment.Job instance at 0x7fe0c47a5870>,12,16,[4 7],13,-1,37,-1,21
1,<environment.Job instance at 0x7fe0c3a822d0>,25,15,[8 3],26,-1,43,-1,28
1,<environment.Job instance at 0x7fe0c3a82870>,27,13,[9 2],28,-1,42,-1,29
1,<environment.Job instance at 0x7fe0c477a0a0>,35,18,[6 4],36,-1,54,-1,36
1,<environment.Job instance at 0x7fe0c477a690>,37,22,[6 4],38,-1,60,-1,38
1,<environment.Job instance at 0x7fe0c4415410>,40,15,[4 9],41,-1,56,-1,41
1,<environment.Job instance at 0x7fe0c3b66960>,43,2,[10  3],44,-1,58,-1,56
1,<environment.Job instance at 0x7fe0c4f17230>,48,12,[14  5],49,-1,69,-1,57
1,<environment.Job instance at 0x7fe0c47b9b90>,47,18,[3 7],48,-1,77,-1,59
1,<environment.Job instance at 0x7fe0c3b66370>,51,17,[7 1],52,-1,76,-1,59
1,<environment.Job instance at 0x7fe0c477a050>,33,14,[5 9],34,-1,75,-1,61
1,<environment.Job instance at 0x7fe0c3b66870>,44,17,[9 5],45,-1,84,-1,67
1,<environment.Job instance at 0x7fe0c3b66730>,49,2,[5 2],50,-1,69,-1,67
1,<environment.Job instance at 0x7fe0c4111140>,56,14,[2 9],57,-1,81,-1,67
1,<environment.Job instance at 0x7fe0c4e8faa0>,54,18,[ 2 10],55,-1,85,-1,67
1,<environment.Job instance at 0x7fe0c477aaa0>,36,15,[ 1 11],37,-1,107,-1,92
1,<environment.Job instance at 0x7fe0c4e8fa50>,55,19,[10  1],56,-1,111,-1,92
1,<environment.Job instance at 0x7fe0c46ae640>,61,17,[8 4],62,-1,109,-1,92
1,<environment.Job instance at 0x7fe0c4c6bb90>,67,20,[5 3],68,-1,113,-1,93
1,<environment.Job instance at 0x7fe0c3e36e60>,63,18,[10  4],64,-1,111,-1,93
1,<environment.Job instance at 0x7fe0c447c370>,69,13,[6 5],70,-1,106,-1,93
1,<environment.Job instance at 0x7fe0c447c140>,71,16,[ 2 10],72,-1,109,-1,93
1,<environment.Job instance at 0x7fe0c46aed20>,62,15,[1 9],63,-1,108,-1,93
1,<environment.Job instance at 0x7fe0c4c6b960>,68,3,[9 1],69,-1,96,-1,93
1,<environment.Job instance at 0x7fe0c447c460>,73,16,[1 9],74,-1,109,-1,93
1,<environment.Job instance at 0x7fe0c447cc30>,75,15,[2 8],76,-1,108,-1,93
1,<environment.Job instance at 0x7fe0c4b059b0>,76,17,[13  4],77,-1,110,-1,93
1,<environment.Job instance at 0x7fe0c447c230>,74,1,[4 6],75,-1,94,-1,93
1,<environment.Job instance at 0x7fe0c447c820>,70,16,[10  2],71,-1,109,-1,93
1,<environment.Job instance at 0x7fe0c4359b40>,79,17,[ 1 11],80,-1,110,-1,93
1,<environment.Job instance at 0x7fe0c447c5a0>,72,3,[3 8],73,-1,96,-1,93
1,<environment.Job instance at 0x7fe0c400b280>,81,13,[8 2],82,-1,106,-1,93
1,<environment.Job instance at 0x7fe0c400b9b0>,82,15,[6 2],83,-1,108,-1,93
1,<environment.Job instance at 0x7fe0c400bd20>,80,17,[1 7],81,-1,110,-1,93
1,<environment.Job instance at 0x7fe0c3709af0>,84,17,[12  2],85,-1,110,-1,93
1,<environment.Job instance at 0x7fe0c3709410>,85,16,[2 9],86,-1,109,-1,93
1,<environment.Job instance at 0x7fe0c396bb90>,83,1,[6 3],84,-1,94,-1,93
1,<environment.Job instance at 0x7fe0c37099b0>,86,12,[7 4],87,-1,105,-1,93
1,<environment.Job instance at 0x7fe0c3709280>,87,3,[6 1],88,-1,96,-1,93
1,<environment.Job instance at 0x7fe0c3708320>,89,13,[ 1 10],90,-1,106,-1,93
1,<environment.Job instance at 0x7fe0c4313c30>,90,1,[9 2],91,-1,94,-1,93
1,<environment.Job instance at 0x7fe0c4313eb0>,91,2,[1 9],92,-1,95,-1,93
1,<environment.Job instance at 0x7fe0c45030a0>,92,1,[ 1 11],93,-1,94,-1,93
1,<environment.Job instance at 0x7fe0c45038c0>,93,3,[9 3],94,-1,97,-1,94
1,<environment.Job instance at 0x7fe0c4503370>,94,12,[ 3 12],95,-1,107,-1,95
1,<environment.Job instance at 0x7fe0c3708f50>,88,1,[1 6],89,-1,96,-1,95
1,<environment.Job instance at 0x7fe0c4503410>,95,17,[14  3],96,-1,113,-1,96
1,<environment.Job instance at 0x7fe0c4387410>,96,12,[9 1],97,-1,109,-1,97
1,<environment.Job instance at 0x7fe0c4359190>,78,13,[7 4],79,-1,110,-1,97
1,<environment.Job instance at 0x7fe0c38090a0>,102,24,[7 2],103,-1,129,-1,105
1,<environment.Job instance at 0x7fe0c4ec8d20>,104,27,[5 1],105,-1,132,-1,105
1,<environment.Job instance at 0x7fe0c4015f00>,2,18,[ 3 13],3,-1,21,-1,3
1,<environment.Job instance at 0x7fe0cd63a460>,26,3,[12  4],27,-1,74,-1,71
1,<environment.Job instance at 0x7fe0c3d8f2d0>,22,26,[9 3],23,-1,103,-1,77
1,<environment.Job instance at 0x7fe0c375a320>,36,15,[ 1 11],37,-1,118,-1,103
1,<environment.Job instance at 0x7fe0c3e32280>,48,12,[14  5],49,-1,160,-1,148
1,<environment.Job instance at 0x7fe0c4068730>,58,23,[1 5],59,-1,220,-1,197
1,<environment.Job instance at 0x7fe0c4068050>,59,2,[12  2],60,-1,199,-1,197
1,<environment.Job instance at 0x7fe0c3ae8780>,76,17,[13  4],77,-1,277,-1,260
1,<environment.Job instance at 0x7fe0c3ae8370>,79,17,[ 1 11],80,-1,285,-1,268
1,<environment.Job instance at 0x7fe0c3ae8140>,84,17,[12  2],85,-1,308,-1,291
1,<environment.Job instance at 0x7fe0c4842820>,92,1,[ 1 11],93,-1,310,-1,309
1,<environment.Job instance at 0x7fe0c4842eb0>,94,12,[ 3 12],95,-1,333,-1,321
1,<environment.Job instance at 0x7fe0c48427d0>,95,17,[14  3],96,-1,338,-1,321
1,<environment.Job instance at 0x7fe0c4842280>,97,24,[1 8],98,-1,363,-1,339
1,<environment.Job instance at 0x7fe0c41d6b40>,102,24,[7 2],103,-1,366,-1,342
1,<environment.Job instance at 0x7fe0c41d6a50>,104,27,[5 1],105,-1,378,-1,351
1,<environment.Job instance at 0x7fe0c41d6e10>,105,1,[ 5 12],106,-1,352,-1,351
1,<environment.Job instance at 0x7fe0c41d6c30>,108,3,[13  2],109,-1,358,-1,355
1,<environment.Job instance at 0x7fe0c4505a50>,1,18,[5 6],2,-1,20,-1,2
1,<environment.Job instance at 0x7fe0c4e6f780>,5,16,[6 5],6,-1,22,-1,6
1,<environment.Job instance at 0x7fe0c4e6f410>,7,18,[3 8],8,-1,26,-1,8
1,<environment.Job instance at 0x7fe0c45ccb90>,12,16,[3 7],13,-1,29,-1,13
1,<environment.Job instance at 0x7fe0c50321e0>,13,15,[9 4],14,-1,29,-1,14
1,<environment.Job instance at 0x7fe0c4414730>,16,14,[7 3],17,-1,31,-1,17
1,<environment.Job instance at 0x7fe0c44147d0>,17,18,[2 8],18,-1,36,-1,18
1,<environment.Job instance at 0x7fe0cd629230>,21,14,[1 8],22,-1,36,-1,22
1,<environment.Job instance at 0x7fe0c415daf0>,22,16,[6 4],23,-1,39,-1,23
1,<environment.Job instance at 0x7fe0c415d5f0>,23,12,[10  2],24,-1,36,-1,24
1,<environment.Job instance at 0x7fe0c415d730>,25,27,[1 5],26,-1,53,-1,26
1,<environment.Job instance at 0x7fe0c4411dc0>,26,18,[ 2 10],27,-1,45,-1,27
1,<environment.Job instance at 0x7fe0c4f67dc0>,30,15,[8 4],31,-1,46,-1,31
1,<environment.Job instance at 0x7fe0c440d5a0>,31,18,[7 3],32,-1,50,-1,32
1,<environment.Job instance at 0x7fe0c4bf55f0>,32,17,[1 7],33,-1,50,-1,33
1,<environment.Job instance at 0x7fe0c46553c0>,35,12,[8 1],36,-1,50,-1,38
1,<environment.Job instance at 0x7fe0c464adc0>,38,12,[10  1],39,-1,51,-1,39
1,<environment.Job instance at 0x7fe0c464afa0>,39,12,[4 6],40,-1,52,-1,40
1,<environment.Job instance at 0x7fe0c464aaf0>,40,17,[5 2],41,-1,58,-1,41
1,<environment.Job instance at 0x7fe0c464a280>,41,21,[8 4],42,-1,63,-1,42
1,<environment.Job instance at 0x7fe0c464ac80>,42,16,[1 7],43,-1,59,-1,43
1,<environment.Job instance at 0x7fe0c48cb190>,45,18,[4 5],46,-1,64,-1,46
1,<environment.Job instance at 0x7fe0c48cb050>,46,12,[2 8],47,-1,59,-1,47
1,<environment.Job instance at 0x7fe0c48cbd70>,47,18,[2 7],48,-1,66,-1,48
1,<environment.Job instance at 0x7fe0c466b7d0>,50,15,[6 1],51,-1,66,-1,51
1,<environment.Job instance at 0x7fe0c466b870>,54,20,[8 2],55,-1,75,-1,55
1,<environment.Job instance at 0x7fe0c466be10>,55,14,[4 9],56,-1,70,-1,56
1,<environment.Job instance at 0x7fe0c3865e60>,37,15,[ 3 10],38,-1,71,-1,56
1,<environment.Job instance at 0x7fe0c48e7230>,60,21,[10  5],61,-1,84,-1,63
1,<environment.Job instance at 0x7fe0c48e7730>,64,12,[9 5],65,-1,79,-1,67
1,<environment.Job instance at 0x7fe0c48e78c0>,66,2,[9 2],67,-1,74,-1,72
1,<environment.Job instance at 0x7fe0c48c4190>,72,16,[9 2],73,-1,90,-1,74
1,<environment.Job instance at 0x7fe0c48c45a0>,78,12,[ 4 10],79,-1,91,-1,79
1,<environment.Job instance at 0x7fe0c48c47d0>,81,15,[9 3],82,-1,98,-1,83
1,<environment.Job instance at 0x7fe0c48c4960>,84,24,[7 3],85,-1,109,-1,85
1,<environment.Job instance at 0x7fe0c48c4b90>,85,13,[7 2],86,-1,99,-1,86
1,<environment.Job instance at 0x7fe0c48c4b40>,86,21,[5 3],87,-1,108,-1,87
1,<environment.Job instance at 0x7fe0c48c4d70>,87,22,[1 9],88,-1,110,-1,88
1,<environment.Job instance at 0x7fe0c48c4e10>,88,16,[1 7],89,-1,105,-1,89
1,<environment.Job instance at 0x7fe0c48c4f50>,90,12,[10  5],91,-1,103,-1,91
1,<environment.Job instance at 0x7fe0c48f70f0>,91,16,[10  1],92,-1,108,-1,92
1,<environment.Job instance at 0x7fe0c48f7230>,93,17,[8 3],94,-1,111,-1,94
1,<environment.Job instance at 0x7fe0c48f7640>,97,15,[5 5],98,-1,113,-1,98
1,<environment.Job instance at 0x7fe0c48f76e0>,102,24,[5 7],103,-1,127,-1,103
1,<environment.Job instance at 0x7fe0c48f7fa0>,106,15,[ 1 10],107,-1,122,-1,107
1,<environment.Job instance at 0x7fe0c466ba50>,10,3,[13  5],11,-1,14,-1,11
1,<environment.Job instance at 0x7fe0c48e7640>,15,3,[14  3],16,-1,39,-1,36
1,<environment.Job instance at 0x7fe0c48f7d70>,25,27,[1 5],26,-1,110,-1,83
1,<environment.Job instance at 0x7fe0c41d6b40>,29,3,[13  3],30,-1,89,-1,86
1,<environment.Job instance at 0x7fe0c4068640>,65,1,[ 3 11],66,-1,205,-1,204
1,<environment.Job instance at 0x7fe0c3d0f500>,76,23,[ 1 13],77,-1,249,-1,226
1,<environment.Job instance at 0x7fe0c3d0f2d0>,77,2,[ 2 11],78,-1,228,-1,226
1,<environment.Job instance at 0x7fe0c3e4e190>,84,24,[7 3],85,-1,272,-1,248
1,<environment.Job instance at 0x7fe0c375a230>,94,19,[ 5 12],95,-1,307,-1,288
1,<environment.Job instance at 0x7fe0cd63ac30>,95,27,[2 8],96,-1,328,-1,301
1,<environment.Job instance at 0x7fe0cd63abe0>,99,1,[ 4 13],100,-1,304,-1,303
1,<environment.Job instance at 0x7fe0c46534b0>,102,24,[5 7],103,-1,332,-1,308
1,<environment.Job instance at 0x7feca42a36e0>,0,18,[ 2 10],1,-1,20,-1,2
1,<environment.Job instance at 0x7fec9acb3a50>,3,18,[ 3 10],4,-1,22,-1,4
1,<environment.Job instance at 0x7fec9acb3be0>,4,18,[10  4],5,-1,23,-1,5
1,<environment.Job instance at 0x7fec9acb3af0>,5,13,[5 9],6,-1,19,-1,6
1,<environment.Job instance at 0x7fec9acb3c80>,6,12,[11  4],7,-1,19,-1,7
1,<environment.Job instance at 0x7fec9acb3dc0>,8,17,[ 2 10],9,-1,26,-1,9
1,<environment.Job instance at 0x7fec9acb3f00>,9,17,[ 4 10],10,-1,27,-1,10
1,<environment.Job instance at 0x7feca42a38c0>,1,15,[ 1 14],2,-1,28,-1,13
1,<environment.Job instance at 0x7fec9acb6730>,18,16,[8 5],19,-1,35,-1,19
1,<environment.Job instance at 0x7fec9acb6c30>,23,18,[5 2],24,-1,42,-1,24
1,<environment.Job instance at 0x7fec9acb6f50>,26,22,[2 9],27,-1,49,-1,27
1,<environment.Job instance at 0x7fec9acb9280>,29,13,[1 6],30,-1,43,-1,30
1,<environment.Job instance at 0x7fec9acb9370>,31,17,[4 9],32,-1,49,-1,32
1,<environment.Job instance at 0x7fec9acb94b0>,32,17,[9 3],33,-1,50,-1,33
1,<environment.Job instance at 0x7fec9acb9c80>,38,12,[3 6],39,-1,52,-1,40
1,<environment.Job instance at 0x7fec9acb9e10>,40,1,[1 8],41,-1,42,-1,41
1,<environment.Job instance at 0x7fec9acb9e60>,41,14,[6 1],42,-1,56,-1,42
1,<environment.Job instance at 0x7fec9acb9f00>,42,14,[8 4],43,-1,57,-1,43
1,<environment.Job instance at 0x7fec9acb9fa0>,43,28,[6 4],44,-1,72,-1,44
1,<environment.Job instance at 0x7fec9acbb0a0>,44,17,[ 5 12],45,-1,62,-1,45
1,<environment.Job instance at 0x7fec9acbb140>,45,16,[6 2],46,-1,62,-1,46
1,<environment.Job instance at 0x7fec9acbb280>,47,1,[2 6],48,-1,49,-1,48
1,<environment.Job instance at 0x7fec9acb9b40>,39,18,[5 8],40,-1,66,-1,48
1,<environment.Job instance at 0x7fec9acbb870>,55,17,[4 7],56,-1,73,-1,56
1,<environment.Job instance at 0x7fec9acbbc80>,56,18,[4 5],57,-1,75,-1,57
1,<environment.Job instance at 0x7fec9acbbeb0>,59,14,[ 2 10],60,-1,75,-1,61
1,<environment.Job instance at 0x7fec9acbd140>,62,20,[9 1],63,-1,83,-1,63
1,<environment.Job instance at 0x7fec9acbd280>,63,15,[1 5],64,-1,79,-1,64
1,<environment.Job instance at 0x7fec9acbd3c0>,65,13,[3 5],66,-1,79,-1,66
1,<environment.Job instance at 0x7fec9acbd4b0>,67,26,[5 4],68,-1,94,-1,68
1,<environment.Job instance at 0x7fec9acbd730>,68,22,[5 6],69,-1,91,-1,69
1,<environment.Job instance at 0x7fec9acbd5f0>,69,13,[7 2],70,-1,83,-1,70
1,<environment.Job instance at 0x7fec9acbd820>,70,18,[5 5],71,-1,89,-1,71
1,<environment.Job instance at 0x7fec9acbd960>,72,14,[9 1],73,-1,87,-1,73
1,<environment.Job instance at 0x7fec9acbd780>,74,1,[6 2],75,-1,76,-1,75
1,<environment.Job instance at 0x7fec9acbdcd0>,75,3,[6 4],76,-1,79,-1,76
1,<environment.Job instance at 0x7fec9acbdaf0>,76,13,[1 5],77,-1,90,-1,77
1,<environment.Job instance at 0x7fec9acbbaa0>,60,24,[ 3 10],61,-1,101,-1,77
1,<environment.Job instance at 0x7fec9acbde60>,78,19,[8 4],79,-1,99,-1,80
1,<environment.Job instance at 0x7fec9acc1af0>,91,16,[5 8],92,-1,108,-1,92
1,<environment.Job instance at 0x7fec9acb6370>,1,15,[ 1 14],2,-1,17,-1,2
1,<environment.Job instance at 0x7fec9acb97d0>,6,12,[11  4],7,-1,19,-1,7
1,<environment.Job instance at 0x7fec9add4a50>,19,17,[12  3],20,-1,67,-1,50
1,<environment.Job instance at 0x7fec9acdb2d0>,22,2,[12  3],23,-1,62,-1,60
1,<environment.Job instance at 0x7fec9acd6500>,43,28,[6 4],44,-1,166,-1,138
1,<environment.Job instance at 0x7fec9acd6d70>,44,17,[ 5 12],45,-1,155,-1,138
1,<environment.Job instance at 0x7fec9ad630a0>,50,27,[9 1],51,-1,179,-1,152
1,<environment.Job instance at 0x7fec9ad63910>,52,3,[ 3 11],53,-1,155,-1,152
1,<environment.Job instance at 0x7fec9adc01e0>,53,18,[ 4 12],54,-1,170,-1,152
1,<environment.Job instance at 0x7fec9add2c80>,60,24,[ 3 10],61,-1,209,-1,185
1,<environment.Job instance at 0x7fec9ad62e10>,67,26,[5 4],68,-1,226,-1,200
1,<environment.Job instance at 0x7fec9ace72d0>,81,17,[ 4 14],82,-1,256,-1,239
1,<environment.Job instance at 0x7fec9aceeaf0>,85,19,[14  4],86,-1,260,-1,241
1,<environment.Job instance at 0x7fec9ac96280>,95,23,[3 7],96,-1,294,-1,271
1,<environment.Job instance at 0x7fec9acff5a0>,102,27,[ 3 13],103,-1,316,-1,289
1,<environment.Job instance at 0x7fec9ac8af50>,111,18,[ 3 13],112,-1,333,-1,315
1,<environment.Job instance at 0x7fec9ac9bcd0>,117,18,[ 3 12],118,-1,348,-1,330
1,<environment.Job instance at 0x7fec9a401050>,10,16,[9 3],11,-1,31,-1,15
1,<environment.Job instance at 0x7fec9a3f6370>,16,18,[1 6],17,-1,35,-1,17
1,<environment.Job instance at 0x7fec9a3f6280>,20,17,[3 8],21,-1,38,-1,21
1,<environment.Job instance at 0x7fec9a3ff4b0>,23,16,[6 4],24,-1,71,-1,55
1,<environment.Job instance at 0x7fec9a4de320>,31,16,[1 9],32,-1,72,-1,56
1,<environment.Job instance at 0x7fec9a401410>,14,15,[10  5],15,-1,71,-1,56
1,<environment.Job instance at 0x7fec9a4deb40>,37,17,[3 8],38,-1,73,-1,56
1,<environment.Job instance at 0x7fec9a4dea50>,38,16,[3 9],39,-1,73,-1,57
1,<environment.Job instance at 0x7fec9a5398c0>,40,12,[6 3],41,-1,70,-1,58
1,<environment.Job instance at 0x7fec9a4c9b40>,43,15,[4 8],44,-1,73,-1,58
1,<environment.Job instance at 0x7fec9a2834b0>,46,22,[11  3],47,-1,82,-1,60
1,<environment.Job instance at 0x7fec9a27d910>,48,18,[4 6],49,-1,88,-1,70
1,<environment.Job instance at 0x7fec9a27d5f0>,49,16,[3 5],50,-1,87,-1,71
1,<environment.Job instance at 0x7fec9a3f6b90>,15,15,[ 3 14],16,-1,86,-1,71
1,<environment.Job instance at 0x7fec9a402460>,59,23,[2 8],60,-1,133,-1,110
1,<environment.Job instance at 0x7fec9a3d6320>,68,14,[8 5],69,-1,124,-1,110
1,<environment.Job instance at 0x7fec9a2b62d0>,69,17,[9 2],70,-1,127,-1,110
1,<environment.Job instance at 0x7fec9a2dc640>,65,17,[10  5],66,-1,127,-1,110
1,<environment.Job instance at 0x7fec9a4013c0>,70,18,[5 1],71,-1,128,-1,110
1,<environment.Job instance at 0x7fec9a24f410>,74,17,[10  5],75,-1,129,-1,112
1,<environment.Job instance at 0x7fec9a24f5f0>,75,16,[ 3 10],76,-1,128,-1,112
1,<environment.Job instance at 0x7fec9a24faa0>,76,23,[5 8],77,-1,135,-1,112
1,<environment.Job instance at 0x7fec9a401dc0>,72,14,[8 4],73,-1,132,-1,118
1,<environment.Job instance at 0x7fec9a24f050>,83,27,[5 3],84,-1,147,-1,120
1,<environment.Job instance at 0x7fec9a2eaaa0>,58,14,[4 7],59,-1,134,-1,120
1,<environment.Job instance at 0x7fec9a3fef50>,84,17,[10  2],85,-1,137,-1,120
1,<environment.Job instance at 0x7fec9a24e050>,92,17,[10  4],93,-1,149,-1,132
1,<environment.Job instance at 0x7fec9a24ee10>,90,17,[2 9],91,-1,162,-1,145
1,<environment.Job instance at 0x7fec9a24ec30>,1,18,[11  5],2,-1,20,-1,2
1,<environment.Job instance at 0x7fec9a2637d0>,2,14,[14  1],3,-1,17,-1,3
1,<environment.Job instance at 0x7feca4411230>,15,15,[ 3 14],16,-1,39,-1,24
1,<environment.Job instance at 0x7fec9a24b8c0>,17,12,[14  5],18,-1,37,-1,25
1,<environment.Job instance at 0x7fec9a478640>,46,22,[11  3],47,-1,157,-1,135
1,<environment.Job instance at 0x7fec9a477a50>,55,25,[3 9],56,-1,217,-1,192
1,<environment.Job instance at 0x7fec9a4a9dc0>,59,23,[2 8],60,-1,216,-1,193
1,<environment.Job instance at 0x7fec9a47d460>,66,26,[9 1],67,-1,251,-1,225
1,<environment.Job instance at 0x7fec9a4748c0>,76,23,[5 8],77,-1,284,-1,261
1,<environment.Job instance at 0x7fec9a5f2050>,81,2,[12  1],82,-1,268,-1,266
1,<environment.Job instance at 0x7fec9a652f50>,83,27,[5 3],84,-1,306,-1,279
1,<environment.Job instance at 0x7fec9a41a320>,89,3,[ 4 12],90,-1,297,-1,294
1,<environment.Job instance at 0x7fec9a601230>,91,18,[ 5 11],92,-1,312,-1,294
1,<environment.Job instance at 0x7fec9a4515a0>,98,28,[7 4],99,-1,371,-1,343
1,<environment.Job instance at 0x7fec9a451460>,104,28,[9 1],105,-1,392,-1,364
1,<environment.Job instance at 0x7fec9a4f6e60>,108,16,[14  3],109,-1,380,-1,364
1,<environment.Job instance at 0x7fec9a2ac8c0>,0,28,[7 3],1,-1,29,-1,1
1,<environment.Job instance at 0x7fec9a2acf00>,1,16,[7 4],2,-1,18,-1,2
1,<environment.Job instance at 0x7fec9a2aca50>,3,18,[1 6],4,-1,22,-1,4
1,<environment.Job instance at 0x7fec9a2acc80>,4,15,[9 5],5,-1,22,-1,7
1,<environment.Job instance at 0x7fec9a2ac7d0>,7,16,[2 8],8,-1,24,-1,8
1,<environment.Job instance at 0x7fec9a2ac910>,8,12,[9 2],9,-1,21,-1,9
1,<environment.Job instance at 0x7fec9a2ace10>,6,17,[2 6],7,-1,26,-1,9
1,<environment.Job instance at 0x7fec9a2ace60>,10,18,[8 5],11,-1,29,-1,11
1,<environment.Job instance at 0x7fec9a2ac460>,14,17,[1 9],15,-1,32,-1,15
1,<environment.Job instance at 0x7fec9a2a6690>,23,21,[9 5],24,-1,46,-1,25
1,<environment.Job instance at 0x7fec9a2a6230>,25,12,[12  4],26,-1,38,-1,26
1,<environment.Job instance at 0x7fec9a2a6500>,26,22,[6 1],27,-1,49,-1,27
1,<environment.Job instance at 0x7fec9a2a6910>,27,14,[3 5],28,-1,42,-1,28
1,<environment.Job instance at 0x7fec9a2a6d70>,28,21,[5 1],29,-1,50,-1,29
1,<environment.Job instance at 0x7fec9a2a6820>,32,17,[8 2],33,-1,50,-1,33
1,<environment.Job instance at 0x7fec9a2a6fa0>,33,18,[7 5],34,-1,52,-1,34
1,<environment.Job instance at 0x7fec9a2a1c80>,36,14,[5 4],37,-1,51,-1,37
1,<environment.Job instance at 0x7fec9a2a1dc0>,37,14,[4 7],38,-1,52,-1,38
1,<environment.Job instance at 0x7fec9a2a1280>,39,13,[5 7],40,-1,53,-1,40
1,<environment.Job instance at 0x7fec9a2a1050>,41,16,[6 2],42,-1,58,-1,42
1,<environment.Job instance at 0x7fec9a29efa0>,46,13,[3 6],47,-1,60,-1,47
1,<environment.Job instance at 0x7fec9a29edc0>,49,14,[5 7],50,-1,64,-1,50
1,<environment.Job instance at 0x7fec9a29e1e0>,53,18,[9 2],54,-1,72,-1,54
1,<environment.Job instance at 0x7fec9a29e4b0>,54,18,[ 5 10],55,-1,73,-1,55
1,<environment.Job instance at 0x7fec9a29b460>,56,16,[5 7],57,-1,73,-1,57
1,<environment.Job instance at 0x7fec9a29bbe0>,58,15,[2 5],59,-1,74,-1,59
1,<environment.Job instance at 0x7fec9a29bb90>,59,15,[7 4],60,-1,75,-1,60
1,<environment.Job instance at 0x7fec9a29baa0>,60,17,[4 5],61,-1,78,-1,61
1,<environment.Job instance at 0x7fec9a2a6730>,24,18,[10  2],25,-1,90,-1,72
1,<environment.Job instance at 0x7fec9a347640>,74,16,[8 3],75,-1,91,-1,75
1,<environment.Job instance at 0x7fec9a28be10>,65,18,[9 5],66,-1,99,-1,81
1,<environment.Job instance at 0x7fec9a29be60>,63,13,[8 3],64,-1,94,-1,81
1,<environment.Job instance at 0x7fec9a347500>,81,18,[ 4 13],82,-1,100,-1,82
1,<environment.Job instance at 0x7fec9a347e60>,79,17,[4 8],80,-1,99,-1,82
1,<environment.Job instance at 0x7fec9a347b90>,83,15,[7 4],84,-1,102,-1,87
1,<environment.Job instance at 0x7fec9a3470a0>,87,16,[ 5 13],88,-1,186,-1,170
1,<environment.Job instance at 0x7fec9a2e9460>,102,20,[7 3],103,-1,190,-1,170
1,<environment.Job instance at 0x7fec9a2e9910>,104,12,[3 5],105,-1,183,-1,171
1,<environment.Job instance at 0x7fec9a2e9aa0>,100,18,[11  4],101,-1,190,-1,172
1,<environment.Job instance at 0x7fec9a2e9190>,94,18,[13  2],95,-1,218,-1,200
1,<environment.Job instance at 0x7fec9a35e730>,116,15,[10  5],117,-1,222,-1,207
1,<environment.Job instance at 0x7fec9a2a65f0>,0,28,[7 3],1,-1,29,-1,1
1,<environment.Job instance at 0x7fec9a62b410>,18,12,[12  2],19,-1,51,-1,39
1,<environment.Job instance at 0x7fec9a24b1e0>,21,19,[ 3 14],22,-1,71,-1,52
1,<environment.Job instance at 0x7feca44dc5a0>,22,2,[14  5],23,-1,54,-1,52
1,<environment.Job instance at 0x7fec9a5d62d0>,25,12,[12  4],26,-1,66,-1,54
1,<environment.Job instance at 0x7fec9b834c30>,31,18,[ 5 14],32,-1,86,-1,68
1,<environment.Job instance at 0x7fec9ab32f50>,38,1,[ 5 14],39,-1,90,-1,89
1,<environment.Job instance at 0x7fec9aa83050>,43,3,[14  5],44,-1,107,-1,104
1,<environment.Job instance at 0x7fec9b7b2b90>,48,17,[12  1],49,-1,138,-1,121
1,<environment.Job instance at 0x7fec9b332500>,52,1,[13  3],53,-1,125,-1,124
1,<environment.Job instance at 0x7fec9b1c1320>,62,27,[ 2 13],63,-1,199,-1,172
1,<environment.Job instance at 0x7fec9a4d7730>,68,1,[12  5],69,-1,192,-1,191
1,<environment.Job instance at 0x7fec9b484a00>,81,18,[ 4 13],82,-1,261,-1,243
1,<environment.Job instance at 0x7fec9a6f7410>,87,16,[ 5 13],88,-1,289,-1,273
1,<environment.Job instance at 0x7fec9a750dc0>,94,18,[13  2],95,-1,308,-1,290
1,<environment.Job instance at 0x7fec9a6fcf00>,100,18,[11  4],101,-1,321,-1,303
1,<environment.Job instance at 0x7fec9b0c3910>,4,22,[1 9],5,-1,27,-1,5
1,<environment.Job instance at 0x7fec9b0c3b90>,7,13,[ 1 10],8,-1,21,-1,8
1,<environment.Job instance at 0x7fec9b0c3730>,9,18,[ 2 10],10,-1,28,-1,10
1,<environment.Job instance at 0x7fec9a24bb40>,3,12,[8 5],4,-1,22,-1,10
1,<environment.Job instance at 0x7feca42cc3c0>,11,18,[3 8],12,-1,30,-1,12
1,<environment.Job instance at 0x7feca42ccf00>,13,24,[3 6],14,-1,38,-1,14
1,<environment.Job instance at 0x7feca42cca00>,15,20,[3 8],16,-1,36,-1,16
1,<environment.Job instance at 0x7feca42ccb40>,16,15,[4 9],17,-1,33,-1,18
1,<environment.Job instance at 0x7feca42cc140>,17,27,[9 5],18,-1,45,-1,18
1,<environment.Job instance at 0x7fec9a7919b0>,25,18,[ 3 10],26,-1,45,-1,27
1,<environment.Job instance at 0x7fec9a649cd0>,35,27,[5 5],36,-1,65,-1,38
1,<environment.Job instance at 0x7fec9a7917d0>,26,21,[6 1],27,-1,59,-1,38
1,<environment.Job instance at 0x7fec9a649370>,32,17,[9 1],33,-1,59,-1,42
1,<environment.Job instance at 0x7fec9a649eb0>,36,22,[2 8],37,-1,64,-1,42
1,<environment.Job instance at 0x7feca42cc5a0>,20,18,[4 8],21,-1,63,-1,45
1,<environment.Job instance at 0x7fec9a944fa0>,39,17,[2 6],40,-1,63,-1,46
1,<environment.Job instance at 0x7fec9a944a00>,42,17,[4 6],43,-1,64,-1,47
1,<environment.Job instance at 0x7fec9a944b90>,43,27,[7 5],44,-1,74,-1,47
1,<environment.Job instance at 0x7fec9a649be0>,37,20,[5 2],38,-1,70,-1,50
1,<environment.Job instance at 0x7fec9a944c30>,38,13,[14  4],39,-1,63,-1,50
1,<environment.Job instance at 0x7fec9a944960>,46,13,[8 3],47,-1,63,-1,50
1,<environment.Job instance at 0x7fec9a8416e0>,49,17,[5 1],50,-1,67,-1,50
1,<environment.Job instance at 0x7fec9a841e60>,48,14,[2 7],49,-1,66,-1,52
1,<environment.Job instance at 0x7fec9a841b90>,47,13,[4 6],48,-1,65,-1,52
1,<environment.Job instance at 0x7fec9a8415a0>,51,18,[5 7],52,-1,70,-1,52
1,<environment.Job instance at 0x7fec9a8410a0>,55,25,[3 7],56,-1,82,-1,57
1,<environment.Job instance at 0x7fec9a651fa0>,57,14,[10  3],58,-1,73,-1,59
1,<environment.Job instance at 0x7fec9a841a50>,56,13,[1 6],57,-1,76,-1,63
1,<environment.Job instance at 0x7fec9a7b1cd0>,65,16,[10  5],66,-1,84,-1,68
1,<environment.Job instance at 0x7fec9a7b1370>,64,12,[13  3],65,-1,80,-1,68
1,<environment.Job instance at 0x7fec9a6493c0>,33,18,[8 1],34,-1,86,-1,68
1,<environment.Job instance at 0x7fec9a7b10f0>,66,13,[8 4],67,-1,81,-1,68
1,<environment.Job instance at 0x7fec9a7b1960>,68,21,[9 5],69,-1,90,-1,69
1,<environment.Job instance at 0x7feca440ca00>,70,17,[9 4],71,-1,88,-1,71
1,<environment.Job instance at 0x7fec9a2c24b0>,75,15,[5 7],76,-1,92,-1,77
1,<environment.Job instance at 0x7fec9a6510f0>,58,13,[8 2],59,-1,91,-1,78
1,<environment.Job instance at 0x7fec9a2c2c30>,77,16,[2 6],78,-1,94,-1,78
1,<environment.Job instance at 0x7fec9a843c30>,83,17,[1 8],84,-1,101,-1,84
1,<environment.Job instance at 0x7fec9ac4f140>,86,17,[9 1],87,-1,107,-1,90
1,<environment.Job instance at 0x7fec9a3dbd70>,92,17,[10  3],93,-1,137,-1,120
1,<environment.Job instance at 0x7fec9a3db6e0>,102,27,[5 5],103,-1,147,-1,120
1,<environment.Job instance at 0x7fec9a791f50>,1,25,[10  4],2,-1,27,-1,2
1,<environment.Job instance at 0x7fec9a843cd0>,13,24,[3 6],14,-1,54,-1,30
1,<environment.Job instance at 0x7fec9a3dbd20>,17,27,[9 5],18,-1,60,-1,33
1,<environment.Job instance at 0x7fec9ae5ae60>,23,2,[ 3 14],24,-1,52,-1,50
1,<environment.Job instance at 0x7fec9a6aec30>,34,3,[ 3 12],35,-1,86,-1,83
1,<environment.Job instance at 0x7fec9a6ae5a0>,35,27,[5 5],36,-1,127,-1,100
1,<environment.Job instance at 0x7fec9a6fc3c0>,38,13,[14  4],39,-1,114,-1,101
1,<environment.Job instance at 0x7fec9a750140>,43,27,[7 5],44,-1,147,-1,120
1,<environment.Job instance at 0x7fec9a6f7d20>,44,13,[14  5],45,-1,133,-1,120
1,<environment.Job instance at 0x7fec9b7a7d70>,55,25,[3 7],56,-1,202,-1,177
1,<environment.Job instance at 0x7feca44718c0>,60,1,[ 4 12],61,-1,192,-1,191
1,<environment.Job instance at 0x7fec9a75a410>,64,12,[13  3],65,-1,207,-1,195
1,<environment.Job instance at 0x7fec9a683870>,69,3,[12  1],70,-1,225,-1,222
1,<environment.Job instance at 0x7fec9a62b410>,79,16,[ 5 13],80,-1,264,-1,248
1,<environment.Job instance at 0x7fec9a24b2d0>,84,14,[ 3 14],85,-1,280,-1,266
1,<environment.Job instance at 0x7fec9acf0370>,85,24,[3 9],86,-1,293,-1,269
1,<environment.Job instance at 0x7fec9acff550>,95,1,[12  4],96,-1,308,-1,307
1,<environment.Job instance at 0x7fec9b159f00>,101,15,[14  1],102,-1,339,-1,324
1,<environment.Job instance at 0x7fec9b1ac6e0>,102,27,[5 5],103,-1,354,-1,327
1,<environment.Job instance at 0x7fec9ad2e460>,104,25,[1 7],105,-1,355,-1,330
1,<environment.Job instance at 0x7fec9ac8ac80>,116,27,[5 8],117,-1,417,-1,390
1,<environment.Job instance at 0x7fec9a9422d0>,1,24,[4 8],2,-1,26,-1,2
1,<environment.Job instance at 0x7fec9b1069b0>,5,19,[7 5],6,-1,25,-1,6
1,<environment.Job instance at 0x7fec9b0fd690>,6,14,[8 1],7,-1,22,-1,8
1,<environment.Job instance at 0x7fec9a6ae460>,7,12,[10  4],8,-1,20,-1,8
1,<environment.Job instance at 0x7fec9b0ea5a0>,12,17,[2 5],13,-1,30,-1,13
1,<environment.Job instance at 0x7fec9b0ea1e0>,13,14,[8 2],14,-1,31,-1,17
1,<environment.Job instance at 0x7fec9b11b410>,16,18,[8 2],17,-1,35,-1,17
1,<environment.Job instance at 0x7fec9a9b7370>,19,18,[5 8],20,-1,38,-1,20
1,<environment.Job instance at 0x7fec9a9b7190>,20,19,[2 7],21,-1,40,-1,21
1,<environment.Job instance at 0x7fec9a72ce60>,27,23,[10  4],28,-1,51,-1,28
1,<environment.Job instance at 0x7fec9a6d3af0>,28,14,[3 8],29,-1,43,-1,29
1,<environment.Job instance at 0x7fec9a637a00>,31,17,[5 7],32,-1,49,-1,32
1,<environment.Job instance at 0x7fec9a7130f0>,32,12,[3 8],33,-1,46,-1,34
1,<environment.Job instance at 0x7fec9a61ec30>,34,13,[1 9],35,-1,48,-1,35
1,<environment.Job instance at 0x7fec9a7099b0>,35,16,[4 5],36,-1,52,-1,36
1,<environment.Job instance at 0x7fec9a9b3d20>,39,17,[ 5 10],40,-1,57,-1,40
1,<environment.Job instance at 0x7fec9a631b40>,40,18,[4 6],41,-1,59,-1,41
1,<environment.Job instance at 0x7fec9a631280>,41,15,[3 5],42,-1,58,-1,43
1,<environment.Job instance at 0x7fec9a9b3910>,42,17,[ 2 12],43,-1,61,-1,44
1,<environment.Job instance at 0x7fec9a634230>,49,27,[14  1],50,-1,81,-1,54
1,<environment.Job instance at 0x7fec9a634140>,47,18,[1 7],48,-1,73,-1,55
1,<environment.Job instance at 0x7fec9a613320>,48,19,[1 6],49,-1,90,-1,71
1,<environment.Job instance at 0x7fec9a634e10>,58,15,[5 9],59,-1,86,-1,71
1,<environment.Job instance at 0x7fec9a6347d0>,56,27,[4 5],57,-1,99,-1,72
1,<environment.Job instance at 0x7fec9a99d0a0>,63,18,[6 1],64,-1,90,-1,72
1,<environment.Job instance at 0x7fec9a988f50>,62,3,[11  3],63,-1,75,-1,72
1,<environment.Job instance at 0x7fec9a99d0f0>,64,12,[4 7],65,-1,84,-1,72
1,<environment.Job instance at 0x7fec9a6397d0>,36,17,[13  2],37,-1,91,-1,74
1,<environment.Job instance at 0x7fec9a988e10>,60,14,[8 4],61,-1,88,-1,74
1,<environment.Job instance at 0x7fec9a613230>,46,14,[ 5 10],47,-1,93,-1,79
1,<environment.Job instance at 0x7fec9b11b640>,1,24,[4 8],2,-1,26,-1,2
1,<environment.Job instance at 0x7fec9a99bdc0>,11,1,[11  1],12,-1,13,-1,12
1,<environment.Job instance at 0x7fec9a9c1370>,21,24,[1 9],22,-1,76,-1,52
1,<environment.Job instance at 0x7fec9a9c1e10>,27,23,[10  4],28,-1,85,-1,62
1,<environment.Job instance at 0x7fec9ad79230>,33,3,[ 5 13],34,-1,82,-1,79
1,<environment.Job instance at 0x7fec9ad790f0>,36,17,[13  2],37,-1,108,-1,91
1,<environment.Job instance at 0x7fec9ad795f0>,37,1,[11  4],38,-1,92,-1,91
1,<environment.Job instance at 0x7fec9b1ac320>,42,17,[ 2 12],43,-1,120,-1,103
1,<environment.Job instance at 0x7fec9acff960>,45,24,[10  2],46,-1,143,-1,119
1,<environment.Job instance at 0x7fec9acffbe0>,49,27,[14  1],50,-1,173,-1,146
1,<environment.Job instance at 0x7fec9ad62640>,52,2,[11  4],53,-1,148,-1,146
1,<environment.Job instance at 0x7fec9acf0e10>,55,12,[11  5],56,-1,159,-1,147
1,<environment.Job instance at 0x7fec9a3a7e60>,56,27,[4 5],57,-1,175,-1,148
1,<environment.Job instance at 0x7fec9a24b550>,62,3,[11  3],63,-1,178,-1,175
1,<environment.Job instance at 0x7fec9aaf3cd0>,71,15,[ 2 14],72,-1,221,-1,206
1,<environment.Job instance at 0x7fec9ab32f50>,75,12,[ 3 13],76,-1,223,-1,211
1,<environment.Job instance at 0x7fec9a6f7c30>,91,17,[14  3],92,-1,294,-1,277
1,<environment.Job instance at 0x7fec9a750be0>,94,15,[ 2 13],95,-1,299,-1,284
1,<environment.Job instance at 0x7fec9a6fc550>,97,3,[12  4],98,-1,295,-1,292
1,<environment.Job instance at 0x7fec9a6fcf00>,99,28,[1 8],100,-1,337,-1,309
1,<environment.Job instance at 0x7fec9b0c3320>,108,18,[13  3],109,-1,350,-1,332
1,<environment.Job instance at 0x7fec9ae13910>,115,24,[8 3],116,-1,389,-1,365
1,<environment.Job instance at 0x7fec9b118550>,0,18,[8 1],1,-1,24,-1,6
1,<environment.Job instance at 0x7fec9b0f1780>,6,18,[9 4],7,-1,25,-1,7
1,<environment.Job instance at 0x7fec9b0f19b0>,7,17,[3 5],8,-1,25,-1,8
1,<environment.Job instance at 0x7fec9b0f15a0>,8,17,[2 6],9,-1,26,-1,9
1,<environment.Job instance at 0x7fec9b0f14b0>,12,15,[10  1],13,-1,29,-1,14
1,<environment.Job instance at 0x7fec9b0f1be0>,14,24,[4 5],15,-1,39,-1,15
1,<environment.Job instance at 0x7fec9b0f11e0>,15,13,[8 5],16,-1,29,-1,16
1,<environment.Job instance at 0x7fec9b0f1aa0>,16,13,[3 9],17,-1,30,-1,17
1,<environment.Job instance at 0x7fec9b0f1280>,18,16,[6 5],19,-1,35,-1,19
1,<environment.Job instance at 0x7fec9b0f20f0>,22,15,[2 5],23,-1,38,-1,23
1,<environment.Job instance at 0x7fec9b0f2820>,23,14,[4 8],24,-1,38,-1,24
1,<environment.Job instance at 0x7fec9b0f27d0>,24,16,[9 2],25,-1,41,-1,25
1,<environment.Job instance at 0x7fec9b0f1320>,13,17,[5 3],14,-1,42,-1,25
1,<environment.Job instance at 0x7fec9b0f29b0>,26,15,[9 1],27,-1,47,-1,32
1,<environment.Job instance at 0x7fec9b0fe0f0>,32,13,[ 5 10],33,-1,46,-1,33
1,<environment.Job instance at 0x7fec9b0febe0>,33,15,[6 1],34,-1,49,-1,34
1,<environment.Job instance at 0x7fec9b11caa0>,38,17,[7 2],39,-1,56,-1,39
1,<environment.Job instance at 0x7fec9b11c780>,39,16,[10  2],40,-1,57,-1,41
1,<environment.Job instance at 0x7fec9b11c320>,44,15,[7 3],45,-1,60,-1,45
1,<environment.Job instance at 0x7fec9b11c370>,45,12,[10  3],46,-1,58,-1,46
1,<environment.Job instance at 0x7fec9b0df0a0>,46,14,[5 4],47,-1,61,-1,47
1,<environment.Job instance at 0x7fec9b0df9b0>,47,15,[10  1],48,-1,63,-1,48
1,<environment.Job instance at 0x7fec9b0df7d0>,49,23,[6 5],50,-1,73,-1,50
1,<environment.Job instance at 0x7fec9b0df870>,50,17,[2 6],51,-1,68,-1,51
1,<environment.Job instance at 0x7fec9b0ad410>,59,21,[1 9],60,-1,81,-1,60
1,<environment.Job instance at 0x7fec9b0adeb0>,60,27,[6 4],61,-1,88,-1,61
1,<environment.Job instance at 0x7fec9b0ada00>,62,15,[10  1],63,-1,78,-1,63
1,<environment.Job instance at 0x7fec9b0a12d0>,63,13,[7 5],64,-1,77,-1,64
1,<environment.Job instance at 0x7fec9b0a10a0>,64,13,[1 8],65,-1,78,-1,65
1,<environment.Job instance at 0x7fec9b0a1870>,66,14,[1 7],67,-1,81,-1,67
1,<environment.Job instance at 0x7fec9b0a1e60>,68,22,[7 5],69,-1,91,-1,69
1,<environment.Job instance at 0x7fec9b0a1b40>,69,16,[5 3],70,-1,86,-1,70
1,<environment.Job instance at 0x7fec9b0a1aa0>,70,18,[ 5 10],71,-1,89,-1,71
1,<environment.Job instance at 0x7fec9b11c9b0>,40,15,[5 6],41,-1,86,-1,71
1,<environment.Job instance at 0x7fec9b0a13c0>,72,24,[1 6],73,-1,97,-1,73
1,<environment.Job instance at 0x7fec9b0cb780>,73,16,[8 5],74,-1,91,-1,75
1,<environment.Job instance at 0x7fec9b0a1e10>,74,16,[9 4],75,-1,91,-1,75
1,<environment.Job instance at 0x7fec9b0cbf00>,76,15,[10  4],77,-1,94,-1,79
1,<environment.Job instance at 0x7fec9b0cb410>,83,13,[5 1],84,-1,97,-1,84
1,<environment.Job instance at 0x7fec9a70e550>,85,2,[3 5],86,-1,88,-1,86
1,<environment.Job instance at 0x7fec9a70eb40>,86,12,[1 5],87,-1,99,-1,87
1,<environment.Job instance at 0x7fec9a70e730>,87,2,[8 4],88,-1,90,-1,88
1,<environment.Job instance at 0x7fec9a70ea00>,88,14,[9 1],89,-1,103,-1,89
1,<environment.Job instance at 0x7fec9a70e960>,89,17,[1 9],90,-1,107,-1,90
1,<environment.Job instance at 0x7fec9a70e8c0>,92,15,[6 2],93,-1,108,-1,93
1,<environment.Job instance at 0x7fec9a6cc1e0>,97,27,[9 3],98,-1,125,-1,98
1,<environment.Job instance at 0x7fec9b0edbe0>,98,18,[6 5],99,-1,117,-1,99
1,<environment.Job instance at 0x7fec9b0ed280>,99,18,[ 5 10],100,-1,118,-1,100
1,<environment.Job instance at 0x7fec9a5b9dc0>,102,1,[6 3],103,-1,104,-1,103
1,<environment.Job instance at 0x7fec9a9c4050>,103,16,[5 3],104,-1,120,-1,104
1,<environment.Job instance at 0x7fec9a9c4910>,104,17,[5 1],105,-1,122,-1,105
1,<environment.Job instance at 0x7fec9a9c4cd0>,105,15,[ 1 10],106,-1,121,-1,106
1,<environment.Job instance at 0x7fec9a9c40f0>,106,12,[ 2 11],107,-1,119,-1,107
1,<environment.Job instance at 0x7fec9aecb9b0>,108,24,[4 7],109,-1,133,-1,109
1,<environment.Job instance at 0x7fec9b0cbc80>,78,17,[3 9],79,-1,130,-1,113
1,<environment.Job instance at 0x7fec9b115410>,114,18,[ 4 11],115,-1,133,-1,115
1,<environment.Job instance at 0x7fec9b1e3c30>,115,16,[9 4],116,-1,132,-1,116
1,<environment.Job instance at 0x7fec9b7abbe0>,117,15,[4 6],118,-1,134,-1,119
1,<environment.Job instance at 0x7fec9b0ade10>,11,13,[12  4],12,-1,32,-1,19
1,<environment.Job instance at 0x7fec9b0cbbe0>,14,24,[4 5],15,-1,53,-1,29
1,<environment.Job instance at 0x7fec9a634780>,49,23,[6 5],50,-1,195,-1,172
1,<environment.Job instance at 0x7fec9b0eab40>,61,1,[11  4],62,-1,196,-1,195
1,<environment.Job instance at 0x7fec9b0ead70>,60,27,[6 4],61,-1,222,-1,195
1,<environment.Job instance at 0x7fec9ae09f00>,72,24,[1 6],73,-1,249,-1,225
1,<environment.Job instance at 0x7fec9b08ad70>,84,3,[ 2 12],85,-1,283,-1,280
1,<environment.Job instance at 0x7fec9aeab550>,91,2,[ 3 14],92,-1,296,-1,294
1,<environment.Job instance at 0x7fec9a9b3640>,96,13,[12  4],97,-1,325,-1,312
1,<environment.Job instance at 0x7fec9aeabf50>,97,27,[9 3],98,-1,340,-1,313
1,<environment.Job instance at 0x7fec9ab45c30>,106,12,[ 2 11],107,-1,357,-1,345
1,<environment.Job instance at 0x7fec9aa8a780>,108,24,[4 7],109,-1,401,-1,377
1,<environment.Job instance at 0x7fec9ad56640>,114,18,[ 4 11],115,-1,395,-1,377
1,<environment.Job instance at 0x7fec9a8ccfa0>,0,20,[4 6],1,-1,21,-1,1
1,<environment.Job instance at 0x7fec9ac75e60>,12,17,[ 2 10],13,-1,31,-1,14
1,<environment.Job instance at 0x7fec9ac750a0>,14,12,[9 1],15,-1,27,-1,15
1,<environment.Job instance at 0x7fec9ac75550>,18,20,[3 8],19,-1,39,-1,19
1,<environment.Job instance at 0x7fec9ac6a230>,20,24,[10  4],21,-1,45,-1,21
1,<environment.Job instance at 0x7fec9ac6a500>,21,21,[4 7],22,-1,43,-1,22
1,<environment.Job instance at 0x7fec9ac6af00>,22,17,[ 2 11],23,-1,40,-1,23
1,<environment.Job instance at 0x7fec9ac6d140>,23,15,[4 9],24,-1,39,-1,24
1,<environment.Job instance at 0x7fec9a6dfaf0>,26,18,[6 3],27,-1,45,-1,27
1,<environment.Job instance at 0x7fec9a702500>,29,19,[5 5],30,-1,49,-1,30
1,<environment.Job instance at 0x7fec9a875fa0>,30,15,[10  4],31,-1,46,-1,31
1,<environment.Job instance at 0x7fec9b13e640>,31,18,[4 8],32,-1,50,-1,32
1,<environment.Job instance at 0x7fec9ace55a0>,32,15,[4 8],33,-1,48,-1,33
1,<environment.Job instance at 0x7fec9a86b780>,34,14,[3 8],35,-1,49,-1,35
1,<environment.Job instance at 0x7fec9a84a4b0>,35,12,[10  1],36,-1,48,-1,36
1,<environment.Job instance at 0x7fec9ad050a0>,37,14,[ 4 10],38,-1,52,-1,38
1,<environment.Job instance at 0x7fec9a84ac30>,38,18,[4 6],39,-1,57,-1,39
1,<environment.Job instance at 0x7fec9b147af0>,42,16,[3 8],43,-1,59,-1,43
1,<environment.Job instance at 0x7fec9aced5a0>,44,3,[7 4],45,-1,48,-1,45
1,<environment.Job instance at 0x7fec9b1291e0>,45,2,[4 5],46,-1,48,-1,46
1,<environment.Job instance at 0x7fec9a24b1e0>,13,15,[5 5],14,-1,61,-1,46
1,<environment.Job instance at 0x7fec9aced050>,46,18,[10  2],47,-1,67,-1,49
1,<environment.Job instance at 0x7fec9b152460>,49,16,[7 2],50,-1,66,-1,50
1,<environment.Job instance at 0x7fec9b152140>,50,16,[ 3 10],51,-1,67,-1,51
1,<environment.Job instance at 0x7fec9b152410>,48,17,[9 5],49,-1,68,-1,51
1,<environment.Job instance at 0x7fec9b152370>,51,16,[5 7],52,-1,68,-1,52
1,<environment.Job instance at 0x7fec9acfc3c0>,71,17,[2 7],72,-1,89,-1,72
1,<environment.Job instance at 0x7fec9acfc870>,72,17,[6 4],73,-1,90,-1,73
1,<environment.Job instance at 0x7fec9acfc2d0>,66,14,[6 4],67,-1,99,-1,85
1,<environment.Job instance at 0x7fec9acfcfa0>,80,14,[ 2 10],81,-1,99,-1,85
1,<environment.Job instance at 0x7fec9ad07230>,82,16,[ 3 10],83,-1,105,-1,89
1,<environment.Job instance at 0x7fec9ad07320>,83,18,[5 5],84,-1,107,-1,89
1,<environment.Job instance at 0x7fec9b152a50>,57,27,[ 2 11],58,-1,116,-1,89
1,<environment.Job instance at 0x7fec9ad075f0>,84,16,[5 5],85,-1,105,-1,89
1,<environment.Job instance at 0x7fec9acfc780>,70,13,[5 3],71,-1,102,-1,89
1,<environment.Job instance at 0x7fec9ad07410>,85,17,[ 3 10],86,-1,106,-1,89
1,<environment.Job instance at 0x7fec9ad076e0>,88,18,[1 5],89,-1,107,-1,89
1,<environment.Job instance at 0x7fec9ad075a0>,86,13,[3 9],87,-1,103,-1,90
1,<environment.Job instance at 0x7fec9ad07820>,89,18,[9 5],90,-1,110,-1,92
1,<environment.Job instance at 0x7fec9ad07b40>,92,13,[9 4],93,-1,108,-1,95
1,<environment.Job instance at 0x7fec9ad07c30>,94,16,[2 7],95,-1,111,-1,95
1,<environment.Job instance at 0x7fec9acf60f0>,101,21,[8 2],102,-1,130,-1,109
1,<environment.Job instance at 0x7fec9acf6230>,102,21,[5 7],103,-1,130,-1,109
1,<environment.Job instance at 0x7fec9acf6050>,100,23,[9 4],101,-1,135,-1,112
1,<environment.Job instance at 0x7fec9acf6370>,104,17,[9 2],105,-1,130,-1,113
1,<environment.Job instance at 0x7fec9acf69b0>,108,28,[10  4],109,-1,148,-1,120
1,<environment.Job instance at 0x7fec9ad07f50>,98,16,[8 3],99,-1,136,-1,120
1,<environment.Job instance at 0x7fec9acf6410>,105,18,[5 5],106,-1,138,-1,120
1,<environment.Job instance at 0x7fec9acf6c80>,112,18,[4 7],113,-1,138,-1,120
1,<environment.Job instance at 0x7fec9acf6eb0>,113,18,[7 1],114,-1,138,-1,120
1,<environment.Job instance at 0x7fec9acf6e10>,114,14,[9 1],115,-1,134,-1,120
1,<environment.Job instance at 0x7fec9acfc460>,68,17,[3 7],69,-1,137,-1,120
1,<environment.Job instance at 0x7fec9ad0e0a0>,116,18,[8 3],117,-1,138,-1,120
1,<environment.Job instance at 0x7fec9ac75fa0>,3,14,[ 1 11],4,-1,18,-1,4
1,<environment.Job instance at 0x7fec9acfc9b0>,5,16,[ 2 11],6,-1,22,-1,6
1,<environment.Job instance at 0x7fec9ad07550>,8,2,[13  3],9,-1,11,-1,9
1,<environment.Job instance at 0x7fec9ab45280>,22,17,[ 2 11],23,-1,56,-1,39
1,<environment.Job instance at 0x7fec9b086d20>,24,1,[ 2 11],25,-1,40,-1,39
1,<environment.Job instance at 0x7fec9aa8a280>,20,24,[10  4],21,-1,64,-1,40
1,<environment.Job instance at 0x7fec9b0eab40>,39,1,[ 5 14],40,-1,95,-1,94
1,<environment.Job instance at 0x7fec9a9c1690>,57,27,[ 2 11],58,-1,201,-1,174
1,<environment.Job instance at 0x7fec9b362230>,59,3,[11  2],60,-1,182,-1,179
1,<environment.Job instance at 0x7fec9a9c4c30>,62,1,[12  5],63,-1,185,-1,184
1,<environment.Job instance at 0x7fec9ab92e60>,100,23,[9 4],101,-1,361,-1,338
1,<environment.Job instance at 0x7fec9a92bb40>,108,28,[10  4],109,-1,401,-1,373
1,<environment.Job instance at 0x7fec9ae9f730>,118,17,[12  1],119,-1,413,-1,396
1,<environment.Job instance at 0x7fec9a71a0a0>,0,26,[4 9],1,-1,27,-1,1
1,<environment.Job instance at 0x7fec9ab1a820>,5,18,[1 8],6,-1,24,-1,6
1,<environment.Job instance at 0x7fec9ab1a280>,7,23,[5 3],8,-1,32,-1,9
1,<environment.Job instance at 0x7fec9a71ad70>,8,16,[9 4],9,-1,25,-1,9
1,<environment.Job instance at 0x7fec9ab1af00>,15,14,[ 1 10],16,-1,31,-1,17
1,<environment.Job instance at 0x7fec9ab1a190>,17,19,[1 5],18,-1,37,-1,18
1,<environment.Job instance at 0x7fec9a388410>,18,14,[1 7],19,-1,33,-1,19
1,<environment.Job instance at 0x7fec9a388370>,19,18,[6 4],20,-1,38,-1,20
1,<environment.Job instance at 0x7fec9a388230>,20,13,[11  2],21,-1,34,-1,21
1,<environment.Job instance at 0x7fec9a388190>,22,14,[3 9],23,-1,37,-1,23
1,<environment.Job instance at 0x7fec9a3884b0>,24,14,[5 3],25,-1,39,-1,25
1,<environment.Job instance at 0x7fec9a388eb0>,27,16,[ 3 12],28,-1,44,-1,28
1,<environment.Job instance at 0x7fec9a388e10>,34,18,[5 6],35,-1,55,-1,37
1,<environment.Job instance at 0x7fec9ab1a4b0>,16,18,[7 4],17,-1,55,-1,37
1,<environment.Job instance at 0x7fec9a388af0>,35,17,[3 6],36,-1,54,-1,37
1,<environment.Job instance at 0x7fec9b1e3500>,40,16,[ 2 10],41,-1,77,-1,61
1,<environment.Job instance at 0x7fec9a388aa0>,29,17,[9 2],30,-1,82,-1,65
1,<environment.Job instance at 0x7fec9b1e37d0>,42,15,[5 9],43,-1,80,-1,65
1,<environment.Job instance at 0x7fec9b1e3eb0>,45,18,[ 5 10],46,-1,92,-1,74
1,<environment.Job instance at 0x7fec9b1e3e10>,46,25,[6 3],47,-1,99,-1,74
1,<environment.Job instance at 0x7fec9b048370>,57,18,[3 8],58,-1,103,-1,85
1,<environment.Job instance at 0x7fec9b048500>,58,16,[7 2],59,-1,101,-1,85
1,<environment.Job instance at 0x7fec9b048190>,61,18,[10  5],62,-1,104,-1,86
1,<environment.Job instance at 0x7fec9b0481e0>,65,18,[9 2],66,-1,104,-1,86
1,<environment.Job instance at 0x7fec9b048960>,67,20,[1 8],68,-1,107,-1,87
1,<environment.Job instance at 0x7fec9a48f1e0>,69,3,[8 2],70,-1,90,-1,87
1,<environment.Job instance at 0x7fec9a48f8c0>,70,2,[ 2 12],71,-1,89,-1,87
1,<environment.Job instance at 0x7fec9a48fbe0>,71,21,[4 9],72,-1,108,-1,87
1,<environment.Job instance at 0x7fec9a48f820>,73,16,[8 1],74,-1,106,-1,90
1,<environment.Job instance at 0x7fec9a48fc30>,74,3,[2 7],75,-1,93,-1,90
1,<environment.Job instance at 0x7fec9a48ff50>,75,23,[8 4],76,-1,114,-1,91
1,<environment.Job instance at 0x7fec9a48fb90>,76,12,[3 9],77,-1,103,-1,91
1,<environment.Job instance at 0x7fec9a48ffa0>,77,20,[5 7],78,-1,111,-1,91
1,<environment.Job instance at 0x7fec9a48f050>,78,16,[4 8],79,-1,108,-1,92
1,<environment.Job instance at 0x7fec9a48ff00>,79,18,[6 1],80,-1,110,-1,92
1,<environment.Job instance at 0x7fec9a48fd20>,80,15,[2 8],81,-1,107,-1,92
1,<environment.Job instance at 0x7fec9a3fc370>,82,12,[6 1],83,-1,104,-1,92
1,<environment.Job instance at 0x7fec9a3fc190>,84,15,[11  1],85,-1,107,-1,92
1,<environment.Job instance at 0x7fec9a3fccd0>,85,16,[10  5],86,-1,110,-1,94
1,<environment.Job instance at 0x7fec9a3fc1e0>,87,16,[1 7],88,-1,110,-1,94
1,<environment.Job instance at 0x7fec9a3fc690>,89,18,[2 7],90,-1,112,-1,94
1,<environment.Job instance at 0x7fec9a3fc780>,90,15,[4 7],91,-1,110,-1,95
1,<environment.Job instance at 0x7fec9a748c30>,91,20,[ 5 13],92,-1,115,-1,95
1,<environment.Job instance at 0x7fec9a748500>,92,1,[5 1],93,-1,96,-1,95
1,<environment.Job instance at 0x7fec9a3fcbe0>,93,16,[9 4],94,-1,112,-1,96
1,<environment.Job instance at 0x7fec9a748e10>,94,13,[8 2],95,-1,109,-1,96
1,<environment.Job instance at 0x7fec9a748a50>,100,24,[7 2],101,-1,127,-1,103
1,<environment.Job instance at 0x7fec9a7485f0>,102,15,[ 2 10],103,-1,120,-1,105
1,<environment.Job instance at 0x7feca41955f0>,104,17,[8 1],105,-1,124,-1,107
1,<environment.Job instance at 0x7fec9a4ba820>,105,15,[ 1 12],106,-1,122,-1,107
1,<environment.Job instance at 0x7fec9a6b65f0>,106,19,[2 9],107,-1,126,-1,107
1,<environment.Job instance at 0x7fec9ae94410>,108,20,[ 1 10],109,-1,129,-1,109
1,<environment.Job instance at 0x7fec9b7b5230>,109,18,[2 7],110,-1,128,-1,110
1,<environment.Job instance at 0x7fec9b0bebe0>,111,18,[3 8],112,-1,130,-1,112
1,<environment.Job instance at 0x7fec9b0be730>,113,14,[ 4 10],114,-1,128,-1,114
1,<environment.Job instance at 0x7fec9b0bed20>,114,15,[4 8],115,-1,130,-1,115
1,<environment.Job instance at 0x7fec9a49c500>,116,16,[1 6],117,-1,133,-1,117
1,<environment.Job instance at 0x7fec9b775d70>,117,15,[7 4],118,-1,133,-1,118
1,<environment.Job instance at 0x7fec9a3887d0>,0,26,[4 9],1,-1,27,-1,1
1,<environment.Job instance at 0x7fec9b048820>,2,16,[13  1],3,-1,19,-1,3
1,<environment.Job instance at 0x7fec9aab69b0>,11,18,[11  2],12,-1,30,-1,12
1,<environment.Job instance at 0x7fec9a3fc050>,12,12,[ 5 13],13,-1,25,-1,13
1,<environment.Job instance at 0x7fec9a4f3820>,13,24,[ 5 11],14,-1,38,-1,14
1,<environment.Job instance at 0x7fec9a3fca50>,7,23,[5 3],8,-1,41,-1,18
1,<environment.Job instance at 0x7fec9b4a2eb0>,20,13,[11  2],21,-1,49,-1,36
1,<environment.Job instance at 0x7fec9a5b9fa0>,27,16,[ 3 12],28,-1,88,-1,72
1,<environment.Job instance at 0x7fec9b6645f0>,46,25,[6 3],47,-1,166,-1,141
1,<environment.Job instance at 0x7fec9ae09780>,53,2,[14  3],54,-1,161,-1,159
1,<environment.Job instance at 0x7fec9acf6640>,54,1,[14  5],55,-1,160,-1,159
1,<environment.Job instance at 0x7fec9ac75370>,63,1,[12  4],64,-1,183,-1,182
1,<environment.Job instance at 0x7fec9adbf2d0>,70,2,[ 2 12],71,-1,205,-1,203
1,<environment.Job instance at 0x7fec9a6564b0>,75,23,[8 4],76,-1,244,-1,221
1,<environment.Job instance at 0x7fec9a94a370>,84,15,[11  1],85,-1,269,-1,254
1,<environment.Job instance at 0x7fec9affe1e0>,91,20,[ 5 13],92,-1,292,-1,272
1,<environment.Job instance at 0x7feca440cd70>,100,24,[7 2],101,-1,340,-1,316
1,<environment.Job instance at 0x7fec9b06c0f0>,105,15,[ 1 12],106,-1,335,-1,320
1,<environment.Job instance at 0x7feca3dced70>,118,2,[ 1 13],119,-1,406,-1,404
1,<environment.Job instance at 0x7fec9a084e60>,1,28,[5 1],2,-1,31,-1,3
1,<environment.Job instance at 0x7fec9a084190>,7,13,[9 1],8,-1,23,-1,10
1,<environment.Job instance at 0x7fec9a084140>,12,13,[9 1],13,-1,26,-1,13
1,<environment.Job instance at 0x7fec9a084a50>,13,23,[7 4],14,-1,37,-1,14
1,<environment.Job instance at 0x7fec9a081f00>,15,12,[2 8],16,-1,29,-1,17
1,<environment.Job instance at 0x7fec9a081fa0>,17,17,[10  4],18,-1,35,-1,18
1,<environment.Job instance at 0x7fec9a0840f0>,16,12,[9 5],17,-1,30,-1,18
1,<environment.Job instance at 0x7fec9a0811e0>,19,15,[2 6],20,-1,37,-1,22
1,<environment.Job instance at 0x7fec9a081b90>,22,13,[2 9],23,-1,36,-1,23
1,<environment.Job instance at 0x7fec9a0817d0>,21,14,[9 4],22,-1,37,-1,23
1,<environment.Job instance at 0x7fec9a081b40>,25,18,[7 5],26,-1,45,-1,27
1,<environment.Job instance at 0x7fec9a081190>,26,27,[5 2],27,-1,54,-1,27
1,<environment.Job instance at 0x7fec9a0b0780>,39,17,[2 6],40,-1,57,-1,40
1,<environment.Job instance at 0x7fec9a0b0690>,44,28,[4 5],45,-1,73,-1,45
1,<environment.Job instance at 0x7fec9a081050>,29,18,[ 2 10],30,-1,63,-1,45
1,<environment.Job instance at 0x7fec9a03daa0>,46,17,[3 5],47,-1,71,-1,54
1,<environment.Job instance at 0x7fec9a05e820>,58,18,[5 5],59,-1,175,-1,157
1,<environment.Job instance at 0x7fec9a081730>,18,18,[13  5],19,-1,201,-1,183
1,<environment.Job instance at 0x7fec9a05e410>,63,17,[5 9],64,-1,202,-1,185
1,<environment.Job instance at 0x7fec9a05e550>,65,21,[9 3],66,-1,206,-1,185
1,<environment.Job instance at 0x7fec9a05e9b0>,67,25,[9 4],68,-1,211,-1,186
1,<environment.Job instance at 0x7fec9a0b0aa0>,38,18,[5 8],39,-1,220,-1,202
1,<environment.Job instance at 0x7fec9a04d9b0>,72,16,[9 4],73,-1,227,-1,211
1,<environment.Job instance at 0x7fec9b14c5f0>,93,24,[5 3],94,-1,329,-1,305
1,<environment.Job instance at 0x7fec9b60f690>,101,28,[9 4],102,-1,334,-1,306
1,<environment.Job instance at 0x7fec9aaef0f0>,103,16,[ 1 12],104,-1,402,-1,386
1,<environment.Job instance at 0x7fec9a610f00>,116,21,[5 5],117,-1,407,-1,386
1,<environment.Job instance at 0x7fec9a57e410>,118,13,[4 6],119,-1,402,-1,389
1,<environment.Job instance at 0x7fec9a0b0be0>,0,28,[ 2 14],1,-1,29,-1,1
1,<environment.Job instance at 0x7fec9a0b01e0>,1,28,[5 1],2,-1,30,-1,2
1,<environment.Job instance at 0x7fec9a161280>,13,23,[7 4],14,-1,38,-1,15
1,<environment.Job instance at 0x7fec9a119730>,18,18,[13  5],19,-1,37,-1,19
1,<environment.Job instance at 0x7fec9a084820>,23,3,[13  5],24,-1,47,-1,44
1,<environment.Job instance at 0x7fec9a084fa0>,26,27,[5 2],27,-1,75,-1,48
1,<environment.Job instance at 0x7fec9a084960>,27,14,[ 3 14],28,-1,62,-1,48
1,<environment.Job instance at 0x7fec9b4588c0>,44,28,[4 5],45,-1,140,-1,112
1,<environment.Job instance at 0x7fec9ab35a00>,47,2,[ 5 13],48,-1,115,-1,113
1,<environment.Job instance at 0x7fec9b448eb0>,51,25,[10  1],52,-1,167,-1,142
1,<environment.Job instance at 0x7fec9ab1f2d0>,67,25,[9 4],68,-1,233,-1,208
1,<environment.Job instance at 0x7fec9b7274b0>,79,28,[6 1],80,-1,278,-1,250
1,<environment.Job instance at 0x7fec9a4b1b90>,82,18,[ 2 12],83,-1,271,-1,253
1,<environment.Job instance at 0x7fec9aaa0050>,93,24,[5 3],94,-1,319,-1,295
1,<environment.Job instance at 0x7fec9b026af0>,97,2,[11  4],98,-1,313,-1,311
1,<environment.Job instance at 0x7fec9aabee60>,101,28,[9 4],102,-1,364,-1,336
1,<environment.Job instance at 0x7fec9aed0d70>,103,16,[ 1 12],104,-1,352,-1,336
1,<environment.Job instance at 0x7fec9adaa410>,108,19,[ 3 11],109,-1,364,-1,345
1,<environment.Job instance at 0x7fec9af51190>,4,16,[7 4],5,-1,22,-1,6
1,<environment.Job instance at 0x7fec9b386280>,8,17,[9 5],9,-1,26,-1,9
1,<environment.Job instance at 0x7fec9b3864b0>,11,18,[4 7],12,-1,30,-1,12
1,<environment.Job instance at 0x7fec9b3867d0>,13,17,[9 1],14,-1,32,-1,15
1,<environment.Job instance at 0x7fec9b386b40>,16,21,[5 5],17,-1,38,-1,17
1,<environment.Job instance at 0x7fec9b386500>,19,15,[3 9],20,-1,35,-1,20
1,<environment.Job instance at 0x7fec9b5be190>,20,15,[5 5],21,-1,36,-1,21
1,<environment.Job instance at 0x7fec9b5be1e0>,22,12,[ 1 10],23,-1,35,-1,23
1,<environment.Job instance at 0x7fec9b5bef00>,24,15,[10  2],25,-1,40,-1,25
1,<environment.Job instance at 0x7fec9b5be690>,25,25,[1 6],26,-1,51,-1,26
1,<environment.Job instance at 0x7fec9b5be500>,27,15,[6 2],28,-1,43,-1,28
1,<environment.Job instance at 0x7fec9b5be6e0>,32,20,[ 5 10],33,-1,53,-1,33
1,<environment.Job instance at 0x7feca3e25aa0>,34,12,[9 1],35,-1,47,-1,35
1,<environment.Job instance at 0x7feca3e25c30>,35,24,[8 3],36,-1,60,-1,36
1,<environment.Job instance at 0x7feca3e25a50>,36,14,[6 4],37,-1,51,-1,37
1,<environment.Job instance at 0x7feca3e25460>,37,12,[5 9],38,-1,50,-1,38
1,<environment.Job instance at 0x7feca3e25b40>,41,16,[3 9],42,-1,58,-1,42
1,<environment.Job instance at 0x7feca3e25230>,44,13,[2 7],45,-1,58,-1,45
1,<environment.Job instance at 0x7feca3e25fa0>,45,17,[10  3],46,-1,63,-1,46
1,<environment.Job instance at 0x7feca3e25050>,46,18,[6 4],47,-1,65,-1,47
1,<environment.Job instance at 0x7feca3e25f00>,47,24,[5 9],48,-1,72,-1,48
1,<environment.Job instance at 0x7fec9acff8c0>,51,28,[3 6],52,-1,80,-1,52
1,<environment.Job instance at 0x7fec9acff460>,52,14,[ 4 10],53,-1,67,-1,53
1,<environment.Job instance at 0x7fec9acffc30>,55,16,[7 3],56,-1,72,-1,56
1,<environment.Job instance at 0x7fec9acff550>,56,12,[8 4],57,-1,69,-1,57
1,<environment.Job instance at 0x7fec9acff280>,57,16,[1 8],58,-1,74,-1,58
1,<environment.Job instance at 0x7fec9acff0a0>,59,26,[2 6],60,-1,86,-1,60
1,<environment.Job instance at 0x7fec9acff320>,60,20,[9 3],61,-1,81,-1,61
1,<environment.Job instance at 0x7fec9acff230>,61,15,[8 4],62,-1,77,-1,62
1,<environment.Job instance at 0x7fec9acff910>,62,14,[9 2],63,-1,77,-1,63
1,<environment.Job instance at 0x7fec9acff780>,63,16,[2 6],64,-1,80,-1,64
1,<environment.Job instance at 0x7fec9acff4b0>,65,17,[5 3],66,-1,83,-1,66
1,<environment.Job instance at 0x7fec9a6ef2d0>,68,26,[8 2],69,-1,95,-1,69
1,<environment.Job instance at 0x7fec9a6efe10>,70,13,[4 6],71,-1,84,-1,71
1,<environment.Job instance at 0x7fec9a6ef820>,72,16,[9 2],73,-1,89,-1,73
1,<environment.Job instance at 0x7fec9a6ef280>,73,18,[4 6],74,-1,92,-1,74
1,<environment.Job instance at 0x7fec9a6ef460>,74,13,[2 8],75,-1,88,-1,75
1,<environment.Job instance at 0x7fec9a6efbe0>,76,17,[3 7],77,-1,94,-1,77
1,<environment.Job instance at 0x7fec9a6eff50>,79,17,[5 7],80,-1,97,-1,80
1,<environment.Job instance at 0x7fec9af1a460>,82,18,[7 4],83,-1,101,-1,83
1,<environment.Job instance at 0x7fec9af1a730>,83,14,[ 2 10],84,-1,98,-1,84
1,<environment.Job instance at 0x7fec9b386640>,14,22,[4 9],15,-1,114,-1,92
1,<environment.Job instance at 0x7fec9af1ae10>,93,16,[3 8],94,-1,119,-1,103
1,<environment.Job instance at 0x7fec9a6efeb0>,7,13,[14  4],8,-1,21,-1,8
1,<environment.Job instance at 0x7fec9ada5d70>,23,2,[13  2],24,-1,55,-1,53
1,<environment.Job instance at 0x7fec9a161280>,25,25,[1 6],26,-1,90,-1,65
1,<environment.Job instance at 0x7fec9aaf05a0>,30,27,[11  2],31,-1,110,-1,83
1,<environment.Job instance at 0x7fec9ab15e60>,35,24,[8 3],36,-1,114,-1,90
1,<environment.Job instance at 0x7fec9b44f050>,47,24,[5 9],48,-1,157,-1,133
1,<environment.Job instance at 0x7fec9b44f320>,51,28,[3 6],52,-1,166,-1,138
1,<environment.Job instance at 0x7fec9aef5820>,59,26,[2 6],60,-1,198,-1,172
1,<environment.Job instance at 0x7fec9a2ac280>,67,1,[ 1 13],68,-1,196,-1,195
1,<environment.Job instance at 0x7fec9a8b3640>,68,26,[8 2],69,-1,235,-1,209
1,<environment.Job instance at 0x7fec9a134e10>,75,25,[ 3 14],76,-1,251,-1,226
1,<environment.Job instance at 0x7fec9a6048c0>,81,3,[ 4 13],82,-1,249,-1,246
1,<environment.Job instance at 0x7fec9a604370>,84,27,[13  3],85,-1,283,-1,256
1,<environment.Job instance at 0x7fec9b455320>,104,27,[6 1],105,-1,376,-1,349
1,<environment.Job instance at 0x7fec9ab2d8c0>,106,17,[ 5 11],107,-1,366,-1,349
1,<environment.Job instance at 0x7fec9b448eb0>,111,24,[14  3],112,-1,388,-1,364
1,<environment.Job instance at 0x7fec9b448f00>,113,24,[10  2],114,-1,404,-1,380
1,<environment.Job instance at 0x7fec9aed0d20>,0,18,[6 4],1,-1,19,-1,1
1,<environment.Job instance at 0x7fec9a0b2780>,5,16,[7 3],6,-1,22,-1,6
1,<environment.Job instance at 0x7fec9a7ada00>,7,13,[10  4],8,-1,21,-1,8
1,<environment.Job instance at 0x7fec9a7ade60>,8,13,[8 5],9,-1,22,-1,9
1,<environment.Job instance at 0x7fec9a9dacd0>,11,16,[ 5 11],12,-1,29,-1,13
1,<environment.Job instance at 0x7fec9ab322d0>,12,16,[5 4],13,-1,31,-1,15
1,<environment.Job instance at 0x7fec9a9da370>,15,27,[4 5],16,-1,43,-1,16
1,<environment.Job instance at 0x7fec9a9da190>,17,18,[1 6],18,-1,36,-1,18
1,<environment.Job instance at 0x7fec9ae267d0>,20,17,[9 2],21,-1,40,-1,23
1,<environment.Job instance at 0x7fec9b60e050>,26,25,[7 3],27,-1,52,-1,27
1,<environment.Job instance at 0x7fec9b60ebe0>,29,18,[6 2],30,-1,48,-1,30
1,<environment.Job instance at 0x7fec9b60e3c0>,30,26,[6 4],31,-1,57,-1,31
1,<environment.Job instance at 0x7fec9a048c80>,32,13,[ 3 10],33,-1,46,-1,33
1,<environment.Job instance at 0x7fec9ae269b0>,33,14,[ 4 10],34,-1,48,-1,34
1,<environment.Job instance at 0x7fec99f83640>,35,14,[5 7],36,-1,50,-1,36
1,<environment.Job instance at 0x7fec99f83e60>,36,16,[9 2],37,-1,53,-1,37
1,<environment.Job instance at 0x7fec99f83280>,37,21,[9 4],38,-1,59,-1,38
1,<environment.Job instance at 0x7fec99f830a0>,38,21,[5 1],39,-1,60,-1,39
1,<environment.Job instance at 0x7fec9a32db40>,42,12,[1 9],43,-1,55,-1,43
1,<environment.Job instance at 0x7fec9a32d1e0>,45,16,[4 9],46,-1,62,-1,46
1,<environment.Job instance at 0x7fec9b158280>,46,18,[5 5],47,-1,65,-1,47
1,<environment.Job instance at 0x7fec9b158870>,49,20,[5 9],50,-1,70,-1,50
1,<environment.Job instance at 0x7fec9b158640>,50,17,[ 5 10],51,-1,68,-1,51
1,<environment.Job instance at 0x7fec9b158410>,51,14,[10  1],52,-1,66,-1,52
1,<environment.Job instance at 0x7fec9b1584b0>,52,18,[3 8],53,-1,71,-1,53
1,<environment.Job instance at 0x7fec9a46e640>,22,14,[7 3],23,-1,72,-1,58
1,<environment.Job instance at 0x7fec9aaa07d0>,62,18,[3 7],63,-1,82,-1,64
1,<environment.Job instance at 0x7fec9aaa0e10>,67,15,[3 6],68,-1,83,-1,68
1,<environment.Job instance at 0x7fec9aaa08c0>,68,14,[ 1 10],69,-1,83,-1,69
1,<environment.Job instance at 0x7fec9a2cce10>,70,25,[5 3],71,-1,96,-1,71
1,<environment.Job instance at 0x7fec9a2cc5a0>,71,16,[11  2],72,-1,88,-1,72
1,<environment.Job instance at 0x7fec9af74c30>,74,13,[3 6],75,-1,88,-1,75
1,<environment.Job instance at 0x7fec9ab11e10>,76,13,[8 1],77,-1,90,-1,77
1,<environment.Job instance at 0x7fec9b78ecd0>,78,16,[10  3],79,-1,95,-1,79
1,<environment.Job instance at 0x7fec9b78e0f0>,79,28,[3 9],80,-1,108,-1,80
1,<environment.Job instance at 0x7fec9aff3410>,82,23,[3 7],83,-1,106,-1,83
1,<environment.Job instance at 0x7fec9aab7f00>,84,17,[2 7],85,-1,102,-1,85
1,<environment.Job instance at 0x7fec9aab7500>,87,16,[5 4],88,-1,104,-1,88
1,<environment.Job instance at 0x7fec9aab7140>,88,17,[6 5],89,-1,106,-1,89
1,<environment.Job instance at 0x7fec9aab7320>,89,18,[5 1],90,-1,108,-1,90
1,<environment.Job instance at 0x7fec9aab7dc0>,90,16,[1 7],91,-1,107,-1,91
1,<environment.Job instance at 0x7fec9aaa0690>,63,12,[5 4],64,-1,107,-1,95
1,<environment.Job instance at 0x7fec9adead20>,95,1,[1 8],96,-1,98,-1,97
1,<environment.Job instance at 0x7fec9a5a76e0>,97,16,[11  1],98,-1,114,-1,98
1,<environment.Job instance at 0x7fec9aab7730>,92,17,[6 4],93,-1,116,-1,99
1,<environment.Job instance at 0x7fec9b14fc30>,99,12,[3 9],100,-1,112,-1,100
1,<environment.Job instance at 0x7fec9b14f9b0>,100,15,[1 8],101,-1,116,-1,101
1,<environment.Job instance at 0x7fec9b14f2d0>,101,16,[5 5],102,-1,118,-1,102
1,<environment.Job instance at 0x7fec9b14f910>,102,18,[2 5],103,-1,121,-1,103
1,<environment.Job instance at 0x7fec9b395500>,104,14,[ 3 10],105,-1,119,-1,105
1,<environment.Job instance at 0x7fec9b395fa0>,111,15,[5 2],112,-1,127,-1,112
1,<environment.Job instance at 0x7fec9b06e050>,115,16,[10  3],116,-1,132,-1,116
1,<environment.Job instance at 0x7fec9b158aa0>,10,13,[12  1],11,-1,34,-1,21
1,<environment.Job instance at 0x7fec9b76d870>,11,16,[ 5 11],12,-1,37,-1,21
1,<environment.Job instance at 0x7fec9b290190>,15,27,[4 5],16,-1,57,-1,30
1,<environment.Job instance at 0x7fec9af74be0>,16,1,[12  2],17,-1,31,-1,30
1,<environment.Job instance at 0x7fec9b448870>,26,25,[7 3],27,-1,82,-1,57
1,<environment.Job instance at 0x7fec9b4550a0>,30,26,[6 4],31,-1,102,-1,76
1,<environment.Job instance at 0x7fec9a5d65f0>,64,1,[13  5],65,-1,175,-1,174
1,<environment.Job instance at 0x7fec9b60faf0>,70,25,[5 3],71,-1,219,-1,194
1,<environment.Job instance at 0x7fec9b60f870>,71,16,[11  2],72,-1,210,-1,194
1,<environment.Job instance at 0x7fec9b44f910>,79,28,[3 9],80,-1,258,-1,230
1,<environment.Job instance at 0x7fec9b44f2d0>,82,23,[3 7],83,-1,254,-1,231
1,<environment.Job instance at 0x7fec9a2d9aa0>,86,3,[ 5 14],87,-1,239,-1,236
1,<environment.Job instance at 0x7fec9a119690>,97,16,[11  1],98,-1,295,-1,279
1,<environment.Job instance at 0x7fec9a6ef3c0>,107,16,[ 5 13],108,-1,333,-1,317
1,<environment.Job instance at 0x7feca3e25820>,109,2,[13  4],110,-1,320,-1,318
1,<environment.Job instance at 0x7feca3e25870>,113,20,[ 5 12],114,-1,340,-1,320
1,<environment.Job instance at 0x7fec9b06e910>,114,2,[ 5 11],115,-1,322,-1,320
1,<environment.Job instance at 0x7fec9a72e370>,0,13,[10  1],1,-1,17,-1,4
1,<environment.Job instance at 0x7fec9a72e140>,4,1,[6 1],5,-1,6,-1,5
1,<environment.Job instance at 0x7fec9a72ea00>,5,15,[1 5],6,-1,21,-1,6
1,<environment.Job instance at 0x7fec9a72ecd0>,3,18,[4 5],4,-1,24,-1,6
1,<environment.Job instance at 0x7fec9a72e230>,6,16,[5 6],7,-1,23,-1,7
1,<environment.Job instance at 0x7fec9b0cbfa0>,17,15,[10  4],18,-1,34,-1,19
1,<environment.Job instance at 0x7fec9a0fcc30>,20,13,[1 5],21,-1,34,-1,21
1,<environment.Job instance at 0x7fec9a0fcd20>,22,14,[3 7],23,-1,37,-1,23
1,<environment.Job instance at 0x7fec9a0fcf00>,26,27,[2 9],27,-1,54,-1,27
1,<environment.Job instance at 0x7fec9a0fc230>,27,15,[2 6],28,-1,43,-1,28
1,<environment.Job instance at 0x7fec9a0fcbe0>,28,18,[ 5 10],29,-1,47,-1,29
1,<environment.Job instance at 0x7fec9a0fc910>,29,18,[10  2],30,-1,48,-1,30
1,<environment.Job instance at 0x7fec9a0fc0a0>,32,22,[8 1],33,-1,55,-1,33
1,<environment.Job instance at 0x7fec9a57cc80>,34,13,[5 8],35,-1,48,-1,35
1,<environment.Job instance at 0x7fec9a57c780>,37,15,[ 5 12],38,-1,53,-1,38
1,<environment.Job instance at 0x7fec9a57cb90>,38,16,[9 1],39,-1,55,-1,39
1,<environment.Job instance at 0x7fec9a57c7d0>,41,27,[8 5],42,-1,69,-1,42
1,<environment.Job instance at 0x7fec9a57c230>,44,16,[11  4],45,-1,61,-1,45
1,<environment.Job instance at 0x7fec9a57c550>,45,14,[1 7],46,-1,60,-1,46
1,<environment.Job instance at 0x7fec9a6e26e0>,47,18,[1 9],48,-1,66,-1,48
1,<environment.Job instance at 0x7fec9a6e2eb0>,52,18,[10  5],53,-1,74,-1,56
1,<environment.Job instance at 0x7fec9a6e2690>,57,15,[ 4 10],58,-1,74,-1,59
1,<environment.Job instance at 0x7fec9b0cb8c0>,18,16,[ 5 10],19,-1,75,-1,59
1,<environment.Job instance at 0x7fec9aa831e0>,62,18,[9 1],63,-1,85,-1,67
1,<environment.Job instance at 0x7fec9aa836e0>,61,2,[3 8],62,-1,69,-1,67
1,<environment.Job instance at 0x7fec9a6e2320>,54,17,[10  5],55,-1,84,-1,67
1,<environment.Job instance at 0x7fec9aa83280>,64,15,[2 7],65,-1,82,-1,67
1,<environment.Job instance at 0x7fec9aa83b90>,66,13,[1 6],67,-1,80,-1,67
1,<environment.Job instance at 0x7fec9a6e2910>,55,18,[5 6],56,-1,91,-1,73
1,<environment.Job instance at 0x7fec9aa83e10>,72,18,[1 9],73,-1,94,-1,76
1,<environment.Job instance at 0x7feca4084960>,78,15,[3 8],79,-1,103,-1,88
1,<environment.Job instance at 0x7feca4084230>,83,17,[13  5],84,-1,106,-1,89
1,<environment.Job instance at 0x7feca40846e0>,81,16,[ 5 12],82,-1,110,-1,94
1,<environment.Job instance at 0x7feca4084d20>,84,17,[8 5],85,-1,111,-1,94
1,<environment.Job instance at 0x7feca4084c30>,80,13,[5 8],81,-1,107,-1,94
1,<environment.Job instance at 0x7feca4084b40>,88,13,[10  4],89,-1,107,-1,94
1,<environment.Job instance at 0x7feca4084d70>,86,16,[1 5],87,-1,110,-1,94
1,<environment.Job instance at 0x7fec9a57cd20>,33,14,[14  4],34,-1,176,-1,162
1,<environment.Job instance at 0x7fec9b51ddc0>,104,15,[6 2],105,-1,177,-1,162
1,<environment.Job instance at 0x7fec9b2b9aa0>,108,24,[5 6],109,-1,187,-1,163
1,<environment.Job instance at 0x7fec9a0b12d0>,112,14,[14  5],113,-1,180,-1,166
1,<environment.Job instance at 0x7fec9a0b1050>,111,17,[5 8],112,-1,183,-1,166
1,<environment.Job instance at 0x7fec9a0b1140>,114,16,[8 2],115,-1,182,-1,166
1,<environment.Job instance at 0x7fec9b0cbdc0>,1,2,[ 5 11],2,-1,4,-1,2
1,<environment.Job instance at 0x7fec9a6e2820>,9,13,[ 4 14],10,-1,23,-1,10
1,<environment.Job instance at 0x7fec9b2b9690>,16,16,[13  1],17,-1,39,-1,23
1,<environment.Job instance at 0x7fec9a275780>,26,27,[2 9],27,-1,80,-1,53
1,<environment.Job instance at 0x7fec9b3a4b90>,33,14,[14  4],34,-1,99,-1,85
1,<environment.Job instance at 0x7fec9b389b40>,35,3,[ 1 13],36,-1,88,-1,85
1,<environment.Job instance at 0x7fec9b389e10>,36,2,[14  2],37,-1,87,-1,85
1,<environment.Job instance at 0x7fec9af40410>,37,15,[ 5 12],38,-1,100,-1,85
1,<environment.Job instance at 0x7fec9af40140>,40,2,[14  4],41,-1,103,-1,101
1,<environment.Job instance at 0x7fec9af40a50>,41,27,[8 5],42,-1,130,-1,103
1,<environment.Job instance at 0x7fec9af50460>,44,16,[11  4],45,-1,119,-1,103
1,<environment.Job instance at 0x7fec9a258e60>,48,16,[13  2],49,-1,125,-1,109
1,<environment.Job instance at 0x7fec9af330f0>,51,14,[ 2 12],52,-1,137,-1,123
1,<environment.Job instance at 0x7fec9af31910>,53,26,[7 1],54,-1,168,-1,142
1,<environment.Job instance at 0x7fec9af57370>,79,25,[3 6],80,-1,256,-1,231
1,<environment.Job instance at 0x7fec9a261960>,81,16,[ 5 12],82,-1,255,-1,239
1,<environment.Job instance at 0x7fec9af4cdc0>,83,17,[13  5],84,-1,260,-1,243
1,<environment.Job instance at 0x7fec9a24caa0>,95,2,[ 3 11],96,-1,293,-1,291
1,<environment.Job instance at 0x7fec9af42280>,102,3,[ 4 11],103,-1,316,-1,313
1,<environment.Job instance at 0x7fec9b375a00>,108,24,[5 6],109,-1,367,-1,343
1,<environment.Job instance at 0x7fec9b375280>,110,3,[ 3 12],111,-1,346,-1,343
1,<environment.Job instance at 0x7fec9b375f00>,112,14,[14  5],113,-1,370,-1,356
1,<environment.Job instance at 0x7fec9a5e1a00>,0,20,[ 4 10],1,-1,21,-1,1
1,<environment.Job instance at 0x7fec9a5e1be0>,3,14,[ 4 10],4,-1,18,-1,4
1,<environment.Job instance at 0x7fec9a5e1410>,6,24,[4 5],7,-1,31,-1,7
1,<environment.Job instance at 0x7fec9a5e1460>,7,24,[4 8],8,-1,32,-1,8
1,<environment.Job instance at 0x7fec9a5ce780>,16,16,[4 9],17,-1,33,-1,17
1,<environment.Job instance at 0x7fec9a5ce820>,17,18,[6 1],18,-1,36,-1,18
1,<environment.Job instance at 0x7fec9a5ce190>,19,15,[6 4],20,-1,35,-1,20
1,<environment.Job instance at 0x7fec9a601960>,22,23,[6 2],23,-1,46,-1,23
1,<environment.Job instance at 0x7fec9a601e10>,26,17,[1 6],27,-1,44,-1,27
1,<environment.Job instance at 0x7fec9a601d70>,27,13,[9 4],28,-1,42,-1,29
1,<environment.Job instance at 0x7fec9af425f0>,32,18,[6 5],33,-1,51,-1,33
1,<environment.Job instance at 0x7fec9af42140>,34,14,[ 5 10],35,-1,49,-1,35
1,<environment.Job instance at 0x7fec9af424b0>,36,16,[4 8],37,-1,53,-1,37
1,<environment.Job instance at 0x7fec9af42d20>,37,15,[4 8],38,-1,53,-1,38
1,<environment.Job instance at 0x7fec9af422d0>,38,15,[1 6],39,-1,54,-1,39
1,<environment.Job instance at 0x7fec9af235f0>,43,14,[ 2 11],44,-1,58,-1,44
1,<environment.Job instance at 0x7fec9af23370>,44,17,[1 6],45,-1,62,-1,45
1,<environment.Job instance at 0x7fec9af238c0>,45,14,[3 8],46,-1,60,-1,46
1,<environment.Job instance at 0x7fec9af23b40>,46,17,[4 6],47,-1,64,-1,47
1,<environment.Job instance at 0x7fec9af230a0>,48,18,[10  1],49,-1,67,-1,49
1,<environment.Job instance at 0x7fec9af230f0>,50,15,[4 7],51,-1,66,-1,51
1,<environment.Job instance at 0x7fec9af3daf0>,52,17,[ 1 10],53,-1,70,-1,53
1,<environment.Job instance at 0x7fec9af3d320>,53,15,[8 4],54,-1,69,-1,54
1,<environment.Job instance at 0x7fec9af3d280>,54,13,[1 9],55,-1,68,-1,55
1,<environment.Job instance at 0x7fec9af3d190>,55,24,[5 2],56,-1,80,-1,56
1,<environment.Job instance at 0x7fec9a41e9b0>,60,25,[6 2],61,-1,86,-1,61
1,<environment.Job instance at 0x7fec9a41ee60>,61,17,[9 4],62,-1,79,-1,62
1,<environment.Job instance at 0x7fec9af4c960>,65,14,[4 8],66,-1,80,-1,66
1,<environment.Job instance at 0x7fec9af4cbe0>,68,18,[10  4],69,-1,87,-1,69
1,<environment.Job instance at 0x7fec9af4cd20>,71,13,[9 3],72,-1,89,-1,76
1,<environment.Job instance at 0x7fec9a2714b0>,76,16,[ 1 10],77,-1,93,-1,77
1,<environment.Job instance at 0x7fec9af27be0>,79,15,[ 5 10],80,-1,95,-1,80
1,<environment.Job instance at 0x7fec9af27b40>,81,17,[ 2 10],82,-1,99,-1,82
1,<environment.Job instance at 0x7fec9af27640>,82,16,[2 8],83,-1,99,-1,83
1,<environment.Job instance at 0x7fec9a271d20>,75,19,[2 8],76,-1,104,-1,85
1,<environment.Job instance at 0x7fec9af27910>,85,18,[4 6],86,-1,104,-1,86
1,<environment.Job instance at 0x7fec9af27690>,86,15,[5 9],87,-1,102,-1,87
1,<environment.Job instance at 0x7fec9af4a960>,89,17,[ 1 10],90,-1,107,-1,90
1,<environment.Job instance at 0x7fec9af4acd0>,90,15,[8 4],91,-1,107,-1,92
1,<environment.Job instance at 0x7fec9ac58af0>,94,19,[ 5 10],95,-1,114,-1,95
1,<environment.Job instance at 0x7fec9a5f10a0>,96,15,[3 9],97,-1,112,-1,97
1,<environment.Job instance at 0x7fec9a5f1b90>,97,27,[8 5],98,-1,125,-1,98
1,<environment.Job instance at 0x7fec9af4c640>,70,25,[5 5],71,-1,124,-1,99
1,<environment.Job instance at 0x7fec9a5f6050>,105,15,[10  1],106,-1,122,-1,107
1,<environment.Job instance at 0x7fec9a806140>,107,12,[6 5],108,-1,120,-1,108
1,<environment.Job instance at 0x7fec9a5f67d0>,110,20,[8 5],111,-1,131,-1,111
1,<environment.Job instance at 0x7fec9a5f1870>,106,13,[ 2 10],107,-1,127,-1,114
1,<environment.Job instance at 0x7fec9aa611e0>,114,16,[5 8],115,-1,131,-1,115
1,<environment.Job instance at 0x7fec9a41ee10>,6,24,[4 5],7,-1,44,-1,20
1,<environment.Job instance at 0x7fec9a2717d0>,7,24,[4 8],8,-1,45,-1,21
1,<environment.Job instance at 0x7fec9af42910>,22,23,[6 2],23,-1,67,-1,44
1,<environment.Job instance at 0x7fec9af42e60>,24,3,[ 1 12],25,-1,47,-1,44
1,<environment.Job instance at 0x7fec9af42960>,25,14,[12  1],26,-1,58,-1,44
1,<environment.Job instance at 0x7fec9a261b90>,33,1,[11  3],34,-1,63,-1,62
1,<environment.Job instance at 0x7fec9af3d4b0>,35,28,[ 4 12],36,-1,91,-1,63
1,<environment.Job instance at 0x7fec9af4cc80>,39,1,[ 4 13],40,-1,91,-1,90
1,<environment.Job instance at 0x7fec9af4c2d0>,43,14,[ 2 11],44,-1,119,-1,105
1,<environment.Job instance at 0x7feca40848c0>,55,24,[5 2],56,-1,183,-1,159
1,<environment.Job instance at 0x7feca3e10500>,60,25,[6 2],61,-1,211,-1,186
1,<environment.Job instance at 0x7feca44efaf0>,69,13,[ 1 11],70,-1,218,-1,205
1,<environment.Job instance at 0x7fec9a0f18c0>,70,25,[5 5],71,-1,233,-1,208
1,<environment.Job instance at 0x7fec9a65e640>,73,3,[ 4 11],74,-1,211,-1,208
1,<environment.Job instance at 0x7fec9afe2370>,88,16,[14  4],89,-1,286,-1,270
1,<environment.Job instance at 0x7fec9a648690>,97,27,[8 5],98,-1,339,-1,312
1,<environment.Job instance at 0x7fec9a648640>,99,3,[ 1 12],100,-1,315,-1,312
1,<environment.Job instance at 0x7fec9a65ce60>,103,17,[13  3],104,-1,337,-1,320
1,<environment.Job instance at 0x7fec9a65cf00>,104,3,[13  1],105,-1,323,-1,320
1,<environment.Job instance at 0x7fec9b1fad20>,115,25,[4 5],116,-1,377,-1,352
1,<environment.Job instance at 0x7fec9b1faa00>,118,1,[ 4 14],119,-1,364,-1,363
1,<environment.Job instance at 0x7fec9af5ea50>,0,18,[3 5],1,-1,19,-1,1
1,<environment.Job instance at 0x7fec9afbddc0>,12,18,[4 8],13,-1,31,-1,13
1,<environment.Job instance at 0x7fec9afbd4b0>,13,15,[ 2 10],14,-1,29,-1,14
1,<environment.Job instance at 0x7fec9a22f370>,17,26,[ 3 10],18,-1,47,-1,21
1,<environment.Job instance at 0x7fec9a22f230>,20,2,[5 4],21,-1,24,-1,22
1,<environment.Job instance at 0x7fec9a22f640>,21,3,[12  2],22,-1,25,-1,22
1,<environment.Job instance at 0x7fec9a22f4b0>,18,12,[10  4],19,-1,35,-1,23
1,<environment.Job instance at 0x7fec9a8811e0>,31,17,[7 4],32,-1,49,-1,32
1,<environment.Job instance at 0x7fec9a881050>,33,14,[ 5 10],34,-1,48,-1,34
1,<environment.Job instance at 0x7fec9a881410>,35,13,[7 4],36,-1,50,-1,37
1,<environment.Job instance at 0x7fec9a881780>,36,16,[3 8],37,-1,53,-1,37
1,<environment.Job instance at 0x7fec9a8818c0>,40,15,[5 5],41,-1,57,-1,42
1,<environment.Job instance at 0x7fec9a881b90>,42,17,[5 7],43,-1,61,-1,44
1,<environment.Job instance at 0x7fec9a87a370>,48,12,[7 5],49,-1,63,-1,51
1,<environment.Job instance at 0x7fec9a87a4b0>,50,18,[9 3],51,-1,69,-1,51
1,<environment.Job instance at 0x7fec9a87a640>,51,17,[9 4],52,-1,69,-1,52
1,<environment.Job instance at 0x7fec9a87abe0>,56,17,[4 8],57,-1,75,-1,58
1,<environment.Job instance at 0x7fec9a87ac30>,58,16,[8 4],59,-1,75,-1,59
1,<environment.Job instance at 0x7fec9a87adc0>,59,17,[5 6],60,-1,77,-1,60
1,<environment.Job instance at 0x7fec9a87ae60>,60,15,[3 7],61,-1,76,-1,61
1,<environment.Job instance at 0x7fec9a87b230>,66,15,[4 6],67,-1,82,-1,67
1,<environment.Job instance at 0x7fec9a87b5f0>,67,13,[7 1],68,-1,81,-1,68
1,<environment.Job instance at 0x7fec9a8834b0>,70,12,[3 8],71,-1,83,-1,71
1,<environment.Job instance at 0x7fec9a883c30>,71,18,[7 1],72,-1,90,-1,72
1,<environment.Job instance at 0x7fec9a883910>,75,16,[3 5],76,-1,92,-1,76
1,<environment.Job instance at 0x7fec9a883e10>,76,14,[6 2],77,-1,91,-1,77
1,<environment.Job instance at 0x7fec9a87ad20>,57,14,[5 6],58,-1,93,-1,79
1,<environment.Job instance at 0x7fec9afc6460>,79,14,[7 3],80,-1,95,-1,81
1,<environment.Job instance at 0x7fec9ab5beb0>,81,26,[7 2],82,-1,108,-1,82
1,<environment.Job instance at 0x7fec9a20ea50>,82,17,[1 5],83,-1,100,-1,83
1,<environment.Job instance at 0x7fec9a5e6050>,84,18,[4 8],85,-1,104,-1,86
1,<environment.Job instance at 0x7fec9a8837d0>,73,15,[ 2 12],74,-1,107,-1,92
1,<environment.Job instance at 0x7fec9b3f9fa0>,88,15,[10  2],89,-1,107,-1,92
1,<environment.Job instance at 0x7fec9b20a190>,91,23,[5 9],92,-1,118,-1,95
1,<environment.Job instance at 0x7fec9a22f3c0>,19,12,[5 8],20,-1,109,-1,97
1,<environment.Job instance at 0x7fec9afe67d0>,89,13,[4 7],90,-1,110,-1,97
1,<environment.Job instance at 0x7fec9b01da00>,97,22,[2 9],98,-1,127,-1,105
1,<environment.Job instance at 0x7fec9affde60>,100,13,[5 8],101,-1,118,-1,105
1,<environment.Job instance at 0x7fec9a5250f0>,101,16,[5 2],102,-1,121,-1,105
1,<environment.Job instance at 0x7fec9ab65640>,103,15,[ 3 10],104,-1,120,-1,105
1,<environment.Job instance at 0x7fec9ab655a0>,104,12,[7 5],105,-1,117,-1,105
1,<environment.Job instance at 0x7fec9ab65460>,107,16,[8 4],108,-1,138,-1,122
1,<environment.Job instance at 0x7fec9ab65a50>,108,26,[2 5],109,-1,148,-1,122
1,<environment.Job instance at 0x7fec9a87a050>,10,2,[13  2],11,-1,20,-1,18
1,<environment.Job instance at 0x7fec9a23ed20>,14,1,[12  5],15,-1,22,-1,21
1,<environment.Job instance at 0x7fec9a86d9b0>,17,26,[ 3 10],18,-1,55,-1,29
1,<environment.Job instance at 0x7fec9a86da00>,21,3,[12  2],22,-1,35,-1,32
1,<environment.Job instance at 0x7fec9a792960>,34,3,[14  3],35,-1,64,-1,61
1,<environment.Job instance at 0x7fec9a4237d0>,46,1,[11  3],47,-1,97,-1,96
1,<environment.Job instance at 0x7fec9af42960>,53,14,[14  1],54,-1,135,-1,121
1,<environment.Job instance at 0x7fec9af27f00>,62,17,[ 5 14],63,-1,182,-1,165
1,<environment.Job instance at 0x7fec9a609500>,73,15,[ 2 12],74,-1,215,-1,200
1,<environment.Job instance at 0x7fec9b13dcd0>,78,2,[13  1],79,-1,225,-1,223
1,<environment.Job instance at 0x7fec9b125140>,81,26,[7 2],82,-1,264,-1,238
1,<environment.Job instance at 0x7fec9b14b230>,91,23,[5 9],92,-1,296,-1,273
1,<environment.Job instance at 0x7fec9b14b0a0>,93,3,[ 1 14],94,-1,276,-1,273
1,<environment.Job instance at 0x7fec9b14e8c0>,96,1,[ 3 13],97,-1,275,-1,274
1,<environment.Job instance at 0x7fec9a653e10>,108,26,[2 5],109,-1,347,-1,321
1,<environment.Job instance at 0x7fec9a64a500>,116,24,[2 9],117,-1,386,-1,362
1,<environment.Job instance at 0x7fec9a64a8c0>,117,12,[ 2 12],118,-1,374,-1,362
1,<environment.Job instance at 0x7fec9a657730>,118,14,[13  4],119,-1,376,-1,362
1,<environment.Job instance at 0x7fec9a8835a0>,1,16,[8 4],2,-1,18,-1,2
1,<environment.Job instance at 0x7fec9a238a50>,5,15,[9 1],6,-1,23,-1,8
1,<environment.Job instance at 0x7fec9b416410>,7,16,[8 4],8,-1,24,-1,8
1,<environment.Job instance at 0x7fec9b3fa460>,13,13,[10  3],14,-1,28,-1,15
1,<environment.Job instance at 0x7fec9b4005a0>,17,14,[4 7],18,-1,32,-1,18
1,<environment.Job instance at 0x7fec9b400c80>,20,12,[9 4],21,-1,33,-1,21
1,<environment.Job instance at 0x7fec9b400be0>,21,23,[1 8],22,-1,45,-1,22
1,<environment.Job instance at 0x7fec9b400f00>,22,14,[3 7],23,-1,37,-1,23
1,<environment.Job instance at 0x7fec9b400910>,23,16,[ 5 10],24,-1,40,-1,24
1,<environment.Job instance at 0x7fec9b3fa2d0>,14,14,[5 3],15,-1,38,-1,24
1,<environment.Job instance at 0x7fec9b4001e0>,24,17,[3 5],25,-1,42,-1,25
1,<environment.Job instance at 0x7fec9b400320>,25,15,[ 1 10],26,-1,42,-1,27
1,<environment.Job instance at 0x7fec9b400dc0>,26,13,[ 5 11],27,-1,41,-1,28
1,<environment.Job instance at 0x7fec9b429640>,36,25,[8 1],37,-1,62,-1,37
1,<environment.Job instance at 0x7fec9b4295f0>,37,18,[ 1 10],38,-1,56,-1,38
1,<environment.Job instance at 0x7fec9b4305f0>,41,3,[4 5],42,-1,45,-1,42
1,<environment.Job instance at 0x7fec9b4301e0>,43,16,[9 5],44,-1,76,-1,60
1,<environment.Job instance at 0x7fec9b430f50>,44,28,[7 4],45,-1,89,-1,61
1,<environment.Job instance at 0x7fec9b430a50>,45,20,[7 2],46,-1,81,-1,61
1,<environment.Job instance at 0x7fec9a227b40>,54,19,[1 8],55,-1,84,-1,65
1,<environment.Job instance at 0x7fec9a23e690>,56,17,[8 4],57,-1,85,-1,68
1,<environment.Job instance at 0x7fec9b4300f0>,47,17,[5 6],48,-1,85,-1,68
1,<environment.Job instance at 0x7fec9b2c79b0>,50,14,[6 1],51,-1,85,-1,71
1,<environment.Job instance at 0x7fec9b2c7280>,51,17,[9 3],52,-1,89,-1,72
1,<environment.Job instance at 0x7fec9b414b40>,65,20,[5 5],66,-1,94,-1,74
1,<environment.Job instance at 0x7fec9b414dc0>,66,18,[7 3],67,-1,94,-1,76
1,<environment.Job instance at 0x7fec9a208550>,60,13,[8 4],61,-1,89,-1,76
1,<environment.Job instance at 0x7fec9b4144b0>,63,20,[4 5],64,-1,102,-1,82
1,<environment.Job instance at 0x7fec9b4145f0>,68,18,[1 5],69,-1,101,-1,83
1,<environment.Job instance at 0x7fec9b414320>,70,16,[ 2 10],71,-1,99,-1,83
1,<environment.Job instance at 0x7fec9b414500>,71,18,[3 9],72,-1,101,-1,83
1,<environment.Job instance at 0x7fec9b414870>,72,15,[5 5],73,-1,98,-1,83
1,<environment.Job instance at 0x7fec9b414a00>,73,15,[1 5],74,-1,98,-1,83
1,<environment.Job instance at 0x7fec9b414190>,62,12,[7 3],63,-1,95,-1,83
1,<environment.Job instance at 0x7fec99ff59b0>,78,13,[8 5],79,-1,96,-1,83
1,<environment.Job instance at 0x7fec99ff5c30>,79,15,[4 6],80,-1,98,-1,83
1,<environment.Job instance at 0x7fec99ff5960>,81,25,[1 6],82,-1,108,-1,83
1,<environment.Job instance at 0x7fec9b3e4c80>,83,26,[10  4],84,-1,110,-1,84
1,<environment.Job instance at 0x7fec9b634730>,84,17,[5 5],85,-1,102,-1,85
1,<environment.Job instance at 0x7fec9b3d5500>,85,24,[4 7],86,-1,110,-1,86
1,<environment.Job instance at 0x7fec9b632410>,87,15,[1 8],88,-1,103,-1,88
1,<environment.Job instance at 0x7fec9b629960>,90,12,[10  4],91,-1,103,-1,91
1,<environment.Job instance at 0x7fec9b414f50>,67,13,[14  1],68,-1,105,-1,92
1,<environment.Job instance at 0x7fec9a124780>,91,15,[10  4],92,-1,108,-1,93
1,<environment.Job instance at 0x7fec9b414c30>,96,14,[9 2],97,-1,111,-1,97
1,<environment.Job instance at 0x7fec9a6fc3c0>,97,28,[7 2],98,-1,126,-1,98
1,<environment.Job instance at 0x7fec9b8b73c0>,89,15,[9 1],90,-1,116,-1,101
1,<environment.Job instance at 0x7fec9abee500>,104,21,[10  5],105,-1,127,-1,106
1,<environment.Job instance at 0x7fec99faa9b0>,107,20,[10  2],108,-1,128,-1,108
1,<environment.Job instance at 0x7fec9a407550>,105,17,[9 3],106,-1,125,-1,108
1,<environment.Job instance at 0x7fec9b8900f0>,108,14,[1 9],109,-1,124,-1,110
1,<environment.Job instance at 0x7fec9a977410>,111,13,[7 4],112,-1,125,-1,112
1,<environment.Job instance at 0x7fec9a651320>,116,14,[8 3],117,-1,132,-1,118
1,<environment.Job instance at 0x7fec9af5f5a0>,117,27,[9 4],118,-1,145,-1,118
1,<environment.Job instance at 0x7fec9ae32690>,16,1,[ 3 11],17,-1,22,-1,21
1,<environment.Job instance at 0x7fec9aa8ea00>,21,23,[1 8],22,-1,61,-1,38
1,<environment.Job instance at 0x7fec9a861190>,26,13,[ 5 11],27,-1,64,-1,51
1,<environment.Job instance at 0x7fec9b6090a0>,36,25,[8 1],37,-1,112,-1,87
1,<environment.Job instance at 0x7fec9b319d20>,44,28,[7 4],45,-1,140,-1,112
1,<environment.Job instance at 0x7fec9b39fd20>,67,13,[14  1],68,-1,205,-1,192
1,<environment.Job instance at 0x7fec9a32db90>,76,2,[14  1],77,-1,230,-1,228
1,<environment.Job instance at 0x7fec9a5f1cd0>,81,25,[1 6],82,-1,268,-1,243
1,<environment.Job instance at 0x7fec9a5f11e0>,82,12,[12  2],83,-1,255,-1,243
1,<environment.Job instance at 0x7fec9a5f1370>,83,26,[10  4],84,-1,272,-1,246
1,<environment.Job instance at 0x7fec9a5f1f00>,85,24,[4 7],86,-1,280,-1,256
1,<environment.Job instance at 0x7fec99ff5a50>,94,13,[ 5 11],95,-1,306,-1,293
1,<environment.Job instance at 0x7fec9b7d8320>,97,28,[7 2],98,-1,339,-1,311
1,<environment.Job instance at 0x7fec9b7d89b0>,99,27,[ 3 10],100,-1,343,-1,316
1,<environment.Job instance at 0x7fec9b3938c0>,102,26,[9 1],103,-1,355,-1,329
1,<environment.Job instance at 0x7fec9b002a50>,106,3,[ 2 14],107,-1,332,-1,329
1,<environment.Job instance at 0x7feca441d280>,117,27,[9 4],118,-1,391,-1,364
1,<environment.Job instance at 0x7fec9b2171e0>,2,18,[2 5],3,-1,21,-1,3
1,<environment.Job instance at 0x7fec9a52b730>,4,15,[10  1],5,-1,21,-1,6
1,<environment.Job instance at 0x7fec9a52b410>,6,14,[2 6],7,-1,21,-1,7
1,<environment.Job instance at 0x7fec9a52b870>,7,15,[6 2],8,-1,23,-1,8
1,<environment.Job instance at 0x7fec9a52bd20>,8,17,[13  5],9,-1,26,-1,9
1,<environment.Job instance at 0x7fec9b217140>,5,15,[8 4],6,-1,24,-1,9
1,<environment.Job instance at 0x7fec9a52b0a0>,9,17,[5 4],10,-1,27,-1,10
1,<environment.Job instance at 0x7fec9a52bc80>,10,16,[1 6],11,-1,27,-1,11
1,<environment.Job instance at 0x7fec9a52bdc0>,12,15,[10  3],13,-1,30,-1,15
1,<environment.Job instance at 0x7fec9a52b0f0>,14,18,[9 3],15,-1,33,-1,15
1,<environment.Job instance at 0x7fec9a52b8c0>,15,16,[3 8],16,-1,32,-1,16
1,<environment.Job instance at 0x7fec9a468e60>,20,14,[1 7],21,-1,35,-1,21
1,<environment.Job instance at 0x7fec9a4681e0>,21,1,[3 9],22,-1,23,-1,22
1,<environment.Job instance at 0x7fec9a468cd0>,24,14,[5 6],25,-1,39,-1,25
1,<environment.Job instance at 0x7fec9a468140>,27,17,[ 5 10],28,-1,45,-1,28
1,<environment.Job instance at 0x7fec9a4683c0>,28,21,[2 5],29,-1,51,-1,30
1,<environment.Job instance at 0x7fec9a4680f0>,30,15,[3 7],31,-1,46,-1,31
1,<environment.Job instance at 0x7fec9a468b90>,31,13,[1 7],32,-1,45,-1,32
1,<environment.Job instance at 0x7fec9a468730>,33,25,[ 1 10],34,-1,59,-1,34
1,<environment.Job instance at 0x7fec9a4680a0>,34,14,[5 3],35,-1,49,-1,35
1,<environment.Job instance at 0x7fec9a453190>,37,19,[ 2 10],38,-1,57,-1,38
1,<environment.Job instance at 0x7fec9a4530a0>,41,18,[9 3],42,-1,60,-1,42
1,<environment.Job instance at 0x7fec9a453e10>,42,14,[5 5],43,-1,57,-1,43
1,<environment.Job instance at 0x7fec9aa49370>,46,14,[9 3],47,-1,61,-1,47
1,<environment.Job instance at 0x7fec9abee6e0>,48,18,[7 1],49,-1,67,-1,49
1,<environment.Job instance at 0x7fec9abee5a0>,49,14,[1 8],50,-1,64,-1,50
1,<environment.Job instance at 0x7fec9abee050>,50,12,[ 1 13],51,-1,63,-1,51
1,<environment.Job instance at 0x7fec9abee230>,53,13,[10  4],54,-1,67,-1,54
1,<environment.Job instance at 0x7feca4413eb0>,57,15,[8 5],58,-1,73,-1,58
1,<environment.Job instance at 0x7fec9a594500>,59,21,[7 2],60,-1,81,-1,60
1,<environment.Job instance at 0x7feca44135f0>,60,13,[4 9],61,-1,74,-1,61
1,<environment.Job instance at 0x7fec9a2c2eb0>,62,16,[8 1],63,-1,79,-1,63
1,<environment.Job instance at 0x7fec9b3c7aa0>,64,14,[ 1 12],65,-1,79,-1,65
1,<environment.Job instance at 0x7fec9b6095f0>,67,21,[10  4],68,-1,89,-1,68
1,<environment.Job instance at 0x7fec9a3f28c0>,71,21,[1 7],72,-1,93,-1,72
1,<environment.Job instance at 0x7feca3dec410>,75,12,[10  3],76,-1,88,-1,76
1,<environment.Job instance at 0x7feca3dec5f0>,76,16,[1 7],77,-1,93,-1,77
1,<environment.Job instance at 0x7fec9ae430f0>,79,14,[2 5],80,-1,94,-1,80
1,<environment.Job instance at 0x7fec9abfb5a0>,80,12,[4 5],81,-1,93,-1,81
1,<environment.Job instance at 0x7fec9abfb500>,81,16,[1 5],82,-1,98,-1,82
1,<environment.Job instance at 0x7fec9abfb550>,82,18,[1 5],83,-1,101,-1,83
1,<environment.Job instance at 0x7fec9b4fc140>,83,15,[2 8],84,-1,99,-1,84
1,<environment.Job instance at 0x7fec9b7b2af0>,84,3,[ 1 12],85,-1,88,-1,85
1,<environment.Job instance at 0x7fec9b50d1e0>,87,13,[ 5 10],88,-1,101,-1,88
1,<environment.Job instance at 0x7fec9b50d8c0>,88,16,[6 5],89,-1,105,-1,89
1,<environment.Job instance at 0x7fec9b50d0f0>,90,25,[6 2],91,-1,116,-1,91
1,<environment.Job instance at 0x7fec9a468d70>,29,23,[5 7],30,-1,116,-1,93
1,<environment.Job instance at 0x7fec9a7c38c0>,97,16,[1 7],98,-1,117,-1,101
1,<environment.Job instance at 0x7feca3decb40>,8,17,[13  5],9,-1,33,-1,16
1,<environment.Job instance at 0x7fec9a717960>,22,13,[13  5],23,-1,79,-1,66
1,<environment.Job instance at 0x7fec9a6cd500>,25,2,[ 2 12],26,-1,80,-1,78
1,<environment.Job instance at 0x7fec9b609dc0>,29,23,[5 7],30,-1,106,-1,83
1,<environment.Job instance at 0x7fec9b353140>,33,25,[ 1 10],34,-1,138,-1,113
1,<environment.Job instance at 0x7fec9a92c500>,36,12,[14  2],37,-1,125,-1,113
1,<environment.Job instance at 0x7fec9a65ae60>,38,1,[ 5 14],39,-1,114,-1,113
1,<environment.Job instance at 0x7fec9a827320>,50,12,[ 1 13],51,-1,158,-1,146
1,<environment.Job instance at 0x7feca42cda00>,55,2,[11  4],56,-1,162,-1,160
1,<environment.Job instance at 0x7fec9a668050>,64,14,[ 1 12],65,-1,198,-1,184
1,<environment.Job instance at 0x7fec9a668b90>,66,23,[ 5 12],67,-1,215,-1,192
1,<environment.Job instance at 0x7fec9a421050>,72,1,[ 4 11],73,-1,210,-1,209
1,<environment.Job instance at 0x7fec9a787f00>,84,3,[ 1 12],85,-1,244,-1,241
1,<environment.Job instance at 0x7fec9a5bd410>,90,25,[6 2],91,-1,296,-1,271
1,<environment.Job instance at 0x7fec9a5bd9b0>,92,3,[14  1],93,-1,274,-1,271
1,<environment.Job instance at 0x7fec9a5bdaf0>,93,1,[ 4 12],94,-1,272,-1,271
1,<environment.Job instance at 0x7fec9a121d20>,101,18,[14  2],102,-1,312,-1,294
1,<environment.Job instance at 0x7fec9a97d960>,105,15,[12  5],106,-1,315,-1,300
1,<environment.Job instance at 0x7fec9af16eb0>,108,20,[ 4 13],109,-1,334,-1,314
1,<environment.Job instance at 0x7fec9af167d0>,107,27,[4 8],108,-1,353,-1,326
1,<environment.Job instance at 0x7fec99ff6cd0>,1,17,[7 1],2,-1,20,-1,3
1,<environment.Job instance at 0x7fec9a5f1cd0>,2,15,[9 5],3,-1,18,-1,3
1,<environment.Job instance at 0x7fec9b14d960>,6,18,[4 9],7,-1,25,-1,7
1,<environment.Job instance at 0x7fec9b14d500>,9,13,[9 3],10,-1,24,-1,11
1,<environment.Job instance at 0x7fec9a610fa0>,12,16,[8 1],13,-1,29,-1,13
1,<environment.Job instance at 0x7fec9b83cfa0>,19,17,[3 5],20,-1,37,-1,20
1,<environment.Job instance at 0x7fec9b83c280>,20,17,[5 8],21,-1,38,-1,21
1,<environment.Job instance at 0x7fec9b14da00>,21,14,[7 5],22,-1,36,-1,22
1,<environment.Job instance at 0x7fec9a048d20>,24,18,[6 5],25,-1,43,-1,25
1,<environment.Job instance at 0x7fec9b8179b0>,29,16,[5 5],30,-1,47,-1,31
1,<environment.Job instance at 0x7fec9b437410>,32,17,[3 5],33,-1,50,-1,33
1,<environment.Job instance at 0x7feca3e51dc0>,35,18,[4 9],36,-1,54,-1,36
1,<environment.Job instance at 0x7fec9a119be0>,36,14,[8 5],37,-1,51,-1,37
1,<environment.Job instance at 0x7fec9a7d6d70>,38,18,[6 5],39,-1,57,-1,39
1,<environment.Job instance at 0x7fec9b2f78c0>,43,18,[6 1],44,-1,62,-1,44
1,<environment.Job instance at 0x7fec9b2f7f50>,44,16,[1 6],45,-1,61,-1,45
1,<environment.Job instance at 0x7fec9b2f7190>,45,16,[10  1],46,-1,63,-1,47
1,<environment.Job instance at 0x7fec9acbe3c0>,46,21,[10  4],47,-1,68,-1,47
1,<environment.Job instance at 0x7fec9b2c4d20>,53,15,[8 2],54,-1,71,-1,56
1,<environment.Job instance at 0x7fec9b2c4e10>,56,2,[ 2 10],57,-1,59,-1,57
1,<environment.Job instance at 0x7fec9b2c4d70>,57,20,[8 3],58,-1,78,-1,58
1,<environment.Job instance at 0x7fec9add0aa0>,59,22,[9 1],60,-1,82,-1,60
1,<environment.Job instance at 0x7fec9b2c4f00>,55,23,[7 3],56,-1,83,-1,60
1,<environment.Job instance at 0x7fec9add0050>,61,16,[1 7],62,-1,78,-1,62
1,<environment.Job instance at 0x7fec9add0500>,66,12,[1 9],67,-1,81,-1,69
1,<environment.Job instance at 0x7fec9add0960>,69,16,[8 4],70,-1,86,-1,70
1,<environment.Job instance at 0x7fec9a013d20>,72,16,[4 7],73,-1,89,-1,73
1,<environment.Job instance at 0x7fec9a013a00>,73,16,[5 9],74,-1,90,-1,74
1,<environment.Job instance at 0x7fec9a013e10>,74,16,[3 5],75,-1,91,-1,75
1,<environment.Job instance at 0x7fec9a0139b0>,75,15,[ 3 10],76,-1,91,-1,76
1,<environment.Job instance at 0x7fec9a013f50>,77,1,[1 9],78,-1,79,-1,78
1,<environment.Job instance at 0x7fec9a0136e0>,81,12,[7 5],82,-1,94,-1,82
1,<environment.Job instance at 0x7fec9b4a1a50>,82,26,[9 3],83,-1,109,-1,83
1,<environment.Job instance at 0x7fec9b4a1820>,83,12,[8 2],84,-1,96,-1,84
1,<environment.Job instance at 0x7fec9b4a1b40>,85,15,[8 3],86,-1,101,-1,86
1,<environment.Job instance at 0x7fec9b4a17d0>,87,13,[9 2],88,-1,101,-1,88
1,<environment.Job instance at 0x7fec9b4a10a0>,90,14,[5 3],91,-1,105,-1,91
1,<environment.Job instance at 0x7fec9a401b40>,92,12,[9 4],93,-1,105,-1,93
1,<environment.Job instance at 0x7fec9a401a50>,93,14,[5 9],94,-1,108,-1,94
1,<environment.Job instance at 0x7fec9a4013c0>,95,18,[6 4],96,-1,114,-1,96
1,<environment.Job instance at 0x7fec9a4010f0>,97,22,[6 4],98,-1,120,-1,98
1,<environment.Job instance at 0x7fec9a4011e0>,100,15,[4 9],101,-1,116,-1,101
1,<environment.Job instance at 0x7fec9a474be0>,104,17,[9 5],105,-1,122,-1,105
1,<environment.Job instance at 0x7fec9a474b40>,106,12,[9 2],107,-1,119,-1,107
1,<environment.Job instance at 0x7fec9a474af0>,107,18,[3 7],108,-1,126,-1,108
1,<environment.Job instance at 0x7fec9a474820>,113,12,[ 4 10],114,-1,126,-1,114
1,<environment.Job instance at 0x7fec9add0b40>,68,18,[5 9],69,-1,139,-1,121
1,<environment.Job instance at 0x7fec9a474550>,114,18,[ 2 10],115,-1,139,-1,121
1,<environment.Job instance at 0x7fec9a401d70>,13,18,[ 5 13],14,-1,39,-1,21
1,<environment.Job instance at 0x7fec9acde410>,47,14,[ 3 12],48,-1,152,-1,138
1,<environment.Job instance at 0x7fec9b0be910>,55,23,[7 3],56,-1,187,-1,164
1,<environment.Job instance at 0x7fec9b5c22d0>,62,18,[ 3 13],63,-1,184,-1,166
1,<environment.Job instance at 0x7fec9b776fa0>,82,26,[9 3],83,-1,266,-1,240
1,<environment.Job instance at 0x7fec9b0590f0>,86,3,[12  4],87,-1,255,-1,252
1,<environment.Job instance at 0x7fec9b02ba50>,96,15,[ 1 11],97,-1,302,-1,287
1,<environment.Job instance at 0x7fec9a2f6410>,108,12,[14  5],109,-1,346,-1,334
1,<environment.Job instance at 0x7feca3fcda50>,118,23,[1 5],119,-1,408,-1,385
1,<environment.Job instance at 0x7fec9b18b500>,1,17,[8 4],2,-1,20,-1,3
1,<environment.Job instance at 0x7fec9a6fc5f0>,3,18,[10  4],4,-1,22,-1,4
1,<environment.Job instance at 0x7fec9a6fc140>,4,14,[ 4 10],5,-1,19,-1,5
1,<environment.Job instance at 0x7fec9a6fc500>,5,12,[1 8],6,-1,18,-1,6
1,<environment.Job instance at 0x7fec9a7b86e0>,2,15,[1 9],3,-1,22,-1,7
1,<environment.Job instance at 0x7fec9a6fc410>,7,20,[5 3],8,-1,28,-1,8
1,<environment.Job instance at 0x7fec9a6fcd70>,10,16,[10  2],11,-1,28,-1,12
1,<environment.Job instance at 0x7fec9a6fcb90>,11,16,[ 2 10],12,-1,29,-1,13
1,<environment.Job instance at 0x7fec9a6fc050>,13,16,[1 9],14,-1,30,-1,14
1,<environment.Job instance at 0x7fec9b3354b0>,19,17,[ 1 11],20,-1,37,-1,20
1,<environment.Job instance at 0x7fec9b335870>,20,17,[1 7],21,-1,39,-1,22
1,<environment.Job instance at 0x7fec9b335a00>,25,16,[2 9],26,-1,42,-1,26
1,<environment.Job instance at 0x7fec9a7f0fa0>,39,13,[9 4],40,-1,54,-1,41
1,<environment.Job instance at 0x7fec9ae32f50>,44,27,[5 1],45,-1,80,-1,53
1,<environment.Job instance at 0x7fec9a7f0140>,37,24,[1 8],38,-1,77,-1,53
1,<environment.Job instance at 0x7fec9ae324b0>,46,13,[4 9],47,-1,66,-1,53
1,<environment.Job instance at 0x7fec9a6fc9b0>,21,13,[8 2],22,-1,66,-1,53
1,<environment.Job instance at 0x7fec9ae32dc0>,49,12,[4 7],50,-1,65,-1,53
1,<environment.Job instance at 0x7fec9ae32690>,51,18,[5 6],52,-1,71,-1,53
1,<environment.Job instance at 0x7fec9ae32230>,54,14,[ 4 10],55,-1,74,-1,60
1,<environment.Job instance at 0x7fec9b2e5e60>,56,15,[1 6],57,-1,75,-1,60
1,<environment.Job instance at 0x7fec9ae32320>,43,18,[1 7],44,-1,80,-1,62
1,<environment.Job instance at 0x7fec9b2e5b90>,55,16,[6 5],56,-1,78,-1,62
1,<environment.Job instance at 0x7fec9b2e5f00>,57,18,[3 8],58,-1,80,-1,62
1,<environment.Job instance at 0x7fec9b2e5960>,59,14,[2 7],60,-1,79,-1,65
1,<environment.Job instance at 0x7fec9ae32be0>,42,24,[7 2],43,-1,90,-1,66
1,<environment.Job instance at 0x7fec9a077b90>,63,15,[9 4],64,-1,82,-1,67
1,<environment.Job instance at 0x7fec9a0772d0>,62,16,[3 7],63,-1,83,-1,67
1,<environment.Job instance at 0x7fec9a077aa0>,67,18,[2 8],68,-1,86,-1,68
1,<environment.Job instance at 0x7fec9ad622d0>,72,16,[6 4],73,-1,89,-1,73
1,<environment.Job instance at 0x7fec9ad62460>,73,12,[10  2],74,-1,89,-1,77
1,<environment.Job instance at 0x7fec9ad62370>,76,18,[ 2 10],77,-1,97,-1,79
1,<environment.Job instance at 0x7fec9b4299b0>,80,15,[8 4],81,-1,97,-1,82
1,<environment.Job instance at 0x7fec9b429b90>,82,17,[1 7],83,-1,100,-1,83
1,<environment.Job instance at 0x7fec9b429a00>,87,15,[ 3 10],88,-1,110,-1,95
1,<environment.Job instance at 0x7fec9b429780>,81,18,[7 3],82,-1,123,-1,105
1,<environment.Job instance at 0x7fec9a2173c0>,90,17,[5 2],91,-1,123,-1,106
1,<environment.Job instance at 0x7fec9a217b40>,92,16,[1 7],93,-1,122,-1,106
1,<environment.Job instance at 0x7fec9a217910>,91,21,[8 4],92,-1,127,-1,106
1,<environment.Job instance at 0x7fec9a2175a0>,95,18,[4 5],96,-1,124,-1,106
1,<environment.Job instance at 0x7fec9a217d70>,97,18,[2 7],98,-1,124,-1,106
1,<environment.Job instance at 0x7fec9a7f0be0>,34,12,[ 3 12],35,-1,118,-1,106
1,<environment.Job instance at 0x7fec9a217f50>,96,12,[2 8],97,-1,118,-1,106
1,<environment.Job instance at 0x7fec9a217a00>,100,15,[6 1],101,-1,121,-1,106
1,<environment.Job instance at 0x7fec9b0231e0>,104,20,[8 2],105,-1,127,-1,107
1,<environment.Job instance at 0x7fec9a455c80>,105,14,[4 9],106,-1,121,-1,107
1,<environment.Job instance at 0x7fec9b8a6690>,110,21,[10  5],111,-1,132,-1,111
1,<environment.Job instance at 0x7fec9a78e640>,113,19,[7 1],114,-1,133,-1,114
1,<environment.Job instance at 0x7fec9b0a7690>,114,12,[9 5],115,-1,131,-1,119
1,<environment.Job instance at 0x7fec9b429c80>,16,17,[13  4],17,-1,64,-1,47
1,<environment.Job instance at 0x7fec9ae27730>,19,17,[ 1 11],20,-1,68,-1,51
1,<environment.Job instance at 0x7fec9ad61690>,24,17,[12  2],25,-1,83,-1,66
1,<environment.Job instance at 0x7feca3e5ef50>,32,1,[ 1 11],33,-1,92,-1,91
1,<environment.Job instance at 0x7fec9b7489b0>,34,12,[ 3 12],35,-1,108,-1,96
1,<environment.Job instance at 0x7feca3e5eaf0>,35,17,[14  3],36,-1,113,-1,96
1,<environment.Job instance at 0x7fec9ace3f00>,37,24,[1 8],38,-1,138,-1,114
1,<environment.Job instance at 0x7fec9b02ba50>,44,27,[5 1],45,-1,153,-1,126
1,<environment.Job instance at 0x7fec9a0753c0>,45,1,[ 5 12],46,-1,127,-1,126
1,<environment.Job instance at 0x7fec9b02b820>,42,24,[7 2],43,-1,157,-1,133
1,<environment.Job instance at 0x7fec9b38ce60>,48,3,[13  2],49,-1,136,-1,133
1,<environment.Job instance at 0x7fec9aa380a0>,60,3,[13  5],61,-1,177,-1,174
1,<environment.Job instance at 0x7feca3e25d70>,65,3,[14  3],66,-1,197,-1,194
1,<environment.Job instance at 0x7fec9a96e460>,75,27,[1 5],76,-1,261,-1,234
1,<environment.Job instance at 0x7fec9a418eb0>,79,3,[13  3],80,-1,252,-1,249
1,<environment.Job instance at 0x7fec9a401d70>,115,1,[ 3 11],116,-1,376,-1,375
1,<environment.Job instance at 0x7fec9a62b550>,2,16,[9 2],3,-1,23,-1,7
1,<environment.Job instance at 0x7fec9b086780>,8,12,[ 4 10],9,-1,21,-1,9
1,<environment.Job instance at 0x7fec9b2bca50>,11,15,[9 3],12,-1,27,-1,12
1,<environment.Job instance at 0x7fec9b2bcf50>,12,17,[4 9],13,-1,30,-1,13
1,<environment.Job instance at 0x7fec9b2bcd20>,14,24,[7 3],15,-1,39,-1,15
1,<environment.Job instance at 0x7fec9b2bc870>,15,13,[7 2],16,-1,29,-1,16
1,<environment.Job instance at 0x7fec9b2bc050>,16,21,[5 3],17,-1,38,-1,17
1,<environment.Job instance at 0x7fec9b2bc9b0>,17,22,[1 9],18,-1,40,-1,18
1,<environment.Job instance at 0x7fec9b2bc5f0>,18,16,[1 7],19,-1,35,-1,19
1,<environment.Job instance at 0x7fec9af99140>,20,12,[10  5],21,-1,33,-1,21
1,<environment.Job instance at 0x7fec9af99370>,21,16,[10  1],22,-1,38,-1,22
1,<environment.Job instance at 0x7fec9b3954b0>,23,17,[8 3],24,-1,41,-1,24
1,<environment.Job instance at 0x7fec9af99280>,24,19,[ 5 12],25,-1,44,-1,25
1,<environment.Job instance at 0x7fec9af990a0>,25,27,[2 8],26,-1,53,-1,26
1,<environment.Job instance at 0x7fec9aefb190>,27,15,[5 5],28,-1,43,-1,28
1,<environment.Job instance at 0x7fec9a3a1780>,30,14,[1 9],31,-1,45,-1,31
1,<environment.Job instance at 0x7fec9ad62d70>,31,1,[10  1],32,-1,33,-1,32
1,<environment.Job instance at 0x7fec9b1c6b90>,32,24,[5 7],33,-1,57,-1,33
1,<environment.Job instance at 0x7fec9a62b1e0>,6,23,[ 1 13],7,-1,57,-1,34
1,<environment.Job instance at 0x7fec99fef870>,39,23,[6 1],40,-1,63,-1,40
1,<environment.Job instance at 0x7fec9a075c80>,42,18,[ 3 10],43,-1,61,-1,43
1,<environment.Job instance at 0x7feca440c550>,43,16,[8 1],44,-1,60,-1,44
1,<environment.Job instance at 0x7feca440c730>,44,18,[ 3 10],45,-1,63,-1,45
1,<environment.Job instance at 0x7feca440c910>,46,23,[ 2 10],47,-1,70,-1,47
1,<environment.Job instance at 0x7fec9b11b370>,49,15,[4 9],50,-1,65,-1,50
1,<environment.Job instance at 0x7fec9a63cfa0>,57,17,[5 6],58,-1,76,-1,59
1,<environment.Job instance at 0x7fec9a632eb0>,58,15,[3 5],59,-1,74,-1,59
1,<environment.Job instance at 0x7fec9a632410>,59,14,[ 2 10],60,-1,74,-1,60
1,<environment.Job instance at 0x7fec9a632280>,62,15,[8 3],63,-1,81,-1,66
1,<environment.Job instance at 0x7feca3ec8820>,65,14,[6 3],66,-1,80,-1,66
1,<environment.Job instance at 0x7fec9b2825a0>,69,12,[7 4],70,-1,83,-1,71
1,<environment.Job instance at 0x7fec9b2823c0>,71,2,[ 1 10],72,-1,74,-1,72
1,<environment.Job instance at 0x7fec9a4b1500>,72,14,[5 3],73,-1,87,-1,73
1,<environment.Job instance at 0x7fec9a4b1cd0>,73,13,[10  5],74,-1,87,-1,74
1,<environment.Job instance at 0x7fec9b2829b0>,70,18,[5 6],71,-1,93,-1,75
1,<environment.Job instance at 0x7fec9b2822d0>,75,15,[10  4],76,-1,92,-1,77
1,<environment.Job instance at 0x7fec9a4b11e0>,76,26,[5 7],77,-1,103,-1,77
1,<environment.Job instance at 0x7fec9a29eaf0>,90,16,[4 9],91,-1,109,-1,93
1,<environment.Job instance at 0x7fec9b82b2d0>,89,20,[3 9],90,-1,113,-1,93
1,<environment.Job instance at 0x7fec9b37e320>,84,14,[5 2],85,-1,108,-1,94
1,<environment.Job instance at 0x7fec9b23ce60>,93,14,[5 4],94,-1,109,-1,95
1,<environment.Job instance at 0x7fec9af5fa00>,92,17,[3 6],93,-1,114,-1,97
1,<environment.Job instance at 0x7fec9b682280>,95,14,[8 2],96,-1,111,-1,97
1,<environment.Job instance at 0x7fec9b794320>,101,17,[7 4],102,-1,119,-1,102
1,<environment.Job instance at 0x7fec99f0c500>,103,16,[1 9],104,-1,120,-1,104
1,<environment.Job instance at 0x7fec9b724a50>,107,15,[10  5],108,-1,126,-1,111
1,<environment.Job instance at 0x7fec9b3d3f50>,110,17,[8 2],111,-1,131,-1,114
1,<environment.Job instance at 0x7fec99faa5f0>,113,15,[5 2],114,-1,129,-1,114
1,<environment.Job instance at 0x7fec9a0f14b0>,115,14,[9 4],116,-1,132,-1,118
1,<environment.Job instance at 0x7fec9b3d3780>,109,18,[5 2],110,-1,137,-1,119
1,<environment.Job instance at 0x7fec99fefd70>,6,23,[ 1 13],7,-1,30,-1,7
1,<environment.Job instance at 0x7fec9a81d5a0>,7,2,[ 2 11],8,-1,10,-1,8
1,<environment.Job instance at 0x7fec9b0eda50>,14,24,[7 3],15,-1,45,-1,21
1,<environment.Job instance at 0x7fec99faa0f0>,24,19,[ 5 12],25,-1,58,-1,39
1,<environment.Job instance at 0x7fec9af293c0>,25,27,[2 8],26,-1,66,-1,39
1,<environment.Job instance at 0x7fec9b056050>,29,1,[ 4 13],30,-1,53,-1,52
1,<environment.Job instance at 0x7feca3ffceb0>,32,24,[5 7],33,-1,91,-1,67
1,<environment.Job instance at 0x7fec9a075d20>,40,1,[11  4],41,-1,75,-1,74
1,<environment.Job instance at 0x7fec9ace3050>,39,23,[6 1],40,-1,110,-1,87
1,<environment.Job instance at 0x7fec9a4b1dc0>,46,23,[ 2 10],47,-1,114,-1,91
1,<environment.Job instance at 0x7fec9b429f50>,50,15,[ 1 11],51,-1,118,-1,103
1,<environment.Job instance at 0x7fec9ad62f00>,51,2,[11  4],52,-1,105,-1,103
1,<environment.Job instance at 0x7fec9a077e60>,52,3,[14  5],53,-1,106,-1,103
1,<environment.Job instance at 0x7fec9a5e12d0>,76,26,[5 7],77,-1,237,-1,211
1,<environment.Job instance at 0x7fec9a5e1910>,79,13,[ 2 14],80,-1,226,-1,213
1,<environment.Job instance at 0x7fec9a5e1780>,86,3,[ 4 11],87,-1,235,-1,232
1,<environment.Job instance at 0x7fec9a5e1550>,91,23,[8 4],92,-1,276,-1,253
1,<environment.Job instance at 0x7fec9a5e15f0>,94,3,[11  3],95,-1,256,-1,253
1,<environment.Job instance at 0x7fec9a5e1500>,96,2,[ 2 12],97,-1,269,-1,267
1,<environment.Job instance at 0x7feca43477d0>,105,27,[6 2],106,-1,333,-1,306
1,<environment.Job instance at 0x7feca4347dc0>,108,3,[ 3 12],109,-1,309,-1,306
1,<environment.Job instance at 0x7fec9b432f50>,1,18,[1 7],2,-1,20,-1,2
1,<environment.Job instance at 0x7fec9ade7b40>,14,18,[7 1],15,-1,34,-1,16
1,<environment.Job instance at 0x7fec9adf52d0>,24,18,[ 4 10],25,-1,44,-1,26
1,<environment.Job instance at 0x7fec9adf59b0>,28,22,[10  4],29,-1,51,-1,29
1,<environment.Job instance at 0x7fec9adf5960>,30,18,[1 7],31,-1,49,-1,31
1,<environment.Job instance at 0x7fec9adf5d70>,31,21,[5 8],32,-1,53,-1,32
1,<environment.Job instance at 0x7fec9adf5dc0>,34,18,[3 8],35,-1,53,-1,35
1,<environment.Job instance at 0x7fec9adf6370>,37,25,[6 5],38,-1,63,-1,38
1,<environment.Job instance at 0x7fec9adf5820>,25,12,[10  4],26,-1,50,-1,38
1,<environment.Job instance at 0x7fec9adf6a50>,43,13,[ 4 10],44,-1,58,-1,45
1,<environment.Job instance at 0x7fec9adf6b90>,44,15,[10  3],45,-1,60,-1,45
1,<environment.Job instance at 0x7fec9adf6aa0>,47,13,[5 6],48,-1,62,-1,49
1,<environment.Job instance at 0x7fec9adf6eb0>,49,13,[ 3 12],50,-1,63,-1,50
1,<environment.Job instance at 0x7fec9adeb140>,51,14,[4 6],52,-1,66,-1,52
1,<environment.Job instance at 0x7fec9adf6e10>,48,25,[5 7],49,-1,79,-1,54
1,<environment.Job instance at 0x7feca419b9b0>,5,1,[ 4 14],6,-1,7,-1,6
1,<environment.Job instance at 0x7fec9adf6280>,16,14,[ 5 11],17,-1,36,-1,22
1,<environment.Job instance at 0x7fec9ae13550>,19,22,[14  5],20,-1,46,-1,24
1,<environment.Job instance at 0x7fec9ae0baf0>,22,12,[11  2],23,-1,37,-1,25
1,<environment.Job instance at 0x7feca41e7140>,37,25,[6 5],38,-1,89,-1,64
1,<environment.Job instance at 0x7feca4347730>,48,25,[5 7],49,-1,127,-1,102
1,<environment.Job instance at 0x7feca4347f50>,49,13,[ 3 12],50,-1,115,-1,102
1,<environment.Job instance at 0x7fec9a5e1550>,58,3,[12  5],59,-1,122,-1,119
1,<environment.Job instance at 0x7fec9a5e1af0>,65,26,[14  3],66,-1,177,-1,151
1,<environment.Job instance at 0x7fec9a5e1140>,67,28,[6 3],68,-1,195,-1,167
1,<environment.Job instance at 0x7fec9a80d7d0>,76,2,[14  2],77,-1,177,-1,175
1,<environment.Job instance at 0x7fec9a80ddc0>,77,3,[13  2],78,-1,178,-1,175
1,<environment.Job instance at 0x7fec9ae325f0>,89,18,[13  1],90,-1,242,-1,224
1,<environment.Job instance at 0x7fec9b2e5410>,92,25,[2 8],93,-1,263,-1,238
1,<environment.Job instance at 0x7fec9ad62be0>,94,15,[ 3 14],95,-1,253,-1,238
1,<environment.Job instance at 0x7fec9b429f00>,100,12,[ 3 11],101,-1,270,-1,258
1,<environment.Job instance at 0x7fec9a633140>,101,28,[1 5],102,-1,286,-1,258
1,<environment.Job instance at 0x7fec9a984af0>,111,16,[ 3 14],112,-1,321,-1,305
1,<environment.Job instance at 0x7feca3ffceb0>,110,27,[3 8],111,-1,334,-1,307
1,<environment.Job instance at 0x7fd49c8d86e0>,0,18,[ 2 10],1,-1,20,-1,2
1,<environment.Job instance at 0x7fd49c8d8730>,4,18,[10  4],5,-1,41,-1,23
1,<environment.Job instance at 0x7fd4932e8a50>,3,18,[ 3 10],4,-1,41,-1,23
1,<environment.Job instance at 0x7fd4932e8d20>,8,17,[ 2 10],9,-1,43,-1,26
1,<environment.Job instance at 0x7fd4932e8dc0>,9,17,[ 4 10],10,-1,53,-1,36
1,<environment.Job instance at 0x7fd49c8d88c0>,1,15,[ 1 14],2,-1,51,-1,36
1,<environment.Job instance at 0x7fd4932eb280>,16,12,[1 8],17,-1,48,-1,36
1,<environment.Job instance at 0x7fd4932eb3c0>,18,16,[8 5],19,-1,55,-1,39
1,<environment.Job instance at 0x7fd4932eb460>,19,17,[12  3],20,-1,56,-1,39
1,<environment.Job instance at 0x7fd4932eb6e0>,23,18,[5 2],24,-1,59,-1,41
1,<environment.Job instance at 0x7fd4932eb960>,26,22,[2 9],27,-1,63,-1,41
1,<environment.Job instance at 0x7fd4932ebaa0>,29,13,[1 6],30,-1,55,-1,42
1,<environment.Job instance at 0x7fd4932e8af0>,6,12,[11  4],7,-1,61,-1,49
1,<environment.Job instance at 0x7fd4932ebbe0>,31,17,[4 9],32,-1,68,-1,51
1,<environment.Job instance at 0x7fd4932ebc80>,32,17,[9 3],33,-1,68,-1,51
1,<environment.Job instance at 0x7fd4932ebe60>,35,16,[8 1],36,-1,67,-1,51
1,<environment.Job instance at 0x7fd4932f03c0>,39,18,[5 8],40,-1,70,-1,52
1,<environment.Job instance at 0x7fd4932f0910>,42,14,[8 4],43,-1,70,-1,56
1,<environment.Job instance at 0x7fd4932f0af0>,43,28,[6 4],44,-1,84,-1,56
1,<environment.Job instance at 0x7fd4932f0960>,44,17,[ 5 12],45,-1,73,-1,56
1,<environment.Job instance at 0x7fd4932f0a00>,45,16,[6 2],46,-1,75,-1,59
1,<environment.Job instance at 0x7fd4932f02d0>,38,12,[3 6],39,-1,71,-1,59
1,<environment.Job instance at 0x7fd4932e8be0>,5,13,[5 9],6,-1,72,-1,59
1,<environment.Job instance at 0x7fd4932f0dc0>,50,27,[9 1],51,-1,87,-1,60
1,<environment.Job instance at 0x7fd4932e8c80>,7,14,[5 1],8,-1,74,-1,60
1,<environment.Job instance at 0x7fd4932f24b0>,55,17,[4 7],56,-1,89,-1,72
1,<environment.Job instance at 0x7fd4932f25f0>,56,18,[4 5],57,-1,91,-1,73
1,<environment.Job instance at 0x7fd4932f0d20>,48,13,[6 1],49,-1,86,-1,73
1,<environment.Job instance at 0x7fd4932f2dc0>,62,20,[9 1],63,-1,93,-1,73
1,<environment.Job instance at 0x7fd4932f2960>,60,24,[ 3 10],61,-1,97,-1,73
1,<environment.Job instance at 0x7fd4932f2a50>,63,15,[1 5],64,-1,88,-1,73
1,<environment.Job instance at 0x7fd4932f30a0>,67,26,[5 4],68,-1,107,-1,81
1,<environment.Job instance at 0x7fd4932f3140>,68,22,[5 6],69,-1,103,-1,81
1,<environment.Job instance at 0x7fd4932f2230>,54,14,[1 7],55,-1,104,-1,90
1,<environment.Job instance at 0x7fd4932f3280>,70,18,[5 5],71,-1,109,-1,91
1,<environment.Job instance at 0x7fd4932f3460>,72,14,[9 1],73,-1,105,-1,91
1,<environment.Job instance at 0x7fd4932f2410>,53,18,[ 4 12],54,-1,113,-1,95
1,<environment.Job instance at 0x7fd4932f3a50>,77,15,[4 7],78,-1,111,-1,96
1,<environment.Job instance at 0x7fd4932f3be0>,79,17,[2 7],80,-1,114,-1,97
1,<environment.Job instance at 0x7fd4932f50a0>,85,19,[14  4],86,-1,116,-1,97
1,<environment.Job instance at 0x7fd4932f5280>,88,12,[3 5],89,-1,109,-1,97
1,<environment.Job instance at 0x7fd4932f3a00>,78,19,[8 4],79,-1,116,-1,97
1,<environment.Job instance at 0x7fd4932f3e60>,84,12,[3 5],85,-1,109,-1,97
1,<environment.Job instance at 0x7fd4932f5820>,91,16,[5 8],92,-1,113,-1,97
1,<environment.Job instance at 0x7fd4932ebf00>,37,14,[5 5],38,-1,112,-1,98
1,<environment.Job instance at 0x7fd4932f5a00>,95,23,[3 7],96,-1,121,-1,98
1,<environment.Job instance at 0x7fd4932f5730>,93,12,[4 9],94,-1,116,-1,104
1,<environment.Job instance at 0x7fd4932df910>,102,27,[ 3 13],103,-1,132,-1,105
1,<environment.Job instance at 0x7fd493325640>,98,12,[10  1],99,-1,124,-1,112
1,<environment.Job instance at 0x7fd4932dfaa0>,103,17,[5 6],104,-1,129,-1,112
1,<environment.Job instance at 0x7fd4932df5f0>,108,20,[5 7],109,-1,132,-1,112
1,<environment.Job instance at 0x7fd49332de10>,105,1,[3 6],106,-1,113,-1,112
1,<environment.Job instance at 0x7fd493473910>,111,18,[ 3 13],112,-1,130,-1,112
1,<environment.Job instance at 0x7fd4932dfc30>,100,18,[7 5],101,-1,134,-1,116
1,<environment.Job instance at 0x7fd49351b280>,115,14,[9 1],116,-1,130,-1,116
1,<environment.Job instance at 0x7fd4932dfa50>,104,17,[5 4],105,-1,134,-1,117
1,<environment.Job instance at 0x7fd4932bf1e0>,110,20,[5 7],111,-1,144,-1,124
1,<environment.Job instance at 0x7fd49339ad20>,116,15,[9 2],117,-1,139,-1,124
1,<environment.Job instance at 0x7fd493392730>,121,18,[11  5],122,-1,145,-1,127
1,<environment.Job instance at 0x7fd493392640>,122,14,[14  1],123,-1,141,-1,127
1,<environment.Job instance at 0x7fd493405550>,124,15,[9 1],125,-1,142,-1,127
1,<environment.Job instance at 0x7fd493491910>,119,16,[1 8],120,-1,143,-1,127
1,<environment.Job instance at 0x7fd4932f0140>,1,15,[ 1 14],2,-1,17,-1,2
1,<environment.Job instance at 0x7fd49c8d8870>,6,12,[11  4],7,-1,19,-1,7
1,<environment.Job instance at 0x7fd49340d780>,19,17,[12  3],20,-1,67,-1,50
1,<environment.Job instance at 0x7fd49340b320>,22,2,[12  3],23,-1,62,-1,60
1,<environment.Job instance at 0x7fd493398190>,43,28,[6 4],44,-1,166,-1,138
1,<environment.Job instance at 0x7fd493398140>,44,17,[ 5 12],45,-1,155,-1,138
1,<environment.Job instance at 0x7fd4933985a0>,50,27,[9 1],51,-1,179,-1,152
1,<environment.Job instance at 0x7fd4933f5730>,52,3,[ 3 11],53,-1,155,-1,152
1,<environment.Job instance at 0x7fd493371690>,53,18,[ 4 12],54,-1,170,-1,152
1,<environment.Job instance at 0x7fd4933977d0>,60,24,[ 3 10],61,-1,209,-1,185
1,<environment.Job instance at 0x7fd4934074b0>,67,26,[5 4],68,-1,226,-1,200
1,<environment.Job instance at 0x7fd493349c30>,81,17,[ 4 14],82,-1,256,-1,239
1,<environment.Job instance at 0x7fd4932d33c0>,85,19,[14  4],86,-1,260,-1,241
1,<environment.Job instance at 0x7fd4932d6960>,95,23,[3 7],96,-1,294,-1,271
1,<environment.Job instance at 0x7fd4932cb230>,102,27,[ 3 13],103,-1,316,-1,289
1,<environment.Job instance at 0x7fd4932dc1e0>,111,18,[ 3 13],112,-1,333,-1,315
1,<environment.Job instance at 0x7fd4932d89b0>,117,18,[ 3 12],118,-1,348,-1,330
1,<environment.Job instance at 0x7fd4932d8c30>,121,18,[11  5],122,-1,359,-1,341
1,<environment.Job instance at 0x7fd4932d8f00>,122,14,[14  1],123,-1,355,-1,341
1,<environment.Job instance at 0x7fd492c84a50>,0,16,[9 3],1,-1,21,-1,5
1,<environment.Job instance at 0x7fd492cc1f00>,10,17,[3 8],11,-1,28,-1,11
1,<environment.Job instance at 0x7fd492cc2fa0>,16,15,[6 2],17,-1,36,-1,21
1,<environment.Job instance at 0x7fd492cc1230>,4,15,[10  5],5,-1,37,-1,22
1,<environment.Job instance at 0x7fd492cf95f0>,21,16,[1 9],22,-1,43,-1,27
1,<environment.Job instance at 0x7fd492cbe690>,25,14,[3 8],26,-1,41,-1,27
1,<environment.Job instance at 0x7fd492cc6a00>,27,17,[3 8],28,-1,45,-1,28
1,<environment.Job instance at 0x7fd492d51140>,28,16,[3 9],29,-1,45,-1,29
1,<environment.Job instance at 0x7fd492d510a0>,30,12,[6 3],31,-1,44,-1,32
1,<environment.Job instance at 0x7fd492d51eb0>,36,22,[11  3],37,-1,63,-1,41
1,<environment.Job instance at 0x7fd492d51640>,37,18,[5 2],38,-1,59,-1,41
1,<environment.Job instance at 0x7fd492d554b0>,39,16,[3 5],40,-1,57,-1,41
1,<environment.Job instance at 0x7fd492d5b870>,49,23,[2 8],50,-1,91,-1,68
1,<environment.Job instance at 0x7fd492d55e60>,48,14,[4 7],49,-1,82,-1,68
1,<environment.Job instance at 0x7fd492b75c30>,55,17,[10  5],56,-1,85,-1,68
1,<environment.Job instance at 0x7fd492b61910>,56,26,[9 1],57,-1,94,-1,68
1,<environment.Job instance at 0x7fd492b7a730>,54,12,[5 7],55,-1,80,-1,68
1,<environment.Job instance at 0x7fd492cc2320>,18,12,[3 9],19,-1,81,-1,69
1,<environment.Job instance at 0x7fd492b05780>,59,17,[9 2],60,-1,89,-1,72
1,<environment.Job instance at 0x7fd49ca53410>,60,18,[5 1],61,-1,90,-1,72
1,<environment.Job instance at 0x7fd4b7fe9190>,62,14,[8 4],63,-1,86,-1,72
1,<environment.Job instance at 0x7fd4928ec460>,64,17,[10  5],65,-1,89,-1,72
1,<environment.Job instance at 0x7fd492a99b90>,65,16,[ 3 10],66,-1,88,-1,72
1,<environment.Job instance at 0x7fd492d55eb0>,45,25,[3 9],46,-1,97,-1,72
1,<environment.Job instance at 0x7fd4928f4e10>,66,23,[5 8],67,-1,95,-1,72
1,<environment.Job instance at 0x7fd492a27870>,72,14,[9 2],73,-1,89,-1,75
1,<environment.Job instance at 0x7fd492895eb0>,73,27,[5 3],74,-1,103,-1,76
1,<environment.Job instance at 0x7fd492895c80>,74,17,[10  2],75,-1,93,-1,76
1,<environment.Job instance at 0x7fd492895640>,75,17,[5 9],76,-1,98,-1,81
1,<environment.Job instance at 0x7fd492895140>,78,22,[9 2],79,-1,114,-1,92
1,<environment.Job instance at 0x7fd492894460>,81,18,[ 5 11],82,-1,110,-1,92
1,<environment.Job instance at 0x7fd492894b40>,82,17,[10  4],83,-1,109,-1,92
1,<environment.Job instance at 0x7fd49321e500>,63,3,[5 4],64,-1,111,-1,108
1,<environment.Job instance at 0x7fd4928956e0>,80,17,[2 9],81,-1,126,-1,109
1,<environment.Job instance at 0x7fd4928943c0>,86,16,[7 2],87,-1,126,-1,110
1,<environment.Job instance at 0x7fd492894c80>,87,18,[ 1 10],88,-1,128,-1,110
1,<environment.Job instance at 0x7fd492894640>,85,17,[8 1],86,-1,127,-1,110
1,<environment.Job instance at 0x7fd492d515f0>,33,15,[4 8],34,-1,127,-1,112
1,<environment.Job instance at 0x7fd492892870>,94,28,[9 1],95,-1,141,-1,113
1,<environment.Job instance at 0x7fd4928925a0>,96,15,[ 5 10],97,-1,128,-1,113
1,<environment.Job instance at 0x7fd492899870>,98,16,[14  3],99,-1,129,-1,113
1,<environment.Job instance at 0x7fd492892a50>,93,15,[5 6],94,-1,128,-1,113
1,<environment.Job instance at 0x7fd492894fa0>,88,28,[7 4],89,-1,141,-1,113
1,<environment.Job instance at 0x7fd49291e0f0>,102,16,[8 5],103,-1,131,-1,115
1,<environment.Job instance at 0x7fd49c95d5f0>,103,12,[3 8],104,-1,127,-1,115
1,<environment.Job instance at 0x7fd492892b90>,100,15,[7 4],101,-1,130,-1,115
1,<environment.Job instance at 0x7fd492a25dc0>,104,14,[8 5],105,-1,129,-1,115
1,<environment.Job instance at 0x7fd49ca51d20>,108,18,[3 8],109,-1,138,-1,120
1,<environment.Job instance at 0x7fd49ca518c0>,109,16,[9 4],110,-1,136,-1,120
1,<environment.Job instance at 0x7fd49287fb40>,110,28,[7 3],111,-1,148,-1,120
1,<environment.Job instance at 0x7fd49ca52640>,107,3,[4 9],108,-1,123,-1,120
1,<environment.Job instance at 0x7fd492d55410>,38,18,[4 6],39,-1,138,-1,120
1,<environment.Job instance at 0x7fd49287f640>,111,16,[7 4],112,-1,136,-1,120
1,<environment.Job instance at 0x7fd492898140>,114,15,[9 5],115,-1,135,-1,120
1,<environment.Job instance at 0x7fd4928985a0>,116,17,[2 6],117,-1,137,-1,120
1,<environment.Job instance at 0x7fd4928989b0>,117,16,[2 8],118,-1,136,-1,120
1,<environment.Job instance at 0x7fd492897280>,120,18,[8 5],121,-1,139,-1,121
1,<environment.Job instance at 0x7fd492d51f00>,5,15,[ 3 14],6,-1,21,-1,6
1,<environment.Job instance at 0x7fd492d55dc0>,7,12,[14  5],8,-1,20,-1,8
1,<environment.Job instance at 0x7fd492a92820>,36,22,[11  3],37,-1,126,-1,104
1,<environment.Job instance at 0x7fd492bd5f00>,45,25,[3 9],46,-1,175,-1,150
1,<environment.Job instance at 0x7fd492ba94b0>,49,23,[2 8],50,-1,173,-1,150
1,<environment.Job instance at 0x7fd492a823c0>,56,26,[9 1],57,-1,197,-1,171
1,<environment.Job instance at 0x7fd492a41a00>,66,23,[5 8],67,-1,247,-1,224
1,<environment.Job instance at 0x7fd492bd3910>,71,2,[12  1],72,-1,228,-1,226
1,<environment.Job instance at 0x7fd492aa7be0>,73,27,[5 3],74,-1,255,-1,228
1,<environment.Job instance at 0x7fd492a493c0>,79,3,[ 4 12],80,-1,250,-1,247
1,<environment.Job instance at 0x7fd492a57b40>,81,18,[ 5 11],82,-1,265,-1,247
1,<environment.Job instance at 0x7fd492aa4320>,88,28,[7 4],89,-1,329,-1,301
1,<environment.Job instance at 0x7fd492a879b0>,94,28,[9 1],95,-1,348,-1,320
1,<environment.Job instance at 0x7fd492a5b910>,98,16,[14  3],99,-1,342,-1,326
1,<environment.Job instance at 0x7fd492a6b500>,110,28,[7 3],111,-1,420,-1,392
1,<environment.Job instance at 0x7fd492a050a0>,128,12,[12  2],129,-1,478,-1,466
1,<environment.Job instance at 0x7fd4929c6a00>,3,21,[9 5],4,-1,26,-1,5
1,<environment.Job instance at 0x7fd4928d4410>,4,18,[10  2],5,-1,23,-1,5
1,<environment.Job instance at 0x7fd4929c7f50>,12,17,[8 2],13,-1,31,-1,14
1,<environment.Job instance at 0x7fd4929c6550>,13,18,[7 5],14,-1,32,-1,14
1,<environment.Job instance at 0x7fd4929bde60>,19,13,[5 7],20,-1,33,-1,20
1,<environment.Job instance at 0x7fd4929bdf50>,21,16,[6 2],22,-1,38,-1,22
1,<environment.Job instance at 0x7fd492b1c280>,33,18,[9 2],34,-1,56,-1,38
1,<environment.Job instance at 0x7fd492b1c320>,34,18,[ 5 10],35,-1,59,-1,41
1,<environment.Job instance at 0x7fd492b1c820>,30,13,[7 4],31,-1,54,-1,41
1,<environment.Job instance at 0x7fd492b1ca50>,36,16,[5 7],37,-1,57,-1,41
1,<environment.Job instance at 0x7fd4929c6690>,5,12,[12  4],6,-1,54,-1,42
1,<environment.Job instance at 0x7fd4929bd5f0>,28,17,[12  1],29,-1,59,-1,42
1,<environment.Job instance at 0x7fd492b1cb40>,40,17,[4 5],41,-1,59,-1,42
1,<environment.Job instance at 0x7fd492c8b960>,45,18,[9 5],46,-1,84,-1,66
1,<environment.Job instance at 0x7fd492c8b140>,51,15,[10  3],52,-1,85,-1,70
1,<environment.Job instance at 0x7fd492c8ba50>,49,1,[8 5],50,-1,72,-1,71
1,<environment.Job instance at 0x7fd492c8b1e0>,54,16,[8 3],55,-1,87,-1,71
1,<environment.Job instance at 0x7fd4929bdaa0>,1,19,[ 3 14],2,-1,21,-1,2
1,<environment.Job instance at 0x7fd4929bd730>,2,2,[14  5],3,-1,5,-1,3
1,<environment.Job instance at 0x7fd492b1cbe0>,5,12,[12  4],6,-1,18,-1,6
1,<environment.Job instance at 0x7fd492a1cb40>,11,18,[ 5 14],12,-1,43,-1,25
1,<environment.Job instance at 0x7fd492897690>,18,1,[ 5 14],19,-1,30,-1,29
1,<environment.Job instance at 0x7fd492b75640>,23,3,[14  5],24,-1,54,-1,51
1,<environment.Job instance at 0x7fd4929e7870>,28,17,[12  1],29,-1,73,-1,56
1,<environment.Job instance at 0x7fd49298a9b0>,32,1,[13  3],33,-1,71,-1,70
1,<environment.Job instance at 0x7fd4929320f0>,42,27,[ 2 13],43,-1,130,-1,103
1,<environment.Job instance at 0x7fd4929ece10>,48,1,[12  5],49,-1,134,-1,133
1,<environment.Job instance at 0x7fd493131230>,61,18,[ 4 13],62,-1,201,-1,183
1,<environment.Job instance at 0x7fd4936cd140>,67,16,[ 5 13],68,-1,216,-1,200
1,<environment.Job instance at 0x7fd4929697d0>,74,18,[13  2],75,-1,241,-1,223
1,<environment.Job instance at 0x7fd49cabe230>,80,18,[11  4],81,-1,258,-1,240
1,<environment.Job instance at 0x7fd4930ebcd0>,101,25,[10  4],102,-1,353,-1,328
1,<environment.Job instance at 0x7fd492b01f50>,113,24,[3 6],114,-1,398,-1,374
1,<environment.Job instance at 0x7fd49ca524b0>,117,27,[9 5],118,-1,411,-1,384
1,<environment.Job instance at 0x7fd492880cd0>,123,2,[ 3 14],124,-1,403,-1,401
1,<environment.Job instance at 0x7fd4931143c0>,2,17,[9 1],3,-1,21,-1,4
1,<environment.Job instance at 0x7fd492f2b3c0>,3,18,[8 1],4,-1,22,-1,4
1,<environment.Job instance at 0x7fd493114550>,5,27,[5 5],6,-1,33,-1,6
1,<environment.Job instance at 0x7fd493114690>,6,22,[2 8],7,-1,29,-1,7
1,<environment.Job instance at 0x7fd493114640>,7,20,[5 2],8,-1,28,-1,8
1,<environment.Job instance at 0x7fd493114820>,9,17,[2 6],10,-1,28,-1,11
1,<environment.Job instance at 0x7fd493114a00>,12,17,[4 6],13,-1,30,-1,13
1,<environment.Job instance at 0x7fd493114b40>,13,27,[7 5],14,-1,41,-1,14
1,<environment.Job instance at 0x7fd493114f00>,18,14,[2 7],19,-1,33,-1,19
1,<environment.Job instance at 0x7fd49312f280>,21,18,[5 7],22,-1,40,-1,22
1,<environment.Job instance at 0x7fd49312f730>,27,14,[10  3],28,-1,42,-1,28
1,<environment.Job instance at 0x7fd49312f4b0>,25,25,[3 7],26,-1,58,-1,33
1,<environment.Job instance at 0x7fd493114e60>,23,16,[3 5],24,-1,49,-1,33
1,<environment.Job instance at 0x7fd49312f910>,28,13,[8 2],29,-1,46,-1,33
1,<environment.Job instance at 0x7fd49312feb0>,35,16,[10  5],36,-1,52,-1,36
1,<environment.Job instance at 0x7fd49312fe60>,36,13,[8 4],37,-1,50,-1,37
1,<environment.Job instance at 0x7fd49312f870>,32,13,[3 9],33,-1,73,-1,60
1,<environment.Job instance at 0x7fd493731820>,47,16,[2 6],48,-1,78,-1,62
1,<environment.Job instance at 0x7fd4937318c0>,49,16,[ 5 13],50,-1,88,-1,72
1,<environment.Job instance at 0x7fd493731b40>,55,24,[3 9],56,-1,107,-1,83
1,<environment.Job instance at 0x7fd49312ff50>,38,21,[9 5],39,-1,112,-1,91
1,<environment.Job instance at 0x7fd493731410>,56,17,[9 1],57,-1,108,-1,91
1,<environment.Job instance at 0x7fd49312fcd0>,34,12,[13  3],35,-1,107,-1,95
1,<environment.Job instance at 0x7fd493731b90>,59,16,[1 8],60,-1,111,-1,95
1,<environment.Job instance at 0x7fd493734550>,62,17,[10  3],63,-1,112,-1,95
1,<environment.Job instance at 0x7fd493734f00>,72,27,[5 5],73,-1,146,-1,119
1,<environment.Job instance at 0x7fd493734fa0>,74,25,[1 7],75,-1,145,-1,120
1,<environment.Job instance at 0x7fd4937310f0>,54,14,[ 3 14],55,-1,136,-1,122
1,<environment.Job instance at 0x7fd493754190>,76,15,[ 5 10],77,-1,138,-1,123
1,<environment.Job instance at 0x7fd4937346e0>,63,13,[9 5],64,-1,149,-1,136
1,<environment.Job instance at 0x7fd493754230>,77,13,[6 5],78,-1,150,-1,137
1,<environment.Job instance at 0x7fd492f37a50>,84,17,[7 4],85,-1,154,-1,137
1,<environment.Job instance at 0x7fd492f3a280>,86,27,[5 8],87,-1,175,-1,148
1,<environment.Job instance at 0x7fd4936f73c0>,91,24,[4 8],92,-1,175,-1,151
1,<environment.Job instance at 0x7fd493988190>,85,14,[7 3],86,-1,172,-1,158
1,<environment.Job instance at 0x7fd49374f0a0>,95,19,[7 5],96,-1,177,-1,158
1,<environment.Job instance at 0x7fd493727320>,83,18,[4 8],84,-1,190,-1,172
1,<environment.Job instance at 0x7fd49374fa50>,97,12,[10  4],98,-1,184,-1,172
1,<environment.Job instance at 0x7fd49374f730>,102,17,[2 5],103,-1,189,-1,172
1,<environment.Job instance at 0x7fd4936f5c30>,103,14,[8 2],104,-1,186,-1,172
1,<environment.Job instance at 0x7fd49374f460>,106,18,[8 2],107,-1,190,-1,172
1,<environment.Job instance at 0x7fd49374fe60>,96,14,[8 1],97,-1,186,-1,172
1,<environment.Job instance at 0x7fd493700cd0>,107,18,[6 2],108,-1,191,-1,173
1,<environment.Job instance at 0x7fd492c3f730>,109,18,[5 8],110,-1,192,-1,174
1,<environment.Job instance at 0x7fd492c43a50>,111,24,[1 9],112,-1,198,-1,174
1,<environment.Job instance at 0x7fd492c560a0>,110,19,[2 7],111,-1,194,-1,175
1,<environment.Job instance at 0x7fd493e03280>,116,14,[7 5],117,-1,189,-1,175
1,<environment.Job instance at 0x7fd493e03910>,117,23,[10  4],118,-1,198,-1,175
1,<environment.Job instance at 0x7fd493e03a50>,118,14,[3 8],119,-1,189,-1,175
1,<environment.Job instance at 0x7fd493734d70>,4,3,[ 3 12],5,-1,8,-1,5
1,<environment.Job instance at 0x7fd4937342d0>,5,27,[5 5],6,-1,33,-1,6
1,<environment.Job instance at 0x7fd492c4a910>,8,13,[14  4],9,-1,22,-1,9
1,<environment.Job instance at 0x7fd493e02410>,14,13,[14  5],15,-1,42,-1,29
1,<environment.Job instance at 0x7fd493e02550>,13,27,[7 5],14,-1,66,-1,39
1,<environment.Job instance at 0x7fd492880aa0>,25,25,[3 7],26,-1,97,-1,72
1,<environment.Job instance at 0x7fd4935203c0>,30,1,[ 4 12],31,-1,81,-1,80
1,<environment.Job instance at 0x7fd49306bc80>,34,12,[13  3],35,-1,97,-1,85
1,<environment.Job instance at 0x7fd49305ea50>,39,3,[12  1],40,-1,118,-1,115
1,<environment.Job instance at 0x7fd49290b780>,49,16,[ 5 13],50,-1,160,-1,144
1,<environment.Job instance at 0x7fd492a245f0>,54,14,[ 3 14],55,-1,176,-1,162
1,<environment.Job instance at 0x7fd4928f75f0>,55,24,[3 9],56,-1,189,-1,165
1,<environment.Job instance at 0x7fd492b75640>,65,1,[12  4],66,-1,199,-1,198
1,<environment.Job instance at 0x7fd4928957d0>,71,15,[14  1],72,-1,230,-1,215
1,<environment.Job instance at 0x7fd492897500>,72,27,[5 5],73,-1,245,-1,218
1,<environment.Job instance at 0x7fd492a1c8c0>,74,25,[1 7],75,-1,251,-1,226
1,<environment.Job instance at 0x7fd493e04aa0>,86,27,[5 8],87,-1,311,-1,284
1,<environment.Job instance at 0x7fd492ca4050>,91,24,[4 8],92,-1,328,-1,304
1,<environment.Job instance at 0x7fd492ea9aa0>,101,1,[11  1],102,-1,322,-1,321
1,<environment.Job instance at 0x7fd4934da820>,111,24,[1 9],112,-1,388,-1,364
1,<environment.Job instance at 0x7fd49354f0a0>,123,3,[ 5 13],124,-1,401,-1,398
1,<environment.Job instance at 0x7fd492ef1d70>,117,23,[10  4],118,-1,424,-1,401
1,<environment.Job instance at 0x7fd4937a3190>,126,17,[13  2],127,-1,418,-1,401
1,<environment.Job instance at 0x7fd492fa30a0>,127,1,[11  4],128,-1,402,-1,401
1,<environment.Job instance at 0x7fd493268140>,0,18,[4 6],1,-1,19,-1,1
1,<environment.Job instance at 0x7fd492a09d70>,7,18,[1 7],8,-1,26,-1,8
1,<environment.Job instance at 0x7fd492a09a50>,8,19,[1 6],9,-1,28,-1,9
1,<environment.Job instance at 0x7fd492a09960>,13,20,[5 7],14,-1,34,-1,14
1,<environment.Job instance at 0x7fd492a092d0>,17,12,[5 5],18,-1,31,-1,19
1,<environment.Job instance at 0x7fd492a09370>,2,17,[ 2 12],3,-1,20,-1,3
1,<environment.Job instance at 0x7fd492cf9190>,5,24,[10  2],6,-1,41,-1,17
1,<environment.Job instance at 0x7fd493643690>,9,27,[14  1],10,-1,44,-1,17
1,<environment.Job instance at 0x7fd493787eb0>,12,2,[11  4],13,-1,20,-1,18
1,<environment.Job instance at 0x7fd493770280>,15,12,[11  5],16,-1,31,-1,19
1,<environment.Job instance at 0x7fd493770f50>,16,27,[4 5],17,-1,46,-1,19
1,<environment.Job instance at 0x7fd493697fa0>,22,3,[11  3],23,-1,47,-1,44
1,<environment.Job instance at 0x7fd492b1c5a0>,31,15,[ 2 14],32,-1,88,-1,73
1,<environment.Job instance at 0x7fd492cc28c0>,35,12,[ 3 13],36,-1,90,-1,78
1,<environment.Job instance at 0x7fd49309e460>,51,17,[14  3],52,-1,145,-1,128
1,<environment.Job instance at 0x7fd493131dc0>,54,15,[ 2 13],55,-1,146,-1,131
1,<environment.Job instance at 0x7fd493131230>,57,3,[12  4],58,-1,145,-1,142
1,<environment.Job instance at 0x7fd493114370>,59,28,[1 8],60,-1,187,-1,159
1,<environment.Job instance at 0x7fd493e02c30>,68,18,[13  3],69,-1,199,-1,181
1,<environment.Job instance at 0x7fd493e306e0>,75,24,[8 3],76,-1,237,-1,213
1,<environment.Job instance at 0x7fd49cb24be0>,91,13,[12  4],92,-1,295,-1,282
1,<environment.Job instance at 0x7fd4929730a0>,94,24,[4 5],95,-1,321,-1,297
1,<environment.Job instance at 0x7fd492b9f320>,0,17,[2 6],1,-1,18,-1,1
1,<environment.Job instance at 0x7fd492c53f00>,9,21,[1 9],10,-1,32,-1,11
1,<environment.Job instance at 0x7fd492ebd460>,10,27,[6 4],11,-1,38,-1,11
1,<environment.Job instance at 0x7fd492c530a0>,12,15,[10  1],13,-1,29,-1,14
1,<environment.Job instance at 0x7fd492c53230>,14,13,[1 8],15,-1,28,-1,15
1,<environment.Job instance at 0x7fd492c53690>,13,13,[7 5],14,-1,29,-1,16
1,<environment.Job instance at 0x7fd492bcb910>,18,22,[7 5],19,-1,41,-1,19
1,<environment.Job instance at 0x7fd492eed0a0>,20,18,[ 5 10],21,-1,39,-1,21
1,<environment.Job instance at 0x7fd492c272d0>,22,24,[1 6],23,-1,47,-1,23
1,<environment.Job instance at 0x7fd492bd0960>,23,16,[8 5],24,-1,40,-1,24
1,<environment.Job instance at 0x7fd4927b18c0>,24,16,[9 4],25,-1,41,-1,25
1,<environment.Job instance at 0x7fd493a41690>,26,15,[10  4],27,-1,43,-1,28
1,<environment.Job instance at 0x7fd4925e1aa0>,28,17,[3 9],29,-1,46,-1,29
1,<environment.Job instance at 0x7fd49c481320>,30,14,[1 8],31,-1,45,-1,31
1,<environment.Job instance at 0x7fd492c27d20>,27,13,[ 4 10],28,-1,44,-1,31
1,<environment.Job instance at 0x7fd4927b5b90>,38,14,[9 1],39,-1,53,-1,39
1,<environment.Job instance at 0x7fd4927b5cd0>,39,17,[1 9],40,-1,57,-1,40
1,<environment.Job instance at 0x7fd4927b5960>,42,15,[6 2],43,-1,58,-1,43
1,<environment.Job instance at 0x7fd4925dcdc0>,48,18,[6 5],49,-1,67,-1,49
1,<environment.Job instance at 0x7fd4925dc730>,49,18,[ 5 10],50,-1,68,-1,50
1,<environment.Job instance at 0x7fd4925d1dc0>,55,15,[ 1 10],56,-1,72,-1,57
1,<environment.Job instance at 0x7fd4925d1550>,56,12,[ 2 11],57,-1,72,-1,60
1,<environment.Job instance at 0x7fd4927b30a0>,59,12,[4 6],60,-1,73,-1,61
1,<environment.Job instance at 0x7fd4926ec5a0>,62,17,[9 4],63,-1,80,-1,63
1,<environment.Job instance at 0x7fd4926ec4b0>,64,18,[ 4 11],65,-1,84,-1,66
1,<environment.Job instance at 0x7fd4925d1aa0>,58,24,[4 7],59,-1,92,-1,68
1,<environment.Job instance at 0x7fd4927b7b40>,67,15,[4 6],68,-1,83,-1,68
1,<environment.Job instance at 0x7fd493a66b90>,70,20,[4 6],71,-1,91,-1,71
1,<environment.Job instance at 0x7fd4926ec0f0>,65,16,[9 4],66,-1,109,-1,93
1,<environment.Job instance at 0x7fd4927b4eb0>,76,3,[8 3],77,-1,102,-1,99
1,<environment.Job instance at 0x7fd4927b44b0>,75,16,[ 2 11],76,-1,116,-1,100
1,<environment.Job instance at 0x7fd49312ef50>,84,12,[9 1],85,-1,114,-1,102
1,<environment.Job instance at 0x7fd4927b2cd0>,82,17,[ 2 10],83,-1,119,-1,102
1,<environment.Job instance at 0x7fd492ba0780>,88,20,[3 8],89,-1,122,-1,102
1,<environment.Job instance at 0x7fd492ba02d0>,86,13,[4 7],87,-1,115,-1,102
1,<environment.Job instance at 0x7fd4925c9550>,90,24,[10  4],91,-1,126,-1,102
1,<environment.Job instance at 0x7fd493a0b3c0>,91,21,[4 7],92,-1,123,-1,102
1,<environment.Job instance at 0x7fd49c97a0a0>,92,17,[ 2 11],93,-1,119,-1,102
1,<environment.Job instance at 0x7fd493a0bb40>,93,15,[4 9],94,-1,117,-1,102
1,<environment.Job instance at 0x7fd4930e9320>,89,13,[7 4],90,-1,116,-1,103
1,<environment.Job instance at 0x7fd4926c8f00>,96,18,[6 3],97,-1,121,-1,103
1,<environment.Job instance at 0x7fd49303f910>,100,15,[10  4],101,-1,118,-1,103
1,<environment.Job instance at 0x7fd4932e8870>,101,18,[4 8],102,-1,123,-1,105
1,<environment.Job instance at 0x7fd492ba4e10>,102,15,[4 8],103,-1,120,-1,105
1,<environment.Job instance at 0x7fd492ba0af0>,87,3,[8 1],88,-1,108,-1,105
1,<environment.Job instance at 0x7fd4926c92d0>,104,14,[3 8],105,-1,119,-1,105
1,<environment.Job instance at 0x7fd4932e8370>,99,19,[5 5],100,-1,138,-1,119
1,<environment.Job instance at 0x7fd492b72280>,111,12,[5 5],112,-1,131,-1,119
1,<environment.Job instance at 0x7fd49c6b53c0>,108,18,[4 6],109,-1,140,-1,122
1,<environment.Job instance at 0x7fd492b72550>,116,18,[10  2],117,-1,146,-1,128
1,<environment.Job instance at 0x7fd49c6bd460>,118,17,[9 5],119,-1,146,-1,129
1,<environment.Job instance at 0x7fd492b72190>,112,16,[3 8],113,-1,145,-1,129
1,<environment.Job instance at 0x7fd49c4035f0>,119,16,[7 2],120,-1,145,-1,129
1,<environment.Job instance at 0x7fd49c403f50>,121,16,[5 7],122,-1,146,-1,130
1,<environment.Job instance at 0x7fd49c4037d0>,123,13,[5 5],124,-1,143,-1,130
1,<environment.Job instance at 0x7fd49c403d20>,120,16,[ 3 10],121,-1,146,-1,130
1,<environment.Job instance at 0x7fd4926ec410>,10,27,[6 4],11,-1,38,-1,11
1,<environment.Job instance at 0x7fd492686a00>,11,1,[11  4],12,-1,13,-1,12
1,<environment.Job instance at 0x7fd492ae7d70>,22,24,[1 6],23,-1,58,-1,34
1,<environment.Job instance at 0x7fd4929ece10>,34,3,[ 2 12],35,-1,83,-1,80
1,<environment.Job instance at 0x7fd4936972d0>,41,2,[ 3 14],42,-1,101,-1,99
1,<environment.Job instance at 0x7fd492a09500>,46,13,[12  4],47,-1,129,-1,116
1,<environment.Job instance at 0x7fd492a09eb0>,47,27,[9 3],48,-1,144,-1,117
1,<environment.Job instance at 0x7fd493e29be0>,56,12,[ 2 11],57,-1,150,-1,138
1,<environment.Job instance at 0x7fd493e290a0>,58,24,[4 7],59,-1,189,-1,165
1,<environment.Job instance at 0x7fd492fc76e0>,64,18,[ 4 11],65,-1,195,-1,177
1,<environment.Job instance at 0x7fd492fc7c80>,69,3,[14  1],70,-1,197,-1,194
1,<environment.Job instance at 0x7fd492688690>,73,14,[ 1 11],74,-1,211,-1,197
1,<environment.Job instance at 0x7fd492688190>,75,16,[ 2 11],76,-1,214,-1,198
1,<environment.Job instance at 0x7fd4926880a0>,78,2,[13  3],79,-1,205,-1,203
1,<environment.Job instance at 0x7fd49268bf00>,90,24,[10  4],91,-1,275,-1,251
1,<environment.Job instance at 0x7fd49268be60>,92,17,[ 2 11],93,-1,268,-1,251
1,<environment.Job instance at 0x7fd49268b9b0>,94,1,[ 2 11],95,-1,252,-1,251
1,<environment.Job instance at 0x7fd4926ed7d0>,109,1,[ 5 14],110,-1,328,-1,327
1,<environment.Job instance at 0x7fd492689b90>,127,27,[ 2 11],128,-1,438,-1,411
1,<environment.Job instance at 0x7fd492d74460>,8,17,[3 7],9,-1,26,-1,9
1,<environment.Job instance at 0x7fd492d740f0>,10,13,[5 3],11,-1,24,-1,11
1,<environment.Job instance at 0x7fd492d74730>,11,17,[2 7],12,-1,29,-1,12
1,<environment.Job instance at 0x7fd492d74640>,12,17,[6 4],13,-1,30,-1,13
1,<environment.Job instance at 0x7fd492d74d70>,18,12,[ 4 10],19,-1,32,-1,20
1,<environment.Job instance at 0x7fd492d74f50>,20,14,[ 2 10],21,-1,35,-1,21
1,<environment.Job instance at 0x7fd492d710a0>,22,16,[ 3 10],23,-1,39,-1,23
1,<environment.Job instance at 0x7fd492d711e0>,23,18,[5 5],24,-1,42,-1,24
1,<environment.Job instance at 0x7fd492d71140>,24,16,[5 5],25,-1,41,-1,25
1,<environment.Job instance at 0x7fd492d71320>,25,17,[ 3 10],26,-1,43,-1,26
1,<environment.Job instance at 0x7fd492d713c0>,26,13,[3 9],27,-1,40,-1,27
1,<environment.Job instance at 0x7fd492d71550>,28,18,[1 5],29,-1,47,-1,29
1,<environment.Job instance at 0x7fd492d71780>,29,18,[9 5],30,-1,48,-1,30
1,<environment.Job instance at 0x7fd492d71500>,30,19,[4 5],31,-1,50,-1,31
1,<environment.Job instance at 0x7fd492d718c0>,32,13,[9 4],33,-1,46,-1,33
1,<environment.Job instance at 0x7fd492d715f0>,34,16,[2 7],35,-1,51,-1,35
1,<environment.Job instance at 0x7fd492d71e10>,38,16,[8 3],39,-1,55,-1,39
1,<environment.Job instance at 0x7fd492d41140>,40,23,[9 4],41,-1,64,-1,41
1,<environment.Job instance at 0x7fd492d41280>,41,21,[8 2],42,-1,64,-1,43
1,<environment.Job instance at 0x7fd492d412d0>,42,21,[5 7],43,-1,65,-1,44
1,<environment.Job instance at 0x7fd492d41190>,44,17,[9 2],45,-1,63,-1,46
1,<environment.Job instance at 0x7fd492d415f0>,45,18,[5 5],46,-1,64,-1,46
1,<environment.Job instance at 0x7fd492d418c0>,48,28,[10  4],49,-1,77,-1,49
1,<environment.Job instance at 0x7fd492d41cd0>,52,18,[4 7],53,-1,71,-1,53
1,<environment.Job instance at 0x7fd492d41d70>,53,18,[7 1],54,-1,73,-1,55
1,<environment.Job instance at 0x7fd492d41f00>,55,12,[7 1],56,-1,68,-1,56
1,<environment.Job instance at 0x7fd492d41fa0>,56,18,[8 3],57,-1,75,-1,57
1,<environment.Job instance at 0x7fd492d41e10>,54,14,[9 1],55,-1,71,-1,57
1,<environment.Job instance at 0x7fd492d521e0>,60,26,[4 9],61,-1,87,-1,61
1,<environment.Job instance at 0x7fd492d528c0>,65,18,[1 8],66,-1,84,-1,66
1,<environment.Job instance at 0x7fd492d52910>,67,23,[5 3],68,-1,92,-1,69
1,<environment.Job instance at 0x7fd492d52af0>,69,15,[5 7],70,-1,85,-1,70
1,<environment.Job instance at 0x7fd492d52c80>,70,14,[1 5],71,-1,85,-1,71
1,<environment.Job instance at 0x7fd492d52d20>,71,18,[11  2],72,-1,90,-1,72
1,<environment.Job instance at 0x7fd492d52dc0>,72,12,[ 5 13],73,-1,85,-1,73
1,<environment.Job instance at 0x7fd492d52c30>,68,16,[9 4],69,-1,90,-1,74
1,<environment.Job instance at 0x7fd492d52fa0>,75,14,[ 1 10],76,-1,91,-1,77
1,<environment.Job instance at 0x7fd492d44190>,76,18,[7 4],77,-1,95,-1,77
1,<environment.Job instance at 0x7fd492d445f0>,82,14,[3 9],83,-1,109,-1,95
1,<environment.Job instance at 0x7fd492d44dc0>,89,17,[9 2],90,-1,113,-1,96
1,<environment.Job instance at 0x7fd492d44be0>,87,16,[ 3 12],88,-1,112,-1,96
1,<environment.Job instance at 0x7fd492d44af0>,88,15,[7 3],89,-1,111,-1,96
1,<environment.Job instance at 0x7fd492d440a0>,78,14,[1 7],79,-1,110,-1,96
1,<environment.Job instance at 0x7fd492d44c30>,93,22,[5 2],94,-1,118,-1,96
1,<environment.Job instance at 0x7fd492d44d20>,94,18,[5 6],95,-1,114,-1,96
1,<environment.Job instance at 0x7fd492d52e60>,73,24,[ 5 11],74,-1,120,-1,96
1,<environment.Job instance at 0x7fd492d460f0>,95,17,[3 6],96,-1,113,-1,96
1,<environment.Job instance at 0x7fd492d462d0>,96,13,[8 2],97,-1,110,-1,97
1,<environment.Job instance at 0x7fd492d44fa0>,92,3,[7 1],93,-1,100,-1,97
1,<environment.Job instance at 0x7fd492d44e60>,90,14,[10  1],91,-1,112,-1,98
1,<environment.Job instance at 0x7fd492d46460>,97,13,[4 5],98,-1,112,-1,99
1,<environment.Job instance at 0x7fd492d465a0>,100,16,[ 2 10],101,-1,117,-1,101
1,<environment.Job instance at 0x7fd492d46640>,102,15,[5 9],103,-1,118,-1,103
1,<environment.Job instance at 0x7fd492d7a230>,104,14,[6 4],105,-1,119,-1,105
1,<environment.Job instance at 0x7fd49293f7d0>,105,18,[ 5 10],106,-1,124,-1,106
1,<environment.Job instance at 0x7fd49293feb0>,106,25,[6 3],107,-1,132,-1,107
1,<environment.Job instance at 0x7fd492d72a00>,117,18,[3 8],118,-1,136,-1,118
1,<environment.Job instance at 0x7fd492d72190>,118,16,[7 2],119,-1,135,-1,119
1,<environment.Job instance at 0x7fd493e6c460>,121,18,[10  5],122,-1,140,-1,122
1,<environment.Job instance at 0x7fd492c27690>,125,18,[9 2],126,-1,145,-1,127
1,<environment.Job instance at 0x7fd493a0ffa0>,127,20,[1 8],128,-1,148,-1,128
1,<environment.Job instance at 0x7fd492d74e10>,2,1,[12  5],3,-1,4,-1,3
1,<environment.Job instance at 0x7fd4926ede10>,40,23,[9 4],41,-1,158,-1,135
1,<environment.Job instance at 0x7fd49268b870>,48,28,[10  4],49,-1,181,-1,153
1,<environment.Job instance at 0x7fd49268bf00>,58,17,[12  1],59,-1,202,-1,185
1,<environment.Job instance at 0x7fd492688780>,62,16,[13  1],63,-1,208,-1,192
1,<environment.Job instance at 0x7fd492688320>,60,26,[4 9],61,-1,230,-1,204
1,<environment.Job instance at 0x7fd492688c80>,67,23,[5 3],68,-1,241,-1,218
1,<environment.Job instance at 0x7fd492688500>,71,18,[11  2],72,-1,240,-1,222
1,<environment.Job instance at 0x7fd4926889b0>,72,12,[ 5 13],73,-1,234,-1,222
1,<environment.Job instance at 0x7fd492688410>,73,24,[ 5 11],74,-1,246,-1,222
1,<environment.Job instance at 0x7fd492fc7050>,80,13,[11  2],81,-1,263,-1,250
1,<environment.Job instance at 0x7fd493e29aa0>,87,16,[ 3 12],88,-1,298,-1,282
1,<environment.Job instance at 0x7fd492b1c5a0>,106,25,[6 3],107,-1,397,-1,372
1,<environment.Job instance at 0x7fd49ca447d0>,113,2,[14  3],114,-1,385,-1,383
1,<environment.Job instance at 0x7fd49ca445f0>,114,1,[14  5],115,-1,384,-1,383
1,<environment.Job instance at 0x7fd4927b4d20>,123,1,[12  4],124,-1,406,-1,405
1,<environment.Job instance at 0x7fd492d46aa0>,1,21,[4 9],2,-1,23,-1,2
1,<environment.Job instance at 0x7fd49367db90>,3,16,[8 1],4,-1,22,-1,6
1,<environment.Job instance at 0x7fd49367dfa0>,5,23,[8 4],6,-1,29,-1,6
1,<environment.Job instance at 0x7fd4934d73c0>,7,20,[5 7],8,-1,28,-1,8
1,<environment.Job instance at 0x7fd4934d78c0>,8,16,[4 8],9,-1,25,-1,9
1,<environment.Job instance at 0x7fd4934d70f0>,10,15,[2 8],11,-1,26,-1,11
1,<environment.Job instance at 0x7fd4934d7820>,15,16,[10  5],16,-1,34,-1,18
1,<environment.Job instance at 0x7fd4938ae960>,17,16,[1 7],18,-1,34,-1,18
1,<environment.Job instance at 0x7fd4938ae230>,19,18,[2 7],20,-1,38,-1,20
1,<environment.Job instance at 0x7fd4938ae2d0>,23,16,[9 4],24,-1,40,-1,24
1,<environment.Job instance at 0x7fd49305b960>,32,15,[ 2 10],33,-1,50,-1,35
1,<environment.Job instance at 0x7fd493d53d20>,36,19,[2 9],37,-1,56,-1,37
1,<environment.Job instance at 0x7fd49399ddc0>,34,17,[8 1],35,-1,54,-1,37
1,<environment.Job instance at 0x7fd493d53b40>,38,20,[ 1 10],39,-1,60,-1,40
1,<environment.Job instance at 0x7fd493d53eb0>,41,18,[3 8],42,-1,60,-1,42
1,<environment.Job instance at 0x7fd492c62460>,44,15,[4 8],45,-1,60,-1,45
1,<environment.Job instance at 0x7fd4930c5280>,46,16,[1 6],47,-1,63,-1,47
1,<environment.Job instance at 0x7fd493066a50>,47,15,[7 4],48,-1,63,-1,48
1,<environment.Job instance at 0x7fd493066d70>,49,17,[ 1 10],50,-1,67,-1,50
1,<environment.Job instance at 0x7fd4930667d0>,51,28,[5 1],52,-1,98,-1,70
1,<environment.Job instance at 0x7fd493d53190>,39,18,[2 7],40,-1,89,-1,71
1,<environment.Job instance at 0x7fd493781320>,67,17,[10  4],68,-1,90,-1,73
1,<environment.Job instance at 0x7fd492c7bcd0>,68,18,[13  5],69,-1,91,-1,73
1,<environment.Job instance at 0x7fd4932a75a0>,57,13,[9 1],58,-1,86,-1,73
1,<environment.Job instance at 0x7fd492e320a0>,69,15,[2 6],70,-1,88,-1,73
1,<environment.Job instance at 0x7fd492c983c0>,30,24,[7 2],31,-1,97,-1,73
1,<environment.Job instance at 0x7fd493066640>,50,28,[ 2 14],51,-1,102,-1,74
1,<environment.Job instance at 0x7fd493040c80>,71,14,[9 4],72,-1,88,-1,74
1,<environment.Job instance at 0x7fd492c88500>,75,18,[7 5],76,-1,96,-1,78
1,<environment.Job instance at 0x7fd493397410>,76,27,[5 2],77,-1,105,-1,78
1,<environment.Job instance at 0x7fd49384ed20>,79,18,[ 2 10],80,-1,107,-1,89
1,<environment.Job instance at 0x7fd493d870a0>,70,2,[5 5],71,-1,91,-1,89
1,<environment.Job instance at 0x7fd492880230>,77,14,[ 3 14],78,-1,183,-1,169
1,<environment.Job instance at 0x7fd492e09410>,98,15,[5 8],99,-1,185,-1,170
1,<environment.Job instance at 0x7fd4939c26e0>,89,17,[2 6],90,-1,187,-1,170
1,<environment.Job instance at 0x7fd492e095f0>,100,13,[5 6],101,-1,183,-1,170
1,<environment.Job instance at 0x7fd492e099b0>,101,25,[10  1],102,-1,195,-1,170
1,<environment.Job instance at 0x7fd492e09960>,102,12,[10  4],103,-1,182,-1,170
1,<environment.Job instance at 0x7fd4939c2230>,96,17,[3 5],97,-1,187,-1,170
1,<environment.Job instance at 0x7fd492e09af0>,105,15,[8 1],106,-1,186,-1,171
1,<environment.Job instance at 0x7fd492e09f00>,108,18,[5 5],109,-1,189,-1,171
1,<environment.Job instance at 0x7fd492e09910>,104,13,[ 5 10],105,-1,184,-1,171
1,<environment.Job instance at 0x7fd492e09fa0>,110,16,[7 5],111,-1,187,-1,171
1,<environment.Job instance at 0x7fd492e09f50>,109,15,[6 2],110,-1,186,-1,171
1,<environment.Job instance at 0x7fd492e090f0>,113,17,[5 9],114,-1,188,-1,171
1,<environment.Job instance at 0x7fd492e095a0>,114,17,[2 5],115,-1,188,-1,171
1,<environment.Job instance at 0x7fd4931f8af0>,115,21,[9 3],116,-1,192,-1,171
1,<environment.Job instance at 0x7fd492e09d20>,111,15,[5 4],112,-1,186,-1,171
1,<environment.Job instance at 0x7fd4931f8370>,116,15,[3 5],117,-1,186,-1,171
1,<environment.Job instance at 0x7fd492e091e0>,117,25,[9 4],118,-1,196,-1,171
1,<environment.Job instance at 0x7fd4931b9f00>,120,12,[10  1],121,-1,183,-1,171
1,<environment.Job instance at 0x7fd493873dc0>,122,16,[9 4],123,-1,190,-1,174
1,<environment.Job instance at 0x7fd4938735f0>,123,12,[10  1],124,-1,186,-1,174
1,<environment.Job instance at 0x7fd493873370>,124,17,[1 9],125,-1,193,-1,176
1,<environment.Job instance at 0x7fd493873f50>,126,18,[8 1],127,-1,194,-1,176
1,<environment.Job instance at 0x7fd4934d70a0>,0,2,[ 2 12],1,-1,3,-1,1
1,<environment.Job instance at 0x7fd49305b500>,5,23,[8 4],6,-1,43,-1,20
1,<environment.Job instance at 0x7fd492e32f00>,14,15,[11  1],15,-1,44,-1,29
1,<environment.Job instance at 0x7fd4938734b0>,21,20,[ 5 13],22,-1,67,-1,47
1,<environment.Job instance at 0x7fd49c80d820>,30,24,[7 2],31,-1,100,-1,76
1,<environment.Job instance at 0x7fd49ca447d0>,35,15,[ 1 12],36,-1,111,-1,96
1,<environment.Job instance at 0x7fd493697c30>,48,2,[ 1 13],49,-1,141,-1,139
1,<environment.Job instance at 0x7fd493e29320>,50,28,[ 2 14],51,-1,180,-1,152
1,<environment.Job instance at 0x7fd493e29690>,51,28,[5 1],52,-1,180,-1,152
1,<environment.Job instance at 0x7fd492fc7e60>,63,23,[7 4],64,-1,231,-1,208
1,<environment.Job instance at 0x7fd492fc7500>,68,18,[13  5],69,-1,226,-1,208
1,<environment.Job instance at 0x7fd492688b90>,73,3,[13  5],74,-1,223,-1,220
1,<environment.Job instance at 0x7fd492688eb0>,76,27,[5 2],77,-1,261,-1,234
1,<environment.Job instance at 0x7fd492688870>,77,14,[ 3 14],78,-1,248,-1,234
1,<environment.Job instance at 0x7fd4926ed370>,94,28,[4 5],95,-1,327,-1,299
1,<environment.Job instance at 0x7fd4926ed640>,97,2,[ 5 13],98,-1,302,-1,300
1,<environment.Job instance at 0x7fd4926edf50>,101,25,[10  1],102,-1,339,-1,314
1,<environment.Job instance at 0x7fd492971e10>,117,25,[9 4],118,-1,416,-1,391
1,<environment.Job instance at 0x7fd49271be60>,4,18,[5 5],5,-1,23,-1,5
1,<environment.Job instance at 0x7fd49271beb0>,6,17,[2 6],7,-1,25,-1,8
1,<environment.Job instance at 0x7fd49271b370>,8,18,[5 3],9,-1,27,-1,9
1,<environment.Job instance at 0x7fd49355f190>,11,13,[10  4],12,-1,26,-1,13
1,<environment.Job instance at 0x7fd49355fb90>,12,15,[8 4],13,-1,28,-1,13
1,<environment.Job instance at 0x7fd49355f0f0>,16,17,[2 5],17,-1,34,-1,17
1,<environment.Job instance at 0x7fd49355fc80>,18,12,[9 3],19,-1,31,-1,19
1,<environment.Job instance at 0x7fd49355f730>,19,13,[6 4],20,-1,35,-1,22
1,<environment.Job instance at 0x7fd49355f820>,21,28,[9 4],22,-1,50,-1,22
1,<environment.Job instance at 0x7fd49355f2d0>,24,12,[9 1],25,-1,38,-1,26
1,<environment.Job instance at 0x7fd49355f460>,27,17,[1 9],28,-1,45,-1,28
1,<environment.Job instance at 0x7fd493590690>,28,19,[ 3 11],29,-1,54,-1,35
1,<environment.Job instance at 0x7fd493590280>,31,14,[5 8],32,-1,51,-1,37
1,<environment.Job instance at 0x7fd493590a50>,36,21,[5 5],37,-1,58,-1,37
1,<environment.Job instance at 0x7fd493590c30>,29,18,[7 5],30,-1,57,-1,39
1,<environment.Job instance at 0x7fd493590b40>,34,17,[7 2],35,-1,56,-1,39
1,<environment.Job instance at 0x7fd493590320>,39,15,[10  2],40,-1,55,-1,40
1,<environment.Job instance at 0x7fd493590820>,40,12,[7 4],41,-1,53,-1,41
1,<environment.Job instance at 0x7fd493590f00>,43,15,[3 9],44,-1,59,-1,44
1,<environment.Job instance at 0x7fd4926fdb90>,44,16,[7 4],45,-1,61,-1,45
1,<environment.Job instance at 0x7fd4926fdf50>,48,17,[9 5],49,-1,74,-1,57
1,<environment.Job instance at 0x7fd4926fd960>,51,18,[4 7],52,-1,76,-1,58
1,<environment.Job instance at 0x7fd49355fa00>,23,16,[ 1 12],24,-1,74,-1,58
1,<environment.Job instance at 0x7fd4926fdb40>,54,22,[4 9],55,-1,80,-1,58
1,<environment.Job instance at 0x7fd4935900f0>,30,17,[10  1],31,-1,75,-1,58
1,<environment.Job instance at 0x7fd4926fd280>,53,17,[9 1],54,-1,75,-1,58
1,<environment.Job instance at 0x7fd4926fd780>,47,13,[14  4],48,-1,74,-1,61
1,<environment.Job instance at 0x7fd4926fd730>,59,15,[3 9],60,-1,78,-1,63
1,<environment.Job instance at 0x7fd49363ad70>,64,15,[10  2],65,-1,80,-1,65
1,<environment.Job instance at 0x7fd4926fde60>,60,15,[5 5],61,-1,81,-1,66
1,<environment.Job instance at 0x7fd49363a0a0>,65,25,[1 6],66,-1,91,-1,66
1,<environment.Job instance at 0x7fd4926fd5a0>,56,21,[5 5],57,-1,98,-1,77
1,<environment.Job instance at 0x7fd49363a910>,72,20,[ 5 10],73,-1,97,-1,77
1,<environment.Job instance at 0x7fd49363a640>,62,12,[ 1 10],63,-1,90,-1,78
1,<environment.Job instance at 0x7fd492d38a50>,74,12,[9 1],75,-1,90,-1,78
1,<environment.Job instance at 0x7fd49363ab90>,70,27,[11  2],71,-1,105,-1,78
1,<environment.Job instance at 0x7fd492d38af0>,77,12,[5 9],78,-1,90,-1,78
1,<environment.Job instance at 0x7fd492d38aa0>,76,14,[6 4],77,-1,94,-1,80
1,<environment.Job instance at 0x7fd492d38190>,80,12,[5 6],81,-1,94,-1,82
1,<environment.Job instance at 0x7fd492d38c80>,81,16,[3 9],82,-1,99,-1,83
1,<environment.Job instance at 0x7fd4927338c0>,84,13,[2 7],85,-1,99,-1,86
1,<environment.Job instance at 0x7fd492733690>,85,17,[10  3],86,-1,103,-1,86
1,<environment.Job instance at 0x7fd492733be0>,86,18,[6 4],87,-1,106,-1,88
1,<environment.Job instance at 0x7fd492733eb0>,88,14,[6 4],89,-1,103,-1,89
1,<environment.Job instance at 0x7fd492733550>,87,24,[5 9],88,-1,113,-1,89
1,<environment.Job instance at 0x7fd492733370>,95,16,[7 3],96,-1,115,-1,99
1,<environment.Job instance at 0x7fd492733cd0>,99,26,[2 6],100,-1,126,-1,100
1,<environment.Job instance at 0x7fd49361a9b0>,100,20,[9 3],101,-1,121,-1,101
1,<environment.Job instance at 0x7fd49361ae60>,101,15,[8 4],102,-1,117,-1,102
1,<environment.Job instance at 0x7fd49361a140>,102,14,[9 2],103,-1,117,-1,103
1,<environment.Job instance at 0x7fd492d38780>,75,24,[8 3],76,-1,129,-1,105
1,<environment.Job instance at 0x7fd49361ad70>,103,16,[2 6],104,-1,125,-1,109
1,<environment.Job instance at 0x7fd493e747d0>,108,26,[8 2],109,-1,151,-1,125
1,<environment.Job instance at 0x7fd493e74e60>,113,18,[4 6],114,-1,146,-1,128
1,<environment.Job instance at 0x7fd493e48a50>,112,16,[9 2],113,-1,144,-1,128
1,<environment.Job instance at 0x7fd49320ab40>,116,17,[3 7],117,-1,145,-1,128
1,<environment.Job instance at 0x7fd492647140>,122,18,[7 4],123,-1,149,-1,131
1,<environment.Job instance at 0x7fd492647280>,123,14,[ 2 10],124,-1,145,-1,131
1,<environment.Job instance at 0x7fd493590730>,2,18,[ 2 12],3,-1,21,-1,3
1,<environment.Job instance at 0x7fd493a58f00>,13,24,[5 3],14,-1,50,-1,26
1,<environment.Job instance at 0x7fd492fc7a50>,17,2,[11  4],18,-1,40,-1,38
1,<environment.Job instance at 0x7fd49ca44050>,21,28,[9 4],22,-1,81,-1,53
1,<environment.Job instance at 0x7fd493a4f280>,23,16,[ 1 12],24,-1,69,-1,53
1,<environment.Job instance at 0x7fd492c986e0>,28,19,[ 3 11],29,-1,83,-1,64
1,<environment.Job instance at 0x7fd4939b9550>,47,13,[14  4],48,-1,160,-1,147
1,<environment.Job instance at 0x7fd4936e6500>,63,2,[13  2],64,-1,209,-1,207
1,<environment.Job instance at 0x7fd49317dfa0>,65,25,[1 6],66,-1,244,-1,219
1,<environment.Job instance at 0x7fd493475a50>,70,27,[11  2],71,-1,262,-1,235
1,<environment.Job instance at 0x7fd492fd05a0>,75,24,[8 3],76,-1,270,-1,246
1,<environment.Job instance at 0x7fd49ca4d280>,87,24,[5 9],88,-1,313,-1,289
1,<environment.Job instance at 0x7fd4927ddd20>,91,28,[3 6],92,-1,335,-1,307
1,<environment.Job instance at 0x7fd4938378c0>,99,26,[2 6],100,-1,358,-1,332
1,<environment.Job instance at 0x7fd4936db690>,107,1,[ 1 13],108,-1,356,-1,355
1,<environment.Job instance at 0x7fd4936db780>,108,26,[8 2],109,-1,398,-1,372
1,<environment.Job instance at 0x7fd492b5c1e0>,115,25,[ 3 14],116,-1,401,-1,376
1,<environment.Job instance at 0x7fd492a50410>,121,3,[ 4 13],122,-1,411,-1,408
1,<environment.Job instance at 0x7fd493c355a0>,124,27,[13  3],125,-1,440,-1,413
1,<environment.Job instance at 0x7fd4932a6280>,3,16,[3 8],4,-1,20,-1,4
1,<environment.Job instance at 0x7fd4932a6cd0>,4,13,[10  5],5,-1,19,-1,6
1,<environment.Job instance at 0x7fd4932a6b90>,6,13,[5 7],7,-1,20,-1,7
1,<environment.Job instance at 0x7fd4937ad7d0>,8,16,[3 8],9,-1,25,-1,9
1,<environment.Job instance at 0x7fd4937ad4b0>,9,1,[9 4],10,-1,11,-1,10
1,<environment.Job instance at 0x7fd492d420a0>,5,19,[1 5],6,-1,29,-1,10
1,<environment.Job instance at 0x7fd4932a63c0>,10,18,[9 2],11,-1,29,-1,11
1,<environment.Job instance at 0x7fd4937ada50>,12,17,[9 4],13,-1,30,-1,13
1,<environment.Job instance at 0x7fd4937ad370>,14,27,[6 1],15,-1,42,-1,15
1,<environment.Job instance at 0x7fd4937ad050>,15,14,[4 8],16,-1,30,-1,16
1,<environment.Job instance at 0x7fd4937adb90>,16,17,[ 5 11],17,-1,35,-1,18
1,<environment.Job instance at 0x7fd4937adaf0>,19,16,[10  5],20,-1,36,-1,20
1,<environment.Job instance at 0x7fd4938ae2d0>,26,1,[9 2],27,-1,28,-1,27
1,<environment.Job instance at 0x7fd4938ae460>,30,18,[6 4],31,-1,49,-1,31
1,<environment.Job instance at 0x7fd4938aef00>,33,13,[8 4],34,-1,47,-1,34
1,<environment.Job instance at 0x7fd493a60f50>,35,16,[7 3],36,-1,52,-1,36
1,<environment.Job instance at 0x7fd493a60c30>,37,13,[10  4],38,-1,51,-1,38
1,<environment.Job instance at 0x7fd493a60780>,38,13,[8 5],39,-1,52,-1,39
1,<environment.Job instance at 0x7fd493a603c0>,39,13,[8 2],40,-1,53,-1,40
1,<environment.Job instance at 0x7fd493a609b0>,40,13,[12  1],41,-1,54,-1,41
1,<environment.Job instance at 0x7fd493a60230>,41,16,[ 5 11],42,-1,58,-1,42
1,<environment.Job instance at 0x7fd493a604b0>,42,16,[5 4],43,-1,59,-1,43
1,<environment.Job instance at 0x7fd493a60410>,45,27,[4 5],46,-1,73,-1,46
1,<environment.Job instance at 0x7fd493a60c80>,47,18,[1 6],48,-1,66,-1,48
1,<environment.Job instance at 0x7fd4938aee60>,28,18,[5 9],29,-1,66,-1,48
1,<environment.Job instance at 0x7fd4929c4190>,50,17,[9 2],51,-1,74,-1,57
1,<environment.Job instance at 0x7fd4926d1460>,59,18,[6 2],60,-1,78,-1,60
1,<environment.Job instance at 0x7fd4926d1280>,60,26,[6 4],61,-1,87,-1,61
1,<environment.Job instance at 0x7fd4926d1730>,63,14,[ 4 10],64,-1,78,-1,64
1,<environment.Job instance at 0x7fd4926d1050>,66,16,[9 2],67,-1,83,-1,67
1,<environment.Job instance at 0x7fd4926d1be0>,67,21,[9 4],68,-1,89,-1,68
1,<environment.Job instance at 0x7fd4926d1a00>,68,21,[5 1],69,-1,90,-1,69
1,<environment.Job instance at 0x7fd4929c4410>,56,25,[7 3],57,-1,100,-1,75
1,<environment.Job instance at 0x7fd4926bcdc0>,75,16,[4 9],76,-1,92,-1,76
1,<environment.Job instance at 0x7fd4926bc9b0>,76,18,[5 5],77,-1,95,-1,77
1,<environment.Job instance at 0x7fd4926bcc30>,79,20,[5 9],80,-1,100,-1,80
1,<environment.Job instance at 0x7fd4926bccd0>,80,17,[ 5 10],81,-1,98,-1,81
1,<environment.Job instance at 0x7fd4926bcd70>,81,14,[10  1],82,-1,97,-1,83
1,<environment.Job instance at 0x7fd49328aaa0>,90,2,[6 1],91,-1,95,-1,93
1,<environment.Job instance at 0x7fd49328ae60>,91,3,[7 4],92,-1,96,-1,93
1,<environment.Job instance at 0x7fd49328a820>,92,18,[3 7],93,-1,111,-1,93
1,<environment.Job instance at 0x7fd4926bcbe0>,82,18,[3 8],83,-1,111,-1,93
1,<environment.Job instance at 0x7fd49ca51dc0>,93,12,[5 4],94,-1,106,-1,94
1,<environment.Job instance at 0x7fd49ca51cd0>,95,13,[9 1],96,-1,111,-1,98
1,<environment.Job instance at 0x7fd492e22500>,98,14,[ 1 10],99,-1,113,-1,99
1,<environment.Job instance at 0x7fd4926a1f00>,100,25,[5 3],101,-1,126,-1,101
1,<environment.Job instance at 0x7fd4926c9870>,104,13,[3 6],105,-1,118,-1,105
1,<environment.Job instance at 0x7fd4926c9eb0>,106,13,[8 1],107,-1,121,-1,108
1,<environment.Job instance at 0x7fd492a7e0a0>,108,16,[10  3],109,-1,125,-1,109
1,<environment.Job instance at 0x7fd492b804b0>,114,17,[2 7],115,-1,145,-1,128
1,<environment.Job instance at 0x7fd4929ed320>,117,16,[5 4],118,-1,147,-1,131
1,<environment.Job instance at 0x7fd492f186e0>,118,17,[6 5],119,-1,148,-1,131
1,<environment.Job instance at 0x7fd493227d70>,119,18,[5 1],120,-1,149,-1,131
1,<environment.Job instance at 0x7fd4932277d0>,120,16,[1 7],121,-1,147,-1,131
1,<environment.Job instance at 0x7fd493775d20>,122,17,[6 4],123,-1,148,-1,131
1,<environment.Job instance at 0x7fd4930c7320>,126,15,[5 6],127,-1,146,-1,131
1,<environment.Job instance at 0x7fd4926bc690>,14,27,[6 1],15,-1,59,-1,32
1,<environment.Job instance at 0x7fd49328aaf0>,16,17,[ 5 11],17,-1,49,-1,32
1,<environment.Job instance at 0x7fd493555780>,21,24,[14  3],22,-1,77,-1,53
1,<environment.Job instance at 0x7fd492b80be0>,23,24,[10  2],24,-1,101,-1,77
1,<environment.Job instance at 0x7fd493c27cd0>,40,13,[12  1],41,-1,132,-1,119
1,<environment.Job instance at 0x7fd4938378c0>,41,16,[ 5 11],42,-1,135,-1,119
1,<environment.Job instance at 0x7fd4935864b0>,45,27,[4 5],46,-1,165,-1,138
1,<environment.Job instance at 0x7fd493586cd0>,46,1,[12  2],47,-1,139,-1,138
1,<environment.Job instance at 0x7fd493990960>,56,25,[7 3],57,-1,197,-1,172
1,<environment.Job instance at 0x7fd493b420a0>,60,26,[6 4],61,-1,207,-1,181
1,<environment.Job instance at 0x7fd492c989b0>,94,1,[13  5],95,-1,275,-1,274
1,<environment.Job instance at 0x7fd493529780>,100,25,[5 3],101,-1,330,-1,305
1,<environment.Job instance at 0x7fd49ca44a00>,101,16,[11  2],102,-1,321,-1,305
1,<environment.Job instance at 0x7fd49262cf50>,109,28,[3 9],110,-1,363,-1,335
1,<environment.Job instance at 0x7fd49262c910>,112,23,[3 7],113,-1,362,-1,339
1,<environment.Job instance at 0x7fd493abea00>,116,3,[ 5 14],117,-1,354,-1,351
1,<environment.Job instance at 0x7fd49310d690>,127,16,[11  1],128,-1,402,-1,386
1,<environment.Job instance at 0x7fd492772730>,1,16,[5 5],2,-1,18,-1,2
1,<environment.Job instance at 0x7fd493a0c910>,2,18,[2 5],3,-1,21,-1,3
1,<environment.Job instance at 0x7fd493a0cd70>,4,14,[ 3 10],5,-1,19,-1,5
1,<environment.Job instance at 0x7fd493c35cd0>,13,20,[ 5 12],14,-1,34,-1,14
1,<environment.Job instance at 0x7fd493da7280>,15,16,[10  3],16,-1,35,-1,19
1,<environment.Job instance at 0x7fd493da76e0>,19,17,[9 4],20,-1,37,-1,20
1,<environment.Job instance at 0x7fd493da7cd0>,26,16,[5 6],27,-1,45,-1,29
1,<environment.Job instance at 0x7fd493a21230>,31,16,[4 6],32,-1,48,-1,32
1,<environment.Job instance at 0x7fd493a21960>,37,15,[10  4],38,-1,54,-1,39
1,<environment.Job instance at 0x7fd493a21a50>,40,13,[1 5],41,-1,54,-1,41
1,<environment.Job instance at 0x7fd493a21b40>,42,14,[3 7],43,-1,57,-1,43
1,<environment.Job instance at 0x7fd493a17230>,46,27,[2 9],47,-1,74,-1,47
1,<environment.Job instance at 0x7fd493a17320>,47,15,[2 6],48,-1,63,-1,48
1,<environment.Job instance at 0x7fd493a170a0>,48,18,[ 5 10],49,-1,67,-1,49
1,<environment.Job instance at 0x7fd493a174b0>,49,18,[10  2],50,-1,68,-1,50
1,<environment.Job instance at 0x7fd493a17550>,50,13,[2 8],51,-1,64,-1,51
1,<environment.Job instance at 0x7fd493a17690>,52,22,[8 1],53,-1,75,-1,53
1,<environment.Job instance at 0x7fd4939f30f0>,64,16,[11  4],65,-1,157,-1,141
1,<environment.Job instance at 0x7fd4939f3410>,69,14,[2 8],70,-1,155,-1,141
1,<environment.Job instance at 0x7fd493a17f50>,61,27,[8 5],62,-1,168,-1,141
1,<environment.Job instance at 0x7fd4939f35f0>,72,18,[10  5],73,-1,173,-1,155
1,<environment.Job instance at 0x7fd493a218c0>,38,16,[ 5 10],39,-1,171,-1,155
1,<environment.Job instance at 0x7fd4939f32d0>,67,18,[1 9],68,-1,179,-1,161
1,<environment.Job instance at 0x7fd4939f3730>,74,17,[10  5],75,-1,214,-1,197
1,<environment.Job instance at 0x7fd4939f3370>,68,16,[13  2],69,-1,214,-1,198
1,<environment.Job instance at 0x7fd49294e960>,104,17,[8 5],105,-1,296,-1,279
1,<environment.Job instance at 0x7fd4937bd280>,103,17,[13  5],104,-1,324,-1,307
1,<environment.Job instance at 0x7fd4938effa0>,114,18,[ 4 10],115,-1,325,-1,307
1,<environment.Job instance at 0x7fd4938e9b90>,121,12,[5 8],122,-1,323,-1,311
1,<environment.Job instance at 0x7fd493ca5dc0>,98,15,[3 8],99,-1,327,-1,312
1,<environment.Job instance at 0x7fd4938ebe60>,125,2,[9 1],126,-1,315,-1,313
1,<environment.Job instance at 0x7fd4938eb500>,126,16,[5 9],127,-1,330,-1,314
1,<environment.Job instance at 0x7fd4938eb780>,124,15,[6 2],125,-1,329,-1,314
1,<environment.Job instance at 0x7fd4938ebaa0>,123,18,[9 2],124,-1,332,-1,314
1,<environment.Job instance at 0x7fd4938ebd20>,128,24,[5 6],129,-1,338,-1,314
1,<environment.Job instance at 0x7fd493a21050>,7,16,[ 5 13],8,-1,24,-1,8
1,<environment.Job instance at 0x7fd493a17eb0>,9,2,[13  4],10,-1,18,-1,16
1,<environment.Job instance at 0x7fd49267a0a0>,13,20,[ 5 12],14,-1,38,-1,18
1,<environment.Job instance at 0x7fd49267a500>,14,2,[ 5 11],15,-1,20,-1,18
1,<environment.Job instance at 0x7fd492645b40>,21,2,[ 5 11],22,-1,26,-1,24
1,<environment.Job instance at 0x7fd4932334b0>,29,13,[ 4 14],30,-1,65,-1,52
1,<environment.Job instance at 0x7fd49ca44870>,36,16,[13  1],37,-1,87,-1,71
1,<environment.Job instance at 0x7fd49c959820>,46,27,[2 9],47,-1,135,-1,108
1,<environment.Job instance at 0x7fd493bee910>,53,14,[14  4],54,-1,151,-1,137
1,<environment.Job instance at 0x7fd492fd7690>,55,3,[ 1 13],56,-1,140,-1,137
1,<environment.Job instance at 0x7fd492c791e0>,56,2,[14  2],57,-1,139,-1,137
1,<environment.Job instance at 0x7fd4937270f0>,57,15,[ 5 12],58,-1,152,-1,137
1,<environment.Job instance at 0x7fd493b42d70>,60,2,[14  4],61,-1,155,-1,153
1,<environment.Job instance at 0x7fd493b42e10>,61,27,[8 5],62,-1,182,-1,155
1,<environment.Job instance at 0x7fd493e02730>,64,16,[11  4],65,-1,173,-1,157
1,<environment.Job instance at 0x7fd49ca4d190>,68,16,[13  2],69,-1,181,-1,165
1,<environment.Job instance at 0x7fd493837820>,71,14,[ 2 12],72,-1,195,-1,181
1,<environment.Job instance at 0x7fd492b80be0>,73,26,[7 1],74,-1,225,-1,199
1,<environment.Job instance at 0x7fd4937d09b0>,99,25,[3 6],100,-1,332,-1,307
1,<environment.Job instance at 0x7fd4938aed20>,101,16,[ 5 12],102,-1,323,-1,307
1,<environment.Job instance at 0x7fd49303f280>,103,17,[13  5],104,-1,326,-1,309
1,<environment.Job instance at 0x7fd492bbbe10>,115,2,[ 3 11],116,-1,347,-1,345
1,<environment.Job instance at 0x7fd493e4d2d0>,122,3,[ 4 11],123,-1,381,-1,378
1,<environment.Job instance at 0x7fd49305beb0>,128,24,[5 6],129,-1,447,-1,423
1,<environment.Job instance at 0x7fd4937ebc80>,1,17,[5 8],2,-1,19,-1,2
1,<environment.Job instance at 0x7fd49cb4fcd0>,8,12,[10  3],9,-1,22,-1,10
1,<environment.Job instance at 0x7fd4929c8eb0>,10,20,[ 4 10],11,-1,31,-1,11
1,<environment.Job instance at 0x7fd49cb4fc80>,9,13,[10  4],10,-1,24,-1,11
1,<environment.Job instance at 0x7fd492d40280>,13,14,[ 4 10],14,-1,28,-1,14
1,<environment.Job instance at 0x7fd493ecf410>,15,14,[5 4],16,-1,30,-1,16
1,<environment.Job instance at 0x7fd493ecf820>,16,24,[4 5],17,-1,41,-1,17
1,<environment.Job instance at 0x7fd493ecfaa0>,17,24,[4 8],18,-1,42,-1,18
1,<environment.Job instance at 0x7fd49340fa50>,26,16,[4 9],27,-1,43,-1,27
1,<environment.Job instance at 0x7fd49340f3c0>,27,18,[6 1],28,-1,47,-1,29
1,<environment.Job instance at 0x7fd492f3bc80>,29,15,[6 4],30,-1,45,-1,30
1,<environment.Job instance at 0x7fd493c5ccd0>,32,23,[6 2],33,-1,56,-1,33
1,<environment.Job instance at 0x7fd49c4aaa50>,36,17,[1 6],37,-1,54,-1,37
1,<environment.Job instance at 0x7fd49c4aaaf0>,42,18,[6 5],43,-1,61,-1,43
1,<environment.Job instance at 0x7fd49257baa0>,44,14,[ 5 10],45,-1,59,-1,45
1,<environment.Job instance at 0x7fd493e43f50>,46,16,[4 8],47,-1,69,-1,53
1,<environment.Job instance at 0x7fd492cbe190>,55,14,[3 8],56,-1,83,-1,69
1,<environment.Job instance at 0x7fd492cbe140>,56,17,[4 6],57,-1,87,-1,70
1,<environment.Job instance at 0x7fd49257b140>,47,15,[4 8],48,-1,85,-1,70
1,<environment.Job instance at 0x7fd492cbe5a0>,57,2,[6 5],58,-1,72,-1,70
1,<environment.Job instance at 0x7fd492cbeb40>,58,18,[10  1],59,-1,88,-1,70
1,<environment.Job instance at 0x7fd492cbea00>,60,15,[4 7],61,-1,85,-1,70
1,<environment.Job instance at 0x7fd492f9cc80>,63,15,[8 4],64,-1,85,-1,70
1,<environment.Job instance at 0x7fd492f9cdc0>,62,17,[ 1 10],63,-1,89,-1,72
1,<environment.Job instance at 0x7fd492f9ce60>,65,24,[5 2],66,-1,96,-1,72
1,<environment.Job instance at 0x7fd492894fa0>,54,17,[1 6],55,-1,89,-1,72
1,<environment.Job instance at 0x7fd493e43870>,45,28,[ 4 12],46,-1,100,-1,72
1,<environment.Job instance at 0x7fd492f9c9b0>,64,13,[1 9],65,-1,85,-1,72
1,<environment.Job instance at 0x7fd4929c6f00>,71,17,[9 4],72,-1,89,-1,72
1,<environment.Job instance at 0x7fd492f9c500>,66,12,[3 5],67,-1,84,-1,72
1,<environment.Job instance at 0x7fd4929c6140>,70,25,[6 2],71,-1,97,-1,72
1,<environment.Job instance at 0x7fd4926ebaa0>,75,14,[4 8],76,-1,91,-1,77
1,<environment.Job instance at 0x7fd4926ebdc0>,78,18,[10  4],79,-1,97,-1,79
1,<environment.Job instance at 0x7fd49319fe60>,81,13,[9 3],82,-1,101,-1,88
1,<environment.Job instance at 0x7fd493ad7f50>,86,16,[ 1 10],87,-1,108,-1,92
1,<environment.Job instance at 0x7fd492a8b280>,89,15,[ 5 10],90,-1,107,-1,92
1,<environment.Job instance at 0x7fd4926eb4b0>,80,25,[5 5],81,-1,118,-1,93
1,<environment.Job instance at 0x7fd4936ddc30>,92,16,[2 8],93,-1,109,-1,93
1,<environment.Job instance at 0x7fd49319f960>,85,19,[2 8],86,-1,120,-1,101
1,<environment.Job instance at 0x7fd4936dd5a0>,95,18,[4 6],96,-1,120,-1,102
1,<environment.Job instance at 0x7fd4926eb370>,79,13,[ 1 11],80,-1,115,-1,102
1,<environment.Job instance at 0x7fd493b6a960>,100,15,[8 4],101,-1,118,-1,103
1,<environment.Job instance at 0x7fd493333730>,99,17,[ 1 10],100,-1,120,-1,103
1,<environment.Job instance at 0x7fd493131410>,104,19,[ 5 10],105,-1,125,-1,106
1,<environment.Job instance at 0x7fd493a1f2d0>,98,16,[14  4],99,-1,125,-1,109
1,<environment.Job instance at 0x7fd4936dd9b0>,96,15,[5 9],97,-1,127,-1,112
1,<environment.Job instance at 0x7fd493d805f0>,107,27,[8 5],108,-1,139,-1,112
1,<environment.Job instance at 0x7fd4930a50f0>,113,17,[13  3],114,-1,138,-1,121
1,<environment.Job instance at 0x7fd4931312d0>,101,12,[8 1],102,-1,133,-1,121
1,<environment.Job instance at 0x7fd492fd7a50>,115,15,[10  1],116,-1,136,-1,121
1,<environment.Job instance at 0x7fd49268bc30>,116,13,[ 2 10],117,-1,134,-1,121
1,<environment.Job instance at 0x7fd492acd4b0>,110,13,[8 3],111,-1,134,-1,121
1,<environment.Job instance at 0x7fd492b11a50>,125,25,[4 5],126,-1,160,-1,135
1,<environment.Job instance at 0x7fd49c4aafa0>,0,3,[ 3 12],1,-1,4,-1,1
1,<environment.Job instance at 0x7fd492f3be60>,2,14,[14  5],3,-1,17,-1,3
1,<environment.Job instance at 0x7fd493e4ddc0>,16,24,[4 5],17,-1,61,-1,37
1,<environment.Job instance at 0x7fd492c4af00>,17,24,[4 8],18,-1,61,-1,37
1,<environment.Job instance at 0x7fd49267a640>,32,23,[6 2],33,-1,109,-1,86
1,<environment.Job instance at 0x7fd49267a780>,34,3,[ 1 12],35,-1,89,-1,86
1,<environment.Job instance at 0x7fd493348050>,35,14,[12  1],36,-1,100,-1,86
1,<environment.Job instance at 0x7fd493347be0>,43,1,[11  3],44,-1,106,-1,105
1,<environment.Job instance at 0x7fd49338b5a0>,45,28,[ 4 12],46,-1,134,-1,106
1,<environment.Job instance at 0x7fd493e1a320>,49,1,[ 4 13],50,-1,123,-1,122
1,<environment.Job instance at 0x7fd4929fd140>,53,14,[ 2 11],54,-1,151,-1,137
1,<environment.Job instance at 0x7fd4925ea4b0>,65,24,[5 2],66,-1,217,-1,193
1,<environment.Job instance at 0x7fd492d40eb0>,70,25,[6 2],71,-1,246,-1,221
1,<environment.Job instance at 0x7fd492cbe5f0>,79,13,[ 1 11],80,-1,250,-1,237
1,<environment.Job instance at 0x7fd492cbef50>,80,25,[5 5],81,-1,271,-1,246
1,<environment.Job instance at 0x7fd4926d1b90>,83,3,[ 4 11],84,-1,254,-1,251
1,<environment.Job instance at 0x7fd493c5cc80>,98,16,[14  4],99,-1,328,-1,312
1,<environment.Job instance at 0x7fd49c4a75a0>,107,27,[8 5],108,-1,376,-1,349
1,<environment.Job instance at 0x7fd49c4a7f00>,109,3,[ 1 12],110,-1,352,-1,349
1,<environment.Job instance at 0x7fd492a6d820>,113,17,[13  3],114,-1,380,-1,363
1,<environment.Job instance at 0x7fd493901af0>,114,3,[13  1],115,-1,366,-1,363
1,<environment.Job instance at 0x7fd49264ef00>,125,25,[4 5],126,-1,418,-1,393
1,<environment.Job instance at 0x7fd492870320>,128,1,[ 4 14],129,-1,406,-1,405
1,<environment.Job instance at 0x7fd492d4d2d0>,0,18,[3 5],1,-1,19,-1,1
1,<environment.Job instance at 0x7fd49303f230>,12,18,[4 8],13,-1,31,-1,13
1,<environment.Job instance at 0x7fd49303f370>,13,15,[ 2 10],14,-1,29,-1,14
1,<environment.Job instance at 0x7fd49c7cef50>,17,26,[ 3 10],18,-1,44,-1,18
1,<environment.Job instance at 0x7fd49c7ce730>,18,12,[10  4],19,-1,32,-1,20
1,<environment.Job instance at 0x7fd49c7cecd0>,19,12,[5 8],20,-1,32,-1,20
1,<environment.Job instance at 0x7fd49c97fe10>,31,17,[7 4],32,-1,49,-1,32
1,<environment.Job instance at 0x7fd49295b0f0>,33,14,[ 5 10],34,-1,48,-1,34
1,<environment.Job instance at 0x7fd49295b910>,35,13,[7 4],36,-1,50,-1,37
1,<environment.Job instance at 0x7fd492d95230>,40,15,[5 5],41,-1,56,-1,41
1,<environment.Job instance at 0x7fd49295b4b0>,36,16,[3 8],37,-1,58,-1,42
1,<environment.Job instance at 0x7fd49291c5f0>,42,17,[5 7],43,-1,60,-1,43
1,<environment.Job instance at 0x7fd492eef1e0>,49,2,[3 9],50,-1,52,-1,50
1,<environment.Job instance at 0x7fd492eef9b0>,50,18,[9 3],51,-1,83,-1,65
1,<environment.Job instance at 0x7fd492eefaa0>,56,17,[4 8],57,-1,85,-1,68
1,<environment.Job instance at 0x7fd492eef460>,57,14,[5 6],58,-1,82,-1,68
1,<environment.Job instance at 0x7fd492eef820>,58,16,[8 4],59,-1,84,-1,68
1,<environment.Job instance at 0x7fd492eef6e0>,59,17,[5 6],60,-1,87,-1,70
1,<environment.Job instance at 0x7fd492eef370>,60,15,[3 7],61,-1,85,-1,70
1,<environment.Job instance at 0x7fd49ca43be0>,62,17,[ 5 14],63,-1,87,-1,70
1,<environment.Job instance at 0x7fd49c97af50>,64,13,[10  1],65,-1,83,-1,70
1,<environment.Job instance at 0x7fd492c73b40>,66,15,[4 6],67,-1,85,-1,70
1,<environment.Job instance at 0x7fd492d95d20>,51,17,[9 4],52,-1,87,-1,70
1,<environment.Job instance at 0x7fd492dfc2d0>,73,15,[ 2 12],74,-1,105,-1,90
1,<environment.Job instance at 0x7fd492a43820>,75,16,[3 5],76,-1,107,-1,91
1,<environment.Job instance at 0x7fd4934e2500>,71,18,[7 1],72,-1,111,-1,93
1,<environment.Job instance at 0x7fd492a430a0>,76,14,[6 2],77,-1,108,-1,94
1,<environment.Job instance at 0x7fd49c85cc30>,81,26,[7 2],82,-1,121,-1,95
1,<environment.Job instance at 0x7fd4930a7b90>,80,14,[8 2],81,-1,111,-1,97
1,<environment.Job instance at 0x7fd49c85caf0>,82,17,[1 5],83,-1,115,-1,98
1,<environment.Job instance at 0x7fd4930a7140>,79,14,[7 3],80,-1,112,-1,98
1,<environment.Job instance at 0x7fd4934e2370>,72,15,[6 2],73,-1,113,-1,98
1,<environment.Job instance at 0x7fd49362fd20>,87,15,[6 1],88,-1,113,-1,98
1,<environment.Job instance at 0x7fd49362feb0>,86,12,[5 3],87,-1,110,-1,98
1,<environment.Job instance at 0x7fd49362f7d0>,88,15,[10  2],89,-1,114,-1,99
1,<environment.Job instance at 0x7fd49362f190>,91,23,[5 9],92,-1,123,-1,100
1,<environment.Job instance at 0x7fd49362fdc0>,89,13,[4 7],90,-1,113,-1,100
1,<environment.Job instance at 0x7fd49362f1e0>,92,14,[5 2],93,-1,114,-1,100
1,<environment.Job instance at 0x7fd49362fb90>,97,22,[2 9],98,-1,122,-1,100
1,<environment.Job instance at 0x7fd49316c730>,100,13,[5 8],101,-1,118,-1,105
1,<environment.Job instance at 0x7fd49316ceb0>,101,16,[5 2],102,-1,121,-1,105
1,<environment.Job instance at 0x7fd49316c0a0>,103,15,[ 3 10],104,-1,120,-1,105
1,<environment.Job instance at 0x7fd49316c320>,104,12,[7 5],105,-1,117,-1,105
1,<environment.Job instance at 0x7fd492eef870>,53,14,[14  1],54,-1,120,-1,106
1,<environment.Job instance at 0x7fd492a0faa0>,105,14,[7 5],106,-1,121,-1,107
1,<environment.Job instance at 0x7fd493e30b40>,107,16,[8 4],108,-1,124,-1,108
1,<environment.Job instance at 0x7fd492ed8b90>,108,26,[2 5],109,-1,135,-1,109
1,<environment.Job instance at 0x7fd493e30eb0>,110,15,[10  5],111,-1,126,-1,111
1,<environment.Job instance at 0x7fd493e30050>,106,20,[8 2],107,-1,132,-1,112
1,<environment.Job instance at 0x7fd493e30320>,113,12,[8 2],114,-1,129,-1,117
1,<environment.Job instance at 0x7fd493e30cd0>,116,24,[2 9],117,-1,141,-1,117
1,<environment.Job instance at 0x7fd493cc05f0>,121,16,[8 4],122,-1,140,-1,124
1,<environment.Job instance at 0x7fd493cc0640>,125,15,[9 1],126,-1,141,-1,126
1,<environment.Job instance at 0x7fd49c97fd20>,10,2,[13  2],11,-1,20,-1,18
1,<environment.Job instance at 0x7fd493d88370>,14,1,[12  5],15,-1,22,-1,21
1,<environment.Job instance at 0x7fd493e020f0>,17,26,[ 3 10],18,-1,55,-1,29
1,<environment.Job instance at 0x7fd49316c1e0>,21,3,[12  2],22,-1,35,-1,32
1,<environment.Job instance at 0x7fd493c5cfa0>,34,3,[14  3],35,-1,64,-1,61
1,<environment.Job instance at 0x7fd492d40be0>,46,1,[11  3],47,-1,97,-1,96
1,<environment.Job instance at 0x7fd493ecf320>,53,14,[14  1],54,-1,135,-1,121
1,<environment.Job instance at 0x7fd493347be0>,62,17,[ 5 14],63,-1,182,-1,165
1,<environment.Job instance at 0x7fd49267ad20>,73,15,[ 2 12],74,-1,215,-1,200
1,<environment.Job instance at 0x7fd4939b9320>,78,2,[13  1],79,-1,225,-1,223
1,<environment.Job instance at 0x7fd49319f410>,81,26,[7 2],82,-1,264,-1,238
1,<environment.Job instance at 0x7fd493a0f3c0>,91,23,[5 9],92,-1,296,-1,273
1,<environment.Job instance at 0x7fd492c952d0>,93,3,[ 1 14],94,-1,276,-1,273
1,<environment.Job instance at 0x7fd492739640>,96,1,[ 3 13],97,-1,275,-1,274
1,<environment.Job instance at 0x7fd492739050>,108,26,[2 5],109,-1,347,-1,321
1,<environment.Job instance at 0x7fd4930b36e0>,116,24,[2 9],117,-1,386,-1,362
1,<environment.Job instance at 0x7fd4938d9f50>,117,12,[ 2 12],118,-1,374,-1,362
1,<environment.Job instance at 0x7fd4938d9370>,118,14,[13  4],119,-1,376,-1,362
1,<environment.Job instance at 0x7fd4938d9af0>,119,20,[ 3 11],120,-1,382,-1,362
1,<environment.Job instance at 0x7fd49300acd0>,3,13,[10  3],4,-1,18,-1,5
1,<environment.Job instance at 0x7fd49300af50>,7,14,[4 7],8,-1,22,-1,8
1,<environment.Job instance at 0x7fd4930040f0>,9,1,[9 1],10,-1,11,-1,10
1,<environment.Job instance at 0x7fd493004320>,10,12,[9 4],11,-1,23,-1,11
1,<environment.Job instance at 0x7fd493004230>,11,23,[1 8],12,-1,35,-1,12
1,<environment.Job instance at 0x7fd493004370>,12,14,[3 7],13,-1,27,-1,13
1,<environment.Job instance at 0x7fd493004410>,13,16,[ 5 10],14,-1,30,-1,14
1,<environment.Job instance at 0x7fd4930044b0>,14,17,[3 5],15,-1,32,-1,15
1,<environment.Job instance at 0x7fd493004550>,15,15,[ 1 10],16,-1,31,-1,16
1,<environment.Job instance at 0x7fd4930045f0>,16,13,[ 5 11],17,-1,30,-1,17
1,<environment.Job instance at 0x7fd492d7a0f0>,4,14,[5 3],5,-1,31,-1,17
1,<environment.Job instance at 0x7fd493004780>,23,13,[6 5],24,-1,37,-1,24
1,<environment.Job instance at 0x7fd493004f00>,26,25,[8 1],27,-1,52,-1,27
1,<environment.Job instance at 0x7fd493011140>,27,18,[ 1 10],28,-1,46,-1,28
1,<environment.Job instance at 0x7fd4930117d0>,33,16,[9 5],34,-1,50,-1,34
1,<environment.Job instance at 0x7fd493011910>,34,28,[7 4],35,-1,63,-1,35
1,<environment.Job instance at 0x7fd493011460>,35,20,[7 2],36,-1,56,-1,36
1,<environment.Job instance at 0x7fd493011a00>,36,14,[10  3],37,-1,52,-1,38
1,<environment.Job instance at 0x7fd493011b40>,38,2,[7 1],39,-1,41,-1,39
1,<environment.Job instance at 0x7fd493011be0>,39,17,[5 2],40,-1,57,-1,40
1,<environment.Job instance at 0x7fd493011c80>,40,14,[6 1],41,-1,55,-1,41
1,<environment.Job instance at 0x7fd493011d20>,41,17,[9 3],42,-1,59,-1,42
1,<environment.Job instance at 0x7fd493011dc0>,42,3,[8 4],43,-1,46,-1,43
1,<environment.Job instance at 0x7fd493011e60>,43,15,[2 7],44,-1,59,-1,44
1,<environment.Job instance at 0x7fd493011f00>,44,19,[1 8],45,-1,64,-1,45
1,<environment.Job instance at 0x7fd493011fa0>,45,3,[9 3],46,-1,49,-1,46
1,<environment.Job instance at 0x7fd4930150a0>,46,17,[8 4],47,-1,64,-1,47
1,<environment.Job instance at 0x7fd493015140>,47,3,[6 1],48,-1,51,-1,48
1,<environment.Job instance at 0x7fd4930151e0>,48,12,[ 1 10],49,-1,61,-1,49
1,<environment.Job instance at 0x7fd493011960>,37,17,[5 6],38,-1,66,-1,49
1,<environment.Job instance at 0x7fd493015730>,53,20,[4 5],54,-1,74,-1,54
1,<environment.Job instance at 0x7fd493015640>,55,20,[5 5],56,-1,76,-1,56
1,<environment.Job instance at 0x7fd493015aa0>,56,18,[7 3],57,-1,75,-1,57
1,<environment.Job instance at 0x7fd493015d70>,60,16,[ 2 10],61,-1,78,-1,62
1,<environment.Job instance at 0x7fd493015c80>,62,15,[5 5],63,-1,78,-1,63
1,<environment.Job instance at 0x7fd493000640>,68,13,[8 5],69,-1,82,-1,69
1,<environment.Job instance at 0x7fd493000780>,69,15,[4 6],70,-1,85,-1,70
1,<environment.Job instance at 0x7fd493000820>,71,25,[1 6],72,-1,97,-1,72
1,<environment.Job instance at 0x7fd493000aa0>,74,17,[5 5],75,-1,92,-1,75
1,<environment.Job instance at 0x7fd493000b40>,75,24,[4 7],76,-1,100,-1,76
1,<environment.Job instance at 0x7fd493000c80>,77,15,[1 8],78,-1,93,-1,78
1,<environment.Job instance at 0x7fd493000d70>,79,15,[9 1],80,-1,95,-1,80
1,<environment.Job instance at 0x7fd493000eb0>,80,12,[10  4],81,-1,93,-1,81
1,<environment.Job instance at 0x7fd493027050>,81,15,[10  4],82,-1,97,-1,82
1,<environment.Job instance at 0x7fd493027230>,86,14,[9 2],87,-1,101,-1,87
1,<environment.Job instance at 0x7fd493027730>,87,28,[7 2],88,-1,116,-1,88
1,<environment.Job instance at 0x7fd493015960>,61,18,[3 9],62,-1,110,-1,92
1,<environment.Job instance at 0x7fd493027aa0>,94,21,[10  5],95,-1,117,-1,96
1,<environment.Job instance at 0x7fd493009d20>,119,17,[5 4],120,-1,2318,-1,2301
1,<environment.Job instance at 0x7fd493009a00>,114,15,[10  1],115,-1,2316,-1,2301
1,<environment.Job instance at 0x7fd4930155f0>,6,1,[ 3 11],7,-1,8,-1,7
1,<environment.Job instance at 0x7fd493000870>,11,23,[1 8],12,-1,42,-1,19
1,<environment.Job instance at 0x7fd4935dd820>,16,13,[ 5 11],17,-1,45,-1,32
1,<environment.Job instance at 0x7fd49300aaa0>,26,25,[8 1],27,-1,93,-1,68
1,<environment.Job instance at 0x7fd49cabdaa0>,34,28,[7 4],35,-1,108,-1,80
1,<environment.Job instance at 0x7fd493a0f780>,57,13,[14  1],58,-1,173,-1,160
1,<environment.Job instance at 0x7fd4926eb0a0>,66,2,[14  1],67,-1,201,-1,199
1,<environment.Job instance at 0x7fd492c4af00>,71,25,[1 6],72,-1,242,-1,217
1,<environment.Job instance at 0x7fd4939b9320>,72,12,[12  2],73,-1,229,-1,217
1,<environment.Job instance at 0x7fd4939b9550>,73,26,[10  4],74,-1,246,-1,220
1,<environment.Job instance at 0x7fd49c486e60>,75,24,[4 7],76,-1,251,-1,227
1,<environment.Job instance at 0x7fd4929fd2d0>,84,13,[ 5 11],85,-1,276,-1,263
1,<environment.Job instance at 0x7fd49357eb90>,87,28,[7 2],88,-1,309,-1,281
1,<environment.Job instance at 0x7fd493ecf4b0>,89,27,[ 3 10],90,-1,313,-1,286
1,<environment.Job instance at 0x7fd493e6a640>,92,26,[9 1],93,-1,325,-1,299
1,<environment.Job instance at 0x7fd492d40c80>,96,3,[ 2 14],97,-1,302,-1,299
1,<environment.Job instance at 0x7fd4926d11e0>,107,27,[9 4],108,-1,361,-1,334
1,<environment.Job instance at 0x7fd492dfc460>,118,17,[13  5],119,-1,388,-1,371
1,<environment.Job instance at 0x7fd493c69a50>,7,17,[ 5 10],8,-1,26,-1,9
1,<environment.Job instance at 0x7fd493c690f0>,9,23,[5 7],10,-1,33,-1,10
1,<environment.Job instance at 0x7fd493c69f00>,10,15,[3 7],11,-1,26,-1,11
1,<environment.Job instance at 0x7fd492bb0f00>,13,25,[ 1 10],14,-1,39,-1,14
1,<environment.Job instance at 0x7fd492587d20>,17,19,[ 2 10],18,-1,37,-1,18
1,<environment.Job instance at 0x7fd493e6c1e0>,21,18,[9 3],22,-1,40,-1,22
1,<environment.Job instance at 0x7fd493508730>,26,14,[9 3],27,-1,41,-1,27
1,<environment.Job instance at 0x7fd4935d0500>,8,21,[2 5],9,-1,64,-1,43
1,<environment.Job instance at 0x7fd4929190f0>,33,13,[10  4],34,-1,56,-1,43
1,<environment.Job instance at 0x7fd49399e870>,37,15,[8 5],38,-1,58,-1,43
1,<environment.Job instance at 0x7fd49399e7d0>,39,21,[7 2],40,-1,64,-1,43
1,<environment.Job instance at 0x7fd49397e370>,47,21,[10  4],48,-1,82,-1,61
1,<environment.Job instance at 0x7fd49267e3c0>,40,13,[4 9],41,-1,83,-1,70
1,<environment.Job instance at 0x7fd49397e550>,51,21,[1 7],52,-1,91,-1,70
1,<environment.Job instance at 0x7fd4929ca960>,53,14,[6 4],54,-1,84,-1,70
1,<environment.Job instance at 0x7fd4929ca550>,56,16,[1 7],57,-1,89,-1,73
1,<environment.Job instance at 0x7fd4929ca870>,55,12,[10  3],56,-1,85,-1,73
1,<environment.Job instance at 0x7fd493d3fe60>,31,12,[4 6],32,-1,99,-1,87
1,<environment.Job instance at 0x7fd4929cad70>,61,16,[1 5],62,-1,103,-1,87
1,<environment.Job instance at 0x7fd492fefb90>,62,18,[1 5],63,-1,105,-1,87
1,<environment.Job instance at 0x7fd492fefdc0>,67,13,[ 5 10],68,-1,101,-1,88
1,<environment.Job instance at 0x7fd492fef5f0>,68,16,[6 5],69,-1,104,-1,88
1,<environment.Job instance at 0x7fd493d88320>,70,25,[6 2],71,-1,113,-1,88
1,<environment.Job instance at 0x7fd49267e460>,2,13,[13  5],3,-1,16,-1,3
1,<environment.Job instance at 0x7fd492ba8550>,5,2,[ 2 12],6,-1,8,-1,6
1,<environment.Job instance at 0x7fd492a2e6e0>,9,23,[5 7],10,-1,38,-1,15
1,<environment.Job instance at 0x7fd492a2e2d0>,13,25,[ 1 10],14,-1,44,-1,19
1,<environment.Job instance at 0x7fd493015690>,16,12,[14  2],17,-1,31,-1,19
1,<environment.Job instance at 0x7fd493015dc0>,18,1,[ 5 14],19,-1,20,-1,19
1,<environment.Job instance at 0x7fd4938a04b0>,30,12,[ 1 13],31,-1,76,-1,64
1,<environment.Job instance at 0x7fd49282aaf0>,35,2,[11  4],36,-1,84,-1,82
1,<environment.Job instance at 0x7fd49c97d870>,44,14,[ 1 12],45,-1,117,-1,103
1,<environment.Job instance at 0x7fd4926d4780>,46,23,[ 5 12],47,-1,136,-1,113
1,<environment.Job instance at 0x7fd4929fb280>,52,1,[ 4 11],53,-1,118,-1,117
1,<environment.Job instance at 0x7fd4932925f0>,64,3,[ 1 12],65,-1,161,-1,158
1,<environment.Job instance at 0x7fd4938f0550>,70,25,[6 2],71,-1,213,-1,188
1,<environment.Job instance at 0x7fd4932a7be0>,72,3,[14  1],73,-1,191,-1,188
1,<environment.Job instance at 0x7fd4926843c0>,73,1,[ 4 12],74,-1,189,-1,188
1,<environment.Job instance at 0x7fd493c68320>,81,18,[14  2],82,-1,213,-1,195
1,<environment.Job instance at 0x7fd493706b90>,85,15,[12  5],86,-1,226,-1,211
1,<environment.Job instance at 0x7fd49370aaf0>,87,27,[4 8],88,-1,254,-1,227
1,<environment.Job instance at 0x7fd49345c6e0>,88,20,[ 4 13],89,-1,247,-1,227
1,<environment.Job instance at 0x7fd492603550>,113,18,[ 5 13],114,-1,322,-1,304
1,<environment.Job instance at 0x7fd493c99690>,2,17,[3 5],3,-1,20,-1,3
1,<environment.Job instance at 0x7fd49ca51be0>,5,18,[4 9],6,-1,24,-1,6
1,<environment.Job instance at 0x7fd49ca51f50>,8,18,[6 5],9,-1,27,-1,9
1,<environment.Job instance at 0x7fd493e1c550>,13,18,[6 1],14,-1,32,-1,14
1,<environment.Job instance at 0x7fd493e1c1e0>,14,16,[1 6],15,-1,31,-1,15
1,<environment.Job instance at 0x7fd493e1c500>,15,16,[10  1],16,-1,33,-1,17
1,<environment.Job instance at 0x7fd493e1c3c0>,16,21,[10  4],17,-1,38,-1,17
1,<environment.Job instance at 0x7fd492660a00>,25,23,[7 3],26,-1,49,-1,26
1,<environment.Job instance at 0x7fd492660eb0>,27,20,[8 3],28,-1,50,-1,30
1,<environment.Job instance at 0x7fd4926600f0>,29,22,[9 1],30,-1,52,-1,30
1,<environment.Job instance at 0x7fd492d5e0a0>,31,16,[1 7],32,-1,48,-1,32
1,<environment.Job instance at 0x7fd492d2cc30>,38,18,[5 9],39,-1,57,-1,39
1,<environment.Job instance at 0x7fd4928325a0>,39,16,[8 4],40,-1,56,-1,40
1,<environment.Job instance at 0x7fd49361db40>,42,16,[4 7],43,-1,59,-1,43
1,<environment.Job instance at 0x7fd4937d0cd0>,43,16,[5 9],44,-1,60,-1,44
1,<environment.Job instance at 0x7fd4928327d0>,44,16,[3 5],45,-1,61,-1,45
1,<environment.Job instance at 0x7fd493650050>,45,15,[ 3 10],46,-1,62,-1,47
1,<environment.Job instance at 0x7fd493578500>,60,14,[5 3],61,-1,75,-1,61
1,<environment.Job instance at 0x7fd493625e10>,62,12,[9 4],63,-1,75,-1,63
1,<environment.Job instance at 0x7fd493625960>,63,14,[5 9],64,-1,78,-1,64
1,<environment.Job instance at 0x7fd493eeca50>,65,18,[6 4],66,-1,84,-1,66
1,<environment.Job instance at 0x7fd493b3eb90>,67,22,[6 4],68,-1,98,-1,76
1,<environment.Job instance at 0x7fd492fa7f00>,93,18,[10  4],94,-1,938,-1,920
1,<environment.Job instance at 0x7fd492f2baa0>,115,16,[2 9],116,-1,1031,-1,1015
1,<environment.Job instance at 0x7fd49ca51910>,17,14,[ 3 12],18,-1,37,-1,23
1,<environment.Job instance at 0x7fd4933a4cd0>,25,23,[7 3],26,-1,79,-1,56
1,<environment.Job instance at 0x7fd4930b8820>,32,18,[ 3 13],33,-1,77,-1,59
1,<environment.Job instance at 0x7fd4938a07d0>,52,26,[9 3],53,-1,161,-1,135
1,<environment.Job instance at 0x7fd4932b3eb0>,56,3,[12  4],57,-1,142,-1,139
1,<environment.Job instance at 0x7fd4930921e0>,66,15,[ 1 11],67,-1,188,-1,173
1,<environment.Job instance at 0x7fd492e37460>,78,12,[14  5],79,-1,233,-1,221
1,<environment.Job instance at 0x7fd493a55370>,88,23,[1 5],89,-1,294,-1,271
1,<environment.Job instance at 0x7fd493a55dc0>,89,2,[12  2],90,-1,273,-1,271
1,<environment.Job instance at 0x7fd493cf79b0>,106,17,[13  4],107,-1,354,-1,337
1,<environment.Job instance at 0x7fd4934d7870>,109,17,[ 1 11],110,-1,369,-1,352
1,<environment.Job instance at 0x7fd493c4d4b0>,114,17,[12  2],115,-1,385,-1,368
1,<environment.Job instance at 0x7fd493293af0>,122,1,[ 1 11],123,-1,399,-1,398
1,<environment.Job instance at 0x7fd493731cd0>,124,12,[ 3 12],125,-1,410,-1,398
1,<environment.Job instance at 0x7fd493293910>,125,17,[14  3],126,-1,415,-1,398
1,<environment.Job instance at 0x7fd493731960>,127,24,[1 8],128,-1,440,-1,416
1,<environment.Job instance at 0x7fd493095320>,2,24,[7 2],3,-1,27,-1,3
1,<environment.Job instance at 0x7fd493095f00>,3,18,[1 7],4,-1,22,-1,4
1,<environment.Job instance at 0x7fd4930957d0>,4,27,[5 1],5,-1,32,-1,5
1,<environment.Job instance at 0x7fd4926985a0>,11,18,[5 6],12,-1,30,-1,12
1,<environment.Job instance at 0x7fd4926986e0>,14,14,[ 4 10],15,-1,29,-1,15
1,<environment.Job instance at 0x7fd49380b140>,15,16,[6 5],16,-1,32,-1,16
1,<environment.Job instance at 0x7fd49c421730>,17,18,[3 8],18,-1,36,-1,18
1,<environment.Job instance at 0x7fd49380b870>,19,14,[2 7],20,-1,34,-1,20
1,<environment.Job instance at 0x7fd492ffc410>,22,16,[3 7],23,-1,39,-1,23
1,<environment.Job instance at 0x7fd493ecf410>,23,15,[9 4],24,-1,39,-1,24
1,<environment.Job instance at 0x7fd4935d0280>,27,18,[2 8],28,-1,47,-1,29
1,<environment.Job instance at 0x7fd493ece690>,32,16,[6 4],33,-1,49,-1,33
1,<environment.Job instance at 0x7fd492e3b730>,33,12,[10  2],34,-1,46,-1,34
1,<environment.Job instance at 0x7fd4935fcd70>,35,27,[1 5],36,-1,63,-1,36
1,<environment.Job instance at 0x7fd4935fc550>,36,18,[ 2 10],37,-1,55,-1,37
1,<environment.Job instance at 0x7fd49259dbe0>,40,15,[8 4],41,-1,56,-1,41
1,<environment.Job instance at 0x7fd49259dfa0>,41,18,[7 3],42,-1,60,-1,42
1,<environment.Job instance at 0x7fd49259db90>,42,17,[1 7],43,-1,60,-1,43
1,<environment.Job instance at 0x7fd49259d8c0>,45,12,[8 1],46,-1,58,-1,46
1,<environment.Job instance at 0x7fd49259dd70>,47,15,[ 3 10],48,-1,63,-1,48
1,<environment.Job instance at 0x7fd49259db40>,48,12,[10  1],49,-1,61,-1,49
1,<environment.Job instance at 0x7fd492a29b90>,49,12,[4 6],50,-1,62,-1,50
1,<environment.Job instance at 0x7fd492a29fa0>,50,17,[5 2],51,-1,68,-1,51
1,<environment.Job instance at 0x7fd4937d00f0>,51,21,[8 4],52,-1,73,-1,52
1,<environment.Job instance at 0x7fd4937d0870>,52,16,[1 7],53,-1,69,-1,53
1,<environment.Job instance at 0x7fd49257a4b0>,55,18,[4 5],56,-1,74,-1,56
1,<environment.Job instance at 0x7fd49379b3c0>,57,18,[2 7],58,-1,76,-1,58
1,<environment.Job instance at 0x7fd49399d910>,64,20,[8 2],65,-1,85,-1,65
1,<environment.Job instance at 0x7fd49399d190>,65,14,[4 9],66,-1,80,-1,66
1,<environment.Job instance at 0x7fd49399d2d0>,69,13,[2 6],70,-1,83,-1,70
1,<environment.Job instance at 0x7fd493b65780>,70,21,[10  5],71,-1,92,-1,71
1,<environment.Job instance at 0x7fd493b65a00>,73,19,[7 1],74,-1,93,-1,74
1,<environment.Job instance at 0x7fd493d30460>,82,16,[9 2],83,-1,99,-1,83
1,<environment.Job instance at 0x7fd4935dd410>,89,2,[9 5],90,-1,92,-1,90
1,<environment.Job instance at 0x7fd4935dd9b0>,91,15,[9 3],92,-1,107,-1,92
1,<environment.Job instance at 0x7fd4935dd730>,92,17,[4 9],93,-1,110,-1,93
1,<environment.Job instance at 0x7fd4935dd140>,94,24,[7 3],95,-1,119,-1,95
1,<environment.Job instance at 0x7fd4935dd320>,95,13,[7 2],96,-1,109,-1,96
1,<environment.Job instance at 0x7fd493a113c0>,96,21,[5 3],97,-1,118,-1,97
1,<environment.Job instance at 0x7fd493a11c30>,97,22,[1 9],98,-1,120,-1,98
1,<environment.Job instance at 0x7fd493a11370>,98,16,[1 7],99,-1,115,-1,99
1,<environment.Job instance at 0x7fd493a11910>,100,12,[10  5],101,-1,114,-1,102
1,<environment.Job instance at 0x7fd493a11c80>,103,17,[8 3],104,-1,121,-1,104
1,<environment.Job instance at 0x7fd493a11fa0>,104,19,[ 5 12],105,-1,124,-1,105
1,<environment.Job instance at 0x7fd493a11190>,105,27,[2 8],106,-1,133,-1,106
1,<environment.Job instance at 0x7fd493a11960>,107,15,[5 5],108,-1,123,-1,108
1,<environment.Job instance at 0x7fd493420e60>,110,14,[1 9],111,-1,125,-1,111
1,<environment.Job instance at 0x7fd493420140>,112,24,[5 7],113,-1,137,-1,113
1,<environment.Job instance at 0x7fd493a11d70>,101,16,[10  1],102,-1,132,-1,116
1,<environment.Job instance at 0x7fd493d26cd0>,119,23,[6 1],120,-1,143,-1,120
1,<environment.Job instance at 0x7fd4932d6f00>,122,18,[ 3 10],123,-1,141,-1,123
1,<environment.Job instance at 0x7fd4932d6230>,124,18,[ 3 10],125,-1,143,-1,125
1,<environment.Job instance at 0x7fd4932d6c30>,126,23,[ 2 10],127,-1,150,-1,127
1,<environment.Job instance at 0x7fd492698eb0>,2,24,[7 2],3,-1,27,-1,3
1,<environment.Job instance at 0x7fd492698550>,4,27,[5 1],5,-1,32,-1,5
1,<environment.Job instance at 0x7fd492caac30>,5,1,[ 5 12],6,-1,7,-1,6
1,<environment.Job instance at 0x7fd4935fcb40>,8,3,[13  2],9,-1,12,-1,9
1,<environment.Job instance at 0x7fd493b65500>,20,3,[13  5],21,-1,38,-1,35
1,<environment.Job instance at 0x7fd4934200f0>,25,3,[14  3],26,-1,64,-1,61
1,<environment.Job instance at 0x7fd4932f3af0>,35,27,[1 5],36,-1,128,-1,101
1,<environment.Job instance at 0x7fd493338dc0>,39,3,[13  3],40,-1,115,-1,112
1,<environment.Job instance at 0x7fd492e8bb40>,75,1,[ 3 11],76,-1,231,-1,230
1,<environment.Job instance at 0x7fd492fa74b0>,86,23,[ 1 13],87,-1,271,-1,248
1,<environment.Job instance at 0x7fd49301b280>,87,2,[ 2 11],88,-1,250,-1,248
1,<environment.Job instance at 0x7fd4936215a0>,94,24,[7 3],95,-1,296,-1,272
1,<environment.Job instance at 0x7fd4936218c0>,104,19,[ 5 12],105,-1,332,-1,313
1,<environment.Job instance at 0x7fd493621730>,105,27,[2 8],106,-1,355,-1,328
1,<environment.Job instance at 0x7fd493d88640>,109,1,[ 4 13],110,-1,331,-1,330
1,<environment.Job instance at 0x7fd493d88a50>,112,24,[5 7],113,-1,357,-1,333
1,<environment.Job instance at 0x7fd493c685a0>,119,23,[6 1],120,-1,377,-1,354
1,<environment.Job instance at 0x7fd493c68be0>,120,1,[11  4],121,-1,355,-1,354
1,<environment.Job instance at 0x7fd493c68960>,126,23,[ 2 10],127,-1,394,-1,371
1,<environment.Job instance at 0x7fd493907910>,7,17,[5 6],8,-1,26,-1,9
1,<environment.Job instance at 0x7fd493907aa0>,9,14,[ 2 10],10,-1,24,-1,10
1,<environment.Job instance at 0x7fd4937c0370>,16,13,[2 7],17,-1,30,-1,17
1,<environment.Job instance at 0x7fd493907c30>,8,15,[3 5],9,-1,32,-1,17
1,<environment.Job instance at 0x7fd4937c0780>,18,14,[2 8],19,-1,34,-1,20
1,<environment.Job instance at 0x7fd4937c0460>,20,18,[5 6],21,-1,39,-1,21
1,<environment.Job instance at 0x7fd4937c0640>,19,12,[7 4],20,-1,33,-1,21
1,<environment.Job instance at 0x7fd4937c0be0>,23,13,[10  5],24,-1,39,-1,26
1,<environment.Job instance at 0x7fd4937b45a0>,25,15,[10  4],26,-1,41,-1,26
1,<environment.Job instance at 0x7fd493550370>,39,20,[3 9],40,-1,65,-1,45
1,<environment.Job instance at 0x7fd493550460>,40,16,[4 9],41,-1,61,-1,45
1,<environment.Job instance at 0x7fd49352c1e0>,51,17,[7 4],52,-1,85,-1,68
1,<environment.Job instance at 0x7fd4935481e0>,53,16,[1 9],54,-1,84,-1,68
1,<environment.Job instance at 0x7fd493516780>,55,27,[6 2],56,-1,95,-1,68
1,<environment.Job instance at 0x7fd493516fa0>,57,15,[10  5],58,-1,86,-1,71
1,<environment.Job instance at 0x7fd493526410>,41,23,[8 4],42,-1,94,-1,71
1,<environment.Job instance at 0x7fd49354e2d0>,0,15,[ 1 11],1,-1,16,-1,1
1,<environment.Job instance at 0x7fd49354eeb0>,1,2,[11  4],2,-1,4,-1,2
1,<environment.Job instance at 0x7fd49354da50>,2,3,[14  5],3,-1,6,-1,3
1,<environment.Job instance at 0x7fd493d8e190>,26,26,[5 7],27,-1,95,-1,69
1,<environment.Job instance at 0x7fd493d8e910>,29,13,[ 2 14],30,-1,82,-1,69
1,<environment.Job instance at 0x7fd493d76190>,36,3,[ 4 11],37,-1,91,-1,88
1,<environment.Job instance at 0x7fd493d7af50>,44,3,[11  3],45,-1,119,-1,116
1,<environment.Job instance at 0x7fd493d9b280>,46,2,[ 2 12],47,-1,120,-1,118
1,<environment.Job instance at 0x7fd492ce29b0>,41,23,[8 4],42,-1,155,-1,132
1,<environment.Job instance at 0x7fd492cd8910>,55,27,[6 2],56,-1,174,-1,147
1,<environment.Job instance at 0x7fd492cbc5f0>,58,3,[ 3 12],59,-1,154,-1,151
1,<environment.Job instance at 0x7fd493197aa0>,75,1,[ 4 14],76,-1,230,-1,229
1,<environment.Job instance at 0x7fd492681460>,86,14,[ 5 11],87,-1,263,-1,249
1,<environment.Job instance at 0x7fd49267f5a0>,89,22,[14  5],90,-1,274,-1,252
1,<environment.Job instance at 0x7fd493d85730>,92,12,[11  2],93,-1,270,-1,258
1,<environment.Job instance at 0x7fd4933fd0f0>,107,25,[6 5],108,-1,333,-1,308
1,<environment.Job instance at 0x7fd4928d8050>,118,25,[5 7],119,-1,360,-1,335
1,<environment.Job instance at 0x7fd4928d8460>,119,13,[ 3 12],120,-1,348,-1,335
1,<environment.Job instance at 0x7fd492a2fd20>,128,3,[12  5],129,-1,358,-1,355
1,<environment.Job instance at 0x7fd49352c3c0>,1,14,[8 5],2,-1,16,-1,2
1,<environment.Job instance at 0x7fd49352caa0>,2,18,[5 8],3,-1,21,-1,3
1,<environment.Job instance at 0x7fd49352c640>,7,28,[6 3],8,-1,36,-1,8
1,<environment.Job instance at 0x7fd49352ce10>,10,18,[5 5],11,-1,29,-1,11
1,<environment.Job instance at 0x7fd49390beb0>,9,1,[2 6],10,-1,12,-1,11
1,<environment.Job instance at 0x7fd49352cd70>,11,19,[3 6],12,-1,31,-1,12
1,<environment.Job instance at 0x7fd4927b1640>,14,18,[1 9],15,-1,33,-1,15
1,<environment.Job instance at 0x7fd4927b1460>,19,17,[8 2],20,-1,37,-1,20
1,<environment.Job instance at 0x7fd4927b1730>,21,19,[3 9],22,-1,41,-1,22
1,<environment.Job instance at 0x7fd4927b1690>,22,16,[5 5],23,-1,39,-1,23
1,<environment.Job instance at 0x7fd4927b1c30>,25,17,[10  2],26,-1,43,-1,26
1,<environment.Job instance at 0x7fd4927b1d70>,26,17,[4 9],27,-1,44,-1,27
1,<environment.Job instance at 0x7fd4927b1be0>,28,13,[5 5],29,-1,42,-1,29
1,<environment.Job instance at 0x7fd493526140>,30,13,[1 6],31,-1,44,-1,31
1,<environment.Job instance at 0x7fd4935264b0>,35,16,[6 1],36,-1,52,-1,36
1,<environment.Job instance at 0x7fd493526be0>,40,12,[ 3 11],41,-1,68,-1,56
1,<environment.Job instance at 0x7fd4927b1e10>,32,25,[2 8],33,-1,81,-1,56
1,<environment.Job instance at 0x7fd4935281e0>,47,14,[9 1],48,-1,70,-1,56
1,<environment.Job instance at 0x7fd493526eb0>,44,17,[4 8],45,-1,73,-1,56
1,<environment.Job instance at 0x7fd493528cd0>,46,15,[3 5],47,-1,71,-1,56
1,<environment.Job instance at 0x7fd493528370>,50,27,[3 8],51,-1,83,-1,56
1,<environment.Job instance at 0x7fd493528820>,52,12,[7 2],53,-1,68,-1,56
1,<environment.Job instance at 0x7fd493528b40>,55,18,[4 5],56,-1,79,-1,61
1,<environment.Job instance at 0x7fd492b35280>,89,22,[12  5],90,-1,347,-1,325
1,<environment.Job instance at 0x7fd492b0d6e0>,108,19,[5 8],109,-1,344,-1,325
1,<environment.Job instance at 0x7fd492b128c0>,112,18,[10  4],113,-1,361,-1,343
1,<environment.Job instance at 0x7fd492b12230>,114,17,[6 4],115,-1,360,-1,343
1,<environment.Job instance at 0x7fd492b35cd0>,85,26,[ 4 10],86,-1,369,-1,343
1,<environment.Job instance at 0x7fd492b0da00>,105,16,[ 5 10],106,-1,359,-1,343
1,<environment.Job instance at 0x7fd4931d1c30>,120,2,[10  3],121,-1,346,-1,344
1,<environment.Job instance at 0x7fd492b12c30>,113,16,[1 8],114,-1,362,-1,346
1,<environment.Job instance at 0x7fd493474870>,124,12,[5 5],125,-1,358,-1,346
1,<environment.Job instance at 0x7fd493474eb0>,125,16,[ 3 10],126,-1,362,-1,346
1,<environment.Job instance at 0x7fd493474370>,126,18,[5 7],127,-1,366,-1,348
1,<environment.Job instance at 0x7fd493c6ca00>,127,28,[8 3],128,-1,376,-1,348
1,<environment.Job instance at 0x7fd492b35370>,94,27,[3 7],95,-1,375,-1,348
1,<environment.Job instance at 0x7fd493526f00>,5,26,[14  3],6,-1,32,-1,6
1,<environment.Job instance at 0x7fd492c4b280>,7,28,[6 3],8,-1,43,-1,15
1,<environment.Job instance at 0x7fd4925edcd0>,16,2,[14  2],17,-1,34,-1,32
1,<environment.Job instance at 0x7fd493c9e050>,17,3,[13  2],18,-1,35,-1,32
1,<environment.Job instance at 0x7fd492a341e0>,29,18,[13  1],30,-1,76,-1,58
1,<environment.Job instance at 0x7fd493a33a00>,32,25,[2 8],33,-1,107,-1,82
1,<environment.Job instance at 0x7fd4932e5690>,34,15,[ 3 14],35,-1,97,-1,82
1,<environment.Job instance at 0x7fd492a0e0f0>,40,12,[ 3 11],41,-1,109,-1,97
1,<environment.Job instance at 0x7fd492603a00>,41,28,[1 5],42,-1,125,-1,97
1,<environment.Job instance at 0x7fd492e9c2d0>,50,27,[3 8],51,-1,164,-1,137
1,<environment.Job instance at 0x7fd493324050>,51,16,[ 3 14],52,-1,153,-1,137
1,<environment.Job instance at 0x7fd49c4702d0>,61,1,[12  2],62,-1,159,-1,158
1,<environment.Job instance at 0x7fd492fd1690>,80,23,[ 1 12],81,-1,246,-1,223
1,<environment.Job instance at 0x7fd492fb95f0>,82,28,[1 7],83,-1,269,-1,241
1,<environment.Job instance at 0x7fd492836550>,85,26,[ 4 10],86,-1,267,-1,241
1,<environment.Job instance at 0x7fd493c27190>,89,22,[12  5],90,-1,264,-1,242
1,<environment.Job instance at 0x7fd492d2cb90>,94,27,[3 7],95,-1,297,-1,270
1,<environment.Job instance at 0x7fd49270a500>,127,28,[8 3],128,-1,427,-1,399
1,<environment.Job instance at 0x7fd49c9029b0>,0,19,[3 8],1,-1,20,-1,1
1,<environment.Job instance at 0x7fd49c9025f0>,4,16,[4 6],5,-1,22,-1,6
1,<environment.Job instance at 0x7fd49c902640>,7,27,[3 7],8,-1,35,-1,8
1,<environment.Job instance at 0x7fd493b3a190>,8,13,[9 1],9,-1,22,-1,9
1,<environment.Job instance at 0x7fd493d815f0>,12,16,[7 5],13,-1,29,-1,13
1,<environment.Job instance at 0x7fd493d81960>,14,17,[5 2],15,-1,32,-1,15
1,<environment.Job instance at 0x7fd493227f00>,5,15,[5 5],6,-1,32,-1,17
1,<environment.Job instance at 0x7fd493d9f1e0>,18,18,[2 5],19,-1,37,-1,19
1,<environment.Job instance at 0x7fd493d9fd70>,20,1,[5 1],21,-1,22,-1,21
1,<environment.Job instance at 0x7fd493d9fcd0>,21,18,[ 5 10],22,-1,40,-1,22
1,<environment.Job instance at 0x7fd493d9f230>,22,2,[8 3],23,-1,25,-1,23
1,<environment.Job instance at 0x7fd493d9fc30>,23,12,[2 9],24,-1,36,-1,24
1,<environment.Job instance at 0x7fd49362ccd0>,26,15,[9 2],27,-1,42,-1,27
1,<environment.Job instance at 0x7fd49302dc30>,56,17,[10  5],57,-1,92,-1,75
1,<environment.Job instance at 0x7fd49302d1e0>,53,17,[10  5],54,-1,98,-1,81
1,<environment.Job instance at 0x7fd49302d8c0>,51,26,[6 3],52,-1,107,-1,81
1,<environment.Job instance at 0x7fd49362cc80>,29,16,[ 1 10],30,-1,97,-1,81
1,<environment.Job instance at 0x7fd492739a00>,67,17,[5 5],68,-1,98,-1,81
1,<environment.Job instance at 0x7fd49302dbe0>,52,12,[7 5],53,-1,93,-1,81
1,<environment.Job instance at 0x7fd492739140>,65,27,[8 5],66,-1,108,-1,81
1,<environment.Job instance at 0x7fd492739b90>,69,18,[1 5],70,-1,99,-1,81
1,<environment.Job instance at 0x7fd49302d870>,62,17,[4 9],63,-1,98,-1,81
1,<environment.Job instance at 0x7fd492739cd0>,68,24,[7 4],69,-1,105,-1,81
1,<environment.Job instance at 0x7fd49394e280>,2,22,[13  5],3,-1,25,-1,3
1,<environment.Job instance at 0x7fd493c35320>,3,28,[10  5],4,-1,32,-1,4
1,<environment.Job instance at 0x7fd493b618c0>,7,27,[3 7],8,-1,47,-1,20
1,<environment.Job instance at 0x7fd493b4f820>,16,27,[13  1],17,-1,54,-1,27
1,<environment.Job instance at 0x7fd493e4d1e0>,25,25,[2 7],26,-1,78,-1,53
1,<environment.Job instance at 0x7fd492d2cf50>,27,17,[ 5 14],28,-1,70,-1,53
1,<environment.Job instance at 0x7fd4932215a0>,51,26,[6 3],52,-1,160,-1,134
1,<environment.Job instance at 0x7fd49c4700a0>,57,1,[ 5 12],58,-1,150,-1,149
1,<environment.Job instance at 0x7fd4925e4af0>,59,3,[12  2],60,-1,152,-1,149
1,<environment.Job instance at 0x7fd492e9caa0>,61,3,[11  1],62,-1,153,-1,150
1,<environment.Job instance at 0x7fd493837d20>,65,27,[8 5],66,-1,193,-1,166
1,<environment.Job instance at 0x7fd4938375f0>,68,24,[7 4],69,-1,193,-1,169
1,<environment.Job instance at 0x7fd492ea42d0>,77,13,[ 2 13],78,-1,199,-1,186
1,<environment.Job instance at 0x7fd4939c28c0>,78,17,[ 1 13],79,-1,203,-1,186
1,<environment.Job instance at 0x7fd4939c2550>,79,2,[12  1],80,-1,188,-1,186
1,<environment.Job instance at 0x7fd4938dd960>,81,24,[ 3 14],82,-1,211,-1,187
1,<environment.Job instance at 0x7fd493276910>,88,13,[14  1],89,-1,217,-1,204
1,<environment.Job instance at 0x7fd493a216e0>,91,15,[ 3 13],92,-1,222,-1,207
1,<environment.Job instance at 0x7fd492e80870>,96,26,[ 4 10],97,-1,259,-1,233
1,<environment.Job instance at 0x7fd49381f320>,101,3,[ 2 12],102,-1,252,-1,249
1,<environment.Job instance at 0x7fd49381fcd0>,105,13,[13  4],106,-1,275,-1,262
1,<environment.Job instance at 0x7fd49381f0a0>,106,25,[ 3 12],107,-1,287,-1,262
1,<environment.Job instance at 0x7fd49352b370>,114,25,[7 4],115,-1,305,-1,280
1,<environment.Job instance at 0x7fd49352b0f0>,116,28,[6 2],117,-1,308,-1,280
1,<environment.Job instance at 0x7fd4932bfa00>,120,1,[ 2 11],121,-1,285,-1,284
1,<environment.Job instance at 0x7fd492fae370>,122,14,[ 4 14],123,-1,300,-1,286
1,<environment.Job instance at 0x7f653a1a36e0>,0,18,[ 2 10],1,-1,20,-1,2
1,<environment.Job instance at 0x7f6530bb3a50>,3,18,[ 3 10],4,-1,22,-1,4
1,<environment.Job instance at 0x7f6530bb3be0>,4,18,[10  4],5,-1,23,-1,5
1,<environment.Job instance at 0x7f6530bb3af0>,5,13,[5 9],6,-1,19,-1,6
1,<environment.Job instance at 0x7f6530bb3c80>,6,12,[11  4],7,-1,19,-1,7
1,<environment.Job instance at 0x7f6530bb3dc0>,8,17,[ 2 10],9,-1,26,-1,9
1,<environment.Job instance at 0x7f6530bb3f00>,9,17,[ 4 10],10,-1,27,-1,10
1,<environment.Job instance at 0x7f6530bb62d0>,13,13,[1 8],14,-1,27,-1,14
1,<environment.Job instance at 0x7f6530bb6730>,18,16,[8 5],19,-1,35,-1,19
1,<environment.Job instance at 0x7f6530bb6b90>,23,18,[5 2],24,-1,42,-1,24
1,<environment.Job instance at 0x7f6530bb6eb0>,26,22,[2 9],27,-1,49,-1,27
1,<environment.Job instance at 0x7f6530bb9370>,31,17,[4 9],32,-1,49,-1,32
1,<environment.Job instance at 0x7f6530bb90f0>,32,17,[9 3],33,-1,50,-1,33
1,<environment.Job instance at 0x7f6530bb9f00>,44,17,[ 5 12],45,-1,81,-1,64
1,<environment.Job instance at 0x7f653a1a38c0>,1,15,[ 1 14],2,-1,79,-1,64
1,<environment.Job instance at 0x7f6530bbb500>,48,13,[6 1],49,-1,77,-1,64
1,<environment.Job instance at 0x7f6530bbb5f0>,50,27,[9 1],51,-1,91,-1,64
1,<environment.Job instance at 0x7f6530bbb6e0>,49,2,[1 9],50,-1,67,-1,65
1,<environment.Job instance at 0x7f6530bbb910>,53,18,[ 4 12],54,-1,84,-1,66
1,<environment.Job instance at 0x7f6530bbb2d0>,45,16,[6 2],46,-1,82,-1,66
1,<environment.Job instance at 0x7f6530bbb960>,54,14,[1 7],55,-1,80,-1,66
1,<environment.Job instance at 0x7f6530bbbaa0>,56,18,[4 5],57,-1,84,-1,66
1,<environment.Job instance at 0x7f6530bbbb40>,57,3,[8 4],58,-1,71,-1,68
1,<environment.Job instance at 0x7f6530bbbd20>,60,24,[ 3 10],61,-1,98,-1,74
1,<environment.Job instance at 0x7f6530bbbe60>,62,20,[9 1],63,-1,95,-1,75
1,<environment.Job instance at 0x7f6530bbba00>,55,17,[4 7],56,-1,100,-1,83
1,<environment.Job instance at 0x7f6530bbbf50>,63,15,[1 5],64,-1,98,-1,83
1,<environment.Job instance at 0x7f6530bbf690>,68,22,[5 6],69,-1,105,-1,83
1,<environment.Job instance at 0x7f6530bb9e10>,41,14,[6 1],42,-1,97,-1,83
1,<environment.Job instance at 0x7f6530bbf4b0>,67,26,[5 4],68,-1,109,-1,83
1,<environment.Job instance at 0x7f6530bbf640>,69,13,[7 2],70,-1,96,-1,83
1,<environment.Job instance at 0x7f6530bbf780>,72,14,[9 1],73,-1,97,-1,83
1,<environment.Job instance at 0x7f6530bbf820>,73,3,[10  4],74,-1,86,-1,83
1,<environment.Job instance at 0x7f6530bb9f50>,43,28,[6 4],44,-1,111,-1,83
1,<environment.Job instance at 0x7f6530bbf460>,71,1,[8 2],72,-1,84,-1,83
1,<environment.Job instance at 0x7f6530bbf5a0>,70,18,[5 5],71,-1,104,-1,86
1,<environment.Job instance at 0x7f6530bbfd20>,78,19,[8 4],79,-1,105,-1,86
1,<environment.Job instance at 0x7f6530bbfdc0>,79,17,[2 7],80,-1,103,-1,86
1,<environment.Job instance at 0x7f6530bc1410>,84,12,[3 5],85,-1,98,-1,86
1,<environment.Job instance at 0x7f6530bbfaa0>,76,13,[1 5],77,-1,99,-1,86
1,<environment.Job instance at 0x7f6530bbfc80>,77,15,[4 7],78,-1,104,-1,89
1,<environment.Job instance at 0x7f6530bc1820>,88,12,[3 5],89,-1,101,-1,89
1,<environment.Job instance at 0x7f6530bc1960>,89,13,[7 2],90,-1,103,-1,90
1,<environment.Job instance at 0x7f6530bc17d0>,87,2,[ 4 10],88,-1,93,-1,91
1,<environment.Job instance at 0x7f6530bc1af0>,91,16,[5 8],92,-1,108,-1,92
1,<environment.Job instance at 0x7f6530bc1cd0>,93,12,[4 9],94,-1,106,-1,94
1,<environment.Job instance at 0x7f653a1d9780>,95,23,[3 7],96,-1,119,-1,96
1,<environment.Job instance at 0x7f6530baa8c0>,98,12,[10  1],99,-1,113,-1,101
1,<environment.Job instance at 0x7f6530baad20>,100,18,[7 5],101,-1,120,-1,102
1,<environment.Job instance at 0x7f6530baa910>,103,17,[5 6],104,-1,121,-1,104
1,<environment.Job instance at 0x7f6530c0a7d0>,105,1,[3 6],106,-1,112,-1,111
1,<environment.Job instance at 0x7f6530baa5f0>,104,17,[5 4],105,-1,128,-1,111
1,<environment.Job instance at 0x7f6530cc0820>,116,15,[9 2],117,-1,132,-1,117
1,<environment.Job instance at 0x7f6530c56a00>,115,14,[9 1],116,-1,132,-1,118
1,<environment.Job instance at 0x7f6530c65500>,117,18,[ 3 12],118,-1,137,-1,119
1,<environment.Job instance at 0x7f6530cd04b0>,121,18,[11  5],122,-1,140,-1,122
1,<environment.Job instance at 0x7f6530cb5690>,122,14,[14  1],123,-1,140,-1,126
1,<environment.Job instance at 0x7f6530bd6550>,125,15,[5 3],126,-1,141,-1,126
1,<environment.Job instance at 0x7f6530cd6f00>,128,16,[7 1],129,-1,146,-1,130
1,<environment.Job instance at 0x7f6530c446e0>,130,16,[9 3],131,-1,147,-1,131
1,<environment.Job instance at 0x7f6530bdbeb0>,134,15,[10  5],135,-1,150,-1,135
1,<environment.Job instance at 0x7f6530bdbc30>,135,15,[ 3 14],136,-1,152,-1,137
1,<environment.Job instance at 0x7f6530bdb960>,136,18,[1 6],137,-1,155,-1,137
1,<environment.Job instance at 0x7f6530bb6280>,1,15,[ 1 14],2,-1,17,-1,2
1,<environment.Job instance at 0x7f6530bb95f0>,6,12,[11  4],7,-1,19,-1,7
1,<environment.Job instance at 0x7f6530cc0280>,19,17,[12  3],20,-1,67,-1,50
1,<environment.Job instance at 0x7f6530bdb690>,22,2,[12  3],23,-1,62,-1,60
1,<environment.Job instance at 0x7f6530cd21e0>,43,28,[6 4],44,-1,166,-1,138
1,<environment.Job instance at 0x7f6530c629b0>,44,17,[ 5 12],45,-1,155,-1,138
1,<environment.Job instance at 0x7f6530be0410>,50,27,[9 1],51,-1,179,-1,152
1,<environment.Job instance at 0x7f6530c62370>,52,3,[ 3 11],53,-1,155,-1,152
1,<environment.Job instance at 0x7f6530c61690>,53,18,[ 4 12],54,-1,170,-1,152
1,<environment.Job instance at 0x7f6530bee9b0>,60,24,[ 3 10],61,-1,209,-1,185
1,<environment.Job instance at 0x7f6530c0ce10>,67,26,[5 4],68,-1,226,-1,200
1,<environment.Job instance at 0x7f6530b96eb0>,81,17,[ 4 14],82,-1,256,-1,239
1,<environment.Job instance at 0x7f6530b9e730>,85,19,[14  4],86,-1,260,-1,241
1,<environment.Job instance at 0x7f6530ba7190>,95,23,[3 7],96,-1,294,-1,271
1,<environment.Job instance at 0x7f6530ba7690>,102,27,[ 3 13],103,-1,316,-1,289
1,<environment.Job instance at 0x7f6530ba3f00>,111,18,[ 3 13],112,-1,333,-1,315
1,<environment.Job instance at 0x7f6530bc1b90>,117,18,[ 3 12],118,-1,348,-1,330
1,<environment.Job instance at 0x7f6530b4d0f0>,121,18,[11  5],122,-1,359,-1,341
1,<environment.Job instance at 0x7f6530b4d230>,122,14,[14  1],123,-1,355,-1,341
1,<environment.Job instance at 0x7f6530b4daf0>,135,15,[ 3 14],136,-1,411,-1,396
1,<environment.Job instance at 0x7f6530b4dc30>,137,12,[14  5],138,-1,408,-1,396
1,<environment.Job instance at 0x7f6530616370>,0,17,[3 8],1,-1,18,-1,1
1,<environment.Job instance at 0x7f6530616a50>,5,15,[6 2],6,-1,21,-1,6
1,<environment.Job instance at 0x7f6530616e10>,10,13,[2 6],11,-1,24,-1,11
1,<environment.Job instance at 0x7f6530616f00>,11,16,[1 9],12,-1,28,-1,12
1,<environment.Job instance at 0x7f653061f3c0>,12,16,[6 2],13,-1,31,-1,15
1,<environment.Job instance at 0x7f653061f4b0>,15,14,[3 8],16,-1,31,-1,17
1,<environment.Job instance at 0x7f653061fa00>,17,17,[3 8],18,-1,35,-1,18
1,<environment.Job instance at 0x7f653061f320>,18,16,[3 9],19,-1,35,-1,19
1,<environment.Job instance at 0x7f6530624370>,23,15,[4 8],24,-1,39,-1,24
1,<environment.Job instance at 0x7f6530624500>,27,18,[5 2],28,-1,46,-1,28
1,<environment.Job instance at 0x7f65306245a0>,28,18,[4 6],29,-1,47,-1,29
1,<environment.Job instance at 0x7f6530624be0>,29,16,[3 5],30,-1,46,-1,30
1,<environment.Job instance at 0x7f6530624a50>,32,1,[ 5 10],33,-1,34,-1,33
1,<environment.Job instance at 0x7f6530680690>,33,12,[1 7],34,-1,46,-1,34
1,<environment.Job instance at 0x7f6530680aa0>,35,25,[3 9],36,-1,61,-1,36
1,<environment.Job instance at 0x7f6530680230>,37,13,[ 4 10],38,-1,51,-1,38
1,<environment.Job instance at 0x7f6530680c30>,38,14,[4 7],39,-1,53,-1,39
1,<environment.Job instance at 0x7f6530680370>,39,23,[2 8],40,-1,63,-1,40
1,<environment.Job instance at 0x7f6530778280>,45,17,[10  5],46,-1,63,-1,46
1,<environment.Job instance at 0x7f6530654e60>,46,26,[9 1],47,-1,73,-1,47
1,<environment.Job instance at 0x7f6530654550>,47,2,[9 3],48,-1,50,-1,48
1,<environment.Job instance at 0x7f653055b370>,48,14,[8 5],49,-1,63,-1,49
1,<environment.Job instance at 0x7f653055b870>,49,17,[9 2],50,-1,67,-1,50
1,<environment.Job instance at 0x7f653055bcd0>,50,18,[5 1],51,-1,69,-1,51
1,<environment.Job instance at 0x7f65307c99b0>,52,14,[8 4],53,-1,67,-1,53
1,<environment.Job instance at 0x7f653055c550>,54,17,[10  5],55,-1,72,-1,55
1,<environment.Job instance at 0x7f653055c2d0>,55,16,[ 3 10],56,-1,72,-1,56
1,<environment.Job instance at 0x7f6530445eb0>,56,23,[5 8],57,-1,80,-1,57
1,<environment.Job instance at 0x7f653a30f870>,62,14,[9 2],63,-1,78,-1,64
1,<environment.Job instance at 0x7f653a30f050>,63,27,[5 3],64,-1,91,-1,64
1,<environment.Job instance at 0x7f654a764a50>,64,17,[10  2],65,-1,83,-1,66
1,<environment.Job instance at 0x7f653a31d2d0>,66,13,[5 1],67,-1,80,-1,67
1,<environment.Job instance at 0x7f6530af0fa0>,68,22,[9 2],69,-1,91,-1,69
1,<environment.Job instance at 0x7f65302b6320>,69,3,[ 4 12],70,-1,73,-1,70
1,<environment.Job instance at 0x7f653a31d960>,65,17,[5 9],66,-1,87,-1,70
1,<environment.Job instance at 0x7f653a31d410>,70,17,[2 9],71,-1,88,-1,71
1,<environment.Job instance at 0x7f65301c16e0>,71,18,[ 5 11],72,-1,90,-1,72
1,<environment.Job instance at 0x7f65301bed20>,72,17,[10  4],73,-1,90,-1,73
1,<environment.Job instance at 0x7f65302da690>,75,17,[8 1],76,-1,94,-1,77
1,<environment.Job instance at 0x7f6530159f50>,77,18,[ 1 10],78,-1,96,-1,78
1,<environment.Job instance at 0x7f65302ef6e0>,78,28,[7 4],79,-1,107,-1,79
1,<environment.Job instance at 0x7f6530159eb0>,76,16,[7 2],77,-1,96,-1,80
1,<environment.Job instance at 0x7f6530164f00>,83,15,[5 6],84,-1,99,-1,84
1,<environment.Job instance at 0x7f65301648c0>,85,17,[3 5],86,-1,103,-1,86
1,<environment.Job instance at 0x7f65301628c0>,91,13,[3 6],92,-1,105,-1,92
1,<environment.Job instance at 0x7f65301620a0>,92,16,[8 5],93,-1,109,-1,93
1,<environment.Job instance at 0x7f6530162af0>,94,14,[8 5],95,-1,109,-1,95
1,<environment.Job instance at 0x7f6530164aa0>,88,16,[14  3],89,-1,114,-1,98
1,<environment.Job instance at 0x7f6530163fa0>,98,18,[3 8],99,-1,117,-1,99
1,<environment.Job instance at 0x7f6530163be0>,99,16,[9 4],100,-1,116,-1,100
1,<environment.Job instance at 0x7f6530162140>,90,15,[7 4],91,-1,115,-1,100
1,<environment.Job instance at 0x7f6530163b40>,101,16,[7 4],102,-1,119,-1,103
1,<environment.Job instance at 0x7f6530163730>,103,18,[1 6],104,-1,122,-1,104
1,<environment.Job instance at 0x7f6530163910>,104,15,[9 5],105,-1,121,-1,106
1,<environment.Job instance at 0x7f65302017d0>,106,17,[2 6],107,-1,124,-1,107
1,<environment.Job instance at 0x7f6530201a00>,107,16,[2 8],108,-1,124,-1,108
1,<environment.Job instance at 0x7f65302012d0>,108,12,[9 2],109,-1,123,-1,111
1,<environment.Job instance at 0x7f65301614b0>,110,18,[8 5],111,-1,129,-1,111
1,<environment.Job instance at 0x7f6530161f00>,113,14,[3 5],114,-1,128,-1,114
1,<environment.Job instance at 0x7f6530161dc0>,114,17,[1 9],115,-1,132,-1,115
1,<environment.Job instance at 0x7f6530b4d460>,26,22,[11  3],27,-1,97,-1,75
1,<environment.Job instance at 0x7f6530bbf1e0>,35,25,[3 9],36,-1,157,-1,132
1,<environment.Job instance at 0x7f6530bb9140>,39,23,[2 8],40,-1,156,-1,133
1,<environment.Job instance at 0x7f653035ce10>,46,26,[9 1],47,-1,183,-1,157
1,<environment.Job instance at 0x7f6530354730>,56,23,[5 8],57,-1,221,-1,198
1,<environment.Job instance at 0x7f6530377910>,61,2,[12  1],62,-1,209,-1,207
1,<environment.Job instance at 0x7f653046a9b0>,63,27,[5 3],64,-1,246,-1,219
1,<environment.Job instance at 0x7f6530493050>,69,3,[ 4 12],70,-1,241,-1,238
1,<environment.Job instance at 0x7f653049c550>,71,18,[ 5 11],72,-1,256,-1,238
1,<environment.Job instance at 0x7f653034e8c0>,78,28,[7 4],79,-1,309,-1,281
1,<environment.Job instance at 0x7f653047f780>,84,28,[9 1],85,-1,330,-1,302
1,<environment.Job instance at 0x7f653034ae10>,88,16,[14  3],89,-1,318,-1,302
1,<environment.Job instance at 0x7f6530311d20>,100,28,[7 3],101,-1,399,-1,371
1,<environment.Job instance at 0x7f6530314a00>,118,12,[12  2],119,-1,460,-1,448
1,<environment.Job instance at 0x7f6530314c30>,121,19,[ 3 14],122,-1,480,-1,461
1,<environment.Job instance at 0x7f653032ad20>,122,2,[14  5],123,-1,463,-1,461
1,<environment.Job instance at 0x7f653032abe0>,125,12,[12  4],126,-1,474,-1,462
1,<environment.Job instance at 0x7f653031a7d0>,131,18,[ 5 14],132,-1,486,-1,468
1,<environment.Job instance at 0x7f65303354b0>,138,1,[ 5 14],139,-1,486,-1,485
1,<environment.Job instance at 0x7f6530340370>,10,13,[7 4],11,-1,24,-1,11
1,<environment.Job instance at 0x7f6530340dc0>,13,18,[9 2],14,-1,32,-1,14
1,<environment.Job instance at 0x7f6530340910>,14,18,[ 5 10],15,-1,33,-1,15
1,<environment.Job instance at 0x7f6530340870>,16,16,[5 7],17,-1,33,-1,17
1,<environment.Job instance at 0x7f653033daa0>,18,15,[2 5],19,-1,34,-1,19
1,<environment.Job instance at 0x7f653033dc80>,19,15,[7 4],20,-1,35,-1,20
1,<environment.Job instance at 0x7f653033dbe0>,20,17,[4 5],21,-1,38,-1,21
1,<environment.Job instance at 0x7f653033d230>,25,18,[9 5],26,-1,44,-1,26
1,<environment.Job instance at 0x7f6530602140>,27,17,[7 5],28,-1,45,-1,28
1,<environment.Job instance at 0x7f65306020f0>,30,14,[2 8],31,-1,45,-1,31
1,<environment.Job instance at 0x7f6530602dc0>,31,15,[10  3],32,-1,50,-1,35
1,<environment.Job instance at 0x7f65306025f0>,34,16,[8 3],35,-1,51,-1,35
1,<environment.Job instance at 0x7f65303388c0>,39,17,[4 8],40,-1,61,-1,44
1,<environment.Job instance at 0x7f6530338910>,43,15,[7 4],44,-1,59,-1,44
1,<environment.Job instance at 0x7f6530338280>,38,3,[5 1],39,-1,49,-1,46
1,<environment.Job instance at 0x7f65303353c0>,47,16,[ 5 13],48,-1,64,-1,48
1,<environment.Job instance at 0x7f6530338730>,41,18,[ 4 13],42,-1,67,-1,49
1,<environment.Job instance at 0x7f65303357d0>,46,15,[6 2],47,-1,64,-1,49
1,<environment.Job instance at 0x7f6530335870>,50,13,[ 4 10],51,-1,64,-1,51
1,<environment.Job instance at 0x7f6530335f00>,51,16,[2 8],52,-1,68,-1,52
1,<environment.Job instance at 0x7f6530332d20>,58,14,[10  4],59,-1,74,-1,60
1,<environment.Job instance at 0x7f65303359b0>,54,18,[13  2],55,-1,79,-1,61
1,<environment.Job instance at 0x7f6530332a50>,59,16,[1 7],60,-1,79,-1,63
1,<environment.Job instance at 0x7f653033d4b0>,22,27,[ 2 13],23,-1,90,-1,63
1,<environment.Job instance at 0x7f6530332b90>,60,18,[11  4],61,-1,81,-1,63
1,<environment.Job instance at 0x7f6530332c80>,62,20,[7 3],63,-1,85,-1,65
1,<environment.Job instance at 0x7f6530332b40>,61,15,[3 5],62,-1,80,-1,65
1,<environment.Job instance at 0x7f6530332af0>,65,17,[6 3],66,-1,83,-1,66
1,<environment.Job instance at 0x7f65303323c0>,66,20,[6 2],67,-1,87,-1,67
1,<environment.Job instance at 0x7f653032c4b0>,68,17,[2 8],69,-1,86,-1,69
1,<environment.Job instance at 0x7f653032cf50>,72,15,[7 3],73,-1,88,-1,73
1,<environment.Job instance at 0x7f653032c140>,75,16,[2 6],76,-1,92,-1,76
1,<environment.Job instance at 0x7f653032a460>,76,15,[10  5],77,-1,92,-1,77
1,<environment.Job instance at 0x7f653032a690>,77,16,[ 3 10],78,-1,94,-1,78
1,<environment.Job instance at 0x7f653032a280>,78,16,[3 6],79,-1,95,-1,79
1,<environment.Job instance at 0x7f653032a140>,79,22,[1 6],80,-1,102,-1,80
1,<environment.Job instance at 0x7f653032a2d0>,81,25,[10  4],82,-1,107,-1,82
1,<environment.Job instance at 0x7f653032ad70>,84,22,[1 9],85,-1,107,-1,85
1,<environment.Job instance at 0x7f653032a780>,87,13,[ 1 10],88,-1,101,-1,88
1,<environment.Job instance at 0x7f6530326190>,89,18,[ 2 10],90,-1,108,-1,90
1,<environment.Job instance at 0x7f6530326820>,90,17,[7 1],91,-1,108,-1,91
1,<environment.Job instance at 0x7f6530326a00>,91,18,[3 8],92,-1,110,-1,92
1,<environment.Job instance at 0x7f6530326aa0>,93,24,[3 6],94,-1,118,-1,94
1,<environment.Job instance at 0x7f6530326c80>,95,20,[3 8],96,-1,116,-1,96
1,<environment.Job instance at 0x7f6530326eb0>,96,15,[4 9],97,-1,112,-1,97
1,<environment.Job instance at 0x7f6530326e10>,97,27,[9 5],98,-1,125,-1,98
1,<environment.Job instance at 0x7f6530326050>,98,14,[3 6],99,-1,114,-1,100
1,<environment.Job instance at 0x7f65302d7d70>,100,18,[4 8],101,-1,119,-1,101
1,<environment.Job instance at 0x7f65302d7960>,105,18,[ 3 10],106,-1,124,-1,106
1,<environment.Job instance at 0x7f65302da230>,106,21,[6 1],107,-1,128,-1,107
1,<environment.Job instance at 0x7f65304b18c0>,113,18,[8 1],114,-1,132,-1,114
1,<environment.Job instance at 0x7f6530332820>,64,12,[3 5],65,-1,126,-1,114
1,<environment.Job instance at 0x7f65302e7b90>,110,12,[1 5],111,-1,128,-1,116
1,<environment.Job instance at 0x7f65301980f0>,115,27,[5 5],116,-1,144,-1,117
1,<environment.Job instance at 0x7f653090c370>,116,22,[2 8],117,-1,140,-1,118
1,<environment.Job instance at 0x7f65304b1e10>,117,20,[5 2],118,-1,138,-1,118
1,<environment.Job instance at 0x7f6530411be0>,119,17,[2 6],120,-1,137,-1,120
1,<environment.Job instance at 0x7f653a367500>,120,16,[1 9],121,-1,137,-1,121
1,<environment.Job instance at 0x7f65301dd870>,122,17,[4 6],123,-1,140,-1,123
1,<environment.Job instance at 0x7f65307e2320>,129,17,[5 1],130,-1,147,-1,130
1,<environment.Job instance at 0x7f653a30caf0>,123,27,[7 5],124,-1,164,-1,137
1,<environment.Job instance at 0x7f653090d690>,127,13,[4 6],128,-1,154,-1,141
1,<environment.Job instance at 0x7f653044fb40>,133,16,[3 5],134,-1,159,-1,143
1,<environment.Job instance at 0x7f653042f050>,135,25,[3 7],136,-1,169,-1,144
1,<environment.Job instance at 0x7f653a21a2d0>,137,14,[10  3],138,-1,158,-1,144
1,<environment.Job instance at 0x7f6530602f50>,3,3,[14  5],4,-1,7,-1,4
1,<environment.Job instance at 0x7f6530293690>,8,17,[12  1],9,-1,26,-1,9
1,<environment.Job instance at 0x7f653092e320>,12,1,[13  3],13,-1,14,-1,13
1,<environment.Job instance at 0x7f65303262d0>,22,27,[ 2 13],23,-1,65,-1,38
1,<environment.Job instance at 0x7f653032afa0>,28,1,[12  5],29,-1,60,-1,59
1,<environment.Job instance at 0x7f6530147d20>,41,18,[ 4 13],42,-1,128,-1,110
1,<environment.Job instance at 0x7f6530163690>,47,16,[ 5 13],48,-1,143,-1,127
1,<environment.Job instance at 0x7f653099cfa0>,54,18,[13  2],55,-1,173,-1,155
1,<environment.Job instance at 0x7f65301bb910>,60,18,[11  4],61,-1,186,-1,168
1,<environment.Job instance at 0x7f65302ef0f0>,81,25,[10  4],82,-1,297,-1,272
1,<environment.Job instance at 0x7f653a30f5f0>,93,24,[3 6],94,-1,324,-1,300
1,<environment.Job instance at 0x7f653019bfa0>,97,27,[9 5],98,-1,336,-1,309
1,<environment.Job instance at 0x7f65302b9b90>,103,2,[ 3 14],104,-1,328,-1,326
1,<environment.Job instance at 0x7f65302b6a00>,114,3,[ 3 12],115,-1,390,-1,387
1,<environment.Job instance at 0x7f65302b6870>,115,27,[5 5],116,-1,414,-1,387
1,<environment.Job instance at 0x7f65303b6eb0>,118,13,[14  4],119,-1,418,-1,405
1,<environment.Job instance at 0x7f65304a1cd0>,124,13,[14  5],125,-1,437,-1,424
1,<environment.Job instance at 0x7f653023dd70>,123,27,[7 5],124,-1,468,-1,441
1,<environment.Job instance at 0x7f65302e3280>,135,25,[3 7],136,-1,498,-1,473
1,<environment.Job instance at 0x7f6530122690>,5,16,[10  5],6,-1,23,-1,7
1,<environment.Job instance at 0x7f65301226e0>,7,14,[9 1],8,-1,22,-1,8
1,<environment.Job instance at 0x7f6530122780>,8,21,[9 5],9,-1,30,-1,9
1,<environment.Job instance at 0x7f65301228c0>,10,17,[9 4],11,-1,28,-1,11
1,<environment.Job instance at 0x7f6530326e60>,6,13,[8 4],7,-1,30,-1,17
1,<environment.Job instance at 0x7f6530122f50>,17,16,[2 6],18,-1,34,-1,18
1,<environment.Job instance at 0x7f6530124690>,23,17,[1 8],24,-1,42,-1,25
1,<environment.Job instance at 0x7f6530124640>,25,24,[3 9],26,-1,50,-1,26
1,<environment.Job instance at 0x7f6530124870>,26,17,[9 1],27,-1,44,-1,27
1,<environment.Job instance at 0x7f6530124b40>,29,16,[1 8],30,-1,46,-1,30
1,<environment.Job instance at 0x7f6530124d70>,32,17,[10  3],33,-1,50,-1,33
1,<environment.Job instance at 0x7f6530124fa0>,33,13,[9 5],34,-1,47,-1,34
1,<environment.Job instance at 0x7f6530125050>,34,15,[ 1 10],35,-1,50,-1,35
1,<environment.Job instance at 0x7f65301256e0>,42,27,[5 5],43,-1,70,-1,43
1,<environment.Job instance at 0x7f6530125870>,43,14,[3 6],44,-1,58,-1,44
1,<environment.Job instance at 0x7f6530125a50>,44,25,[1 7],45,-1,70,-1,45
1,<environment.Job instance at 0x7f6530124780>,24,14,[ 3 14],25,-1,59,-1,45
1,<environment.Job instance at 0x7f6530125b90>,46,15,[ 5 10],47,-1,62,-1,47
1,<environment.Job instance at 0x7f653012a0a0>,54,17,[7 4],55,-1,72,-1,55
1,<environment.Job instance at 0x7f653012a0f0>,53,18,[4 8],54,-1,73,-1,55
1,<environment.Job instance at 0x7f6530125820>,41,15,[14  1],42,-1,71,-1,56
1,<environment.Job instance at 0x7f653012a410>,56,27,[5 8],57,-1,84,-1,57
1,<environment.Job instance at 0x7f6530125dc0>,50,2,[6 5],51,-1,61,-1,59
1,<environment.Job instance at 0x7f65308b09b0>,62,3,[1 7],63,-1,70,-1,67
1,<environment.Job instance at 0x7f65308b0c30>,61,24,[4 8],62,-1,91,-1,67
1,<environment.Job instance at 0x7f653088e5a0>,65,19,[7 5],66,-1,86,-1,67
1,<environment.Job instance at 0x7f6530b0faa0>,67,12,[10  4],68,-1,82,-1,70
1,<environment.Job instance at 0x7f653053e7d0>,69,3,[4 8],70,-1,74,-1,71
1,<environment.Job instance at 0x7f6530527460>,76,18,[8 2],77,-1,105,-1,87
1,<environment.Job instance at 0x7f653012a190>,51,14,[1 9],52,-1,101,-1,87
1,<environment.Job instance at 0x7f6530b39a00>,73,14,[8 2],74,-1,101,-1,87
1,<environment.Job instance at 0x7f653101b230>,79,18,[5 8],80,-1,111,-1,93
1,<environment.Job instance at 0x7f65307d2be0>,77,18,[6 2],78,-1,111,-1,93
1,<environment.Job instance at 0x7f6530527320>,81,24,[1 9],82,-1,117,-1,93
1,<environment.Job instance at 0x7f6530fb43c0>,80,19,[2 7],81,-1,112,-1,93
1,<environment.Job instance at 0x7f65308a1410>,83,15,[6 5],84,-1,108,-1,93
1,<environment.Job instance at 0x7f65305143c0>,87,23,[10  4],88,-1,117,-1,94
1,<environment.Job instance at 0x7f65308c0870>,88,14,[3 8],89,-1,108,-1,94
1,<environment.Job instance at 0x7f6530514820>,91,17,[5 7],92,-1,111,-1,94
1,<environment.Job instance at 0x7f6530514640>,92,12,[3 8],93,-1,106,-1,94
1,<environment.Job instance at 0x7f6530514f50>,94,13,[1 9],95,-1,108,-1,95
1,<environment.Job instance at 0x7f6530514b90>,95,16,[4 5],96,-1,112,-1,96
1,<environment.Job instance at 0x7f65308c0500>,86,14,[7 5],87,-1,110,-1,96
1,<environment.Job instance at 0x7f6530514e10>,99,17,[ 5 10],100,-1,117,-1,100
1,<environment.Job instance at 0x7f6530514c80>,96,17,[13  2],97,-1,119,-1,102
1,<environment.Job instance at 0x7f65308abc30>,103,1,[8 5],104,-1,106,-1,105
1,<environment.Job instance at 0x7f65308abbe0>,102,17,[ 2 12],103,-1,122,-1,105
1,<environment.Job instance at 0x7f65308abcd0>,105,24,[10  2],106,-1,132,-1,108
1,<environment.Job instance at 0x7f6530514140>,100,18,[4 6],101,-1,127,-1,109
1,<environment.Job instance at 0x7f65308abe10>,106,14,[ 5 10],107,-1,123,-1,109
1,<environment.Job instance at 0x7f6530523140>,108,19,[1 6],109,-1,128,-1,109
1,<environment.Job instance at 0x7f6530523960>,109,27,[14  1],110,-1,140,-1,113
1,<environment.Job instance at 0x7f65308abdc0>,107,18,[1 7],108,-1,131,-1,113
1,<environment.Job instance at 0x7f65305423c0>,113,20,[5 7],114,-1,134,-1,114
1,<environment.Job instance at 0x7f6530542050>,116,27,[4 5],117,-1,144,-1,117
1,<environment.Job instance at 0x7f65305421e0>,115,12,[11  5],116,-1,130,-1,118
1,<environment.Job instance at 0x7f65308abb40>,104,15,[5 7],105,-1,134,-1,119
1,<environment.Job instance at 0x7f65308a6140>,119,12,[9 1],120,-1,132,-1,120
1,<environment.Job instance at 0x7f65308a6c30>,118,15,[5 9],119,-1,135,-1,120
1,<environment.Job instance at 0x7f65305140f0>,101,15,[3 5],102,-1,140,-1,125
1,<environment.Job instance at 0x7f6530542190>,120,14,[8 4],121,-1,139,-1,125
1,<environment.Job instance at 0x7f6530510370>,124,12,[4 7],125,-1,138,-1,126
1,<environment.Job instance at 0x7f6530510a50>,126,14,[10  4],127,-1,141,-1,127
1,<environment.Job instance at 0x7f65305105f0>,137,18,[3 6],138,-1,159,-1,141
1,<environment.Job instance at 0x7f65301247d0>,0,1,[ 4 12],1,-1,2,-1,1
1,<environment.Job instance at 0x7f6530125640>,4,12,[13  3],5,-1,17,-1,5
1,<environment.Job instance at 0x7f6530117c30>,9,3,[12  1],10,-1,13,-1,10
1,<environment.Job instance at 0x7f6530510e10>,19,16,[ 5 13],20,-1,53,-1,37
1,<environment.Job instance at 0x7f6530122280>,24,14,[ 3 14],25,-1,67,-1,53
1,<environment.Job instance at 0x7f6530122500>,25,24,[3 9],26,-1,79,-1,55
1,<environment.Job instance at 0x7f6530289960>,35,1,[12  4],36,-1,91,-1,90
1,<environment.Job instance at 0x7f6530288b40>,41,15,[14  1],42,-1,115,-1,100
1,<environment.Job instance at 0x7f65303b6eb0>,42,27,[5 5],43,-1,128,-1,101
1,<environment.Job instance at 0x7f65302b6960>,44,25,[1 7],45,-1,138,-1,113
1,<environment.Job instance at 0x7f65302b9280>,56,27,[5 8],57,-1,198,-1,171
1,<environment.Job instance at 0x7f65301b79b0>,61,24,[4 8],62,-1,209,-1,185
1,<environment.Job instance at 0x7f653096e230>,71,1,[11  1],72,-1,207,-1,206
1,<environment.Job instance at 0x7f65301d13c0>,81,24,[1 9],82,-1,269,-1,245
1,<environment.Job instance at 0x7f6530162870>,87,23,[10  4],88,-1,294,-1,271
1,<environment.Job instance at 0x7f653090feb0>,93,3,[ 5 13],94,-1,280,-1,277
1,<environment.Job instance at 0x7f65301bb140>,96,17,[13  2],97,-1,307,-1,290
1,<environment.Job instance at 0x7f65301bb050>,97,1,[11  4],98,-1,291,-1,290
1,<environment.Job instance at 0x7f653a315370>,102,17,[ 2 12],103,-1,323,-1,306
1,<environment.Job instance at 0x7f653058d370>,105,24,[10  2],106,-1,351,-1,327
1,<environment.Job instance at 0x7f65301631e0>,109,27,[14  1],110,-1,375,-1,348
1,<environment.Job instance at 0x7f65301e2a00>,112,2,[11  4],113,-1,350,-1,348
1,<environment.Job instance at 0x7f65302f3780>,115,12,[11  5],116,-1,361,-1,349
1,<environment.Job instance at 0x7f65301e2690>,116,27,[4 5],117,-1,377,-1,350
1,<environment.Job instance at 0x7f6530332e60>,122,3,[11  3],123,-1,380,-1,377
1,<environment.Job instance at 0x7f65304b1280>,131,15,[ 2 14],132,-1,423,-1,408
1,<environment.Job instance at 0x7f65302d7c80>,135,12,[ 3 13],136,-1,431,-1,419
1,<environment.Job instance at 0x7f65316db730>,0,18,[5 9],1,-1,19,-1,1
1,<environment.Job instance at 0x7f6530c195a0>,3,18,[ 1 10],4,-1,23,-1,5
1,<environment.Job instance at 0x7f65309c8e10>,4,14,[7 5],5,-1,19,-1,5
1,<environment.Job instance at 0x7f6530c19190>,9,14,[9 5],10,-1,26,-1,12
1,<environment.Job instance at 0x7f6530c19870>,11,17,[14  3],12,-1,30,-1,13
1,<environment.Job instance at 0x7f6530c28730>,15,17,[ 5 10],16,-1,34,-1,17
1,<environment.Job instance at 0x7f6530c19730>,16,17,[ 1 10],17,-1,35,-1,18
1,<environment.Job instance at 0x7f6530c28550>,18,16,[9 2],19,-1,36,-1,20
1,<environment.Job instance at 0x7f6530c28e60>,19,28,[1 8],20,-1,48,-1,20
1,<environment.Job instance at 0x7f6530c28140>,26,14,[9 2],27,-1,42,-1,28
1,<environment.Job instance at 0x7f6530c28cd0>,27,17,[3 8],28,-1,45,-1,28
1,<environment.Job instance at 0x7f6530c28f50>,30,13,[10  4],31,-1,46,-1,33
1,<environment.Job instance at 0x7f6530c21370>,35,24,[8 3],36,-1,60,-1,36
1,<environment.Job instance at 0x7f6530c21500>,38,17,[2 7],39,-1,56,-1,39
1,<environment.Job instance at 0x7f6530c21c80>,39,14,[4 9],40,-1,54,-1,40
1,<environment.Job instance at 0x7f6530c21870>,40,18,[8 1],41,-1,59,-1,41
1,<environment.Job instance at 0x7f6530c16910>,46,18,[9 4],47,-1,65,-1,47
1,<environment.Job instance at 0x7f6530c16d20>,47,17,[3 5],48,-1,65,-1,48
1,<environment.Job instance at 0x7f6530c16370>,48,17,[2 6],49,-1,66,-1,49
1,<environment.Job instance at 0x7f6530c16a00>,52,15,[10  1],53,-1,68,-1,53
1,<environment.Job instance at 0x7f6530c165a0>,53,17,[5 3],54,-1,71,-1,54
1,<environment.Job instance at 0x7f6530c16460>,54,24,[4 5],55,-1,79,-1,55
1,<environment.Job instance at 0x7f6530c16690>,56,13,[3 9],57,-1,70,-1,57
1,<environment.Job instance at 0x7f6530c16820>,58,16,[6 5],59,-1,75,-1,59
1,<environment.Job instance at 0x7f6530d406e0>,66,15,[9 1],67,-1,89,-1,74
1,<environment.Job instance at 0x7f6530d40dc0>,69,13,[1 8],70,-1,87,-1,74
1,<environment.Job instance at 0x7f6530d40eb0>,63,14,[4 8],64,-1,88,-1,74
1,<environment.Job instance at 0x7f6530e73a00>,71,13,[6 5],72,-1,87,-1,74
1,<environment.Job instance at 0x7f6530d40910>,64,16,[9 2],65,-1,90,-1,74
1,<environment.Job instance at 0x7f6530e73eb0>,73,15,[6 1],74,-1,89,-1,74
1,<environment.Job instance at 0x7f6530e73690>,78,17,[7 2],79,-1,97,-1,80
1,<environment.Job instance at 0x7f6530e73780>,80,15,[5 6],81,-1,96,-1,81
1,<environment.Job instance at 0x7f65309d2050>,84,15,[7 3],85,-1,100,-1,85
1,<environment.Job instance at 0x7f65309d20f0>,87,15,[10  1],88,-1,107,-1,92
1,<environment.Job instance at 0x7f65309d2370>,89,23,[6 5],90,-1,115,-1,92
1,<environment.Job instance at 0x7f65309d2780>,90,17,[2 6],91,-1,109,-1,92
1,<environment.Job instance at 0x7f6530e73230>,79,16,[10  2],80,-1,111,-1,95
1,<environment.Job instance at 0x7f6530d5baf0>,100,27,[6 4],101,-1,128,-1,101
1,<environment.Job instance at 0x7f6530e7a960>,102,15,[10  1],103,-1,119,-1,104
1,<environment.Job instance at 0x7f6530e7ae60>,103,13,[7 5],104,-1,118,-1,105
1,<environment.Job instance at 0x7f65310edd70>,99,21,[1 9],100,-1,128,-1,107
1,<environment.Job instance at 0x7f6530c804b0>,108,22,[7 5],109,-1,132,-1,110
1,<environment.Job instance at 0x7f6530dc8640>,112,24,[1 6],113,-1,159,-1,135
1,<environment.Job instance at 0x7f6530d2ce10>,113,16,[8 5],114,-1,151,-1,135
1,<environment.Job instance at 0x7f6530d2c6e0>,114,16,[9 4],115,-1,151,-1,135
1,<environment.Job instance at 0x7f653128c8c0>,116,15,[10  4],117,-1,150,-1,135
1,<environment.Job instance at 0x7f65309d2b90>,86,14,[5 4],87,-1,149,-1,135
1,<environment.Job instance at 0x7f6530e734b0>,11,17,[14  3],12,-1,38,-1,21
1,<environment.Job instance at 0x7f6530e73960>,14,15,[ 2 13],15,-1,37,-1,22
1,<environment.Job instance at 0x7f6530d13460>,17,3,[12  4],18,-1,26,-1,23
1,<environment.Job instance at 0x7f65309d2230>,19,28,[1 8],20,-1,63,-1,35
1,<environment.Job instance at 0x7f6530c19780>,28,18,[13  3],29,-1,75,-1,57
1,<environment.Job instance at 0x7f6530326320>,35,24,[8 3],36,-1,130,-1,106
1,<environment.Job instance at 0x7f6530159fa0>,51,13,[12  4],52,-1,170,-1,157
1,<environment.Job instance at 0x7f65301631e0>,54,24,[4 5],55,-1,183,-1,159
1,<environment.Job instance at 0x7f6530289960>,89,23,[6 5],90,-1,333,-1,310
1,<environment.Job instance at 0x7f6530514730>,101,1,[11  4],102,-1,332,-1,331
1,<environment.Job instance at 0x7f65308a6230>,100,27,[6 4],101,-1,365,-1,338
1,<environment.Job instance at 0x7f6530125640>,112,24,[1 6],113,-1,392,-1,368
1,<environment.Job instance at 0x7f6530cde780>,124,3,[ 2 12],125,-1,423,-1,420
1,<environment.Job instance at 0x7f6530cdb320>,131,2,[ 3 14],132,-1,444,-1,442
1,<environment.Job instance at 0x7f6530cdbf00>,136,13,[12  4],137,-1,467,-1,454
1,<environment.Job instance at 0x7f6530cdb230>,137,27,[9 3],138,-1,486,-1,459
1,<environment.Job instance at 0x7f653116cdc0>,5,15,[ 1 10],6,-1,21,-1,6
1,<environment.Job instance at 0x7f653152fe10>,8,24,[4 7],9,-1,33,-1,9
1,<environment.Job instance at 0x7f652fed1140>,14,18,[ 4 11],15,-1,36,-1,18
1,<environment.Job instance at 0x7f6530e29410>,20,20,[4 6],21,-1,42,-1,22
1,<environment.Job instance at 0x7f6530e29500>,23,14,[ 1 11],24,-1,39,-1,25
1,<environment.Job instance at 0x7f6531602aa0>,25,16,[ 2 11],26,-1,43,-1,27
1,<environment.Job instance at 0x7f653152ffa0>,15,16,[9 4],16,-1,43,-1,27
1,<environment.Job instance at 0x7f65311cb550>,17,15,[4 6],18,-1,48,-1,33
1,<environment.Job instance at 0x7f653156ac80>,32,17,[ 2 10],33,-1,51,-1,34
1,<environment.Job instance at 0x7f653152f5a0>,12,17,[9 4],13,-1,56,-1,39
1,<environment.Job instance at 0x7f653156aaa0>,33,15,[5 5],34,-1,54,-1,39
1,<environment.Job instance at 0x7f653179c550>,38,20,[3 8],39,-1,59,-1,39
1,<environment.Job instance at 0x7f653179cf00>,39,13,[7 4],40,-1,54,-1,41
1,<environment.Job instance at 0x7f653179ce10>,40,24,[10  4],41,-1,65,-1,41
1,<environment.Job instance at 0x7f653179ce60>,41,21,[4 7],42,-1,64,-1,43
1,<environment.Job instance at 0x7f653179c7d0>,42,17,[ 2 11],43,-1,61,-1,44
1,<environment.Job instance at 0x7f6531602e60>,24,16,[4 5],25,-1,63,-1,47
1,<environment.Job instance at 0x7f6531582140>,43,15,[4 9],44,-1,62,-1,47
1,<environment.Job instance at 0x7f65311c9e10>,49,19,[5 5],50,-1,69,-1,50
1,<environment.Job instance at 0x7f6531182410>,50,15,[10  4],51,-1,66,-1,51
1,<environment.Job instance at 0x7f6531182be0>,51,18,[4 8],52,-1,70,-1,52
1,<environment.Job instance at 0x7f65306ac0a0>,52,15,[4 8],53,-1,69,-1,54
1,<environment.Job instance at 0x7f6531582370>,46,18,[6 3],47,-1,75,-1,57
1,<environment.Job instance at 0x7f6531235a00>,58,18,[4 6],59,-1,77,-1,59
1,<environment.Job instance at 0x7f653055ce10>,62,16,[3 8],63,-1,79,-1,63
1,<environment.Job instance at 0x7f6530934370>,66,18,[10  2],67,-1,85,-1,67
1,<environment.Job instance at 0x7f6530cfb960>,68,17,[9 5],69,-1,92,-1,75
1,<environment.Job instance at 0x7f6530cfbeb0>,70,16,[ 3 10],71,-1,96,-1,80
1,<environment.Job instance at 0x7f6530cfbe10>,71,16,[5 7],72,-1,97,-1,81
1,<environment.Job instance at 0x7f6530de80f0>,73,13,[5 5],74,-1,94,-1,81
1,<environment.Job instance at 0x7f6531193820>,56,12,[2 7],57,-1,93,-1,81
1,<environment.Job instance at 0x7f6530373410>,75,14,[4 6],76,-1,95,-1,81
1,<environment.Job instance at 0x7f65310e3690>,55,12,[10  1],56,-1,105,-1,93
1,<environment.Job instance at 0x7f65306688c0>,86,14,[6 4],87,-1,107,-1,93
1,<environment.Job instance at 0x7f6530668d70>,88,17,[3 7],89,-1,114,-1,97
1,<environment.Job instance at 0x7f653a1cd690>,90,13,[5 3],91,-1,110,-1,97
1,<environment.Job instance at 0x7f653a1ccfa0>,76,1,[5 1],77,-1,98,-1,97
1,<environment.Job instance at 0x7f653a1cd910>,92,17,[6 4],93,-1,115,-1,98
1,<environment.Job instance at 0x7f6530cfb460>,69,16,[7 2],70,-1,115,-1,99
1,<environment.Job instance at 0x7f653a1cdc80>,91,17,[2 7],92,-1,116,-1,99
1,<environment.Job instance at 0x7f653103f640>,100,14,[ 2 10],101,-1,115,-1,101
1,<environment.Job instance at 0x7f6530fa8780>,98,12,[ 4 10],99,-1,114,-1,102
1,<environment.Job instance at 0x7f653103f4b0>,102,16,[ 3 10],103,-1,119,-1,103
1,<environment.Job instance at 0x7f65311ec190>,93,12,[7 4],94,-1,119,-1,107
1,<environment.Job instance at 0x7f653103f8c0>,103,18,[5 5],104,-1,125,-1,107
1,<environment.Job instance at 0x7f65306682d0>,87,3,[7 5],88,-1,110,-1,107
1,<environment.Job instance at 0x7f653103f5a0>,104,16,[5 5],105,-1,123,-1,107
1,<environment.Job instance at 0x7f653103f320>,106,13,[3 9],107,-1,122,-1,109
1,<environment.Job instance at 0x7f653103f370>,108,18,[1 5],109,-1,128,-1,110
1,<environment.Job instance at 0x7f653103f960>,109,18,[9 5],110,-1,129,-1,111
1,<environment.Job instance at 0x7f653179c5f0>,36,13,[4 7],37,-1,128,-1,115
1,<environment.Job instance at 0x7f653103ab40>,112,13,[9 4],113,-1,128,-1,115
1,<environment.Job instance at 0x7f653103a6e0>,114,16,[2 7],115,-1,133,-1,117
1,<environment.Job instance at 0x7f653103a8c0>,118,16,[8 3],119,-1,135,-1,119
1,<environment.Job instance at 0x7f653103a2d0>,120,23,[9 4],121,-1,144,-1,121
1,<environment.Job instance at 0x7f653103a460>,121,21,[8 2],122,-1,143,-1,122
1,<environment.Job instance at 0x7f653103a820>,122,21,[5 7],123,-1,144,-1,123
1,<environment.Job instance at 0x7f653103ae60>,124,17,[9 2],125,-1,142,-1,125
1,<environment.Job instance at 0x7f653103a5a0>,116,13,[5 5],117,-1,139,-1,126
1,<environment.Job instance at 0x7f653065e5a0>,132,18,[4 7],133,-1,152,-1,134
1,<environment.Job instance at 0x7f65315e23c0>,6,12,[ 2 11],7,-1,19,-1,7
1,<environment.Job instance at 0x7f65315e20a0>,8,24,[4 7],9,-1,38,-1,14
1,<environment.Job instance at 0x7f65309344b0>,14,18,[ 4 11],15,-1,38,-1,20
1,<environment.Job instance at 0x7f65302cb6e0>,19,3,[14  1],20,-1,37,-1,34
1,<environment.Job instance at 0x7f653103a0a0>,23,14,[ 1 11],24,-1,52,-1,38
1,<environment.Job instance at 0x7f653065e0a0>,25,16,[ 2 11],26,-1,56,-1,40
1,<environment.Job instance at 0x7f65306a5be0>,28,2,[13  3],29,-1,45,-1,43
1,<environment.Job instance at 0x7f653a30b690>,40,24,[10  4],41,-1,116,-1,92
1,<environment.Job instance at 0x7f6530159fa0>,42,17,[ 2 11],43,-1,109,-1,92
1,<environment.Job instance at 0x7f6530e16f00>,44,1,[ 2 11],45,-1,93,-1,92
1,<environment.Job instance at 0x7f6530c28190>,59,1,[ 5 14],60,-1,157,-1,156
1,<environment.Job instance at 0x7f65307a8140>,77,27,[ 2 11],78,-1,267,-1,240
1,<environment.Job instance at 0x7f65307a87d0>,79,3,[11  2],80,-1,243,-1,240
1,<environment.Job instance at 0x7f65307a8050>,82,1,[12  5],83,-1,246,-1,245
1,<environment.Job instance at 0x7f6530593370>,120,23,[9 4],121,-1,429,-1,406
1,<environment.Job instance at 0x7f6530c70d70>,128,28,[10  4],129,-1,487,-1,459
1,<environment.Job instance at 0x7f65310464b0>,138,17,[12  1],139,-1,507,-1,490
1,<environment.Job instance at 0x7f6530cbed70>,5,18,[1 8],6,-1,25,-1,7
1,<environment.Job instance at 0x7f6530cdb870>,7,23,[5 3],8,-1,31,-1,8
1,<environment.Job instance at 0x7f6530f77460>,8,16,[9 4],9,-1,25,-1,9
1,<environment.Job instance at 0x7f6530f77910>,9,15,[5 7],10,-1,25,-1,10
1,<environment.Job instance at 0x7f6530db1460>,22,14,[3 9],23,-1,50,-1,36
1,<environment.Job instance at 0x7f65305818c0>,27,16,[ 3 12],28,-1,52,-1,36
1,<environment.Job instance at 0x7f6530581b90>,28,15,[7 3],29,-1,51,-1,36
1,<environment.Job instance at 0x7f6530581cd0>,29,17,[9 2],30,-1,55,-1,38
1,<environment.Job instance at 0x7f6530dc92d0>,30,14,[10  1],31,-1,52,-1,38
1,<environment.Job instance at 0x7f6530583a50>,33,22,[5 2],34,-1,60,-1,38
1,<environment.Job instance at 0x7f6530dc9be0>,34,18,[5 6],35,-1,56,-1,38
1,<environment.Job instance at 0x7f6530556280>,35,17,[3 6],36,-1,55,-1,38
1,<environment.Job instance at 0x7f6530100a50>,0,26,[4 9],1,-1,27,-1,1
1,<environment.Job instance at 0x7f6530f79fa0>,2,16,[13  1],3,-1,19,-1,3
1,<environment.Job instance at 0x7f6530c70fa0>,11,18,[11  2],12,-1,30,-1,12
1,<environment.Job instance at 0x7f6530c700a0>,12,12,[ 5 13],13,-1,25,-1,13
1,<environment.Job instance at 0x7f6530c70af0>,13,24,[ 5 11],14,-1,38,-1,14
1,<environment.Job instance at 0x7f653158cdc0>,7,23,[5 3],8,-1,41,-1,18
1,<environment.Job instance at 0x7f6530c70280>,20,13,[11  2],21,-1,49,-1,36
1,<environment.Job instance at 0x7f6530593f50>,27,16,[ 3 12],28,-1,88,-1,72
1,<environment.Job instance at 0x7f6530663b90>,46,25,[6 3],47,-1,166,-1,141
1,<environment.Job instance at 0x7f65307a85f0>,53,2,[14  3],54,-1,161,-1,159
1,<environment.Job instance at 0x7f65307a8410>,54,1,[14  5],55,-1,160,-1,159
1,<environment.Job instance at 0x7f65307a8460>,63,1,[12  4],64,-1,183,-1,182
1,<environment.Job instance at 0x7f653093aa00>,70,2,[ 2 12],71,-1,205,-1,203
1,<environment.Job instance at 0x7f653093aa50>,75,23,[8 4],76,-1,244,-1,221
1,<environment.Job instance at 0x7f65302e78c0>,84,15,[11  1],85,-1,269,-1,254
1,<environment.Job instance at 0x7f653032acd0>,91,20,[ 5 13],92,-1,292,-1,272
1,<environment.Job instance at 0x7f6530253fa0>,100,24,[7 2],101,-1,340,-1,316
1,<environment.Job instance at 0x7f6530cdb320>,105,15,[ 1 12],106,-1,335,-1,320
1,<environment.Job instance at 0x7f653103f9b0>,118,2,[ 1 13],119,-1,406,-1,404
1,<environment.Job instance at 0x7f65309344b0>,120,28,[ 2 14],121,-1,435,-1,407
1,<environment.Job instance at 0x7f653055ccd0>,121,28,[5 1],122,-1,435,-1,407
1,<environment.Job instance at 0x7f653032c190>,133,23,[7 4],134,-1,469,-1,446
1,<environment.Job instance at 0x7f6531598140>,138,18,[13  5],139,-1,477,-1,459
1,<environment.Job instance at 0x7f65307bf5f0>,1,14,[9 4],2,-1,17,-1,3
1,<environment.Job instance at 0x7f65307e8fa0>,5,18,[7 5],6,-1,24,-1,6
1,<environment.Job instance at 0x7f65307e8cd0>,6,27,[5 2],7,-1,34,-1,7
1,<environment.Job instance at 0x7f65307e8140>,9,18,[ 2 10],10,-1,28,-1,10
1,<environment.Job instance at 0x7f65307e8320>,10,22,[2 5],11,-1,33,-1,11
1,<environment.Job instance at 0x7f65307e8d20>,14,18,[10  2],15,-1,36,-1,18
1,<environment.Job instance at 0x7f65307e8a00>,18,18,[5 8],19,-1,37,-1,19
1,<environment.Job instance at 0x7f6530404b90>,19,17,[2 6],20,-1,37,-1,20
1,<environment.Job instance at 0x7f65307e8e10>,17,15,[5 8],18,-1,35,-1,20
1,<environment.Job instance at 0x7f6530404410>,24,28,[4 5],25,-1,53,-1,25
1,<environment.Job instance at 0x7f65304042d0>,26,17,[3 5],27,-1,46,-1,29
1,<environment.Job instance at 0x7f6530c287d0>,28,15,[5 8],29,-1,45,-1,30
1,<environment.Job instance at 0x7f6530c289b0>,31,25,[10  1],32,-1,57,-1,32
1,<environment.Job instance at 0x7f653051ef00>,32,12,[10  4],33,-1,47,-1,35
1,<environment.Job instance at 0x7f653051e4b0>,35,15,[8 1],36,-1,51,-1,36
1,<environment.Job instance at 0x7f653051ec80>,36,3,[5 1],37,-1,40,-1,37
1,<environment.Job instance at 0x7f653051ea00>,37,1,[2 6],38,-1,39,-1,38
1,<environment.Job instance at 0x7f653051ea50>,38,18,[5 5],39,-1,57,-1,39
1,<environment.Job instance at 0x7f653051e1e0>,39,15,[6 2],40,-1,55,-1,40
1,<environment.Job instance at 0x7f653051eb40>,40,16,[7 5],41,-1,57,-1,41
1,<environment.Job instance at 0x7f653051eaf0>,41,15,[5 4],42,-1,57,-1,42
1,<environment.Job instance at 0x7f653051e7d0>,43,17,[5 9],44,-1,61,-1,44
1,<environment.Job instance at 0x7f6530563910>,44,17,[2 5],45,-1,62,-1,45
1,<environment.Job instance at 0x7f65305633c0>,45,21,[9 3],46,-1,67,-1,46
1,<environment.Job instance at 0x7f6530563230>,46,15,[3 5],47,-1,62,-1,47
1,<environment.Job instance at 0x7f6530563b90>,47,25,[9 4],48,-1,73,-1,48
1,<environment.Job instance at 0x7f65305639b0>,49,14,[5 4],50,-1,64,-1,50
1,<environment.Job instance at 0x7f65305630a0>,50,12,[10  1],51,-1,63,-1,51
1,<environment.Job instance at 0x7f653148beb0>,52,16,[9 4],53,-1,69,-1,53
1,<environment.Job instance at 0x7f653148bf50>,53,12,[10  1],54,-1,66,-1,54
1,<environment.Job instance at 0x7f653148b6e0>,54,17,[1 9],55,-1,72,-1,55
1,<environment.Job instance at 0x7f653148b1e0>,56,18,[8 1],57,-1,75,-1,57
1,<environment.Job instance at 0x7f653148b2d0>,59,28,[6 1],60,-1,88,-1,60
1,<environment.Job instance at 0x7f6530784140>,64,18,[5 5],65,-1,83,-1,65
1,<environment.Job instance at 0x7f6530784500>,66,17,[2 6],67,-1,84,-1,67
1,<environment.Job instance at 0x7f6530784870>,68,18,[5 3],69,-1,87,-1,69
1,<environment.Job instance at 0x7f65306cd870>,69,12,[4 6],70,-1,82,-1,70
1,<environment.Job instance at 0x7f65306cd190>,70,13,[2 6],71,-1,84,-1,71
1,<environment.Job instance at 0x7f65306cd960>,71,13,[10  4],72,-1,85,-1,72
1,<environment.Job instance at 0x7f65306cdeb0>,72,15,[8 4],73,-1,88,-1,73
1,<environment.Job instance at 0x7f65306cd460>,73,24,[5 3],74,-1,98,-1,74
1,<environment.Job instance at 0x7f65306cdb90>,74,15,[5 6],75,-1,90,-1,75
1,<environment.Job instance at 0x7f653068a8c0>,76,17,[2 5],77,-1,94,-1,77
1,<environment.Job instance at 0x7f65308370f0>,78,12,[9 3],79,-1,91,-1,79
1,<environment.Job instance at 0x7f6530204cd0>,81,28,[9 4],82,-1,110,-1,82
1,<environment.Job instance at 0x7f653051e280>,34,13,[ 5 10],35,-1,97,-1,84
1,<environment.Job instance at 0x7f65316b9410>,96,21,[5 5],97,-1,131,-1,110
1,<environment.Job instance at 0x7f65316b9c80>,99,15,[10  2],100,-1,126,-1,111
1,<environment.Job instance at 0x7f65313a2fa0>,89,18,[7 5],90,-1,139,-1,121
1,<environment.Job instance at 0x7f65307a7af0>,104,16,[7 4],105,-1,137,-1,121
1,<environment.Job instance at 0x7f6530ed4a00>,108,17,[9 5],109,-1,138,-1,121
1,<environment.Job instance at 0x7f6530cf7f00>,62,18,[ 2 12],63,-1,139,-1,121
1,<environment.Job instance at 0x7f6530910190>,87,17,[1 9],88,-1,138,-1,121
1,<environment.Job instance at 0x7f65313a20a0>,88,19,[ 3 11],89,-1,140,-1,121
1,<environment.Job instance at 0x7f6530ed4aa0>,110,15,[5 3],111,-1,136,-1,121
1,<environment.Job instance at 0x7f6530ed49b0>,111,18,[4 7],112,-1,139,-1,121
1,<environment.Job instance at 0x7f6530ed4050>,113,17,[9 1],114,-1,138,-1,121
1,<environment.Job instance at 0x7f653113e2d0>,84,12,[9 1],85,-1,133,-1,121
1,<environment.Job instance at 0x7f6530ed46e0>,116,21,[5 5],117,-1,144,-1,123
1,<environment.Job instance at 0x7f6530ed4780>,114,22,[4 9],115,-1,147,-1,125
1,<environment.Job instance at 0x7f653057c190>,98,13,[4 6],99,-1,139,-1,126
1,<environment.Job instance at 0x7f6530ed4140>,107,13,[14  4],108,-1,139,-1,126
1,<environment.Job instance at 0x7f6530ed4dc0>,112,14,[4 6],113,-1,142,-1,128
1,<environment.Job instance at 0x7f6530e364b0>,119,15,[3 9],120,-1,144,-1,129
1,<environment.Job instance at 0x7f6530e36a50>,120,15,[5 5],121,-1,144,-1,129
1,<environment.Job instance at 0x7f653026ec30>,125,25,[1 6],126,-1,154,-1,129
1,<environment.Job instance at 0x7f6530730370>,127,15,[6 2],128,-1,144,-1,129
1,<environment.Job instance at 0x7f6530e36f50>,124,15,[10  2],125,-1,145,-1,130
1,<environment.Job instance at 0x7f6539f734b0>,132,20,[ 5 10],133,-1,159,-1,139
1,<environment.Job instance at 0x7f6530e61d20>,135,24,[8 3],136,-1,165,-1,141
1,<environment.Job instance at 0x7f65307a7140>,103,15,[3 9],104,-1,156,-1,141
1,<environment.Job instance at 0x7f6530e617d0>,137,12,[5 9],138,-1,154,-1,142
1,<environment.Job instance at 0x7f6530e61fa0>,136,14,[6 4],137,-1,156,-1,142
1,<environment.Job instance at 0x7f6530404b40>,3,3,[13  5],4,-1,7,-1,4
1,<environment.Job instance at 0x7f6530cf7780>,7,14,[ 3 14],8,-1,22,-1,8
1,<environment.Job instance at 0x7f6530739280>,6,27,[5 2],7,-1,43,-1,16
1,<environment.Job instance at 0x7f65315981e0>,24,28,[4 5],25,-1,83,-1,55
1,<environment.Job instance at 0x7f65315e2730>,27,2,[ 5 13],28,-1,58,-1,56
1,<environment.Job instance at 0x7f653a1ccb90>,31,25,[10  1],32,-1,108,-1,83
1,<environment.Job instance at 0x7f6530258410>,47,25,[9 4],48,-1,175,-1,150
1,<environment.Job instance at 0x7f6530c281e0>,59,28,[6 1],60,-1,227,-1,199
1,<environment.Job instance at 0x7f653093a9b0>,62,18,[ 2 12],63,-1,219,-1,201
1,<environment.Job instance at 0x7f65307a80a0>,73,24,[5 3],74,-1,275,-1,251
1,<environment.Job instance at 0x7f65307a8870>,77,2,[11  4],78,-1,254,-1,252
1,<environment.Job instance at 0x7f65307a8e60>,81,28,[9 4],82,-1,301,-1,273
1,<environment.Job instance at 0x7f65307a8410>,83,16,[ 1 12],84,-1,289,-1,273
1,<environment.Job instance at 0x7f65306637d0>,88,19,[ 3 11],89,-1,307,-1,288
1,<environment.Job instance at 0x7f65305938c0>,107,13,[14  4],108,-1,387,-1,374
1,<environment.Job instance at 0x7f6530c70c30>,123,2,[13  2],124,-1,433,-1,431
1,<environment.Job instance at 0x7f653158c9b0>,125,25,[1 6],126,-1,479,-1,454
1,<environment.Job instance at 0x7f6530da0a50>,130,27,[11  2],131,-1,485,-1,458
1,<environment.Job instance at 0x7f653118de10>,135,24,[8 3],136,-1,515,-1,491
1,<environment.Job instance at 0x7f6530a9a4b0>,1,16,[3 9],2,-1,18,-1,2
1,<environment.Job instance at 0x7f6530a9a8c0>,5,17,[10  3],6,-1,24,-1,7
1,<environment.Job instance at 0x7f6530a9a6e0>,6,18,[6 4],7,-1,25,-1,7
1,<environment.Job instance at 0x7f6530a9a9b0>,7,24,[5 9],8,-1,32,-1,8
1,<environment.Job instance at 0x7f652fdd0af0>,11,28,[3 6],12,-1,41,-1,13
1,<environment.Job instance at 0x7f652fdd0d20>,15,16,[7 3],16,-1,32,-1,16
1,<environment.Job instance at 0x7f652fdd0960>,16,12,[8 4],17,-1,29,-1,17
1,<environment.Job instance at 0x7f652fdd0640>,17,16,[1 8],18,-1,34,-1,18
1,<environment.Job instance at 0x7f652fdd0cd0>,18,2,[4 6],19,-1,21,-1,19
1,<environment.Job instance at 0x7f652fdd0b90>,19,26,[2 6],20,-1,46,-1,20
1,<environment.Job instance at 0x7f652fdd0820>,20,20,[9 3],21,-1,41,-1,21
1,<environment.Job instance at 0x7f6530a9a230>,12,14,[ 4 10],13,-1,35,-1,21
1,<environment.Job instance at 0x7f652fdd0690>,21,15,[8 4],22,-1,38,-1,23
1,<environment.Job instance at 0x7f652fdd0320>,22,14,[9 2],23,-1,37,-1,23
1,<environment.Job instance at 0x7f652fdd0370>,23,16,[2 6],24,-1,42,-1,26
1,<environment.Job instance at 0x7f652fdd07d0>,26,12,[2 7],27,-1,39,-1,27
1,<environment.Job instance at 0x7f652fdd0a50>,25,17,[5 3],26,-1,44,-1,27
1,<environment.Job instance at 0x7f652fdd0730>,28,26,[8 2],29,-1,55,-1,29
1,<environment.Job instance at 0x7f6530af11e0>,32,16,[9 2],33,-1,50,-1,34
1,<environment.Job instance at 0x7f6530af1910>,34,13,[2 8],35,-1,48,-1,35
1,<environment.Job instance at 0x7f6530af1af0>,36,17,[3 7],37,-1,54,-1,37
1,<environment.Job instance at 0x7f6530af1550>,33,18,[4 6],34,-1,55,-1,37
1,<environment.Job instance at 0x7f6530af15f0>,38,3,[10  2],39,-1,42,-1,39
1,<environment.Job instance at 0x7f6530af1460>,39,17,[5 7],40,-1,57,-1,40
1,<environment.Job instance at 0x7f6530af1410>,41,3,[ 4 13],42,-1,45,-1,42
1,<environment.Job instance at 0x7f6530af1c30>,42,18,[7 4],43,-1,62,-1,44
1,<environment.Job instance at 0x7f6530af18c0>,43,14,[ 2 10],44,-1,59,-1,45
1,<environment.Job instance at 0x7f652fed4e60>,48,3,[9 5],49,-1,52,-1,49
1,<environment.Job instance at 0x7f652fed4640>,49,15,[3 9],50,-1,65,-1,50
1,<environment.Job instance at 0x7f652fed48c0>,52,14,[ 2 10],53,-1,67,-1,53
1,<environment.Job instance at 0x7f652fed4550>,53,16,[3 8],54,-1,71,-1,55
1,<environment.Job instance at 0x7f652fed4500>,54,13,[10  5],55,-1,68,-1,55
1,<environment.Job instance at 0x7f652fed4e10>,55,19,[1 5],56,-1,76,-1,57
1,<environment.Job instance at 0x7f653095ce10>,57,1,[10  2],58,-1,59,-1,58
1,<environment.Job instance at 0x7f653095cb40>,58,16,[3 8],59,-1,75,-1,59
1,<environment.Job instance at 0x7f653095c960>,59,1,[9 4],60,-1,61,-1,60
1,<environment.Job instance at 0x7f653095c7d0>,60,18,[9 2],61,-1,79,-1,61
1,<environment.Job instance at 0x7f653095c0a0>,62,17,[9 4],63,-1,80,-1,63
1,<environment.Job instance at 0x7f653095c0f0>,64,27,[6 1],65,-1,92,-1,65
1,<environment.Job instance at 0x7f653095cdc0>,65,14,[4 8],66,-1,80,-1,66
1,<environment.Job instance at 0x7f653095c9b0>,66,17,[ 5 11],67,-1,84,-1,67
1,<environment.Job instance at 0x7f653095cf00>,69,16,[10  5],70,-1,86,-1,70
1,<environment.Job instance at 0x7f653095caf0>,70,12,[4 8],71,-1,83,-1,71
1,<environment.Job instance at 0x7f652fed45a0>,56,13,[5 7],57,-1,85,-1,72
1,<environment.Job instance at 0x7f65305c84b0>,73,24,[10  2],74,-1,99,-1,75
1,<environment.Job instance at 0x7f65305c83c0>,77,1,[5 3],78,-1,79,-1,78
1,<environment.Job instance at 0x7f65305c8c80>,78,18,[5 9],79,-1,97,-1,79
1,<environment.Job instance at 0x7f652fea2500>,88,13,[8 5],89,-1,102,-1,89
1,<environment.Job instance at 0x7f652fea25a0>,89,13,[8 2],90,-1,103,-1,90
1,<environment.Job instance at 0x7f652fed4c80>,7,24,[5 9],8,-1,42,-1,18
1,<environment.Job instance at 0x7f65305c8370>,11,28,[3 6],12,-1,47,-1,19
1,<environment.Job instance at 0x7f65302cbaa0>,19,26,[2 6],20,-1,79,-1,53
1,<environment.Job instance at 0x7f65302641e0>,27,1,[ 1 13],28,-1,77,-1,76
1,<environment.Job instance at 0x7f652fe27a50>,28,26,[8 2],29,-1,111,-1,85
1,<environment.Job instance at 0x7f653a12d190>,35,25,[ 3 14],36,-1,125,-1,100
1,<environment.Job instance at 0x7f653005fcd0>,41,3,[ 4 13],42,-1,126,-1,123
1,<environment.Job instance at 0x7f652ff36050>,44,27,[13  3],45,-1,153,-1,126
1,<environment.Job instance at 0x7f6539d52190>,64,27,[6 1],65,-1,248,-1,221
1,<environment.Job instance at 0x7f6539d52230>,66,17,[ 5 11],67,-1,238,-1,221
1,<environment.Job instance at 0x7f65304b12d0>,71,24,[14  3],72,-1,260,-1,236
1,<environment.Job instance at 0x7f652ffac870>,73,24,[10  2],74,-1,276,-1,252
1,<environment.Job instance at 0x7f6530f54c80>,90,13,[12  1],91,-1,309,-1,296
1,<environment.Job instance at 0x7f6530f54410>,91,16,[ 5 11],92,-1,312,-1,296
1,<environment.Job instance at 0x7f6539f84140>,95,27,[4 5],96,-1,349,-1,322
1,<environment.Job instance at 0x7f653a127b40>,96,1,[12  2],97,-1,323,-1,322
1,<environment.Job instance at 0x7f6530dd0550>,106,25,[7 3],107,-1,375,-1,350
1,<environment.Job instance at 0x7f65312b37d0>,110,26,[6 4],111,-1,383,-1,357
1,<environment.Job instance at 0x7f65300915f0>,2,18,[3 7],3,-1,21,-1,3
1,<environment.Job instance at 0x7f6530091640>,5,13,[9 1],6,-1,21,-1,8
1,<environment.Job instance at 0x7f6530dd0c30>,8,14,[ 1 10],9,-1,23,-1,9
1,<environment.Job instance at 0x7f6530dd0050>,7,15,[3 6],8,-1,25,-1,10
1,<environment.Job instance at 0x7f65300918c0>,10,25,[5 3],11,-1,36,-1,11
1,<environment.Job instance at 0x7f6530dd0dc0>,18,16,[10  3],19,-1,35,-1,19
1,<environment.Job instance at 0x7f65311e5f50>,19,28,[3 9],20,-1,48,-1,20
1,<environment.Job instance at 0x7f65311e5aa0>,22,23,[3 7],23,-1,46,-1,23
1,<environment.Job instance at 0x7f65311e5320>,24,17,[2 7],25,-1,42,-1,25
1,<environment.Job instance at 0x7f65309bb870>,27,16,[5 4],28,-1,44,-1,28
1,<environment.Job instance at 0x7f65309bb190>,28,17,[6 5],29,-1,46,-1,29
1,<environment.Job instance at 0x7f65309bb6e0>,29,18,[5 1],30,-1,48,-1,30
1,<environment.Job instance at 0x7f65309bb780>,30,16,[1 7],31,-1,47,-1,31
1,<environment.Job instance at 0x7f65309bbe60>,31,12,[2 6],32,-1,45,-1,33
1,<environment.Job instance at 0x7f65309bbbe0>,32,17,[6 4],33,-1,50,-1,33
1,<environment.Job instance at 0x7f65309bbd70>,36,15,[5 6],37,-1,52,-1,37
1,<environment.Job instance at 0x7f65309bbc80>,40,15,[1 8],41,-1,56,-1,41
1,<environment.Job instance at 0x7f65309bbb40>,41,16,[5 5],42,-1,58,-1,42
1,<environment.Job instance at 0x7f65309bbb90>,42,18,[2 5],43,-1,61,-1,43
1,<environment.Job instance at 0x7f65309bb500>,44,14,[ 3 10],45,-1,59,-1,45
1,<environment.Job instance at 0x7f6531405f50>,59,17,[9 4],60,-1,77,-1,60
1,<environment.Job instance at 0x7f65314059b0>,60,13,[10  1],61,-1,76,-1,63
1,<environment.Job instance at 0x7f6531405500>,63,18,[4 5],64,-1,82,-1,64
1,<environment.Job instance at 0x7f6531405820>,65,15,[1 5],66,-1,81,-1,66
1,<environment.Job instance at 0x7f6531405280>,66,16,[5 6],67,-1,83,-1,67
1,<environment.Job instance at 0x7f653104de10>,53,20,[ 5 12],54,-1,103,-1,83
1,<environment.Job instance at 0x7f65312361e0>,77,15,[10  4],78,-1,98,-1,83
1,<environment.Job instance at 0x7f653104d550>,55,16,[10  3],56,-1,116,-1,100
1,<environment.Job instance at 0x7f65312360f0>,86,27,[2 9],87,-1,128,-1,101
1,<environment.Job instance at 0x7f653150e3c0>,90,13,[2 8],91,-1,115,-1,102
1,<environment.Job instance at 0x7f6531236af0>,88,18,[ 5 10],89,-1,124,-1,106
1,<environment.Job instance at 0x7f653150e6e0>,92,22,[8 1],93,-1,128,-1,106
1,<environment.Job instance at 0x7f653150e8c0>,89,18,[10  2],90,-1,124,-1,106
1,<environment.Job instance at 0x7f65301d5280>,98,16,[9 1],99,-1,131,-1,115
1,<environment.Job instance at 0x7f653104de60>,47,16,[ 5 13],48,-1,131,-1,115
1,<environment.Job instance at 0x7f65301d5aa0>,101,27,[8 5],102,-1,144,-1,117
1,<environment.Job instance at 0x7f6530b52f50>,114,17,[10  5],115,-1,304,-1,287
1,<environment.Job instance at 0x7f6530403960>,112,18,[10  5],113,-1,336,-1,318
1,<environment.Job instance at 0x7f6531490550>,124,15,[2 7],125,-1,334,-1,319
1,<environment.Job instance at 0x7f6531409b90>,125,3,[6 4],126,-1,323,-1,320
1,<environment.Job instance at 0x7f6531226f50>,126,13,[1 6],127,-1,333,-1,320
1,<environment.Job instance at 0x7f65302cf190>,117,15,[ 4 10],118,-1,335,-1,320
1,<environment.Job instance at 0x7f65312366e0>,78,16,[ 5 10],79,-1,348,-1,332
1,<environment.Job instance at 0x7f65306cd460>,132,18,[1 9],133,-1,350,-1,332
1,<environment.Job instance at 0x7f65312932d0>,138,15,[3 8],139,-1,347,-1,332
1,<environment.Job instance at 0x7f653104d3c0>,4,1,[13  5],5,-1,6,-1,5
1,<environment.Job instance at 0x7f6531405140>,10,25,[5 3],11,-1,42,-1,17
1,<environment.Job instance at 0x7f6531236550>,11,16,[11  2],12,-1,33,-1,17
1,<environment.Job instance at 0x7f65311eabe0>,19,28,[3 9],20,-1,73,-1,45
1,<environment.Job instance at 0x7f653111db40>,22,23,[3 7],23,-1,71,-1,48
1,<environment.Job instance at 0x7f65300931e0>,26,3,[ 5 14],27,-1,54,-1,51
1,<environment.Job instance at 0x7f652fde3370>,37,16,[11  1],38,-1,100,-1,84
1,<environment.Job instance at 0x7f6530de5780>,47,16,[ 5 13],48,-1,146,-1,130
1,<environment.Job instance at 0x7f653153b460>,49,2,[13  4],50,-1,133,-1,131
1,<environment.Job instance at 0x7f6530dd0550>,53,20,[ 5 12],54,-1,153,-1,133
1,<environment.Job instance at 0x7f6530dd0820>,54,2,[ 5 11],55,-1,135,-1,133
1,<environment.Job instance at 0x7f65310565a0>,61,2,[ 5 11],62,-1,155,-1,153
1,<environment.Job instance at 0x7f6530f54960>,69,13,[ 4 14],70,-1,187,-1,174
1,<environment.Job instance at 0x7f6539f887d0>,76,16,[13  1],77,-1,217,-1,201
1,<environment.Job instance at 0x7f6539d52230>,86,27,[2 9],87,-1,266,-1,239
1,<environment.Job instance at 0x7f653a313960>,93,14,[14  4],94,-1,272,-1,258
1,<environment.Job instance at 0x7f652ff77e10>,95,3,[ 1 13],96,-1,261,-1,258
1,<environment.Job instance at 0x7f652ff77500>,96,2,[14  2],97,-1,260,-1,258
1,<environment.Job instance at 0x7f65316d5b40>,97,15,[ 5 12],98,-1,273,-1,258
1,<environment.Job instance at 0x7f6530587550>,100,2,[14  4],101,-1,270,-1,268
1,<environment.Job instance at 0x7f6530587f00>,101,27,[8 5],102,-1,302,-1,275
1,<environment.Job instance at 0x7f6531226dc0>,104,16,[11  4],105,-1,293,-1,277
1,<environment.Job instance at 0x7f653a31d9b0>,108,16,[13  2],109,-1,297,-1,281
1,<environment.Job instance at 0x7f652fe279b0>,111,14,[ 2 12],112,-1,309,-1,295
1,<environment.Job instance at 0x7f65302641e0>,113,26,[7 1],114,-1,338,-1,312
1,<environment.Job instance at 0x7f6530c86050>,4,17,[8 5],5,-1,23,-1,6
1,<environment.Job instance at 0x7f6530c696e0>,8,13,[10  4],9,-1,22,-1,9
1,<environment.Job instance at 0x7f6530b916e0>,14,18,[ 4 10],15,-1,33,-1,15
1,<environment.Job instance at 0x7f6530b91730>,16,15,[ 3 10],17,-1,32,-1,17
1,<environment.Job instance at 0x7f6530b91dc0>,21,12,[5 8],22,-1,34,-1,22
1,<environment.Job instance at 0x7f652fe42730>,5,17,[1 7],6,-1,41,-1,24
1,<environment.Job instance at 0x7f65307481e0>,24,15,[6 2],25,-1,40,-1,25
1,<environment.Job instance at 0x7f65307480f0>,26,16,[5 9],27,-1,43,-1,27
1,<environment.Job instance at 0x7f65307482d0>,28,24,[5 6],29,-1,53,-1,29
1,<environment.Job instance at 0x7f65307487d0>,31,17,[5 8],32,-1,50,-1,33
1,<environment.Job instance at 0x7f65307486e0>,33,14,[3 6],34,-1,48,-1,34
1,<environment.Job instance at 0x7f65307489b0>,34,16,[8 2],35,-1,51,-1,35
1,<environment.Job instance at 0x7f6530748af0>,36,14,[4 7],37,-1,51,-1,37
1,<environment.Job instance at 0x7f6530748910>,32,14,[14  5],33,-1,53,-1,39
1,<environment.Job instance at 0x7f6530748b90>,38,12,[10  3],39,-1,52,-1,40
1,<environment.Job instance at 0x7f6530748fa0>,40,20,[ 4 10],41,-1,61,-1,41
1,<environment.Job instance at 0x7f6530785230>,43,14,[ 4 10],44,-1,58,-1,44
1,<environment.Job instance at 0x7f65307851e0>,45,14,[5 4],46,-1,60,-1,46
1,<environment.Job instance at 0x7f65307855f0>,46,24,[4 5],47,-1,71,-1,47
1,<environment.Job instance at 0x7f6530785460>,47,24,[4 8],48,-1,72,-1,48
1,<environment.Job instance at 0x7f65307860a0>,56,16,[4 9],57,-1,73,-1,57
1,<environment.Job instance at 0x7f6530786190>,57,18,[6 1],58,-1,76,-1,58
1,<environment.Job instance at 0x7f6530786140>,58,14,[5 4],59,-1,73,-1,59
1,<environment.Job instance at 0x7f6530748f50>,39,13,[10  4],40,-1,75,-1,62
1,<environment.Job instance at 0x7f6530786be0>,67,13,[9 4],68,-1,87,-1,74
1,<environment.Job instance at 0x7f6530786410>,62,23,[6 2],63,-1,103,-1,80
1,<environment.Job instance at 0x7f6530786f00>,72,18,[6 5],73,-1,98,-1,80
1,<environment.Job instance at 0x7f6530f65c30>,76,16,[4 8],77,-1,99,-1,83
1,<environment.Job instance at 0x7f6530f65c80>,77,15,[4 8],78,-1,103,-1,88
1,<environment.Job instance at 0x7f6530f68e10>,83,14,[ 2 11],84,-1,104,-1,90
1,<environment.Job instance at 0x7f6530f68e60>,84,17,[1 6],85,-1,108,-1,91
1,<environment.Job instance at 0x7f6530f684b0>,85,14,[3 8],86,-1,106,-1,92
1,<environment.Job instance at 0x7f6530f688c0>,86,17,[4 6],87,-1,109,-1,92
1,<environment.Job instance at 0x7f6530f68050>,81,12,[5 6],82,-1,104,-1,92
1,<environment.Job instance at 0x7f65302b9b40>,88,18,[10  1],89,-1,110,-1,92
1,<environment.Job instance at 0x7f6530b91aa0>,1,16,[ 5 12],2,-1,18,-1,2
1,<environment.Job instance at 0x7f6530b91640>,3,17,[13  5],4,-1,21,-1,4
1,<environment.Job instance at 0x7f6530f68780>,15,2,[ 3 11],16,-1,23,-1,21
1,<environment.Job instance at 0x7f652fdd0f50>,22,3,[ 4 11],23,-1,43,-1,40
1,<environment.Job instance at 0x7f6531226dc0>,28,24,[5 6],29,-1,94,-1,70
1,<environment.Job instance at 0x7f6530587550>,30,3,[ 3 12],31,-1,73,-1,70
1,<environment.Job instance at 0x7f65311b1c30>,32,14,[14  5],33,-1,86,-1,72
1,<environment.Job instance at 0x7f6530cd9820>,47,24,[4 8],48,-1,170,-1,146
1,<environment.Job instance at 0x7f6530cd95f0>,46,24,[4 5],47,-1,170,-1,146
1,<environment.Job instance at 0x7f6530b79370>,64,3,[ 1 12],65,-1,179,-1,176
1,<environment.Job instance at 0x7f6530b79230>,65,14,[12  1],66,-1,190,-1,176
1,<environment.Job instance at 0x7f65310565a0>,62,23,[6 2],63,-1,215,-1,192
1,<environment.Job instance at 0x7f6530dd0c80>,73,1,[11  3],74,-1,207,-1,206
1,<environment.Job instance at 0x7f6530e31780>,75,28,[ 4 12],76,-1,234,-1,206
1,<environment.Job instance at 0x7f652ff7c280>,79,1,[ 4 13],80,-1,227,-1,226
1,<environment.Job instance at 0x7f6530093190>,83,14,[ 2 11],84,-1,254,-1,240
1,<environment.Job instance at 0x7f6530e1a960>,95,24,[5 2],96,-1,327,-1,303
1,<environment.Job instance at 0x7f6531405d70>,100,25,[6 2],101,-1,342,-1,317
1,<environment.Job instance at 0x7f65310973c0>,109,13,[ 1 11],110,-1,350,-1,337
1,<environment.Job instance at 0x7f6531097af0>,110,25,[5 5],111,-1,373,-1,348
1,<environment.Job instance at 0x7f6531097b40>,113,3,[ 4 11],114,-1,352,-1,349
1,<environment.Job instance at 0x7f653054e0a0>,128,16,[14  4],129,-1,429,-1,413
1,<environment.Job instance at 0x7f6530564a00>,137,27,[8 5],138,-1,477,-1,450
1,<environment.Job instance at 0x7f6530dcbc80>,5,15,[10  1],6,-1,23,-1,8
1,<environment.Job instance at 0x7f653058caa0>,10,20,[8 5],11,-1,31,-1,11
1,<environment.Job instance at 0x7f653128d2d0>,14,16,[5 8],15,-1,31,-1,15
1,<environment.Job instance at 0x7f65300b8690>,15,25,[4 5],16,-1,41,-1,16
1,<environment.Job instance at 0x7f653049b280>,20,18,[3 5],21,-1,39,-1,21
1,<environment.Job instance at 0x7f653049b5a0>,21,15,[3 7],22,-1,37,-1,22
1,<environment.Job instance at 0x7f6530562690>,31,13,[3 5],32,-1,45,-1,32
1,<environment.Job instance at 0x7f6530163550>,32,18,[4 8],33,-1,51,-1,33
1,<environment.Job instance at 0x7f6530163a50>,33,15,[ 2 10],34,-1,49,-1,34
1,<environment.Job instance at 0x7f65316a7d70>,36,13,[6 4],37,-1,50,-1,37
1,<environment.Job instance at 0x7f65316a7a50>,37,26,[ 3 10],38,-1,64,-1,38
1,<environment.Job instance at 0x7f65316a7190>,38,12,[10  4],39,-1,51,-1,39
1,<environment.Job instance at 0x7f65310ed5a0>,42,1,[2 6],43,-1,44,-1,43
1,<environment.Job instance at 0x7f65310ed3c0>,43,3,[6 1],44,-1,47,-1,44
1,<environment.Job instance at 0x7f65305d6780>,50,12,[2 5],51,-1,63,-1,51
1,<environment.Job instance at 0x7f65305d6280>,51,17,[7 4],52,-1,69,-1,52
1,<environment.Job instance at 0x7f65305d60f0>,53,14,[ 5 10],54,-1,68,-1,54
1,<environment.Job instance at 0x7f65305d6960>,55,13,[7 4],56,-1,69,-1,56
1,<environment.Job instance at 0x7f65305d69b0>,56,16,[3 8],57,-1,73,-1,57
1,<environment.Job instance at 0x7f6530e744b0>,60,15,[5 5],61,-1,76,-1,61
1,<environment.Job instance at 0x7f6530e74f00>,62,17,[5 7],63,-1,80,-1,63
1,<environment.Job instance at 0x7f6530acb640>,68,12,[7 5],69,-1,81,-1,69
1,<environment.Job instance at 0x7f6530acb140>,70,18,[9 3],71,-1,89,-1,71
1,<environment.Job instance at 0x7f6530acb5a0>,71,17,[9 4],72,-1,89,-1,72
1,<environment.Job instance at 0x7f6530acbc30>,76,17,[4 8],77,-1,94,-1,77
1,<environment.Job instance at 0x7f653113e320>,78,16,[8 4],79,-1,95,-1,79
1,<environment.Job instance at 0x7f653113e410>,79,17,[5 6],80,-1,97,-1,80
1,<environment.Job instance at 0x7f653113e8c0>,80,15,[3 7],81,-1,96,-1,81
1,<environment.Job instance at 0x7f653a247640>,84,13,[10  1],85,-1,100,-1,87
1,<environment.Job instance at 0x7f653a2477d0>,87,13,[7 1],88,-1,101,-1,88
1,<environment.Job instance at 0x7f6530da2410>,90,12,[3 8],91,-1,103,-1,91
1,<environment.Job instance at 0x7f653099cc30>,91,18,[7 1],92,-1,110,-1,92
1,<environment.Job instance at 0x7f65307c3af0>,92,15,[6 2],93,-1,108,-1,93
1,<environment.Job instance at 0x7f65309e40a0>,100,14,[8 2],101,-1,115,-1,101
1,<environment.Job instance at 0x7f652ff77050>,99,14,[7 3],100,-1,130,-1,116
1,<environment.Job instance at 0x7f653002cb40>,108,15,[10  2],109,-1,131,-1,116
1,<environment.Job instance at 0x7f653079bc30>,112,14,[5 2],113,-1,130,-1,116
1,<environment.Job instance at 0x7f65314a3140>,117,22,[2 9],118,-1,141,-1,119
1,<environment.Job instance at 0x7f65312f8370>,111,23,[5 9],112,-1,145,-1,122
1,<environment.Job instance at 0x7f652fed2af0>,120,13,[5 8],121,-1,135,-1,122
1,<environment.Job instance at 0x7f6531527140>,123,15,[ 3 10],124,-1,139,-1,124
1,<environment.Job instance at 0x7f6530393780>,96,14,[6 2],97,-1,145,-1,131
1,<environment.Job instance at 0x7f6531169c30>,126,20,[8 2],127,-1,151,-1,131
1,<environment.Job instance at 0x7f65316abcd0>,121,16,[5 2],122,-1,147,-1,131
1,<environment.Job instance at 0x7f65312f8e60>,109,13,[4 7],110,-1,144,-1,131
1,<environment.Job instance at 0x7f652fff2a50>,130,15,[10  5],131,-1,147,-1,132
1,<environment.Job instance at 0x7f65310eddc0>,3,17,[13  3],4,-1,21,-1,4
1,<environment.Job instance at 0x7f65305d6d20>,4,3,[13  1],5,-1,8,-1,5
1,<environment.Job instance at 0x7f6530e72e60>,15,25,[4 5],16,-1,48,-1,23
1,<environment.Job instance at 0x7f65309e4a00>,18,1,[ 4 14],19,-1,24,-1,23
1,<environment.Job instance at 0x7f653a127af0>,30,2,[13  2],31,-1,54,-1,52
1,<environment.Job instance at 0x7f6530cd9820>,34,1,[12  5],35,-1,67,-1,66
1,<environment.Job instance at 0x7f652fe92dc0>,37,26,[ 3 10],38,-1,98,-1,72
1,<environment.Job instance at 0x7f6530785280>,41,3,[12  2],42,-1,90,-1,87
1,<environment.Job instance at 0x7f653049b730>,54,3,[14  3],55,-1,113,-1,110
1,<environment.Job instance at 0x7f653099c8c0>,66,1,[11  3],67,-1,157,-1,156
1,<environment.Job instance at 0x7f653034a050>,73,14,[14  1],74,-1,191,-1,177
1,<environment.Job instance at 0x7f65316b9fa0>,82,17,[ 5 14],83,-1,234,-1,217
1,<environment.Job instance at 0x7f6530934870>,93,15,[ 2 12],94,-1,267,-1,252
1,<environment.Job instance at 0x7f6539d5b370>,98,2,[13  1],99,-1,281,-1,279
1,<environment.Job instance at 0x7f6530159f00>,101,26,[7 2],102,-1,316,-1,290
1,<environment.Job instance at 0x7f6530f0e8c0>,111,23,[5 9],112,-1,351,-1,328
1,<environment.Job instance at 0x7f65316b8d20>,113,3,[ 1 14],114,-1,331,-1,328
1,<environment.Job instance at 0x7f65316166e0>,116,1,[ 3 13],117,-1,329,-1,328
1,<environment.Job instance at 0x7f6530569fa0>,128,26,[2 5],129,-1,401,-1,375
1,<environment.Job instance at 0x7f653a1cbb90>,136,24,[2 9],137,-1,440,-1,416
1,<environment.Job instance at 0x7f653a1cb1e0>,137,12,[ 2 12],138,-1,428,-1,416
1,<environment.Job instance at 0x7f65307b9550>,138,14,[13  4],139,-1,430,-1,416
1,<environment.Job instance at 0x7f653123b0a0>,1,16,[8 4],2,-1,20,-1,4
1,<environment.Job instance at 0x7f653054cb40>,5,15,[9 1],6,-1,21,-1,6
1,<environment.Job instance at 0x7f653054c780>,7,16,[8 4],8,-1,24,-1,8
1,<environment.Job instance at 0x7f65301b56e0>,10,15,[1 8],11,-1,26,-1,11
1,<environment.Job instance at 0x7f65301b5640>,13,13,[10  3],14,-1,27,-1,14
1,<environment.Job instance at 0x7f65301b5500>,14,14,[5 3],15,-1,29,-1,15
1,<environment.Job instance at 0x7f65301b5aa0>,16,1,[ 3 11],17,-1,18,-1,17
1,<environment.Job instance at 0x7f65301b5960>,17,14,[4 7],18,-1,32,-1,18
1,<environment.Job instance at 0x7f653123b4b0>,3,12,[6 5],4,-1,32,-1,20
1,<environment.Job instance at 0x7f65301b5d70>,20,12,[9 4],21,-1,34,-1,22
1,<environment.Job instance at 0x7f65301b5c30>,22,14,[3 7],23,-1,37,-1,23
1,<environment.Job instance at 0x7f65301b50a0>,21,23,[1 8],22,-1,46,-1,23
1,<environment.Job instance at 0x7f65301b59b0>,23,16,[ 5 10],24,-1,40,-1,24
1,<environment.Job instance at 0x7f65309bb690>,24,17,[3 5],25,-1,42,-1,25
1,<environment.Job instance at 0x7f65309bb230>,25,15,[ 1 10],26,-1,42,-1,27
1,<environment.Job instance at 0x7f65309bbcd0>,31,13,[5 8],32,-1,45,-1,32
1,<environment.Job instance at 0x7f65309bb190>,32,14,[6 2],33,-1,47,-1,33
1,<environment.Job instance at 0x7f65309bb730>,33,13,[6 5],34,-1,47,-1,34
1,<environment.Job instance at 0x7f65309bb5a0>,36,25,[8 1],37,-1,62,-1,37
1,<environment.Job instance at 0x7f65312f77d0>,37,18,[ 1 10],38,-1,56,-1,38
1,<environment.Job instance at 0x7f65312f72d0>,38,12,[6 3],39,-1,51,-1,39
1,<environment.Job instance at 0x7f65312f7690>,43,16,[9 5],44,-1,60,-1,44
1,<environment.Job instance at 0x7f65316a1a50>,44,28,[7 4],45,-1,73,-1,45
1,<environment.Job instance at 0x7f6530f7feb0>,45,20,[7 2],46,-1,66,-1,46
1,<environment.Job instance at 0x7f6530f7ff00>,46,14,[10  3],47,-1,61,-1,47
1,<environment.Job instance at 0x7f6530f7f140>,47,17,[5 6],48,-1,65,-1,48
1,<environment.Job instance at 0x7f6530f7faa0>,49,17,[5 2],50,-1,67,-1,50
1,<environment.Job instance at 0x7f6530f7f230>,50,14,[6 1],51,-1,65,-1,51
1,<environment.Job instance at 0x7f6530f7fa50>,51,17,[9 3],52,-1,69,-1,52
1,<environment.Job instance at 0x7f6530f7f960>,53,15,[2 7],54,-1,69,-1,54
1,<environment.Job instance at 0x7f653a31e460>,54,19,[1 8],55,-1,74,-1,55
1,<environment.Job instance at 0x7f6530fa84b0>,56,17,[8 4],57,-1,74,-1,57
1,<environment.Job instance at 0x7f6530fa85a0>,58,12,[ 1 10],59,-1,71,-1,59
1,<environment.Job instance at 0x7f6530fa8460>,60,13,[8 4],61,-1,74,-1,61
1,<environment.Job instance at 0x7f6530fa81e0>,62,12,[7 3],63,-1,75,-1,63
1,<environment.Job instance at 0x7f6530fa83c0>,63,20,[4 5],64,-1,84,-1,64
1,<environment.Job instance at 0x7f6530fa8780>,65,20,[5 5],66,-1,86,-1,66
1,<environment.Job instance at 0x7f6530fa85f0>,66,18,[7 3],67,-1,85,-1,67
1,<environment.Job instance at 0x7f6530a00aa0>,68,18,[1 5],69,-1,87,-1,69
1,<environment.Job instance at 0x7f653a313690>,70,16,[ 2 10],71,-1,87,-1,71
1,<environment.Job instance at 0x7f6539cddfa0>,71,18,[3 9],72,-1,90,-1,72
1,<environment.Job instance at 0x7f6539cddb40>,72,15,[5 5],73,-1,88,-1,73
1,<environment.Job instance at 0x7f6531724780>,78,13,[8 5],79,-1,92,-1,79
1,<environment.Job instance at 0x7f65317245f0>,79,15,[4 6],80,-1,95,-1,80
1,<environment.Job instance at 0x7f6531724050>,81,25,[1 6],82,-1,107,-1,82
1,<environment.Job instance at 0x7f6531420870>,84,17,[5 5],85,-1,102,-1,85
1,<environment.Job instance at 0x7f65314c2fa0>,91,15,[10  4],92,-1,112,-1,97
1,<environment.Job instance at 0x7f65309bbdc0>,26,13,[ 5 11],27,-1,110,-1,97
1,<environment.Job instance at 0x7f6530290e10>,16,1,[ 3 11],17,-1,22,-1,21
1,<environment.Job instance at 0x7f65307028c0>,21,23,[1 8],22,-1,61,-1,38
1,<environment.Job instance at 0x7f6530ecc460>,26,13,[ 5 11],27,-1,64,-1,51
1,<environment.Job instance at 0x7f65302f3a00>,36,25,[8 1],37,-1,112,-1,87
1,<environment.Job instance at 0x7f652ff58dc0>,44,28,[7 4],45,-1,140,-1,112
1,<environment.Job instance at 0x7f6530dcb8c0>,67,13,[14  1],68,-1,205,-1,192
1,<environment.Job instance at 0x7f65305d6e60>,76,2,[14  1],77,-1,230,-1,228
1,<environment.Job instance at 0x7f653117deb0>,81,25,[1 6],82,-1,268,-1,243
1,<environment.Job instance at 0x7f653117da50>,82,12,[12  2],83,-1,255,-1,243
1,<environment.Job instance at 0x7f653117d550>,83,26,[10  4],84,-1,272,-1,246
1,<environment.Job instance at 0x7f653117d690>,85,24,[4 7],86,-1,280,-1,256
1,<environment.Job instance at 0x7f653117d870>,94,13,[ 5 11],95,-1,306,-1,293
1,<environment.Job instance at 0x7f653a30c870>,97,28,[7 2],98,-1,339,-1,311
1,<environment.Job instance at 0x7f653a30ca00>,99,27,[ 3 10],100,-1,343,-1,316
1,<environment.Job instance at 0x7f65317389b0>,102,26,[9 1],103,-1,355,-1,329
1,<environment.Job instance at 0x7f653a248280>,106,3,[ 2 14],107,-1,332,-1,329
1,<environment.Job instance at 0x7f6539d509b0>,117,27,[9 4],118,-1,391,-1,364
1,<environment.Job instance at 0x7f652fed1dc0>,128,17,[13  5],129,-1,414,-1,397
1,<environment.Job instance at 0x7f65316116e0>,7,17,[ 5 10],8,-1,26,-1,9
1,<environment.Job instance at 0x7f6531611410>,9,23,[5 7],10,-1,33,-1,10
1,<environment.Job instance at 0x7f6531611870>,10,15,[3 7],11,-1,26,-1,11
1,<environment.Job instance at 0x7f6531611af0>,13,25,[ 1 10],14,-1,39,-1,14
1,<environment.Job instance at 0x7f6531611f00>,17,19,[ 2 10],18,-1,37,-1,18
1,<environment.Job instance at 0x7f653161d190>,21,18,[9 3],22,-1,40,-1,22
1,<environment.Job instance at 0x7f653161d640>,24,13,[4 7],25,-1,38,-1,25
1,<environment.Job instance at 0x7f653161d690>,26,14,[9 3],27,-1,41,-1,27
1,<environment.Job instance at 0x7f653161d780>,28,18,[7 1],29,-1,47,-1,29
1,<environment.Job instance at 0x7f653161dd20>,31,12,[4 6],32,-1,44,-1,32
1,<environment.Job instance at 0x7f653161ddc0>,33,13,[10  4],34,-1,47,-1,34
1,<environment.Job instance at 0x7f65315f9320>,37,15,[8 5],38,-1,53,-1,38
1,<environment.Job instance at 0x7f65315f9730>,42,16,[8 1],43,-1,71,-1,55
1,<environment.Job instance at 0x7f65315f9c80>,47,21,[10  4],48,-1,102,-1,81
1,<environment.Job instance at 0x7f65315f9e60>,51,21,[1 7],52,-1,102,-1,81
1,<environment.Job instance at 0x7f65315f9870>,44,14,[ 1 12],45,-1,96,-1,82
1,<environment.Job instance at 0x7f65316286e0>,61,16,[1 5],62,-1,99,-1,83
1,<environment.Job instance at 0x7f6531628730>,62,18,[1 5],63,-1,101,-1,83
1,<environment.Job instance at 0x7f6531628820>,63,15,[2 8],64,-1,98,-1,83
1,<environment.Job instance at 0x7f6531628be0>,68,16,[6 5],69,-1,110,-1,94
1,<environment.Job instance at 0x7f6531628eb0>,70,25,[6 2],71,-1,120,-1,95
1,<environment.Job instance at 0x7f6531614190>,74,21,[5 2],75,-1,117,-1,96
1,<environment.Job instance at 0x7f6531614230>,77,16,[1 7],78,-1,114,-1,98
1,<environment.Job instance at 0x7f6531628af0>,67,13,[ 5 10],68,-1,118,-1,105
1,<environment.Job instance at 0x7f6531614500>,80,16,[5 9],81,-1,147,-1,131
1,<environment.Job instance at 0x7f6531614910>,81,18,[14  2],82,-1,149,-1,131
1,<environment.Job instance at 0x7f6531614b40>,84,17,[4 9],85,-1,152,-1,135
1,<environment.Job instance at 0x7f6531614c80>,86,18,[1 8],87,-1,156,-1,138
1,<environment.Job instance at 0x7f6531628370>,56,16,[1 7],57,-1,154,-1,138
1,<environment.Job instance at 0x7f6531614d20>,87,27,[4 8],88,-1,167,-1,140
1,<environment.Job instance at 0x7f6531614dc0>,88,20,[ 4 13],89,-1,160,-1,140
1,<environment.Job instance at 0x7f65315ec370>,93,15,[5 3],94,-1,155,-1,140
1,<environment.Job instance at 0x7f6531614be0>,85,15,[12  5],86,-1,158,-1,143
1,<environment.Job instance at 0x7f6531614f00>,90,15,[8 5],91,-1,158,-1,143
1,<environment.Job instance at 0x7f65315ecaa0>,98,18,[6 4],99,-1,162,-1,144
1,<environment.Job instance at 0x7f65315ecc30>,101,17,[7 1],102,-1,161,-1,144
1,<environment.Job instance at 0x7f653123b1e0>,106,18,[4 9],107,-1,164,-1,146
1,<environment.Job instance at 0x7f6531614e60>,89,12,[10  1],90,-1,158,-1,146
1,<environment.Job instance at 0x7f653065ecd0>,120,17,[5 8],121,-1,206,-1,189
1,<environment.Job instance at 0x7f65315eccd0>,102,15,[9 5],103,-1,210,-1,195
1,<environment.Job instance at 0x7f652fdf3e60>,126,17,[5 1],127,-1,225,-1,208
1,<environment.Job instance at 0x7f65316152d0>,135,18,[4 9],136,-1,246,-1,228
1,<environment.Job instance at 0x7f65316154b0>,138,18,[6 5],139,-1,260,-1,242
1,<environment.Job instance at 0x7f653161d370>,2,13,[13  5],3,-1,16,-1,3
1,<environment.Job instance at 0x7f6531628910>,5,2,[ 2 12],6,-1,8,-1,6
1,<environment.Job instance at 0x7f6530665230>,9,23,[5 7],10,-1,38,-1,15
1,<environment.Job instance at 0x7f6531614050>,13,25,[ 1 10],14,-1,44,-1,19
1,<environment.Job instance at 0x7f65315ec6e0>,16,12,[14  2],17,-1,31,-1,19
1,<environment.Job instance at 0x7f65316156e0>,18,1,[ 5 14],19,-1,20,-1,19
1,<environment.Job instance at 0x7f6539d19e10>,30,12,[ 1 13],31,-1,76,-1,64
1,<environment.Job instance at 0x7f652fed1eb0>,35,2,[11  4],36,-1,84,-1,82
1,<environment.Job instance at 0x7f65302ca960>,44,14,[ 1 12],45,-1,117,-1,103
1,<environment.Job instance at 0x7f6539d509b0>,46,23,[ 5 12],47,-1,136,-1,113
1,<environment.Job instance at 0x7f653a248370>,52,1,[ 4 11],53,-1,118,-1,117
1,<environment.Job instance at 0x7f653a30cc30>,64,3,[ 1 12],65,-1,161,-1,158
1,<environment.Job instance at 0x7f653117d0f0>,70,25,[6 2],71,-1,213,-1,188
1,<environment.Job instance at 0x7f653117d2d0>,72,3,[14  1],73,-1,191,-1,188
1,<environment.Job instance at 0x7f653117d640>,73,1,[ 4 12],74,-1,189,-1,188
1,<environment.Job instance at 0x7f653117d320>,81,18,[14  2],82,-1,213,-1,195
1,<environment.Job instance at 0x7f6530393730>,85,15,[12  5],86,-1,226,-1,211
1,<environment.Job instance at 0x7f653058a500>,87,27,[4 8],88,-1,254,-1,227
1,<environment.Job instance at 0x7f6530dcbd70>,88,20,[ 4 13],89,-1,247,-1,227
1,<environment.Job instance at 0x7f653034a050>,113,18,[ 5 13],114,-1,322,-1,304
1,<environment.Job instance at 0x7f65317b2a50>,4,16,[1 6],5,-1,21,-1,5
1,<environment.Job instance at 0x7f6530994b40>,5,16,[10  1],6,-1,29,-1,13
1,<environment.Job instance at 0x7f6530994140>,7,14,[ 3 12],8,-1,28,-1,14
1,<environment.Job instance at 0x7f6530994c30>,13,15,[8 2],14,-1,29,-1,14
1,<environment.Job instance at 0x7f65305a5690>,15,23,[7 3],16,-1,39,-1,16
1,<environment.Job instance at 0x7f653a099dc0>,17,20,[8 3],18,-1,38,-1,18
1,<environment.Job instance at 0x7f65307a6230>,19,22,[9 1],20,-1,42,-1,20
1,<environment.Job instance at 0x7f6531757050>,21,16,[1 7],22,-1,38,-1,22
1,<environment.Job instance at 0x7f65307a66e0>,22,18,[ 3 13],23,-1,41,-1,23
1,<environment.Job instance at 0x7f6531724eb0>,24,12,[ 1 10],25,-1,37,-1,25
1,<environment.Job instance at 0x7f6530266b90>,26,12,[1 9],27,-1,39,-1,27
1,<environment.Job instance at 0x7f6530f6aaf0>,28,18,[5 9],29,-1,47,-1,29
1,<environment.Job instance at 0x7f6530bf0870>,29,16,[8 4],30,-1,46,-1,30
1,<environment.Job instance at 0x7f65307a7c80>,32,16,[4 7],33,-1,49,-1,33
1,<environment.Job instance at 0x7f65317125f0>,33,16,[5 9],34,-1,50,-1,34
1,<environment.Job instance at 0x7f65317b2550>,6,21,[10  4],7,-1,55,-1,34
1,<environment.Job instance at 0x7f653067c9b0>,34,16,[3 5],35,-1,52,-1,36
1,<environment.Job instance at 0x7f652fec1cd0>,36,12,[1 5],37,-1,49,-1,37
1,<environment.Job instance at 0x7f653049d9b0>,41,12,[7 5],42,-1,55,-1,43
1,<environment.Job instance at 0x7f65315fb050>,43,12,[8 2],44,-1,56,-1,44
1,<environment.Job instance at 0x7f653168b190>,42,26,[9 3],43,-1,71,-1,45
1,<environment.Job instance at 0x7f653056ee10>,47,13,[9 2],48,-1,61,-1,48
1,<environment.Job instance at 0x7f6531544280>,52,12,[9 4],53,-1,65,-1,53
1,<environment.Job instance at 0x7f6531544140>,53,14,[5 9],54,-1,68,-1,54
1,<environment.Job instance at 0x7f65315441e0>,55,18,[6 4],56,-1,74,-1,56
1,<environment.Job instance at 0x7f65307a8f00>,56,15,[ 1 11],57,-1,72,-1,57
1,<environment.Job instance at 0x7f6531263730>,57,22,[6 4],58,-1,80,-1,58
1,<environment.Job instance at 0x7f653056e230>,45,15,[8 3],46,-1,73,-1,58
1,<environment.Job instance at 0x7f6530aac370>,61,12,[4 6],62,-1,74,-1,62
1,<environment.Job instance at 0x7f6530aac730>,64,17,[9 5],65,-1,83,-1,66
1,<environment.Job instance at 0x7f6530994190>,8,14,[5 5],9,-1,87,-1,73
1,<environment.Job instance at 0x7f6530aac500>,60,15,[4 9],61,-1,88,-1,73
1,<environment.Job instance at 0x7f6530aacb90>,66,12,[9 2],67,-1,85,-1,73
1,<environment.Job instance at 0x7f6531193d70>,73,12,[ 4 10],74,-1,86,-1,74
1,<environment.Job instance at 0x7f653161e2d0>,74,18,[ 2 10],75,-1,111,-1,93
1,<environment.Job instance at 0x7f6531193960>,68,12,[14  5],69,-1,105,-1,93
1,<environment.Job instance at 0x7f65311939b0>,67,18,[3 7],68,-1,111,-1,93
1,<environment.Job instance at 0x7f65305b02d0>,78,23,[1 5],79,-1,117,-1,94
1,<environment.Job instance at 0x7f6531616b40>,81,17,[8 4],82,-1,114,-1,97
1,<environment.Job instance at 0x7f6531616eb0>,82,15,[1 9],83,-1,112,-1,97
1,<environment.Job instance at 0x7f65316167d0>,83,18,[10  4],84,-1,115,-1,97
1,<environment.Job instance at 0x7f65316162d0>,84,14,[ 4 10],85,-1,111,-1,97
1,<environment.Job instance at 0x7f6531193230>,71,17,[7 1],72,-1,114,-1,97
1,<environment.Job instance at 0x7f653002cb90>,85,12,[1 8],86,-1,109,-1,97
1,<environment.Job instance at 0x7f6530e92410>,90,16,[10  2],91,-1,118,-1,102
1,<environment.Job instance at 0x7f6530e92b40>,91,16,[ 2 10],92,-1,120,-1,104
1,<environment.Job instance at 0x7f652fddf4b0>,89,13,[6 5],90,-1,117,-1,104
1,<environment.Job instance at 0x7f65306794b0>,79,2,[12  2],80,-1,106,-1,104
1,<environment.Job instance at 0x7f6531087e10>,93,16,[1 9],94,-1,120,-1,104
1,<environment.Job instance at 0x7f65304ed050>,96,17,[13  4],97,-1,121,-1,104
1,<environment.Job instance at 0x7f65311cbd20>,95,15,[2 8],96,-1,119,-1,104
1,<environment.Job instance at 0x7f653154baf0>,99,17,[ 1 11],100,-1,121,-1,104
1,<environment.Job instance at 0x7f652fdcb7d0>,87,20,[5 3],88,-1,124,-1,104
1,<environment.Job instance at 0x7f653161ea50>,75,19,[10  1],76,-1,123,-1,104
1,<environment.Job instance at 0x7f6530cc0410>,100,17,[1 7],101,-1,133,-1,116
1,<environment.Job instance at 0x7f6530c213c0>,105,16,[2 9],106,-1,143,-1,127
1,<environment.Job instance at 0x7f6530cc0140>,101,13,[8 2],102,-1,140,-1,127
1,<environment.Job instance at 0x7f65316c90a0>,115,17,[14  3],116,-1,144,-1,127
1,<environment.Job instance at 0x7f65316c9fa0>,116,12,[9 1],117,-1,139,-1,127
1,<environment.Job instance at 0x7f65316c9140>,110,1,[9 2],111,-1,128,-1,127
1,<environment.Job instance at 0x7f6530cc0370>,102,15,[6 2],103,-1,145,-1,130
1,<environment.Job instance at 0x7f65316c9870>,119,13,[9 4],120,-1,145,-1,132
1,<environment.Job instance at 0x7f65316c9a50>,117,24,[1 8],118,-1,156,-1,132
1,<environment.Job instance at 0x7f6530668500>,122,24,[7 2],123,-1,156,-1,132
1,<environment.Job instance at 0x7f65306680a0>,123,18,[1 7],124,-1,153,-1,135
1,<environment.Job instance at 0x7f6530668cd0>,124,27,[5 1],125,-1,162,-1,135
1,<environment.Job instance at 0x7f6530e82190>,126,13,[4 9],127,-1,151,-1,138
1,<environment.Job instance at 0x7f65316c9eb0>,118,12,[4 6],119,-1,152,-1,140
1,<environment.Job instance at 0x7f653061fbe0>,106,12,[7 4],107,-1,152,-1,140
1,<environment.Job instance at 0x7f653007dcd0>,129,12,[4 7],130,-1,152,-1,140
1,<environment.Job instance at 0x7f65316e6370>,134,14,[ 4 10],135,-1,154,-1,140
1,<environment.Job instance at 0x7f653021b2d0>,135,16,[6 5],136,-1,156,-1,140
1,<environment.Job instance at 0x7f653021baf0>,136,15,[1 6],137,-1,155,-1,140
1,<environment.Job instance at 0x7f653065e140>,131,18,[5 6],132,-1,158,-1,140
1,<environment.Job instance at 0x7f653021bf00>,137,18,[3 8],138,-1,161,-1,143
1,<environment.Job instance at 0x7f65315c3a00>,7,14,[ 3 12],8,-1,22,-1,8
1,<environment.Job instance at 0x7f6539ecd870>,15,23,[7 3],16,-1,48,-1,25
1,<environment.Job instance at 0x7f65316a1690>,22,18,[ 3 13],23,-1,46,-1,28
1,<environment.Job instance at 0x7f653080d780>,42,26,[9 3],43,-1,127,-1,101
1,<environment.Job instance at 0x7f653080daa0>,46,3,[12  4],47,-1,107,-1,104
1,<environment.Job instance at 0x7f653a1cc0a0>,56,15,[ 1 11],57,-1,151,-1,136
1,<environment.Job instance at 0x7f6531381aa0>,68,12,[14  5],69,-1,197,-1,185
1,<environment.Job instance at 0x7f653059db90>,78,23,[1 5],79,-1,255,-1,232
1,<environment.Job instance at 0x7f653059d960>,79,2,[12  2],80,-1,234,-1,232
1,<environment.Job instance at 0x7f6530f10870>,96,17,[13  4],97,-1,327,-1,310
1,<environment.Job instance at 0x7f65300b36e0>,99,17,[ 1 11],100,-1,331,-1,314
1,<environment.Job instance at 0x7f6530f62190>,104,17,[12  2],105,-1,346,-1,329
1,<environment.Job instance at 0x7f6539d2baf0>,112,1,[ 1 11],113,-1,360,-1,359
1,<environment.Job instance at 0x7f653079baf0>,114,12,[ 3 12],115,-1,371,-1,359
1,<environment.Job instance at 0x7f653079b050>,115,17,[14  3],116,-1,376,-1,359
1,<environment.Job instance at 0x7f653079bf50>,117,24,[1 8],118,-1,401,-1,377
1,<environment.Job instance at 0x7f652fe0dbe0>,122,24,[7 2],123,-1,410,-1,386
1,<environment.Job instance at 0x7f652fe0d730>,124,27,[5 1],125,-1,413,-1,386
1,<environment.Job instance at 0x7f652fe0de60>,125,1,[ 5 12],126,-1,387,-1,386
1,<environment.Job instance at 0x7f6531512c30>,128,3,[13  2],129,-1,399,-1,396
1,<environment.Job instance at 0x7f6539d89b40>,2,16,[3 7],3,-1,19,-1,3
1,<environment.Job instance at 0x7f6539d89870>,3,15,[9 4],4,-1,22,-1,7
1,<environment.Job instance at 0x7f6539d89d20>,7,18,[2 8],8,-1,26,-1,8
1,<environment.Job instance at 0x7f6539d89e10>,6,14,[7 3],7,-1,22,-1,8
1,<environment.Job instance at 0x7f6539d898c0>,12,16,[6 4],13,-1,29,-1,13
1,<environment.Job instance at 0x7f6539d89460>,13,12,[10  2],14,-1,28,-1,16
1,<environment.Job instance at 0x7f6539d89230>,16,18,[ 2 10],17,-1,35,-1,17
1,<environment.Job instance at 0x7f65306440f0>,19,3,[13  3],20,-1,23,-1,20
1,<environment.Job instance at 0x7f6539d89320>,15,27,[1 5],16,-1,47,-1,20
1,<environment.Job instance at 0x7f6530644cd0>,20,15,[8 4],21,-1,36,-1,21
1,<environment.Job instance at 0x7f6530644500>,21,18,[7 3],22,-1,40,-1,22
1,<environment.Job instance at 0x7f65306444b0>,22,17,[1 7],23,-1,40,-1,23
1,<environment.Job instance at 0x7f65306448c0>,26,1,[10  1],27,-1,29,-1,28
1,<environment.Job instance at 0x7f65306443c0>,28,12,[10  1],29,-1,41,-1,29
1,<environment.Job instance at 0x7f6530644960>,29,12,[4 6],30,-1,42,-1,30
1,<environment.Job instance at 0x7f6530644370>,30,17,[5 2],31,-1,48,-1,31
1,<environment.Job instance at 0x7f6530644910>,31,21,[8 4],32,-1,53,-1,32
1,<environment.Job instance at 0x7f6530644820>,32,16,[1 7],33,-1,49,-1,33
1,<environment.Job instance at 0x7f6530644d20>,27,15,[ 3 10],28,-1,48,-1,33
1,<environment.Job instance at 0x7f652ffdfb40>,35,18,[4 5],36,-1,54,-1,36
1,<environment.Job instance at 0x7f652ffd8320>,37,18,[2 7],38,-1,56,-1,38
1,<environment.Job instance at 0x7f652ffff640>,44,20,[8 2],45,-1,65,-1,45
1,<environment.Job instance at 0x7f652ffff730>,45,14,[4 9],46,-1,60,-1,46
1,<environment.Job instance at 0x7f65300975a0>,50,21,[10  5],51,-1,72,-1,51
1,<environment.Job instance at 0x7f65300e53c0>,53,19,[7 1],54,-1,73,-1,54
1,<environment.Job instance at 0x7f652feca6e0>,62,16,[9 2],63,-1,79,-1,63
1,<environment.Job instance at 0x7f653118a640>,69,2,[9 5],70,-1,72,-1,70
1,<environment.Job instance at 0x7f653118a910>,70,3,[8 2],71,-1,74,-1,71
1,<environment.Job instance at 0x7f653118aaa0>,71,15,[9 3],72,-1,87,-1,72
1,<environment.Job instance at 0x7f653118a370>,72,17,[4 9],73,-1,90,-1,73
1,<environment.Job instance at 0x7f653118a410>,73,1,[5 5],74,-1,75,-1,74
1,<environment.Job instance at 0x7f653118a5f0>,74,24,[7 3],75,-1,99,-1,75
1,<environment.Job instance at 0x7f653118ae10>,75,13,[7 2],76,-1,89,-1,76
1,<environment.Job instance at 0x7f653118a1e0>,76,21,[5 3],77,-1,98,-1,77
1,<environment.Job instance at 0x7f652feb4730>,77,22,[1 9],78,-1,100,-1,78
1,<environment.Job instance at 0x7f652feb4f00>,78,16,[1 7],79,-1,95,-1,79
1,<environment.Job instance at 0x7f652feb41e0>,80,12,[10  5],81,-1,94,-1,82
1,<environment.Job instance at 0x7f652feb4cd0>,81,16,[10  1],82,-1,98,-1,82
1,<environment.Job instance at 0x7f6530e64a00>,83,17,[8 3],84,-1,101,-1,84
1,<environment.Job instance at 0x7f652ff45f00>,92,24,[5 7],93,-1,117,-1,93
1,<environment.Job instance at 0x7f65309caf50>,96,15,[ 1 10],97,-1,115,-1,100
1,<environment.Job instance at 0x7f6530739c80>,102,18,[ 3 10],103,-1,121,-1,103
1,<environment.Job instance at 0x7f6530739780>,103,16,[8 1],104,-1,121,-1,105
1,<environment.Job instance at 0x7f6530739c30>,104,18,[ 3 10],105,-1,124,-1,106
1,<environment.Job instance at 0x7f65311cb0a0>,109,15,[4 9],110,-1,126,-1,111
1,<environment.Job instance at 0x7f653030e910>,117,17,[5 6],118,-1,140,-1,123
1,<environment.Job instance at 0x7f65301dde60>,122,15,[8 3],123,-1,138,-1,123
1,<environment.Job instance at 0x7f65300a1eb0>,128,14,[2 8],129,-1,147,-1,133
1,<environment.Job instance at 0x7f65311c2fa0>,130,18,[5 6],131,-1,157,-1,139
1,<environment.Job instance at 0x7f65301c9910>,133,13,[10  5],134,-1,163,-1,150
1,<environment.Job instance at 0x7f65301c9140>,135,15,[10  4],136,-1,165,-1,150
1,<environment.Job instance at 0x7f65301c9e10>,136,26,[5 7],137,-1,177,-1,151
1,<environment.Job instance at 0x7f6539d89780>,0,3,[13  5],1,-1,4,-1,1
1,<environment.Job instance at 0x7f6530e64140>,5,3,[14  3],6,-1,9,-1,6
1,<environment.Job instance at 0x7f6530b1ccd0>,15,27,[1 5],16,-1,66,-1,39
1,<environment.Job instance at 0x7f65308128c0>,19,3,[13  3],20,-1,44,-1,41
1,<environment.Job instance at 0x7f653a313050>,55,1,[ 3 11],56,-1,157,-1,156
1,<environment.Job instance at 0x7f6531747f00>,66,23,[ 1 13],67,-1,201,-1,178
1,<environment.Job instance at 0x7f65305686e0>,67,2,[ 2 11],68,-1,180,-1,178
1,<environment.Job instance at 0x7f6530a02c30>,74,24,[7 3],75,-1,223,-1,199
1,<environment.Job instance at 0x7f653a30b780>,84,19,[ 5 12],85,-1,258,-1,239
1,<environment.Job instance at 0x7f653a30b2d0>,85,27,[2 8],86,-1,278,-1,251
1,<environment.Job instance at 0x7f6530c3c8c0>,89,1,[ 4 13],90,-1,254,-1,253
1,<environment.Job instance at 0x7f65303265a0>,92,24,[5 7],93,-1,283,-1,259
1,<environment.Job instance at 0x7f653012d3c0>,99,23,[6 1],100,-1,303,-1,280
1,<environment.Job instance at 0x7f652ffcbe60>,100,1,[11  4],101,-1,281,-1,280
1,<environment.Job instance at 0x7f65312600f0>,106,23,[ 2 10],107,-1,320,-1,297
1,<environment.Job instance at 0x7f6530a809b0>,110,15,[ 1 11],111,-1,316,-1,301
1,<environment.Job instance at 0x7f6530a805a0>,111,2,[11  4],112,-1,303,-1,301
1,<environment.Job instance at 0x7f6530a800f0>,112,3,[14  5],113,-1,304,-1,301
1,<environment.Job instance at 0x7f6530dd35a0>,136,26,[5 7],137,-1,458,-1,432
1,<environment.Job instance at 0x7f653097c640>,8,12,[5 3],9,-1,22,-1,10
1,<environment.Job instance at 0x7f6530884730>,9,20,[3 9],10,-1,41,-1,21
1,<environment.Job instance at 0x7f6530c35370>,13,14,[5 4],14,-1,37,-1,23
1,<environment.Job instance at 0x7f653097c050>,11,23,[8 4],12,-1,47,-1,24
1,<environment.Job instance at 0x7f653097c230>,10,16,[4 9],11,-1,42,-1,26
1,<environment.Job instance at 0x7f653179a280>,21,17,[7 4],22,-1,43,-1,26
1,<environment.Job instance at 0x7f65305b0550>,23,16,[1 9],24,-1,42,-1,26
1,<environment.Job instance at 0x7f653079bb90>,27,15,[10  5],28,-1,45,-1,30
1,<environment.Job instance at 0x7f653056eb40>,30,17,[8 2],31,-1,48,-1,31
1,<environment.Job instance at 0x7f6531193be0>,29,18,[5 2],30,-1,51,-1,33
1,<environment.Job instance at 0x7f6531397370>,35,14,[9 4],36,-1,52,-1,38
1,<environment.Job instance at 0x7f65305b0230>,25,27,[6 2],26,-1,70,-1,43
1,<environment.Job instance at 0x7f6530aacdc0>,39,12,[9 5],40,-1,57,-1,45
1,<environment.Job instance at 0x7f6530aace60>,38,18,[5 3],39,-1,65,-1,47
1,<environment.Job instance at 0x7f6530aac0a0>,41,18,[1 7],42,-1,66,-1,48
1,<environment.Job instance at 0x7f6530aac410>,42,3,[1 9],43,-1,52,-1,49
1,<environment.Job instance at 0x7f65315448c0>,48,2,[2 7],49,-1,51,-1,49
1,<environment.Job instance at 0x7f6530aac6e0>,40,12,[5 7],41,-1,61,-1,49
1,<environment.Job instance at 0x7f65309bb9b0>,36,12,[7 2],37,-1,61,-1,49
1,<environment.Job instance at 0x7f653069a960>,52,13,[5 8],53,-1,67,-1,54
1,<environment.Job instance at 0x7f6530665f00>,54,18,[7 1],55,-1,73,-1,55
1,<environment.Job instance at 0x7f6530ca93c0>,56,14,[ 5 11],57,-1,74,-1,60
1,<environment.Job instance at 0x7f653096ddc0>,60,12,[9 3],61,-1,73,-1,61
1,<environment.Job instance at 0x7f653096d460>,61,1,[ 5 10],62,-1,63,-1,62
1,<environment.Job instance at 0x7f653096d0a0>,62,12,[11  2],63,-1,75,-1,63
1,<environment.Job instance at 0x7f653096d8c0>,63,3,[4 6],64,-1,67,-1,64
1,<environment.Job instance at 0x7f653096d190>,66,13,[7 3],67,-1,119,-1,106
1,<environment.Job instance at 0x7f653096d370>,67,1,[10  4],68,-1,108,-1,107
1,<environment.Job instance at 0x7f653096dc80>,64,18,[ 4 10],65,-1,163,-1,145
1,<environment.Job instance at 0x7f653096d960>,59,22,[14  5],60,-1,168,-1,146
1,<environment.Job instance at 0x7f653096d230>,65,12,[10  4],66,-1,160,-1,148
1,<environment.Job instance at 0x7f653096df50>,70,18,[1 7],71,-1,166,-1,148
1,<environment.Job instance at 0x7f65302b6b90>,77,25,[6 5],78,-1,174,-1,149
1,<environment.Job instance at 0x7f65312d3820>,71,21,[5 8],72,-1,170,-1,149
1,<environment.Job instance at 0x7f65302b6190>,74,18,[3 8],75,-1,167,-1,149
1,<environment.Job instance at 0x7f65302b6370>,80,16,[8 3],81,-1,167,-1,151
1,<environment.Job instance at 0x7f65302b6dc0>,88,25,[5 7],89,-1,179,-1,154
1,<environment.Job instance at 0x7f65302b6f00>,84,15,[10  3],85,-1,173,-1,158
1,<environment.Job instance at 0x7f653096d3c0>,68,22,[10  4],69,-1,180,-1,158
1,<environment.Job instance at 0x7f65302b6a00>,97,16,[6 3],98,-1,175,-1,159
1,<environment.Job instance at 0x7f65315119b0>,101,14,[8 5],102,-1,173,-1,159
1,<environment.Job instance at 0x7f6531511190>,102,18,[5 8],103,-1,177,-1,159
1,<environment.Job instance at 0x7f6531511280>,107,28,[6 3],108,-1,202,-1,174
1,<environment.Job instance at 0x7f653080d8c0>,111,19,[3 6],112,-1,194,-1,175
1,<environment.Job instance at 0x7f653080df50>,110,18,[5 5],111,-1,193,-1,175
1,<environment.Job instance at 0x7f6531511c80>,105,26,[14  3],106,-1,202,-1,176
1,<environment.Job instance at 0x7f653080dc30>,113,13,[1 7],114,-1,189,-1,176
1,<environment.Job instance at 0x7f6531511230>,100,14,[7 5],101,-1,191,-1,177
1,<environment.Job instance at 0x7f6530beb910>,121,19,[3 9],122,-1,200,-1,181
1,<environment.Job instance at 0x7f6530bebeb0>,125,17,[10  2],126,-1,212,-1,195
1,<environment.Job instance at 0x7f6530bebd70>,128,13,[5 5],129,-1,219,-1,206
1,<environment.Job instance at 0x7f6530bebfa0>,132,25,[2 8],133,-1,233,-1,208
1,<environment.Job instance at 0x7f6530beb230>,126,17,[4 9],127,-1,227,-1,210
1,<environment.Job instance at 0x7f6530c08f00>,136,13,[5 7],137,-1,223,-1,210
1,<environment.Job instance at 0x7f653080d320>,114,18,[1 9],115,-1,230,-1,212
1,<environment.Job instance at 0x7f6530beb0f0>,135,16,[6 1],136,-1,228,-1,212
1,<environment.Job instance at 0x7f65303d5640>,6,3,[ 4 11],7,-1,10,-1,7
1,<environment.Job instance at 0x7f6531405a50>,11,23,[8 4],12,-1,40,-1,17
1,<environment.Job instance at 0x7f6530b7d190>,14,3,[11  3],15,-1,20,-1,17
1,<environment.Job instance at 0x7f6531544d20>,16,2,[ 2 12],17,-1,21,-1,19
1,<environment.Job instance at 0x7f6530655e10>,25,27,[6 2],26,-1,75,-1,48
1,<environment.Job instance at 0x7f6530655a00>,28,3,[ 3 12],29,-1,54,-1,51
1,<environment.Job instance at 0x7f6530a80af0>,45,1,[ 4 14],46,-1,126,-1,125
1,<environment.Job instance at 0x7f653a30b3c0>,56,14,[ 5 11],57,-1,156,-1,142
1,<environment.Job instance at 0x7f6530b2f690>,59,22,[14  5],60,-1,176,-1,154
1,<environment.Job instance at 0x7f653a30b690>,62,12,[11  2],63,-1,172,-1,160
1,<environment.Job instance at 0x7f65311c69b0>,77,25,[6 5],78,-1,220,-1,195
1,<environment.Job instance at 0x7f653a243f00>,88,25,[5 7],89,-1,252,-1,227
1,<environment.Job instance at 0x7f6539d4ff00>,89,13,[ 3 12],90,-1,240,-1,227
1,<environment.Job instance at 0x7f6530b1c050>,98,3,[12  5],99,-1,244,-1,241
1,<environment.Job instance at 0x7f6530e64140>,105,26,[14  3],106,-1,299,-1,273
1,<environment.Job instance at 0x7f6530e7a0f0>,107,28,[6 3],108,-1,315,-1,287
1,<environment.Job instance at 0x7f653067cf00>,116,2,[14  2],117,-1,305,-1,303
1,<environment.Job instance at 0x7f653067c410>,117,3,[13  2],118,-1,306,-1,303
1,<environment.Job instance at 0x7f653067c640>,129,18,[13  1],130,-1,364,-1,346
1,<environment.Job instance at 0x7f6530bfc320>,132,25,[2 8],133,-1,388,-1,363
1,<environment.Job instance at 0x7f6530bfc870>,134,15,[ 3 14],135,-1,378,-1,363
1,<environment.Job instance at 0x7f6530badb40>,3,16,[10  1],4,-1,21,-1,5
1,<environment.Job instance at 0x7f652fff3dc0>,4,17,[4 8],5,-1,22,-1,5
1,<environment.Job instance at 0x7f65313610f0>,7,14,[9 1],8,-1,23,-1,9
1,<environment.Job instance at 0x7f65313345f0>,14,19,[6 5],15,-1,34,-1,15
1,<environment.Job instance at 0x7f6531334690>,15,18,[4 5],16,-1,34,-1,16
1,<environment.Job instance at 0x7f653133daa0>,20,20,[7 1],21,-1,41,-1,21
1,<environment.Job instance at 0x7f6530afecd0>,29,16,[1 8],30,-1,46,-1,30
1,<environment.Job instance at 0x7f6531361e60>,8,14,[4 7],9,-1,44,-1,30
1,<environment.Job instance at 0x7f6530696af0>,31,17,[ 3 10],32,-1,50,-1,33
1,<environment.Job instance at 0x7f6530696820>,34,17,[4 5],35,-1,52,-1,35
1,<environment.Job instance at 0x7f653009b5a0>,43,16,[5 5],44,-1,60,-1,44
1,<environment.Job instance at 0x7f65316cb6e0>,44,18,[7 5],45,-1,63,-1,45
1,<environment.Job instance at 0x7f65316f9a00>,56,15,[9 4],57,-1,176,-1,161
1,<environment.Job instance at 0x7f653009b690>,45,26,[ 4 10],46,-1,196,-1,170
1,<environment.Job instance at 0x7f653008a3c0>,68,19,[5 8],69,-1,213,-1,194
1,<environment.Job instance at 0x7f653008a320>,72,18,[10  4],73,-1,226,-1,208
1,<environment.Job instance at 0x7f653008abe0>,73,16,[1 8],74,-1,225,-1,209
1,<environment.Job instance at 0x7f653008ab40>,74,17,[6 4],75,-1,237,-1,220
1,<environment.Job instance at 0x7f6530e5fd70>,86,18,[5 7],87,-1,275,-1,257
1,<environment.Job instance at 0x7f653008b190>,90,19,[3 8],91,-1,292,-1,273
1,<environment.Job instance at 0x7f653008ba00>,94,16,[4 6],95,-1,289,-1,273
1,<environment.Job instance at 0x7f653008b5a0>,97,27,[3 7],98,-1,313,-1,286
1,<environment.Job instance at 0x7f65300b5050>,98,13,[9 1],99,-1,299,-1,286
1,<environment.Job instance at 0x7f6530696370>,0,12,[ 3 11],1,-1,13,-1,1
1,<environment.Job instance at 0x7f65310d0050>,1,28,[1 5],2,-1,30,-1,2
1,<environment.Job instance at 0x7f6530560050>,10,27,[3 8],11,-1,49,-1,22
1,<environment.Job instance at 0x7f65305604b0>,11,16,[ 3 14],12,-1,38,-1,22
1,<environment.Job instance at 0x7f6530655410>,21,1,[12  2],22,-1,40,-1,39
1,<environment.Job instance at 0x7f652ffcd5f0>,40,23,[ 1 12],41,-1,115,-1,92
1,<environment.Job instance at 0x7f65300066e0>,42,28,[1 7],43,-1,128,-1,100
1,<environment.Job instance at 0x7f652ffdd640>,45,26,[ 4 10],46,-1,140,-1,114
1,<environment.Job instance at 0x7f653045e4b0>,49,22,[12  5],50,-1,136,-1,114
1,<environment.Job instance at 0x7f6530480c30>,54,27,[3 7],55,-1,156,-1,129
1,<environment.Job instance at 0x7f65311ff8c0>,87,28,[8 3],88,-1,290,-1,262
1,<environment.Job instance at 0x7f6539d7cdc0>,92,22,[13  5],93,-1,297,-1,275
1,<environment.Job instance at 0x7f65311ee730>,93,28,[10  5],94,-1,308,-1,280
1,<environment.Job instance at 0x7f6530ed1f00>,97,27,[3 7],98,-1,322,-1,295
1,<environment.Job instance at 0x7f65317323c0>,106,27,[13  1],107,-1,349,-1,322
1,<environment.Job instance at 0x7f653011e460>,115,25,[2 7],116,-1,374,-1,349
1,<environment.Job instance at 0x7f652ffd5cd0>,117,17,[ 5 14],118,-1,366,-1,349
1,<environment.Job instance at 0x7f653128d2d0>,1,26,[6 3],2,-1,28,-1,2
1,<environment.Job instance at 0x7f653128d140>,3,17,[10  5],4,-1,21,-1,4
1,<environment.Job instance at 0x7f65306980f0>,6,17,[10  5],7,-1,24,-1,7
1,<environment.Job instance at 0x7f6530698af0>,12,17,[4 9],13,-1,30,-1,13
1,<environment.Job instance at 0x7f65306985a0>,15,27,[8 5],16,-1,43,-1,16
1,<environment.Job instance at 0x7f65306984b0>,16,22,[9 5],17,-1,40,-1,18
1,<environment.Job instance at 0x7f6530698960>,17,17,[5 5],18,-1,35,-1,18
1,<environment.Job instance at 0x7f65306c0230>,21,14,[10  4],22,-1,38,-1,24
1,<environment.Job instance at 0x7f653009bcd0>,42,17,[4 7],43,-1,108,-1,91
1,<environment.Job instance at 0x7f653009bc30>,41,15,[ 3 13],42,-1,109,-1,94
1,<environment.Job instance at 0x7f653009b500>,45,3,[3 8],46,-1,98,-1,95
1,<environment.Job instance at 0x7f65306c00a0>,23,13,[6 4],24,-1,108,-1,95
1,<environment.Job instance at 0x7f65310dbe10>,49,17,[7 1],50,-1,118,-1,101
1,<environment.Job instance at 0x7f653009b460>,46,26,[ 4 10],47,-1,134,-1,108
1,<environment.Job instance at 0x7f65310db550>,55,13,[13  4],56,-1,124,-1,111
1,<environment.Job instance at 0x7f65310dbaf0>,56,25,[ 3 12],57,-1,138,-1,113
1,<environment.Job instance at 0x7f65310dbe60>,57,17,[7 2],58,-1,130,-1,113
1,<environment.Job instance at 0x7f65310dbd20>,59,1,[8 5],60,-1,114,-1,113
1,<environment.Job instance at 0x7f65310dbeb0>,53,13,[2 7],54,-1,126,-1,113
1,<environment.Job instance at 0x7f65306acb90>,64,25,[7 4],65,-1,138,-1,113
1,<environment.Job instance at 0x7f65306ac3c0>,65,22,[9 2],66,-1,136,-1,114
1,<environment.Job instance at 0x7f65306ac690>,66,28,[6 2],67,-1,142,-1,114
1,<environment.Job instance at 0x7f65306ac820>,68,19,[2 5],69,-1,133,-1,114
1,<environment.Job instance at 0x7f65306ace60>,71,21,[7 2],72,-1,139,-1,118
1,<environment.Job instance at 0x7f65306ac6e0>,73,22,[10  1],74,-1,140,-1,118
1,<environment.Job instance at 0x7f65306ac280>,75,14,[7 2],76,-1,132,-1,118
1,<environment.Job instance at 0x7f65306ac5a0>,76,18,[10  3],77,-1,136,-1,118
1,<environment.Job instance at 0x7f653009bbe0>,47,12,[3 5],48,-1,133,-1,121
1,<environment.Job instance at 0x7f65306ac730>,77,16,[3 9],78,-1,137,-1,121
1,<environment.Job instance at 0x7f65310d7780>,82,17,[1 9],83,-1,139,-1,122
1,<environment.Job instance at 0x7f65300bc140>,1,26,[6 3],2,-1,28,-1,2
1,<environment.Job instance at 0x7f6530cca780>,7,1,[ 5 12],8,-1,9,-1,8
1,<environment.Job instance at 0x7f6530e7ab40>,9,3,[12  2],10,-1,17,-1,14
1,<environment.Job instance at 0x7f65301ec6e0>,11,3,[11  1],12,-1,18,-1,15
1,<environment.Job instance at 0x7f6530293500>,15,27,[8 5],16,-1,46,-1,19
1,<environment.Job instance at 0x7f65316d5dc0>,18,24,[7 4],19,-1,43,-1,19
1,<environment.Job instance at 0x7f652ff9a140>,27,13,[ 2 13],28,-1,63,-1,50
1,<environment.Job instance at 0x7f65300e5fa0>,28,17,[ 1 13],29,-1,67,-1,50
1,<environment.Job instance at 0x7f65300d2e60>,29,2,[12  1],30,-1,52,-1,50
1,<environment.Job instance at 0x7f65300d2690>,31,24,[ 3 14],32,-1,76,-1,52
1,<environment.Job instance at 0x7f6530cd3f00>,38,13,[14  1],39,-1,69,-1,56
1,<environment.Job instance at 0x7f6530554460>,41,15,[ 3 13],42,-1,74,-1,59
1,<environment.Job instance at 0x7f653138ad20>,46,26,[ 4 10],47,-1,124,-1,98
1,<environment.Job instance at 0x7f6530958500>,51,3,[ 2 12],52,-1,104,-1,101
1,<environment.Job instance at 0x7f653055ca50>,55,13,[13  4],56,-1,127,-1,114
1,<environment.Job instance at 0x7f653055c8c0>,56,25,[ 3 12],57,-1,139,-1,114
1,<environment.Job instance at 0x7f6539d5cc80>,64,25,[7 4],65,-1,158,-1,133
1,<environment.Job instance at 0x7f6530608b40>,66,28,[6 2],67,-1,164,-1,136
1,<environment.Job instance at 0x7f6531533aa0>,70,1,[ 2 11],71,-1,139,-1,138
1,<environment.Job instance at 0x7f65315335f0>,72,14,[ 4 14],73,-1,153,-1,139
1,<environment.Job instance at 0x7f65309d5cd0>,80,18,[ 2 13],81,-1,191,-1,173
1,<environment.Job instance at 0x7f653171cb90>,87,3,[12  2],88,-1,198,-1,195
1,<environment.Job instance at 0x7f65317b2140>,92,26,[5 7],93,-1,259,-1,233
1,<environment.Job instance at 0x7f65317b2e10>,94,28,[9 1],95,-1,261,-1,233
1,<environment.Job instance at 0x7f653083d690>,98,28,[5 2],99,-1,280,-1,252
1,<environment.Job instance at 0x7f65315280a0>,103,3,[11  4],104,-1,259,-1,256
1,<environment.Job instance at 0x7f6530e8f140>,110,2,[ 5 14],111,-1,304,-1,302
1,<environment.Job instance at 0x7f6530e88b90>,119,28,[10  4],120,-1,380,-1,352
1,<environment.Job instance at 0x7f652ff98910>,125,3,[11  1],126,-1,359,-1,356
1,<environment.Job instance at 0x7f6531647d70>,130,1,[ 1 14],131,-1,386,-1,385
1,<environment.Job instance at 0x7f6530e9f140>,138,28,[2 8],139,-1,446,-1,418
1,<environment.Job instance at 0x7f65305636e0>,1,17,[5 5],2,-1,19,-1,2
1,<environment.Job instance at 0x7f65302fe4b0>,4,17,[1 5],5,-1,22,-1,5
1,<environment.Job instance at 0x7f65302febe0>,8,16,[5 9],9,-1,25,-1,9
1,<environment.Job instance at 0x7f65302feaf0>,9,14,[8 1],10,-1,25,-1,11
1,<environment.Job instance at 0x7f65302fe320>,15,2,[5 1],16,-1,18,-1,16
1,<environment.Job instance at 0x7f65302fe140>,17,2,[10  1],18,-1,20,-1,18
1,<environment.Job instance at 0x7f65316b6dc0>,18,14,[8 5],19,-1,33,-1,19
1,<environment.Job instance at 0x7f65316b65f0>,20,24,[7 2],21,-1,45,-1,21
1,<environment.Job instance at 0x7f65316b6870>,22,25,[7 5],23,-1,48,-1,23
1,<environment.Job instance at 0x7f65316b65a0>,23,17,[2 5],24,-1,41,-1,24
1,<environment.Job instance at 0x7f65316b6a50>,24,17,[2 6],25,-1,42,-1,25
1,<environment.Job instance at 0x7f65316b6780>,25,14,[3 5],26,-1,40,-1,26
1,<environment.Job instance at 0x7f65316b66e0>,27,16,[ 2 10],28,-1,44,-1,28
1,<environment.Job instance at 0x7f653142ceb0>,29,14,[3 9],30,-1,44,-1,30
1,<environment.Job instance at 0x7f6539cce960>,30,15,[ 3 10],31,-1,46,-1,31
1,<environment.Job instance at 0x7f6539cce500>,31,12,[10  5],32,-1,44,-1,32
1,<environment.Job instance at 0x7f6531298e10>,32,16,[5 8],33,-1,49,-1,33
1,<environment.Job instance at 0x7f6531298eb0>,34,18,[2 9],35,-1,53,-1,35
1,<environment.Job instance at 0x7f65313f8c80>,36,17,[4 9],37,-1,54,-1,37
1,<environment.Job instance at 0x7f653055f1e0>,37,18,[3 7],38,-1,56,-1,38
1,<environment.Job instance at 0x7f6539f01050>,40,13,[9 4],41,-1,54,-1,41
1,<environment.Job instance at 0x7f65316b81e0>,42,24,[2 9],43,-1,67,-1,43
1,<environment.Job instance at 0x7f65316b8d70>,44,15,[ 5 10],45,-1,60,-1,45
1,<environment.Job instance at 0x7f65316b8820>,47,16,[5 7],48,-1,64,-1,48
1,<environment.Job instance at 0x7f65316b84b0>,49,18,[1 9],50,-1,68,-1,50
1,<environment.Job instance at 0x7f65316b82d0>,50,16,[9 3],51,-1,67,-1,51
1,<environment.Job instance at 0x7f65316b8190>,52,17,[8 1],53,-1,72,-1,55
1,<environment.Job instance at 0x7f6530de5140>,56,15,[5 5],57,-1,72,-1,57
1,<environment.Job instance at 0x7f6530de5b90>,57,16,[5 9],58,-1,74,-1,58
1,<environment.Job instance at 0x7f6530de5050>,58,16,[7 3],59,-1,75,-1,59
1,<environment.Job instance at 0x7f6530de5af0>,59,20,[5 3],60,-1,80,-1,60
1,<environment.Job instance at 0x7f65314a3be0>,61,17,[4 6],62,-1,79,-1,62
1,<environment.Job instance at 0x7f6539d730a0>,64,14,[10  2],65,-1,79,-1,65
1,<environment.Job instance at 0x7f6539d73be0>,65,23,[1 8],66,-1,89,-1,66
1,<environment.Job instance at 0x7f65312b4230>,74,18,[2 6],75,-1,93,-1,75
1,<environment.Job instance at 0x7f6539d3a460>,75,18,[4 6],76,-1,94,-1,76
1,<environment.Job instance at 0x7f6539d3a4b0>,77,18,[3 5],78,-1,96,-1,78
1,<environment.Job instance at 0x7f6539d3ad70>,78,19,[3 9],79,-1,98,-1,79
1,<environment.Job instance at 0x7f6539ce83c0>,81,18,[1 8],82,-1,100,-1,82
1,<environment.Job instance at 0x7f6539ce8190>,83,17,[6 4],84,-1,101,-1,84
1,<environment.Job instance at 0x7f6539ce8d70>,84,26,[8 5],85,-1,111,-1,85
1,<environment.Job instance at 0x7f65315820a0>,87,17,[4 8],88,-1,105,-1,88
1,<environment.Job instance at 0x7f6531046960>,90,22,[6 2],91,-1,113,-1,91
1,<environment.Job instance at 0x7f6531046370>,91,13,[ 5 10],92,-1,105,-1,92
1,<environment.Job instance at 0x7f6531046410>,93,24,[3 7],94,-1,118,-1,94
1,<environment.Job instance at 0x7f6531046eb0>,95,18,[7 3],96,-1,122,-1,104
1,<environment.Job instance at 0x7f6531046870>,94,16,[10  1],95,-1,120,-1,104
1,<environment.Job instance at 0x7f6530a99f50>,108,18,[5 8],109,-1,127,-1,109
1,<environment.Job instance at 0x7f6530b4d4b0>,99,18,[3 7],100,-1,131,-1,113
1,<environment.Job instance at 0x7f65310c00f0>,106,15,[14  5],107,-1,129,-1,114
1,<environment.Job instance at 0x7f65310c0d20>,102,16,[ 4 12],103,-1,130,-1,114
1,<environment.Job instance at 0x7f65310c06e0>,105,18,[6 3],106,-1,132,-1,114
1,<environment.Job instance at 0x7f6530731320>,113,15,[5 6],114,-1,129,-1,114
1,<environment.Job instance at 0x7f65311c49b0>,111,18,[10  3],112,-1,134,-1,116
1,<environment.Job instance at 0x7f6539d60fa0>,119,16,[ 3 12],120,-1,143,-1,127
1,<environment.Job instance at 0x7f653095ec80>,126,18,[6 4],127,-1,145,-1,127
1,<environment.Job instance at 0x7f6530e5ee60>,116,13,[9 3],117,-1,141,-1,128
1,<environment.Job instance at 0x7f6531512500>,130,17,[5 2],131,-1,148,-1,131
1,<environment.Job instance at 0x7f6539d60550>,118,15,[4 6],119,-1,146,-1,131
1,<environment.Job instance at 0x7f6530a490a0>,127,18,[ 5 10],128,-1,149,-1,131
1,<environment.Job instance at 0x7f653024bcd0>,133,15,[7 4],134,-1,153,-1,138
1,<environment.Job instance at 0x7f653055fd70>,6,2,[12  3],7,-1,9,-1,7
1,<environment.Job instance at 0x7f65314a33c0>,5,25,[10  3],6,-1,58,-1,33
1,<environment.Job instance at 0x7f6530da2dc0>,14,3,[14  3],15,-1,36,-1,33
1,<environment.Job instance at 0x7f6531616140>,19,15,[13  3],20,-1,53,-1,38
1,<environment.Job instance at 0x7f6530217e60>,20,24,[7 2],21,-1,62,-1,38
1,<environment.Job instance at 0x7f65303eed70>,22,25,[7 5],23,-1,66,-1,41
1,<environment.Job instance at 0x7f6531512cd0>,26,3,[12  5],27,-1,56,-1,53
1,<environment.Job instance at 0x7f653152f4b0>,42,24,[2 9],43,-1,180,-1,156
1,<environment.Job instance at 0x7f6530554f00>,65,23,[1 8],66,-1,267,-1,244
1,<environment.Job instance at 0x7f653011faa0>,68,13,[ 5 13],69,-1,257,-1,244
1,<environment.Job instance at 0x7f6531509910>,72,3,[ 5 13],73,-1,251,-1,248
1,<environment.Job instance at 0x7f65301ec730>,84,26,[8 5],85,-1,324,-1,298
1,<environment.Job instance at 0x7f6530db1dc0>,93,24,[3 7],94,-1,354,-1,330
1,<environment.Job instance at 0x7f6530948dc0>,101,3,[14  4],102,-1,353,-1,350
1,<environment.Job instance at 0x7f6530db10a0>,102,16,[ 4 12],103,-1,366,-1,350
1,<environment.Job instance at 0x7f65307c3f00>,106,15,[14  5],107,-1,369,-1,354
1,<environment.Job instance at 0x7f6530e7b910>,115,25,[ 4 10],116,-1,417,-1,392
1,<environment.Job instance at 0x7f6530cd3d20>,119,16,[ 3 12],120,-1,423,-1,407
1,<environment.Job instance at 0x7f65300bb460>,128,2,[ 5 11],129,-1,429,-1,427
1,<environment.Job instance at 0x7f65300bb3c0>,131,27,[4 5],132,-1,474,-1,447
1,<environment.Job instance at 0x7f65306962d0>,136,27,[10  5],137,-1,505,-1,478
1,<environment.Job instance at 0x7f32870a26e0>,0,18,[ 2 10],1,-1,20,-1,2
1,<environment.Job instance at 0x7f327dab2a50>,3,18,[ 3 10],4,-1,22,-1,4
1,<environment.Job instance at 0x7f327dab2be0>,4,18,[10  4],5,-1,23,-1,5
1,<environment.Job instance at 0x7f327dab2d70>,8,17,[ 2 10],9,-1,26,-1,9
1,<environment.Job instance at 0x7f327dab2fa0>,9,17,[ 4 10],10,-1,27,-1,10
1,<environment.Job instance at 0x7f327dab55f0>,16,12,[1 8],17,-1,29,-1,17
1,<environment.Job instance at 0x7f327dab53c0>,18,16,[8 5],19,-1,35,-1,19
1,<environment.Job instance at 0x7f327dab5c30>,23,18,[5 2],24,-1,48,-1,30
1,<environment.Job instance at 0x7f327dab80a0>,31,17,[4 9],32,-1,49,-1,32
1,<environment.Job instance at 0x7f327dab8550>,32,17,[9 3],33,-1,50,-1,33
1,<environment.Job instance at 0x7f327dab8960>,35,16,[8 1],36,-1,52,-1,36
1,<environment.Job instance at 0x7f327dab8c80>,38,12,[3 6],39,-1,51,-1,39
1,<environment.Job instance at 0x7f327dab8dc0>,39,18,[5 8],40,-1,58,-1,40
1,<environment.Job instance at 0x7f327dab8f00>,42,14,[8 4],43,-1,57,-1,43
1,<environment.Job instance at 0x7f327daba140>,43,28,[6 4],44,-1,72,-1,44
1,<environment.Job instance at 0x7f327daba6e0>,50,27,[9 1],51,-1,111,-1,84
1,<environment.Job instance at 0x7f327dabaf00>,60,24,[ 3 10],61,-1,157,-1,133
1,<environment.Job instance at 0x7f327daba7d0>,53,18,[ 4 12],54,-1,151,-1,133
1,<environment.Job instance at 0x7f327dabd690>,68,22,[5 6],69,-1,157,-1,135
1,<environment.Job instance at 0x7f327dabab90>,55,17,[4 7],56,-1,152,-1,135
1,<environment.Job instance at 0x7f327dabdd20>,78,19,[8 4],79,-1,155,-1,136
1,<environment.Job instance at 0x7f327dabddc0>,79,17,[2 7],80,-1,153,-1,136
1,<environment.Job instance at 0x7f327dac0c80>,98,12,[10  1],99,-1,186,-1,174
1,<environment.Job instance at 0x7f327dac0d20>,102,27,[ 3 13],103,-1,202,-1,175
1,<environment.Job instance at 0x7f327dac0a00>,95,23,[3 7],96,-1,198,-1,175
1,<environment.Job instance at 0x7f327dac30a0>,103,17,[5 6],104,-1,192,-1,175
1,<environment.Job instance at 0x7f327dac30f0>,104,17,[5 4],105,-1,192,-1,175
1,<environment.Job instance at 0x7f327dac32d0>,106,12,[2 6],107,-1,207,-1,195
1,<environment.Job instance at 0x7f327daa0910>,111,18,[ 3 13],112,-1,216,-1,198
1,<environment.Job instance at 0x7f327daa07d0>,110,20,[5 7],111,-1,218,-1,198
1,<environment.Job instance at 0x7f327dabd7d0>,70,18,[5 5],71,-1,216,-1,198
1,<environment.Job instance at 0x7f327daa9d20>,121,18,[11  5],122,-1,341,-1,323
1,<environment.Job instance at 0x7f327dab5140>,1,15,[ 1 14],2,-1,17,-1,2
1,<environment.Job instance at 0x7f327dab8500>,6,12,[11  4],7,-1,19,-1,7
1,<environment.Job instance at 0x7f327db6fe60>,19,17,[12  3],20,-1,67,-1,50
1,<environment.Job instance at 0x7f327dbbf780>,22,2,[12  3],23,-1,62,-1,60
1,<environment.Job instance at 0x7f327db13410>,43,28,[6 4],44,-1,166,-1,138
1,<environment.Job instance at 0x7f327daedaa0>,44,17,[ 5 12],45,-1,155,-1,138
1,<environment.Job instance at 0x7f327da8fdc0>,50,27,[9 1],51,-1,179,-1,152
1,<environment.Job instance at 0x7f327db0b820>,52,3,[ 3 11],53,-1,155,-1,152
1,<environment.Job instance at 0x7f327db0bf00>,53,18,[ 4 12],54,-1,170,-1,152
1,<environment.Job instance at 0x7f327da9ac80>,60,24,[ 3 10],61,-1,209,-1,185
1,<environment.Job instance at 0x7f327daa62d0>,67,26,[5 4],68,-1,226,-1,200
1,<environment.Job instance at 0x7f327dac3640>,81,17,[ 4 14],82,-1,256,-1,239
1,<environment.Job instance at 0x7f327dac3870>,85,19,[14  4],86,-1,260,-1,241
1,<environment.Job instance at 0x7f327dac3d70>,95,23,[3 7],96,-1,294,-1,271
1,<environment.Job instance at 0x7f327da4d500>,102,27,[ 3 13],103,-1,316,-1,289
1,<environment.Job instance at 0x7f327da4dc80>,111,18,[ 3 13],112,-1,333,-1,315
1,<environment.Job instance at 0x7f327da4de10>,117,18,[ 3 12],118,-1,348,-1,330
1,<environment.Job instance at 0x7f327da50230>,121,18,[11  5],122,-1,359,-1,341
1,<environment.Job instance at 0x7f327da50370>,122,14,[14  1],123,-1,355,-1,341
1,<environment.Job instance at 0x7f327da50c30>,135,15,[ 3 14],136,-1,411,-1,396
1,<environment.Job instance at 0x7f327da50d70>,137,12,[14  5],138,-1,408,-1,396
1,<environment.Job instance at 0x7f327d489a50>,1,16,[1 9],2,-1,18,-1,2
1,<environment.Job instance at 0x7f327d451190>,5,14,[3 8],6,-1,20,-1,6
1,<environment.Job instance at 0x7f327d493c30>,7,17,[3 8],8,-1,25,-1,8
1,<environment.Job instance at 0x7f327d493eb0>,8,16,[3 9],9,-1,25,-1,9
1,<environment.Job instance at 0x7f327d51da00>,13,15,[4 8],14,-1,29,-1,14
1,<environment.Job instance at 0x7f327d51dcd0>,17,18,[5 2],18,-1,36,-1,18
1,<environment.Job instance at 0x7f327d521e60>,18,18,[4 6],19,-1,37,-1,19
1,<environment.Job instance at 0x7f327d5211e0>,19,16,[3 5],20,-1,36,-1,20
1,<environment.Job instance at 0x7f327d521370>,25,25,[3 9],26,-1,51,-1,26
1,<environment.Job instance at 0x7f327d521e10>,27,13,[ 4 10],28,-1,41,-1,28
1,<environment.Job instance at 0x7f327d521d20>,28,14,[4 7],29,-1,43,-1,29
1,<environment.Job instance at 0x7f327d521410>,29,23,[2 8],30,-1,55,-1,32
1,<environment.Job instance at 0x7f327d6e3320>,35,17,[10  5],36,-1,54,-1,37
1,<environment.Job instance at 0x7f327d591910>,38,14,[8 5],39,-1,53,-1,39
1,<environment.Job instance at 0x7f327d6bd320>,39,17,[9 2],40,-1,57,-1,40
1,<environment.Job instance at 0x7f327d6bd5f0>,40,18,[5 1],41,-1,59,-1,41
1,<environment.Job instance at 0x7f327d565280>,42,14,[8 4],43,-1,57,-1,43
1,<environment.Job instance at 0x7f327d5705f0>,44,17,[10  5],45,-1,62,-1,45
1,<environment.Job instance at 0x7f327d570460>,45,16,[ 3 10],46,-1,62,-1,46
1,<environment.Job instance at 0x7f327d5707d0>,46,23,[5 8],47,-1,70,-1,47
1,<environment.Job instance at 0x7f327d447d70>,52,14,[9 2],53,-1,67,-1,53
1,<environment.Job instance at 0x7f327d535730>,53,27,[5 3],54,-1,81,-1,54
1,<environment.Job instance at 0x7f328df18550>,54,17,[10  2],55,-1,72,-1,55
1,<environment.Job instance at 0x7f327d32ef00>,55,17,[5 9],56,-1,73,-1,56
1,<environment.Job instance at 0x7f328720a320>,58,22,[9 2],59,-1,81,-1,59
1,<environment.Job instance at 0x7f327d13a4b0>,60,17,[2 9],61,-1,78,-1,61
1,<environment.Job instance at 0x7f3287149dc0>,62,17,[10  4],63,-1,80,-1,63
1,<environment.Job instance at 0x7f327d9de140>,65,17,[8 1],66,-1,83,-1,66
1,<environment.Job instance at 0x7f327d04b9b0>,66,16,[7 2],67,-1,83,-1,67
1,<environment.Job instance at 0x7f327d04b8c0>,67,18,[ 1 10],68,-1,86,-1,68
1,<environment.Job instance at 0x7f327d0bcc30>,68,28,[7 4],69,-1,97,-1,69
1,<environment.Job instance at 0x7f327d0628c0>,73,15,[5 6],74,-1,89,-1,74
1,<environment.Job instance at 0x7f327d062c30>,75,17,[3 5],76,-1,93,-1,76
1,<environment.Job instance at 0x7f327d062f00>,81,13,[3 6],82,-1,95,-1,82
1,<environment.Job instance at 0x7f327d064140>,82,16,[8 5],83,-1,99,-1,83
1,<environment.Job instance at 0x7f327d064c80>,83,12,[3 8],84,-1,96,-1,84
1,<environment.Job instance at 0x7f327d064780>,84,14,[8 5],85,-1,99,-1,85
1,<environment.Job instance at 0x7f327d0640a0>,88,18,[3 8],89,-1,107,-1,89
1,<environment.Job instance at 0x7f327d064500>,89,16,[9 4],90,-1,106,-1,90
1,<environment.Job instance at 0x7f327d5261e0>,34,12,[5 7],35,-1,109,-1,97
1,<environment.Job instance at 0x7f327d061cd0>,96,17,[2 6],97,-1,115,-1,98
1,<environment.Job instance at 0x7f327d065140>,94,15,[9 5],95,-1,113,-1,98
1,<environment.Job instance at 0x7f327d061f00>,97,16,[2 8],98,-1,114,-1,98
1,<environment.Job instance at 0x7f327d0615f0>,100,18,[8 5],101,-1,125,-1,107
1,<environment.Job instance at 0x7f327d67b6e0>,36,26,[9 1],37,-1,133,-1,107
1,<environment.Job instance at 0x7f327d062b90>,74,28,[9 1],75,-1,135,-1,107
1,<environment.Job instance at 0x7f327d061910>,101,3,[1 8],102,-1,111,-1,108
1,<environment.Job instance at 0x7f327d065320>,90,28,[7 3],91,-1,136,-1,108
1,<environment.Job instance at 0x7f327d05f9b0>,113,21,[9 5],114,-1,136,-1,115
1,<environment.Job instance at 0x7f327d061820>,104,17,[1 9],105,-1,144,-1,127
1,<environment.Job instance at 0x7f328e208870>,116,22,[6 1],117,-1,149,-1,127
1,<environment.Job instance at 0x7f327d05f640>,117,14,[3 5],118,-1,141,-1,127
1,<environment.Job instance at 0x7f327d1f10f0>,118,21,[5 1],119,-1,148,-1,127
1,<environment.Job instance at 0x7f328720ecd0>,122,17,[8 2],123,-1,144,-1,127
1,<environment.Job instance at 0x7f3287142e60>,123,18,[7 5],124,-1,150,-1,132
1,<environment.Job instance at 0x7f327d05f870>,114,18,[10  2],115,-1,150,-1,132
1,<environment.Job instance at 0x7f328721c2d0>,121,18,[ 5 14],122,-1,150,-1,132
1,<environment.Job instance at 0x7f327d048320>,108,12,[12  2],109,-1,144,-1,132
1,<environment.Job instance at 0x7f327d383dc0>,127,14,[4 7],128,-1,146,-1,132
1,<environment.Job instance at 0x7f3287212320>,126,14,[5 4],127,-1,147,-1,133
1,<environment.Job instance at 0x7f327d0dfb90>,129,13,[5 7],130,-1,146,-1,133
1,<environment.Job instance at 0x7f327d0dfe60>,131,16,[6 2],132,-1,149,-1,133
1,<environment.Job instance at 0x7f327d2ce1e0>,139,14,[5 7],140,-1,156,-1,142
1,<environment.Job instance at 0x7f327d048a50>,111,19,[ 3 14],112,-1,161,-1,142
1,<environment.Job instance at 0x7f327d2ce500>,140,13,[7 4],141,-1,155,-1,142
1,<environment.Job instance at 0x7f327d194f00>,138,17,[12  1],139,-1,159,-1,142
1,<environment.Job instance at 0x7f327d2cea50>,143,18,[9 2],144,-1,163,-1,145
1,<environment.Job instance at 0x7f327d2cecd0>,144,18,[ 5 10],145,-1,164,-1,146
1,<environment.Job instance at 0x7f327d3f0e10>,16,22,[11  3],17,-1,57,-1,35
1,<environment.Job instance at 0x7f327da50870>,25,25,[3 9],26,-1,106,-1,81
1,<environment.Job instance at 0x7f327da502d0>,29,23,[2 8],30,-1,104,-1,81
1,<environment.Job instance at 0x7f327da4de60>,36,26,[9 1],37,-1,128,-1,102
1,<environment.Job instance at 0x7f327da4d640>,46,23,[5 8],47,-1,172,-1,149
1,<environment.Job instance at 0x7f327da4d140>,51,2,[12  1],52,-1,157,-1,155
1,<environment.Job instance at 0x7f327dabd320>,53,27,[5 3],54,-1,184,-1,157
1,<environment.Job instance at 0x7f327d2bb690>,59,3,[ 4 12],60,-1,187,-1,184
1,<environment.Job instance at 0x7f327dab8eb0>,61,18,[ 5 11],62,-1,202,-1,184
1,<environment.Job instance at 0x7f327d262c30>,68,28,[7 4],69,-1,261,-1,233
1,<environment.Job instance at 0x7f327d2769b0>,74,28,[9 1],75,-1,280,-1,252
1,<environment.Job instance at 0x7f327d276140>,78,16,[14  3],79,-1,283,-1,267
1,<environment.Job instance at 0x7f327d2df370>,90,28,[7 3],91,-1,352,-1,324
1,<environment.Job instance at 0x7f327d36e5f0>,108,12,[12  2],109,-1,404,-1,392
1,<environment.Job instance at 0x7f327d2133c0>,111,19,[ 3 14],112,-1,424,-1,405
1,<environment.Job instance at 0x7f327d213410>,112,2,[14  5],113,-1,407,-1,405
1,<environment.Job instance at 0x7f327d210320>,115,12,[12  4],116,-1,419,-1,407
1,<environment.Job instance at 0x7f327d39c0a0>,121,18,[ 5 14],122,-1,440,-1,422
1,<environment.Job instance at 0x7f327d217d20>,128,1,[ 5 14],129,-1,444,-1,443
1,<environment.Job instance at 0x7f327d254190>,133,3,[14  5],134,-1,471,-1,468
1,<environment.Job instance at 0x7f327d22c370>,138,17,[12  1],139,-1,493,-1,476
1,<environment.Job instance at 0x7f327d228640>,142,1,[13  3],143,-1,490,-1,489
1,<environment.Job instance at 0x7f327d4ff910>,0,17,[4 5],1,-1,18,-1,1
1,<environment.Job instance at 0x7f327d4ffb40>,5,18,[9 5],6,-1,24,-1,6
1,<environment.Job instance at 0x7f327d4ff870>,7,17,[7 5],8,-1,25,-1,8
1,<environment.Job instance at 0x7f327d2a9c80>,11,15,[10  3],12,-1,35,-1,20
1,<environment.Job instance at 0x7f327d1e5d20>,20,14,[ 3 10],21,-1,35,-1,21
1,<environment.Job instance at 0x7f327d1e5140>,23,15,[7 4],24,-1,39,-1,24
1,<environment.Job instance at 0x7f327d1e5a50>,26,15,[6 2],27,-1,42,-1,27
1,<environment.Job instance at 0x7f327d1e1910>,30,13,[ 4 10],31,-1,44,-1,31
1,<environment.Job instance at 0x7f327d1e19b0>,31,16,[2 8],32,-1,48,-1,32
1,<environment.Job instance at 0x7f327d2a9780>,19,17,[4 8],20,-1,51,-1,34
1,<environment.Job instance at 0x7f327d1e1460>,39,16,[1 7],40,-1,57,-1,41
1,<environment.Job instance at 0x7f327d1dcbe0>,41,15,[3 5],42,-1,57,-1,42
1,<environment.Job instance at 0x7f327d1dc500>,42,20,[7 3],43,-1,63,-1,43
1,<environment.Job instance at 0x7f327d1dc0a0>,45,17,[6 3],46,-1,64,-1,47
1,<environment.Job instance at 0x7f327d1dc690>,46,20,[6 2],47,-1,67,-1,47
1,<environment.Job instance at 0x7f327d1dc410>,48,17,[2 8],49,-1,69,-1,52
1,<environment.Job instance at 0x7f327d1d98c0>,52,15,[7 3],53,-1,68,-1,53
1,<environment.Job instance at 0x7f327d1d9c30>,55,16,[2 6],56,-1,72,-1,56
1,<environment.Job instance at 0x7f327d1d9280>,56,15,[10  5],57,-1,72,-1,57
1,<environment.Job instance at 0x7f327d1e59b0>,27,16,[ 5 13],28,-1,74,-1,58
1,<environment.Job instance at 0x7f327d1d9050>,57,16,[ 3 10],58,-1,74,-1,58
1,<environment.Job instance at 0x7f327d1d9140>,58,16,[3 6],59,-1,78,-1,62
1,<environment.Job instance at 0x7f327d1d9410>,63,12,[8 5],64,-1,76,-1,64
1,<environment.Job instance at 0x7f327d1d78c0>,64,22,[1 9],65,-1,87,-1,65
1,<environment.Job instance at 0x7f327d1d7e60>,65,12,[2 5],66,-1,78,-1,66
1,<environment.Job instance at 0x7f327d1d7fa0>,69,18,[ 2 10],70,-1,88,-1,70
1,<environment.Job instance at 0x7f327d1d7aa0>,70,17,[7 1],71,-1,94,-1,77
1,<environment.Job instance at 0x7f327d1d70f0>,73,24,[3 6],74,-1,101,-1,77
1,<environment.Job instance at 0x7f327d1d1190>,75,20,[3 8],76,-1,98,-1,78
1,<environment.Job instance at 0x7f327d1d10a0>,76,15,[4 9],77,-1,93,-1,78
1,<environment.Job instance at 0x7f327d1d1dc0>,77,27,[9 5],78,-1,105,-1,78
1,<environment.Job instance at 0x7f327d1d9190>,61,25,[10  4],62,-1,103,-1,78
1,<environment.Job instance at 0x7f327d1d1fa0>,78,14,[3 6],79,-1,93,-1,79
1,<environment.Job instance at 0x7f327d1d1a50>,80,18,[4 8],81,-1,101,-1,83
1,<environment.Job instance at 0x7f327d1d90f0>,60,1,[5 1],61,-1,88,-1,87
1,<environment.Job instance at 0x7f327d1e1550>,40,18,[11  4],41,-1,108,-1,90
1,<environment.Job instance at 0x7f327d1d9910>,59,22,[1 6],60,-1,112,-1,90
1,<environment.Job instance at 0x7f327d1ceb40>,85,18,[ 3 10],86,-1,108,-1,90
1,<environment.Job instance at 0x7f327d1ce230>,92,17,[9 1],93,-1,110,-1,93
1,<environment.Job instance at 0x7f327d1ced70>,86,21,[6 1],87,-1,115,-1,94
1,<environment.Job instance at 0x7f327d1cae60>,95,27,[5 5],96,-1,123,-1,96
1,<environment.Job instance at 0x7f327d1ce370>,93,18,[8 1],94,-1,115,-1,97
1,<environment.Job instance at 0x7f327d1caf50>,97,20,[5 2],98,-1,119,-1,99
1,<environment.Job instance at 0x7f327d4882d0>,99,17,[2 6],100,-1,117,-1,100
1,<environment.Job instance at 0x7f327d2997d0>,100,16,[1 9],101,-1,118,-1,102
1,<environment.Job instance at 0x7f327d093780>,102,17,[4 6],103,-1,120,-1,103
1,<environment.Job instance at 0x7f327d188280>,112,13,[8 1],113,-1,153,-1,140
1,<environment.Job instance at 0x7f327d1ca690>,98,13,[14  4],99,-1,157,-1,144
1,<environment.Job instance at 0x7f327dcfa190>,117,14,[10  3],118,-1,158,-1,144
1,<environment.Job instance at 0x7f327d1cac80>,96,22,[2 8],97,-1,171,-1,149
1,<environment.Job instance at 0x7f327d188f50>,111,18,[5 7],112,-1,173,-1,155
1,<environment.Job instance at 0x7f327d89dfa0>,118,13,[8 2],119,-1,168,-1,155
1,<environment.Job instance at 0x7f327d064730>,125,16,[10  5],126,-1,171,-1,155
1,<environment.Job instance at 0x7f327d0d4aa0>,127,14,[9 1],128,-1,169,-1,155
1,<environment.Job instance at 0x7f327d272190>,130,17,[9 4],131,-1,172,-1,155
1,<environment.Job instance at 0x7f327dce8b90>,128,21,[9 5],129,-1,176,-1,155
1,<environment.Job instance at 0x7f327d1e1e60>,2,27,[ 2 13],3,-1,30,-1,3
1,<environment.Job instance at 0x7f327d1d7dc0>,8,1,[12  5],9,-1,10,-1,9
1,<environment.Job instance at 0x7f327d88fa50>,21,18,[ 4 13],22,-1,68,-1,50
1,<environment.Job instance at 0x7f327d8707d0>,27,16,[ 5 13],28,-1,83,-1,67
1,<environment.Job instance at 0x7f327d2a9140>,34,18,[13  2],35,-1,115,-1,97
1,<environment.Job instance at 0x7f327d2d2960>,40,18,[11  4],41,-1,125,-1,107
1,<environment.Job instance at 0x7f327d86f2d0>,61,25,[10  4],62,-1,230,-1,205
1,<environment.Job instance at 0x7f327d195cd0>,73,24,[3 6],74,-1,257,-1,233
1,<environment.Job instance at 0x7f327d0fe410>,77,27,[9 5],78,-1,273,-1,246
1,<environment.Job instance at 0x7f327d0f44b0>,83,2,[ 3 14],84,-1,265,-1,263
1,<environment.Job instance at 0x7f327d1928c0>,94,3,[ 3 12],95,-1,323,-1,320
1,<environment.Job instance at 0x7f327d0bc190>,95,27,[5 5],96,-1,347,-1,320
1,<environment.Job instance at 0x7f327d101460>,98,13,[14  4],99,-1,351,-1,338
1,<environment.Job instance at 0x7f327d1b4730>,103,27,[7 5],104,-1,386,-1,359
1,<environment.Job instance at 0x7f327d1b4aa0>,104,13,[14  5],105,-1,372,-1,359
1,<environment.Job instance at 0x7f327d1899b0>,115,25,[3 7],116,-1,441,-1,416
1,<environment.Job instance at 0x7f327d1893c0>,120,1,[ 4 12],121,-1,431,-1,430
1,<environment.Job instance at 0x7f327d1ca500>,124,12,[13  3],125,-1,446,-1,434
1,<environment.Job instance at 0x7f327d1ca7d0>,129,3,[12  1],130,-1,465,-1,462
1,<environment.Job instance at 0x7f327d1c6aa0>,139,16,[ 5 13],140,-1,516,-1,500
1,<environment.Job instance at 0x7f327d1c6640>,144,14,[ 3 14],145,-1,523,-1,509
1,<environment.Job instance at 0x7f327d1c6f50>,145,24,[3 9],146,-1,546,-1,522
1,<environment.Job instance at 0x7f327d0147d0>,2,17,[10  3],3,-1,21,-1,4
1,<environment.Job instance at 0x7f327d48c5f0>,3,13,[9 5],4,-1,17,-1,4
1,<environment.Job instance at 0x7f327d014c30>,11,15,[14  1],12,-1,27,-1,12
1,<environment.Job instance at 0x7f327d014f50>,12,27,[5 5],13,-1,40,-1,13
1,<environment.Job instance at 0x7f327d0180f0>,13,14,[3 6],14,-1,28,-1,14
1,<environment.Job instance at 0x7f327d018140>,14,25,[1 7],15,-1,40,-1,15
1,<environment.Job instance at 0x7f327d0181e0>,15,1,[3 6],16,-1,17,-1,16
1,<environment.Job instance at 0x7f327d018280>,16,15,[ 5 10],17,-1,32,-1,17
1,<environment.Job instance at 0x7f327d018320>,17,13,[6 5],18,-1,31,-1,18
1,<environment.Job instance at 0x7f327d018460>,19,14,[2 6],20,-1,34,-1,20
1,<environment.Job instance at 0x7f327d018550>,21,14,[1 9],22,-1,36,-1,22
1,<environment.Job instance at 0x7f327d0186e0>,23,18,[4 8],24,-1,42,-1,24
1,<environment.Job instance at 0x7f327d0189b0>,24,17,[7 4],25,-1,42,-1,25
1,<environment.Job instance at 0x7f327d018870>,25,14,[7 3],26,-1,40,-1,26
1,<environment.Job instance at 0x7f327d018aa0>,26,27,[5 8],27,-1,54,-1,27
1,<environment.Job instance at 0x7f327d018f00>,31,24,[4 8],32,-1,56,-1,32
1,<environment.Job instance at 0x7f327d01a4b0>,35,19,[7 5],36,-1,55,-1,36
1,<environment.Job instance at 0x7f327d01a640>,36,14,[8 1],37,-1,51,-1,37
1,<environment.Job instance at 0x7f327d01a500>,37,12,[10  4],38,-1,52,-1,40
1,<environment.Job instance at 0x7f327d01a910>,40,14,[ 4 10],41,-1,55,-1,41
1,<environment.Job instance at 0x7f327d01a9b0>,42,17,[2 5],43,-1,61,-1,44
1,<environment.Job instance at 0x7f327d01ac30>,43,14,[8 2],44,-1,58,-1,44
1,<environment.Job instance at 0x7f327d01af00>,46,18,[8 2],47,-1,66,-1,48
1,<environment.Job instance at 0x7f327d01b0a0>,48,3,[9 1],49,-1,52,-1,49
1,<environment.Job instance at 0x7f327d01b140>,49,18,[5 8],50,-1,68,-1,50
1,<environment.Job instance at 0x7f327d01b1e0>,50,19,[2 7],51,-1,70,-1,51
1,<environment.Job instance at 0x7f327d01b280>,51,24,[1 9],52,-1,76,-1,52
1,<environment.Job instance at 0x7f327d01adc0>,47,18,[6 2],48,-1,71,-1,53
1,<environment.Job instance at 0x7f327d01b6e0>,56,14,[7 5],57,-1,71,-1,57
1,<environment.Job instance at 0x7f327d01b960>,57,23,[10  4],58,-1,81,-1,58
1,<environment.Job instance at 0x7f327d00b460>,61,17,[5 7],62,-1,79,-1,62
1,<environment.Job instance at 0x7f327d00ba00>,62,12,[3 8],63,-1,75,-1,63
1,<environment.Job instance at 0x7f327d00b960>,64,13,[1 9],65,-1,78,-1,65
1,<environment.Job instance at 0x7f327d00b4b0>,65,16,[4 5],66,-1,82,-1,66
1,<environment.Job instance at 0x7f327d00b0f0>,69,17,[ 5 10],70,-1,87,-1,70
1,<environment.Job instance at 0x7f327d79c0f0>,70,18,[4 6],71,-1,89,-1,71
1,<environment.Job instance at 0x7f327d433e10>,76,14,[ 5 10],77,-1,91,-1,77
1,<environment.Job instance at 0x7f327d433dc0>,77,18,[1 7],78,-1,96,-1,78
1,<environment.Job instance at 0x7f327d409b40>,78,19,[1 6],79,-1,98,-1,79
1,<environment.Job instance at 0x7f327d407a00>,83,20,[5 7],84,-1,104,-1,84
1,<environment.Job instance at 0x7f327d904690>,85,12,[11  5],86,-1,101,-1,89
1,<environment.Job instance at 0x7f327d435370>,86,27,[4 5],87,-1,116,-1,89
1,<environment.Job instance at 0x7f327d435460>,88,15,[5 9],89,-1,104,-1,89
1,<environment.Job instance at 0x7f327d434870>,90,14,[8 4],91,-1,106,-1,92
1,<environment.Job instance at 0x7f327d434e10>,93,18,[6 1],94,-1,112,-1,94
1,<environment.Job instance at 0x7f327d434af0>,95,1,[8 1],96,-1,97,-1,96
1,<environment.Job instance at 0x7f327d4342d0>,96,14,[10  4],97,-1,111,-1,97
1,<environment.Job instance at 0x7f327d43dc80>,91,12,[5 9],92,-1,109,-1,97
1,<environment.Job instance at 0x7f327d4163c0>,126,17,[ 1 10],127,-1,299,-1,282
1,<environment.Job instance at 0x7f327d416190>,124,15,[ 2 13],125,-1,297,-1,282
1,<environment.Job instance at 0x7f327d416140>,131,13,[1 9],132,-1,296,-1,283
1,<environment.Job instance at 0x7f327d7b2870>,121,17,[14  3],122,-1,312,-1,295
1,<environment.Job instance at 0x7f327d794640>,138,18,[13  3],139,-1,313,-1,295
1,<environment.Job instance at 0x7f327d7947d0>,137,17,[3 8],138,-1,312,-1,295
1,<environment.Job instance at 0x7f327d794820>,140,13,[10  4],141,-1,308,-1,295
1,<environment.Job instance at 0x7f327d411050>,142,17,[2 5],143,-1,322,-1,305
1,<environment.Job instance at 0x7f327d40fb40>,148,17,[2 7],149,-1,323,-1,306
1,<environment.Job instance at 0x7f327d433d20>,75,24,[10  2],76,-1,331,-1,307
1,<environment.Job instance at 0x7f327d01aaa0>,5,1,[12  4],6,-1,7,-1,6
1,<environment.Job instance at 0x7f327d407460>,11,15,[14  1],12,-1,33,-1,18
1,<environment.Job instance at 0x7f327d79f4b0>,12,27,[5 5],13,-1,47,-1,20
1,<environment.Job instance at 0x7f327d434640>,14,25,[1 7],15,-1,45,-1,20
1,<environment.Job instance at 0x7f327d009550>,26,27,[5 8],27,-1,92,-1,65
1,<environment.Job instance at 0x7f327d014730>,31,24,[4 8],32,-1,105,-1,81
1,<environment.Job instance at 0x7f327d1c6b40>,41,1,[11  1],42,-1,102,-1,101
1,<environment.Job instance at 0x7f327d1f1c30>,51,24,[1 9],52,-1,164,-1,140
1,<environment.Job instance at 0x7f327d1897d0>,57,23,[10  4],58,-1,195,-1,172
1,<environment.Job instance at 0x7f327d1891e0>,63,3,[ 5 13],64,-1,181,-1,178
1,<environment.Job instance at 0x7f327d189c30>,66,17,[13  2],67,-1,207,-1,190
1,<environment.Job instance at 0x7f327d1898c0>,67,1,[11  4],68,-1,191,-1,190
1,<environment.Job instance at 0x7f327d1b4d20>,72,17,[ 2 12],73,-1,221,-1,204
1,<environment.Job instance at 0x7f327d1b4fa0>,75,24,[10  2],76,-1,257,-1,233
1,<environment.Job instance at 0x7f327d0bc500>,79,27,[14  1],80,-1,261,-1,234
1,<environment.Job instance at 0x7f327d192460>,82,2,[11  4],83,-1,237,-1,235
1,<environment.Job instance at 0x7f327d04b140>,85,12,[11  5],86,-1,257,-1,245
1,<environment.Job instance at 0x7f327d18fe10>,86,27,[4 5],87,-1,273,-1,246
1,<environment.Job instance at 0x7f327d0f4870>,92,3,[11  3],93,-1,273,-1,270
1,<environment.Job instance at 0x7f327d057780>,101,15,[ 2 14],102,-1,311,-1,296
1,<environment.Job instance at 0x7f327d048f50>,105,12,[ 3 13],106,-1,323,-1,311
1,<environment.Job instance at 0x7f32872d3190>,121,17,[14  3],122,-1,378,-1,361
1,<environment.Job instance at 0x7f327d2d20a0>,124,15,[ 2 13],125,-1,379,-1,364
1,<environment.Job instance at 0x7f327d6c7e60>,127,3,[12  4],128,-1,379,-1,376
1,<environment.Job instance at 0x7f327d064640>,129,28,[1 8],130,-1,421,-1,393
1,<environment.Job instance at 0x7f327d870b90>,138,18,[13  3],139,-1,433,-1,415
1,<environment.Job instance at 0x7f327dce8e60>,145,24,[8 3],146,-1,471,-1,447
1,<environment.Job instance at 0x7f327debe3c0>,0,18,[8 1],1,-1,24,-1,6
1,<environment.Job instance at 0x7f327dfcdf50>,6,18,[9 4],7,-1,25,-1,7
1,<environment.Job instance at 0x7f327dfcd3c0>,7,17,[3 5],8,-1,25,-1,8
1,<environment.Job instance at 0x7f327dfcd550>,8,17,[2 6],9,-1,26,-1,9
1,<environment.Job instance at 0x7f327dfcd870>,12,15,[10  1],13,-1,29,-1,14
1,<environment.Job instance at 0x7f327dfcdd20>,14,24,[4 5],15,-1,39,-1,15
1,<environment.Job instance at 0x7f327dfcdeb0>,15,13,[8 5],16,-1,29,-1,16
1,<environment.Job instance at 0x7f327dfcd0a0>,16,13,[3 9],17,-1,30,-1,17
1,<environment.Job instance at 0x7f327dfcda50>,18,16,[6 5],19,-1,35,-1,19
1,<environment.Job instance at 0x7f327ddf2a50>,22,15,[2 5],23,-1,38,-1,23
1,<environment.Job instance at 0x7f327de8dc30>,23,14,[4 8],24,-1,38,-1,24
1,<environment.Job instance at 0x7f327de8daa0>,24,16,[9 2],25,-1,41,-1,25
1,<environment.Job instance at 0x7f327de8d6e0>,26,15,[9 1],27,-1,42,-1,27
1,<environment.Job instance at 0x7f327d8130a0>,32,13,[ 5 10],33,-1,46,-1,33
1,<environment.Job instance at 0x7f327d8134b0>,33,15,[6 1],34,-1,49,-1,34
1,<environment.Job instance at 0x7f327d813780>,38,17,[7 2],39,-1,56,-1,39
1,<environment.Job instance at 0x7f327d813320>,39,16,[10  2],40,-1,56,-1,40
1,<environment.Job instance at 0x7f327d813640>,40,15,[5 6],41,-1,56,-1,41
1,<environment.Job instance at 0x7f327d813e60>,44,15,[7 3],45,-1,60,-1,45
1,<environment.Job instance at 0x7f327d8130f0>,45,12,[10  3],46,-1,58,-1,46
1,<environment.Job instance at 0x7f327d813eb0>,46,14,[5 4],47,-1,61,-1,47
1,<environment.Job instance at 0x7f327de22640>,47,15,[10  1],48,-1,63,-1,48
1,<environment.Job instance at 0x7f327dfcd6e0>,13,17,[5 3],14,-1,65,-1,48
1,<environment.Job instance at 0x7f327de22f00>,50,17,[2 6],51,-1,77,-1,60
1,<environment.Job instance at 0x7f327d870870>,60,27,[6 4],61,-1,88,-1,61
1,<environment.Job instance at 0x7f327d8703c0>,62,15,[10  1],63,-1,78,-1,63
1,<environment.Job instance at 0x7f327d870640>,59,21,[1 9],60,-1,92,-1,71
1,<environment.Job instance at 0x7f327d7ec6e0>,69,16,[5 3],70,-1,88,-1,72
1,<environment.Job instance at 0x7f327d7ec910>,68,22,[7 5],69,-1,97,-1,75
1,<environment.Job instance at 0x7f327d7ec190>,70,18,[ 5 10],71,-1,94,-1,76
1,<environment.Job instance at 0x7f327d7ec410>,73,16,[8 5],74,-1,92,-1,76
1,<environment.Job instance at 0x7f327d7ecd70>,72,24,[1 6],73,-1,100,-1,76
1,<environment.Job instance at 0x7f327d7eca50>,74,16,[9 4],75,-1,92,-1,76
1,<environment.Job instance at 0x7f327d8095a0>,76,15,[10  4],77,-1,93,-1,78
1,<environment.Job instance at 0x7f327d809e60>,78,17,[3 9],79,-1,96,-1,79
1,<environment.Job instance at 0x7f327d8095f0>,80,14,[1 8],81,-1,100,-1,86
1,<environment.Job instance at 0x7f327d809640>,85,2,[3 5],86,-1,92,-1,90
1,<environment.Job instance at 0x7f327e1256e0>,89,17,[1 9],90,-1,135,-1,118
1,<environment.Job instance at 0x7f327e1253c0>,98,18,[6 5],99,-1,136,-1,118
1,<environment.Job instance at 0x7f327e125460>,99,18,[ 5 10],100,-1,136,-1,118
1,<environment.Job instance at 0x7f327d7ecb40>,66,14,[1 7],67,-1,136,-1,122
1,<environment.Job instance at 0x7f327db0bc30>,105,15,[ 1 10],106,-1,138,-1,123
1,<environment.Job instance at 0x7f327db0b910>,104,17,[5 1],105,-1,140,-1,123
1,<environment.Job instance at 0x7f327db0b870>,106,12,[ 2 11],107,-1,135,-1,123
1,<environment.Job instance at 0x7f327db0b690>,108,24,[4 7],109,-1,147,-1,123
1,<environment.Job instance at 0x7f327db0b0f0>,103,16,[5 3],104,-1,141,-1,125
1,<environment.Job instance at 0x7f327db0b550>,112,17,[9 4],113,-1,142,-1,125
1,<environment.Job instance at 0x7f327dc31870>,114,18,[ 4 11],115,-1,144,-1,126
1,<environment.Job instance at 0x7f327d83aaf0>,115,16,[9 4],116,-1,142,-1,126
1,<environment.Job instance at 0x7f327db55140>,117,15,[4 6],118,-1,141,-1,126
1,<environment.Job instance at 0x7f327e125280>,97,27,[9 3],98,-1,153,-1,126
1,<environment.Job instance at 0x7f327dd79cd0>,120,20,[4 6],121,-1,147,-1,127
1,<environment.Job instance at 0x7f327db0baa0>,110,13,[5 3],111,-1,150,-1,137
1,<environment.Job instance at 0x7f327d895e10>,125,16,[ 2 11],126,-1,153,-1,137
1,<environment.Job instance at 0x7f327d8625f0>,132,17,[ 2 10],133,-1,159,-1,142
1,<environment.Job instance at 0x7f327d862370>,133,15,[5 5],134,-1,157,-1,142
1,<environment.Job instance at 0x7f327ddbc190>,123,14,[ 1 11],124,-1,190,-1,176
1,<environment.Job instance at 0x7f327daadf00>,142,17,[ 2 11],143,-1,193,-1,176
1,<environment.Job instance at 0x7f327d8620a0>,141,21,[4 7],142,-1,197,-1,176
1,<environment.Job instance at 0x7f327daad4b0>,143,15,[4 9],144,-1,192,-1,177
1,<environment.Job instance at 0x7f327d809190>,11,13,[12  4],12,-1,32,-1,19
1,<environment.Job instance at 0x7f327d83a320>,14,24,[4 5],15,-1,53,-1,29
1,<environment.Job instance at 0x7f327d8fd7d0>,49,23,[6 5],50,-1,195,-1,172
1,<environment.Job instance at 0x7f327d0f4dc0>,61,1,[11  4],62,-1,196,-1,195
1,<environment.Job instance at 0x7f327d195fa0>,60,27,[6 4],61,-1,222,-1,195
1,<environment.Job instance at 0x7f327d009500>,72,24,[1 6],73,-1,249,-1,225
1,<environment.Job instance at 0x7f327d433c80>,84,3,[ 2 12],85,-1,283,-1,280
1,<environment.Job instance at 0x7f327d01a550>,91,2,[ 3 14],92,-1,296,-1,294
1,<environment.Job instance at 0x7f327d014e10>,96,13,[12  4],97,-1,325,-1,312
1,<environment.Job instance at 0x7f327d0145f0>,97,27,[9 3],98,-1,340,-1,313
1,<environment.Job instance at 0x7f327da8f730>,106,12,[ 2 11],107,-1,357,-1,345
1,<environment.Job instance at 0x7f327da8f140>,108,24,[4 7],109,-1,401,-1,377
1,<environment.Job instance at 0x7f327de85cd0>,114,18,[ 4 11],115,-1,395,-1,377
1,<environment.Job instance at 0x7f327de85910>,119,3,[14  1],120,-1,385,-1,382
1,<environment.Job instance at 0x7f327de85a00>,123,14,[ 1 11],124,-1,409,-1,395
1,<environment.Job instance at 0x7f327daed910>,125,16,[ 2 11],126,-1,413,-1,397
1,<environment.Job instance at 0x7f327daedaa0>,128,2,[13  3],129,-1,401,-1,399
1,<environment.Job instance at 0x7f327daedeb0>,140,24,[10  4],141,-1,469,-1,445
1,<environment.Job instance at 0x7f327dd30370>,142,17,[ 2 11],143,-1,462,-1,445
1,<environment.Job instance at 0x7f327dd30500>,144,1,[ 2 11],145,-1,446,-1,445
1,<environment.Job instance at 0x7f327cd1e870>,0,15,[10  4],1,-1,17,-1,2
1,<environment.Job instance at 0x7f327e5518c0>,2,15,[4 8],3,-1,18,-1,3
1,<environment.Job instance at 0x7f327d88f050>,1,18,[4 8],2,-1,21,-1,3
1,<environment.Job instance at 0x7f327d4f0eb0>,5,12,[10  1],6,-1,19,-1,7
1,<environment.Job instance at 0x7f327db3b690>,7,14,[ 4 10],8,-1,22,-1,8
1,<environment.Job instance at 0x7f327e5f3820>,8,18,[4 6],9,-1,27,-1,9
1,<environment.Job instance at 0x7f327e506410>,11,12,[5 5],12,-1,24,-1,12
1,<environment.Job instance at 0x7f327e63ad70>,12,16,[3 8],13,-1,29,-1,13
1,<environment.Job instance at 0x7f327e63abe0>,13,13,[7 4],14,-1,27,-1,14
1,<environment.Job instance at 0x7f327e63a0a0>,16,18,[10  2],17,-1,36,-1,18
1,<environment.Job instance at 0x7f327e63a0f0>,18,17,[9 5],19,-1,36,-1,19
1,<environment.Job instance at 0x7f327e590a50>,20,16,[ 3 10],21,-1,37,-1,21
1,<environment.Job instance at 0x7f327e5901e0>,21,16,[5 7],22,-1,38,-1,22
1,<environment.Job instance at 0x7f327e590e60>,23,13,[5 5],24,-1,37,-1,24
1,<environment.Job instance at 0x7f327e4bce60>,25,14,[4 6],26,-1,40,-1,26
1,<environment.Job instance at 0x7f327dc9e4b0>,38,17,[3 7],39,-1,60,-1,43
1,<environment.Job instance at 0x7f327dcfe550>,35,12,[8 5],36,-1,61,-1,49
1,<environment.Job instance at 0x7f327dd63b90>,43,12,[7 4],44,-1,61,-1,49
1,<environment.Job instance at 0x7f327e5a0aa0>,50,14,[ 2 10],51,-1,65,-1,51
1,<environment.Job instance at 0x7f327e06b640>,52,16,[ 3 10],53,-1,69,-1,53
1,<environment.Job instance at 0x7f327de83d20>,53,18,[5 5],54,-1,72,-1,54
1,<environment.Job instance at 0x7f327dcea050>,48,12,[ 4 10],49,-1,67,-1,55
1,<environment.Job instance at 0x7f327de83fa0>,55,17,[ 3 10],56,-1,73,-1,56
1,<environment.Job instance at 0x7f327de833c0>,54,16,[5 5],55,-1,75,-1,59
1,<environment.Job instance at 0x7f327d604f00>,59,18,[9 5],60,-1,78,-1,60
1,<environment.Job instance at 0x7f327d604af0>,60,19,[4 5],61,-1,82,-1,63
1,<environment.Job instance at 0x7f327e0ca0f0>,62,13,[9 4],63,-1,76,-1,63
1,<environment.Job instance at 0x7f327e0d4e10>,63,12,[2 6],64,-1,77,-1,65
1,<environment.Job instance at 0x7f3286c702d0>,64,16,[2 7],65,-1,81,-1,65
1,<environment.Job instance at 0x7f327dd8de10>,66,13,[5 5],67,-1,82,-1,69
1,<environment.Job instance at 0x7f327dd8deb0>,68,16,[8 3],69,-1,86,-1,70
1,<environment.Job instance at 0x7f327dd8d870>,72,21,[5 7],73,-1,94,-1,73
1,<environment.Job instance at 0x7f327e6101e0>,74,17,[9 2],75,-1,92,-1,75
1,<environment.Job instance at 0x7f327e4d2d70>,75,18,[5 5],76,-1,94,-1,76
1,<environment.Job instance at 0x7f327dd63960>,42,17,[6 4],43,-1,99,-1,82
1,<environment.Job instance at 0x7f327de6e9b0>,84,14,[9 1],85,-1,103,-1,89
1,<environment.Job instance at 0x7f327de6ea50>,82,18,[4 7],83,-1,110,-1,92
1,<environment.Job instance at 0x7f327de6e5f0>,86,18,[8 3],87,-1,110,-1,92
1,<environment.Job instance at 0x7f327dc9e0a0>,9,1,[ 5 14],10,-1,21,-1,20
1,<environment.Job instance at 0x7f327de85c80>,27,27,[ 2 11],28,-1,129,-1,102
1,<environment.Job instance at 0x7f327de85190>,29,3,[11  2],30,-1,106,-1,103
1,<environment.Job instance at 0x7f327d7b27d0>,32,1,[12  5],33,-1,109,-1,108
1,<environment.Job instance at 0x7f327dd72f50>,70,23,[9 4],71,-1,287,-1,264
1,<environment.Job instance at 0x7f327e136d70>,78,28,[10  4],79,-1,312,-1,284
1,<environment.Job instance at 0x7f327d48e5a0>,88,17,[12  1],89,-1,338,-1,321
1,<environment.Job instance at 0x7f327d48e910>,90,26,[4 9],91,-1,350,-1,324
1,<environment.Job instance at 0x7f327d48e730>,92,16,[13  1],93,-1,340,-1,324
1,<environment.Job instance at 0x7f327d48e4b0>,97,23,[5 3],98,-1,369,-1,346
1,<environment.Job instance at 0x7f327d48ed20>,101,18,[11  2],102,-1,374,-1,356
1,<environment.Job instance at 0x7f327d48ea00>,102,12,[ 5 13],103,-1,368,-1,356
1,<environment.Job instance at 0x7f327d48e640>,103,24,[ 5 11],104,-1,380,-1,356
1,<environment.Job instance at 0x7f327de6c0f0>,110,13,[11  2],111,-1,402,-1,389
1,<environment.Job instance at 0x7f327de6c1e0>,117,16,[ 3 12],118,-1,437,-1,421
1,<environment.Job instance at 0x7f327e6116e0>,136,25,[6 3],137,-1,536,-1,511
1,<environment.Job instance at 0x7f327e611460>,143,2,[14  3],144,-1,524,-1,522
1,<environment.Job instance at 0x7f327d42e8c0>,144,1,[14  5],145,-1,523,-1,522
1,<environment.Job instance at 0x7f327cf15f00>,1,18,[10  5],2,-1,20,-1,2
1,<environment.Job instance at 0x7f327d79be10>,5,18,[9 2],6,-1,26,-1,8
1,<environment.Job instance at 0x7f327e1b80f0>,11,21,[4 9],12,-1,33,-1,12
1,<environment.Job instance at 0x7f327e1b8b40>,13,16,[8 1],14,-1,30,-1,14
1,<environment.Job instance at 0x7f327d263d70>,15,23,[8 4],16,-1,39,-1,16
1,<environment.Job instance at 0x7f327d263230>,16,12,[3 9],17,-1,29,-1,17
1,<environment.Job instance at 0x7f327d263140>,17,20,[5 7],18,-1,38,-1,18
1,<environment.Job instance at 0x7f327d2634b0>,18,16,[4 8],19,-1,35,-1,19
1,<environment.Job instance at 0x7f327d263e10>,19,18,[6 1],20,-1,38,-1,20
1,<environment.Job instance at 0x7f327e5760f0>,20,15,[2 8],21,-1,36,-1,21
1,<environment.Job instance at 0x7f327da15f50>,22,12,[6 1],23,-1,35,-1,23
1,<environment.Job instance at 0x7f327d436190>,25,16,[10  5],26,-1,42,-1,26
1,<environment.Job instance at 0x7f327e56b6e0>,27,16,[1 7],28,-1,44,-1,28
1,<environment.Job instance at 0x7f327e562f00>,29,18,[2 7],30,-1,48,-1,30
1,<environment.Job instance at 0x7f327e547b40>,30,15,[4 7],31,-1,46,-1,31
1,<environment.Job instance at 0x7f327da2d640>,33,16,[9 4],34,-1,50,-1,34
1,<environment.Job instance at 0x7f327e260460>,34,13,[8 2],35,-1,48,-1,35
1,<environment.Job instance at 0x7f327e56dcd0>,40,24,[7 2],41,-1,65,-1,41
1,<environment.Job instance at 0x7f327e23a3c0>,42,15,[ 2 10],43,-1,58,-1,43
1,<environment.Job instance at 0x7f327e23a460>,44,17,[8 1],45,-1,62,-1,45
1,<environment.Job instance at 0x7f327e23a780>,48,20,[ 1 10],49,-1,69,-1,49
1,<environment.Job instance at 0x7f327e56c3c0>,49,18,[2 7],50,-1,68,-1,50
1,<environment.Job instance at 0x7f327e56c320>,51,18,[3 8],52,-1,70,-1,52
1,<environment.Job instance at 0x7f327d770230>,7,20,[1 8],8,-1,77,-1,57
1,<environment.Job instance at 0x7f327e26b190>,56,16,[1 6],57,-1,74,-1,58
1,<environment.Job instance at 0x7f327e26b050>,57,15,[7 4],58,-1,75,-1,60
1,<environment.Job instance at 0x7f327e23aa00>,46,19,[2 9],47,-1,87,-1,68
1,<environment.Job instance at 0x7f327e24c2d0>,61,28,[5 1],62,-1,101,-1,73
1,<environment.Job instance at 0x7f327e24c230>,60,28,[ 2 14],61,-1,101,-1,73
1,<environment.Job instance at 0x7f327e24c050>,59,17,[ 1 10],60,-1,91,-1,74
1,<environment.Job instance at 0x7f327e24c910>,72,13,[9 1],73,-1,87,-1,74
1,<environment.Job instance at 0x7f327e24cb40>,73,23,[7 4],74,-1,98,-1,75
1,<environment.Job instance at 0x7f327e24cf00>,74,13,[4 8],75,-1,88,-1,75
1,<environment.Job instance at 0x7f327e256050>,76,12,[9 5],77,-1,89,-1,77
1,<environment.Job instance at 0x7f327e256280>,77,17,[10  4],78,-1,95,-1,78
1,<environment.Job instance at 0x7f327e2565f0>,81,14,[9 4],82,-1,96,-1,82
1,<environment.Job instance at 0x7f327e256780>,82,13,[2 9],83,-1,96,-1,83
1,<environment.Job instance at 0x7f327e24c5f0>,67,13,[9 1],68,-1,102,-1,89
1,<environment.Job instance at 0x7f327e256aa0>,87,14,[ 3 14],88,-1,107,-1,93
1,<environment.Job instance at 0x7f327e256960>,85,18,[7 5],86,-1,111,-1,93
1,<environment.Job instance at 0x7f327e2561e0>,78,18,[13  5],79,-1,111,-1,93
1,<environment.Job instance at 0x7f327e256d70>,89,18,[ 2 10],90,-1,112,-1,94
1,<environment.Job instance at 0x7f327e256e10>,90,22,[2 5],91,-1,116,-1,94
1,<environment.Job instance at 0x7f327e24b280>,94,18,[10  2],95,-1,113,-1,95
1,<environment.Job instance at 0x7f327e24c370>,63,12,[3 8],64,-1,110,-1,98
1,<environment.Job instance at 0x7f327e256a00>,86,27,[5 2],87,-1,125,-1,98
1,<environment.Job instance at 0x7f327e24b500>,97,15,[5 8],98,-1,113,-1,98
1,<environment.Job instance at 0x7f327e24b2d0>,98,18,[5 8],99,-1,121,-1,103
1,<environment.Job instance at 0x7f327e24baa0>,104,28,[4 5],105,-1,133,-1,105
1,<environment.Job instance at 0x7f327e24bd70>,106,17,[3 5],107,-1,124,-1,107
1,<environment.Job instance at 0x7f327e24bd20>,108,15,[5 8],109,-1,127,-1,112
1,<environment.Job instance at 0x7f327e24f370>,111,25,[10  1],112,-1,137,-1,112
1,<environment.Job instance at 0x7f327e24f0f0>,112,12,[10  4],113,-1,125,-1,113
1,<environment.Job instance at 0x7f327e24b550>,100,1,[ 2 10],101,-1,116,-1,115
1,<environment.Job instance at 0x7f327e24f230>,114,13,[ 5 10],115,-1,128,-1,115
1,<environment.Job instance at 0x7f327e24f1e0>,110,13,[5 6],111,-1,129,-1,116
1,<environment.Job instance at 0x7f327e24fb40>,120,16,[7 5],121,-1,138,-1,122
1,<environment.Job instance at 0x7f327e24fbe0>,121,15,[5 4],122,-1,137,-1,122
1,<environment.Job instance at 0x7f327e24fd20>,123,17,[5 9],124,-1,141,-1,124
1,<environment.Job instance at 0x7f327e24faf0>,125,21,[9 3],126,-1,147,-1,126
1,<environment.Job instance at 0x7f327e24feb0>,124,17,[2 5],125,-1,144,-1,127
1,<environment.Job instance at 0x7f327e2631e0>,127,25,[9 4],128,-1,153,-1,128
1,<environment.Job instance at 0x7f327e2632d0>,129,14,[5 4],130,-1,144,-1,130
1,<environment.Job instance at 0x7f327e263460>,130,12,[10  1],131,-1,143,-1,131
1,<environment.Job instance at 0x7f327e2635a0>,132,16,[9 4],133,-1,154,-1,138
1,<environment.Job instance at 0x7f327e263640>,133,12,[10  1],134,-1,151,-1,139
1,<environment.Job instance at 0x7f327e263820>,136,18,[8 1],137,-1,158,-1,140
1,<environment.Job instance at 0x7f327e24f960>,118,18,[5 5],119,-1,158,-1,140
1,<environment.Job instance at 0x7f327e2636e0>,134,17,[1 9],135,-1,157,-1,140
1,<environment.Job instance at 0x7f327e263a50>,139,28,[6 1],140,-1,171,-1,143
1,<environment.Job instance at 0x7f327e242050>,144,18,[5 5],145,-1,163,-1,145
1,<environment.Job instance at 0x7f327e24b640>,99,17,[2 6],100,-1,164,-1,147
1,<environment.Job instance at 0x7f327e263e60>,142,18,[ 2 12],143,-1,165,-1,147
1,<environment.Job instance at 0x7f327e2420f0>,146,17,[2 6],147,-1,164,-1,147
1,<environment.Job instance at 0x7f327e242280>,148,18,[5 3],149,-1,167,-1,149
1,<environment.Job instance at 0x7f327e56eeb0>,3,1,[12  4],4,-1,5,-1,4
1,<environment.Job instance at 0x7f327e24ce60>,10,2,[ 2 12],11,-1,13,-1,11
1,<environment.Job instance at 0x7f327e256640>,15,23,[8 4],16,-1,49,-1,26
1,<environment.Job instance at 0x7f327e24f6e0>,24,15,[11  1],25,-1,60,-1,45
1,<environment.Job instance at 0x7f327e611320>,31,20,[ 5 13],32,-1,87,-1,67
1,<environment.Job instance at 0x7f327e611a50>,40,24,[7 2],41,-1,121,-1,97
1,<environment.Job instance at 0x7f327e611640>,45,15,[ 1 12],46,-1,131,-1,116
1,<environment.Job instance at 0x7f327de6ceb0>,58,2,[ 1 13],59,-1,170,-1,168
1,<environment.Job instance at 0x7f327de6ccd0>,60,28,[ 2 14],61,-1,202,-1,174
1,<environment.Job instance at 0x7f327de6ce10>,61,28,[5 1],62,-1,202,-1,174
1,<environment.Job instance at 0x7f327d48e190>,73,23,[7 4],74,-1,236,-1,213
1,<environment.Job instance at 0x7f327d48eaa0>,78,18,[13  5],79,-1,244,-1,226
1,<environment.Job instance at 0x7f327e136280>,83,3,[13  5],84,-1,253,-1,250
1,<environment.Job instance at 0x7f327e136d20>,86,27,[5 2],87,-1,290,-1,263
1,<environment.Job instance at 0x7f327e1360f0>,87,14,[ 3 14],88,-1,277,-1,263
1,<environment.Job instance at 0x7f327de225f0>,104,28,[4 5],105,-1,359,-1,331
1,<environment.Job instance at 0x7f327d89aeb0>,107,2,[ 5 13],108,-1,334,-1,332
1,<environment.Job instance at 0x7f327e125410>,111,25,[10  1],112,-1,371,-1,346
1,<environment.Job instance at 0x7f327d7a9280>,127,25,[9 4],128,-1,447,-1,422
1,<environment.Job instance at 0x7f327de85d70>,139,28,[6 1],140,-1,504,-1,476
1,<environment.Job instance at 0x7f327de6e460>,142,18,[ 2 12],143,-1,496,-1,478
1,<environment.Job instance at 0x7f327e105a50>,1,13,[10  4],2,-1,16,-1,3
1,<environment.Job instance at 0x7f327d3ec230>,3,24,[5 3],4,-1,28,-1,4
1,<environment.Job instance at 0x7f327d42e8c0>,2,15,[8 4],3,-1,19,-1,4
1,<environment.Job instance at 0x7f327e0f5960>,6,17,[2 5],7,-1,26,-1,9
1,<environment.Job instance at 0x7f327e0f50f0>,8,12,[9 3],9,-1,21,-1,9
1,<environment.Job instance at 0x7f327e0f5410>,11,28,[9 4],12,-1,40,-1,12
1,<environment.Job instance at 0x7f327e0f5c80>,14,12,[9 1],15,-1,28,-1,16
1,<environment.Job instance at 0x7f327e0f5230>,17,17,[1 9],18,-1,35,-1,18
1,<environment.Job instance at 0x7f327e2a0370>,18,19,[ 3 11],19,-1,41,-1,22
1,<environment.Job instance at 0x7f327e0f50a0>,19,18,[7 5],20,-1,43,-1,25
1,<environment.Job instance at 0x7f327e2a0230>,24,17,[7 2],25,-1,42,-1,25
1,<environment.Job instance at 0x7f327e2a0f50>,26,21,[5 5],27,-1,48,-1,27
1,<environment.Job instance at 0x7f327d8b8a50>,28,13,[4 6],29,-1,42,-1,29
1,<environment.Job instance at 0x7f327d8b8780>,29,15,[10  2],30,-1,45,-1,30
1,<environment.Job instance at 0x7f327e2a0140>,21,14,[5 8],22,-1,45,-1,31
1,<environment.Job instance at 0x7f327d8b85f0>,30,12,[7 4],31,-1,46,-1,34
1,<environment.Job instance at 0x7f327d8b8b90>,34,16,[7 4],35,-1,51,-1,35
1,<environment.Job instance at 0x7f327d8b8f50>,38,17,[9 5],39,-1,59,-1,42
1,<environment.Job instance at 0x7f327e286e60>,43,17,[9 1],44,-1,61,-1,44
1,<environment.Job instance at 0x7f327e286140>,44,22,[4 9],45,-1,67,-1,45
1,<environment.Job instance at 0x7f327e286cd0>,46,21,[5 5],47,-1,68,-1,47
1,<environment.Job instance at 0x7f327e286b90>,49,15,[3 9],50,-1,65,-1,50
1,<environment.Job instance at 0x7f3286c72410>,50,15,[5 5],51,-1,67,-1,52
1,<environment.Job instance at 0x7f3286c727d0>,51,3,[8 5],52,-1,59,-1,56
1,<environment.Job instance at 0x7f3286c72c30>,55,25,[1 6],56,-1,81,-1,56
1,<environment.Job instance at 0x7f327e2868c0>,41,18,[4 7],42,-1,75,-1,57
1,<environment.Job instance at 0x7f327d735c30>,62,20,[ 5 10],63,-1,89,-1,69
1,<environment.Job instance at 0x7f3286c72af0>,54,15,[10  2],55,-1,86,-1,71
1,<environment.Job instance at 0x7f327d7357d0>,67,12,[5 9],68,-1,83,-1,71
1,<environment.Job instance at 0x7f327d7355a0>,70,12,[5 6],71,-1,83,-1,71
1,<environment.Job instance at 0x7f327d20deb0>,71,16,[3 9],72,-1,88,-1,72
1,<environment.Job instance at 0x7f327d20d690>,75,17,[10  3],76,-1,100,-1,83
1,<environment.Job instance at 0x7f327d20d9b0>,76,18,[6 4],77,-1,101,-1,83
1,<environment.Job instance at 0x7f327d20d910>,77,24,[5 9],78,-1,107,-1,83
1,<environment.Job instance at 0x7f327d5c8dc0>,78,14,[6 4],79,-1,97,-1,83
1,<environment.Job instance at 0x7f327d4510a0>,81,28,[3 6],82,-1,111,-1,83
1,<environment.Job instance at 0x7f327d451780>,82,14,[ 4 10],83,-1,97,-1,83
1,<environment.Job instance at 0x7f327e38fb90>,85,16,[7 3],86,-1,102,-1,86
1,<environment.Job instance at 0x7f3286c37b90>,87,16,[1 8],88,-1,105,-1,89
1,<environment.Job instance at 0x7f327e639fa0>,60,27,[11  2],61,-1,116,-1,89
1,<environment.Job instance at 0x7f327d735b40>,65,24,[8 3],66,-1,114,-1,90
1,<environment.Job instance at 0x7f3286c37460>,89,26,[2 6],90,-1,116,-1,90
1,<environment.Job instance at 0x7f327e395c30>,90,20,[9 3],91,-1,112,-1,92
1,<environment.Job instance at 0x7f327cf3e550>,92,14,[9 2],93,-1,107,-1,93
1,<environment.Job instance at 0x7f327e6137d0>,93,16,[2 6],94,-1,110,-1,94
1,<environment.Job instance at 0x7f327cf275a0>,91,15,[8 4],92,-1,111,-1,96
1,<environment.Job instance at 0x7f327e3bd690>,95,17,[5 3],96,-1,117,-1,100
1,<environment.Job instance at 0x7f327def2820>,100,13,[4 6],101,-1,114,-1,101
1,<environment.Job instance at 0x7f327d7b6870>,102,16,[9 2],103,-1,121,-1,105
1,<environment.Job instance at 0x7f327d609190>,98,26,[8 2],99,-1,131,-1,105
1,<environment.Job instance at 0x7f327e03b550>,106,17,[3 7],107,-1,124,-1,107
1,<environment.Job instance at 0x7f327d6a9c30>,107,12,[1 6],108,-1,120,-1,108
1,<environment.Job instance at 0x7f327e03b3c0>,103,18,[4 6],104,-1,132,-1,114
1,<environment.Job instance at 0x7f327e03b8c0>,105,25,[ 3 14],106,-1,139,-1,114
1,<environment.Job instance at 0x7f327d02e730>,112,18,[7 4],113,-1,134,-1,116
1,<environment.Job instance at 0x7f327d66ad70>,122,14,[ 2 10],123,-1,147,-1,133
1,<environment.Job instance at 0x7f327d66a280>,124,13,[10  5],125,-1,147,-1,134
1,<environment.Job instance at 0x7f327d632cd0>,113,14,[ 2 10],114,-1,148,-1,134
1,<environment.Job instance at 0x7f327d66aeb0>,125,19,[1 5],126,-1,154,-1,135
1,<environment.Job instance at 0x7f327d561c80>,7,2,[11  4],8,-1,10,-1,8
1,<environment.Job instance at 0x7f327e0f5c30>,3,24,[5 3],4,-1,39,-1,15
1,<environment.Job instance at 0x7f327d5f2c30>,13,16,[ 1 12],14,-1,35,-1,19
1,<environment.Job instance at 0x7f327e3bdb40>,11,28,[9 4],12,-1,59,-1,31
1,<environment.Job instance at 0x7f327d43f780>,18,19,[ 3 11],19,-1,51,-1,32
1,<environment.Job instance at 0x7f327de85320>,37,13,[14  4],38,-1,128,-1,115
1,<environment.Job instance at 0x7f327d048d70>,53,2,[13  2],54,-1,172,-1,170
1,<environment.Job instance at 0x7f327d45b280>,55,25,[1 6],56,-1,207,-1,182
1,<environment.Job instance at 0x7f327d862b90>,60,27,[11  2],61,-1,225,-1,198
1,<environment.Job instance at 0x7f327de225f0>,65,24,[8 3],66,-1,235,-1,211
1,<environment.Job instance at 0x7f327e136500>,77,24,[5 9],78,-1,278,-1,254
1,<environment.Job instance at 0x7f327e1360f0>,81,28,[3 6],82,-1,287,-1,259
1,<environment.Job instance at 0x7f327de6cb90>,89,26,[2 6],90,-1,319,-1,293
1,<environment.Job instance at 0x7f327de6c550>,97,1,[ 1 13],98,-1,317,-1,316
1,<environment.Job instance at 0x7f327de6c2d0>,98,26,[8 2],99,-1,356,-1,330
1,<environment.Job instance at 0x7f327e263140>,105,25,[ 3 14],106,-1,372,-1,347
1,<environment.Job instance at 0x7f327e24bc30>,111,3,[ 4 13],112,-1,372,-1,369
1,<environment.Job instance at 0x7f327e24b910>,114,27,[13  3],115,-1,406,-1,379
1,<environment.Job instance at 0x7f327d25cb40>,134,27,[6 1],135,-1,508,-1,481
1,<environment.Job instance at 0x7f327d25c730>,136,17,[ 5 11],137,-1,498,-1,481
1,<environment.Job instance at 0x7f327d25c0f0>,141,24,[14  3],142,-1,520,-1,496
1,<environment.Job instance at 0x7f327dca1730>,143,24,[10  2],144,-1,536,-1,512
1,<environment.Job instance at 0x7f327db10050>,0,18,[6 4],1,-1,19,-1,1
1,<environment.Job instance at 0x7f327d0560f0>,5,16,[7 3],6,-1,24,-1,8
1,<environment.Job instance at 0x7f327d0567d0>,8,13,[8 5],9,-1,22,-1,9
1,<environment.Job instance at 0x7f327d056b90>,9,13,[8 2],10,-1,23,-1,10
1,<environment.Job instance at 0x7f327d056320>,7,13,[10  4],8,-1,23,-1,10
1,<environment.Job instance at 0x7f327d0560a0>,11,16,[ 5 11],12,-1,29,-1,13
1,<environment.Job instance at 0x7f327d0563c0>,12,16,[5 4],13,-1,30,-1,14
1,<environment.Job instance at 0x7f327d056690>,15,27,[4 5],16,-1,43,-1,16
1,<environment.Job instance at 0x7f327d056190>,17,18,[1 6],18,-1,36,-1,18
1,<environment.Job instance at 0x7f327d072780>,20,17,[9 2],21,-1,40,-1,23
1,<environment.Job instance at 0x7f327d072820>,26,25,[7 3],27,-1,52,-1,27
1,<environment.Job instance at 0x7f327d072af0>,22,14,[7 3],23,-1,44,-1,30
1,<environment.Job instance at 0x7f327d072d20>,30,26,[6 4],31,-1,57,-1,31
1,<environment.Job instance at 0x7f327d072a00>,33,14,[ 4 10],34,-1,48,-1,34
1,<environment.Job instance at 0x7f327d07f3c0>,35,14,[5 7],36,-1,50,-1,36
1,<environment.Job instance at 0x7f327d07fd20>,36,16,[9 2],37,-1,53,-1,37
1,<environment.Job instance at 0x7f327d07ff50>,37,21,[9 4],38,-1,59,-1,38
1,<environment.Job instance at 0x7f327d07fbe0>,38,21,[5 1],39,-1,61,-1,40
1,<environment.Job instance at 0x7f327d0476e0>,45,16,[4 9],46,-1,62,-1,46
1,<environment.Job instance at 0x7f327d047eb0>,46,18,[5 5],47,-1,65,-1,47
1,<environment.Job instance at 0x7f327d047550>,49,20,[5 9],50,-1,70,-1,50
1,<environment.Job instance at 0x7f327d047320>,50,17,[ 5 10],51,-1,68,-1,51
1,<environment.Job instance at 0x7f327d047c30>,51,14,[10  1],52,-1,67,-1,53
1,<environment.Job instance at 0x7f327d0552d0>,59,2,[6 1],60,-1,62,-1,60
1,<environment.Job instance at 0x7f327d055a50>,60,2,[6 1],61,-1,63,-1,61
1,<environment.Job instance at 0x7f327d0550f0>,61,3,[7 4],62,-1,65,-1,62
1,<environment.Job instance at 0x7f327d055370>,62,18,[3 7],63,-1,81,-1,63
1,<environment.Job instance at 0x7f327d055f50>,63,12,[5 4],64,-1,76,-1,64
1,<environment.Job instance at 0x7f327d0557d0>,65,13,[9 1],66,-1,79,-1,66
1,<environment.Job instance at 0x7f327d055af0>,67,15,[3 6],68,-1,83,-1,68
1,<environment.Job instance at 0x7f327d06bcd0>,68,14,[ 1 10],69,-1,83,-1,69
1,<environment.Job instance at 0x7f327d06b640>,70,25,[5 3],71,-1,96,-1,71
1,<environment.Job instance at 0x7f327d06b5f0>,71,16,[11  2],72,-1,88,-1,72
1,<environment.Job instance at 0x7f327d06be10>,73,13,[5 6],74,-1,87,-1,74
1,<environment.Job instance at 0x7f327d06b410>,74,13,[3 6],75,-1,88,-1,75
1,<environment.Job instance at 0x7f327d06b3c0>,76,13,[8 1],77,-1,90,-1,77
1,<environment.Job instance at 0x7f327d06b190>,78,16,[10  3],79,-1,95,-1,79
1,<environment.Job instance at 0x7f327d06bc30>,79,28,[3 9],80,-1,108,-1,80
1,<environment.Job instance at 0x7f327db0fa50>,82,23,[3 7],83,-1,106,-1,83
1,<environment.Job instance at 0x7f327db0f5a0>,84,17,[2 7],85,-1,102,-1,85
1,<environment.Job instance at 0x7f327db0fe60>,87,16,[5 4],88,-1,104,-1,88
1,<environment.Job instance at 0x7f327db0f7d0>,88,17,[6 5],89,-1,106,-1,89
1,<environment.Job instance at 0x7f327db0f550>,89,18,[5 1],90,-1,108,-1,90
1,<environment.Job instance at 0x7f327db0f0f0>,90,16,[1 7],91,-1,107,-1,91
1,<environment.Job instance at 0x7f327db0faf0>,91,12,[2 6],92,-1,104,-1,92
1,<environment.Job instance at 0x7f327d047370>,52,18,[3 8],53,-1,110,-1,92
1,<environment.Job instance at 0x7f327e0adfa0>,96,15,[5 6],97,-1,112,-1,97
1,<environment.Job instance at 0x7f327e0add70>,99,12,[3 9],100,-1,112,-1,100
1,<environment.Job instance at 0x7f327e0ad5a0>,100,15,[1 8],101,-1,116,-1,101
1,<environment.Job instance at 0x7f327e0ad870>,101,16,[5 5],102,-1,118,-1,102
1,<environment.Job instance at 0x7f327e0ad7d0>,102,18,[2 5],103,-1,121,-1,103
1,<environment.Job instance at 0x7f327d1020f0>,115,16,[10  3],116,-1,132,-1,116
1,<environment.Job instance at 0x7f327de22410>,119,17,[9 4],120,-1,144,-1,127
1,<environment.Job instance at 0x7f327d513f50>,120,13,[10  1],121,-1,142,-1,129
1,<environment.Job instance at 0x7f327e6270a0>,131,16,[4 6],132,-1,149,-1,133
1,<environment.Job instance at 0x7f327d055820>,10,13,[12  1],11,-1,34,-1,21
1,<environment.Job instance at 0x7f327d0553c0>,11,16,[ 5 11],12,-1,37,-1,21
1,<environment.Job instance at 0x7f327db0f780>,15,27,[4 5],16,-1,57,-1,30
1,<environment.Job instance at 0x7f32872ee460>,16,1,[12  2],17,-1,31,-1,30
1,<environment.Job instance at 0x7f327de6c4b0>,26,25,[7 3],27,-1,82,-1,57
1,<environment.Job instance at 0x7f327d014780>,30,26,[6 4],31,-1,102,-1,76
1,<environment.Job instance at 0x7f327de932d0>,64,1,[13  5],65,-1,175,-1,174
1,<environment.Job instance at 0x7f327d92f0f0>,70,25,[5 3],71,-1,219,-1,194
1,<environment.Job instance at 0x7f327e27cb90>,71,16,[11  2],72,-1,210,-1,194
1,<environment.Job instance at 0x7f3286c3e870>,79,28,[3 9],80,-1,258,-1,230
1,<environment.Job instance at 0x7f327d0f4cd0>,82,23,[3 7],83,-1,254,-1,231
1,<environment.Job instance at 0x7f327df16a50>,86,3,[ 5 14],87,-1,239,-1,236
1,<environment.Job instance at 0x7f327dbfb280>,97,16,[11  1],98,-1,295,-1,279
1,<environment.Job instance at 0x7f327d5985a0>,107,16,[ 5 13],108,-1,333,-1,317
1,<environment.Job instance at 0x7f327daf3690>,109,2,[13  4],110,-1,320,-1,318
1,<environment.Job instance at 0x7f327daf36e0>,113,20,[ 5 12],114,-1,340,-1,320
1,<environment.Job instance at 0x7f327d1ed780>,114,2,[ 5 11],115,-1,322,-1,320
1,<environment.Job instance at 0x7f327d363550>,121,2,[ 5 11],122,-1,345,-1,343
1,<environment.Job instance at 0x7f327d94c190>,129,13,[ 4 14],130,-1,376,-1,363
1,<environment.Job instance at 0x7f327e304370>,136,16,[13  1],137,-1,398,-1,382
1,<environment.Job instance at 0x7f327d46b410>,146,27,[2 9],147,-1,457,-1,430
1,<environment.Job instance at 0x7f327d3f0050>,8,16,[9 1],9,-1,28,-1,12
1,<environment.Job instance at 0x7f327e610690>,14,16,[11  4],15,-1,31,-1,15
1,<environment.Job instance at 0x7f327df4c550>,15,14,[1 7],16,-1,30,-1,16
1,<environment.Job instance at 0x7f327df4cb40>,17,18,[1 9],18,-1,36,-1,18
1,<environment.Job instance at 0x7f327cf4ee10>,22,18,[10  5],23,-1,57,-1,39
1,<environment.Job instance at 0x7f327d3f07d0>,11,27,[8 5],12,-1,66,-1,39
1,<environment.Job instance at 0x7f327cf4e820>,32,18,[9 1],33,-1,57,-1,39
1,<environment.Job instance at 0x7f327d3f0320>,7,15,[ 5 12],8,-1,89,-1,74
1,<environment.Job instance at 0x7f327dceed20>,38,3,[3 6],39,-1,77,-1,74
1,<environment.Job instance at 0x7f327cf4ec30>,25,18,[5 6],26,-1,93,-1,75
1,<environment.Job instance at 0x7f327dceec30>,39,12,[5 8],40,-1,87,-1,75
1,<environment.Job instance at 0x7f327dcee550>,34,15,[2 7],35,-1,90,-1,75
1,<environment.Job instance at 0x7f327dcee690>,41,3,[10  1],42,-1,78,-1,75
1,<environment.Job instance at 0x7f327dcee6e0>,42,18,[1 9],43,-1,93,-1,75
1,<environment.Job instance at 0x7f327dcee640>,44,18,[7 1],45,-1,93,-1,75
1,<environment.Job instance at 0x7f327cfa5c30>,53,17,[13  5],54,-1,128,-1,111
1,<environment.Job instance at 0x7f327cfa5190>,54,17,[8 5],55,-1,128,-1,111
1,<environment.Job instance at 0x7f327dfcd2d0>,66,15,[ 3 10],67,-1,155,-1,140
1,<environment.Job instance at 0x7f327dfcdaf0>,68,13,[6 2],69,-1,153,-1,140
1,<environment.Job instance at 0x7f327dfcd8c0>,64,18,[ 4 10],65,-1,158,-1,140
1,<environment.Job instance at 0x7f327dfcd6e0>,76,16,[5 9],77,-1,177,-1,161
1,<environment.Job instance at 0x7f327d790280>,88,12,[10  3],89,-1,231,-1,219
1,<environment.Job instance at 0x7f327cff7e60>,90,20,[ 4 10],91,-1,239,-1,219
1,<environment.Job instance at 0x7f327cff7820>,93,14,[ 4 10],94,-1,234,-1,220
1,<environment.Job instance at 0x7f327e126640>,107,18,[6 1],108,-1,276,-1,258
1,<environment.Job instance at 0x7f327cff7230>,97,24,[4 8],98,-1,282,-1,258
1,<environment.Job instance at 0x7f327cfa5d70>,51,16,[ 5 12],52,-1,328,-1,312
1,<environment.Job instance at 0x7f327cf4ea50>,24,17,[10  5],25,-1,329,-1,312
1,<environment.Job instance at 0x7f327e08cfa0>,122,18,[6 5],123,-1,330,-1,312
1,<environment.Job instance at 0x7f327e1ceeb0>,115,14,[12  1],116,-1,326,-1,312
1,<environment.Job instance at 0x7f327e126410>,106,16,[4 9],107,-1,329,-1,313
1,<environment.Job instance at 0x7f327e08cbe0>,126,16,[4 8],127,-1,329,-1,313
1,<environment.Job instance at 0x7f327daf7cd0>,128,15,[1 6],129,-1,330,-1,315
1,<environment.Job instance at 0x7f327dd09410>,124,14,[ 5 10],125,-1,329,-1,315
1,<environment.Job instance at 0x7f327da955a0>,133,14,[ 2 11],134,-1,355,-1,341
1,<environment.Job instance at 0x7f327db441e0>,140,15,[4 7],141,-1,358,-1,343
1,<environment.Job instance at 0x7f327ce56c30>,142,17,[ 1 10],143,-1,361,-1,344
1,<environment.Job instance at 0x7f3286cc95a0>,143,15,[8 4],144,-1,359,-1,344
1,<environment.Job instance at 0x7f327d3f0140>,3,14,[14  4],4,-1,18,-1,4
1,<environment.Job instance at 0x7f327cfa52d0>,5,3,[ 1 13],6,-1,9,-1,6
1,<environment.Job instance at 0x7f327d064cd0>,6,2,[14  2],7,-1,9,-1,7
1,<environment.Job instance at 0x7f327dfcd640>,7,15,[ 5 12],8,-1,23,-1,8
1,<environment.Job instance at 0x7f327d790dc0>,10,2,[14  4],11,-1,13,-1,11
1,<environment.Job instance at 0x7f327d790820>,11,27,[8 5],12,-1,52,-1,25
1,<environment.Job instance at 0x7f327e40c550>,14,16,[11  4],15,-1,41,-1,25
1,<environment.Job instance at 0x7f327dc3c500>,18,16,[13  2],19,-1,43,-1,27
1,<environment.Job instance at 0x7f327dd6db40>,21,14,[ 2 12],22,-1,44,-1,30
1,<environment.Job instance at 0x7f327dbcb9b0>,23,26,[7 1],24,-1,59,-1,33
1,<environment.Job instance at 0x7f327e6b65a0>,49,25,[3 6],50,-1,165,-1,140
1,<environment.Job instance at 0x7f327dd28500>,51,16,[ 5 12],52,-1,156,-1,140
1,<environment.Job instance at 0x7f327e195910>,53,17,[13  5],54,-1,159,-1,142
1,<environment.Job instance at 0x7f327e6fc7d0>,65,2,[ 3 11],66,-1,193,-1,191
1,<environment.Job instance at 0x7f327d8cd3c0>,72,3,[ 4 11],73,-1,212,-1,209
1,<environment.Job instance at 0x7f327dca4e10>,80,3,[ 3 12],81,-1,249,-1,246
1,<environment.Job instance at 0x7f327e0b1730>,78,24,[5 6],79,-1,278,-1,254
1,<environment.Job instance at 0x7f327e0b19b0>,82,14,[14  5],83,-1,268,-1,254
1,<environment.Job instance at 0x7f327e38af00>,96,24,[4 5],97,-1,332,-1,308
1,<environment.Job instance at 0x7f327e27cbe0>,97,24,[4 8],98,-1,332,-1,308
1,<environment.Job instance at 0x7f327e5124b0>,112,23,[6 2],113,-1,371,-1,348
1,<environment.Job instance at 0x7f327d9b34b0>,114,3,[ 1 12],115,-1,351,-1,348
1,<environment.Job instance at 0x7f327d82ebe0>,115,14,[12  1],116,-1,362,-1,348
1,<environment.Job instance at 0x7f327d1023c0>,123,1,[11  3],124,-1,368,-1,367
1,<environment.Job instance at 0x7f327dfb6d20>,125,28,[ 4 12],126,-1,396,-1,368
1,<environment.Job instance at 0x7f327d5980f0>,129,1,[ 4 13],130,-1,396,-1,395
1,<environment.Job instance at 0x7f327e0368c0>,133,14,[ 2 11],134,-1,422,-1,408
1,<environment.Job instance at 0x7f327cf48500>,145,24,[5 2],146,-1,483,-1,459
1,<environment.Job instance at 0x7f327e412820>,0,25,[6 2],1,-1,26,-1,1
1,<environment.Job instance at 0x7f327e412370>,1,17,[9 4],2,-1,19,-1,2
1,<environment.Job instance at 0x7f327e0d6a00>,6,12,[9 1],7,-1,21,-1,9
1,<environment.Job instance at 0x7f327d42f780>,8,18,[10  4],9,-1,27,-1,9
1,<environment.Job instance at 0x7f327d42fb40>,10,25,[5 5],11,-1,36,-1,11
1,<environment.Job instance at 0x7f327d42fc30>,11,13,[9 3],12,-1,29,-1,16
1,<environment.Job instance at 0x7f327d42f190>,15,19,[2 8],16,-1,35,-1,16
1,<environment.Job instance at 0x7f327da69230>,21,17,[ 2 10],22,-1,40,-1,23
1,<environment.Job instance at 0x7f327da69410>,23,12,[3 9],24,-1,36,-1,24
1,<environment.Job instance at 0x7f327da69550>,22,16,[2 8],23,-1,40,-1,24
1,<environment.Job instance at 0x7f327da69690>,25,18,[4 6],26,-1,44,-1,26
1,<environment.Job instance at 0x7f327da69b90>,29,17,[ 1 10],30,-1,47,-1,30
1,<environment.Job instance at 0x7f327da69820>,30,15,[8 4],31,-1,46,-1,31
1,<environment.Job instance at 0x7f327da69c30>,31,12,[8 1],32,-1,45,-1,33
1,<environment.Job instance at 0x7f327da69e10>,34,19,[ 5 10],35,-1,54,-1,35
1,<environment.Job instance at 0x7f327da79050>,36,15,[3 9],37,-1,52,-1,37
1,<environment.Job instance at 0x7f327da79190>,37,27,[8 5],38,-1,65,-1,38
1,<environment.Job instance at 0x7f327da79460>,40,13,[8 3],41,-1,54,-1,41
1,<environment.Job instance at 0x7f327da79640>,45,15,[10  1],46,-1,76,-1,61
1,<environment.Job instance at 0x7f327e4e3730>,60,18,[3 5],61,-1,82,-1,64
1,<environment.Job instance at 0x7f327e4e3370>,54,16,[5 8],55,-1,80,-1,64
1,<environment.Job instance at 0x7f327e4e39b0>,61,15,[3 7],62,-1,85,-1,70
1,<environment.Job instance at 0x7f327da79dc0>,50,20,[8 5],51,-1,91,-1,71
1,<environment.Job instance at 0x7f327e4e35f0>,63,14,[6 2],64,-1,85,-1,71
1,<environment.Job instance at 0x7f327e4e3320>,55,25,[4 5],56,-1,96,-1,71
1,<environment.Job instance at 0x7f327e4e3fa0>,68,12,[6 4],69,-1,88,-1,76
1,<environment.Job instance at 0x7f327e4c9460>,72,18,[4 8],73,-1,94,-1,76
1,<environment.Job instance at 0x7f327e4c9410>,71,13,[3 5],72,-1,90,-1,77
1,<environment.Job instance at 0x7f327e0e9500>,76,13,[6 4],77,-1,90,-1,77
1,<environment.Job instance at 0x7f327e0e9730>,78,12,[10  4],79,-1,92,-1,80
1,<environment.Job instance at 0x7f327e0e9dc0>,79,12,[5 8],80,-1,92,-1,80
1,<environment.Job instance at 0x7f327daee370>,91,17,[7 4],92,-1,109,-1,92
1,<environment.Job instance at 0x7f327df10fa0>,93,14,[ 5 10],94,-1,114,-1,100
1,<environment.Job instance at 0x7f327e0e9690>,77,26,[ 3 10],78,-1,127,-1,101
1,<environment.Job instance at 0x7f327d43c5a0>,90,12,[2 5],91,-1,114,-1,102
1,<environment.Job instance at 0x7f327d86f6e0>,96,16,[3 8],97,-1,118,-1,102
1,<environment.Job instance at 0x7f327e565af0>,100,15,[5 5],101,-1,123,-1,108
1,<environment.Job instance at 0x7f327e557460>,102,17,[5 7],103,-1,125,-1,108
1,<environment.Job instance at 0x7f327dae7eb0>,108,12,[7 5],109,-1,121,-1,109
1,<environment.Job instance at 0x7f327e5454b0>,110,18,[9 3],111,-1,129,-1,111
1,<environment.Job instance at 0x7f327e545960>,111,17,[9 4],112,-1,129,-1,112
1,<environment.Job instance at 0x7f327e557140>,104,12,[7 1],105,-1,128,-1,116
1,<environment.Job instance at 0x7f327e574820>,116,17,[4 8],117,-1,134,-1,117
1,<environment.Job instance at 0x7f327e5748c0>,118,16,[8 4],119,-1,135,-1,119
1,<environment.Job instance at 0x7f327e574500>,119,17,[5 6],120,-1,137,-1,120
1,<environment.Job instance at 0x7f327e574d20>,120,15,[3 7],121,-1,137,-1,122
1,<environment.Job instance at 0x7f327da69a00>,28,16,[14  4],29,-1,223,-1,207
1,<environment.Job instance at 0x7f327da69960>,0,25,[6 2],1,-1,26,-1,1
1,<environment.Job instance at 0x7f327e4e3230>,9,13,[ 1 11],10,-1,32,-1,19
1,<environment.Job instance at 0x7f327db58500>,10,25,[5 5],11,-1,45,-1,20
1,<environment.Job instance at 0x7f327d420d20>,13,3,[ 4 11],14,-1,24,-1,21
1,<environment.Job instance at 0x7f327d82ec30>,28,16,[14  4],29,-1,86,-1,70
1,<environment.Job instance at 0x7f327e5f1230>,37,27,[8 5],38,-1,133,-1,106
1,<environment.Job instance at 0x7f327e1bacd0>,39,3,[ 1 12],40,-1,109,-1,106
1,<environment.Job instance at 0x7f327df74d70>,43,17,[13  3],44,-1,135,-1,118
1,<environment.Job instance at 0x7f327de93f50>,44,3,[13  1],45,-1,121,-1,118
1,<environment.Job instance at 0x7f327d90b640>,55,25,[4 5],56,-1,172,-1,147
1,<environment.Job instance at 0x7f327dccad20>,58,1,[ 4 14],59,-1,164,-1,163
1,<environment.Job instance at 0x7f327d89e280>,70,2,[13  2],71,-1,193,-1,191
1,<environment.Job instance at 0x7f327e195b90>,74,1,[12  5],75,-1,206,-1,205
1,<environment.Job instance at 0x7f327e0baaa0>,77,26,[ 3 10],78,-1,236,-1,210
1,<environment.Job instance at 0x7f327e660b40>,81,3,[12  2],82,-1,228,-1,225
1,<environment.Job instance at 0x7f327dc3caa0>,94,3,[14  3],95,-1,250,-1,247
1,<environment.Job instance at 0x7f3286c360f0>,106,1,[11  3],107,-1,296,-1,295
1,<environment.Job instance at 0x7f327dcd2870>,113,14,[14  1],114,-1,335,-1,321
1,<environment.Job instance at 0x7f327d8b89b0>,122,17,[ 5 14],123,-1,385,-1,368
1,<environment.Job instance at 0x7f327d7098c0>,133,15,[ 2 12],134,-1,415,-1,400
1,<environment.Job instance at 0x7f327d732820>,138,2,[13  1],139,-1,424,-1,422
1,<environment.Job instance at 0x7f327d7327d0>,141,26,[7 2],142,-1,472,-1,446
1,<environment.Job instance at 0x7f327cfe0fa0>,1,23,[5 9],2,-1,25,-1,2
1,<environment.Job instance at 0x7f327e43a960>,7,22,[2 9],8,-1,33,-1,11
1,<environment.Job instance at 0x7f327e42c0a0>,11,16,[5 2],12,-1,28,-1,12
1,<environment.Job instance at 0x7f327e42cd20>,12,2,[5 4],13,-1,15,-1,13
1,<environment.Job instance at 0x7f327e42c320>,13,15,[ 3 10],14,-1,29,-1,14
1,<environment.Job instance at 0x7f327e42c1e0>,14,12,[7 5],15,-1,27,-1,15
1,<environment.Job instance at 0x7f327e42cb40>,15,14,[7 5],16,-1,30,-1,16
1,<environment.Job instance at 0x7f327e42c870>,16,20,[8 2],17,-1,37,-1,17
1,<environment.Job instance at 0x7f327e42c190>,17,16,[8 4],18,-1,34,-1,18
1,<environment.Job instance at 0x7f327e42c780>,18,26,[2 5],19,-1,45,-1,19
1,<environment.Job instance at 0x7f327e42c690>,19,1,[9 3],20,-1,21,-1,20
1,<environment.Job instance at 0x7f327e42c4b0>,20,15,[10  5],21,-1,36,-1,21
1,<environment.Job instance at 0x7f327cfae0f0>,22,12,[8 2],23,-1,35,-1,23
1,<environment.Job instance at 0x7f327cfae3c0>,23,12,[8 2],24,-1,36,-1,24
1,<environment.Job instance at 0x7f327cf4e460>,26,24,[2 9],27,-1,51,-1,27
1,<environment.Job instance at 0x7f327cf4e2d0>,27,12,[ 2 12],28,-1,40,-1,28
1,<environment.Job instance at 0x7f327cf6d0f0>,31,16,[8 4],32,-1,48,-1,32
1,<environment.Job instance at 0x7f327d468f50>,35,15,[9 1],36,-1,51,-1,36
1,<environment.Job instance at 0x7f327d468aa0>,37,16,[8 4],38,-1,54,-1,38
1,<environment.Job instance at 0x7f32871460f0>,40,15,[1 8],41,-1,56,-1,41
1,<environment.Job instance at 0x7f327e41dfa0>,43,13,[10  3],44,-1,57,-1,44
1,<environment.Job instance at 0x7f327cd96c80>,47,14,[4 7],48,-1,62,-1,48
1,<environment.Job instance at 0x7f327cd96960>,50,12,[9 4],51,-1,63,-1,51
1,<environment.Job instance at 0x7f327cd96550>,51,23,[1 8],52,-1,75,-1,52
1,<environment.Job instance at 0x7f327cd96870>,52,14,[3 7],53,-1,67,-1,53
1,<environment.Job instance at 0x7f327cd96640>,53,16,[ 5 10],54,-1,70,-1,54
1,<environment.Job instance at 0x7f327d3f0a00>,54,17,[3 5],55,-1,72,-1,55
1,<environment.Job instance at 0x7f327d3f0370>,55,15,[ 1 10],56,-1,71,-1,56
1,<environment.Job instance at 0x7f327d4655f0>,61,13,[5 8],62,-1,75,-1,62
1,<environment.Job instance at 0x7f327d465690>,62,14,[6 2],63,-1,77,-1,63
1,<environment.Job instance at 0x7f327d465230>,63,13,[6 5],64,-1,77,-1,64
1,<environment.Job instance at 0x7f327d465550>,66,25,[8 1],67,-1,92,-1,67
1,<environment.Job instance at 0x7f327e184e10>,67,18,[ 1 10],68,-1,86,-1,68
1,<environment.Job instance at 0x7f327d9ad640>,73,16,[9 5],74,-1,90,-1,74
1,<environment.Job instance at 0x7f327d9ad960>,74,28,[7 4],75,-1,103,-1,75
1,<environment.Job instance at 0x7f327d9ad370>,75,20,[7 2],76,-1,96,-1,76
1,<environment.Job instance at 0x7f327d9adf50>,76,14,[10  3],77,-1,91,-1,77
1,<environment.Job instance at 0x7f327d9ad690>,77,17,[5 6],78,-1,95,-1,78
1,<environment.Job instance at 0x7f327d9adcd0>,79,17,[5 2],80,-1,97,-1,80
1,<environment.Job instance at 0x7f327d9adf00>,81,17,[9 3],82,-1,99,-1,82
1,<environment.Job instance at 0x7f3286c378c0>,83,15,[2 7],84,-1,99,-1,84
1,<environment.Job instance at 0x7f3286c37b90>,84,19,[1 8],85,-1,104,-1,85
1,<environment.Job instance at 0x7f3286c370a0>,86,17,[8 4],87,-1,104,-1,87
1,<environment.Job instance at 0x7f3286c379b0>,90,13,[8 4],91,-1,104,-1,91
1,<environment.Job instance at 0x7f3286c37140>,92,12,[7 3],93,-1,105,-1,93
1,<environment.Job instance at 0x7f3286c37f00>,93,20,[4 5],94,-1,114,-1,94
1,<environment.Job instance at 0x7f3286c37640>,95,20,[5 5],96,-1,116,-1,96
1,<environment.Job instance at 0x7f3286c375a0>,96,18,[7 3],97,-1,115,-1,97
1,<environment.Job instance at 0x7f327e0d6e10>,98,18,[1 5],99,-1,117,-1,99
1,<environment.Job instance at 0x7f327e075730>,100,16,[ 2 10],101,-1,117,-1,101
1,<environment.Job instance at 0x7f327e075eb0>,101,18,[3 9],102,-1,120,-1,102
1,<environment.Job instance at 0x7f327e075500>,102,15,[5 5],103,-1,118,-1,103
1,<environment.Job instance at 0x7f327d76f4b0>,103,15,[1 5],104,-1,119,-1,104
1,<environment.Job instance at 0x7f327d76f370>,108,13,[8 5],109,-1,122,-1,109
1,<environment.Job instance at 0x7f327df74aa0>,109,15,[4 6],110,-1,125,-1,110
1,<environment.Job instance at 0x7f327d624a00>,111,25,[1 6],112,-1,137,-1,112
1,<environment.Job instance at 0x7f327e42cf00>,10,13,[5 8],11,-1,146,-1,133
1,<environment.Job instance at 0x7f327e5aa820>,127,28,[7 2],128,-1,171,-1,143
1,<environment.Job instance at 0x7f3286e83eb0>,126,14,[9 2],127,-1,157,-1,143
1,<environment.Job instance at 0x7f327dd6dc80>,129,27,[ 3 10],130,-1,170,-1,143
1,<environment.Job instance at 0x7f327d2a9fa0>,117,15,[1 8],118,-1,158,-1,143
1,<environment.Job instance at 0x7f327e577280>,130,13,[3 7],131,-1,157,-1,144
1,<environment.Job instance at 0x7f327de4d6e0>,113,26,[10  4],114,-1,170,-1,144
1,<environment.Job instance at 0x7f3286c371e0>,97,13,[14  1],98,-1,157,-1,144
1,<environment.Job instance at 0x7f3286c2a820>,134,21,[10  5],135,-1,165,-1,144
1,<environment.Job instance at 0x7f327ccf5190>,135,17,[9 3],136,-1,163,-1,146
1,<environment.Job instance at 0x7f327d94c550>,137,20,[10  2],138,-1,167,-1,147
1,<environment.Job instance at 0x7f3287217460>,132,26,[9 1],133,-1,173,-1,147
1,<environment.Job instance at 0x7f327de4d230>,112,12,[12  2],113,-1,159,-1,147
1,<environment.Job instance at 0x7f327dec2aa0>,141,13,[7 4],142,-1,161,-1,148
1,<environment.Job instance at 0x7f327ce45c80>,120,12,[10  4],121,-1,160,-1,148
1,<environment.Job instance at 0x7f327e624b90>,139,12,[5 1],140,-1,160,-1,148
1,<environment.Job instance at 0x7f327cd96690>,1,23,[5 9],2,-1,25,-1,2
1,<environment.Job instance at 0x7f327d4654b0>,3,3,[ 1 14],4,-1,7,-1,4
1,<environment.Job instance at 0x7f327d9adc80>,6,1,[ 3 13],7,-1,8,-1,7
1,<environment.Job instance at 0x7f327e27cb90>,18,26,[2 5],19,-1,60,-1,34
1,<environment.Job instance at 0x7f327d416cd0>,27,12,[ 2 12],28,-1,77,-1,65
1,<environment.Job instance at 0x7f327e545a00>,28,14,[13  4],29,-1,79,-1,65
1,<environment.Job instance at 0x7f327e545460>,29,20,[ 3 11],30,-1,85,-1,65
1,<environment.Job instance at 0x7f327d40deb0>,26,24,[2 9],27,-1,100,-1,76
1,<environment.Job instance at 0x7f327d910d20>,46,1,[ 3 11],47,-1,102,-1,101
1,<environment.Job instance at 0x7f327d05c640>,51,23,[1 8],52,-1,143,-1,120
1,<environment.Job instance at 0x7f327cfcbb90>,56,13,[ 5 11],57,-1,156,-1,143
1,<environment.Job instance at 0x7f327e611d20>,66,25,[8 1],67,-1,213,-1,188
1,<environment.Job instance at 0x7f327e2f7550>,74,28,[7 4],75,-1,226,-1,198
1,<environment.Job instance at 0x7f3286be7190>,97,13,[14  1],98,-1,289,-1,276
1,<environment.Job instance at 0x7f327e1da230>,106,2,[14  1],107,-1,321,-1,319
1,<environment.Job instance at 0x7f327dd28460>,111,25,[1 6],112,-1,362,-1,337
1,<environment.Job instance at 0x7f327e5b4b90>,112,12,[12  2],113,-1,349,-1,337
1,<environment.Job instance at 0x7f327e5b42d0>,113,26,[10  4],114,-1,366,-1,340
1,<environment.Job instance at 0x7f327d67b8c0>,115,24,[4 7],116,-1,371,-1,347
1,<environment.Job instance at 0x7f327e032a50>,124,13,[ 5 11],125,-1,396,-1,383
1,<environment.Job instance at 0x7f327e327280>,127,28,[7 2],128,-1,425,-1,397
1,<environment.Job instance at 0x7f327cd18dc0>,129,27,[ 3 10],130,-1,424,-1,397
1,<environment.Job instance at 0x7f327ce45960>,132,26,[9 1],133,-1,426,-1,400
1,<environment.Job instance at 0x7f327ce515f0>,136,3,[ 2 14],137,-1,418,-1,415
1,<environment.Job instance at 0x7f327d6244b0>,147,27,[9 4],148,-1,500,-1,473
1,<environment.Job instance at 0x7f327d65c410>,2,18,[2 5],3,-1,21,-1,3
1,<environment.Job instance at 0x7f327d65cb90>,4,15,[10  1],5,-1,21,-1,6
1,<environment.Job instance at 0x7f327d65cd20>,6,14,[2 6],7,-1,21,-1,7
1,<environment.Job instance at 0x7f327d1edaa0>,5,15,[8 4],6,-1,22,-1,7
1,<environment.Job instance at 0x7f327deb0190>,9,17,[5 4],10,-1,27,-1,10
1,<environment.Job instance at 0x7f327deb09b0>,10,16,[1 6],11,-1,27,-1,11
1,<environment.Job instance at 0x7f327deb05a0>,12,15,[10  3],13,-1,30,-1,15
1,<environment.Job instance at 0x7f327deb0780>,14,18,[9 3],15,-1,33,-1,15
1,<environment.Job instance at 0x7f327deb0870>,15,16,[3 8],16,-1,33,-1,17
1,<environment.Job instance at 0x7f327deb0b90>,19,14,[4 7],20,-1,34,-1,20
1,<environment.Job instance at 0x7f327de6bb40>,27,17,[ 5 10],28,-1,45,-1,28
1,<environment.Job instance at 0x7f327de6bdc0>,31,13,[1 7],32,-1,54,-1,41
1,<environment.Job instance at 0x7f327de6b3c0>,30,15,[3 7],31,-1,56,-1,41
1,<environment.Job instance at 0x7f327de6b5a0>,37,19,[ 2 10],38,-1,60,-1,41
1,<environment.Job instance at 0x7f327e63c640>,67,21,[10  4],68,-1,259,-1,238
1,<environment.Job instance at 0x7f327e63caf0>,59,21,[7 2],60,-1,259,-1,238
1,<environment.Job instance at 0x7f327d829960>,80,12,[4 5],81,-1,250,-1,238
1,<environment.Job instance at 0x7f327d4603c0>,81,16,[1 5],82,-1,254,-1,238
1,<environment.Job instance at 0x7f327dcaad70>,105,15,[12  5],106,-1,331,-1,316
1,<environment.Job instance at 0x7f327dcaaeb0>,118,18,[6 4],119,-1,404,-1,386
1,<environment.Job instance at 0x7f327dcaa910>,108,20,[ 4 13],109,-1,492,-1,472
1,<environment.Job instance at 0x7f327d874410>,133,18,[ 5 13],134,-1,492,-1,474
1,<environment.Job instance at 0x7f327d874f00>,140,17,[5 8],141,-1,491,-1,474
1,<environment.Job instance at 0x7f327d874550>,144,18,[6 5],145,-1,492,-1,474
1,<environment.Job instance at 0x7f327d874690>,8,17,[13  5],9,-1,33,-1,16
1,<environment.Job instance at 0x7f327e5542d0>,22,13,[13  5],23,-1,79,-1,66
1,<environment.Job instance at 0x7f327dcca5f0>,25,2,[ 2 12],26,-1,80,-1,78
1,<environment.Job instance at 0x7f327dc26320>,29,23,[5 7],30,-1,106,-1,83
1,<environment.Job instance at 0x7f327cff4aa0>,33,25,[ 1 10],34,-1,138,-1,113
1,<environment.Job instance at 0x7f327cff4e60>,36,12,[14  2],37,-1,125,-1,113
1,<environment.Job instance at 0x7f3286c80640>,38,1,[ 5 14],39,-1,114,-1,113
1,<environment.Job instance at 0x7f327d65c140>,50,12,[ 1 13],51,-1,158,-1,146
1,<environment.Job instance at 0x7f327e3278c0>,55,2,[11  4],56,-1,162,-1,160
1,<environment.Job instance at 0x7f327dd28460>,64,14,[ 1 12],65,-1,198,-1,184
1,<environment.Job instance at 0x7f3286e83910>,66,23,[ 5 12],67,-1,215,-1,192
1,<environment.Job instance at 0x7f3286be7aa0>,72,1,[ 4 11],73,-1,210,-1,209
1,<environment.Job instance at 0x7f327e6f2aa0>,84,3,[ 1 12],85,-1,244,-1,241
1,<environment.Job instance at 0x7f327cf6de60>,90,25,[6 2],91,-1,296,-1,271
1,<environment.Job instance at 0x7f327db44a50>,92,3,[14  1],93,-1,274,-1,271
1,<environment.Job instance at 0x7f327db441e0>,93,1,[ 4 12],94,-1,272,-1,271
1,<environment.Job instance at 0x7f327d910500>,101,18,[14  2],102,-1,312,-1,294
1,<environment.Job instance at 0x7f327e541550>,105,15,[12  5],106,-1,315,-1,300
1,<environment.Job instance at 0x7f327d4442d0>,108,20,[ 4 13],109,-1,334,-1,314
1,<environment.Job instance at 0x7f327e4acb90>,107,27,[4 8],108,-1,353,-1,326
1,<environment.Job instance at 0x7f327ddc9eb0>,133,18,[ 5 13],134,-1,420,-1,402
1,<environment.Job instance at 0x7f327d1db910>,2,17,[3 5],3,-1,20,-1,3
1,<environment.Job instance at 0x7f327d1dbb90>,5,18,[4 9],6,-1,24,-1,6
1,<environment.Job instance at 0x7f327d1dbc30>,6,14,[8 5],7,-1,21,-1,7
1,<environment.Job instance at 0x7f327d1dbcd0>,8,18,[6 5],9,-1,27,-1,9
1,<environment.Job instance at 0x7f327d1e6370>,14,16,[1 6],15,-1,31,-1,15
1,<environment.Job instance at 0x7f327d1e63c0>,15,16,[10  1],16,-1,33,-1,17
1,<environment.Job instance at 0x7f327d1e6460>,16,21,[10  4],17,-1,38,-1,17
1,<environment.Job instance at 0x7f327d1e6e10>,25,23,[7 3],26,-1,49,-1,26
1,<environment.Job instance at 0x7f327d1e6aa0>,27,20,[8 3],28,-1,48,-1,28
1,<environment.Job instance at 0x7f327d1f94b0>,34,12,[ 1 10],35,-1,49,-1,37
1,<environment.Job instance at 0x7f327d1f9960>,38,18,[5 9],39,-1,57,-1,39
1,<environment.Job instance at 0x7f327d1f9c80>,39,16,[8 4],40,-1,59,-1,43
1,<environment.Job instance at 0x7f327d1f9e10>,43,16,[5 9],44,-1,60,-1,44
1,<environment.Job instance at 0x7f327d1d50a0>,44,16,[3 5],45,-1,61,-1,45
1,<environment.Job instance at 0x7f327d1d5140>,45,15,[ 3 10],46,-1,61,-1,46
1,<environment.Job instance at 0x7f327d1d5820>,51,12,[7 5],52,-1,64,-1,52
1,<environment.Job instance at 0x7f327d1d5870>,52,26,[9 3],53,-1,79,-1,53
1,<environment.Job instance at 0x7f327d1d57d0>,53,12,[8 2],54,-1,66,-1,54
1,<environment.Job instance at 0x7f327d1d5c80>,55,15,[8 3],56,-1,71,-1,56
1,<environment.Job instance at 0x7f327d1d5aa0>,57,13,[9 2],58,-1,71,-1,58
1,<environment.Job instance at 0x7f327d1c60a0>,62,12,[9 4],63,-1,75,-1,63
1,<environment.Job instance at 0x7f327d1c6460>,63,14,[5 9],64,-1,78,-1,64
1,<environment.Job instance at 0x7f327d1c6500>,65,18,[6 4],66,-1,84,-1,66
1,<environment.Job instance at 0x7f327d1c68c0>,67,22,[6 4],68,-1,90,-1,68
1,<environment.Job instance at 0x7f327d1c6960>,70,15,[4 9],71,-1,86,-1,71
1,<environment.Job instance at 0x7f327d1c6be0>,71,12,[4 6],72,-1,84,-1,72
1,<environment.Job instance at 0x7f327d1c6e60>,74,17,[9 5],75,-1,92,-1,75
1,<environment.Job instance at 0x7f327d1c6d20>,76,12,[9 2],77,-1,89,-1,77
1,<environment.Job instance at 0x7f327d204140>,77,18,[3 7],78,-1,96,-1,78
1,<environment.Job instance at 0x7f327d204f50>,93,18,[10  4],94,-1,132,-1,114
1,<environment.Job instance at 0x7f327d2048c0>,85,19,[10  1],86,-1,144,-1,125
1,<environment.Job instance at 0x7f327d1f9d20>,42,16,[4 7],43,-1,142,-1,126
1,<environment.Job instance at 0x7f327d1e14b0>,97,20,[5 3],98,-1,146,-1,126
1,<environment.Job instance at 0x7f327d204370>,84,18,[ 2 10],85,-1,144,-1,126
1,<environment.Job instance at 0x7f327d1e1690>,100,16,[10  2],101,-1,143,-1,127
1,<environment.Job instance at 0x7f327d1e1870>,103,16,[1 9],104,-1,144,-1,128
1,<environment.Job instance at 0x7f327d1e1730>,101,16,[ 2 10],102,-1,159,-1,143
1,<environment.Job instance at 0x7f327d1e1cd0>,110,17,[1 7],111,-1,161,-1,144
1,<environment.Job instance at 0x7f327d1e1d70>,111,13,[8 2],112,-1,157,-1,144
1,<environment.Job instance at 0x7f327d1e19b0>,105,15,[2 8],106,-1,159,-1,144
1,<environment.Job instance at 0x7f327d3415a0>,114,17,[12  2],115,-1,163,-1,146
1,<environment.Job instance at 0x7f327d1e1140>,17,14,[ 3 12],18,-1,37,-1,23
1,<environment.Job instance at 0x7f327d1efcd0>,25,23,[7 3],26,-1,79,-1,56
1,<environment.Job instance at 0x7f327d1c76e0>,32,18,[ 3 13],33,-1,77,-1,59
1,<environment.Job instance at 0x7f327ddc9190>,52,26,[9 3],53,-1,161,-1,135
1,<environment.Job instance at 0x7f327e617410>,56,3,[12  4],57,-1,142,-1,139
1,<environment.Job instance at 0x7f327e27c370>,66,15,[ 1 11],67,-1,188,-1,173
1,<environment.Job instance at 0x7f327e6a9050>,78,12,[14  5],79,-1,233,-1,221
1,<environment.Job instance at 0x7f3286dfbd20>,88,23,[1 5],89,-1,294,-1,271
1,<environment.Job instance at 0x7f327cf6de60>,89,2,[12  2],90,-1,273,-1,271
1,<environment.Job instance at 0x7f3286be7730>,106,17,[13  4],107,-1,354,-1,337
1,<environment.Job instance at 0x7f327e1da190>,109,17,[ 1 11],110,-1,369,-1,352
1,<environment.Job instance at 0x7f327dd28460>,114,17,[12  2],115,-1,385,-1,368
1,<environment.Job instance at 0x7f327e327550>,122,1,[ 1 11],123,-1,399,-1,398
1,<environment.Job instance at 0x7f327e327d70>,124,12,[ 3 12],125,-1,410,-1,398
1,<environment.Job instance at 0x7f327ce45be0>,125,17,[14  3],126,-1,415,-1,398
1,<environment.Job instance at 0x7f327d970730>,127,24,[1 8],128,-1,440,-1,416
1,<environment.Job instance at 0x7f327ce62780>,132,24,[7 2],133,-1,452,-1,428
1,<environment.Job instance at 0x7f327ccf5b90>,134,27,[5 1],135,-1,455,-1,428
1,<environment.Job instance at 0x7f327ce62f50>,135,1,[ 5 12],136,-1,429,-1,428
1,<environment.Job instance at 0x7f327de58910>,138,3,[13  2],139,-1,438,-1,435
1,<environment.Job instance at 0x7f327d4ff5f0>,2,16,[3 7],3,-1,19,-1,3
1,<environment.Job instance at 0x7f327e01cd20>,3,15,[9 4],4,-1,22,-1,7
1,<environment.Job instance at 0x7f327e01c550>,7,18,[2 8],8,-1,26,-1,8
1,<environment.Job instance at 0x7f327dce8960>,9,1,[8 3],10,-1,11,-1,10
1,<environment.Job instance at 0x7f327dce8910>,11,14,[1 8],12,-1,26,-1,12
1,<environment.Job instance at 0x7f327e01c3c0>,6,14,[7 3],7,-1,26,-1,12
1,<environment.Job instance at 0x7f327dce8d20>,13,12,[10  2],14,-1,28,-1,16
1,<environment.Job instance at 0x7f327dce8140>,15,27,[1 5],16,-1,43,-1,16
1,<environment.Job instance at 0x7f327dce81e0>,16,18,[ 2 10],17,-1,39,-1,21
1,<environment.Job instance at 0x7f327e01d8c0>,21,18,[7 3],22,-1,40,-1,22
1,<environment.Job instance at 0x7f327e01d4b0>,20,15,[8 4],21,-1,37,-1,22
1,<environment.Job instance at 0x7f327e01d050>,22,17,[1 7],23,-1,40,-1,23
1,<environment.Job instance at 0x7f327d5f2870>,27,15,[ 3 10],28,-1,43,-1,28
1,<environment.Job instance at 0x7f327e01da50>,28,12,[10  1],29,-1,41,-1,29
1,<environment.Job instance at 0x7f327d69b0a0>,29,12,[4 6],30,-1,42,-1,30
1,<environment.Job instance at 0x7f327d69b500>,30,17,[5 2],31,-1,48,-1,31
1,<environment.Job instance at 0x7f327d341be0>,31,21,[8 4],32,-1,53,-1,32
1,<environment.Job instance at 0x7f327d8cf460>,32,16,[1 7],33,-1,49,-1,33
1,<environment.Job instance at 0x7f327e699cd0>,35,18,[4 5],36,-1,54,-1,36
1,<environment.Job instance at 0x7f327d247550>,37,18,[2 7],38,-1,56,-1,38
1,<environment.Job instance at 0x7f327e3138c0>,44,20,[8 2],45,-1,65,-1,45
1,<environment.Job instance at 0x7f327e313550>,45,14,[4 9],46,-1,60,-1,46
1,<environment.Job instance at 0x7f327d94b6e0>,49,13,[2 6],50,-1,63,-1,50
1,<environment.Job instance at 0x7f327d94b780>,50,21,[10  5],51,-1,72,-1,51
1,<environment.Job instance at 0x7f327cfaa410>,53,19,[7 1],54,-1,73,-1,54
1,<environment.Job instance at 0x7f327cfaa460>,54,12,[9 5],55,-1,67,-1,55
1,<environment.Job instance at 0x7f32871237d0>,62,16,[9 2],63,-1,81,-1,65
1,<environment.Job instance at 0x7f327d97c820>,71,15,[9 3],72,-1,88,-1,73
1,<environment.Job instance at 0x7f327d97c730>,73,1,[5 5],74,-1,75,-1,74
1,<environment.Job instance at 0x7f327d97cf00>,74,24,[7 3],75,-1,99,-1,75
1,<environment.Job instance at 0x7f327d02cb40>,75,13,[7 2],76,-1,89,-1,76
1,<environment.Job instance at 0x7f327d0484b0>,76,21,[5 3],77,-1,98,-1,77
1,<environment.Job instance at 0x7f327d7cbbe0>,77,22,[1 9],78,-1,100,-1,78
1,<environment.Job instance at 0x7f327d7cbf50>,78,16,[1 7],79,-1,95,-1,79
1,<environment.Job instance at 0x7f327d7cb500>,79,1,[ 4 10],80,-1,81,-1,80
1,<environment.Job instance at 0x7f327d7cb690>,80,12,[10  5],81,-1,93,-1,81
1,<environment.Job instance at 0x7f327d7ff190>,81,16,[10  1],82,-1,98,-1,82
1,<environment.Job instance at 0x7f327d5a6820>,72,17,[4 9],73,-1,100,-1,83
1,<environment.Job instance at 0x7f3286e755a0>,83,17,[8 3],84,-1,102,-1,85
1,<environment.Job instance at 0x7f327d1f4a50>,85,27,[2 8],86,-1,113,-1,86
1,<environment.Job instance at 0x7f327da2dc80>,87,15,[5 5],88,-1,103,-1,88
1,<environment.Job instance at 0x7f327e577d20>,88,1,[9 4],89,-1,90,-1,89
1,<environment.Job instance at 0x7f327d48ae60>,89,1,[ 4 13],90,-1,91,-1,90
1,<environment.Job instance at 0x7f327d8004b0>,90,14,[1 9],91,-1,105,-1,91
1,<environment.Job instance at 0x7f327d800960>,91,1,[10  1],92,-1,93,-1,92
1,<environment.Job instance at 0x7f327d8005f0>,92,24,[5 7],93,-1,117,-1,93
1,<environment.Job instance at 0x7f327d1b7870>,96,15,[ 1 10],97,-1,112,-1,97
1,<environment.Job instance at 0x7f327d316690>,98,1,[4 5],99,-1,100,-1,99
1,<environment.Job instance at 0x7f327d1b76e0>,99,23,[6 1],100,-1,123,-1,100
1,<environment.Job instance at 0x7f327d3d1cd0>,100,1,[11  4],101,-1,102,-1,101
1,<environment.Job instance at 0x7f327d777eb0>,102,18,[ 3 10],103,-1,121,-1,103
1,<environment.Job instance at 0x7f327d316c80>,103,16,[8 1],104,-1,120,-1,104
1,<environment.Job instance at 0x7f327d061e60>,104,18,[ 3 10],105,-1,123,-1,105
1,<environment.Job instance at 0x7f327d76efa0>,105,12,[5 1],106,-1,118,-1,106
1,<environment.Job instance at 0x7f327d76e4b0>,106,23,[ 2 10],107,-1,130,-1,107
1,<environment.Job instance at 0x7f327d3f7230>,109,15,[4 9],110,-1,125,-1,110
1,<environment.Job instance at 0x7f327e5b8820>,110,15,[ 1 11],111,-1,126,-1,111
1,<environment.Job instance at 0x7f327cf89500>,115,13,[9 1],116,-1,129,-1,116
1,<environment.Job instance at 0x7f327df102d0>,84,19,[ 5 12],85,-1,136,-1,117
1,<environment.Job instance at 0x7f327cf89910>,117,17,[5 6],118,-1,136,-1,119
1,<environment.Job instance at 0x7f327cf895f0>,119,14,[ 2 10],120,-1,134,-1,120
1,<environment.Job instance at 0x7f327cf89c80>,122,15,[8 3],123,-1,138,-1,123
1,<environment.Job instance at 0x7f327df39e60>,124,12,[2 9],125,-1,137,-1,125
1,<environment.Job instance at 0x7f327df49fa0>,128,14,[2 8],129,-1,143,-1,129
1,<environment.Job instance at 0x7f3286be75f0>,130,18,[5 6],131,-1,149,-1,131
1,<environment.Job instance at 0x7f327dd7df50>,133,13,[10  5],134,-1,147,-1,134
1,<environment.Job instance at 0x7f327e4173c0>,135,15,[10  4],136,-1,161,-1,146
1,<environment.Job instance at 0x7f327dadae10>,0,3,[13  5],1,-1,4,-1,1
1,<environment.Job instance at 0x7f327d97cc80>,5,3,[14  3],6,-1,9,-1,6
1,<environment.Job instance at 0x7f327de97730>,15,27,[1 5],16,-1,66,-1,39
1,<environment.Job instance at 0x7f327d1c7d70>,19,3,[13  3],20,-1,44,-1,41
1,<environment.Job instance at 0x7f327d732fa0>,55,1,[ 3 11],56,-1,157,-1,156
1,<environment.Job instance at 0x7f327d1f90a0>,66,23,[ 1 13],67,-1,201,-1,178
1,<environment.Job instance at 0x7f327cd016e0>,67,2,[ 2 11],68,-1,180,-1,178
1,<environment.Job instance at 0x7f327e0755f0>,74,24,[7 3],75,-1,223,-1,199
1,<environment.Job instance at 0x7f327da2e870>,84,19,[ 5 12],85,-1,258,-1,239
1,<environment.Job instance at 0x7f32871495f0>,85,27,[2 8],86,-1,278,-1,251
1,<environment.Job instance at 0x7f327d5f2780>,89,1,[ 4 13],90,-1,254,-1,253
1,<environment.Job instance at 0x7f327d328eb0>,92,24,[5 7],93,-1,283,-1,259
1,<environment.Job instance at 0x7f327e38f3c0>,99,23,[6 1],100,-1,303,-1,280
1,<environment.Job instance at 0x7f327e38f0f0>,100,1,[11  4],101,-1,281,-1,280
1,<environment.Job instance at 0x7f327d2c55f0>,106,23,[ 2 10],107,-1,320,-1,297
1,<environment.Job instance at 0x7f327dfb8640>,110,15,[ 1 11],111,-1,316,-1,301
1,<environment.Job instance at 0x7f327dfb8f50>,111,2,[11  4],112,-1,303,-1,301
1,<environment.Job instance at 0x7f327d757410>,112,3,[14  5],113,-1,304,-1,301
1,<environment.Job instance at 0x7f327d6506e0>,136,26,[5 7],137,-1,458,-1,432
1,<environment.Job instance at 0x7f327e1a2690>,139,13,[ 2 14],140,-1,445,-1,432
1,<environment.Job instance at 0x7f327d67e190>,146,3,[ 4 11],147,-1,445,-1,442
1,<environment.Job instance at 0x7f327cd937d0>,0,16,[4 9],1,-1,17,-1,1
1,<environment.Job instance at 0x7f327cd93320>,2,17,[3 6],3,-1,21,-1,4
1,<environment.Job instance at 0x7f3286c0e7d0>,11,17,[7 4],12,-1,29,-1,12
1,<environment.Job instance at 0x7f3286c0ec30>,13,16,[1 9],14,-1,30,-1,14
1,<environment.Job instance at 0x7f3286c0ee60>,15,27,[6 2],16,-1,43,-1,16
1,<environment.Job instance at 0x7f3286c0e0a0>,17,15,[10  5],18,-1,33,-1,18
1,<environment.Job instance at 0x7f327dccabe0>,3,14,[5 4],4,-1,33,-1,19
1,<environment.Job instance at 0x7f3286c0e500>,19,18,[5 2],20,-1,39,-1,21
1,<environment.Job instance at 0x7f3286c0eb90>,20,17,[8 2],21,-1,38,-1,21
1,<environment.Job instance at 0x7f327e06b9b0>,25,14,[9 4],26,-1,41,-1,27
1,<environment.Job instance at 0x7f327e06bcd0>,28,18,[5 3],29,-1,47,-1,29
1,<environment.Job instance at 0x7f327e06bb90>,31,18,[1 7],32,-1,50,-1,32
1,<environment.Job instance at 0x7f327e06b410>,26,12,[7 2],27,-1,52,-1,40
1,<environment.Job instance at 0x7f327e0a2a00>,41,1,[4 6],42,-1,43,-1,42
1,<environment.Job instance at 0x7f327e0a2cd0>,43,2,[2 7],44,-1,46,-1,44
1,<environment.Job instance at 0x7f327e0a2190>,44,18,[7 1],45,-1,63,-1,45
1,<environment.Job instance at 0x7f327e147690>,45,2,[10  4],46,-1,48,-1,46
1,<environment.Job instance at 0x7f327e147460>,46,14,[ 5 11],47,-1,61,-1,47
1,<environment.Job instance at 0x7f327e147230>,49,22,[14  5],50,-1,79,-1,57
1,<environment.Job instance at 0x7f327d47ba00>,56,13,[7 3],57,-1,70,-1,57
1,<environment.Job instance at 0x7f327d8e5320>,55,12,[10  4],56,-1,69,-1,57
1,<environment.Job instance at 0x7f327e299140>,58,22,[10  4],59,-1,81,-1,59
1,<environment.Job instance at 0x7f327e469be0>,54,18,[ 4 10],55,-1,78,-1,60
1,<environment.Job instance at 0x7f327e5a0230>,59,12,[3 8],60,-1,72,-1,60
1,<environment.Job instance at 0x7f327d5c8cd0>,60,18,[1 7],61,-1,79,-1,61
1,<environment.Job instance at 0x7f327df49c80>,52,12,[11  2],53,-1,73,-1,61
1,<environment.Job instance at 0x7f327e3bd8c0>,61,21,[5 8],62,-1,83,-1,62
1,<environment.Job instance at 0x7f327dff0870>,64,18,[3 8],65,-1,83,-1,65
1,<environment.Job instance at 0x7f327e238c30>,67,25,[6 5],68,-1,93,-1,68
1,<environment.Job instance at 0x7f327d897460>,70,16,[8 3],71,-1,88,-1,72
1,<environment.Job instance at 0x7f327d897e10>,73,13,[ 4 10],74,-1,87,-1,74
1,<environment.Job instance at 0x7f327d8975f0>,74,15,[10  3],75,-1,93,-1,78
1,<environment.Job instance at 0x7f327e610870>,78,25,[5 7],79,-1,104,-1,79
1,<environment.Job instance at 0x7f327e552a50>,87,16,[6 3],88,-1,104,-1,88
1,<environment.Job instance at 0x7f327d794780>,91,14,[8 5],92,-1,106,-1,92
1,<environment.Job instance at 0x7f327d794410>,92,18,[5 8],93,-1,111,-1,93
1,<environment.Job instance at 0x7f327dc97460>,97,28,[6 3],98,-1,126,-1,98
1,<environment.Job instance at 0x7f327d2c5690>,100,18,[5 5],101,-1,119,-1,101
1,<environment.Job instance at 0x7f327d2c51e0>,101,19,[3 6],102,-1,121,-1,102
1,<environment.Job instance at 0x7f327d2c52d0>,104,18,[1 9],105,-1,123,-1,105
1,<environment.Job instance at 0x7f3287123cd0>,109,17,[8 2],110,-1,127,-1,110
1,<environment.Job instance at 0x7f327d603f50>,111,19,[3 9],112,-1,131,-1,112
1,<environment.Job instance at 0x7f327e3b8960>,112,16,[5 5],113,-1,129,-1,113
1,<environment.Job instance at 0x7f327e40cc80>,115,17,[10  2],116,-1,133,-1,116
1,<environment.Job instance at 0x7f3287214820>,116,17,[4 9],117,-1,134,-1,117
1,<environment.Job instance at 0x7f327d7e8690>,117,12,[5 6],118,-1,130,-1,118
1,<environment.Job instance at 0x7f327ccf3320>,120,13,[1 6],121,-1,134,-1,121
1,<environment.Job instance at 0x7f327e131d20>,133,16,[10  1],134,-1,158,-1,142
1,<environment.Job instance at 0x7f327d8a7f50>,130,12,[ 3 11],131,-1,156,-1,144
1,<environment.Job instance at 0x7f327defc960>,134,17,[4 8],135,-1,163,-1,146
1,<environment.Job instance at 0x7f327d176190>,126,13,[5 7],127,-1,159,-1,146
1,<environment.Job instance at 0x7f327d48a690>,124,15,[ 3 14],125,-1,161,-1,146
1,<environment.Job instance at 0x7f327d8f4fa0>,1,23,[8 4],2,-1,25,-1,2
1,<environment.Job instance at 0x7f327d794b40>,4,3,[11  3],5,-1,8,-1,5
1,<environment.Job instance at 0x7f327dc97b90>,6,2,[ 2 12],7,-1,9,-1,7
1,<environment.Job instance at 0x7f327daa9410>,15,27,[6 2],16,-1,48,-1,21
1,<environment.Job instance at 0x7f327db10f00>,18,3,[ 3 12],19,-1,26,-1,23
1,<environment.Job instance at 0x7f327dd79280>,35,1,[ 4 14],36,-1,99,-1,98
1,<environment.Job instance at 0x7f327d5dec80>,46,14,[ 5 11],47,-1,131,-1,117
1,<environment.Job instance at 0x7f327d22bd20>,49,22,[14  5],50,-1,142,-1,120
1,<environment.Job instance at 0x7f327d22bcd0>,52,12,[11  2],53,-1,137,-1,125
1,<environment.Job instance at 0x7f327e0bb050>,67,25,[6 5],68,-1,201,-1,176
1,<environment.Job instance at 0x7f327e6651e0>,78,25,[5 7],79,-1,235,-1,210
1,<environment.Job instance at 0x7f327cf6df00>,79,13,[ 3 12],80,-1,223,-1,210
1,<environment.Job instance at 0x7f327da7bfa0>,88,3,[12  5],89,-1,222,-1,219
1,<environment.Job instance at 0x7f327e549aa0>,95,26,[14  3],96,-1,278,-1,252
1,<environment.Job instance at 0x7f327d7325a0>,97,28,[6 3],98,-1,296,-1,268
1,<environment.Job instance at 0x7f327d5e1b90>,106,2,[14  2],107,-1,278,-1,276
1,<environment.Job instance at 0x7f327d07f7d0>,107,3,[13  2],108,-1,279,-1,276
1,<environment.Job instance at 0x7f3286fdfd20>,119,18,[13  1],120,-1,343,-1,325
1,<environment.Job instance at 0x7f3286fdffa0>,122,25,[2 8],123,-1,365,-1,340
1,<environment.Job instance at 0x7f3286fdf5a0>,124,15,[ 3 14],125,-1,355,-1,340
1,<environment.Job instance at 0x7f327e6ec6e0>,130,12,[ 3 11],131,-1,367,-1,355
1,<environment.Job instance at 0x7f327cd90640>,131,28,[1 5],132,-1,386,-1,358
1,<environment.Job instance at 0x7f327dbc4500>,141,16,[ 3 14],142,-1,417,-1,401
1,<environment.Job instance at 0x7f327dce8410>,140,27,[3 8],141,-1,432,-1,405
1,<environment.Job instance at 0x7f327d4bb690>,0,20,[7 1],1,-1,24,-1,4
1,<environment.Job instance at 0x7f327d1329b0>,3,12,[6 3],4,-1,16,-1,4
1,<environment.Job instance at 0x7f327db440f0>,6,14,[8 2],7,-1,23,-1,9
1,<environment.Job instance at 0x7f327db44370>,9,16,[1 8],10,-1,26,-1,10
1,<environment.Job instance at 0x7f327d1c5410>,11,17,[ 3 10],12,-1,29,-1,12
1,<environment.Job instance at 0x7f327d1c5dc0>,12,12,[3 6],13,-1,25,-1,13
1,<environment.Job instance at 0x7f327d1c5550>,14,17,[4 5],15,-1,32,-1,15
1,<environment.Job instance at 0x7f327d1c5eb0>,15,13,[3 7],16,-1,29,-1,16
1,<environment.Job instance at 0x7f327db445a0>,8,12,[6 1],9,-1,32,-1,20
1,<environment.Job instance at 0x7f327e395640>,24,18,[7 5],25,-1,44,-1,26
1,<environment.Job instance at 0x7f327d777410>,27,16,[7 4],28,-1,44,-1,28
1,<environment.Job instance at 0x7f327e610b90>,25,26,[ 4 10],26,-1,56,-1,30
1,<environment.Job instance at 0x7f327dfb7cd0>,31,17,[ 3 10],32,-1,49,-1,32
1,<environment.Job instance at 0x7f327dfb75a0>,32,14,[1 7],33,-1,49,-1,35
1,<environment.Job instance at 0x7f327da2e5a0>,34,27,[3 7],35,-1,62,-1,35
1,<environment.Job instance at 0x7f327da2e0f0>,36,15,[9 4],37,-1,53,-1,38
1,<environment.Job instance at 0x7f327da2eb40>,37,17,[8 2],38,-1,55,-1,38
1,<environment.Job instance at 0x7f327d33aa00>,43,16,[9 3],44,-1,63,-1,47
1,<environment.Job instance at 0x7f327d69ceb0>,48,19,[5 8],49,-1,68,-1,49
1,<environment.Job instance at 0x7f327dfb8140>,49,12,[10  3],50,-1,62,-1,50
1,<environment.Job instance at 0x7f327d74b280>,50,12,[9 5],51,-1,63,-1,51
1,<environment.Job instance at 0x7f327d33ac80>,45,16,[ 5 10],46,-1,67,-1,51
1,<environment.Job instance at 0x7f327d328fa0>,52,18,[10  4],53,-1,72,-1,54
1,<environment.Job instance at 0x7f327e5b8e10>,54,17,[6 4],55,-1,72,-1,55
1,<environment.Job instance at 0x7f327d637370>,58,13,[8 3],59,-1,72,-1,59
1,<environment.Job instance at 0x7f327db64320>,64,12,[5 5],65,-1,77,-1,65
1,<environment.Job instance at 0x7f327db641e0>,65,16,[ 3 10],66,-1,82,-1,66
1,<environment.Job instance at 0x7f327db64dc0>,66,18,[5 7],67,-1,85,-1,67
1,<environment.Job instance at 0x7f327db64410>,67,28,[8 3],68,-1,96,-1,68
1,<environment.Job instance at 0x7f327db645f0>,69,15,[3 7],70,-1,85,-1,70
1,<environment.Job instance at 0x7f327db64a50>,70,19,[3 8],71,-1,90,-1,71
1,<environment.Job instance at 0x7f327d1c55a0>,1,1,[12  2],2,-1,3,-1,2
1,<environment.Job instance at 0x7f327d6a98c0>,20,23,[ 1 12],21,-1,63,-1,40
1,<environment.Job instance at 0x7f3286fdf690>,22,28,[1 7],23,-1,78,-1,50
1,<environment.Job instance at 0x7f327e183be0>,25,26,[ 4 10],26,-1,81,-1,55
1,<environment.Job instance at 0x7f327e64e5f0>,29,22,[12  5],30,-1,81,-1,59
1,<environment.Job instance at 0x7f327dff6410>,34,27,[3 7],35,-1,113,-1,86
1,<environment.Job instance at 0x7f327ccc78c0>,67,28,[8 3],68,-1,247,-1,219
1,<environment.Job instance at 0x7f32870cc690>,72,22,[13  5],73,-1,254,-1,232
1,<environment.Job instance at 0x7f327d8f9a50>,73,28,[10  5],74,-1,265,-1,237
1,<environment.Job instance at 0x7f327d1761e0>,77,27,[3 7],78,-1,279,-1,252
1,<environment.Job instance at 0x7f327d8977d0>,86,27,[13  1],87,-1,306,-1,279
1,<environment.Job instance at 0x7f327d69bc80>,95,25,[2 7],96,-1,331,-1,306
1,<environment.Job instance at 0x7f327d69bdc0>,97,17,[ 5 14],98,-1,323,-1,306
1,<environment.Job instance at 0x7f327dcee370>,121,26,[6 3],122,-1,399,-1,373
1,<environment.Job instance at 0x7f327d97c870>,127,1,[ 5 12],128,-1,390,-1,389
1,<environment.Job instance at 0x7f327d97ce60>,129,3,[12  2],130,-1,398,-1,395
1,<environment.Job instance at 0x7f327d97cdc0>,131,3,[11  1],132,-1,399,-1,396
1,<environment.Job instance at 0x7f327d97c0a0>,135,27,[8 5],136,-1,440,-1,413
1,<environment.Job instance at 0x7f327d97c500>,138,24,[7 4],139,-1,447,-1,423
1,<environment.Job instance at 0x7f327cf8b2d0>,147,13,[ 2 13],148,-1,458,-1,445
1,<environment.Job instance at 0x7f327cf8b050>,148,17,[ 1 13],149,-1,462,-1,445
1,<environment.Job instance at 0x7f327e5efc80>,5,1,[10  4],6,-1,7,-1,6
1,<environment.Job instance at 0x7f327d66bb90>,10,20,[9 2],11,-1,33,-1,13
1,<environment.Job instance at 0x7f327d859960>,13,18,[2 9],14,-1,32,-1,14
1,<environment.Job instance at 0x7f327d863550>,14,15,[9 1],15,-1,30,-1,15
1,<environment.Job instance at 0x7f327d8637d0>,16,26,[ 4 10],17,-1,43,-1,17
1,<environment.Job instance at 0x7f327d8bd410>,22,14,[5 6],23,-1,37,-1,23
1,<environment.Job instance at 0x7f327d859c30>,12,17,[4 7],13,-1,43,-1,26
1,<environment.Job instance at 0x7f327d8bd870>,25,13,[13  4],26,-1,46,-1,33
1,<environment.Job instance at 0x7f327d8bddc0>,27,17,[7 2],28,-1,50,-1,33
1,<environment.Job instance at 0x7f327d8bd910>,26,25,[ 3 12],27,-1,58,-1,33
1,<environment.Job instance at 0x7f327cd07b90>,34,25,[7 4],35,-1,61,-1,36
1,<environment.Job instance at 0x7f327de18d70>,36,28,[6 2],37,-1,65,-1,37
1,<environment.Job instance at 0x7f327ddf3460>,38,19,[2 5],39,-1,58,-1,39
1,<environment.Job instance at 0x7f327e42bb90>,43,22,[10  1],44,-1,66,-1,44
1,<environment.Job instance at 0x7f327ce42dc0>,46,18,[10  3],47,-1,65,-1,47
1,<environment.Job instance at 0x7f327d853e10>,35,22,[9 2],36,-1,73,-1,51
1,<environment.Job instance at 0x7f327ce42d20>,47,16,[3 9],48,-1,71,-1,55
1,<environment.Job instance at 0x7f327ce3dd20>,42,14,[ 4 14],43,-1,70,-1,56
1,<environment.Job instance at 0x7f327e45a460>,52,17,[1 9],53,-1,73,-1,56
1,<environment.Job instance at 0x7f327e45adc0>,54,17,[10  1],55,-1,74,-1,57
1,<environment.Job instance at 0x7f327e45a8c0>,50,18,[ 2 13],51,-1,75,-1,57
1,<environment.Job instance at 0x7f327e447690>,56,16,[9 3],57,-1,76,-1,60
1,<environment.Job instance at 0x7f327e447c80>,58,16,[8 3],59,-1,76,-1,60
1,<environment.Job instance at 0x7f327d859a50>,11,15,[ 3 13],12,-1,77,-1,62
1,<environment.Job instance at 0x7f327e45e5a0>,61,13,[3 5],62,-1,75,-1,62
1,<environment.Job instance at 0x7f327e45e960>,62,26,[5 7],63,-1,89,-1,63
1,<environment.Job instance at 0x7f327e45e280>,63,17,[5 8],64,-1,81,-1,64
1,<environment.Job instance at 0x7f327e45e320>,65,19,[3 8],66,-1,85,-1,66
1,<environment.Job instance at 0x7f327e45e8c0>,66,14,[5 3],67,-1,83,-1,69
1,<environment.Job instance at 0x7f327ce268c0>,69,18,[10  5],70,-1,88,-1,70
1,<environment.Job instance at 0x7f327ce26f50>,72,20,[10  4],73,-1,93,-1,73
1,<environment.Job instance at 0x7f327ce26280>,74,14,[1 9],75,-1,89,-1,75
1,<environment.Job instance at 0x7f327e42c190>,75,16,[ 3 10],76,-1,92,-1,76
1,<environment.Job instance at 0x7f327e42caa0>,77,13,[10  1],78,-1,95,-1,82
1,<environment.Job instance at 0x7f327de0e550>,82,12,[ 3 10],83,-1,95,-1,83
1,<environment.Job instance at 0x7f327e42ce60>,83,16,[7 2],84,-1,100,-1,84
1,<environment.Job instance at 0x7f327e45ec80>,68,28,[5 2],69,-1,112,-1,84
1,<environment.Job instance at 0x7f327e457fa0>,89,28,[10  4],90,-1,120,-1,92
1,<environment.Job instance at 0x7f327e45e3c0>,64,28,[9 1],65,-1,120,-1,92
1,<environment.Job instance at 0x7f327de0ed70>,84,14,[7 2],85,-1,107,-1,93
1,<environment.Job instance at 0x7f327cd0f370>,94,17,[5 9],95,-1,114,-1,97
1,<environment.Job instance at 0x7f327e4351e0>,87,20,[10  3],88,-1,118,-1,98
1,<environment.Job instance at 0x7f327d1c3960>,97,14,[1 9],98,-1,112,-1,98
1,<environment.Job instance at 0x7f327e435aa0>,88,3,[8 2],89,-1,102,-1,99
1,<environment.Job instance at 0x7f327d1c3820>,98,18,[5 2],99,-1,117,-1,99
1,<environment.Job instance at 0x7f327e43a4b0>,101,17,[ 5 10],102,-1,119,-1,102
1,<environment.Job instance at 0x7f327e43a3c0>,103,12,[10  1],104,-1,117,-1,105
1,<environment.Job instance at 0x7f327d1b60f0>,104,15,[10  1],105,-1,124,-1,109
1,<environment.Job instance at 0x7f327cf28f50>,106,14,[2 7],107,-1,125,-1,111
1,<environment.Job instance at 0x7f327cd320a0>,111,17,[5 5],112,-1,129,-1,112
1,<environment.Job instance at 0x7f327cd32a50>,112,13,[8 4],113,-1,126,-1,113
1,<environment.Job instance at 0x7f327cd329b0>,113,16,[5 2],114,-1,131,-1,115
1,<environment.Job instance at 0x7f327cd3b230>,118,16,[5 9],119,-1,135,-1,119
1,<environment.Job instance at 0x7f327cd3b1e0>,119,14,[8 1],120,-1,141,-1,127
1,<environment.Job instance at 0x7f327e45af00>,1,24,[ 3 14],2,-1,26,-1,2
1,<environment.Job instance at 0x7f327d89b870>,8,13,[14  1],9,-1,22,-1,9
1,<environment.Job instance at 0x7f327dad7280>,11,15,[ 3 13],12,-1,27,-1,12
1,<environment.Job instance at 0x7f327d780fa0>,16,26,[ 4 10],17,-1,54,-1,28
1,<environment.Job instance at 0x7f327d66e460>,21,3,[ 2 12],22,-1,34,-1,31
1,<environment.Job instance at 0x7f327cda7cd0>,25,13,[13  4],26,-1,57,-1,44
1,<environment.Job instance at 0x7f327cdc2870>,26,25,[ 3 12],27,-1,69,-1,44
1,<environment.Job instance at 0x7f327cd92b40>,34,25,[7 4],35,-1,94,-1,69
1,<environment.Job instance at 0x7f327d773d70>,36,28,[6 2],37,-1,97,-1,69
1,<environment.Job instance at 0x7f327d7735f0>,40,1,[ 2 11],41,-1,72,-1,71
1,<environment.Job instance at 0x7f327cd8e960>,42,14,[ 4 14],43,-1,88,-1,74
1,<environment.Job instance at 0x7f327dd22780>,50,18,[ 2 13],51,-1,98,-1,80
1,<environment.Job instance at 0x7f327cdb7cd0>,57,3,[12  2],58,-1,105,-1,102
1,<environment.Job instance at 0x7f327d318370>,62,26,[5 7],63,-1,157,-1,131
1,<environment.Job instance at 0x7f327e1f8a00>,64,28,[9 1],65,-1,170,-1,142
1,<environment.Job instance at 0x7f327d7506e0>,68,28,[5 2],69,-1,188,-1,160
1,<environment.Job instance at 0x7f327e2293c0>,73,3,[11  4],74,-1,181,-1,178
1,<environment.Job instance at 0x7f327d64e140>,80,2,[ 5 14],81,-1,213,-1,211
1,<environment.Job instance at 0x7f327e207280>,89,28,[10  4],90,-1,287,-1,259
1,<environment.Job instance at 0x7f327cd9abe0>,95,3,[11  1],96,-1,267,-1,264
1,<environment.Job instance at 0x7f327d647370>,100,1,[ 1 14],101,-1,293,-1,292
1,<environment.Job instance at 0x7f327e5b0eb0>,108,28,[2 8],109,-1,353,-1,325
1,<environment.Job instance at 0x7f327de82410>,109,13,[ 5 12],110,-1,338,-1,325
1,<environment.Job instance at 0x7f327de90050>,116,2,[12  3],117,-1,343,-1,341
1,<environment.Job instance at 0x7f327e205a00>,115,25,[10  3],116,-1,382,-1,357
1,<environment.Job instance at 0x7f327d77ab90>,124,3,[14  3],125,-1,375,-1,372
1,<environment.Job instance at 0x7f327e0833c0>,129,15,[13  3],130,-1,405,-1,390
1,<environment.Job instance at 0x7f327e083550>,130,24,[7 2],131,-1,416,-1,392
1,<environment.Job instance at 0x7f327e0a4410>,132,25,[7 5],133,-1,417,-1,392
1,<environment.Job instance at 0x7f327e07a280>,136,3,[12  5],137,-1,409,-1,406
1,<environment.Job instance at 0x7f327cd3b320>,0,13,[9 4],1,-1,16,-1,3
1,<environment.Job instance at 0x7f327d8d5b90>,3,1,[9 4],4,-1,5,-1,4
1,<environment.Job instance at 0x7f327d8d5190>,4,15,[ 5 10],5,-1,20,-1,5
1,<environment.Job instance at 0x7f327d8d5c30>,6,1,[5 3],7,-1,8,-1,7
1,<environment.Job instance at 0x7f327d1b6280>,7,16,[5 7],8,-1,24,-1,8
1,<environment.Job instance at 0x7f327d1b66e0>,9,18,[1 9],10,-1,28,-1,10
1,<environment.Job instance at 0x7f327d1b6640>,10,16,[9 3],11,-1,27,-1,11
1,<environment.Job instance at 0x7f327d8d5230>,2,24,[2 9],3,-1,36,-1,12
1,<environment.Job instance at 0x7f327d8d5820>,12,17,[8 1],13,-1,32,-1,15
1,<environment.Job instance at 0x7f327d1b6c30>,14,13,[7 4],15,-1,29,-1,16
1,<environment.Job instance at 0x7f327d1b61e0>,17,16,[5 9],18,-1,34,-1,18
1,<environment.Job instance at 0x7f327d1b64b0>,19,20,[5 3],20,-1,40,-1,20
1,<environment.Job instance at 0x7f327d1b6820>,21,17,[4 6],22,-1,39,-1,22
1,<environment.Job instance at 0x7f327cd32c30>,24,14,[10  2],25,-1,40,-1,26
1,<environment.Job instance at 0x7f327cd32690>,27,3,[3 5],28,-1,31,-1,28
1,<environment.Job instance at 0x7f327cd32820>,25,23,[1 8],26,-1,51,-1,28
1,<environment.Job instance at 0x7f327cf42460>,34,18,[2 6],35,-1,53,-1,35
1,<environment.Job instance at 0x7f327cf42190>,35,18,[4 6],36,-1,54,-1,36
1,<environment.Job instance at 0x7f327cf422d0>,37,18,[3 5],38,-1,56,-1,38
1,<environment.Job instance at 0x7f327cf42b40>,38,19,[3 9],39,-1,59,-1,40
1,<environment.Job instance at 0x7f327cf427d0>,41,18,[1 8],42,-1,60,-1,42
1,<environment.Job instance at 0x7f327cf42c30>,43,17,[6 4],44,-1,61,-1,44
1,<environment.Job instance at 0x7f327ce42aa0>,44,26,[8 5],45,-1,71,-1,45
1,<environment.Job instance at 0x7f327ce42af0>,47,17,[4 8],48,-1,65,-1,48
1,<environment.Job instance at 0x7f327ce42fa0>,50,22,[6 2],51,-1,73,-1,51
1,<environment.Job instance at 0x7f327ce42cd0>,51,13,[ 5 10],52,-1,65,-1,52
1,<environment.Job instance at 0x7f327cf193c0>,53,24,[3 7],54,-1,78,-1,54
1,<environment.Job instance at 0x7f327cf19e60>,54,16,[10  1],55,-1,72,-1,56
1,<environment.Job instance at 0x7f327cf19820>,56,3,[4 7],57,-1,60,-1,57
1,<environment.Job instance at 0x7f327cf19d20>,55,18,[7 3],56,-1,75,-1,57
1,<environment.Job instance at 0x7f327cf19050>,59,18,[3 7],60,-1,78,-1,60
1,<environment.Job instance at 0x7f327cf19500>,65,18,[6 3],66,-1,85,-1,67
1,<environment.Job instance at 0x7f327cf26690>,66,15,[14  5],67,-1,82,-1,67
1,<environment.Job instance at 0x7f327cf26a50>,68,18,[5 8],69,-1,88,-1,70
1,<environment.Job instance at 0x7f327cf26e10>,71,18,[10  3],72,-1,92,-1,74
1,<environment.Job instance at 0x7f327e44ff50>,75,25,[ 4 10],76,-1,101,-1,76
1,<environment.Job instance at 0x7f327e44fe10>,76,13,[9 3],77,-1,90,-1,77
1,<environment.Job instance at 0x7f327e44f4b0>,77,14,[10  2],78,-1,92,-1,78
1,<environment.Job instance at 0x7f327e44f460>,78,15,[4 6],79,-1,94,-1,79
1,<environment.Job instance at 0x7f327cf26fa0>,73,15,[5 6],74,-1,95,-1,80
1,<environment.Job instance at 0x7f327e44f730>,86,18,[6 4],87,-1,106,-1,88
1,<environment.Job instance at 0x7f327d18d320>,90,17,[5 2],91,-1,108,-1,91
1,<environment.Job instance at 0x7f327d18d6e0>,91,27,[4 5],92,-1,119,-1,92
1,<environment.Job instance at 0x7f327d18d3c0>,92,14,[5 7],93,-1,107,-1,93
1,<environment.Job instance at 0x7f327d18d7d0>,93,15,[7 4],94,-1,109,-1,94
1,<environment.Job instance at 0x7f327d18db40>,95,18,[1 8],96,-1,114,-1,96
1,<environment.Job instance at 0x7f327d18de10>,100,15,[10  1],101,-1,116,-1,101
1,<environment.Job instance at 0x7f327d18d140>,101,15,[2 9],102,-1,117,-1,102
1,<environment.Job instance at 0x7f327d18d9b0>,102,17,[5 5],103,-1,120,-1,103
1,<environment.Job instance at 0x7f327dd71c80>,105,17,[9 3],106,-1,123,-1,106
1,<environment.Job instance at 0x7f327e44f960>,79,16,[ 3 12],80,-1,137,-1,121
1,<environment.Job instance at 0x7f327e44fb40>,87,18,[ 5 10],88,-1,139,-1,121
1,<environment.Job instance at 0x7f327dcea050>,133,21,[9 1],134,-1,159,-1,138
1,<environment.Job instance at 0x7f327e452dc0>,112,14,[3 7],113,-1,152,-1,138
1,<environment.Job instance at 0x7f327d759370>,135,23,[4 8],136,-1,161,-1,138
1,<environment.Job instance at 0x7f327d5dbe10>,134,18,[2 6],135,-1,156,-1,138
1,<environment.Job instance at 0x7f327db95190>,130,16,[3 9],131,-1,155,-1,139
1,<environment.Job instance at 0x7f327cf19410>,62,16,[ 4 12],63,-1,156,-1,140
1,<environment.Job instance at 0x7f327d8590a0>,140,16,[2 8],141,-1,158,-1,142
1,<environment.Job instance at 0x7f327e452d70>,2,24,[2 9],3,-1,29,-1,5
1,<environment.Job instance at 0x7f327dbe8820>,25,23,[1 8],26,-1,98,-1,75
1,<environment.Job instance at 0x7f327d3dee10>,28,13,[ 5 13],29,-1,88,-1,75
1,<environment.Job instance at 0x7f327d46bd70>,32,3,[ 5 13],33,-1,85,-1,82
1,<environment.Job instance at 0x7f327e13a050>,44,26,[8 5],45,-1,157,-1,131
1,<environment.Job instance at 0x7f327d3f03c0>,53,24,[3 7],54,-1,166,-1,142
1,<environment.Job instance at 0x7f327df5d8c0>,61,3,[14  4],62,-1,173,-1,170
1,<environment.Job instance at 0x7f327df5db90>,62,16,[ 4 12],63,-1,186,-1,170
1,<environment.Job instance at 0x7f327d3c9be0>,66,15,[14  5],67,-1,189,-1,174
1,<environment.Job instance at 0x7f327d27a6e0>,75,25,[ 4 10],76,-1,245,-1,220
1,<environment.Job instance at 0x7f327d60dfa0>,79,16,[ 3 12],80,-1,239,-1,223
1,<environment.Job instance at 0x7f327d4eff50>,88,2,[ 5 11],89,-1,243,-1,241
1,<environment.Job instance at 0x7f327dee5be0>,91,27,[4 5],92,-1,282,-1,255
1,<environment.Job instance at 0x7f327e398fa0>,96,27,[10  5],97,-1,328,-1,301
1,<environment.Job instance at 0x7f327ce5c500>,106,14,[13  3],107,-1,334,-1,320
1,<environment.Job instance at 0x7f327e0fa500>,119,2,[ 5 11],120,-1,371,-1,369
1,<environment.Job instance at 0x7f327daf0640>,135,23,[4 8],136,-1,445,-1,422
1,<environment.Job instance at 0x7f327de7e230>,139,13,[ 3 14],140,-1,435,-1,422
1,<environment.Job instance at 0x7f327e0f9690>,141,27,[6 2],142,-1,450,-1,423
1,<environment.Job instance at 0x7f327de83460>,143,13,[13  1],144,-1,436,-1,423
1,<environment.Job instance at 0x7f327dd790f0>,3,17,[10  2],4,-1,22,-1,5
1,<environment.Job instance at 0x7f327dd79500>,5,18,[8 1],6,-1,24,-1,6
1,<environment.Job instance at 0x7f327dd794b0>,7,17,[2 9],8,-1,25,-1,8
1,<environment.Job instance at 0x7f327dd793c0>,8,27,[9 1],9,-1,36,-1,9
1,<environment.Job instance at 0x7f327dd79190>,9,12,[9 3],10,-1,22,-1,10
1,<environment.Job instance at 0x7f327dd79460>,12,22,[8 5],13,-1,35,-1,13
1,<environment.Job instance at 0x7f327de17550>,13,27,[6 5],14,-1,41,-1,14
1,<environment.Job instance at 0x7f327de17780>,15,26,[6 1],16,-1,42,-1,16
1,<environment.Job instance at 0x7f327ccea0f0>,4,13,[1 5],5,-1,29,-1,16
1,<environment.Job instance at 0x7f327dd79f50>,16,16,[10  2],17,-1,34,-1,18
1,<environment.Job instance at 0x7f327de17e10>,17,15,[7 3],18,-1,33,-1,18
1,<environment.Job instance at 0x7f327de17910>,20,26,[4 5],21,-1,47,-1,21
1,<environment.Job instance at 0x7f327de175f0>,23,17,[9 1],24,-1,41,-1,24
1,<environment.Job instance at 0x7f327de170f0>,25,18,[8 2],26,-1,44,-1,26
1,<environment.Job instance at 0x7f327de17dc0>,29,23,[4 6],30,-1,53,-1,30
1,<environment.Job instance at 0x7f327dcac4b0>,34,17,[7 5],35,-1,52,-1,35
1,<environment.Job instance at 0x7f327dcac410>,36,14,[ 4 10],37,-1,53,-1,39
1,<environment.Job instance at 0x7f327e5aafa0>,43,16,[1 8],44,-1,63,-1,47
1,<environment.Job instance at 0x7f327e5aa280>,44,15,[9 3],45,-1,62,-1,47
1,<environment.Job instance at 0x7f327e5aa410>,45,15,[4 8],46,-1,62,-1,47
1,<environment.Job instance at 0x7f327e5aa320>,42,16,[2 9],43,-1,63,-1,47
1,<environment.Job instance at 0x7f327e5aa640>,47,25,[9 5],48,-1,73,-1,48
1,<environment.Job instance at 0x7f327e5aab40>,50,15,[2 9],51,-1,68,-1,53
1,<environment.Job instance at 0x7f327e5cdf50>,57,12,[5 6],58,-1,71,-1,59
1,<environment.Job instance at 0x7f327e5cdf00>,58,15,[ 5 14],59,-1,74,-1,59
1,<environment.Job instance at 0x7f327e5cdcd0>,60,14,[1 8],61,-1,75,-1,61
1,<environment.Job instance at 0x7f327e5cd4b0>,61,14,[9 1],62,-1,76,-1,62
1,<environment.Job instance at 0x7f327e5cddc0>,63,15,[4 9],64,-1,79,-1,64
1,<environment.Job instance at 0x7f327e44f820>,68,27,[4 6],69,-1,104,-1,77
1,<environment.Job instance at 0x7f327e5cd500>,55,15,[ 3 14],56,-1,92,-1,77
1,<environment.Job instance at 0x7f327d8635a0>,73,12,[10  3],74,-1,89,-1,77
1,<environment.Job instance at 0x7f327e44f870>,66,18,[2 5],67,-1,95,-1,77
1,<environment.Job instance at 0x7f327ce44e60>,78,13,[4 6],79,-1,92,-1,79
1,<environment.Job instance at 0x7f327ce445a0>,81,18,[1 6],82,-1,100,-1,82
1,<environment.Job instance at 0x7f327e42b500>,82,17,[5 2],83,-1,100,-1,83
1,<environment.Job instance at 0x7f327e42beb0>,83,14,[8 5],84,-1,98,-1,84
1,<environment.Job instance at 0x7f327e42b7d0>,85,18,[5 8],86,-1,104,-1,86
1,<environment.Job instance at 0x7f327e42bb40>,87,16,[3 5],88,-1,104,-1,88
1,<environment.Job instance at 0x7f327e42b4b0>,89,18,[5 6],90,-1,108,-1,90
1,<environment.Job instance at 0x7f327d88ca50>,98,16,[10  1],99,-1,121,-1,105
1,<environment.Job instance at 0x7f327d88cb90>,99,16,[2 5],100,-1,121,-1,105
1,<environment.Job instance at 0x7f327e42b550>,93,27,[2 5],94,-1,134,-1,107
1,<environment.Job instance at 0x7f327dd1d0a0>,96,16,[4 6],97,-1,124,-1,108
1,<environment.Job instance at 0x7f327ccc7be0>,103,16,[8 3],104,-1,134,-1,118
1,<environment.Job instance at 0x7f327e42b690>,90,26,[ 5 14],91,-1,144,-1,118
1,<environment.Job instance at 0x7f327df74dc0>,108,14,[3 9],109,-1,132,-1,118
1,<environment.Job instance at 0x7f327ccc7d20>,109,20,[8 1],110,-1,138,-1,118
1,<environment.Job instance at 0x7f327e32bb40>,110,28,[5 3],111,-1,146,-1,118
1,<environment.Job instance at 0x7f327ccc75a0>,106,15,[5 2],107,-1,138,-1,123
1,<environment.Job instance at 0x7f327e31cd70>,115,17,[5 8],116,-1,140,-1,123
1,<environment.Job instance at 0x7f327e304960>,105,18,[4 6],106,-1,144,-1,126
1,<environment.Job instance at 0x7f327e0758c0>,118,3,[2 6],119,-1,137,-1,134
1,<environment.Job instance at 0x7f327d07dc30>,124,16,[3 6],125,-1,150,-1,134
1,<environment.Job instance at 0x7f327d671730>,125,14,[2 6],126,-1,149,-1,135
1,<environment.Job instance at 0x7f327d3360f0>,126,18,[3 5],127,-1,153,-1,135
1,<environment.Job instance at 0x7f327dfcb460>,117,12,[2 8],118,-1,147,-1,135
1,<environment.Job instance at 0x7f327e42bf50>,92,16,[ 2 13],93,-1,151,-1,135
1,<environment.Job instance at 0x7f327cd18870>,123,18,[7 3],124,-1,153,-1,135
1,<environment.Job instance at 0x7f327e3ff730>,133,27,[6 3],134,-1,162,-1,135
1,<environment.Job instance at 0x7f327e3ff9b0>,134,14,[5 6],135,-1,149,-1,135
1,<environment.Job instance at 0x7f327e699870>,135,14,[7 3],136,-1,151,-1,137
1,<environment.Job instance at 0x7f327e699460>,138,17,[7 3],139,-1,156,-1,139
1,<environment.Job instance at 0x7f327cea20a0>,139,15,[1 7],140,-1,155,-1,140
1,<environment.Job instance at 0x7f327cf71fa0>,143,17,[4 5],144,-1,170,-1,153
1,<environment.Job instance at 0x7f327d08d320>,145,14,[10  5],146,-1,167,-1,153
1,<environment.Job instance at 0x7f327e5cd0a0>,8,27,[9 1],9,-1,51,-1,24
1,<environment.Job instance at 0x7f327ce44c80>,11,16,[14  3],12,-1,40,-1,24
1,<environment.Job instance at 0x7f327e5cdc80>,13,27,[6 5],14,-1,51,-1,24
1,<environment.Job instance at 0x7f327ccc7370>,15,26,[6 1],16,-1,50,-1,24
1,<environment.Job instance at 0x7f327debef00>,20,26,[4 5],21,-1,73,-1,47
1,<environment.Job instance at 0x7f327d8dd5a0>,27,15,[12  1],28,-1,85,-1,70
1,<environment.Job instance at 0x7f327ccea0a0>,29,23,[4 6],30,-1,103,-1,80
1,<environment.Job instance at 0x7f327ccea4b0>,30,1,[ 2 14],31,-1,81,-1,80
1,<environment.Job instance at 0x7f327e6b6eb0>,48,2,[ 1 13],49,-1,153,-1,151
1,<environment.Job instance at 0x7f327e398a00>,47,25,[9 5],48,-1,177,-1,152
1,<environment.Job instance at 0x7f327d8538c0>,55,15,[ 3 14],56,-1,184,-1,169
1,<environment.Job instance at 0x7f327d8537d0>,58,15,[ 5 14],59,-1,185,-1,170
1,<environment.Job instance at 0x7f327d3c9410>,67,2,[ 1 11],68,-1,211,-1,209
1,<environment.Job instance at 0x7f327d3c9050>,68,27,[4 6],69,-1,239,-1,212
1,<environment.Job instance at 0x7f327d2c8e60>,90,26,[ 5 14],91,-1,299,-1,273
1,<environment.Job instance at 0x7f327d3debe0>,92,16,[ 2 13],93,-1,293,-1,277
1,<environment.Job instance at 0x7f327d3dee10>,93,27,[2 5],94,-1,304,-1,277
1,<environment.Job instance at 0x7f327dcbc6e0>,110,28,[5 3],111,-1,367,-1,339
1,<environment.Job instance at 0x7f327dcbc140>,113,1,[13  4],114,-1,343,-1,342
1,<environment.Job instance at 0x7f32871edb40>,133,27,[6 3],134,-1,462,-1,435
1,<environment.Job instance at 0x7f327e59f320>,140,2,[11  1],141,-1,442,-1,440
1,<environment.Job instance at 0x7f4bec3c46e0>,0,18,[ 2 10],1,-1,20,-1,2
1,<environment.Job instance at 0x7f4be2dd4a50>,3,18,[ 3 10],4,-1,22,-1,4
1,<environment.Job instance at 0x7f4be2dd4be0>,4,18,[10  4],5,-1,23,-1,5
1,<environment.Job instance at 0x7f4be2dd4af0>,5,13,[5 9],6,-1,19,-1,6
1,<environment.Job instance at 0x7f4be2dd4dc0>,8,17,[ 2 10],9,-1,26,-1,9
1,<environment.Job instance at 0x7f4be2dd4f00>,9,17,[ 4 10],10,-1,27,-1,10
1,<environment.Job instance at 0x7f4be2dd7780>,18,16,[8 5],19,-1,35,-1,19
1,<environment.Job instance at 0x7f4be2dd7c30>,23,18,[5 2],24,-1,42,-1,24
1,<environment.Job instance at 0x7f4be2dd7f50>,26,22,[2 9],27,-1,49,-1,27
1,<environment.Job instance at 0x7f4be2dda410>,31,17,[4 9],32,-1,49,-1,32
1,<environment.Job instance at 0x7f4be2dda550>,32,17,[9 3],33,-1,50,-1,33
1,<environment.Job instance at 0x7f4be2dda960>,35,16,[8 1],36,-1,52,-1,36
1,<environment.Job instance at 0x7f4be2ddac80>,38,12,[3 6],39,-1,51,-1,39
1,<environment.Job instance at 0x7f4be2ddadc0>,39,18,[5 8],40,-1,58,-1,40
1,<environment.Job instance at 0x7f4be2ddae60>,41,14,[6 1],42,-1,56,-1,42
1,<environment.Job instance at 0x7f4be2ddaeb0>,42,14,[8 4],43,-1,57,-1,43
1,<environment.Job instance at 0x7f4be2ddc0a0>,43,28,[6 4],44,-1,72,-1,44
1,<environment.Job instance at 0x7f4be2ddcaf0>,56,18,[4 5],57,-1,75,-1,57
1,<environment.Job instance at 0x7f4be2dde320>,62,20,[9 1],63,-1,172,-1,152
1,<environment.Job instance at 0x7f4be2dde050>,60,24,[ 3 10],61,-1,176,-1,152
1,<environment.Job instance at 0x7f4be2ddef00>,78,19,[8 4],79,-1,171,-1,152
1,<environment.Job instance at 0x7f4be2dde640>,67,26,[5 4],68,-1,178,-1,152
1,<environment.Job instance at 0x7f4be2de34b0>,85,19,[14  4],86,-1,172,-1,153
1,<environment.Job instance at 0x7f4be2ddeeb0>,77,15,[4 7],78,-1,168,-1,153
1,<environment.Job instance at 0x7f4be2de36e0>,89,13,[7 2],90,-1,167,-1,154
1,<environment.Job instance at 0x7f4be2de3f00>,100,18,[7 5],101,-1,214,-1,196
1,<environment.Job instance at 0x7f4be2de4140>,103,17,[5 6],104,-1,213,-1,196
1,<environment.Job instance at 0x7f4be2dd7370>,1,15,[ 1 14],2,-1,17,-1,2
1,<environment.Job instance at 0x7f4be2dda4b0>,6,12,[11  4],7,-1,19,-1,7
1,<environment.Job instance at 0x7f4be2de3be0>,19,17,[12  3],20,-1,67,-1,50
1,<environment.Job instance at 0x7f4be2efbd20>,22,2,[12  3],23,-1,62,-1,60
1,<environment.Job instance at 0x7f4be2db1c80>,43,28,[6 4],44,-1,166,-1,138
1,<environment.Job instance at 0x7f4be2e2d6e0>,44,17,[ 5 12],45,-1,155,-1,138
1,<environment.Job instance at 0x7f4be2db7a00>,50,27,[9 1],51,-1,179,-1,152
1,<environment.Job instance at 0x7f4be2dc8320>,52,3,[ 3 11],53,-1,155,-1,152
1,<environment.Job instance at 0x7f4be2dc80a0>,53,18,[ 4 12],54,-1,170,-1,152
1,<environment.Job instance at 0x7f4be2de4910>,60,24,[ 3 10],61,-1,209,-1,185
1,<environment.Job instance at 0x7f4be2de4d70>,67,26,[5 4],68,-1,226,-1,200
1,<environment.Job instance at 0x7f4be2d70780>,81,17,[ 4 14],82,-1,256,-1,239
1,<environment.Job instance at 0x7f4be2d709b0>,85,19,[14  4],86,-1,260,-1,241
1,<environment.Job instance at 0x7f4be2d720a0>,95,23,[3 7],96,-1,294,-1,271
1,<environment.Job instance at 0x7f4be2d72640>,102,27,[ 3 13],103,-1,316,-1,289
1,<environment.Job instance at 0x7f4be2d72dc0>,111,18,[ 3 13],112,-1,333,-1,315
1,<environment.Job instance at 0x7f4be2d750f0>,117,18,[ 3 12],118,-1,348,-1,330
1,<environment.Job instance at 0x7f4be2d75370>,121,18,[11  5],122,-1,359,-1,341
1,<environment.Job instance at 0x7f4be2d754b0>,122,14,[14  1],123,-1,355,-1,341
1,<environment.Job instance at 0x7f4be2d75d70>,135,15,[ 3 14],136,-1,411,-1,396
1,<environment.Job instance at 0x7f4be2d75190>,137,12,[14  5],138,-1,408,-1,396
1,<environment.Job instance at 0x7f4be27b1f50>,8,18,[4 6],9,-1,27,-1,9
1,<environment.Job instance at 0x7f4be27b1550>,9,16,[3 5],10,-1,26,-1,10
1,<environment.Job instance at 0x7f4be27b2f00>,18,14,[4 7],19,-1,33,-1,19
1,<environment.Job instance at 0x7f4be276e0a0>,19,23,[2 8],20,-1,44,-1,21
1,<environment.Job instance at 0x7f4be283f460>,24,12,[5 7],25,-1,37,-1,25
1,<environment.Job instance at 0x7f4be283f280>,25,17,[10  5],26,-1,43,-1,26
1,<environment.Job instance at 0x7f4be283f230>,26,26,[9 1],27,-1,53,-1,27
1,<environment.Job instance at 0x7f4be283ffa0>,30,18,[5 1],31,-1,51,-1,33
1,<environment.Job instance at 0x7f4be27b1820>,15,25,[3 9],16,-1,63,-1,38
1,<environment.Job instance at 0x7f4be28441e0>,34,17,[10  5],35,-1,55,-1,38
1,<environment.Job instance at 0x7f4be28449b0>,36,23,[5 8],37,-1,61,-1,38
1,<environment.Job instance at 0x7f4be2844140>,32,14,[8 4],33,-1,57,-1,43
1,<environment.Job instance at 0x7f4be28491e0>,43,27,[5 3],44,-1,71,-1,44
1,<environment.Job instance at 0x7f4be28495a0>,44,17,[10  2],45,-1,62,-1,45
1,<environment.Job instance at 0x7f4be2849410>,45,17,[5 9],46,-1,63,-1,46
1,<environment.Job instance at 0x7f4be28496e0>,48,22,[9 2],49,-1,73,-1,51
1,<environment.Job instance at 0x7f4be2849730>,50,17,[2 9],51,-1,73,-1,56
1,<environment.Job instance at 0x7f4be2849460>,42,14,[9 2],43,-1,70,-1,56
1,<environment.Job instance at 0x7f4be29b6fa0>,51,18,[ 5 11],52,-1,74,-1,56
1,<environment.Job instance at 0x7f4be2654460>,52,17,[10  4],53,-1,73,-1,56
1,<environment.Job instance at 0x7f4be28447d0>,35,16,[ 3 10],36,-1,82,-1,66
1,<environment.Job instance at 0x7f4be25e9a50>,58,28,[7 4],59,-1,97,-1,69
1,<environment.Job instance at 0x7f4be263ed70>,55,17,[8 1],56,-1,87,-1,70
1,<environment.Job instance at 0x7f4be25f4eb0>,64,28,[9 1],65,-1,99,-1,71
1,<environment.Job instance at 0x7f4be25e96e0>,57,18,[ 1 10],58,-1,89,-1,71
1,<environment.Job instance at 0x7f4bec43be10>,66,15,[ 5 10],67,-1,86,-1,71
1,<environment.Job instance at 0x7f4be25f49b0>,63,15,[5 6],64,-1,86,-1,71
1,<environment.Job instance at 0x7f4be2cf4690>,70,15,[7 4],71,-1,86,-1,71
1,<environment.Job instance at 0x7f4be2516e60>,72,16,[8 5],73,-1,97,-1,81
1,<environment.Job instance at 0x7f4be236faa0>,73,12,[3 8],74,-1,93,-1,81
1,<environment.Job instance at 0x7f4be236f050>,74,14,[8 5],75,-1,95,-1,81
1,<environment.Job instance at 0x7f4be23e20a0>,75,12,[2 6],76,-1,93,-1,81
1,<environment.Job instance at 0x7f4be25f4780>,65,17,[3 5],66,-1,98,-1,81
1,<environment.Job instance at 0x7f4be2423230>,78,18,[3 8],79,-1,99,-1,81
1,<environment.Job instance at 0x7f4be23b5cd0>,77,3,[4 9],78,-1,84,-1,81
1,<environment.Job instance at 0x7f4be24254b0>,80,28,[7 3],81,-1,109,-1,81
1,<environment.Job instance at 0x7f4be2387280>,81,16,[7 4],82,-1,98,-1,82
1,<environment.Job instance at 0x7f4be2421370>,79,16,[9 4],80,-1,98,-1,82
1,<environment.Job instance at 0x7f4be23878c0>,83,18,[1 6],84,-1,103,-1,85
1,<environment.Job instance at 0x7f4be2387140>,84,15,[9 5],85,-1,101,-1,86
1,<environment.Job instance at 0x7f4be2387780>,86,17,[2 6],87,-1,105,-1,88
1,<environment.Job instance at 0x7f4be2384fa0>,88,12,[9 2],89,-1,101,-1,89
1,<environment.Job instance at 0x7f4be2384140>,90,18,[8 5],91,-1,109,-1,91
1,<environment.Job instance at 0x7f4be2386820>,103,21,[9 5],104,-1,151,-1,130
1,<environment.Job instance at 0x7f4bec3ee1e0>,111,18,[ 5 14],112,-1,149,-1,131
1,<environment.Job instance at 0x7f4be23864b0>,104,18,[10  2],105,-1,149,-1,131
1,<environment.Job instance at 0x7f4bec52f3c0>,112,17,[8 2],113,-1,148,-1,131
1,<environment.Job instance at 0x7f4be2386410>,106,22,[6 1],107,-1,153,-1,131
1,<environment.Job instance at 0x7f4be2381780>,117,14,[4 7],118,-1,145,-1,131
1,<environment.Job instance at 0x7f4be25e9910>,6,22,[11  3],7,-1,29,-1,7
1,<environment.Job instance at 0x7f4be23819b0>,15,25,[3 9],16,-1,63,-1,38
1,<environment.Job instance at 0x7f4be24082d0>,19,23,[2 8],20,-1,61,-1,38
1,<environment.Job instance at 0x7f4be2385c80>,26,26,[9 1],27,-1,83,-1,57
1,<environment.Job instance at 0x7f4be2d758c0>,36,23,[5 8],37,-1,134,-1,111
1,<environment.Job instance at 0x7f4be2d75780>,41,2,[12  1],42,-1,118,-1,116
1,<environment.Job instance at 0x7f4be2d751e0>,43,27,[5 3],44,-1,151,-1,124
1,<environment.Job instance at 0x7f4be2d72e10>,49,3,[ 4 12],50,-1,142,-1,139
1,<environment.Job instance at 0x7f4be2d72e60>,51,18,[ 5 11],52,-1,157,-1,139
1,<environment.Job instance at 0x7f4be2d72d20>,58,28,[7 4],59,-1,224,-1,196
1,<environment.Job instance at 0x7f4be2de3be0>,64,28,[9 1],65,-1,243,-1,215
1,<environment.Job instance at 0x7f4be2660b40>,68,16,[14  3],69,-1,237,-1,221
1,<environment.Job instance at 0x7f4be2599dc0>,80,28,[7 3],81,-1,315,-1,287
1,<environment.Job instance at 0x7f4be2779b90>,98,12,[12  2],99,-1,373,-1,361
1,<environment.Job instance at 0x7f4be2785a00>,101,19,[ 3 14],102,-1,388,-1,369
1,<environment.Job instance at 0x7f4be25dc410>,102,2,[14  5],103,-1,371,-1,369
1,<environment.Job instance at 0x7f4be26bb190>,105,12,[12  4],106,-1,390,-1,378
1,<environment.Job instance at 0x7f4be25d6460>,111,18,[ 5 14],112,-1,412,-1,394
1,<environment.Job instance at 0x7f4be2597640>,118,1,[ 5 14],119,-1,418,-1,417
1,<environment.Job instance at 0x7f4be25bfaa0>,123,3,[14  5],124,-1,434,-1,431
1,<environment.Job instance at 0x7f4be2542af0>,128,17,[12  1],129,-1,462,-1,445
1,<environment.Job instance at 0x7f4be2585910>,132,1,[13  3],133,-1,460,-1,459
1,<environment.Job instance at 0x7f4be253de60>,142,27,[ 2 13],143,-1,532,-1,505
1,<environment.Job instance at 0x7f4be252fbe0>,148,1,[12  5],149,-1,527,-1,526
1,<environment.Job instance at 0x7f4be2501a50>,11,16,[2 8],12,-1,28,-1,12
1,<environment.Job instance at 0x7f4be24fec30>,13,13,[2 5],14,-1,28,-1,15
1,<environment.Job instance at 0x7f4be24fe640>,18,14,[10  4],19,-1,33,-1,19
1,<environment.Job instance at 0x7f4be24fe8c0>,19,16,[1 7],20,-1,36,-1,20
1,<environment.Job instance at 0x7f4be24fe320>,14,18,[13  2],15,-1,38,-1,20
1,<environment.Job instance at 0x7f4be24fed70>,21,15,[3 5],22,-1,38,-1,23
1,<environment.Job instance at 0x7f4be24fef50>,24,12,[3 5],25,-1,37,-1,25
1,<environment.Job instance at 0x7f4be24fc410>,25,17,[6 3],26,-1,43,-1,26
1,<environment.Job instance at 0x7f4be24fc460>,26,20,[6 2],27,-1,47,-1,27
1,<environment.Job instance at 0x7f4be24fc640>,28,17,[2 8],29,-1,46,-1,29
1,<environment.Job instance at 0x7f4be24feeb0>,22,20,[7 3],23,-1,51,-1,31
1,<environment.Job instance at 0x7f4be24fcb40>,34,12,[2 9],35,-1,48,-1,36
1,<environment.Job instance at 0x7f4be24f3c80>,36,15,[10  5],37,-1,52,-1,37
1,<environment.Job instance at 0x7f4be24f3780>,37,16,[ 3 10],38,-1,54,-1,38
1,<environment.Job instance at 0x7f4be24f3690>,38,16,[3 6],39,-1,55,-1,39
1,<environment.Job instance at 0x7f4be24f3eb0>,39,22,[1 6],40,-1,62,-1,40
1,<environment.Job instance at 0x7f4be24f3fa0>,41,25,[10  4],42,-1,67,-1,42
1,<environment.Job instance at 0x7f4be24f3e10>,43,12,[8 5],44,-1,56,-1,44
1,<environment.Job instance at 0x7f4be24f3190>,44,22,[1 9],45,-1,67,-1,45
1,<environment.Job instance at 0x7f4be24f3820>,47,13,[ 1 10],48,-1,61,-1,48
1,<environment.Job instance at 0x7f4be24f0fa0>,49,18,[ 2 10],50,-1,68,-1,50
1,<environment.Job instance at 0x7f4be24f0460>,50,17,[7 1],51,-1,68,-1,51
1,<environment.Job instance at 0x7f4be24f0320>,51,18,[3 8],52,-1,70,-1,52
1,<environment.Job instance at 0x7f4be24f02d0>,53,24,[3 6],54,-1,78,-1,54
1,<environment.Job instance at 0x7f4be24f0230>,55,20,[3 8],56,-1,76,-1,56
1,<environment.Job instance at 0x7f4be24f0b90>,56,15,[4 9],57,-1,72,-1,57
1,<environment.Job instance at 0x7f4be24f07d0>,60,18,[4 8],61,-1,79,-1,61
1,<environment.Job instance at 0x7f4be24ecb90>,65,18,[ 3 10],66,-1,84,-1,66
1,<environment.Job instance at 0x7f4be24fca00>,35,16,[2 6],36,-1,91,-1,75
1,<environment.Job instance at 0x7f4be2567d70>,75,27,[5 5],76,-1,103,-1,76
1,<environment.Job instance at 0x7f4be25677d0>,76,22,[2 8],77,-1,100,-1,78
1,<environment.Job instance at 0x7f4be2567eb0>,73,18,[8 1],74,-1,98,-1,80
1,<environment.Job instance at 0x7f4be2567050>,79,17,[2 6],80,-1,97,-1,80
1,<environment.Job instance at 0x7f4be2567280>,80,16,[1 9],81,-1,97,-1,81
1,<environment.Job instance at 0x7f4be2564c80>,82,17,[4 6],83,-1,100,-1,83
1,<environment.Job instance at 0x7f4be25643c0>,83,27,[7 5],84,-1,112,-1,85
1,<environment.Job instance at 0x7f4be25644b0>,84,13,[14  5],85,-1,99,-1,86
1,<environment.Job instance at 0x7f4be2564140>,85,12,[4 7],86,-1,98,-1,86
1,<environment.Job instance at 0x7f4be2564280>,86,13,[8 3],87,-1,100,-1,87
1,<environment.Job instance at 0x7f4be2564e60>,91,18,[5 7],92,-1,110,-1,92
1,<environment.Job instance at 0x7f4be25618c0>,95,25,[3 7],96,-1,161,-1,136
1,<environment.Job instance at 0x7f4be2567e60>,72,17,[9 1],73,-1,156,-1,139
1,<environment.Job instance at 0x7f4be2561640>,105,16,[10  5],106,-1,155,-1,139
1,<environment.Job instance at 0x7f4be254aa00>,108,21,[9 5],109,-1,160,-1,139
1,<environment.Job instance at 0x7f4be254a1e0>,110,17,[9 4],111,-1,156,-1,139
1,<environment.Job instance at 0x7f4be2567230>,77,20,[5 2],78,-1,159,-1,139
1,<environment.Job instance at 0x7f4be268f5f0>,117,16,[2 6],118,-1,158,-1,142
1,<environment.Job instance at 0x7f4be24fe3c0>,1,18,[ 4 13],2,-1,20,-1,2
1,<environment.Job instance at 0x7f4be24f30f0>,7,16,[ 5 13],8,-1,24,-1,8
1,<environment.Job instance at 0x7f4be2567f50>,14,18,[13  2],15,-1,38,-1,20
1,<environment.Job instance at 0x7f4be2b34910>,20,18,[11  4],21,-1,54,-1,36
1,<environment.Job instance at 0x7f4be236b7d0>,41,25,[10  4],42,-1,143,-1,118
1,<environment.Job instance at 0x7f4be2383820>,53,24,[3 6],54,-1,172,-1,148
1,<environment.Job instance at 0x7f4be23836e0>,57,27,[9 5],58,-1,189,-1,162
1,<environment.Job instance at 0x7f4be24b6910>,63,2,[ 3 14],64,-1,181,-1,179
1,<environment.Job instance at 0x7f4be2516b90>,74,3,[ 3 12],75,-1,234,-1,231
1,<environment.Job instance at 0x7f4be24ad370>,75,27,[5 5],76,-1,258,-1,231
1,<environment.Job instance at 0x7f4be24ad6e0>,78,13,[14  4],79,-1,262,-1,249
1,<environment.Job instance at 0x7f4be24b0280>,84,13,[14  5],85,-1,281,-1,268
1,<environment.Job instance at 0x7f4be24b0f00>,83,27,[7 5],84,-1,312,-1,285
1,<environment.Job instance at 0x7f4be2619190>,95,25,[3 7],96,-1,342,-1,317
1,<environment.Job instance at 0x7f4be2619a50>,100,1,[ 4 12],101,-1,331,-1,330
1,<environment.Job instance at 0x7f4be24b5af0>,104,12,[13  3],105,-1,355,-1,343
1,<environment.Job instance at 0x7f4be24b5a50>,109,3,[12  1],110,-1,368,-1,365
1,<environment.Job instance at 0x7f4be254a320>,119,16,[ 5 13],120,-1,417,-1,401
1,<environment.Job instance at 0x7f4be2559e60>,124,14,[ 3 14],125,-1,433,-1,419
1,<environment.Job instance at 0x7f4be2559960>,125,24,[3 9],126,-1,446,-1,422
1,<environment.Job instance at 0x7f4be2559500>,135,1,[12  4],136,-1,461,-1,460
1,<environment.Job instance at 0x7f4be255c550>,141,15,[14  1],142,-1,492,-1,477
1,<environment.Job instance at 0x7f4be255cf00>,142,27,[5 5],143,-1,507,-1,480
1,<environment.Job instance at 0x7f4be255ce10>,144,25,[1 7],145,-1,508,-1,483
1,<environment.Job instance at 0x7f4be2556410>,156,27,[5 8],157,-1,564,-1,537
1,<environment.Job instance at 0x7f4be2535230>,1,24,[4 8],2,-1,26,-1,2
1,<environment.Job instance at 0x7f4be2347320>,5,19,[7 5],6,-1,25,-1,6
1,<environment.Job instance at 0x7f4be23473c0>,6,14,[8 1],7,-1,22,-1,8
1,<environment.Job instance at 0x7f4be2342fa0>,7,12,[10  4],8,-1,20,-1,8
1,<environment.Job instance at 0x7f4be2347640>,10,14,[ 4 10],11,-1,25,-1,11
1,<environment.Job instance at 0x7f4be23475f0>,12,17,[2 5],13,-1,31,-1,14
1,<environment.Job instance at 0x7f4be23475a0>,13,14,[8 2],14,-1,30,-1,16
1,<environment.Job instance at 0x7f4be2347aa0>,16,18,[8 2],17,-1,36,-1,18
1,<environment.Job instance at 0x7f4be2347af0>,17,18,[6 2],18,-1,36,-1,18
1,<environment.Job instance at 0x7f4be2347cd0>,19,18,[5 8],20,-1,38,-1,20
1,<environment.Job instance at 0x7f4be2347e60>,20,19,[2 7],21,-1,40,-1,21
1,<environment.Job instance at 0x7f4be23495f0>,27,23,[10  4],28,-1,51,-1,28
1,<environment.Job instance at 0x7f4be2349a00>,31,17,[5 7],32,-1,49,-1,32
1,<environment.Job instance at 0x7f4be2349b40>,32,12,[3 8],33,-1,47,-1,35
1,<environment.Job instance at 0x7f4be2349aa0>,35,16,[4 5],36,-1,52,-1,36
1,<environment.Job instance at 0x7f4be234a190>,39,17,[ 5 10],40,-1,57,-1,40
1,<environment.Job instance at 0x7f4be234a230>,40,18,[4 6],41,-1,59,-1,41
1,<environment.Job instance at 0x7f4be234a0f0>,41,15,[3 5],42,-1,57,-1,42
1,<environment.Job instance at 0x7f4be234a4b0>,44,15,[5 7],45,-1,60,-1,45
1,<environment.Job instance at 0x7f4be234a280>,46,14,[ 5 10],47,-1,68,-1,54
1,<environment.Job instance at 0x7f4be234af50>,56,27,[4 5],57,-1,90,-1,63
1,<environment.Job instance at 0x7f4be234a960>,49,27,[14  1],50,-1,90,-1,63
1,<environment.Job instance at 0x7f4be234f1e0>,60,14,[8 4],61,-1,77,-1,63
1,<environment.Job instance at 0x7f4be2347b90>,1,24,[4 8],2,-1,26,-1,2
1,<environment.Job instance at 0x7f4be2aca1e0>,11,1,[11  1],12,-1,13,-1,12
1,<environment.Job instance at 0x7f4be23377d0>,21,24,[1 9],22,-1,76,-1,52
1,<environment.Job instance at 0x7f4be2748870>,27,23,[10  4],28,-1,85,-1,62
1,<environment.Job instance at 0x7f4be2abc0f0>,33,3,[ 5 13],34,-1,82,-1,79
1,<environment.Job instance at 0x7f4be2abcaf0>,36,17,[13  2],37,-1,108,-1,91
1,<environment.Job instance at 0x7f4be2abc460>,37,1,[11  4],38,-1,92,-1,91
1,<environment.Job instance at 0x7f4be23326e0>,42,17,[ 2 12],43,-1,120,-1,103
1,<environment.Job instance at 0x7f4be2ac1af0>,45,24,[10  2],46,-1,143,-1,119
1,<environment.Job instance at 0x7f4be2ad3e10>,49,27,[14  1],50,-1,173,-1,146
1,<environment.Job instance at 0x7f4be2d0de60>,52,2,[11  4],53,-1,148,-1,146
1,<environment.Job instance at 0x7f4be2342eb0>,55,12,[11  5],56,-1,159,-1,147
1,<environment.Job instance at 0x7f4be25562d0>,56,27,[4 5],57,-1,175,-1,148
1,<environment.Job instance at 0x7f4be255c5f0>,62,3,[11  3],63,-1,178,-1,175
1,<environment.Job instance at 0x7f4be255cc30>,71,15,[ 2 14],72,-1,221,-1,206
1,<environment.Job instance at 0x7f4be25595f0>,75,12,[ 3 13],76,-1,223,-1,211
1,<environment.Job instance at 0x7f4be261e1e0>,91,17,[14  3],92,-1,294,-1,277
1,<environment.Job instance at 0x7f4be261e500>,94,15,[ 2 13],95,-1,299,-1,284
1,<environment.Job instance at 0x7f4be24b5460>,97,3,[12  4],98,-1,295,-1,292
1,<environment.Job instance at 0x7f4be24b5eb0>,99,28,[1 8],100,-1,337,-1,309
1,<environment.Job instance at 0x7f4be2619f50>,108,18,[13  3],109,-1,350,-1,332
1,<environment.Job instance at 0x7f4be2429550>,115,24,[8 3],116,-1,389,-1,365
1,<environment.Job instance at 0x7f4be24b4280>,131,13,[12  4],132,-1,451,-1,438
1,<environment.Job instance at 0x7f4be2414640>,134,24,[4 5],135,-1,474,-1,450
1,<environment.Job instance at 0x7f4be2bf6140>,5,12,[10  3],6,-1,19,-1,7
1,<environment.Job instance at 0x7f4be2dab3c0>,7,15,[10  1],8,-1,23,-1,8
1,<environment.Job instance at 0x7f4be2dabfa0>,9,23,[6 5],10,-1,33,-1,10
1,<environment.Job instance at 0x7f4be2daba50>,10,17,[2 6],11,-1,28,-1,11
1,<environment.Job instance at 0x7f4be2dab370>,12,1,[4 6],13,-1,14,-1,13
1,<environment.Job instance at 0x7f4be2dabf50>,13,1,[4 9],14,-1,15,-1,14
1,<environment.Job instance at 0x7f4be2bf6af0>,6,14,[5 4],7,-1,28,-1,14
1,<environment.Job instance at 0x7f4be2dabf00>,19,21,[1 9],20,-1,41,-1,20
1,<environment.Job instance at 0x7f4be3417aa0>,20,27,[6 4],21,-1,48,-1,21
1,<environment.Job instance at 0x7f4be3417730>,22,15,[10  1],23,-1,39,-1,24
1,<environment.Job instance at 0x7f4be34171e0>,24,13,[1 8],25,-1,38,-1,25
1,<environment.Job instance at 0x7f4be34175f0>,25,3,[10  4],26,-1,29,-1,26
1,<environment.Job instance at 0x7f4be3417f00>,26,14,[1 7],27,-1,41,-1,27
1,<environment.Job instance at 0x7f4be3417460>,23,13,[7 5],24,-1,41,-1,28
1,<environment.Job instance at 0x7f4be3417690>,28,22,[7 5],29,-1,51,-1,29
1,<environment.Job instance at 0x7f4be34172d0>,30,18,[ 5 10],31,-1,50,-1,32
1,<environment.Job instance at 0x7f4be34170a0>,32,24,[1 6],33,-1,57,-1,33
1,<environment.Job instance at 0x7f4be3417a00>,33,16,[8 5],34,-1,50,-1,34
1,<environment.Job instance at 0x7f4be2edc960>,34,16,[9 4],35,-1,52,-1,36
1,<environment.Job instance at 0x7f4be2edc320>,36,15,[10  4],37,-1,53,-1,38
1,<environment.Job instance at 0x7f4be2edc460>,38,17,[3 9],39,-1,56,-1,39
1,<environment.Job instance at 0x7f4be2edc910>,40,14,[1 8],41,-1,55,-1,41
1,<environment.Job instance at 0x7f4be2edc0f0>,41,12,[5 6],42,-1,54,-1,42
1,<environment.Job instance at 0x7f4be2edfa00>,48,14,[9 1],49,-1,63,-1,49
1,<environment.Job instance at 0x7f4be2edf730>,49,17,[1 9],50,-1,67,-1,50
1,<environment.Job instance at 0x7f4be2edf460>,52,15,[6 2],53,-1,68,-1,53
1,<environment.Job instance at 0x7f4be2edf780>,54,3,[3 6],55,-1,58,-1,55
1,<environment.Job instance at 0x7f4be2edfdc0>,55,1,[8 4],56,-1,57,-1,56
1,<environment.Job instance at 0x7f4be2edf370>,58,18,[6 5],59,-1,77,-1,59
1,<environment.Job instance at 0x7f4be311f870>,59,18,[ 5 10],60,-1,78,-1,60
1,<environment.Job instance at 0x7f4be311f9b0>,64,17,[5 1],65,-1,82,-1,65
1,<environment.Job instance at 0x7f4be311f3c0>,65,15,[ 1 10],66,-1,81,-1,66
1,<environment.Job instance at 0x7f4be311fe10>,67,12,[7 2],68,-1,80,-1,68
1,<environment.Job instance at 0x7f4be2ee2aa0>,68,24,[4 7],69,-1,93,-1,69
1,<environment.Job instance at 0x7f4be2ee2640>,69,12,[4 6],70,-1,82,-1,70
1,<environment.Job instance at 0x7f4be2ee20f0>,70,13,[5 3],71,-1,84,-1,71
1,<environment.Job instance at 0x7f4be2ee2eb0>,72,17,[9 4],73,-1,90,-1,73
1,<environment.Job instance at 0x7f4be2ee24b0>,74,18,[ 4 11],75,-1,93,-1,75
1,<environment.Job instance at 0x7f4be2ee2730>,75,16,[9 4],76,-1,92,-1,76
1,<environment.Job instance at 0x7f4be2ee2f50>,77,15,[4 6],78,-1,93,-1,78
1,<environment.Job instance at 0x7f4be2ee2a50>,80,20,[4 6],81,-1,101,-1,81
1,<environment.Job instance at 0x7f4be2efe780>,84,16,[4 5],85,-1,101,-1,85
1,<environment.Job instance at 0x7f4be2efe230>,92,17,[ 2 10],93,-1,110,-1,93
1,<environment.Job instance at 0x7f4be2ee1c30>,96,13,[4 7],97,-1,110,-1,97
1,<environment.Job instance at 0x7f4be2ee1640>,98,20,[3 8],99,-1,119,-1,99
1,<environment.Job instance at 0x7f4be2ee1aa0>,101,21,[4 7],102,-1,123,-1,102
1,<environment.Job instance at 0x7f4be2b11b90>,102,17,[ 2 11],103,-1,122,-1,105
1,<environment.Job instance at 0x7f4be2edce10>,37,13,[ 4 10],38,-1,118,-1,105
1,<environment.Job instance at 0x7f4be2ee1be0>,100,24,[10  4],101,-1,133,-1,109
1,<environment.Job instance at 0x7f4be2f1d140>,106,18,[6 3],107,-1,127,-1,109
1,<environment.Job instance at 0x7f4be2e49820>,109,19,[5 5],110,-1,129,-1,110
1,<environment.Job instance at 0x7f4be34829b0>,110,15,[10  4],111,-1,126,-1,111
1,<environment.Job instance at 0x7f4be2eed410>,111,18,[4 8],112,-1,130,-1,112
1,<environment.Job instance at 0x7f4be2efed70>,83,14,[ 1 11],84,-1,136,-1,122
1,<environment.Job instance at 0x7f4be2eed050>,115,12,[10  1],116,-1,134,-1,122
1,<environment.Job instance at 0x7f4be2e6da50>,117,14,[ 4 10],118,-1,137,-1,123
1,<environment.Job instance at 0x7f4be2e378c0>,122,16,[3 8],123,-1,140,-1,124
1,<environment.Job instance at 0x7f4be2b11500>,126,18,[10  2],127,-1,154,-1,136
1,<environment.Job instance at 0x7f4be2b111e0>,128,17,[9 5],129,-1,154,-1,137
1,<environment.Job instance at 0x7f4be34188c0>,130,16,[ 3 10],131,-1,162,-1,146
1,<environment.Job instance at 0x7f4be2eed3c0>,114,14,[3 8],115,-1,161,-1,147
1,<environment.Job instance at 0x7f4be3418500>,131,16,[5 7],132,-1,163,-1,147
1,<environment.Job instance at 0x7f4be3418e60>,135,14,[4 6],136,-1,164,-1,150
1,<environment.Job instance at 0x7f4be3418a50>,132,3,[4 8],133,-1,157,-1,154
1,<environment.Job instance at 0x7f4be33e3aa0>,151,17,[2 7],152,-1,202,-1,185
1,<environment.Job instance at 0x7f4be3418870>,145,12,[8 5],146,-1,200,-1,188
1,<environment.Job instance at 0x7f4be33e38c0>,153,12,[7 4],154,-1,202,-1,190
1,<environment.Job instance at 0x7f4be33e35f0>,152,17,[6 4],153,-1,207,-1,190
1,<environment.Job instance at 0x7f4be2ee2c80>,9,23,[6 5],10,-1,39,-1,16
1,<environment.Job instance at 0x7f4be2e37140>,20,27,[6 4],21,-1,67,-1,40
1,<environment.Job instance at 0x7f4be34184b0>,21,1,[11  4],22,-1,41,-1,40
1,<environment.Job instance at 0x7f4be2bf69b0>,32,24,[1 6],33,-1,96,-1,72
1,<environment.Job instance at 0x7f4be24ad640>,44,3,[ 2 12],45,-1,126,-1,123
1,<environment.Job instance at 0x7f4be2619280>,51,2,[ 3 14],52,-1,143,-1,141
1,<environment.Job instance at 0x7f4be261edc0>,56,13,[12  4],57,-1,170,-1,157
1,<environment.Job instance at 0x7f4be261ee10>,57,27,[9 3],58,-1,185,-1,158
1,<environment.Job instance at 0x7f4be2559c80>,66,12,[ 2 11],67,-1,198,-1,186
1,<environment.Job instance at 0x7f4be2556370>,68,24,[4 7],69,-1,225,-1,201
1,<environment.Job instance at 0x7f4be2d0d780>,74,18,[ 4 11],75,-1,231,-1,213
1,<environment.Job instance at 0x7f4be2ac1eb0>,79,3,[14  1],80,-1,235,-1,232
1,<environment.Job instance at 0x7f4be2d07c30>,83,14,[ 1 11],84,-1,250,-1,236
1,<environment.Job instance at 0x7f4be2335050>,85,16,[ 2 11],86,-1,254,-1,238
1,<environment.Job instance at 0x7f4be2abce10>,88,2,[13  3],89,-1,246,-1,244
1,<environment.Job instance at 0x7f4be2337050>,100,24,[10  4],101,-1,314,-1,290
1,<environment.Job instance at 0x7f4be233c910>,102,17,[ 2 11],103,-1,307,-1,290
1,<environment.Job instance at 0x7f4be23377d0>,104,1,[ 2 11],105,-1,291,-1,290
1,<environment.Job instance at 0x7f4be2347190>,119,1,[ 5 14],120,-1,373,-1,372
1,<environment.Job instance at 0x7f4be3094500>,137,27,[ 2 11],138,-1,487,-1,460
1,<environment.Job instance at 0x7f4be338af00>,139,3,[11  2],140,-1,464,-1,461
1,<environment.Job instance at 0x7f4be338a820>,142,1,[12  5],143,-1,465,-1,464
1,<environment.Job instance at 0x7f4be2047f50>,2,16,[ 3 10],3,-1,19,-1,3
1,<environment.Job instance at 0x7f4be38fe1e0>,3,18,[5 5],4,-1,22,-1,4
1,<environment.Job instance at 0x7f4be21a2e60>,4,16,[5 5],5,-1,21,-1,5
1,<environment.Job instance at 0x7f4be21a2640>,5,17,[ 3 10],6,-1,23,-1,6
1,<environment.Job instance at 0x7f4be200d230>,8,18,[1 5],9,-1,27,-1,9
1,<environment.Job instance at 0x7f4be200de10>,9,18,[9 5],10,-1,28,-1,10
1,<environment.Job instance at 0x7f4be200dfa0>,10,19,[4 5],11,-1,30,-1,11
1,<environment.Job instance at 0x7f4be2a165f0>,12,13,[9 4],13,-1,26,-1,13
1,<environment.Job instance at 0x7f4be2191fa0>,14,16,[2 7],15,-1,31,-1,15
1,<environment.Job instance at 0x7f4be32233c0>,18,16,[8 3],19,-1,35,-1,19
1,<environment.Job instance at 0x7f4be2191d20>,20,23,[9 4],21,-1,44,-1,21
1,<environment.Job instance at 0x7f4be247f8c0>,21,21,[8 2],22,-1,43,-1,22
1,<environment.Job instance at 0x7f4be247f2d0>,22,21,[5 7],23,-1,44,-1,23
1,<environment.Job instance at 0x7f4be2335410>,24,17,[9 2],25,-1,42,-1,25
1,<environment.Job instance at 0x7f4be2335d20>,25,18,[5 5],26,-1,44,-1,26
1,<environment.Job instance at 0x7f4be2775780>,28,28,[10  4],29,-1,57,-1,29
1,<environment.Job instance at 0x7f4be2775c30>,32,18,[4 7],33,-1,51,-1,33
1,<environment.Job instance at 0x7f4be2775410>,33,18,[7 1],34,-1,52,-1,34
1,<environment.Job instance at 0x7f4be2775230>,34,14,[9 1],35,-1,49,-1,35
1,<environment.Job instance at 0x7f4be246fc80>,36,18,[8 3],37,-1,55,-1,37
1,<environment.Job instance at 0x7f4be38efbe0>,40,26,[4 9],41,-1,67,-1,41
1,<environment.Job instance at 0x7f4be2000690>,45,18,[1 8],46,-1,64,-1,46
1,<environment.Job instance at 0x7f4be20008c0>,47,23,[5 3],48,-1,71,-1,48
1,<environment.Job instance at 0x7f4be2000aa0>,48,16,[9 4],49,-1,65,-1,49
1,<environment.Job instance at 0x7f4be2000190>,49,15,[5 7],50,-1,65,-1,50
1,<environment.Job instance at 0x7f4be3008280>,56,18,[7 4],57,-1,78,-1,60
1,<environment.Job instance at 0x7f4be338d460>,59,18,[6 4],60,-1,78,-1,60
1,<environment.Job instance at 0x7f4be338d140>,60,13,[11  2],61,-1,88,-1,75
1,<environment.Job instance at 0x7f4be37a3a50>,67,16,[ 3 12],68,-1,91,-1,75
1,<environment.Job instance at 0x7f4be37a3a00>,68,15,[7 3],69,-1,92,-1,77
1,<environment.Job instance at 0x7f4be3397190>,70,14,[10  1],71,-1,91,-1,77
1,<environment.Job instance at 0x7f4be357df00>,73,22,[5 2],74,-1,102,-1,80
1,<environment.Job instance at 0x7f4be357d9b0>,74,18,[5 6],75,-1,101,-1,83
1,<environment.Job instance at 0x7f4be357dc30>,75,17,[3 6],76,-1,100,-1,83
1,<environment.Job instance at 0x7f4be33973c0>,69,17,[9 2],70,-1,100,-1,83
1,<environment.Job instance at 0x7f4be3050050>,55,14,[ 1 10],56,-1,97,-1,83
1,<environment.Job instance at 0x7f4be340daa0>,53,24,[ 5 11],54,-1,108,-1,84
1,<environment.Job instance at 0x7f4be3886410>,80,16,[ 2 10],81,-1,100,-1,84
1,<environment.Job instance at 0x7f4be2000910>,51,18,[11  2],52,-1,102,-1,84
1,<environment.Job instance at 0x7f4be3886140>,82,15,[5 9],83,-1,108,-1,93
1,<environment.Job instance at 0x7f4be290a780>,84,14,[6 4],85,-1,107,-1,93
1,<environment.Job instance at 0x7f4be28fd640>,85,18,[ 5 10],86,-1,111,-1,93
1,<environment.Job instance at 0x7f4be290a960>,86,25,[6 3],87,-1,118,-1,93
1,<environment.Job instance at 0x7f4be38780a0>,89,12,[9 4],90,-1,105,-1,93
1,<environment.Job instance at 0x7f4be38d5b40>,97,18,[3 8],98,-1,117,-1,99
1,<environment.Job instance at 0x7f4be38d5c80>,98,16,[7 2],99,-1,115,-1,99
1,<environment.Job instance at 0x7f4be27aea50>,101,18,[10  5],102,-1,124,-1,106
1,<environment.Job instance at 0x7f4be29855a0>,105,18,[9 2],106,-1,126,-1,108
1,<environment.Job instance at 0x7f4be27b23c0>,111,21,[4 9],112,-1,133,-1,112
1,<environment.Job instance at 0x7f4be27b2820>,113,16,[8 1],114,-1,130,-1,114
1,<environment.Job instance at 0x7f4be29856e0>,107,20,[1 8],108,-1,136,-1,116
1,<environment.Job instance at 0x7f4be3114b40>,115,23,[8 4],116,-1,140,-1,117
1,<environment.Job instance at 0x7f4be3114e60>,117,20,[5 7],118,-1,138,-1,118
1,<environment.Job instance at 0x7f4be3114690>,118,16,[4 8],119,-1,137,-1,121
1,<environment.Job instance at 0x7f4be3114910>,119,18,[6 1],120,-1,139,-1,121
1,<environment.Job instance at 0x7f4be3114dc0>,125,16,[10  5],126,-1,142,-1,126
1,<environment.Job instance at 0x7f4be31e5b40>,127,16,[1 7],128,-1,144,-1,128
1,<environment.Job instance at 0x7f4be31e5c30>,129,18,[2 7],130,-1,148,-1,130
1,<environment.Job instance at 0x7f4be31e51e0>,131,20,[ 5 13],132,-1,157,-1,137
1,<environment.Job instance at 0x7f4be1fecdc0>,78,12,[ 4 10],79,-1,149,-1,137
1,<environment.Job instance at 0x7f4be31e5870>,133,16,[9 4],134,-1,153,-1,137
1,<environment.Job instance at 0x7f4be31e5af0>,134,13,[8 2],135,-1,150,-1,137
1,<environment.Job instance at 0x7f4be31145f0>,120,15,[2 8],121,-1,153,-1,138
1,<environment.Job instance at 0x7f4be3114fa0>,124,15,[11  1],125,-1,153,-1,138
1,<environment.Job instance at 0x7f4be3218280>,141,12,[3 7],142,-1,155,-1,143
1,<environment.Job instance at 0x7f4be3218f50>,144,17,[8 1],145,-1,162,-1,145
1,<environment.Job instance at 0x7f4be3218cd0>,142,15,[ 2 10],143,-1,172,-1,157
1,<environment.Job instance at 0x7f4be31a5730>,153,14,[ 4 10],154,-1,171,-1,157
1,<environment.Job instance at 0x7f4be31c9190>,146,19,[2 9],147,-1,176,-1,157
1,<environment.Job instance at 0x7f4be31a5050>,154,15,[4 8],155,-1,173,-1,158
1,<environment.Job instance at 0x7f4be31a5550>,156,16,[1 6],157,-1,174,-1,158
1,<environment.Job instance at 0x7f4be2dfc9b0>,140,24,[7 2],141,-1,182,-1,158
1,<environment.Job instance at 0x7f4be27ae640>,20,23,[9 4],21,-1,92,-1,69
1,<environment.Job instance at 0x7f4be3218d70>,28,28,[10  4],29,-1,115,-1,87
1,<environment.Job instance at 0x7f4be2335050>,38,17,[12  1],39,-1,137,-1,120
1,<environment.Job instance at 0x7f4be2aa9370>,40,26,[4 9],41,-1,152,-1,126
1,<environment.Job instance at 0x7f4be261ee10>,42,16,[13  1],43,-1,142,-1,126
1,<environment.Job instance at 0x7f4be2f7cdc0>,47,23,[5 3],48,-1,164,-1,141
1,<environment.Job instance at 0x7f4be27b2190>,51,18,[11  2],52,-1,174,-1,156
1,<environment.Job instance at 0x7f4be2efeb90>,52,12,[ 5 13],53,-1,168,-1,156
1,<environment.Job instance at 0x7f4be2ee2d70>,53,24,[ 5 11],54,-1,180,-1,156
1,<environment.Job instance at 0x7f4be2edc7d0>,60,13,[11  2],61,-1,197,-1,184
1,<environment.Job instance at 0x7f4be2f5e640>,67,16,[ 3 12],68,-1,232,-1,216
1,<environment.Job instance at 0x7f4be2bc31e0>,86,25,[6 3],87,-1,327,-1,302
1,<environment.Job instance at 0x7f4be3140be0>,93,2,[14  3],94,-1,318,-1,316
1,<environment.Job instance at 0x7f4be3140460>,94,1,[14  5],95,-1,317,-1,316
1,<environment.Job instance at 0x7f4be2e59c30>,103,1,[12  4],104,-1,335,-1,334
1,<environment.Job instance at 0x7f4be2e59f00>,110,2,[ 2 12],111,-1,359,-1,357
1,<environment.Job instance at 0x7f4be2e59910>,115,23,[8 4],116,-1,417,-1,394
1,<environment.Job instance at 0x7f4be331faf0>,124,15,[11  1],125,-1,445,-1,430
1,<environment.Job instance at 0x7f4be331fa00>,131,20,[ 5 13],132,-1,470,-1,450
1,<environment.Job instance at 0x7f4be34b9820>,140,24,[7 2],141,-1,509,-1,485
1,<environment.Job instance at 0x7f4be34b90a0>,145,15,[ 1 12],146,-1,516,-1,501
1,<environment.Job instance at 0x7f4be33e57d0>,158,2,[ 1 13],159,-1,576,-1,574
1,<environment.Job instance at 0x7f4be2a0bb90>,1,28,[5 1],2,-1,30,-1,2
1,<environment.Job instance at 0x7f4be2abc4b0>,3,12,[3 8],4,-1,17,-1,5
1,<environment.Job instance at 0x7f4be3505e10>,5,15,[3 5],6,-1,22,-1,7
1,<environment.Job instance at 0x7f4be2c7d9b0>,12,13,[9 1],13,-1,27,-1,14
1,<environment.Job instance at 0x7f4be2c7d2d0>,14,13,[4 8],15,-1,28,-1,15
1,<environment.Job instance at 0x7f4be2c7d7d0>,15,12,[2 8],16,-1,28,-1,16
1,<environment.Job instance at 0x7f4be30d57d0>,16,12,[9 5],17,-1,29,-1,17
1,<environment.Job instance at 0x7f4be30d55a0>,17,17,[10  4],18,-1,35,-1,18
1,<environment.Job instance at 0x7f4be2964b40>,13,23,[7 4],14,-1,41,-1,18
1,<environment.Job instance at 0x7f4be3396a50>,21,14,[9 4],22,-1,40,-1,26
1,<environment.Job instance at 0x7f4be29491e0>,26,27,[5 2],27,-1,54,-1,27
1,<environment.Job instance at 0x7f4be2956320>,28,13,[1 5],29,-1,42,-1,29
1,<environment.Job instance at 0x7f4be295d5f0>,25,18,[7 5],26,-1,47,-1,29
1,<environment.Job instance at 0x7f4be2955050>,30,22,[2 5],31,-1,75,-1,53
1,<environment.Job instance at 0x7f4be244bc80>,46,17,[3 5],47,-1,70,-1,53
1,<environment.Job instance at 0x7f4be2c7da00>,18,18,[13  5],19,-1,71,-1,53
1,<environment.Job instance at 0x7f4be295d190>,29,18,[ 2 10],30,-1,73,-1,55
1,<environment.Job instance at 0x7f4be244a230>,49,1,[4 5],50,-1,57,-1,56
1,<environment.Job instance at 0x7f4be244a460>,48,15,[5 8],49,-1,72,-1,57
1,<environment.Job instance at 0x7f4be244aa00>,52,12,[10  4],53,-1,69,-1,57
1,<environment.Job instance at 0x7f4be34e40a0>,37,15,[5 8],38,-1,72,-1,57
1,<environment.Job instance at 0x7f4be244a1e0>,54,13,[ 5 10],55,-1,77,-1,64
1,<environment.Job instance at 0x7f4be34e42d0>,38,18,[5 8],39,-1,83,-1,65
1,<environment.Job instance at 0x7f4be244aaa0>,56,3,[5 1],57,-1,68,-1,65
1,<environment.Job instance at 0x7f4be24587d0>,59,15,[6 2],60,-1,82,-1,67
1,<environment.Job instance at 0x7f4be2467910>,63,17,[5 9],64,-1,87,-1,70
1,<environment.Job instance at 0x7f4be244a320>,51,25,[10  1],52,-1,95,-1,70
1,<environment.Job instance at 0x7f4be2964730>,7,13,[9 1],8,-1,83,-1,70
1,<environment.Job instance at 0x7f4be2467be0>,64,17,[2 5],65,-1,87,-1,70
1,<environment.Job instance at 0x7f4be2467b40>,65,21,[9 3],66,-1,91,-1,70
1,<environment.Job instance at 0x7f4be24677d0>,66,15,[3 5],67,-1,85,-1,70
1,<environment.Job instance at 0x7f4be2467b90>,67,25,[9 4],68,-1,95,-1,70
1,<environment.Job instance at 0x7f4be2467eb0>,69,14,[5 4],70,-1,84,-1,70
1,<environment.Job instance at 0x7f4be2435190>,70,12,[10  1],71,-1,83,-1,71
1,<environment.Job instance at 0x7f4be2467d20>,71,1,[5 5],72,-1,73,-1,72
1,<environment.Job instance at 0x7f4be24350a0>,72,16,[9 4],73,-1,89,-1,73
1,<environment.Job instance at 0x7f4be2435050>,73,12,[10  1],74,-1,86,-1,74
1,<environment.Job instance at 0x7f4be2435370>,74,17,[1 9],75,-1,92,-1,75
1,<environment.Job instance at 0x7f4be2435870>,79,28,[6 1],80,-1,108,-1,80
1,<environment.Job instance at 0x7f4be2435820>,81,13,[7 4],82,-1,96,-1,83
1,<environment.Job instance at 0x7f4be2435c30>,84,18,[5 5],85,-1,104,-1,86
1,<environment.Job instance at 0x7f4be2435c80>,86,17,[2 6],87,-1,104,-1,87
1,<environment.Job instance at 0x7f4be2435fa0>,87,12,[2 8],88,-1,100,-1,88
1,<environment.Job instance at 0x7f4be242e050>,88,18,[5 3],89,-1,107,-1,89
1,<environment.Job instance at 0x7f4be242e0f0>,89,12,[4 6],90,-1,111,-1,99
1,<environment.Job instance at 0x7f4be242e550>,93,24,[5 3],94,-1,123,-1,99
1,<environment.Job instance at 0x7f4be242e1e0>,94,15,[5 6],95,-1,114,-1,99
1,<environment.Job instance at 0x7f4be242e320>,92,15,[8 4],93,-1,118,-1,103
1,<environment.Job instance at 0x7f4be242e6e0>,96,17,[2 5],97,-1,121,-1,104
1,<environment.Job instance at 0x7f4be242e820>,98,12,[9 3],99,-1,116,-1,104
1,<environment.Job instance at 0x7f4be242e9b0>,99,13,[6 4],100,-1,117,-1,104
1,<environment.Job instance at 0x7f4be242eaa0>,100,3,[8 3],101,-1,107,-1,104
1,<environment.Job instance at 0x7f4be242e960>,101,28,[9 4],102,-1,132,-1,104
1,<environment.Job instance at 0x7f4be242e410>,91,13,[10  4],92,-1,117,-1,104
1,<environment.Job instance at 0x7f4be244bdc0>,44,28,[4 5],45,-1,132,-1,104
1,<environment.Job instance at 0x7f4be318da00>,109,18,[7 5],110,-1,128,-1,110
1,<environment.Job instance at 0x7f4be242ec30>,103,16,[ 1 12],104,-1,135,-1,119
1,<environment.Job instance at 0x7f4be318dd20>,113,3,[8 2],114,-1,129,-1,126
1,<environment.Job instance at 0x7f4be2458870>,58,18,[5 5],59,-1,144,-1,126
1,<environment.Job instance at 0x7f4be242ef50>,107,17,[1 9],108,-1,143,-1,126
1,<environment.Job instance at 0x7f4be318dcd0>,115,3,[5 3],116,-1,129,-1,126
1,<environment.Job instance at 0x7f4be318d6e0>,114,17,[7 2],115,-1,146,-1,129
1,<environment.Job instance at 0x7f4be318daa0>,119,15,[10  2],120,-1,144,-1,129
1,<environment.Job instance at 0x7f4be318de60>,118,13,[4 6],119,-1,142,-1,129
1,<environment.Job instance at 0x7f4be318d500>,123,15,[3 9],124,-1,145,-1,130
1,<environment.Job instance at 0x7f4be318d730>,124,16,[7 4],125,-1,146,-1,130
1,<environment.Job instance at 0x7f4be318d9b0>,127,13,[14  4],128,-1,143,-1,130
1,<environment.Job instance at 0x7f4be318da50>,128,17,[9 5],129,-1,147,-1,130
1,<environment.Job instance at 0x7f4be3191730>,131,18,[4 7],132,-1,150,-1,132
1,<environment.Job instance at 0x7f4be318d910>,120,12,[7 4],121,-1,144,-1,132
1,<environment.Job instance at 0x7f4be318ddc0>,116,21,[5 5],117,-1,153,-1,132
1,<environment.Job instance at 0x7f4be3191640>,133,17,[9 1],134,-1,151,-1,134
1,<environment.Job instance at 0x7f4be31914b0>,132,14,[4 6],133,-1,148,-1,134
1,<environment.Job instance at 0x7f4be31917d0>,134,22,[4 9],135,-1,157,-1,135
1,<environment.Job instance at 0x7f4be31919b0>,136,21,[5 5],137,-1,158,-1,137
1,<environment.Job instance at 0x7f4be3191c80>,139,15,[3 9],140,-1,160,-1,145
1,<environment.Job instance at 0x7f4be31ba410>,145,25,[1 6],146,-1,171,-1,146
1,<environment.Job instance at 0x7f4be31913c0>,130,15,[5 3],131,-1,163,-1,148
1,<environment.Job instance at 0x7f4be31ba730>,150,27,[11  2],151,-1,179,-1,152
1,<environment.Job instance at 0x7f4be31baaa0>,152,20,[ 5 10],153,-1,174,-1,154
1,<environment.Job instance at 0x7f4be31ba370>,144,15,[10  2],145,-1,171,-1,156
1,<environment.Job instance at 0x7f4be30cca00>,0,28,[ 2 14],1,-1,29,-1,1
1,<environment.Job instance at 0x7f4be2c7d5f0>,1,28,[5 1],2,-1,30,-1,2
1,<environment.Job instance at 0x7f4be24355f0>,13,23,[7 4],14,-1,38,-1,15
1,<environment.Job instance at 0x7f4be318d2d0>,18,18,[13  5],19,-1,37,-1,19
1,<environment.Job instance at 0x7f4be3191370>,23,3,[13  5],24,-1,47,-1,44
1,<environment.Job instance at 0x7f4be31ba8c0>,26,27,[5 2],27,-1,75,-1,48
1,<environment.Job instance at 0x7f4be2a65fa0>,27,14,[ 3 14],28,-1,62,-1,48
1,<environment.Job instance at 0x7f4be34b98c0>,44,28,[4 5],45,-1,140,-1,112
1,<environment.Job instance at 0x7f4be34b9af0>,47,2,[ 5 13],48,-1,115,-1,113
1,<environment.Job instance at 0x7f4be331fd70>,51,25,[10  1],52,-1,167,-1,142
1,<environment.Job instance at 0x7f4be2e59c80>,67,25,[9 4],68,-1,233,-1,208
1,<environment.Job instance at 0x7f4be3140cd0>,79,28,[6 1],80,-1,278,-1,250
1,<environment.Job instance at 0x7f4be3140be0>,82,18,[ 2 12],83,-1,271,-1,253
1,<environment.Job instance at 0x7f4be2bc3eb0>,93,24,[5 3],94,-1,319,-1,295
1,<environment.Job instance at 0x7f4be3413af0>,97,2,[11  4],98,-1,313,-1,311
1,<environment.Job instance at 0x7f4be34137d0>,101,28,[9 4],102,-1,364,-1,336
1,<environment.Job instance at 0x7f4be3413c30>,103,16,[ 1 12],104,-1,352,-1,336
1,<environment.Job instance at 0x7f4be2f5e1e0>,108,19,[ 3 11],109,-1,364,-1,345
1,<environment.Job instance at 0x7f4be261e1e0>,127,13,[14  4],128,-1,442,-1,429
1,<environment.Job instance at 0x7f4be31e5640>,143,2,[13  2],144,-1,499,-1,497
1,<environment.Job instance at 0x7f4be27ae690>,145,25,[1 6],146,-1,535,-1,510
1,<environment.Job instance at 0x7f4be38d53c0>,150,27,[11  2],151,-1,541,-1,514
1,<environment.Job instance at 0x7f4be30c50a0>,155,24,[8 3],156,-1,557,-1,533
1,<environment.Job instance at 0x7f4be290a5f0>,1,16,[3 9],2,-1,18,-1,2
1,<environment.Job instance at 0x7f4be290af50>,5,17,[10  3],6,-1,24,-1,7
1,<environment.Job instance at 0x7f4be290a0a0>,7,24,[5 9],8,-1,32,-1,8
1,<environment.Job instance at 0x7f4be2c66e60>,6,18,[6 4],7,-1,26,-1,8
1,<environment.Job instance at 0x7f4be2894a00>,11,28,[3 6],12,-1,40,-1,12
1,<environment.Job instance at 0x7f4be2894190>,12,14,[ 4 10],13,-1,27,-1,13
1,<environment.Job instance at 0x7f4be2894cd0>,15,16,[7 3],16,-1,33,-1,17
1,<environment.Job instance at 0x7f4be2894af0>,17,16,[1 8],18,-1,34,-1,18
1,<environment.Job instance at 0x7f4be28945a0>,18,2,[4 6],19,-1,21,-1,19
1,<environment.Job instance at 0x7f4be2894c30>,19,26,[2 6],20,-1,46,-1,20
1,<environment.Job instance at 0x7f4be28946e0>,20,20,[9 3],21,-1,41,-1,21
1,<environment.Job instance at 0x7f4be2894e60>,21,15,[8 4],22,-1,37,-1,22
1,<environment.Job instance at 0x7f4be2894410>,22,14,[9 2],23,-1,37,-1,23
1,<environment.Job instance at 0x7f4be290a280>,16,12,[8 4],17,-1,35,-1,23
1,<environment.Job instance at 0x7f4be2894550>,23,16,[2 6],24,-1,40,-1,24
1,<environment.Job instance at 0x7f4be2894fa0>,25,17,[5 3],26,-1,44,-1,27
1,<environment.Job instance at 0x7f4be35130f0>,28,26,[8 2],29,-1,55,-1,29
1,<environment.Job instance at 0x7f4be3513960>,30,13,[4 6],31,-1,44,-1,31
1,<environment.Job instance at 0x7f4be3513aa0>,32,16,[9 2],33,-1,49,-1,33
1,<environment.Job instance at 0x7f4be3513cd0>,33,18,[4 6],34,-1,52,-1,34
1,<environment.Job instance at 0x7f4be35136e0>,34,13,[2 8],35,-1,48,-1,35
1,<environment.Job instance at 0x7f4be3581230>,36,17,[3 7],37,-1,54,-1,37
1,<environment.Job instance at 0x7f4be3581fa0>,39,17,[5 7],40,-1,57,-1,40
1,<environment.Job instance at 0x7f4be3513eb0>,26,12,[2 7],27,-1,53,-1,41
1,<environment.Job instance at 0x7f4be2b9f3c0>,42,18,[7 4],43,-1,62,-1,44
1,<environment.Job instance at 0x7f4be2b9f780>,43,14,[ 2 10],44,-1,62,-1,48
1,<environment.Job instance at 0x7f4be32d0f00>,53,16,[3 8],54,-1,71,-1,55
1,<environment.Job instance at 0x7f4be32d07d0>,54,13,[10  5],55,-1,68,-1,55
1,<environment.Job instance at 0x7f4be3a0a230>,60,18,[9 2],61,-1,89,-1,71
1,<environment.Job instance at 0x7f4be3a0ae60>,64,27,[6 1],65,-1,98,-1,71
1,<environment.Job instance at 0x7f4be242bcd0>,66,17,[ 5 11],67,-1,88,-1,71
1,<environment.Job instance at 0x7f4be3a0aa50>,65,14,[4 8],66,-1,85,-1,71
1,<environment.Job instance at 0x7f4be32d0d70>,58,16,[3 8],59,-1,87,-1,71
1,<environment.Job instance at 0x7f4be3a0a5f0>,62,17,[9 4],63,-1,88,-1,71
1,<environment.Job instance at 0x7f4be23f8550>,73,24,[10  2],74,-1,98,-1,74
1,<environment.Job instance at 0x7f4be23f8c30>,78,18,[5 9],79,-1,100,-1,82
1,<environment.Job instance at 0x7f4be2b9fc80>,44,27,[13  3],45,-1,119,-1,92
1,<environment.Job instance at 0x7f4be31a5b40>,80,18,[6 4],81,-1,110,-1,92
1,<environment.Job instance at 0x7f4be357d280>,83,13,[8 4],84,-1,105,-1,92
1,<environment.Job instance at 0x7f4bec3ee820>,85,16,[7 3],86,-1,108,-1,92
1,<environment.Job instance at 0x7f4be363e370>,69,16,[10  5],70,-1,108,-1,92
1,<environment.Job instance at 0x7f4bebfe2e60>,87,13,[10  4],88,-1,105,-1,92
1,<environment.Job instance at 0x7f4be3455640>,90,13,[12  1],91,-1,105,-1,92
1,<environment.Job instance at 0x7f4be33c6fa0>,91,16,[ 5 11],92,-1,108,-1,92
1,<environment.Job instance at 0x7f4be363ef00>,71,24,[14  3],72,-1,116,-1,92
1,<environment.Job instance at 0x7f4be33c6a50>,92,16,[5 4],93,-1,109,-1,93
1,<environment.Job instance at 0x7f4be386c0a0>,97,18,[1 6],98,-1,116,-1,98
1,<environment.Job instance at 0x7f4be363ed20>,70,12,[4 8],71,-1,122,-1,110
1,<environment.Job instance at 0x7f4be290ddc0>,102,14,[7 3],103,-1,124,-1,110
1,<environment.Job instance at 0x7f4be3626c30>,106,25,[7 3],107,-1,135,-1,110
1,<environment.Job instance at 0x7f4bebf4ceb0>,100,17,[9 2],101,-1,130,-1,113
1,<environment.Job instance at 0x7f4be3358f50>,109,18,[6 2],110,-1,131,-1,113
1,<environment.Job instance at 0x7f4be33c9690>,112,13,[ 3 10],113,-1,126,-1,113
1,<environment.Job instance at 0x7f4be33c9500>,113,14,[ 4 10],114,-1,128,-1,114
1,<environment.Job instance at 0x7f4be33c9870>,115,14,[5 7],116,-1,130,-1,116
1,<environment.Job instance at 0x7f4be2fd8460>,116,16,[9 2],117,-1,133,-1,117
1,<environment.Job instance at 0x7f4be2fd8550>,117,21,[9 4],118,-1,139,-1,118
1,<environment.Job instance at 0x7f4be2fd8690>,118,21,[5 1],119,-1,141,-1,120
1,<environment.Job instance at 0x7f4be28fd410>,122,12,[1 9],123,-1,135,-1,123
1,<environment.Job instance at 0x7f4be29ea5a0>,125,16,[4 9],126,-1,142,-1,126
1,<environment.Job instance at 0x7f4be37235f0>,126,18,[5 5],127,-1,145,-1,127
1,<environment.Job instance at 0x7f4be2947280>,129,20,[5 9],130,-1,151,-1,131
1,<environment.Job instance at 0x7f4be288c960>,131,14,[10  1],132,-1,146,-1,132
1,<environment.Job instance at 0x7f4be2363eb0>,110,26,[6 4],111,-1,160,-1,134
1,<environment.Job instance at 0x7f4be288cd70>,132,18,[3 8],133,-1,152,-1,134
1,<environment.Job instance at 0x7f4be2952370>,142,18,[3 7],143,-1,161,-1,143
1,<environment.Job instance at 0x7f4be29520a0>,143,12,[5 4],144,-1,156,-1,144
1,<environment.Job instance at 0x7f4be2952cd0>,145,13,[9 1],146,-1,161,-1,148
1,<environment.Job instance at 0x7f4be33bc410>,148,14,[ 1 10],149,-1,163,-1,149
1,<environment.Job instance at 0x7f4be33bce10>,150,25,[5 3],151,-1,176,-1,151
1,<environment.Job instance at 0x7f4be33bc9b0>,151,16,[11  2],152,-1,168,-1,152
1,<environment.Job instance at 0x7f4be29e7500>,153,13,[5 6],154,-1,167,-1,154
1,<environment.Job instance at 0x7f4be29e7fa0>,154,13,[3 6],155,-1,168,-1,155
1,<environment.Job instance at 0x7f4be296f730>,158,16,[10  3],159,-1,175,-1,159
1,<environment.Job instance at 0x7f4be32d0320>,7,24,[5 9],8,-1,42,-1,18
1,<environment.Job instance at 0x7f4be363e460>,11,28,[3 6],12,-1,47,-1,19
1,<environment.Job instance at 0x7f4be33c93c0>,19,26,[2 6],20,-1,79,-1,53
1,<environment.Job instance at 0x7f4be29e7410>,27,1,[ 1 13],28,-1,77,-1,76
1,<environment.Job instance at 0x7f4be33ab910>,28,26,[8 2],29,-1,111,-1,85
1,<environment.Job instance at 0x7f4be2985a50>,35,25,[ 3 14],36,-1,125,-1,100
1,<environment.Job instance at 0x7f4be21a4780>,41,3,[ 4 13],42,-1,126,-1,123
1,<environment.Job instance at 0x7f4be2dfc910>,44,27,[13  3],45,-1,153,-1,126
1,<environment.Job instance at 0x7f4be2f5e410>,64,27,[6 1],65,-1,248,-1,221
1,<environment.Job instance at 0x7f4be2f5e5a0>,66,17,[ 5 11],67,-1,238,-1,221
1,<environment.Job instance at 0x7f4be3413910>,71,24,[14  3],72,-1,260,-1,236
1,<environment.Job instance at 0x7f4be34135a0>,73,24,[10  2],74,-1,276,-1,252
1,<environment.Job instance at 0x7f4be31401e0>,90,13,[12  1],91,-1,309,-1,296
1,<environment.Job instance at 0x7f4be3140a00>,91,16,[ 5 11],92,-1,312,-1,296
1,<environment.Job instance at 0x7f4be31407d0>,95,27,[4 5],96,-1,349,-1,322
1,<environment.Job instance at 0x7f4be331fb90>,96,1,[12  2],97,-1,323,-1,322
1,<environment.Job instance at 0x7f4be331f5a0>,106,25,[7 3],107,-1,375,-1,350
1,<environment.Job instance at 0x7f4be34b9be0>,110,26,[6 4],111,-1,383,-1,357
1,<environment.Job instance at 0x7f4be2448780>,144,1,[13  5],145,-1,464,-1,463
1,<environment.Job instance at 0x7f4be29499b0>,150,25,[5 3],151,-1,515,-1,490
1,<environment.Job instance at 0x7f4be244a730>,151,16,[11  2],152,-1,506,-1,490
1,<environment.Job instance at 0x7f4be387a5f0>,2,23,[3 7],3,-1,26,-1,3
1,<environment.Job instance at 0x7f4be387a500>,4,17,[2 7],5,-1,23,-1,6
1,<environment.Job instance at 0x7f4be387af50>,8,17,[6 5],9,-1,26,-1,9
1,<environment.Job instance at 0x7f4be387a870>,9,18,[5 1],10,-1,29,-1,11
1,<environment.Job instance at 0x7f4be387aeb0>,11,12,[2 6],12,-1,24,-1,12
1,<environment.Job instance at 0x7f4be387ac80>,12,17,[6 4],13,-1,30,-1,13
1,<environment.Job instance at 0x7f4be387a190>,16,15,[5 6],17,-1,32,-1,17
1,<environment.Job instance at 0x7f4be21081e0>,21,16,[5 5],22,-1,38,-1,22
1,<environment.Job instance at 0x7f4be21086e0>,22,18,[2 5],23,-1,41,-1,23
1,<environment.Job instance at 0x7f4be2108050>,24,14,[ 3 10],25,-1,39,-1,25
1,<environment.Job instance at 0x7f4be2108320>,35,16,[10  3],36,-1,52,-1,36
1,<environment.Job instance at 0x7f4be284e780>,39,17,[9 4],40,-1,57,-1,40
1,<environment.Job instance at 0x7f4be284e640>,40,13,[10  1],41,-1,54,-1,41
1,<environment.Job instance at 0x7f4be284e5f0>,43,18,[4 5],44,-1,62,-1,44
1,<environment.Job instance at 0x7f4be284e690>,45,15,[1 5],46,-1,61,-1,46
1,<environment.Job instance at 0x7f4be284eaa0>,46,16,[5 6],47,-1,63,-1,47
1,<environment.Job instance at 0x7f4be20ea690>,58,16,[ 5 10],59,-1,77,-1,61
1,<environment.Job instance at 0x7f4be20ea8c0>,57,15,[10  4],58,-1,77,-1,62
1,<environment.Job instance at 0x7f4be20ea820>,61,1,[6 3],62,-1,63,-1,62
1,<environment.Job instance at 0x7f4be20ea460>,60,13,[1 5],61,-1,75,-1,62
1,<environment.Job instance at 0x7f4be284e280>,49,13,[ 4 14],50,-1,75,-1,62
1,<environment.Job instance at 0x7f4be20ea4b0>,62,14,[3 7],63,-1,80,-1,66
1,<environment.Job instance at 0x7f4be20b9e10>,66,27,[2 9],67,-1,94,-1,67
1,<environment.Job instance at 0x7f4be20b98c0>,67,15,[2 6],68,-1,83,-1,68
1,<environment.Job instance at 0x7f4be20b9dc0>,68,18,[ 5 10],69,-1,88,-1,70
1,<environment.Job instance at 0x7f4be20b92d0>,69,18,[10  2],70,-1,88,-1,70
1,<environment.Job instance at 0x7f4be20ea280>,65,13,[5 4],66,-1,83,-1,70
1,<environment.Job instance at 0x7f4be20b99b0>,70,13,[2 8],71,-1,86,-1,73
1,<environment.Job instance at 0x7f4be20b9320>,72,22,[8 1],73,-1,95,-1,73
1,<environment.Job instance at 0x7f4be20b9aa0>,77,15,[ 5 12],78,-1,96,-1,81
1,<environment.Job instance at 0x7f4be206daa0>,81,27,[8 5],82,-1,109,-1,82
1,<environment.Job instance at 0x7f4be20b9a50>,78,16,[9 1],79,-1,112,-1,96
1,<environment.Job instance at 0x7f4be206d640>,88,16,[13  2],89,-1,112,-1,96
1,<environment.Job instance at 0x7f4be206d780>,91,14,[ 2 12],92,-1,110,-1,96
1,<environment.Job instance at 0x7f4be2108910>,33,20,[ 5 12],34,-1,116,-1,96
1,<environment.Job instance at 0x7f4be206d7d0>,92,18,[10  5],93,-1,114,-1,96
1,<environment.Job instance at 0x7f4be206d4b0>,94,17,[10  5],95,-1,121,-1,104
1,<environment.Job instance at 0x7f4be20e8f00>,95,18,[5 6],96,-1,122,-1,104
1,<environment.Job instance at 0x7f4be206db90>,93,26,[7 1],94,-1,130,-1,104
1,<environment.Job instance at 0x7f4be206d820>,89,14,[2 8],90,-1,118,-1,104
1,<environment.Job instance at 0x7f4be20e86e0>,97,15,[ 4 10],98,-1,119,-1,104
1,<environment.Job instance at 0x7f4be206de10>,84,16,[11  4],85,-1,120,-1,104
1,<environment.Job instance at 0x7f4be20b90f0>,73,14,[14  4],74,-1,118,-1,104
1,<environment.Job instance at 0x7f4be20e8f50>,102,18,[9 1],103,-1,149,-1,131
1,<environment.Job instance at 0x7f4be1fa8dc0>,106,13,[1 6],107,-1,144,-1,131
1,<environment.Job instance at 0x7f4be2186e10>,112,18,[1 9],113,-1,149,-1,131
1,<environment.Job instance at 0x7f4bec2ec870>,114,18,[7 1],115,-1,150,-1,132
1,<environment.Job instance at 0x7f4bebf89e60>,118,15,[3 8],119,-1,147,-1,132
1,<environment.Job instance at 0x7f4be2e35960>,119,25,[3 6],120,-1,157,-1,132
1,<environment.Job instance at 0x7f4be3878eb0>,120,13,[5 8],121,-1,145,-1,132
1,<environment.Job instance at 0x7f4be33b0b40>,121,16,[ 5 12],122,-1,149,-1,133
1,<environment.Job instance at 0x7f4be39d8e60>,123,17,[13  5],124,-1,150,-1,133
1,<environment.Job instance at 0x7f4be20e8640>,103,13,[3 9],104,-1,147,-1,134
1,<environment.Job instance at 0x7f4be33bfcd0>,124,17,[8 5],125,-1,155,-1,138
1,<environment.Job instance at 0x7f4be2fe5640>,126,16,[1 5],127,-1,154,-1,138
1,<environment.Job instance at 0x7f4be30764b0>,125,17,[1 7],126,-1,155,-1,138
1,<environment.Job instance at 0x7f4be2057c30>,128,13,[10  4],129,-1,152,-1,139
1,<environment.Job instance at 0x7f4be2ce9c80>,110,12,[4 6],111,-1,151,-1,139
1,<environment.Job instance at 0x7f4be2d80050>,134,18,[ 4 10],135,-1,158,-1,140
1,<environment.Job instance at 0x7f4be24adaa0>,131,12,[7 2],132,-1,152,-1,140
1,<environment.Job instance at 0x7f4be2d80780>,136,15,[ 3 10],137,-1,155,-1,140
1,<environment.Job instance at 0x7f4be21daf00>,129,19,[2 5],130,-1,159,-1,140
1,<environment.Job instance at 0x7f4bec53de10>,138,13,[6 2],139,-1,153,-1,140
1,<environment.Job instance at 0x7f4be20eacd0>,51,16,[4 6],52,-1,157,-1,141
1,<environment.Job instance at 0x7f4be34f00a0>,141,12,[5 8],142,-1,154,-1,142
1,<environment.Job instance at 0x7f4be36be8c0>,143,18,[9 2],144,-1,162,-1,144
1,<environment.Job instance at 0x7f4be36e3320>,144,15,[6 2],145,-1,160,-1,145
1,<environment.Job instance at 0x7f4be36e3780>,146,16,[5 9],147,-1,163,-1,147
1,<environment.Job instance at 0x7f4be36e3aa0>,148,24,[5 6],149,-1,173,-1,149
1,<environment.Job instance at 0x7f4be3059b90>,151,17,[5 8],152,-1,169,-1,152
1,<environment.Job instance at 0x7f4bec016460>,153,14,[3 6],154,-1,168,-1,154
1,<environment.Job instance at 0x7f4be21635a0>,154,16,[8 2],155,-1,171,-1,155
1,<environment.Job instance at 0x7f4be2163050>,156,14,[4 7],157,-1,171,-1,157
1,<environment.Job instance at 0x7f4be21633c0>,158,12,[10  3],159,-1,171,-1,159
1,<environment.Job instance at 0x7f4be387a9b0>,2,23,[3 7],3,-1,27,-1,4
1,<environment.Job instance at 0x7f4be284ecd0>,6,3,[ 5 14],7,-1,10,-1,7
1,<environment.Job instance at 0x7f4be24adc80>,17,16,[11  1],18,-1,53,-1,37
1,<environment.Job instance at 0x7f4bebf8b460>,27,16,[ 5 13],28,-1,85,-1,69
1,<environment.Job instance at 0x7f4be37b8280>,29,2,[13  4],30,-1,72,-1,70
1,<environment.Job instance at 0x7f4be3937500>,33,20,[ 5 12],34,-1,93,-1,73
1,<environment.Job instance at 0x7f4be3937e60>,34,2,[ 5 11],35,-1,75,-1,73
1,<environment.Job instance at 0x7f4be2ba8500>,41,2,[ 5 11],42,-1,94,-1,92
1,<environment.Job instance at 0x7f4bec4497d0>,49,13,[ 4 14],50,-1,135,-1,122
1,<environment.Job instance at 0x7f4be1fff550>,56,16,[13  1],57,-1,155,-1,139
1,<environment.Job instance at 0x7f4be2ba73c0>,66,27,[2 9],67,-1,204,-1,177
1,<environment.Job instance at 0x7f4be2c8db40>,73,14,[14  4],74,-1,218,-1,204
1,<environment.Job instance at 0x7f4be327ebe0>,75,3,[ 1 13],76,-1,207,-1,204
1,<environment.Job instance at 0x7f4be299c3c0>,76,2,[14  2],77,-1,206,-1,204
1,<environment.Job instance at 0x7f4be36aceb0>,77,15,[ 5 12],78,-1,219,-1,204
1,<environment.Job instance at 0x7f4be29b20a0>,80,2,[14  4],81,-1,223,-1,221
1,<environment.Job instance at 0x7f4be34d47d0>,81,27,[8 5],82,-1,250,-1,223
1,<environment.Job instance at 0x7f4bec1944b0>,84,16,[11  4],85,-1,239,-1,223
1,<environment.Job instance at 0x7f4bec3ecaa0>,88,16,[13  2],89,-1,253,-1,237
1,<environment.Job instance at 0x7f4be27694b0>,91,14,[ 2 12],92,-1,255,-1,241
1,<environment.Job instance at 0x7f4be2769820>,93,26,[7 1],94,-1,277,-1,251
1,<environment.Job instance at 0x7f4bec300d20>,119,25,[3 6],120,-1,385,-1,360
1,<environment.Job instance at 0x7f4be3763960>,121,16,[ 5 12],122,-1,376,-1,360
1,<environment.Job instance at 0x7f4be3888be0>,123,17,[13  5],124,-1,379,-1,362
1,<environment.Job instance at 0x7f4be265d140>,135,2,[ 3 11],136,-1,405,-1,403
1,<environment.Job instance at 0x7f4be2569050>,142,3,[ 4 11],143,-1,436,-1,433
1,<environment.Job instance at 0x7f4be346ca50>,148,24,[5 6],149,-1,487,-1,463
1,<environment.Job instance at 0x7f4be20f86e0>,150,3,[ 3 12],151,-1,466,-1,463
1,<environment.Job instance at 0x7f4be339a320>,152,14,[14  5],153,-1,477,-1,463
1,<environment.Job instance at 0x7f4be38c86e0>,0,20,[ 4 10],1,-1,22,-1,2
1,<environment.Job instance at 0x7f4be2349910>,3,14,[ 4 10],4,-1,18,-1,4
1,<environment.Job instance at 0x7f4be2349190>,6,24,[4 5],7,-1,31,-1,7
1,<environment.Job instance at 0x7f4be2349dc0>,7,24,[4 8],8,-1,32,-1,8
1,<environment.Job instance at 0x7f4be218a690>,16,16,[4 9],17,-1,33,-1,17
1,<environment.Job instance at 0x7f4be218acd0>,18,14,[5 4],19,-1,33,-1,19
1,<environment.Job instance at 0x7f4be2294af0>,19,15,[6 4],20,-1,35,-1,20
1,<environment.Job instance at 0x7f4be2294280>,22,23,[6 2],23,-1,46,-1,23
1,<environment.Job instance at 0x7f4be22945f0>,26,17,[1 6],27,-1,44,-1,27
1,<environment.Job instance at 0x7f4be22942d0>,27,13,[9 4],28,-1,41,-1,28
1,<environment.Job instance at 0x7f4be231a410>,32,18,[6 5],33,-1,51,-1,33
1,<environment.Job instance at 0x7f4be231a2d0>,34,14,[ 5 10],35,-1,50,-1,36
1,<environment.Job instance at 0x7f4be231a5f0>,36,16,[4 8],37,-1,53,-1,37
1,<environment.Job instance at 0x7f4be231a5a0>,37,15,[4 8],38,-1,53,-1,38
1,<environment.Job instance at 0x7f4be227daf0>,38,15,[1 6],39,-1,54,-1,39
1,<environment.Job instance at 0x7f4be231ac80>,35,28,[ 4 12],36,-1,67,-1,39
1,<environment.Job instance at 0x7f4be227d320>,44,17,[1 6],45,-1,62,-1,45
1,<environment.Job instance at 0x7f4be3354b90>,45,14,[3 8],46,-1,60,-1,46
1,<environment.Job instance at 0x7f4be33540f0>,46,17,[4 6],47,-1,64,-1,47
1,<environment.Job instance at 0x7f4be33541e0>,48,18,[10  1],49,-1,69,-1,51
1,<environment.Job instance at 0x7f4be3354870>,52,17,[ 1 10],53,-1,70,-1,53
1,<environment.Job instance at 0x7f4be3354050>,53,15,[8 4],54,-1,69,-1,54
1,<environment.Job instance at 0x7f4be3354d20>,54,13,[1 9],55,-1,68,-1,55
1,<environment.Job instance at 0x7f4be3354dc0>,55,24,[5 2],56,-1,80,-1,56
1,<environment.Job instance at 0x7f4be33546e0>,60,25,[6 2],61,-1,86,-1,61
1,<environment.Job instance at 0x7f4be3354a50>,61,17,[9 4],62,-1,79,-1,62
1,<environment.Job instance at 0x7f4bebf04d70>,65,14,[4 8],66,-1,80,-1,66
1,<environment.Job instance at 0x7f4bebf04910>,66,12,[9 1],67,-1,79,-1,67
1,<environment.Job instance at 0x7f4bebf04aa0>,68,18,[10  4],69,-1,87,-1,69
1,<environment.Job instance at 0x7f4bebf049b0>,69,13,[ 1 11],70,-1,83,-1,70
1,<environment.Job instance at 0x7f4bebf04190>,70,25,[5 5],71,-1,96,-1,71
1,<environment.Job instance at 0x7f4bebf04050>,71,13,[9 3],72,-1,85,-1,72
1,<environment.Job instance at 0x7f4be2b33460>,75,19,[2 8],76,-1,95,-1,76
1,<environment.Job instance at 0x7f4be2b33410>,76,16,[ 1 10],77,-1,93,-1,77
1,<environment.Job instance at 0x7f4be2b33640>,79,15,[ 5 10],80,-1,95,-1,80
1,<environment.Job instance at 0x7f4be2b33280>,81,17,[ 2 10],82,-1,99,-1,82
1,<environment.Job instance at 0x7f4be2b33aa0>,82,16,[2 8],83,-1,99,-1,83
1,<environment.Job instance at 0x7f4be2b335f0>,85,18,[4 6],86,-1,104,-1,86
1,<environment.Job instance at 0x7f4be2191780>,86,15,[5 9],87,-1,102,-1,87
1,<environment.Job instance at 0x7f4be2191a00>,89,17,[ 1 10],90,-1,107,-1,90
1,<environment.Job instance at 0x7f4be21918c0>,90,15,[8 4],91,-1,106,-1,91
1,<environment.Job instance at 0x7f4be2191a50>,91,12,[8 1],92,-1,104,-1,92
1,<environment.Job instance at 0x7f4be2191870>,92,13,[5 3],93,-1,106,-1,93
1,<environment.Job instance at 0x7f4be21912d0>,94,19,[ 5 10],95,-1,114,-1,95
1,<environment.Job instance at 0x7f4be22e74b0>,96,15,[3 9],97,-1,112,-1,97
1,<environment.Job instance at 0x7f4be302e1e0>,97,27,[8 5],98,-1,125,-1,98
1,<environment.Job instance at 0x7f4be302eb90>,100,13,[8 3],101,-1,114,-1,101
1,<environment.Job instance at 0x7f4be329efa0>,105,15,[10  1],106,-1,121,-1,106
1,<environment.Job instance at 0x7f4be36df8c0>,106,13,[ 2 10],107,-1,120,-1,107
1,<environment.Job instance at 0x7f4be36ac6e0>,110,20,[8 5],111,-1,131,-1,111
1,<environment.Job instance at 0x7f4be34dcaf0>,114,16,[5 8],115,-1,131,-1,115
1,<environment.Job instance at 0x7f4be299c730>,115,25,[4 5],116,-1,141,-1,116
1,<environment.Job instance at 0x7f4be26ea3c0>,120,18,[3 5],121,-1,139,-1,121
1,<environment.Job instance at 0x7f4be3886e60>,121,15,[3 7],122,-1,137,-1,122
1,<environment.Job instance at 0x7f4be361d730>,131,13,[3 5],132,-1,145,-1,132
1,<environment.Job instance at 0x7f4be361db90>,132,18,[4 8],133,-1,151,-1,133
1,<environment.Job instance at 0x7f4be361d910>,133,15,[ 2 10],134,-1,149,-1,134
1,<environment.Job instance at 0x7f4be2191690>,88,16,[14  4],89,-1,154,-1,138
1,<environment.Job instance at 0x7f4be3354aa0>,50,15,[4 7],51,-1,153,-1,138
1,<environment.Job instance at 0x7f4be34b7460>,138,12,[10  4],139,-1,152,-1,140
1,<environment.Job instance at 0x7f4be3006c30>,151,17,[7 4],152,-1,170,-1,153
1,<environment.Job instance at 0x7f4be37cd280>,153,14,[ 5 10],154,-1,169,-1,155
1,<environment.Job instance at 0x7f4be339e0a0>,155,13,[7 4],156,-1,169,-1,156
1,<environment.Job instance at 0x7f4be2f48af0>,156,16,[3 8],157,-1,173,-1,157
1,<environment.Job instance at 0x7f4be33547d0>,6,24,[4 5],7,-1,44,-1,20
1,<environment.Job instance at 0x7f4be227dd20>,7,24,[4 8],8,-1,45,-1,21
1,<environment.Job instance at 0x7f4be235e7d0>,22,23,[6 2],23,-1,67,-1,44
1,<environment.Job instance at 0x7f4be2cc4050>,24,3,[ 1 12],25,-1,47,-1,44
1,<environment.Job instance at 0x7f4be3005e60>,25,14,[12  1],26,-1,58,-1,44
1,<environment.Job instance at 0x7f4be23495a0>,33,1,[11  3],34,-1,63,-1,62
1,<environment.Job instance at 0x7f4be2349870>,35,28,[ 4 12],36,-1,91,-1,63
1,<environment.Job instance at 0x7f4be3076eb0>,39,1,[ 4 13],40,-1,91,-1,90
1,<environment.Job instance at 0x7f4be3886870>,43,14,[ 2 11],44,-1,119,-1,105
1,<environment.Job instance at 0x7f4be37639b0>,55,24,[5 2],56,-1,183,-1,159
1,<environment.Job instance at 0x7f4be29bb7d0>,60,25,[6 2],61,-1,211,-1,186
1,<environment.Job instance at 0x7f4be34009b0>,69,13,[ 1 11],70,-1,218,-1,205
1,<environment.Job instance at 0x7f4be26c82d0>,70,25,[5 5],71,-1,233,-1,208
1,<environment.Job instance at 0x7f4be339e960>,73,3,[ 4 11],74,-1,211,-1,208
1,<environment.Job instance at 0x7f4be205de10>,88,16,[14  4],89,-1,286,-1,270
1,<environment.Job instance at 0x7f4be33c7500>,97,27,[8 5],98,-1,339,-1,312
1,<environment.Job instance at 0x7f4be21a7af0>,99,3,[ 1 12],100,-1,315,-1,312
1,<environment.Job instance at 0x7f4be3937500>,103,17,[13  3],104,-1,337,-1,320
1,<environment.Job instance at 0x7f4be3937280>,104,3,[13  1],105,-1,323,-1,320
1,<environment.Job instance at 0x7f4be2ef56e0>,115,25,[4 5],116,-1,377,-1,352
1,<environment.Job instance at 0x7f4be387a9b0>,118,1,[ 4 14],119,-1,364,-1,363
1,<environment.Job instance at 0x7f4be2fb9280>,130,2,[13  2],131,-1,392,-1,390
1,<environment.Job instance at 0x7f4be2fb9eb0>,134,1,[12  5],135,-1,398,-1,397
1,<environment.Job instance at 0x7f4be2eaad20>,137,26,[ 3 10],138,-1,441,-1,415
1,<environment.Job instance at 0x7f4be300ae10>,141,3,[12  2],142,-1,434,-1,431
1,<environment.Job instance at 0x7f4be3007b40>,154,3,[14  3],155,-1,456,-1,453
1,<environment.Job instance at 0x7f4be2932e10>,2,17,[5 7],3,-1,20,-1,3
1,<environment.Job instance at 0x7f4be293a550>,10,18,[9 3],11,-1,29,-1,11
1,<environment.Job instance at 0x7f4be293a640>,11,17,[9 4],12,-1,29,-1,12
1,<environment.Job instance at 0x7f4be293aaa0>,16,17,[4 8],17,-1,34,-1,17
1,<environment.Job instance at 0x7f4be293ab90>,17,14,[5 6],18,-1,32,-1,18
1,<environment.Job instance at 0x7f4be293a960>,18,16,[8 4],19,-1,35,-1,19
1,<environment.Job instance at 0x7f4be293ac80>,19,17,[5 6],20,-1,37,-1,20
1,<environment.Job instance at 0x7f4be2931050>,24,13,[10  1],25,-1,40,-1,27
1,<environment.Job instance at 0x7f4be29314b0>,27,13,[7 1],28,-1,41,-1,28
1,<environment.Job instance at 0x7f4be2931730>,30,12,[3 8],31,-1,43,-1,31
1,<environment.Job instance at 0x7f4be2931870>,31,18,[7 1],32,-1,50,-1,32
1,<environment.Job instance at 0x7f4be2931500>,32,15,[6 2],33,-1,48,-1,33
1,<environment.Job instance at 0x7f4be2931aa0>,35,16,[3 5],36,-1,52,-1,36
1,<environment.Job instance at 0x7f4be2931c80>,36,14,[6 2],37,-1,51,-1,37
1,<environment.Job instance at 0x7f4be2931f00>,39,14,[7 3],40,-1,54,-1,40
1,<environment.Job instance at 0x7f4be29440a0>,41,26,[7 2],42,-1,68,-1,42
1,<environment.Job instance at 0x7f4be29441e0>,42,17,[1 5],43,-1,60,-1,43
1,<environment.Job instance at 0x7f4be2944320>,44,18,[4 8],45,-1,63,-1,45
1,<environment.Job instance at 0x7f4be29443c0>,46,12,[5 3],47,-1,59,-1,47
1,<environment.Job instance at 0x7f4be2944690>,47,15,[6 1],48,-1,63,-1,48
1,<environment.Job instance at 0x7f4be2944550>,48,15,[10  2],49,-1,64,-1,49
1,<environment.Job instance at 0x7f4be2944780>,49,13,[4 7],50,-1,63,-1,50
1,<environment.Job instance at 0x7f4be29448c0>,51,23,[5 9],52,-1,75,-1,52
1,<environment.Job instance at 0x7f4be2944aa0>,52,14,[5 2],53,-1,67,-1,53
1,<environment.Job instance at 0x7f4be2944f50>,57,22,[2 9],58,-1,80,-1,58
1,<environment.Job instance at 0x7f4be2957410>,61,16,[5 2],62,-1,78,-1,62
1,<environment.Job instance at 0x7f4be29574b0>,62,2,[5 4],63,-1,65,-1,63
1,<environment.Job instance at 0x7f4be29571e0>,63,15,[ 3 10],64,-1,79,-1,64
1,<environment.Job instance at 0x7f4be2957640>,64,12,[7 5],65,-1,77,-1,65
1,<environment.Job instance at 0x7f4be29576e0>,65,14,[7 5],66,-1,80,-1,66
1,<environment.Job instance at 0x7f4be2957780>,66,20,[8 2],67,-1,87,-1,67
1,<environment.Job instance at 0x7f4be2957820>,67,16,[8 4],68,-1,84,-1,68
1,<environment.Job instance at 0x7f4be29311e0>,26,15,[4 6],27,-1,83,-1,68
1,<environment.Job instance at 0x7f4be2957550>,68,26,[2 5],69,-1,95,-1,69
1,<environment.Job instance at 0x7f4be2957a00>,70,15,[10  5],71,-1,88,-1,73
1,<environment.Job instance at 0x7f4be2618140>,76,24,[2 9],77,-1,101,-1,77
1,<environment.Job instance at 0x7f4be2618870>,85,15,[9 1],86,-1,110,-1,95
1,<environment.Job instance at 0x7f4be2618cd0>,90,15,[1 8],91,-1,110,-1,95
1,<environment.Job instance at 0x7f4be2618af0>,87,16,[8 4],88,-1,113,-1,97
1,<environment.Job instance at 0x7f4be261e500>,97,14,[4 7],98,-1,116,-1,102
1,<environment.Job instance at 0x7f4be261e870>,100,12,[9 4],101,-1,114,-1,102
1,<environment.Job instance at 0x7f4be261eaf0>,101,23,[1 8],102,-1,126,-1,103
1,<environment.Job instance at 0x7f4be3164640>,102,14,[3 7],103,-1,117,-1,103
1,<environment.Job instance at 0x7f4be2423050>,104,17,[3 5],105,-1,122,-1,105
1,<environment.Job instance at 0x7f4be261e140>,94,14,[5 3],95,-1,129,-1,115
1,<environment.Job instance at 0x7f4be25f9460>,117,18,[ 1 10],118,-1,166,-1,148
1,<environment.Job instance at 0x7f4be25f95a0>,116,25,[8 1],117,-1,173,-1,148
1,<environment.Job instance at 0x7f4be2062050>,123,16,[9 5],124,-1,174,-1,158
1,<environment.Job instance at 0x7f4be32a7460>,124,28,[7 4],125,-1,186,-1,158
1,<environment.Job instance at 0x7f4be26183c0>,81,16,[8 4],82,-1,174,-1,158
1,<environment.Job instance at 0x7f4be20632d0>,118,12,[6 3],119,-1,170,-1,158
1,<environment.Job instance at 0x7f4be2423c80>,105,15,[ 1 10],106,-1,174,-1,159
1,<environment.Job instance at 0x7f4be328fd70>,127,17,[5 6],128,-1,176,-1,159
1,<environment.Job instance at 0x7f4be33be280>,129,17,[5 2],130,-1,176,-1,159
1,<environment.Job instance at 0x7f4be33cb190>,130,14,[6 1],131,-1,187,-1,173
1,<environment.Job instance at 0x7f4be2931960>,33,15,[ 2 12],34,-1,205,-1,190
1,<environment.Job instance at 0x7f4be320aa00>,136,17,[8 4],137,-1,207,-1,190
1,<environment.Job instance at 0x7f4be32b29b0>,145,20,[5 5],146,-1,222,-1,202
1,<environment.Job instance at 0x7f4be320afa0>,146,18,[7 3],147,-1,220,-1,202
1,<environment.Job instance at 0x7f4be2220e60>,147,13,[14  1],148,-1,233,-1,220
1,<environment.Job instance at 0x7f4be323b820>,151,18,[3 9],152,-1,238,-1,220
1,<environment.Job instance at 0x7f4be323bf00>,152,15,[5 5],153,-1,235,-1,220
1,<environment.Job instance at 0x7f4be2618190>,78,14,[13  4],79,-1,234,-1,220
1,<environment.Job instance at 0x7f4be323b960>,150,16,[ 2 10],151,-1,236,-1,220
1,<environment.Job instance at 0x7f4be33d1500>,131,17,[9 3],132,-1,237,-1,220
1,<environment.Job instance at 0x7f4be2944b90>,6,1,[11  3],7,-1,8,-1,7
1,<environment.Job instance at 0x7f4be26180a0>,13,14,[14  1],14,-1,36,-1,22
1,<environment.Job instance at 0x7f4be3222b40>,22,17,[ 5 14],23,-1,77,-1,60
1,<environment.Job instance at 0x7f4be226aeb0>,33,15,[ 2 12],34,-1,107,-1,92
1,<environment.Job instance at 0x7f4be36e3690>,38,2,[13  1],39,-1,116,-1,114
1,<environment.Job instance at 0x7f4bec016500>,41,26,[7 2],42,-1,156,-1,130
1,<environment.Job instance at 0x7f4bec4493c0>,51,23,[5 9],52,-1,197,-1,174
1,<environment.Job instance at 0x7f4be205df50>,53,3,[ 1 14],54,-1,177,-1,174
1,<environment.Job instance at 0x7f4bec537c30>,56,1,[ 3 13],57,-1,176,-1,175
1,<environment.Job instance at 0x7f4be28c4500>,68,26,[2 5],69,-1,245,-1,219
1,<environment.Job instance at 0x7f4be37b4f00>,76,24,[2 9],77,-1,275,-1,251
1,<environment.Job instance at 0x7f4be3888460>,77,12,[ 2 12],78,-1,263,-1,251
1,<environment.Job instance at 0x7f4be3886aa0>,78,14,[13  4],79,-1,265,-1,251
1,<environment.Job instance at 0x7f4be200f690>,79,20,[ 3 11],80,-1,271,-1,251
1,<environment.Job instance at 0x7f4be227d9b0>,96,1,[ 3 11],97,-1,318,-1,317
1,<environment.Job instance at 0x7f4be218aaf0>,101,23,[1 8],102,-1,356,-1,333
1,<environment.Job instance at 0x7f4be2b559b0>,106,13,[ 5 11],107,-1,361,-1,348
1,<environment.Job instance at 0x7f4bebeef410>,116,25,[8 1],117,-1,408,-1,383
1,<environment.Job instance at 0x7f4be26ecb90>,124,28,[7 4],125,-1,429,-1,401
1,<environment.Job instance at 0x7f4be28fd460>,147,13,[14  1],148,-1,501,-1,488
1,<environment.Job instance at 0x7f4be323f410>,156,2,[14  1],157,-1,532,-1,530
1,<environment.Job instance at 0x7f4be324ef00>,1,25,[1 6],2,-1,27,-1,2
1,<environment.Job instance at 0x7f4be22b1a00>,9,15,[9 1],10,-1,26,-1,11
1,<environment.Job instance at 0x7f4be22b1460>,11,15,[10  4],12,-1,27,-1,12
1,<environment.Job instance at 0x7f4bec418dc0>,10,12,[10  4],11,-1,24,-1,12
1,<environment.Job instance at 0x7f4be21965a0>,25,17,[9 3],26,-1,51,-1,34
1,<environment.Job instance at 0x7f4be22b1eb0>,16,14,[9 2],17,-1,51,-1,37
1,<environment.Job instance at 0x7f4be2196910>,22,26,[9 1],23,-1,63,-1,37
1,<environment.Job instance at 0x7f4be2196320>,27,20,[10  2],28,-1,57,-1,37
1,<environment.Job instance at 0x7f4be2d58870>,30,3,[8 5],31,-1,40,-1,37
1,<environment.Job instance at 0x7f4be2196d70>,28,14,[1 9],29,-1,51,-1,37
1,<environment.Job instance at 0x7f4be2196eb0>,19,27,[ 3 10],20,-1,64,-1,37
1,<environment.Job instance at 0x7f4be2d58190>,31,13,[7 4],32,-1,50,-1,37
1,<environment.Job instance at 0x7f4be388a0a0>,5,24,[4 7],6,-1,61,-1,37
1,<environment.Job instance at 0x7f4be2d58370>,32,2,[4 9],33,-1,40,-1,38
1,<environment.Job instance at 0x7f4be2d58b90>,36,14,[8 3],37,-1,52,-1,38
1,<environment.Job instance at 0x7f4be2d58320>,37,27,[9 4],38,-1,65,-1,38
1,<environment.Job instance at 0x7f4be2d58cd0>,39,15,[5 5],40,-1,56,-1,41
1,<environment.Job instance at 0x7f4be2d58230>,40,15,[2 8],41,-1,56,-1,41
1,<environment.Job instance at 0x7f4be3867d70>,46,14,[2 6],47,-1,61,-1,47
1,<environment.Job instance at 0x7f4be2d58960>,45,15,[8 4],46,-1,63,-1,48
1,<environment.Job instance at 0x7f4be2d58640>,42,18,[2 5],43,-1,67,-1,49
1,<environment.Job instance at 0x7f4be3867910>,49,17,[5 4],50,-1,67,-1,50
1,<environment.Job instance at 0x7f4be3867fa0>,48,17,[13  5],49,-1,68,-1,51
1,<environment.Job instance at 0x7f4be3867320>,52,15,[10  3],53,-1,72,-1,57
1,<environment.Job instance at 0x7f4be38674b0>,55,16,[3 8],56,-1,73,-1,57
1,<environment.Job instance at 0x7f4be3867e60>,47,15,[6 2],48,-1,73,-1,58
1,<environment.Job instance at 0x7f4be2d58280>,44,15,[10  1],45,-1,75,-1,60
1,<environment.Job instance at 0x7f4be3867c30>,59,14,[4 7],60,-1,74,-1,60
1,<environment.Job instance at 0x7f4be3867640>,54,18,[9 3],55,-1,80,-1,62
1,<environment.Job instance at 0x7f4be3867050>,62,13,[13  5],63,-1,76,-1,63
1,<environment.Job instance at 0x7f4be3837870>,64,14,[5 6],65,-1,79,-1,65
1,<environment.Job instance at 0x7f4be3837b40>,67,17,[ 5 10],68,-1,85,-1,68
1,<environment.Job instance at 0x7f4be3837050>,68,21,[2 5],69,-1,90,-1,69
1,<environment.Job instance at 0x7f4be38377d0>,69,23,[5 7],70,-1,93,-1,70
1,<environment.Job instance at 0x7f4be3837410>,70,15,[3 7],71,-1,87,-1,72
1,<environment.Job instance at 0x7f4be3837460>,71,13,[1 7],72,-1,91,-1,78
1,<environment.Job instance at 0x7f4be3837230>,77,19,[ 2 10],78,-1,102,-1,83
1,<environment.Job instance at 0x7f4bebf94dc0>,86,14,[9 3],87,-1,101,-1,87
1,<environment.Job instance at 0x7f4be38372d0>,76,12,[14  2],77,-1,100,-1,88
1,<environment.Job instance at 0x7f4bebf94140>,81,18,[9 3],82,-1,106,-1,88
1,<environment.Job instance at 0x7f4bebf94f00>,88,18,[7 1],89,-1,107,-1,89
1,<environment.Job instance at 0x7f4bebf94050>,90,12,[ 1 13],91,-1,106,-1,94
1,<environment.Job instance at 0x7f4bebf94c30>,93,13,[10  4],94,-1,107,-1,94
1,<environment.Job instance at 0x7f4be3837640>,73,25,[ 1 10],74,-1,119,-1,94
1,<environment.Job instance at 0x7f4be38d6cd0>,97,15,[8 5],98,-1,118,-1,103
1,<environment.Job instance at 0x7f4be29e6960>,99,21,[7 2],100,-1,125,-1,104
1,<environment.Job instance at 0x7f4be38d6dc0>,96,1,[6 4],97,-1,107,-1,106
1,<environment.Job instance at 0x7f4be2960960>,103,14,[6 1],104,-1,122,-1,108
1,<environment.Job instance at 0x7f4be20fddc0>,102,16,[8 1],103,-1,125,-1,109
1,<environment.Job instance at 0x7f4be30f9690>,100,13,[4 9],101,-1,122,-1,109
1,<environment.Job instance at 0x7f4bec532820>,106,23,[ 5 12],107,-1,132,-1,109
1,<environment.Job instance at 0x7f4be32beb40>,107,21,[10  4],108,-1,130,-1,109
1,<environment.Job instance at 0x7f4be2d17b40>,111,21,[1 7],112,-1,136,-1,115
1,<environment.Job instance at 0x7f4bebf94870>,91,12,[4 6],92,-1,128,-1,116
1,<environment.Job instance at 0x7f4be2855cd0>,113,14,[6 4],114,-1,130,-1,116
1,<environment.Job instance at 0x7f4be2082c80>,115,12,[10  3],116,-1,128,-1,116
1,<environment.Job instance at 0x7f4be2082280>,116,16,[1 7],117,-1,136,-1,120
1,<environment.Job instance at 0x7f4be2082460>,119,14,[2 5],120,-1,134,-1,120
1,<environment.Job instance at 0x7f4be2551d20>,121,16,[1 5],122,-1,138,-1,122
1,<environment.Job instance at 0x7f4be385ceb0>,122,18,[1 5],123,-1,141,-1,123
1,<environment.Job instance at 0x7f4be385c230>,123,15,[2 8],124,-1,139,-1,124
1,<environment.Job instance at 0x7f4be2f5e280>,128,16,[6 5],129,-1,145,-1,129
1,<environment.Job instance at 0x7f4be27ab4b0>,130,25,[6 2],131,-1,157,-1,132
1,<environment.Job instance at 0x7f4be2792690>,134,21,[5 2],135,-1,158,-1,137
1,<environment.Job instance at 0x7f4be36464b0>,127,13,[ 5 10],128,-1,151,-1,138
1,<environment.Job instance at 0x7f4be27927d0>,137,16,[1 7],138,-1,154,-1,138
1,<environment.Job instance at 0x7f4be3009730>,141,18,[14  2],142,-1,160,-1,142
1,<environment.Job instance at 0x7f4bebf58410>,104,14,[ 1 12],105,-1,157,-1,143
1,<environment.Job instance at 0x7f4be350fa00>,140,16,[5 9],141,-1,159,-1,143
1,<environment.Job instance at 0x7f4be2860f00>,144,17,[4 9],145,-1,162,-1,145
1,<environment.Job instance at 0x7f4be2dcbcd0>,146,18,[1 8],147,-1,165,-1,147
1,<environment.Job instance at 0x7f4be2196dc0>,1,25,[1 6],2,-1,27,-1,2
1,<environment.Job instance at 0x7f4be2196370>,2,12,[12  2],3,-1,15,-1,3
1,<environment.Job instance at 0x7f4be2d58820>,3,26,[10  4],4,-1,30,-1,4
1,<environment.Job instance at 0x7f4be2d58eb0>,5,24,[4 7],6,-1,30,-1,6
1,<environment.Job instance at 0x7f4bebf94c80>,14,13,[ 5 11],15,-1,35,-1,22
1,<environment.Job instance at 0x7f4be2353dc0>,19,27,[ 3 10],20,-1,57,-1,30
1,<environment.Job instance at 0x7f4bebf94e10>,17,28,[7 2],18,-1,62,-1,34
1,<environment.Job instance at 0x7f4be26ed690>,22,26,[9 1],23,-1,60,-1,34
1,<environment.Job instance at 0x7f4be26ec5f0>,26,3,[ 2 14],27,-1,38,-1,35
1,<environment.Job instance at 0x7f4be36dfbe0>,37,27,[9 4],38,-1,93,-1,66
1,<environment.Job instance at 0x7f4be358caf0>,48,17,[13  5],49,-1,119,-1,102
1,<environment.Job instance at 0x7f4be2960fa0>,62,13,[13  5],63,-1,183,-1,170
1,<environment.Job instance at 0x7f4be30cb960>,65,2,[ 2 12],66,-1,174,-1,172
1,<environment.Job instance at 0x7f4be2110460>,69,23,[5 7],70,-1,209,-1,186
1,<environment.Job instance at 0x7f4be2c7ec30>,73,25,[ 1 10],74,-1,226,-1,201
1,<environment.Job instance at 0x7f4be2ed2280>,76,12,[14  2],77,-1,213,-1,201
1,<environment.Job instance at 0x7f4be276a780>,78,1,[ 5 14],79,-1,202,-1,201
1,<environment.Job instance at 0x7f4be3632870>,90,12,[ 1 13],91,-1,260,-1,248
1,<environment.Job instance at 0x7f4be309fb40>,95,2,[11  4],96,-1,267,-1,265
1,<environment.Job instance at 0x7f4be227d8c0>,104,14,[ 1 12],105,-1,310,-1,296
1,<environment.Job instance at 0x7f4be20e8280>,106,23,[ 5 12],107,-1,322,-1,299
1,<environment.Job instance at 0x7f4be37a30f0>,112,1,[ 4 11],113,-1,318,-1,317
1,<environment.Job instance at 0x7f4be33d2b90>,124,3,[ 1 12],125,-1,366,-1,363
1,<environment.Job instance at 0x7f4be25ff5f0>,130,25,[6 2],131,-1,423,-1,398
1,<environment.Job instance at 0x7f4be21b2500>,132,3,[14  1],133,-1,401,-1,398
1,<environment.Job instance at 0x7f4be21b2fa0>,133,1,[ 4 12],134,-1,399,-1,398
1,<environment.Job instance at 0x7f4be37de410>,141,18,[14  2],142,-1,434,-1,416
1,<environment.Job instance at 0x7f4be3712820>,145,15,[12  5],146,-1,440,-1,425
1,<environment.Job instance at 0x7f4be2bc3e10>,148,20,[ 4 13],149,-1,459,-1,439
1,<environment.Job instance at 0x7f4be2d17190>,147,27,[4 8],148,-1,472,-1,445
1,<environment.Job instance at 0x7f4be378b230>,2,15,[9 5],3,-1,19,-1,4
1,<environment.Job instance at 0x7f4be378b500>,6,18,[4 9],7,-1,25,-1,7
1,<environment.Job instance at 0x7f4be378baa0>,7,18,[5 3],8,-1,26,-1,8
1,<environment.Job instance at 0x7f4be378b7d0>,9,13,[9 3],10,-1,24,-1,11
1,<environment.Job instance at 0x7f4be2516140>,12,16,[8 1],13,-1,29,-1,13
1,<environment.Job instance at 0x7f4be2a2a3c0>,19,17,[3 5],20,-1,37,-1,20
1,<environment.Job instance at 0x7f4be25f4f00>,20,17,[5 8],21,-1,38,-1,21
1,<environment.Job instance at 0x7f4be392ab90>,24,18,[6 5],25,-1,43,-1,25
1,<environment.Job instance at 0x7f4be392ad20>,29,16,[5 5],30,-1,46,-1,30
1,<environment.Job instance at 0x7f4be2e377d0>,32,17,[3 5],33,-1,50,-1,33
1,<environment.Job instance at 0x7f4be2e37a50>,35,18,[4 9],36,-1,54,-1,36
1,<environment.Job instance at 0x7f4be35c6fa0>,36,14,[8 5],37,-1,51,-1,37
1,<environment.Job instance at 0x7f4be35c61e0>,38,18,[6 5],39,-1,57,-1,39
1,<environment.Job instance at 0x7f4be2b385f0>,43,18,[6 1],44,-1,62,-1,44
1,<environment.Job instance at 0x7f4be2b38c30>,44,16,[1 6],45,-1,61,-1,45
1,<environment.Job instance at 0x7f4be2b38a50>,45,16,[10  1],46,-1,63,-1,47
1,<environment.Job instance at 0x7f4be2b381e0>,46,21,[10  4],47,-1,68,-1,47
1,<environment.Job instance at 0x7f4be38c23c0>,53,15,[8 2],54,-1,71,-1,56
1,<environment.Job instance at 0x7f4be34ad690>,55,23,[7 3],56,-1,79,-1,56
1,<environment.Job instance at 0x7f4be32bee60>,57,20,[8 3],58,-1,80,-1,60
1,<environment.Job instance at 0x7f4bec01d7d0>,59,22,[9 1],60,-1,82,-1,60
1,<environment.Job instance at 0x7f4be349e640>,61,16,[1 7],62,-1,79,-1,63
1,<environment.Job instance at 0x7f4be358cd20>,65,1,[8 4],66,-1,67,-1,66
1,<environment.Job instance at 0x7f4be358c9b0>,66,12,[1 9],67,-1,79,-1,67
1,<environment.Job instance at 0x7f4be358cfa0>,67,2,[4 5],68,-1,70,-1,68
1,<environment.Job instance at 0x7f4be358c230>,68,18,[5 9],69,-1,87,-1,69
1,<environment.Job instance at 0x7f4be358c730>,69,16,[8 4],70,-1,86,-1,70
1,<environment.Job instance at 0x7f4be358ca00>,72,16,[4 7],73,-1,89,-1,73
1,<environment.Job instance at 0x7f4be276a050>,73,16,[5 9],74,-1,90,-1,74
1,<environment.Job instance at 0x7f4be276a370>,74,16,[3 5],75,-1,91,-1,75
1,<environment.Job instance at 0x7f4be276a280>,75,15,[ 3 10],76,-1,91,-1,76
1,<environment.Job instance at 0x7f4be358c140>,62,18,[ 3 13],63,-1,100,-1,82
1,<environment.Job instance at 0x7f4be29b4dc0>,82,26,[9 3],83,-1,109,-1,83
1,<environment.Job instance at 0x7f4be29b4230>,85,15,[8 3],86,-1,101,-1,86
1,<environment.Job instance at 0x7f4be29b4780>,87,13,[9 2],88,-1,101,-1,88
1,<environment.Job instance at 0x7f4be337bfa0>,90,14,[5 3],91,-1,108,-1,94
1,<environment.Job instance at 0x7f4be337bbe0>,93,14,[5 9],94,-1,109,-1,95
1,<environment.Job instance at 0x7f4be32796e0>,95,18,[6 4],96,-1,115,-1,97
1,<environment.Job instance at 0x7f4be3279500>,97,22,[6 4],98,-1,120,-1,98
1,<environment.Job instance at 0x7f4be3279c80>,100,15,[4 9],101,-1,116,-1,101
1,<environment.Job instance at 0x7f4be3279e60>,96,15,[ 1 11],97,-1,117,-1,102
1,<environment.Job instance at 0x7f4be303fc80>,104,17,[9 5],105,-1,122,-1,105
1,<environment.Job instance at 0x7f4be303fdc0>,106,12,[9 2],107,-1,120,-1,108
1,<environment.Job instance at 0x7f4be303fe10>,107,18,[3 7],108,-1,126,-1,108
1,<environment.Job instance at 0x7f4be38d7c80>,115,19,[10  1],116,-1,135,-1,116
1,<environment.Job instance at 0x7f4be2bc1aa0>,113,12,[ 4 10],114,-1,128,-1,116
1,<environment.Job instance at 0x7f4be2bc12d0>,114,18,[ 2 10],115,-1,135,-1,117
1,<environment.Job instance at 0x7f4be303f280>,108,12,[14  5],109,-1,129,-1,117
1,<environment.Job instance at 0x7f4be2bc1780>,111,17,[7 1],112,-1,134,-1,117
1,<environment.Job instance at 0x7f4be2bc1370>,116,14,[2 9],117,-1,133,-1,119
1,<environment.Job instance at 0x7f4be3748050>,118,23,[1 5],119,-1,145,-1,122
1,<environment.Job instance at 0x7f4be27482d0>,122,15,[1 9],123,-1,138,-1,123
1,<environment.Job instance at 0x7f4be38343c0>,123,18,[10  4],124,-1,142,-1,124
1,<environment.Job instance at 0x7f4be3834730>,124,14,[ 4 10],125,-1,139,-1,125
1,<environment.Job instance at 0x7f4be236b870>,127,20,[5 3],128,-1,148,-1,128
1,<environment.Job instance at 0x7f4be270ce10>,130,16,[10  2],131,-1,147,-1,131
1,<environment.Job instance at 0x7f4bec025730>,131,16,[ 2 10],132,-1,148,-1,132
1,<environment.Job instance at 0x7f4bec025690>,133,16,[1 9],134,-1,150,-1,134
1,<environment.Job instance at 0x7f4bec025870>,135,15,[2 8],136,-1,151,-1,136
1,<environment.Job instance at 0x7f4bec025960>,138,13,[7 4],139,-1,152,-1,139
1,<environment.Job instance at 0x7f4be39388c0>,140,17,[1 7],141,-1,158,-1,141
1,<environment.Job instance at 0x7f4be2ba7140>,145,16,[2 9],146,-1,168,-1,152
1,<environment.Job instance at 0x7f4be337b6e0>,13,18,[ 5 13],14,-1,39,-1,21
1,<environment.Job instance at 0x7f4be2b980a0>,47,14,[ 3 12],48,-1,152,-1,138
1,<environment.Job instance at 0x7f4be2c8dd20>,55,23,[7 3],56,-1,187,-1,164
1,<environment.Job instance at 0x7f4be20e8280>,62,18,[ 3 13],63,-1,184,-1,166
1,<environment.Job instance at 0x7f4be22cbeb0>,82,26,[9 3],83,-1,266,-1,240
1,<environment.Job instance at 0x7f4be2ed26e0>,86,3,[12  4],87,-1,255,-1,252
1,<environment.Job instance at 0x7f4be29e65a0>,96,15,[ 1 11],97,-1,302,-1,287
1,<environment.Job instance at 0x7f4be3886aa0>,108,12,[14  5],109,-1,346,-1,334
1,<environment.Job instance at 0x7f4bec532190>,118,23,[1 5],119,-1,408,-1,385
1,<environment.Job instance at 0x7f4be3037780>,119,2,[12  2],120,-1,387,-1,385
1,<environment.Job instance at 0x7f4be35c6d20>,136,17,[13  4],137,-1,468,-1,451
1,<environment.Job instance at 0x7f4be35c6a00>,139,17,[ 1 11],140,-1,483,-1,466
1,<environment.Job instance at 0x7f4be35c67d0>,144,17,[12  2],145,-1,499,-1,482
1,<environment.Job instance at 0x7f4be2c20a00>,152,1,[ 1 11],153,-1,513,-1,512
1,<environment.Job instance at 0x7f4be2c208c0>,154,12,[ 3 12],155,-1,524,-1,512
1,<environment.Job instance at 0x7f4be3291dc0>,155,17,[14  3],156,-1,529,-1,512
1,<environment.Job instance at 0x7f4be32911e0>,157,24,[1 8],158,-1,554,-1,530
1,<environment.Job instance at 0x7f4be35454b0>,2,24,[7 2],3,-1,27,-1,3
1,<environment.Job instance at 0x7f4be3545a00>,3,18,[1 7],4,-1,22,-1,4
1,<environment.Job instance at 0x7f4be3545eb0>,4,27,[5 1],5,-1,32,-1,5
1,<environment.Job instance at 0x7f4be21e85a0>,11,18,[5 6],12,-1,30,-1,12
1,<environment.Job instance at 0x7f4be2212050>,14,14,[ 4 10],15,-1,29,-1,15
1,<environment.Job instance at 0x7f4be22120f0>,15,16,[6 5],16,-1,32,-1,16
1,<environment.Job instance at 0x7f4be22123c0>,16,15,[1 6],17,-1,32,-1,17
1,<environment.Job instance at 0x7f4be22129b0>,17,18,[3 8],18,-1,36,-1,18
1,<environment.Job instance at 0x7f4be2977960>,19,14,[2 7],20,-1,34,-1,20
1,<environment.Job instance at 0x7f4be354e7d0>,22,16,[3 7],23,-1,39,-1,23
1,<environment.Job instance at 0x7f4be354e320>,23,15,[9 4],24,-1,39,-1,24
1,<environment.Job instance at 0x7f4be332dd70>,27,18,[2 8],28,-1,46,-1,28
1,<environment.Job instance at 0x7f4be3302dc0>,31,14,[1 8],32,-1,46,-1,32
1,<environment.Job instance at 0x7f4be33290a0>,32,16,[6 4],33,-1,49,-1,33
1,<environment.Job instance at 0x7f4be21f02d0>,33,12,[10  2],34,-1,48,-1,36
1,<environment.Job instance at 0x7f4be21f08c0>,35,27,[1 5],36,-1,63,-1,36
1,<environment.Job instance at 0x7f4be21f0b90>,36,18,[ 2 10],37,-1,59,-1,41
1,<environment.Job instance at 0x7f4be332a320>,40,15,[8 4],41,-1,56,-1,41
1,<environment.Job instance at 0x7f4be332aa50>,41,18,[7 3],42,-1,61,-1,43
1,<environment.Job instance at 0x7f4be332a460>,43,14,[7 2],44,-1,58,-1,44
1,<environment.Job instance at 0x7f4be332abe0>,45,12,[8 1],46,-1,58,-1,46
1,<environment.Job instance at 0x7f4be332ae60>,42,17,[1 7],43,-1,64,-1,47
1,<environment.Job instance at 0x7f4be330c0a0>,47,15,[ 3 10],48,-1,64,-1,49
1,<environment.Job instance at 0x7f4be330c140>,48,12,[10  1],49,-1,61,-1,49
1,<environment.Job instance at 0x7f4be33100f0>,51,21,[8 4],52,-1,73,-1,52
1,<environment.Job instance at 0x7f4be33103c0>,52,16,[1 7],53,-1,69,-1,53
1,<environment.Job instance at 0x7f4be3320d70>,55,18,[4 5],56,-1,74,-1,56
1,<environment.Job instance at 0x7f4be33145f0>,57,18,[2 7],58,-1,76,-1,58
1,<environment.Job instance at 0x7f4be3340aa0>,66,2,[4 7],67,-1,69,-1,67
1,<environment.Job instance at 0x7f4be21fc6e0>,65,14,[4 9],66,-1,82,-1,68
1,<environment.Job instance at 0x7f4be2211960>,64,20,[8 2],65,-1,95,-1,75
1,<environment.Job instance at 0x7f4be3339320>,69,13,[2 6],70,-1,89,-1,76
1,<environment.Job instance at 0x7f4be3339500>,73,19,[7 1],74,-1,101,-1,82
1,<environment.Job instance at 0x7f4be33395a0>,74,12,[9 5],75,-1,94,-1,82
1,<environment.Job instance at 0x7f4be3339460>,70,21,[10  5],71,-1,103,-1,82
1,<environment.Job instance at 0x7f4be3339e60>,82,16,[9 2],83,-1,99,-1,83
1,<environment.Job instance at 0x7f4be2304960>,91,15,[9 3],92,-1,107,-1,92
1,<environment.Job instance at 0x7f4be23042d0>,92,17,[4 9],93,-1,110,-1,93
1,<environment.Job instance at 0x7f4be2304460>,96,21,[5 3],97,-1,119,-1,98
1,<environment.Job instance at 0x7f4be231dcd0>,98,16,[1 7],99,-1,115,-1,99
1,<environment.Job instance at 0x7f4be231d780>,100,12,[10  5],101,-1,113,-1,101
1,<environment.Job instance at 0x7f4be231d1e0>,101,16,[10  1],102,-1,118,-1,102
1,<environment.Job instance at 0x7f4be231df00>,103,17,[8 3],104,-1,121,-1,104
1,<environment.Job instance at 0x7f4be231de60>,104,19,[ 5 12],105,-1,124,-1,105
1,<environment.Job instance at 0x7f4be231da00>,105,27,[2 8],106,-1,133,-1,106
1,<environment.Job instance at 0x7f4be231d410>,107,15,[5 5],108,-1,123,-1,108
1,<environment.Job instance at 0x7f4be231d0a0>,110,14,[1 9],111,-1,125,-1,111
1,<environment.Job instance at 0x7f4be231db40>,111,1,[10  1],112,-1,113,-1,112
1,<environment.Job instance at 0x7f4be231dfa0>,112,24,[5 7],113,-1,137,-1,113
1,<environment.Job instance at 0x7f4be230a0a0>,116,15,[ 1 10],117,-1,132,-1,117
1,<environment.Job instance at 0x7f4be230a370>,119,23,[6 1],120,-1,143,-1,120
1,<environment.Job instance at 0x7f4be230a640>,122,18,[ 3 10],123,-1,141,-1,123
1,<environment.Job instance at 0x7f4be230a780>,123,16,[8 1],124,-1,140,-1,124
1,<environment.Job instance at 0x7f4be230a730>,124,18,[ 3 10],125,-1,143,-1,125
1,<environment.Job instance at 0x7f4be230a960>,125,12,[5 1],126,-1,138,-1,126
1,<environment.Job instance at 0x7f4be230aa00>,126,23,[ 2 10],127,-1,150,-1,127
1,<environment.Job instance at 0x7f4be230acd0>,129,15,[4 9],130,-1,145,-1,130
1,<environment.Job instance at 0x7f4be230ad70>,130,15,[ 1 11],131,-1,146,-1,131
1,<environment.Job instance at 0x7f4be22eafa0>,135,13,[9 1],136,-1,149,-1,136
1,<environment.Job instance at 0x7f4be22eadc0>,137,17,[5 6],138,-1,155,-1,138
1,<environment.Job instance at 0x7f4be22eaaa0>,138,15,[3 5],139,-1,154,-1,139
1,<environment.Job instance at 0x7f4be22ea5f0>,139,14,[ 2 10],140,-1,154,-1,140
1,<environment.Job instance at 0x7f4be22ea910>,142,15,[8 3],143,-1,158,-1,143
1,<environment.Job instance at 0x7f4be22ea370>,144,12,[2 9],145,-1,157,-1,145
1,<environment.Job instance at 0x7f4be22eaf50>,145,14,[6 3],146,-1,160,-1,146
1,<environment.Job instance at 0x7f4be2305050>,146,13,[2 7],147,-1,160,-1,147
1,<environment.Job instance at 0x7f4be2305190>,148,14,[2 8],149,-1,163,-1,149
1,<environment.Job instance at 0x7f4be2305280>,149,12,[7 4],150,-1,162,-1,150
1,<environment.Job instance at 0x7f4be23053c0>,150,18,[5 6],151,-1,169,-1,151
1,<environment.Job instance at 0x7f4be2305500>,152,14,[5 3],153,-1,167,-1,153
1,<environment.Job instance at 0x7f4be3866280>,153,13,[10  5],154,-1,167,-1,154
1,<environment.Job instance at 0x7f4be220bc30>,155,15,[10  4],156,-1,171,-1,156
1,<environment.Job instance at 0x7f4be330c730>,156,26,[5 7],157,-1,183,-1,157
1,<environment.Job instance at 0x7f4be21e89b0>,2,24,[7 2],3,-1,27,-1,3
1,<environment.Job instance at 0x7f4be2516690>,4,27,[5 1],5,-1,32,-1,5
1,<environment.Job instance at 0x7f4be2190f00>,5,1,[ 5 12],6,-1,7,-1,6
1,<environment.Job instance at 0x7f4be3314230>,8,3,[13  2],9,-1,12,-1,9
1,<environment.Job instance at 0x7f4be231d5a0>,20,3,[13  5],21,-1,38,-1,35
1,<environment.Job instance at 0x7f4be22ea0f0>,25,3,[14  3],26,-1,64,-1,61
1,<environment.Job instance at 0x7f4be2c20aa0>,35,27,[1 5],36,-1,128,-1,101
1,<environment.Job instance at 0x7f4be2c20e10>,39,3,[13  3],40,-1,115,-1,112
1,<environment.Job instance at 0x7f4be36dfbe0>,75,1,[ 3 11],76,-1,231,-1,230
1,<environment.Job instance at 0x7f4be2960fa0>,86,23,[ 1 13],87,-1,271,-1,248
1,<environment.Job instance at 0x7f4be358caa0>,87,2,[ 2 11],88,-1,250,-1,248
1,<environment.Job instance at 0x7f4be2c7eb90>,94,24,[7 3],95,-1,296,-1,272
1,<environment.Job instance at 0x7f4be21f2280>,104,19,[ 5 12],105,-1,332,-1,313
1,<environment.Job instance at 0x7f4be21f2910>,105,27,[2 8],106,-1,355,-1,328
1,<environment.Job instance at 0x7f4be3632c30>,109,1,[ 4 13],110,-1,331,-1,330
1,<environment.Job instance at 0x7f4be309faa0>,112,24,[5 7],113,-1,357,-1,333
1,<environment.Job instance at 0x7f4be37a3a00>,119,23,[6 1],120,-1,377,-1,354
1,<environment.Job instance at 0x7f4be37a3640>,120,1,[11  4],121,-1,355,-1,354
1,<environment.Job instance at 0x7f4be3939960>,126,23,[ 2 10],127,-1,394,-1,371
1,<environment.Job instance at 0x7f4be2b98730>,130,15,[ 1 11],131,-1,393,-1,378
1,<environment.Job instance at 0x7f4be2b989b0>,131,2,[11  4],132,-1,380,-1,378
1,<environment.Job instance at 0x7f4be2b980a0>,132,3,[14  5],133,-1,381,-1,378
1,<environment.Job instance at 0x7f4be2748c80>,156,26,[5 7],157,-1,532,-1,506
1,<environment.Job instance at 0x7f4be2c7d730>,8,12,[5 3],9,-1,21,-1,9
1,<environment.Job instance at 0x7f4be2c7dbe0>,9,20,[3 9],10,-1,40,-1,20
1,<environment.Job instance at 0x7f4be2448640>,10,16,[4 9],11,-1,36,-1,20
1,<environment.Job instance at 0x7f4be32d5820>,21,17,[7 4],22,-1,39,-1,22
1,<environment.Job instance at 0x7f4be2b487d0>,23,16,[1 9],24,-1,40,-1,24
1,<environment.Job instance at 0x7f4be2784780>,25,27,[6 2],26,-1,54,-1,27
1,<environment.Job instance at 0x7f4be26ec2d0>,27,15,[10  5],28,-1,43,-1,28
1,<environment.Job instance at 0x7f4be2784eb0>,29,18,[5 2],30,-1,48,-1,30
1,<environment.Job instance at 0x7f4be3517d70>,30,17,[8 2],31,-1,49,-1,32
1,<environment.Job instance at 0x7f4bec53ec30>,35,14,[9 4],36,-1,51,-1,37
1,<environment.Job instance at 0x7f4be3790910>,33,15,[5 2],34,-1,52,-1,37
1,<environment.Job instance at 0x7f4be3973f50>,36,12,[7 2],37,-1,50,-1,38
1,<environment.Job instance at 0x7f4be39735a0>,38,18,[5 3],39,-1,57,-1,39
1,<environment.Job instance at 0x7f4be20ba230>,11,23,[8 4],12,-1,66,-1,43
1,<environment.Job instance at 0x7f4be3973a50>,40,12,[5 7],41,-1,55,-1,43
1,<environment.Job instance at 0x7f4be3973140>,41,18,[1 7],42,-1,73,-1,55
1,<environment.Job instance at 0x7f4be2d675a0>,54,18,[7 1],55,-1,73,-1,55
1,<environment.Job instance at 0x7f4be2d67e60>,56,14,[ 5 11],57,-1,71,-1,57
1,<environment.Job instance at 0x7f4be2286a00>,68,22,[10  4],69,-1,103,-1,81
1,<environment.Job instance at 0x7f4be27838c0>,64,18,[ 4 10],65,-1,99,-1,81
1,<environment.Job instance at 0x7f4be2b0e230>,71,21,[5 8],72,-1,104,-1,83
1,<environment.Job instance at 0x7f4be2c86460>,66,13,[7 3],67,-1,97,-1,84
1,<environment.Job instance at 0x7f4be2af9140>,74,18,[3 8],75,-1,103,-1,85
1,<environment.Job instance at 0x7f4be24ba8c0>,70,18,[1 7],71,-1,107,-1,89
1,<environment.Job instance at 0x7f4be34cafa0>,77,25,[6 5],78,-1,114,-1,89
1,<environment.Job instance at 0x7f4be20ba9b0>,13,14,[5 4],14,-1,103,-1,89
1,<environment.Job instance at 0x7f4be379c9b0>,80,16,[8 3],81,-1,106,-1,90
1,<environment.Job instance at 0x7f4be2ca2d70>,84,15,[10  3],85,-1,105,-1,90
1,<environment.Job instance at 0x7f4be38d50a0>,88,25,[5 7],89,-1,126,-1,101
1,<environment.Job instance at 0x7f4be2b083c0>,89,13,[ 3 12],90,-1,114,-1,101
1,<environment.Job instance at 0x7f4be3545b90>,91,14,[4 6],92,-1,117,-1,103
1,<environment.Job instance at 0x7f4be309fc30>,97,16,[6 3],98,-1,122,-1,106
1,<environment.Job instance at 0x7f4be2ce05a0>,101,14,[8 5],102,-1,120,-1,106
1,<environment.Job instance at 0x7f4be2ce0050>,102,18,[5 8],103,-1,130,-1,112
1,<environment.Job instance at 0x7f4be2ce0910>,100,14,[7 5],101,-1,137,-1,123
1,<environment.Job instance at 0x7f4be3903a00>,107,28,[6 3],108,-1,151,-1,123
1,<environment.Job instance at 0x7f4be3903690>,110,18,[5 5],111,-1,143,-1,125
1,<environment.Job instance at 0x7f4be3903be0>,108,2,[10  3],109,-1,127,-1,125
1,<environment.Job instance at 0x7f4be3891f00>,112,2,[1 7],113,-1,127,-1,125
1,<environment.Job instance at 0x7f4be38d59b0>,87,13,[5 6],88,-1,141,-1,128
1,<environment.Job instance at 0x7f4be3903550>,111,19,[3 6],112,-1,147,-1,128
1,<environment.Job instance at 0x7f4be38915f0>,113,13,[1 7],114,-1,141,-1,128
1,<environment.Job instance at 0x7f4be388aa00>,119,17,[8 2],120,-1,147,-1,130
1,<environment.Job instance at 0x7f4be388a780>,118,1,[5 2],119,-1,131,-1,130
1,<environment.Job instance at 0x7f4be3903960>,105,26,[14  3],106,-1,157,-1,131
1,<environment.Job instance at 0x7f4be20a1460>,122,16,[5 5],123,-1,147,-1,131
1,<environment.Job instance at 0x7f4be20a1cd0>,121,19,[3 9],122,-1,150,-1,131
1,<environment.Job instance at 0x7f4be2194550>,125,17,[10  2],126,-1,148,-1,131
1,<environment.Job instance at 0x7f4be21942d0>,126,17,[4 9],127,-1,149,-1,132
1,<environment.Job instance at 0x7f4be2194230>,129,18,[13  1],130,-1,150,-1,132
1,<environment.Job instance at 0x7f4be3891d20>,114,18,[1 9],115,-1,150,-1,132
1,<environment.Job instance at 0x7f4be349e320>,134,15,[ 3 14],135,-1,160,-1,145
1,<environment.Job instance at 0x7f4be20a19b0>,123,13,[2 7],124,-1,158,-1,145
1,<environment.Job instance at 0x7f4be349e7d0>,135,16,[6 1],136,-1,162,-1,146
1,<environment.Job instance at 0x7f4be349ecd0>,132,25,[2 8],133,-1,172,-1,147
1,<environment.Job instance at 0x7f4be349e500>,136,13,[5 7],137,-1,169,-1,156
1,<environment.Job instance at 0x7f4be2c97af0>,143,16,[10  1],144,-1,172,-1,156
1,<environment.Job instance at 0x7f4be29b45a0>,144,17,[4 8],145,-1,173,-1,156
1,<environment.Job instance at 0x7f4be2c97cd0>,141,28,[1 5],142,-1,185,-1,157
1,<environment.Job instance at 0x7f4be29b4af0>,146,15,[3 5],147,-1,172,-1,157
1,<environment.Job instance at 0x7f4be29b46e0>,147,14,[9 1],148,-1,171,-1,157
1,<environment.Job instance at 0x7f4be29b48c0>,148,14,[4 7],149,-1,172,-1,158
1,<environment.Job instance at 0x7f4be29b4c30>,149,2,[4 6],150,-1,160,-1,158
1,<environment.Job instance at 0x7f4be36b1190>,150,27,[3 8],151,-1,185,-1,158
1,<environment.Job instance at 0x7f4be29b4b40>,145,2,[1 7],146,-1,160,-1,158
1,<environment.Job instance at 0x7f4be36b1fa0>,151,16,[ 3 14],152,-1,174,-1,158
1,<environment.Job instance at 0x7f4be36b1370>,152,12,[7 2],153,-1,170,-1,158
1,<environment.Job instance at 0x7f4bec17d050>,154,19,[6 5],155,-1,179,-1,160
1,<environment.Job instance at 0x7f4bec3b1410>,155,18,[4 5],156,-1,178,-1,160
1,<environment.Job instance at 0x7f4bec01db90>,157,13,[7 4],158,-1,173,-1,160
1,<environment.Job instance at 0x7f4be349e230>,138,16,[6 1],139,-1,176,-1,160
1,<environment.Job instance at 0x7f4be34969b0>,6,3,[ 4 11],7,-1,10,-1,7
1,<environment.Job instance at 0x7f4bebeeff50>,11,23,[8 4],12,-1,40,-1,17
1,<environment.Job instance at 0x7f4be2194870>,14,3,[11  3],15,-1,20,-1,17
1,<environment.Job instance at 0x7f4bec01dbe0>,16,2,[ 2 12],17,-1,21,-1,19
1,<environment.Job instance at 0x7f4be2304dc0>,25,27,[6 2],26,-1,75,-1,48
1,<environment.Job instance at 0x7f4be3339f50>,28,3,[ 3 12],29,-1,54,-1,51
1,<environment.Job instance at 0x7f4be29b4730>,45,1,[ 4 14],46,-1,126,-1,125
1,<environment.Job instance at 0x7f4be2057c80>,56,14,[ 5 11],57,-1,156,-1,142
1,<environment.Job instance at 0x7f4be2af7f00>,59,22,[14  5],60,-1,176,-1,154
1,<environment.Job instance at 0x7f4be3007d20>,62,12,[11  2],63,-1,172,-1,160
1,<environment.Job instance at 0x7f4be21d0140>,77,25,[6 5],78,-1,220,-1,195
1,<environment.Job instance at 0x7f4be35509b0>,88,25,[5 7],89,-1,252,-1,227
1,<environment.Job instance at 0x7f4be362ac30>,89,13,[ 3 12],90,-1,240,-1,227
1,<environment.Job instance at 0x7f4be2a2a960>,98,3,[12  5],99,-1,244,-1,241
1,<environment.Job instance at 0x7f4be26bc6e0>,105,26,[14  3],106,-1,299,-1,273
1,<environment.Job instance at 0x7f4be38f4640>,107,28,[6 3],108,-1,315,-1,287
1,<environment.Job instance at 0x7f4be20b9690>,116,2,[14  2],117,-1,305,-1,303
1,<environment.Job instance at 0x7f4be20b9640>,117,3,[13  2],118,-1,306,-1,303
1,<environment.Job instance at 0x7f4be33e90a0>,129,18,[13  1],130,-1,364,-1,346
1,<environment.Job instance at 0x7f4be3517be0>,132,25,[2 8],133,-1,388,-1,363
1,<environment.Job instance at 0x7f4be1ff3550>,134,15,[ 3 14],135,-1,378,-1,363
1,<environment.Job instance at 0x7f4be2e2af00>,140,12,[ 3 11],141,-1,390,-1,378
1,<environment.Job instance at 0x7f4be34f0a00>,141,28,[1 5],142,-1,406,-1,378
1,<environment.Job instance at 0x7f4be2629550>,150,27,[3 8],151,-1,445,-1,418
1,<environment.Job instance at 0x7f4be2b48b90>,151,16,[ 3 14],152,-1,434,-1,418
1,<environment.Job instance at 0x7f4be33ab640>,0,20,[7 1],1,-1,24,-1,4
1,<environment.Job instance at 0x7f4bebf7ddc0>,6,14,[8 2],7,-1,21,-1,7
1,<environment.Job instance at 0x7f4be33ab820>,3,12,[6 3],4,-1,20,-1,8
1,<environment.Job instance at 0x7f4bebf7dc30>,9,16,[1 8],10,-1,26,-1,10
1,<environment.Job instance at 0x7f4bebf7dd70>,11,17,[ 3 10],12,-1,30,-1,13
1,<environment.Job instance at 0x7f4bebf7d320>,14,17,[4 5],15,-1,32,-1,15
1,<environment.Job instance at 0x7f4bebf7d500>,15,13,[3 7],16,-1,29,-1,16
1,<environment.Job instance at 0x7f4be28f8460>,21,13,[ 3 10],22,-1,35,-1,22
1,<environment.Job instance at 0x7f4be28f8b40>,24,18,[7 5],25,-1,44,-1,26
1,<environment.Job instance at 0x7f4be28f8b90>,25,26,[ 4 10],26,-1,52,-1,26
1,<environment.Job instance at 0x7f4be28f85a0>,27,16,[7 4],28,-1,45,-1,29
1,<environment.Job instance at 0x7f4bebf74910>,31,17,[ 3 10],32,-1,49,-1,32
1,<environment.Job instance at 0x7f4bebf741e0>,32,14,[1 7],33,-1,47,-1,33
1,<environment.Job instance at 0x7f4bebf74d70>,29,22,[12  5],30,-1,68,-1,46
1,<environment.Job instance at 0x7f4bebf740a0>,34,27,[3 7],35,-1,74,-1,47
1,<environment.Job instance at 0x7f4be2629f50>,43,16,[9 3],44,-1,63,-1,47
1,<environment.Job instance at 0x7f4be2629cd0>,45,16,[ 5 10],46,-1,64,-1,48
1,<environment.Job instance at 0x7f4be3487f50>,48,19,[5 8],49,-1,69,-1,50
1,<environment.Job instance at 0x7f4be3487550>,46,12,[1 9],47,-1,63,-1,51
1,<environment.Job instance at 0x7f4be3487c80>,52,18,[10  4],53,-1,75,-1,57
1,<environment.Job instance at 0x7f4be3487cd0>,49,12,[10  3],50,-1,69,-1,57
1,<environment.Job instance at 0x7f4be34874b0>,53,16,[1 8],54,-1,74,-1,58
1,<environment.Job instance at 0x7f4be33dd3c0>,36,15,[9 4],37,-1,74,-1,59
1,<environment.Job instance at 0x7f4be3487460>,54,17,[6 4],55,-1,76,-1,59
1,<environment.Job instance at 0x7f4be2357460>,58,13,[8 3],59,-1,79,-1,66
1,<environment.Job instance at 0x7f4be3834d20>,66,18,[5 7],67,-1,85,-1,67
1,<environment.Job instance at 0x7f4be38342d0>,67,28,[8 3],68,-1,96,-1,68
1,<environment.Job instance at 0x7f4be2467910>,69,15,[3 7],70,-1,85,-1,70
1,<environment.Job instance at 0x7f4be22c21e0>,70,19,[3 8],71,-1,90,-1,71
1,<environment.Job instance at 0x7f4be306e8c0>,74,16,[4 6],75,-1,92,-1,76
1,<environment.Job instance at 0x7f4bebf4abe0>,77,27,[3 7],78,-1,106,-1,79
1,<environment.Job instance at 0x7f4be2b35c30>,78,13,[9 1],79,-1,92,-1,79
1,<environment.Job instance at 0x7f4be24dd550>,65,16,[ 3 10],66,-1,97,-1,81
1,<environment.Job instance at 0x7f4be2b35410>,80,12,[7 4],81,-1,97,-1,85
1,<environment.Job instance at 0x7f4be306eb90>,72,22,[13  5],73,-1,122,-1,100
1,<environment.Job instance at 0x7f4be24bc280>,86,27,[13  1],87,-1,128,-1,101
1,<environment.Job instance at 0x7f4be38f48c0>,88,18,[2 5],89,-1,120,-1,102
1,<environment.Job instance at 0x7f4be3476870>,90,1,[5 1],91,-1,103,-1,102
1,<environment.Job instance at 0x7f4be28f8500>,22,28,[1 7],23,-1,130,-1,102
1,<environment.Job instance at 0x7f4be2abc1e0>,93,12,[2 9],94,-1,115,-1,103
1,<environment.Job instance at 0x7f4be34767d0>,91,18,[ 5 10],92,-1,121,-1,103
1,<environment.Job instance at 0x7f4bebf09eb0>,95,25,[2 7],96,-1,128,-1,103
1,<environment.Job instance at 0x7f4be37de7d0>,97,17,[ 5 14],98,-1,120,-1,103
1,<environment.Job instance at 0x7f4be37deb90>,98,17,[7 4],99,-1,127,-1,110
1,<environment.Job instance at 0x7f4be37de730>,99,16,[ 1 10],100,-1,126,-1,110
1,<environment.Job instance at 0x7f4be306ed70>,73,28,[10  5],74,-1,138,-1,110
1,<environment.Job instance at 0x7f4be32e2e60>,101,14,[ 2 10],102,-1,124,-1,110
1,<environment.Job instance at 0x7f4be2abc8c0>,92,2,[8 3],93,-1,112,-1,110
1,<environment.Job instance at 0x7f4be2fcc910>,96,15,[9 2],97,-1,125,-1,110
1,<environment.Job instance at 0x7f4be25713c0>,109,3,[ 1 10],110,-1,113,-1,110
1,<environment.Job instance at 0x7f4be32854b0>,106,1,[6 4],107,-1,111,-1,110
1,<environment.Job instance at 0x7f4be22cbb90>,119,12,[2 9],120,-1,132,-1,120
1,<environment.Job instance at 0x7f4be38c8140>,120,13,[2 8],121,-1,134,-1,121
1,<environment.Job instance at 0x7f4be3530eb0>,121,26,[6 3],122,-1,148,-1,122
1,<environment.Job instance at 0x7f4be35304b0>,122,12,[7 5],123,-1,135,-1,123
1,<environment.Job instance at 0x7f4be26ece10>,123,17,[10  5],124,-1,141,-1,124
1,<environment.Job instance at 0x7f4be270c320>,126,17,[10  5],127,-1,144,-1,127
1,<environment.Job instance at 0x7f4be21d0460>,135,27,[8 5],136,-1,163,-1,136
1,<environment.Job instance at 0x7f4be21d0e10>,136,22,[9 5],137,-1,159,-1,137
1,<environment.Job instance at 0x7f4be23efc30>,137,17,[5 5],138,-1,155,-1,138
1,<environment.Job instance at 0x7f4be21d0c30>,138,24,[7 4],139,-1,164,-1,140
1,<environment.Job instance at 0x7f4be310f550>,141,14,[10  4],142,-1,156,-1,142
1,<environment.Job instance at 0x7f4be29cc870>,132,17,[4 9],133,-1,165,-1,148
1,<environment.Job instance at 0x7f4be21d0af0>,139,18,[1 5],140,-1,166,-1,148
1,<environment.Job instance at 0x7f4be2597be0>,146,2,[7 5],147,-1,150,-1,148
1,<environment.Job instance at 0x7f4be2037fa0>,147,13,[ 2 13],148,-1,161,-1,148
1,<environment.Job instance at 0x7f4be35c0a50>,145,2,[5 4],146,-1,151,-1,149
1,<environment.Job instance at 0x7f4be38d7d20>,148,17,[ 1 13],149,-1,166,-1,149
1,<environment.Job instance at 0x7f4be38d7d70>,150,14,[2 7],151,-1,165,-1,151
1,<environment.Job instance at 0x7f4be38d7320>,151,24,[ 3 14],152,-1,176,-1,152
1,<environment.Job instance at 0x7f4bebf74d20>,157,15,[3 5],158,-1,174,-1,159
1,<environment.Job instance at 0x7f4be30202d0>,1,1,[12  2],2,-1,3,-1,2
1,<environment.Job instance at 0x7f4be2b48320>,20,23,[ 1 12],21,-1,63,-1,40
1,<environment.Job instance at 0x7f4be22c16e0>,22,28,[1 7],23,-1,78,-1,50
1,<environment.Job instance at 0x7f4be387a960>,25,26,[ 4 10],26,-1,81,-1,55
1,<environment.Job instance at 0x7f4be26ec460>,29,22,[12  5],30,-1,81,-1,59
1,<environment.Job instance at 0x7f4be1ffff00>,34,27,[3 7],35,-1,113,-1,86
1,<environment.Job instance at 0x7f4be3626500>,67,28,[8 3],68,-1,247,-1,219
1,<environment.Job instance at 0x7f4be2cafcd0>,72,22,[13  5],73,-1,254,-1,232
1,<environment.Job instance at 0x7f4be2caf9b0>,73,28,[10  5],74,-1,265,-1,237
1,<environment.Job instance at 0x7f4be3866a50>,77,27,[3 7],78,-1,279,-1,252
1,<environment.Job instance at 0x7f4be2206460>,86,27,[13  1],87,-1,306,-1,279
1,<environment.Job instance at 0x7f4be3734140>,95,25,[2 7],96,-1,331,-1,306
1,<environment.Job instance at 0x7f4be3632af0>,97,17,[ 5 14],98,-1,323,-1,306
1,<environment.Job instance at 0x7f4be37756e0>,121,26,[6 3],122,-1,399,-1,373
1,<environment.Job instance at 0x7f4bec01de10>,127,1,[ 5 12],128,-1,390,-1,389
1,<environment.Job instance at 0x7f4bec01d7d0>,129,3,[12  2],130,-1,398,-1,395
1,<environment.Job instance at 0x7f4bec01d690>,131,3,[11  1],132,-1,399,-1,396
1,<environment.Job instance at 0x7f4be2e11460>,135,27,[8 5],136,-1,440,-1,413
1,<environment.Job instance at 0x7f4bf352a870>,138,24,[7 4],139,-1,447,-1,423
1,<environment.Job instance at 0x7f4be2a2cc80>,147,13,[ 2 13],148,-1,458,-1,445
1,<environment.Job instance at 0x7f4be2a2ceb0>,148,17,[ 1 13],149,-1,462,-1,445
1,<environment.Job instance at 0x7f4be2a2ca00>,149,2,[12  1],150,-1,447,-1,445
1,<environment.Job instance at 0x7f4be2a50730>,151,24,[ 3 14],152,-1,471,-1,447
1,<environment.Job instance at 0x7f4be21be4b0>,158,13,[14  1],159,-1,481,-1,468
1,<environment.Job instance at 0x7f4be31aa820>,0,20,[9 2],1,-1,22,-1,2
1,<environment.Job instance at 0x7f4be31aad20>,2,17,[4 7],3,-1,20,-1,3
1,<environment.Job instance at 0x7f4be33d24b0>,3,18,[2 9],4,-1,22,-1,4
1,<environment.Job instance at 0x7f4be33d2eb0>,4,15,[9 1],5,-1,20,-1,5
1,<environment.Job instance at 0x7f4be3005820>,6,26,[ 4 10],7,-1,34,-1,8
1,<environment.Job instance at 0x7f4be30050f0>,9,17,[7 1],10,-1,27,-1,10
1,<environment.Job instance at 0x7f4be2829780>,12,14,[5 6],13,-1,27,-1,13
1,<environment.Job instance at 0x7f4be31aacd0>,7,12,[3 5],8,-1,46,-1,34
1,<environment.Job instance at 0x7f4bebf09230>,14,19,[1 7],15,-1,55,-1,36
1,<environment.Job instance at 0x7f4be24076e0>,24,25,[7 4],25,-1,61,-1,36
1,<environment.Job instance at 0x7f4be2660370>,25,22,[9 2],26,-1,59,-1,37
1,<environment.Job instance at 0x7f4be2660280>,26,28,[6 2],27,-1,65,-1,37
1,<environment.Job instance at 0x7f4be388f550>,28,19,[2 5],29,-1,56,-1,37
1,<environment.Job instance at 0x7f4bebf092d0>,15,13,[13  4],16,-1,50,-1,37
1,<environment.Job instance at 0x7f4be37de9b0>,33,22,[10  1],34,-1,70,-1,48
1,<environment.Job instance at 0x7f4be3016c30>,31,21,[7 2],32,-1,77,-1,56
1,<environment.Job instance at 0x7f4be2fc6b40>,17,17,[7 2],18,-1,73,-1,56
1,<environment.Job instance at 0x7f4be340c2d0>,37,16,[3 9],38,-1,72,-1,56
1,<environment.Job instance at 0x7f4be2232640>,36,18,[10  3],37,-1,74,-1,56
1,<environment.Job instance at 0x7f4be300a780>,44,17,[10  1],45,-1,73,-1,56
1,<environment.Job instance at 0x7f4bebf03230>,46,16,[9 3],47,-1,72,-1,56
1,<environment.Job instance at 0x7f4be3843f00>,42,17,[1 9],43,-1,73,-1,56
1,<environment.Job instance at 0x7f4bebf03b90>,49,15,[1 5],50,-1,71,-1,56
1,<environment.Job instance at 0x7f4be25a4be0>,52,26,[5 7],53,-1,82,-1,56
1,<environment.Job instance at 0x7f4be2fc6c30>,16,25,[ 3 12],17,-1,81,-1,56
1,<environment.Job instance at 0x7f4be25a4190>,54,28,[9 1],55,-1,84,-1,56
1,<environment.Job instance at 0x7f4be25a4870>,55,19,[3 8],56,-1,75,-1,56
1,<environment.Job instance at 0x7f4be25a4690>,50,12,[1 6],51,-1,69,-1,57
1,<environment.Job instance at 0x7f4be25a4dc0>,53,17,[5 8],54,-1,74,-1,57
1,<environment.Job instance at 0x7f4be242e5a0>,58,28,[5 2],59,-1,88,-1,60
1,<environment.Job instance at 0x7f4be2bbe320>,62,20,[10  4],63,-1,83,-1,63
1,<environment.Job instance at 0x7f4be242ec30>,59,18,[10  5],60,-1,83,-1,65
1,<environment.Job instance at 0x7f4be348c5a0>,56,14,[5 3],57,-1,80,-1,66
1,<environment.Job instance at 0x7f4be32c7780>,64,14,[1 9],65,-1,80,-1,66
1,<environment.Job instance at 0x7f4be39aceb0>,32,14,[ 4 14],33,-1,87,-1,73
1,<environment.Job instance at 0x7f4be314fa50>,67,13,[10  1],68,-1,86,-1,73
1,<environment.Job instance at 0x7f4be256c0a0>,71,15,[2 7],72,-1,90,-1,75
1,<environment.Job instance at 0x7f4be256c8c0>,74,14,[7 2],75,-1,89,-1,75
1,<environment.Job instance at 0x7f4be3865320>,65,16,[ 3 10],66,-1,91,-1,75
1,<environment.Job instance at 0x7f4be256cf00>,73,16,[7 2],74,-1,93,-1,77
1,<environment.Job instance at 0x7f4be256c140>,77,20,[10  3],78,-1,98,-1,78
1,<environment.Job instance at 0x7f4be2587690>,84,17,[5 9],85,-1,102,-1,85
1,<environment.Job instance at 0x7f4be256c280>,69,14,[8 4],70,-1,102,-1,88
1,<environment.Job instance at 0x7f4be2587d20>,87,14,[1 9],88,-1,102,-1,88
1,<environment.Job instance at 0x7f4be2b98e60>,88,18,[5 2],89,-1,107,-1,89
1,<environment.Job instance at 0x7f4be2b98a00>,91,17,[ 5 10],92,-1,109,-1,92
1,<environment.Job instance at 0x7f4be2b98820>,93,12,[10  1],94,-1,107,-1,95
1,<environment.Job instance at 0x7f4be2198280>,96,14,[2 7],97,-1,111,-1,97
1,<environment.Job instance at 0x7f4be2198820>,101,17,[5 5],102,-1,120,-1,103
1,<environment.Job instance at 0x7f4be2198c80>,105,25,[10  3],106,-1,138,-1,113
1,<environment.Job instance at 0x7f4be37a1050>,108,16,[5 9],109,-1,129,-1,113
1,<environment.Job instance at 0x7f4be2232550>,1,15,[ 3 13],2,-1,17,-1,2
1,<environment.Job instance at 0x7f4be34118c0>,6,26,[ 4 10],7,-1,46,-1,20
1,<environment.Job instance at 0x7f4be256c500>,11,3,[ 2 12],12,-1,24,-1,21
1,<environment.Job instance at 0x7f4be25878c0>,15,13,[13  4],16,-1,45,-1,32
1,<environment.Job instance at 0x7f4be2b98910>,16,25,[ 3 12],17,-1,57,-1,32
1,<environment.Job instance at 0x7f4be25a4460>,24,25,[7 4],25,-1,80,-1,55
1,<environment.Job instance at 0x7f4be28f8230>,26,28,[6 2],27,-1,85,-1,57
1,<environment.Job instance at 0x7f4be3423870>,30,1,[ 2 11],31,-1,60,-1,59
1,<environment.Job instance at 0x7f4be3423e60>,32,14,[ 4 14],33,-1,74,-1,60
1,<environment.Job instance at 0x7f4be2a50eb0>,40,18,[ 2 13],41,-1,84,-1,66
1,<environment.Job instance at 0x7f4be37fd190>,47,3,[12  2],48,-1,91,-1,88
1,<environment.Job instance at 0x7f4be2dde820>,52,26,[5 7],53,-1,143,-1,117
1,<environment.Job instance at 0x7f4be2dac280>,54,28,[9 1],55,-1,154,-1,126
1,<environment.Job instance at 0x7f4be2dd3b40>,58,28,[5 2],59,-1,172,-1,144
1,<environment.Job instance at 0x7f4be2dadcd0>,63,3,[11  4],64,-1,165,-1,162
1,<environment.Job instance at 0x7f4be36e3af0>,70,2,[ 5 14],71,-1,188,-1,186
1,<environment.Job instance at 0x7f4bec6568c0>,79,28,[10  4],80,-1,272,-1,244
1,<environment.Job instance at 0x7f4be3626870>,85,3,[11  1],86,-1,261,-1,258
1,<environment.Job instance at 0x7f4be20fb910>,90,1,[ 1 14],91,-1,275,-1,274
1,<environment.Job instance at 0x7f4be23f50f0>,98,28,[2 8],99,-1,338,-1,310
1,<environment.Job instance at 0x7f4bebf922d0>,99,13,[ 5 12],100,-1,323,-1,310
1,<environment.Job instance at 0x7f4bec422190>,106,2,[12  3],107,-1,328,-1,326
1,<environment.Job instance at 0x7f4be2b35be0>,105,25,[10  3],106,-1,367,-1,342
1,<environment.Job instance at 0x7f4be2d5ecd0>,114,3,[14  3],115,-1,360,-1,357
1,<environment.Job instance at 0x7f4be28fa910>,119,15,[13  3],120,-1,390,-1,375
1,<environment.Job instance at 0x7f4be28fac30>,120,24,[7 2],121,-1,401,-1,377
1,<environment.Job instance at 0x7f4be28fae10>,122,25,[7 5],123,-1,402,-1,377
1,<environment.Job instance at 0x7f4be28fa050>,126,3,[12  5],127,-1,394,-1,391
1,<environment.Job instance at 0x7f4be3878fa0>,142,24,[2 9],143,-1,498,-1,474
1,<environment.Job instance at 0x7f4be29bb8c0>,1,17,[4 6],2,-1,19,-1,2
1,<environment.Job instance at 0x7f4be29bb9b0>,4,14,[10  2],5,-1,20,-1,6
1,<environment.Job instance at 0x7f4be2ea4640>,6,3,[3 8],7,-1,10,-1,7
1,<environment.Job instance at 0x7f4be2ea4320>,7,3,[3 5],8,-1,11,-1,8
1,<environment.Job instance at 0x7f4be29bb780>,5,23,[1 8],6,-1,33,-1,10
1,<environment.Job instance at 0x7f4be2386d20>,14,18,[2 6],15,-1,34,-1,16
1,<environment.Job instance at 0x7f4be3998b40>,17,18,[3 5],18,-1,36,-1,18
1,<environment.Job instance at 0x7f4be3998b90>,18,19,[3 9],19,-1,38,-1,19
1,<environment.Job instance at 0x7f4be3998d20>,19,12,[1 5],20,-1,32,-1,20
1,<environment.Job instance at 0x7f4be2388370>,15,18,[4 6],16,-1,38,-1,20
1,<environment.Job instance at 0x7f4be3998500>,21,18,[1 8],22,-1,42,-1,24
1,<environment.Job instance at 0x7f4be3998eb0>,23,17,[6 4],24,-1,41,-1,24
1,<environment.Job instance at 0x7f4be2baf910>,24,26,[8 5],25,-1,51,-1,25
1,<environment.Job instance at 0x7f4be2bc8870>,27,17,[4 8],28,-1,48,-1,31
1,<environment.Job instance at 0x7f4be2bc17d0>,30,22,[6 2],31,-1,53,-1,31
1,<environment.Job instance at 0x7f4be2ddfaa0>,32,3,[9 1],33,-1,36,-1,33
1,<environment.Job instance at 0x7f4be397c960>,33,24,[3 7],34,-1,58,-1,34
1,<environment.Job instance at 0x7f4be2af1320>,35,18,[7 3],36,-1,54,-1,36
1,<environment.Job instance at 0x7f4be397cf50>,34,16,[10  1],35,-1,53,-1,37
1,<environment.Job instance at 0x7f4be2b07460>,39,18,[3 7],40,-1,58,-1,40
1,<environment.Job instance at 0x7f4be322dd70>,40,3,[ 4 10],41,-1,44,-1,41
1,<environment.Job instance at 0x7f4be323ce10>,41,3,[14  4],42,-1,45,-1,42
1,<environment.Job instance at 0x7f4be2b1c230>,42,16,[ 4 12],43,-1,59,-1,43
1,<environment.Job instance at 0x7f4be3239820>,43,2,[5 4],44,-1,46,-1,44
1,<environment.Job instance at 0x7f4be34d8e60>,50,13,[1 6],51,-1,65,-1,52
1,<environment.Job instance at 0x7f4be34d81e0>,53,15,[5 6],54,-1,69,-1,54
1,<environment.Job instance at 0x7f4be350e320>,55,25,[ 4 10],56,-1,81,-1,56
1,<environment.Job instance at 0x7f4be3998f00>,56,13,[9 3],57,-1,70,-1,57
1,<environment.Job instance at 0x7f4be3998fa0>,57,14,[10  2],58,-1,72,-1,58
1,<environment.Job instance at 0x7f4be34d8460>,51,18,[10  3],52,-1,76,-1,58
1,<environment.Job instance at 0x7f4be34d77d0>,66,18,[6 4],67,-1,86,-1,68
1,<environment.Job instance at 0x7f4be34e4a00>,70,17,[5 2],71,-1,88,-1,71
1,<environment.Job instance at 0x7f4be34e4b40>,71,27,[4 5],72,-1,99,-1,72
1,<environment.Job instance at 0x7f4be34e4730>,72,14,[5 7],73,-1,87,-1,73
1,<environment.Job instance at 0x7f4be34e4cd0>,73,15,[7 4],74,-1,89,-1,74
1,<environment.Job instance at 0x7f4be34e4500>,75,18,[1 8],76,-1,94,-1,76
1,<environment.Job instance at 0x7f4be3511d70>,80,15,[10  1],81,-1,96,-1,81
1,<environment.Job instance at 0x7f4be3214b90>,88,17,[8 2],89,-1,112,-1,95
1,<environment.Job instance at 0x7f4be3214aa0>,90,15,[8 1],91,-1,110,-1,95
1,<environment.Job instance at 0x7f4be34d7d20>,67,18,[ 5 10],68,-1,116,-1,98
1,<environment.Job instance at 0x7f4be26c3dc0>,100,14,[5 5],101,-1,128,-1,114
1,<environment.Job instance at 0x7f4be2b1d460>,111,16,[5 2],112,-1,148,-1,132
1,<environment.Job instance at 0x7f4be3511410>,86,14,[13  3],87,-1,146,-1,132
1,<environment.Job instance at 0x7f4be2143a50>,113,21,[9 1],114,-1,153,-1,132
1,<environment.Job instance at 0x7f4be2af8870>,115,23,[4 8],116,-1,155,-1,132
1,<environment.Job instance at 0x7f4be350e3c0>,5,23,[1 8],6,-1,42,-1,19
1,<environment.Job instance at 0x7f4be2148b40>,8,13,[ 5 13],9,-1,32,-1,19
1,<environment.Job instance at 0x7f4be26d6320>,12,3,[ 5 13],13,-1,23,-1,20
1,<environment.Job instance at 0x7f4be32c9140>,24,26,[8 5],25,-1,68,-1,42
1,<environment.Job instance at 0x7f4be37e0370>,33,24,[3 7],34,-1,98,-1,74
1,<environment.Job instance at 0x7f4be37ee4b0>,41,3,[14  4],42,-1,97,-1,94
1,<environment.Job instance at 0x7f4be28bdfa0>,42,16,[ 4 12],43,-1,110,-1,94
1,<environment.Job instance at 0x7f4be21e61e0>,46,15,[14  5],47,-1,113,-1,98
1,<environment.Job instance at 0x7f4be21b6190>,55,25,[ 4 10],56,-1,175,-1,150
1,<environment.Job instance at 0x7f4be21b9f50>,59,16,[ 3 12],60,-1,167,-1,151
1,<environment.Job instance at 0x7f4be37d5280>,68,2,[ 5 11],69,-1,175,-1,173
1,<environment.Job instance at 0x7f4be37d5640>,71,27,[4 5],72,-1,217,-1,190
1,<environment.Job instance at 0x7f4be37d5b40>,76,27,[10  5],77,-1,263,-1,236
1,<environment.Job instance at 0x7f4be291b500>,86,14,[13  3],87,-1,265,-1,251
1,<environment.Job instance at 0x7f4be35c4e10>,99,2,[ 5 11],100,-1,301,-1,299
1,<environment.Job instance at 0x7f4be32d2550>,115,23,[4 8],116,-1,366,-1,343
1,<environment.Job instance at 0x7f4be32c63c0>,119,13,[ 3 14],120,-1,356,-1,343
1,<environment.Job instance at 0x7f4be32c6050>,121,27,[6 2],122,-1,386,-1,359
1,<environment.Job instance at 0x7f4be35a2780>,123,13,[13  1],124,-1,372,-1,359
1,<environment.Job instance at 0x7f4be23adaa0>,129,12,[11  3],130,-1,386,-1,374
1,<environment.Job instance at 0x7f4be2de3870>,138,27,[9 1],139,-1,451,-1,424
1,<environment.Job instance at 0x7f4be2de3410>,141,16,[14  3],142,-1,440,-1,424
1,<environment.Job instance at 0x7f4be2dbc5f0>,143,27,[6 5],144,-1,454,-1,427
1,<environment.Job instance at 0x7f4bec300500>,145,26,[6 1],146,-1,456,-1,430
1,<environment.Job instance at 0x7f4be32dc6e0>,150,26,[4 5],151,-1,477,-1,451
1,<environment.Job instance at 0x7f4be2dae640>,157,15,[12  1],158,-1,496,-1,481
1,<environment.Job instance at 0x7f4be35115a0>,4,17,[7 5],5,-1,23,-1,6
1,<environment.Job instance at 0x7f4be35111e0>,6,14,[ 4 10],7,-1,21,-1,7
1,<environment.Job instance at 0x7f4be22a4730>,5,13,[7 1],6,-1,20,-1,7
1,<environment.Job instance at 0x7f4be2b1ddc0>,12,16,[2 9],13,-1,30,-1,14
1,<environment.Job instance at 0x7f4be2b1d140>,14,15,[9 3],15,-1,30,-1,15
1,<environment.Job instance at 0x7f4be2b1dd20>,15,15,[4 8],16,-1,31,-1,16
1,<environment.Job instance at 0x7f4be2b1d550>,16,1,[7 2],17,-1,18,-1,17
1,<environment.Job instance at 0x7f4be3511a00>,13,16,[1 8],14,-1,33,-1,17
1,<environment.Job instance at 0x7f4be2b1de10>,17,25,[9 5],18,-1,43,-1,18
1,<environment.Job instance at 0x7f4be3127190>,27,12,[5 6],28,-1,40,-1,28
1,<environment.Job instance at 0x7f4be3127c80>,30,14,[1 8],31,-1,46,-1,32
1,<environment.Job instance at 0x7f4be31272d0>,32,13,[8 3],33,-1,46,-1,33
1,<environment.Job instance at 0x7f4be31275f0>,33,15,[4 9],34,-1,49,-1,34
1,<environment.Job instance at 0x7f4be3127640>,31,14,[9 1],32,-1,49,-1,35
1,<environment.Job instance at 0x7f4be3127960>,36,18,[2 5],37,-1,56,-1,38
1,<environment.Job instance at 0x7f4be3958960>,43,12,[10  3],44,-1,57,-1,45
1,<environment.Job instance at 0x7f4be34d7500>,51,18,[1 6],52,-1,70,-1,52
1,<environment.Job instance at 0x7f4be34d7a00>,52,17,[5 2],53,-1,70,-1,53
1,<environment.Job instance at 0x7f4be34d7f50>,53,14,[8 5],54,-1,68,-1,54
1,<environment.Job instance at 0x7f4be34d7af0>,55,18,[5 8],56,-1,74,-1,56
1,<environment.Job instance at 0x7f4be34d7aa0>,57,16,[3 5],58,-1,74,-1,58
1,<environment.Job instance at 0x7f4be34d7c80>,59,18,[5 6],60,-1,78,-1,60
1,<environment.Job instance at 0x7f4be3958b90>,44,14,[10  2],45,-1,83,-1,69
1,<environment.Job instance at 0x7f4be34d7050>,63,27,[2 5],64,-1,98,-1,71
1,<environment.Job instance at 0x7f4be2af8550>,73,16,[8 3],74,-1,90,-1,74
1,<environment.Job instance at 0x7f4be34d7910>,62,16,[ 2 13],63,-1,113,-1,97
1,<environment.Job instance at 0x7f4be34e43c0>,68,16,[10  1],69,-1,168,-1,152
1,<environment.Job instance at 0x7f4be2af8c80>,75,18,[4 6],76,-1,170,-1,152
1,<environment.Job instance at 0x7f4be2af87d0>,80,28,[5 3],81,-1,184,-1,156
1,<environment.Job instance at 0x7f4be3127f50>,28,15,[ 5 14],29,-1,175,-1,160
1,<environment.Job instance at 0x7f4be2af8640>,78,14,[3 9],79,-1,178,-1,164
1,<environment.Job instance at 0x7f4be2143b90>,90,18,[2 5],91,-1,185,-1,167
1,<environment.Job instance at 0x7f4be34d7780>,60,26,[ 5 14],61,-1,193,-1,167
1,<environment.Job instance at 0x7f4be2af83c0>,85,17,[5 8],86,-1,184,-1,167
1,<environment.Job instance at 0x7f4be2143780>,91,12,[10  4],92,-1,182,-1,170
1,<environment.Job instance at 0x7f4be2143320>,94,16,[3 6],95,-1,186,-1,170
1,<environment.Job instance at 0x7f4be2af82d0>,76,15,[5 2],77,-1,187,-1,172
1,<environment.Job instance at 0x7f4be21430a0>,103,27,[6 3],104,-1,210,-1,183
1,<environment.Job instance at 0x7f4be2143140>,106,15,[9 1],107,-1,198,-1,183
1,<environment.Job instance at 0x7f4be2143500>,108,17,[7 3],109,-1,200,-1,183
1,<environment.Job instance at 0x7f4be21433c0>,104,14,[5 6],105,-1,197,-1,183
1,<environment.Job instance at 0x7f4be3501500>,109,15,[1 7],110,-1,198,-1,183
1,<environment.Job instance at 0x7f4be3501820>,112,16,[8 2],113,-1,200,-1,184
1,<environment.Job instance at 0x7f4be2143eb0>,99,3,[9 1],100,-1,187,-1,184
1,<environment.Job instance at 0x7f4be35011e0>,113,17,[4 5],114,-1,201,-1,184
1,<environment.Job instance at 0x7f4be35018c0>,115,14,[10  5],116,-1,198,-1,184
1,<environment.Job instance at 0x7f4be3501d70>,116,13,[ 2 10],117,-1,197,-1,184
1,<environment.Job instance at 0x7f4be3501f50>,119,28,[3 9],120,-1,212,-1,184
1,<environment.Job instance at 0x7f4be3501c30>,120,13,[10  2],121,-1,197,-1,184
1,<environment.Job instance at 0x7f4be3501960>,121,18,[ 3 10],122,-1,204,-1,186
1,<environment.Job instance at 0x7f4be35015f0>,123,16,[5 3],124,-1,202,-1,186
1,<environment.Job instance at 0x7f4be3501eb0>,118,14,[9 1],119,-1,204,-1,190
1,<environment.Job instance at 0x7f4be29cc4b0>,127,17,[1 9],128,-1,210,-1,193
1,<environment.Job instance at 0x7f4be34d6cd0>,134,16,[2 6],135,-1,210,-1,194
1,<environment.Job instance at 0x7f4be32cdf50>,126,17,[ 5 10],127,-1,212,-1,195
1,<environment.Job instance at 0x7f4be34d6370>,133,17,[6 4],134,-1,213,-1,196
1,<environment.Job instance at 0x7f4be34d6d20>,135,28,[5 2],136,-1,227,-1,199
1,<environment.Job instance at 0x7f4be2f7b960>,140,18,[7 3],141,-1,217,-1,199
1,<environment.Job instance at 0x7f4be2228c30>,143,17,[5 8],144,-1,216,-1,199
1,<environment.Job instance at 0x7f4be235aa50>,149,22,[ 4 10],150,-1,226,-1,204
1,<environment.Job instance at 0x7f4be22a4b40>,147,15,[6 5],148,-1,222,-1,207
1,<environment.Job instance at 0x7f4be31e5640>,151,15,[5 6],152,-1,231,-1,216
1,<environment.Job instance at 0x7f4be31e5780>,154,12,[10  5],155,-1,228,-1,216
1,<environment.Job instance at 0x7f4be35aacd0>,155,20,[7 3],156,-1,236,-1,216
1,<environment.Job instance at 0x7f4be3511dc0>,0,1,[ 2 14],1,-1,2,-1,1
1,<environment.Job instance at 0x7f4be26bb0f0>,17,25,[9 5],18,-1,63,-1,38
1,<environment.Job instance at 0x7f4be26bb0a0>,18,2,[ 1 13],19,-1,40,-1,38
1,<environment.Job instance at 0x7f4be2522e10>,25,15,[ 3 14],26,-1,58,-1,43
1,<environment.Job instance at 0x7f4be36c4230>,28,15,[ 5 14],29,-1,70,-1,55
1,<environment.Job instance at 0x7f4be2629b90>,37,2,[ 1 11],38,-1,88,-1,86
1,<environment.Job instance at 0x7f4be2932410>,38,27,[4 6],39,-1,127,-1,100
1,<environment.Job instance at 0x7f4be2ead6e0>,60,26,[ 5 14],61,-1,182,-1,156
1,<environment.Job instance at 0x7f4be37ec8c0>,62,16,[ 2 13],63,-1,175,-1,159
1,<environment.Job instance at 0x7f4bec301a00>,63,27,[2 5],64,-1,196,-1,169
1,<environment.Job instance at 0x7f4bec35faf0>,80,28,[5 3],81,-1,252,-1,224
1,<environment.Job instance at 0x7f4be2fce910>,83,1,[13  4],84,-1,228,-1,227
1,<environment.Job instance at 0x7f4be330b140>,103,27,[6 3],104,-1,337,-1,310
1,<environment.Job instance at 0x7f4be37ffbe0>,110,2,[11  1],111,-1,338,-1,336
1,<environment.Job instance at 0x7f4bebf04820>,119,28,[3 9],120,-1,407,-1,379
1,<environment.Job instance at 0x7f4be35a9140>,122,12,[13  5],123,-1,391,-1,379
1,<environment.Job instance at 0x7f4be3793730>,125,25,[10  4],126,-1,427,-1,402
1,<environment.Job instance at 0x7f4be23bd6e0>,135,28,[5 2],136,-1,452,-1,424
1,<environment.Job instance at 0x7f4be3748230>,6,13,[9 2],7,-1,21,-1,8
1,<environment.Job instance at 0x7f4be3748730>,8,14,[4 8],9,-1,23,-1,9
1,<environment.Job instance at 0x7f4bec466780>,7,17,[2 8],8,-1,26,-1,9
1,<environment.Job instance at 0x7f4be37484b0>,10,13,[9 1],11,-1,25,-1,12
1,<environment.Job instance at 0x7f4be37480f0>,11,16,[10  2],12,-1,29,-1,13
1,<environment.Job instance at 0x7f4be3748b90>,13,16,[1 7],14,-1,30,-1,14
1,<environment.Job instance at 0x7f4be34369b0>,23,26,[9 5],24,-1,50,-1,24
1,<environment.Job instance at 0x7f4be214a9b0>,27,14,[5 1],28,-1,42,-1,28
1,<environment.Job instance at 0x7f4be214abe0>,29,25,[4 9],30,-1,55,-1,30
1,<environment.Job instance at 0x7f4be34d89b0>,31,16,[1 8],32,-1,48,-1,32
1,<environment.Job instance at 0x7f4be34d8370>,32,16,[ 5 10],33,-1,49,-1,33
1,<environment.Job instance at 0x7f4be34d8af0>,36,13,[ 1 10],37,-1,51,-1,38
1,<environment.Job instance at 0x7f4be34d8b40>,40,14,[10  2],41,-1,55,-1,41
1,<environment.Job instance at 0x7f4be34d8460>,44,19,[3 6],45,-1,70,-1,51
1,<environment.Job instance at 0x7f4be3563d70>,51,16,[3 6],52,-1,68,-1,52
1,<environment.Job instance at 0x7f4be34d81e0>,37,18,[7 4],38,-1,83,-1,65
1,<environment.Job instance at 0x7f4be2de35a0>,59,12,[3 8],60,-1,78,-1,66
1,<environment.Job instance at 0x7f4be320d230>,49,17,[8 4],50,-1,83,-1,66
1,<environment.Job instance at 0x7f4be26aa3c0>,62,16,[3 5],63,-1,82,-1,66
1,<environment.Job instance at 0x7f4be2de3550>,56,16,[6 2],57,-1,86,-1,70
1,<environment.Job instance at 0x7f4be26aaaa0>,61,15,[5 5],62,-1,85,-1,70
1,<environment.Job instance at 0x7f4be320dd20>,47,13,[2 9],48,-1,83,-1,70
1,<environment.Job instance at 0x7f4be26aa0a0>,68,15,[7 4],69,-1,85,-1,70
1,<environment.Job instance at 0x7f4be26aacd0>,66,14,[6 5],67,-1,85,-1,71
1,<environment.Job instance at 0x7f4be2476c80>,84,17,[ 3 11],85,-1,122,-1,105
1,<environment.Job instance at 0x7f4be37ce7d0>,86,24,[8 4],87,-1,130,-1,106
1,<environment.Job instance at 0x7f4be26aa960>,63,18,[8 4],64,-1,124,-1,106
1,<environment.Job instance at 0x7f4be37cee60>,87,17,[8 3],88,-1,123,-1,106
1,<environment.Job instance at 0x7f4be26aaf00>,67,13,[9 3],68,-1,119,-1,106
1,<environment.Job instance at 0x7f4be37ce460>,89,15,[3 9],90,-1,121,-1,106
1,<environment.Job instance at 0x7f4be37cedc0>,91,12,[6 2],92,-1,118,-1,106
1,<environment.Job instance at 0x7f4be37cee10>,94,22,[10  1],95,-1,128,-1,106
1,<environment.Job instance at 0x7f4be37f24b0>,98,15,[ 3 10],99,-1,122,-1,107
1,<environment.Job instance at 0x7f4bec308370>,99,15,[3 5],100,-1,122,-1,107
1,<environment.Job instance at 0x7f4be37ce730>,85,16,[9 5],86,-1,125,-1,109
1,<environment.Job instance at 0x7f4bec50fe60>,100,18,[1 5],101,-1,127,-1,109
1,<environment.Job instance at 0x7f4be314fd70>,130,17,[10  3],131,-1,417,-1,400
1,<environment.Job instance at 0x7f4be2860320>,125,18,[14  5],126,-1,418,-1,400
1,<environment.Job instance at 0x7f4be2b410a0>,158,12,[9 1],159,-1,412,-1,400
1,<environment.Job instance at 0x7f4be29076e0>,157,18,[ 1 10],158,-1,418,-1,400
1,<environment.Job instance at 0x7f4be24e4b40>,14,16,[12  4],15,-1,49,-1,33
1,<environment.Job instance at 0x7f4be314f5f0>,18,16,[11  4],19,-1,54,-1,38
1,<environment.Job instance at 0x7f4be34b5780>,23,26,[9 5],24,-1,78,-1,52
1,<environment.Job instance at 0x7f4be30b07d0>,26,3,[ 2 12],27,-1,57,-1,54
1,<environment.Job instance at 0x7f4be38f5e60>,28,16,[12  5],29,-1,70,-1,54
1,<environment.Job instance at 0x7f4be215f4b0>,29,25,[4 9],30,-1,81,-1,56
1,<environment.Job instance at 0x7f4be3802cd0>,33,2,[ 3 12],34,-1,68,-1,66
1,<environment.Job instance at 0x7f4be3998eb0>,39,18,[14  4],40,-1,105,-1,87
1,<environment.Job instance at 0x7f4be24499b0>,41,13,[ 2 13],42,-1,102,-1,89
1,<environment.Job instance at 0x7f4be2449140>,42,3,[ 2 14],43,-1,92,-1,89
1,<environment.Job instance at 0x7f4bebf04820>,52,12,[11  5],53,-1,135,-1,123
1,<environment.Job instance at 0x7f4be2e795f0>,79,13,[11  2],80,-1,245,-1,232
1,<environment.Job instance at 0x7f4be21dd320>,82,2,[ 5 13],83,-1,244,-1,242
1,<environment.Job instance at 0x7f4be2090280>,84,17,[ 3 11],85,-1,261,-1,244
1,<environment.Job instance at 0x7f4be20906e0>,86,24,[8 4],87,-1,273,-1,249
1,<environment.Job instance at 0x7f4bebf58640>,93,1,[ 5 11],94,-1,266,-1,265
1,<environment.Job instance at 0x7f4be30653c0>,97,17,[12  1],98,-1,285,-1,268
1,<environment.Job instance at 0x7f4bebfa9a00>,102,15,[ 2 13],103,-1,302,-1,287
1,<environment.Job instance at 0x7f4be2932410>,105,1,[14  4],106,-1,300,-1,299
1,<environment.Job instance at 0x7f4be2522e10>,112,28,[9 3],113,-1,346,-1,318
1,<environment.Job instance at 0x7f4be3511dc0>,119,17,[ 2 13],120,-1,349,-1,332
1,<environment.Job instance at 0x7f4bec466370>,125,18,[14  5],126,-1,380,-1,362
1,<environment.Job instance at 0x7f4bec4666e0>,127,3,[12  1],128,-1,376,-1,373
1,<environment.Job instance at 0x7f4be2928c30>,137,27,[9 3],138,-1,445,-1,418
1,<environment.Job instance at 0x7f4be3229190>,139,16,[14  4],140,-1,434,-1,418
1,<environment.Job instance at 0x7f4be2928460>,140,3,[ 3 13],141,-1,421,-1,418
1,<environment.Job instance at 0x7effcaafc6e0>,0,18,[ 2 10],1,-1,20,-1,2
1,<environment.Job instance at 0x7effc150ca50>,3,18,[ 3 10],4,-1,22,-1,4
1,<environment.Job instance at 0x7effc150cbe0>,4,18,[10  4],5,-1,23,-1,5
1,<environment.Job instance at 0x7effc150caf0>,5,13,[5 9],6,-1,19,-1,6
1,<environment.Job instance at 0x7effc150cc80>,6,12,[11  4],7,-1,19,-1,7
1,<environment.Job instance at 0x7effc150cdc0>,8,17,[ 2 10],9,-1,26,-1,9
1,<environment.Job instance at 0x7effc150cf00>,9,17,[ 4 10],10,-1,27,-1,10
1,<environment.Job instance at 0x7effc150f2d0>,13,13,[1 8],14,-1,27,-1,14
1,<environment.Job instance at 0x7effc150f730>,18,16,[8 5],19,-1,35,-1,19
1,<environment.Job instance at 0x7effc150fb90>,23,18,[5 2],24,-1,42,-1,24
1,<environment.Job instance at 0x7effc150feb0>,26,22,[2 9],27,-1,55,-1,33
1,<environment.Job instance at 0x7effcaafc8c0>,1,15,[ 1 14],2,-1,52,-1,37
1,<environment.Job instance at 0x7effc1512820>,35,16,[8 1],36,-1,54,-1,38
1,<environment.Job instance at 0x7effc1512b40>,39,18,[5 8],40,-1,58,-1,40
1,<environment.Job instance at 0x7effc15123c0>,32,17,[9 3],33,-1,60,-1,43
1,<environment.Job instance at 0x7effc1512eb0>,41,14,[6 1],42,-1,57,-1,43
1,<environment.Job instance at 0x7effc1512f50>,43,28,[6 4],44,-1,72,-1,44
1,<environment.Job instance at 0x7effc15140a0>,44,17,[ 5 12],45,-1,62,-1,45
1,<environment.Job instance at 0x7effc15145f0>,50,27,[9 1],51,-1,78,-1,51
1,<environment.Job instance at 0x7effc1514aa0>,53,18,[ 4 12],54,-1,72,-1,54
1,<environment.Job instance at 0x7effc1514b90>,54,14,[1 7],55,-1,69,-1,55
1,<environment.Job instance at 0x7effc1514a50>,55,17,[4 7],56,-1,73,-1,56
1,<environment.Job instance at 0x7effc1514c80>,56,18,[4 5],57,-1,75,-1,57
1,<environment.Job instance at 0x7effc15120f0>,31,17,[4 9],32,-1,78,-1,61
1,<environment.Job instance at 0x7effc1514f50>,59,14,[ 2 10],60,-1,75,-1,61
1,<environment.Job instance at 0x7effc15183c0>,62,20,[9 1],63,-1,83,-1,63
1,<environment.Job instance at 0x7effc1514be0>,60,24,[ 3 10],61,-1,88,-1,64
1,<environment.Job instance at 0x7effc15182d0>,63,15,[1 5],64,-1,79,-1,64
1,<environment.Job instance at 0x7effc1518460>,65,13,[3 5],66,-1,79,-1,66
1,<environment.Job instance at 0x7effc1518500>,67,26,[5 4],68,-1,94,-1,68
1,<environment.Job instance at 0x7effc15187d0>,68,22,[5 6],69,-1,91,-1,69
1,<environment.Job instance at 0x7effc15188c0>,70,18,[5 5],71,-1,89,-1,71
1,<environment.Job instance at 0x7effc1518910>,72,14,[9 1],73,-1,87,-1,73
1,<environment.Job instance at 0x7effc15190a0>,77,15,[4 7],78,-1,93,-1,78
1,<environment.Job instance at 0x7effc15191e0>,78,19,[8 4],79,-1,98,-1,79
1,<environment.Job instance at 0x7effc15190f0>,79,17,[2 7],80,-1,97,-1,80
1,<environment.Job instance at 0x7effc1519730>,84,12,[3 5],85,-1,97,-1,85
1,<environment.Job instance at 0x7effc1512fa0>,42,14,[8 4],43,-1,100,-1,86
1,<environment.Job instance at 0x7effcab42140>,91,16,[5 8],92,-1,108,-1,92
1,<environment.Job instance at 0x7effc1503640>,100,18,[7 5],101,-1,121,-1,103
1,<environment.Job instance at 0x7effc150f280>,1,15,[ 1 14],2,-1,17,-1,2
1,<environment.Job instance at 0x7effc15127d0>,6,12,[11  4],7,-1,19,-1,7
1,<environment.Job instance at 0x7effc14e36e0>,19,17,[12  3],20,-1,67,-1,50
1,<environment.Job instance at 0x7effc15bc2d0>,22,2,[12  3],23,-1,62,-1,60
1,<environment.Job instance at 0x7effc14f4eb0>,43,28,[6 4],44,-1,166,-1,138
1,<environment.Job instance at 0x7effc14f4230>,44,17,[ 5 12],45,-1,155,-1,138
1,<environment.Job instance at 0x7effc14efdc0>,50,27,[9 1],51,-1,179,-1,152
1,<environment.Job instance at 0x7effc14ef9b0>,52,3,[ 3 11],53,-1,155,-1,152
1,<environment.Job instance at 0x7effc14ef140>,53,18,[ 4 12],54,-1,170,-1,152
1,<environment.Job instance at 0x7effc1500690>,60,24,[ 3 10],61,-1,209,-1,185
1,<environment.Job instance at 0x7effc14fcfa0>,67,26,[5 4],68,-1,226,-1,200
1,<environment.Job instance at 0x7effc14a60f0>,81,17,[ 4 14],82,-1,256,-1,239
1,<environment.Job instance at 0x7effc14a6410>,85,19,[14  4],86,-1,260,-1,241
1,<environment.Job instance at 0x7effc14a6aa0>,95,23,[3 7],96,-1,294,-1,271
1,<environment.Job instance at 0x7effc14a90a0>,102,27,[ 3 13],103,-1,316,-1,289
1,<environment.Job instance at 0x7effc14a9820>,111,18,[ 3 13],112,-1,333,-1,315
1,<environment.Job instance at 0x7effc14a9af0>,117,18,[ 3 12],118,-1,348,-1,330
1,<environment.Job instance at 0x7effc14a9d70>,121,18,[11  5],122,-1,359,-1,341
1,<environment.Job instance at 0x7effc14a91e0>,122,14,[14  1],123,-1,355,-1,341
1,<environment.Job instance at 0x7effc14ac7d0>,135,15,[ 3 14],136,-1,411,-1,396
1,<environment.Job instance at 0x7effc14ac910>,137,12,[14  5],138,-1,408,-1,396
1,<environment.Job instance at 0x7effc14affa0>,166,22,[11  3],167,-1,533,-1,511
1,<environment.Job instance at 0x7effc0eedb90>,5,25,[3 9],6,-1,31,-1,6
1,<environment.Job instance at 0x7effc0eed7d0>,7,13,[ 4 10],8,-1,21,-1,8
1,<environment.Job instance at 0x7effc0eefa00>,9,23,[2 8],10,-1,33,-1,10
1,<environment.Job instance at 0x7effc0ee6370>,15,17,[10  5],16,-1,33,-1,16
1,<environment.Job instance at 0x7effc0f72730>,16,26,[9 1],17,-1,43,-1,17
1,<environment.Job instance at 0x7effc0f72410>,18,14,[8 5],19,-1,34,-1,20
1,<environment.Job instance at 0x7effc0f725f0>,20,18,[5 1],21,-1,39,-1,21
1,<environment.Job instance at 0x7effc0f72690>,19,17,[9 2],20,-1,38,-1,21
1,<environment.Job instance at 0x7effc0f72be0>,22,14,[8 4],23,-1,39,-1,25
1,<environment.Job instance at 0x7effc0f72d70>,24,17,[10  5],25,-1,42,-1,25
1,<environment.Job instance at 0x7effc0f72f50>,25,16,[ 3 10],26,-1,42,-1,26
1,<environment.Job instance at 0x7effc0f72fa0>,26,23,[5 8],27,-1,50,-1,27
1,<environment.Job instance at 0x7effc0f7be10>,32,14,[9 2],33,-1,48,-1,34
1,<environment.Job instance at 0x7effc0f7bd20>,33,27,[5 3],34,-1,61,-1,34
1,<environment.Job instance at 0x7effc0f7bfa0>,34,17,[10  2],35,-1,53,-1,36
1,<environment.Job instance at 0x7effc0f7f0a0>,36,13,[5 1],37,-1,50,-1,37
1,<environment.Job instance at 0x7effc0f7f550>,37,1,[1 6],38,-1,39,-1,38
1,<environment.Job instance at 0x7effc0f7f4b0>,38,22,[9 2],39,-1,61,-1,39
1,<environment.Job instance at 0x7effc0f7f500>,39,3,[ 4 12],40,-1,43,-1,40
1,<environment.Job instance at 0x7effc0f7f690>,40,17,[2 9],41,-1,58,-1,41
1,<environment.Job instance at 0x7effc0f7b870>,35,17,[5 9],36,-1,58,-1,41
1,<environment.Job instance at 0x7effc0f7b9b0>,41,18,[ 5 11],42,-1,60,-1,42
1,<environment.Job instance at 0x7effc0f7f6e0>,42,17,[10  4],43,-1,60,-1,43
1,<environment.Job instance at 0x7effc0f7f960>,45,17,[8 1],46,-1,64,-1,47
1,<environment.Job instance at 0x7effc0f7f820>,47,18,[ 1 10],48,-1,66,-1,48
1,<environment.Job instance at 0x7effc0f7feb0>,48,28,[7 4],49,-1,77,-1,49
1,<environment.Job instance at 0x7effc0f7fcd0>,49,1,[9 2],50,-1,52,-1,51
1,<environment.Job instance at 0x7effc0f7f370>,46,16,[7 2],47,-1,68,-1,52
1,<environment.Job instance at 0x7effc0d866e0>,53,15,[5 6],54,-1,69,-1,54
1,<environment.Job instance at 0x7effc0d254b0>,55,17,[3 5],56,-1,73,-1,56
1,<environment.Job instance at 0x7effc0d25f50>,56,15,[ 5 10],57,-1,72,-1,57
1,<environment.Job instance at 0x7effc0ea3a00>,58,16,[14  3],59,-1,75,-1,59
1,<environment.Job instance at 0x7effc0d25730>,59,12,[5 4],60,-1,72,-1,60
1,<environment.Job instance at 0x7effc0d25d20>,62,16,[8 5],63,-1,79,-1,63
1,<environment.Job instance at 0x7effc0d7a050>,64,14,[8 5],65,-1,79,-1,65
1,<environment.Job instance at 0x7effcad983c0>,68,18,[3 8],69,-1,87,-1,69
1,<environment.Job instance at 0x7effc0d988c0>,69,16,[9 4],70,-1,86,-1,70
1,<environment.Job instance at 0x7effc1cda320>,70,28,[7 3],71,-1,99,-1,71
1,<environment.Job instance at 0x7effcab24690>,71,16,[7 4],72,-1,88,-1,72
1,<environment.Job instance at 0x7effc0b9e230>,73,18,[1 6],74,-1,92,-1,74
1,<environment.Job instance at 0x7effc0cd1140>,74,15,[9 5],75,-1,90,-1,75
1,<environment.Job instance at 0x7effc0b1eb90>,76,17,[2 6],77,-1,94,-1,77
1,<environment.Job instance at 0x7effc0ab5f00>,77,16,[2 8],78,-1,94,-1,78
1,<environment.Job instance at 0x7effc0aa7280>,80,18,[8 5],81,-1,99,-1,81
1,<environment.Job instance at 0x7effc0be4a50>,82,13,[2 5],83,-1,96,-1,83
1,<environment.Job instance at 0x7effc0be4050>,83,14,[3 5],84,-1,98,-1,84
1,<environment.Job instance at 0x7effc0be4d20>,84,17,[1 9],85,-1,102,-1,85
1,<environment.Job instance at 0x7effc0aa3aa0>,93,21,[9 5],94,-1,116,-1,95
1,<environment.Job instance at 0x7effc0ac0640>,94,18,[10  2],95,-1,113,-1,95
1,<environment.Job instance at 0x7effc0ac0960>,91,19,[ 3 14],92,-1,125,-1,106
1,<environment.Job instance at 0x7effc0abd460>,96,22,[6 1],97,-1,128,-1,106
1,<environment.Job instance at 0x7effc0abef00>,106,14,[5 4],107,-1,122,-1,108
1,<environment.Job instance at 0x7effc0abe4b0>,104,1,[3 7],105,-1,109,-1,108
1,<environment.Job instance at 0x7effc0abd6e0>,101,18,[ 5 14],102,-1,127,-1,109
1,<environment.Job instance at 0x7effc0abee60>,107,14,[4 7],108,-1,123,-1,109
1,<environment.Job instance at 0x7effc0abec30>,111,16,[6 2],112,-1,128,-1,112
1,<environment.Job instance at 0x7effc0abc190>,116,13,[3 6],117,-1,130,-1,117
1,<environment.Job instance at 0x7effc0abe7d0>,103,18,[7 5],104,-1,135,-1,117
1,<environment.Job instance at 0x7effc0abcaf0>,119,14,[5 7],120,-1,138,-1,124
1,<environment.Job instance at 0x7effc0abceb0>,118,17,[12  1],119,-1,142,-1,125
1,<environment.Job instance at 0x7effc0bee9b0>,124,18,[ 5 10],125,-1,144,-1,126
1,<environment.Job instance at 0x7effc0bee050>,126,16,[5 7],127,-1,143,-1,127
1,<environment.Job instance at 0x7effcaba3690>,130,17,[4 5],131,-1,149,-1,132
1,<environment.Job instance at 0x7effc0ac4b40>,132,27,[ 2 13],133,-1,160,-1,133
1,<environment.Job instance at 0x7effc0beed20>,129,15,[7 4],130,-1,150,-1,135
1,<environment.Job instance at 0x7effc0aa6960>,133,13,[8 3],134,-1,149,-1,136
1,<environment.Job instance at 0x7effc0aa6aa0>,135,18,[9 5],136,-1,154,-1,136
1,<environment.Job instance at 0x7effc0abd960>,98,21,[5 1],99,-1,159,-1,138
1,<environment.Job instance at 0x7effc0b3cd20>,136,15,[7 3],137,-1,153,-1,138
1,<environment.Job instance at 0x7effc0b3c230>,137,17,[7 5],138,-1,156,-1,139
1,<environment.Job instance at 0x7effc0bf0370>,140,14,[2 8],141,-1,156,-1,142
1,<environment.Job instance at 0x7effc0d30140>,144,16,[8 3],145,-1,161,-1,145
1,<environment.Job instance at 0x7effc0be55a0>,149,17,[4 8],150,-1,167,-1,150
1,<environment.Job instance at 0x7effc0be5b90>,150,14,[ 3 10],151,-1,165,-1,151
1,<environment.Job instance at 0x7effc0be5a50>,153,15,[7 4],154,-1,169,-1,154
1,<environment.Job instance at 0x7effc0bf0730>,141,15,[10  3],142,-1,172,-1,157
1,<environment.Job instance at 0x7effc0ab9500>,161,16,[2 8],162,-1,181,-1,165
1,<environment.Job instance at 0x7effc0bece10>,168,14,[10  4],169,-1,183,-1,169
1,<environment.Job instance at 0x7effc0f7f0f0>,5,25,[3 9],6,-1,42,-1,17
1,<environment.Job instance at 0x7effc0d25230>,9,23,[2 8],10,-1,40,-1,17
1,<environment.Job instance at 0x7effcab3e9b0>,16,26,[9 1],17,-1,49,-1,23
1,<environment.Job instance at 0x7effc14af7d0>,26,23,[5 8],27,-1,94,-1,71
1,<environment.Job instance at 0x7effc14af410>,31,2,[12  1],32,-1,75,-1,73
1,<environment.Job instance at 0x7effc14af230>,33,27,[5 3],34,-1,102,-1,75
1,<environment.Job instance at 0x7effc14a9d20>,39,3,[ 4 12],40,-1,98,-1,95
1,<environment.Job instance at 0x7effc14a9b40>,41,18,[ 5 11],42,-1,113,-1,95
1,<environment.Job instance at 0x7effc14a9690>,48,28,[7 4],49,-1,185,-1,157
1,<environment.Job instance at 0x7effc14a9230>,54,28,[9 1],55,-1,207,-1,179
1,<environment.Job instance at 0x7effc14a6f50>,58,16,[14  3],59,-1,195,-1,179
1,<environment.Job instance at 0x7effc14a6410>,70,28,[7 3],71,-1,271,-1,243
1,<environment.Job instance at 0x7effc0cd3640>,88,12,[12  2],89,-1,329,-1,317
1,<environment.Job instance at 0x7effc0cd3e10>,91,19,[ 3 14],92,-1,344,-1,325
1,<environment.Job instance at 0x7effc0ee9870>,92,2,[14  5],93,-1,327,-1,325
1,<environment.Job instance at 0x7effc0cd3be0>,95,12,[12  4],96,-1,346,-1,334
1,<environment.Job instance at 0x7effc0cd1690>,101,18,[ 5 14],102,-1,368,-1,350
1,<environment.Job instance at 0x7effc0e4afa0>,108,1,[ 5 14],109,-1,371,-1,370
1,<environment.Job instance at 0x7effc0df5500>,113,3,[14  5],114,-1,389,-1,386
1,<environment.Job instance at 0x7effc0db7550>,118,17,[12  1],119,-1,406,-1,389
1,<environment.Job instance at 0x7effc0cd5aa0>,122,1,[13  3],123,-1,407,-1,406
1,<environment.Job instance at 0x7effc0cbec80>,132,27,[ 2 13],133,-1,481,-1,454
1,<environment.Job instance at 0x7effc0cfc7d0>,138,1,[12  5],139,-1,476,-1,475
1,<environment.Job instance at 0x7effc0c85fa0>,151,18,[ 4 13],152,-1,546,-1,528
1,<environment.Job instance at 0x7effc0ccb280>,157,16,[ 5 13],158,-1,574,-1,558
1,<environment.Job instance at 0x7effc0ccb640>,164,18,[13  2],165,-1,593,-1,575
1,<environment.Job instance at 0x7effc0c38a50>,5,17,[6 3],6,-1,23,-1,6
1,<environment.Job instance at 0x7effc0c38190>,8,17,[2 8],9,-1,26,-1,9
1,<environment.Job instance at 0x7effc0c38f00>,11,14,[3 6],12,-1,26,-1,12
1,<environment.Job instance at 0x7effc0c383c0>,14,12,[2 9],15,-1,27,-1,15
1,<environment.Job instance at 0x7effc0c380a0>,15,16,[2 6],16,-1,32,-1,16
1,<environment.Job instance at 0x7effc0c38370>,16,15,[10  5],17,-1,32,-1,17
1,<environment.Job instance at 0x7effc0c38e10>,17,16,[ 3 10],18,-1,34,-1,18
1,<environment.Job instance at 0x7effc0c38be0>,18,16,[3 6],19,-1,35,-1,19
1,<environment.Job instance at 0x7effc0c36cd0>,19,22,[1 6],20,-1,42,-1,20
1,<environment.Job instance at 0x7effc0c36870>,24,22,[1 9],25,-1,47,-1,25
1,<environment.Job instance at 0x7effc0c36050>,27,13,[ 1 10],28,-1,41,-1,28
1,<environment.Job instance at 0x7effc0c33690>,29,18,[ 2 10],30,-1,48,-1,30
1,<environment.Job instance at 0x7effc0c33b40>,30,17,[7 1],31,-1,48,-1,31
1,<environment.Job instance at 0x7effc0c335a0>,31,18,[3 8],32,-1,50,-1,32
1,<environment.Job instance at 0x7effc0c33cd0>,33,24,[3 6],34,-1,58,-1,34
1,<environment.Job instance at 0x7effc0c33f50>,35,20,[3 8],36,-1,56,-1,36
1,<environment.Job instance at 0x7effc0c33e60>,36,15,[4 9],37,-1,53,-1,38
1,<environment.Job instance at 0x7effc0c33fa0>,37,27,[9 5],38,-1,65,-1,38
1,<environment.Job instance at 0x7effc0c2e5f0>,40,18,[4 8],41,-1,59,-1,41
1,<environment.Job instance at 0x7effc0c2e8c0>,45,18,[ 3 10],46,-1,64,-1,46
1,<environment.Job instance at 0x7effc0c2ed20>,46,21,[6 1],47,-1,68,-1,47
1,<environment.Job instance at 0x7effc0c2b960>,52,17,[9 1],53,-1,70,-1,53
1,<environment.Job instance at 0x7effc0c2b230>,53,18,[8 1],54,-1,72,-1,54
1,<environment.Job instance at 0x7effc0c2b870>,55,27,[5 5],56,-1,83,-1,56
1,<environment.Job instance at 0x7effc0c2bbe0>,51,2,[7 4],52,-1,59,-1,57
1,<environment.Job instance at 0x7effc0c2bf00>,56,22,[2 8],57,-1,79,-1,57
1,<environment.Job instance at 0x7effc0c2b730>,57,20,[5 2],58,-1,78,-1,58
1,<environment.Job instance at 0x7effc0c2beb0>,59,17,[2 6],60,-1,77,-1,60
1,<environment.Job instance at 0x7effc0c2ee60>,48,12,[8 2],49,-1,72,-1,60
1,<environment.Job instance at 0x7effc0c2b910>,60,16,[1 9],61,-1,77,-1,61
1,<environment.Job instance at 0x7effc0c2b0a0>,62,17,[4 6],63,-1,80,-1,63
1,<environment.Job instance at 0x7effc0c26190>,71,18,[5 7],72,-1,91,-1,73
1,<environment.Job instance at 0x7effc0c2b3c0>,66,13,[8 3],67,-1,87,-1,74
1,<environment.Job instance at 0x7effc0c2b6e0>,58,13,[14  4],59,-1,87,-1,74
1,<environment.Job instance at 0x7effc0c22500>,85,16,[10  5],86,-1,119,-1,103
1,<environment.Job instance at 0x7effc0c267d0>,75,25,[3 7],76,-1,141,-1,116
1,<environment.Job instance at 0x7effc0c20050>,92,12,[8 5],93,-1,145,-1,133
1,<environment.Job instance at 0x7effc0c22eb0>,90,17,[9 4],91,-1,152,-1,135
1,<environment.Job instance at 0x7effc0c9b7d0>,105,24,[3 9],106,-1,244,-1,220
1,<environment.Job instance at 0x7effc0b3c1e0>,114,15,[ 1 10],115,-1,235,-1,220
1,<environment.Job instance at 0x7effc0dfe3c0>,113,13,[9 5],114,-1,233,-1,220
1,<environment.Job instance at 0x7effc0e0af00>,120,13,[3 8],121,-1,233,-1,220
1,<environment.Job instance at 0x7effc0e0a230>,121,15,[14  1],122,-1,235,-1,220
1,<environment.Job instance at 0x7effc0c9bb90>,112,17,[10  3],113,-1,237,-1,220
1,<environment.Job instance at 0x7effc0e0aa50>,122,27,[5 5],123,-1,319,-1,292
1,<environment.Job instance at 0x7effc10625f0>,136,27,[5 8],137,-1,319,-1,292
1,<environment.Job instance at 0x7effc0e0aa00>,124,25,[1 7],125,-1,318,-1,293
1,<environment.Job instance at 0x7effc129c5f0>,141,24,[4 8],142,-1,317,-1,293
1,<environment.Job instance at 0x7effc128f2d0>,145,19,[7 5],146,-1,315,-1,296
1,<environment.Job instance at 0x7effc1297d20>,138,12,[5 6],139,-1,308,-1,296
1,<environment.Job instance at 0x7effc128f0f0>,147,12,[10  4],148,-1,308,-1,296
1,<environment.Job instance at 0x7effc126a9b0>,167,23,[10  4],168,-1,415,-1,392
1,<environment.Job instance at 0x7effc0c382d0>,0,18,[11  4],1,-1,19,-1,1
1,<environment.Job instance at 0x7effc1171dc0>,21,25,[10  4],22,-1,78,-1,53
1,<environment.Job instance at 0x7effc0c4d9b0>,33,24,[3 6],34,-1,124,-1,100
1,<environment.Job instance at 0x7effc0beb6e0>,37,27,[9 5],38,-1,143,-1,116
1,<environment.Job instance at 0x7effc0bf0280>,43,2,[ 3 14],44,-1,118,-1,116
1,<environment.Job instance at 0x7effc0ac11e0>,54,3,[ 3 12],55,-1,151,-1,148
1,<environment.Job instance at 0x7effc0ac1370>,55,27,[5 5],56,-1,192,-1,165
1,<environment.Job instance at 0x7effc0abefa0>,58,13,[14  4],59,-1,181,-1,168
1,<environment.Job instance at 0x7effc0ac0460>,63,27,[7 5],64,-1,232,-1,205
1,<environment.Job instance at 0x7effc0eef910>,64,13,[14  5],65,-1,218,-1,205
1,<environment.Job instance at 0x7effc0c4fa00>,75,25,[3 7],76,-1,287,-1,262
1,<environment.Job instance at 0x7effc0bec370>,80,1,[ 4 12],81,-1,277,-1,276
1,<environment.Job instance at 0x7effc0bec0a0>,84,12,[13  3],85,-1,292,-1,280
1,<environment.Job instance at 0x7effc0c9bd70>,89,3,[12  1],90,-1,310,-1,307
1,<environment.Job instance at 0x7effc0cfc410>,99,16,[ 5 13],100,-1,362,-1,346
1,<environment.Job instance at 0x7effc0cfc730>,104,14,[ 3 14],105,-1,368,-1,354
1,<environment.Job instance at 0x7effc0cfcc80>,105,24,[3 9],106,-1,392,-1,368
1,<environment.Job instance at 0x7effc0c97910>,115,1,[12  4],116,-1,401,-1,400
1,<environment.Job instance at 0x7effc0c91320>,121,15,[14  1],122,-1,428,-1,413
1,<environment.Job instance at 0x7effc0c91af0>,122,27,[5 5],123,-1,442,-1,415
1,<environment.Job instance at 0x7effc0c918c0>,124,25,[1 7],125,-1,453,-1,428
1,<environment.Job instance at 0x7effc0c94780>,136,27,[5 8],137,-1,513,-1,486
1,<environment.Job instance at 0x7effc0c94910>,141,24,[4 8],142,-1,530,-1,506
1,<environment.Job instance at 0x7effc0c8ea50>,151,1,[11  1],152,-1,531,-1,530
1,<environment.Job instance at 0x7effc0c8e1e0>,161,24,[1 9],162,-1,599,-1,575
1,<environment.Job instance at 0x7effc0c88640>,167,23,[10  4],168,-1,638,-1,615
1,<environment.Job instance at 0x7effc0c6d8c0>,1,17,[5 7],2,-1,19,-1,2
1,<environment.Job instance at 0x7effc0a73730>,5,16,[4 5],6,-1,22,-1,6
1,<environment.Job instance at 0x7effc0a73a50>,9,17,[ 5 10],10,-1,27,-1,10
1,<environment.Job instance at 0x7effc0a73b40>,10,18,[4 6],11,-1,29,-1,11
1,<environment.Job instance at 0x7effc0a73c80>,14,15,[5 7],15,-1,30,-1,15
1,<environment.Job instance at 0x7effc0a73f50>,17,18,[1 7],18,-1,36,-1,18
1,<environment.Job instance at 0x7effc0a760a0>,18,19,[1 6],19,-1,38,-1,19
1,<environment.Job instance at 0x7effc0a765a0>,23,20,[5 7],24,-1,44,-1,24
1,<environment.Job instance at 0x7effc0a76320>,26,27,[4 5],27,-1,61,-1,34
1,<environment.Job instance at 0x7effc0a76780>,28,15,[5 9],29,-1,69,-1,54
1,<environment.Job instance at 0x7effc0a76f00>,36,14,[10  4],37,-1,68,-1,54
1,<environment.Job instance at 0x7effc0a76a00>,30,14,[8 4],31,-1,174,-1,160
1,<environment.Job instance at 0x7effc0a78960>,50,18,[5 9],51,-1,185,-1,167
1,<environment.Job instance at 0x7effc0a78640>,45,12,[ 3 13],46,-1,181,-1,169
1,<environment.Job instance at 0x7effc0a78b40>,53,18,[ 1 10],54,-1,187,-1,169
1,<environment.Job instance at 0x7effc0a7a1e0>,59,14,[9 5],60,-1,183,-1,169
1,<environment.Job instance at 0x7effc0a7a320>,61,17,[14  3],62,-1,186,-1,169
1,<environment.Job instance at 0x7effc0a7a5a0>,65,17,[ 5 10],66,-1,188,-1,171
1,<environment.Job instance at 0x7effc0a7a640>,66,17,[ 1 10],67,-1,188,-1,171
1,<environment.Job instance at 0x7effc0a788c0>,49,1,[8 3],50,-1,172,-1,171
1,<environment.Job instance at 0x7effc0a7a780>,68,16,[9 2],69,-1,188,-1,172
1,<environment.Job instance at 0x7effc0a78820>,48,14,[6 4],49,-1,186,-1,172
1,<environment.Job instance at 0x7effc0a7ac80>,76,14,[9 2],77,-1,202,-1,188
1,<environment.Job instance at 0x7effc0a7ad20>,77,17,[3 8],78,-1,205,-1,188
1,<environment.Job instance at 0x7effc0a78d20>,54,14,[7 5],55,-1,203,-1,189
1,<environment.Job instance at 0x7effc0a76960>,29,12,[9 1],30,-1,201,-1,189
1,<environment.Job instance at 0x7effc0c3ea50>,80,13,[10  4],81,-1,202,-1,189
1,<environment.Job instance at 0x7effc0a69910>,85,24,[8 3],86,-1,213,-1,189
1,<environment.Job instance at 0x7effc0a7a820>,69,28,[1 8],70,-1,219,-1,191
1,<environment.Job instance at 0x7effc0a7afa0>,81,15,[1 9],82,-1,206,-1,191
1,<environment.Job instance at 0x7effc0a69550>,89,14,[4 9],90,-1,206,-1,192
1,<environment.Job instance at 0x7effc111c190>,95,13,[3 9],96,-1,209,-1,196
1,<environment.Job instance at 0x7effc12075f0>,97,17,[3 5],98,-1,214,-1,197
1,<environment.Job instance at 0x7effc1431780>,98,17,[2 6],99,-1,215,-1,198
1,<environment.Job instance at 0x7effc0e7aaa0>,100,1,[9 5],101,-1,199,-1,198
1,<environment.Job instance at 0x7effc19337d0>,96,18,[9 4],97,-1,217,-1,199
1,<environment.Job instance at 0x7effc0a69370>,90,18,[8 1],91,-1,217,-1,199
1,<environment.Job instance at 0x7effc0e7aa00>,102,15,[10  1],103,-1,214,-1,199
1,<environment.Job instance at 0x7effc0e7a960>,101,13,[12  4],102,-1,263,-1,250
1,<environment.Job instance at 0x7effc203e9b0>,105,13,[8 5],106,-1,267,-1,254
1,<environment.Job instance at 0x7effc0e9b140>,116,15,[9 1],117,-1,273,-1,258
1,<environment.Job instance at 0x7effc0e9f640>,150,27,[6 4],151,-1,395,-1,368
1,<environment.Job instance at 0x7effc12037d0>,129,16,[10  2],130,-1,384,-1,368
1,<environment.Job instance at 0x7effc0e9fa50>,152,15,[10  1],153,-1,383,-1,368
1,<environment.Job instance at 0x7effc0e9f780>,154,13,[1 8],155,-1,382,-1,369
1,<environment.Job instance at 0x7effc1200280>,136,14,[5 4],137,-1,385,-1,371
1,<environment.Job instance at 0x7effc0e9f3c0>,158,22,[7 5],159,-1,393,-1,371
1,<environment.Job instance at 0x7effc0a76550>,25,12,[11  5],26,-1,383,-1,371
1,<environment.Job instance at 0x7effc0e9faa0>,159,16,[5 3],160,-1,388,-1,372
1,<environment.Job instance at 0x7effc0a73f00>,15,24,[10  2],16,-1,396,-1,372
1,<environment.Job instance at 0x7effc0e9fe60>,161,2,[2 6],162,-1,374,-1,372
1,<environment.Job instance at 0x7effc0e9f050>,160,18,[ 5 10],161,-1,390,-1,372
1,<environment.Job instance at 0x7effc0e9f960>,162,24,[1 6],163,-1,396,-1,372
1,<environment.Job instance at 0x7effc0e9f5a0>,164,16,[9 4],165,-1,389,-1,373
1,<environment.Job instance at 0x7effc0e9fe10>,156,14,[1 7],157,-1,387,-1,373
1,<environment.Job instance at 0x7effc0e9fcd0>,166,15,[10  4],167,-1,389,-1,374
1,<environment.Job instance at 0x7effc0e9f0a0>,168,17,[3 9],169,-1,393,-1,376
1,<environment.Job instance at 0x7effc1431b90>,3,3,[ 5 13],4,-1,7,-1,4
1,<environment.Job instance at 0x7effc0e86320>,6,17,[13  2],7,-1,24,-1,7
1,<environment.Job instance at 0x7effc0e9f1e0>,7,1,[11  4],8,-1,9,-1,8
1,<environment.Job instance at 0x7effc0e7cfa0>,12,17,[ 2 12],13,-1,33,-1,16
1,<environment.Job instance at 0x7effc0e7c7d0>,15,24,[10  2],16,-1,55,-1,31
1,<environment.Job instance at 0x7effc0e7c280>,19,27,[14  1],20,-1,71,-1,44
1,<environment.Job instance at 0x7effc0a66fa0>,22,2,[11  4],23,-1,46,-1,44
1,<environment.Job instance at 0x7effc0a66460>,25,12,[11  5],26,-1,65,-1,53
1,<environment.Job instance at 0x7effc11f0140>,26,27,[4 5],27,-1,81,-1,54
1,<environment.Job instance at 0x7effc0a63410>,32,3,[11  3],33,-1,75,-1,72
1,<environment.Job instance at 0x7effc1437be0>,41,15,[ 2 14],42,-1,119,-1,104
1,<environment.Job instance at 0x7effc0e75280>,45,12,[ 3 13],46,-1,123,-1,111
1,<environment.Job instance at 0x7effc0c8ef00>,61,17,[14  3],62,-1,186,-1,169
1,<environment.Job instance at 0x7effc0c8e460>,64,15,[ 2 13],65,-1,187,-1,172
1,<environment.Job instance at 0x7effc0c8e4b0>,67,3,[12  4],68,-1,187,-1,184
1,<environment.Job instance at 0x7effc0c94640>,69,28,[1 8],70,-1,229,-1,201
1,<environment.Job instance at 0x7effc0c942d0>,78,18,[13  3],79,-1,241,-1,223
1,<environment.Job instance at 0x7effc0c91c30>,85,24,[8 3],86,-1,279,-1,255
1,<environment.Job instance at 0x7effc0c97690>,101,13,[12  4],102,-1,337,-1,324
1,<environment.Job instance at 0x7effc0cfc730>,104,24,[4 5],105,-1,363,-1,339
1,<environment.Job instance at 0x7effc0d250f0>,139,23,[6 5],140,-1,515,-1,492
1,<environment.Job instance at 0x7effc0c336e0>,150,27,[6 4],151,-1,543,-1,516
1,<environment.Job instance at 0x7effc0c33730>,151,1,[11  4],152,-1,517,-1,516
1,<environment.Job instance at 0x7effc0af6c80>,162,24,[1 6],163,-1,573,-1,549
1,<environment.Job instance at 0x7effc1b250f0>,8,14,[9 1],9,-1,24,-1,10
1,<environment.Job instance at 0x7effc1b25d70>,10,1,[9 4],11,-1,12,-1,11
1,<environment.Job instance at 0x7effc0a7f820>,9,17,[1 9],10,-1,28,-1,11
1,<environment.Job instance at 0x7effcad2d780>,18,18,[6 5],19,-1,37,-1,19
1,<environment.Job instance at 0x7effc1bbb780>,19,18,[ 5 10],20,-1,39,-1,21
1,<environment.Job instance at 0x7effc1bbb910>,23,16,[5 3],24,-1,41,-1,25
1,<environment.Job instance at 0x7effc1bbb6e0>,25,15,[ 1 10],26,-1,41,-1,26
1,<environment.Job instance at 0x7effc1bbb690>,28,24,[4 7],29,-1,53,-1,29
1,<environment.Job instance at 0x7effc1bbbcd0>,30,13,[5 3],31,-1,44,-1,31
1,<environment.Job instance at 0x7effc1bbb320>,31,3,[5 2],32,-1,35,-1,32
1,<environment.Job instance at 0x7effc1bbbe10>,32,17,[9 4],33,-1,50,-1,33
1,<environment.Job instance at 0x7effc1bbb0a0>,34,18,[ 4 11],35,-1,53,-1,35
1,<environment.Job instance at 0x7effc1bbb0f0>,35,16,[9 4],36,-1,52,-1,36
1,<environment.Job instance at 0x7effc131eeb0>,37,15,[4 6],38,-1,53,-1,38
1,<environment.Job instance at 0x7effc131e190>,40,20,[4 6],41,-1,61,-1,41
1,<environment.Job instance at 0x7effc131efa0>,44,16,[4 5],45,-1,61,-1,45
1,<environment.Job instance at 0x7effc1a1a7d0>,56,13,[4 7],57,-1,72,-1,59
1,<environment.Job instance at 0x7effc1a1a5a0>,58,20,[3 8],59,-1,82,-1,62
1,<environment.Job instance at 0x7effc131e8c0>,45,16,[ 2 11],46,-1,78,-1,62
1,<environment.Job instance at 0x7effc1a1a4b0>,60,24,[10  4],61,-1,86,-1,62
1,<environment.Job instance at 0x7effc126d780>,61,21,[4 7],62,-1,83,-1,62
1,<environment.Job instance at 0x7effc1a1aaa0>,52,17,[ 2 10],53,-1,79,-1,62
1,<environment.Job instance at 0x7effc126dc80>,63,15,[4 9],64,-1,79,-1,64
1,<environment.Job instance at 0x7effc126d410>,66,18,[6 3],67,-1,85,-1,67
1,<environment.Job instance at 0x7effc126db90>,69,19,[5 5],70,-1,89,-1,70
1,<environment.Job instance at 0x7effc126dc30>,70,15,[10  4],71,-1,87,-1,72
1,<environment.Job instance at 0x7effc126d500>,71,18,[4 8],72,-1,91,-1,73
1,<environment.Job instance at 0x7effc126d7d0>,75,12,[10  1],76,-1,90,-1,78
1,<environment.Job instance at 0x7effc126d0a0>,62,17,[ 2 11],63,-1,96,-1,79
1,<environment.Job instance at 0x7effc1a3caf0>,77,14,[ 4 10],78,-1,96,-1,82
1,<environment.Job instance at 0x7effc1a3c640>,78,18,[4 6],79,-1,100,-1,82
1,<environment.Job instance at 0x7effc126daf0>,76,12,[2 7],77,-1,99,-1,87
1,<environment.Job instance at 0x7effc1a3c0f0>,79,1,[ 5 14],80,-1,88,-1,87
1,<environment.Job instance at 0x7effc1a3ce60>,82,16,[3 8],83,-1,103,-1,87
1,<environment.Job instance at 0x7effc1a3cf00>,81,12,[5 5],82,-1,99,-1,87
1,<environment.Job instance at 0x7effc1a3c690>,83,13,[7 4],84,-1,100,-1,87
1,<environment.Job instance at 0x7effc1a3cd20>,86,18,[10  2],87,-1,105,-1,87
1,<environment.Job instance at 0x7effc1a3c410>,88,17,[9 5],89,-1,106,-1,89
1,<environment.Job instance at 0x7effc1a3c280>,90,16,[ 3 10],91,-1,107,-1,91
1,<environment.Job instance at 0x7effc1a3cc30>,89,16,[7 2],90,-1,108,-1,92
1,<environment.Job instance at 0x7effc1a3c5a0>,93,13,[5 5],94,-1,107,-1,94
1,<environment.Job instance at 0x7effc1a3c2d0>,91,16,[5 7],92,-1,112,-1,96
1,<environment.Job instance at 0x7effc18e0280>,105,12,[8 5],106,-1,122,-1,110
1,<environment.Job instance at 0x7effc18e0780>,108,17,[3 7],109,-1,127,-1,110
1,<environment.Job instance at 0x7effc18e0c80>,106,14,[6 4],107,-1,125,-1,111
1,<environment.Job instance at 0x7effc12eea50>,97,27,[ 2 11],98,-1,139,-1,112
1,<environment.Job instance at 0x7effc129b050>,111,17,[2 7],112,-1,129,-1,112
1,<environment.Job instance at 0x7effc1b4f5a0>,112,17,[6 4],113,-1,130,-1,113
1,<environment.Job instance at 0x7effc1b4fcd0>,113,12,[7 4],114,-1,126,-1,114
1,<environment.Job instance at 0x7effc12eeb40>,120,14,[ 2 10],121,-1,137,-1,123
1,<environment.Job instance at 0x7effc12eef00>,121,3,[3 9],122,-1,128,-1,125
1,<environment.Job instance at 0x7effc128cc30>,122,16,[ 3 10],123,-1,141,-1,125
1,<environment.Job instance at 0x7effc128c230>,123,18,[5 5],124,-1,144,-1,126
1,<environment.Job instance at 0x7effc128cd70>,124,16,[5 5],125,-1,142,-1,126
1,<environment.Job instance at 0x7effc128c1e0>,125,17,[ 3 10],126,-1,144,-1,127
1,<environment.Job instance at 0x7effc128c2d0>,126,13,[3 9],127,-1,140,-1,127
1,<environment.Job instance at 0x7effc128c7d0>,128,18,[1 5],129,-1,147,-1,129
1,<environment.Job instance at 0x7effc15ba230>,119,1,[5 7],120,-1,131,-1,130
1,<environment.Job instance at 0x7effc128c190>,129,18,[9 5],130,-1,148,-1,130
1,<environment.Job instance at 0x7effc128c640>,130,19,[4 5],131,-1,150,-1,131
1,<environment.Job instance at 0x7effc128c460>,132,13,[9 4],133,-1,146,-1,133
1,<environment.Job instance at 0x7effc129b320>,110,13,[5 3],111,-1,149,-1,136
1,<environment.Job instance at 0x7effc12f1730>,138,16,[8 3],139,-1,156,-1,140
1,<environment.Job instance at 0x7effc12f1870>,140,23,[9 4],141,-1,164,-1,141
1,<environment.Job instance at 0x7effc12f1f50>,137,2,[9 3],138,-1,143,-1,141
1,<environment.Job instance at 0x7effc12f1640>,141,21,[8 2],142,-1,163,-1,142
1,<environment.Job instance at 0x7effc12f1960>,142,21,[5 7],143,-1,164,-1,143
1,<environment.Job instance at 0x7effc12f1a00>,144,17,[9 2],145,-1,162,-1,145
1,<environment.Job instance at 0x7effc1549690>,145,18,[5 5],146,-1,165,-1,147
1,<environment.Job instance at 0x7effc1549e10>,153,18,[7 1],154,-1,172,-1,154
1,<environment.Job instance at 0x7effc1a1aa50>,54,12,[9 1],55,-1,167,-1,155
1,<environment.Job instance at 0x7effc1549320>,152,18,[4 7],153,-1,173,-1,155
1,<environment.Job instance at 0x7effc18adeb0>,156,18,[8 3],157,-1,175,-1,157
1,<environment.Job instance at 0x7effc18ad5a0>,160,26,[4 9],161,-1,212,-1,186
1,<environment.Job instance at 0x7effc131e460>,4,3,[ 2 12],5,-1,8,-1,5
1,<environment.Job instance at 0x7effc1a1ac30>,11,2,[ 3 14],12,-1,18,-1,16
1,<environment.Job instance at 0x7effc126da00>,16,13,[12  4],17,-1,32,-1,19
1,<environment.Job instance at 0x7effc12eed70>,17,27,[9 3],18,-1,59,-1,32
1,<environment.Job instance at 0x7effc1549cd0>,26,12,[ 2 11],27,-1,58,-1,46
1,<environment.Job instance at 0x7effc18ad7d0>,28,24,[4 7],29,-1,102,-1,78
1,<environment.Job instance at 0x7effc0ac1280>,34,18,[ 4 11],35,-1,96,-1,78
1,<environment.Job instance at 0x7effc0abc410>,39,3,[14  1],40,-1,87,-1,84
1,<environment.Job instance at 0x7effc0d43870>,43,14,[ 1 11],44,-1,102,-1,88
1,<environment.Job instance at 0x7effc0cfcd70>,45,16,[ 2 11],46,-1,106,-1,90
1,<environment.Job instance at 0x7effc0cfc730>,48,2,[13  3],49,-1,100,-1,98
1,<environment.Job instance at 0x7effc0c979b0>,60,24,[10  4],61,-1,176,-1,152
1,<environment.Job instance at 0x7effc0c97820>,62,17,[ 2 11],63,-1,169,-1,152
1,<environment.Job instance at 0x7effc0c91730>,64,1,[ 2 11],65,-1,153,-1,152
1,<environment.Job instance at 0x7effc0c94a50>,79,1,[ 5 14],80,-1,218,-1,217
1,<environment.Job instance at 0x7effc0a732d0>,97,27,[ 2 11],98,-1,321,-1,294
1,<environment.Job instance at 0x7effc0e75280>,99,3,[11  2],100,-1,302,-1,299
1,<environment.Job instance at 0x7effc0e75cd0>,102,1,[12  5],103,-1,305,-1,304
1,<environment.Job instance at 0x7effc1a463c0>,140,23,[9 4],141,-1,496,-1,473
1,<environment.Job instance at 0x7effc1a46460>,148,28,[10  4],149,-1,524,-1,496
1,<environment.Job instance at 0x7effc1857d70>,158,17,[12  1],159,-1,554,-1,537
1,<environment.Job instance at 0x7effc1857050>,160,26,[4 9],161,-1,564,-1,538
1,<environment.Job instance at 0x7effc1857280>,162,16,[13  1],163,-1,554,-1,538
1,<environment.Job instance at 0x7effc18575f0>,167,23,[5 3],168,-1,575,-1,552
1,<environment.Job instance at 0x7effc1372640>,5,14,[ 1 10],6,-1,21,-1,7
1,<environment.Job instance at 0x7effc1998730>,7,19,[1 5],8,-1,27,-1,8
1,<environment.Job instance at 0x7effc19984b0>,8,14,[1 7],9,-1,23,-1,9
1,<environment.Job instance at 0x7effc1998fa0>,9,18,[6 4],10,-1,28,-1,10
1,<environment.Job instance at 0x7effc1c69820>,14,14,[5 3],15,-1,29,-1,15
1,<environment.Job instance at 0x7effc1c69a00>,19,17,[9 2],20,-1,48,-1,31
1,<environment.Job instance at 0x7effc12e57d0>,25,17,[3 6],26,-1,51,-1,34
1,<environment.Job instance at 0x7effc1816690>,18,15,[7 3],19,-1,50,-1,35
1,<environment.Job instance at 0x7effc1816b90>,17,16,[ 3 12],18,-1,51,-1,35
1,<environment.Job instance at 0x7effc1b08730>,27,13,[4 5],28,-1,48,-1,35
1,<environment.Job instance at 0x7effc1b08870>,26,13,[8 2],27,-1,48,-1,35
1,<environment.Job instance at 0x7effc1934dc0>,6,18,[7 4],7,-1,53,-1,35
1,<environment.Job instance at 0x7effc074cbe0>,3,24,[ 5 11],4,-1,61,-1,37
1,<environment.Job instance at 0x7effc1b08500>,30,16,[ 2 10],31,-1,55,-1,39
1,<environment.Job instance at 0x7effc1a2f690>,35,18,[ 5 10],36,-1,57,-1,39
1,<environment.Job instance at 0x7effc1a2f140>,39,12,[9 4],40,-1,60,-1,48
1,<environment.Job instance at 0x7effcab8de60>,47,18,[3 8],48,-1,66,-1,48
1,<environment.Job instance at 0x7effc1b08640>,36,25,[6 3],37,-1,74,-1,49
1,<environment.Job instance at 0x7effc1f5b730>,48,16,[7 2],49,-1,65,-1,49
1,<environment.Job instance at 0x7effc18ddc30>,51,18,[10  5],52,-1,70,-1,52
1,<environment.Job instance at 0x7effc168bf00>,55,18,[9 2],56,-1,75,-1,57
1,<environment.Job instance at 0x7effc175fd20>,57,20,[1 8],58,-1,78,-1,58
1,<environment.Job instance at 0x7effca6daa50>,61,21,[4 9],62,-1,83,-1,62
1,<environment.Job instance at 0x7effca6da8c0>,63,16,[8 1],64,-1,83,-1,67
1,<environment.Job instance at 0x7effca9f4f00>,65,23,[8 4],66,-1,90,-1,67
1,<environment.Job instance at 0x7effc0fafe10>,67,20,[5 7],68,-1,88,-1,68
1,<environment.Job instance at 0x7effc0faf5a0>,68,16,[4 8],69,-1,85,-1,69
1,<environment.Job instance at 0x7effc0faf960>,69,18,[6 1],70,-1,88,-1,70
1,<environment.Job instance at 0x7effc0abc500>,75,16,[10  5],76,-1,92,-1,76
1,<environment.Job instance at 0x7effc0fe2140>,83,16,[9 4],84,-1,247,-1,231
1,<environment.Job instance at 0x7effc1009500>,99,18,[2 7],100,-1,249,-1,231
1,<environment.Job instance at 0x7effc0fe2730>,84,13,[8 2],85,-1,290,-1,277
1,<environment.Job instance at 0x7effc1697c30>,110,28,[ 2 14],111,-1,305,-1,277
1,<environment.Job instance at 0x7effc1b08c30>,32,15,[5 9],33,-1,292,-1,277
1,<environment.Job instance at 0x7effc1009730>,96,19,[2 9],97,-1,297,-1,278
1,<environment.Job instance at 0x7effc16977d0>,109,17,[ 1 10],110,-1,297,-1,280
1,<environment.Job instance at 0x7effc1ba40a0>,103,14,[ 4 10],104,-1,309,-1,295
1,<environment.Job instance at 0x7effc101e640>,117,13,[9 1],118,-1,308,-1,295
1,<environment.Job instance at 0x7effc1bdda50>,122,13,[9 1],123,-1,308,-1,295
1,<environment.Job instance at 0x7effc1bddd20>,123,23,[7 4],124,-1,318,-1,295
1,<environment.Job instance at 0x7effc1bdd410>,127,17,[10  4],128,-1,314,-1,297
1,<environment.Job instance at 0x7effc1bdd230>,126,12,[9 5],127,-1,309,-1,297
1,<environment.Job instance at 0x7effc18c77d0>,131,14,[9 4],132,-1,312,-1,298
1,<environment.Job instance at 0x7effc18c7690>,139,18,[ 2 10],140,-1,345,-1,327
1,<environment.Job instance at 0x7effc18c75a0>,144,18,[10  2],145,-1,365,-1,347
1,<environment.Job instance at 0x7effc0f72960>,148,18,[5 8],149,-1,372,-1,354
1,<environment.Job instance at 0x7effc18c7730>,140,22,[2 5],141,-1,376,-1,354
1,<environment.Job instance at 0x7effc18c7c80>,147,15,[5 8],148,-1,369,-1,354
1,<environment.Job instance at 0x7effc0f724b0>,149,17,[2 6],150,-1,371,-1,354
1,<environment.Job instance at 0x7effc0f726e0>,154,28,[4 5],155,-1,382,-1,354
1,<environment.Job instance at 0x7effc0f72370>,156,17,[3 5],157,-1,371,-1,354
1,<environment.Job instance at 0x7effc10416e0>,161,25,[10  1],162,-1,380,-1,355
1,<environment.Job instance at 0x7effc0f72870>,153,14,[ 5 10],154,-1,369,-1,355
1,<environment.Job instance at 0x7effc1041d70>,158,15,[5 8],159,-1,370,-1,355
1,<environment.Job instance at 0x7effc1041370>,160,13,[5 6],161,-1,368,-1,355
1,<environment.Job instance at 0x7effc0b9e3c0>,165,15,[8 1],166,-1,370,-1,355
1,<environment.Job instance at 0x7effc0b9e8c0>,168,18,[5 5],169,-1,373,-1,355
1,<environment.Job instance at 0x7effc1041c30>,162,12,[10  4],163,-1,367,-1,355
1,<environment.Job instance at 0x7effc1bdde60>,128,18,[13  5],129,-1,373,-1,355
1,<environment.Job instance at 0x7effc1fea910>,1,18,[11  2],2,-1,20,-1,2
1,<environment.Job instance at 0x7effca6daf00>,2,12,[ 5 13],3,-1,15,-1,3
1,<environment.Job instance at 0x7effc1ef9eb0>,3,24,[ 5 11],4,-1,28,-1,4
1,<environment.Job instance at 0x7effc0b9e0a0>,10,13,[11  2],11,-1,24,-1,11
1,<environment.Job instance at 0x7effc13f4f00>,17,16,[ 3 12],18,-1,46,-1,30
1,<environment.Job instance at 0x7effc18570f0>,36,25,[6 3],37,-1,136,-1,111
1,<environment.Job instance at 0x7effc1437be0>,43,2,[14  3],44,-1,124,-1,122
1,<environment.Job instance at 0x7effc0c911e0>,44,1,[14  5],45,-1,123,-1,122
1,<environment.Job instance at 0x7effc0c91b40>,53,1,[12  4],54,-1,146,-1,145
1,<environment.Job instance at 0x7effc175f140>,60,2,[ 2 12],61,-1,179,-1,177
1,<environment.Job instance at 0x7effc15f5910>,65,23,[8 4],66,-1,208,-1,185
1,<environment.Job instance at 0x7effc1998be0>,74,15,[11  1],75,-1,216,-1,201
1,<environment.Job instance at 0x7effc1c69cd0>,81,20,[ 5 13],82,-1,252,-1,232
1,<environment.Job instance at 0x7effc1a2fb90>,90,24,[7 2],91,-1,284,-1,260
1,<environment.Job instance at 0x7effc1a2ff50>,95,15,[ 1 12],96,-1,293,-1,278
1,<environment.Job instance at 0x7effc166cb90>,108,2,[ 1 13],109,-1,354,-1,352
1,<environment.Job instance at 0x7effc1993c30>,110,28,[ 2 14],111,-1,393,-1,365
1,<environment.Job instance at 0x7effcab8d050>,111,28,[5 1],112,-1,393,-1,365
1,<environment.Job instance at 0x7effc1c84140>,123,23,[7 4],124,-1,427,-1,404
1,<environment.Job instance at 0x7effc16b4690>,128,18,[13  5],129,-1,437,-1,419
1,<environment.Job instance at 0x7effc1934eb0>,133,3,[13  5],134,-1,447,-1,444
1,<environment.Job instance at 0x7effc07d14b0>,136,27,[5 2],137,-1,485,-1,458
1,<environment.Job instance at 0x7effc074c140>,137,14,[ 3 14],138,-1,472,-1,458
1,<environment.Job instance at 0x7effc19a3e10>,154,28,[4 5],155,-1,564,-1,536
1,<environment.Job instance at 0x7effc1bbd960>,157,2,[ 5 13],158,-1,539,-1,537
1,<environment.Job instance at 0x7effc13015f0>,161,25,[10  1],162,-1,581,-1,556
1,<environment.Job instance at 0x7effcab250f0>,0,16,[7 5],1,-1,17,-1,1
1,<environment.Job instance at 0x7effc0a377d0>,3,17,[5 9],4,-1,21,-1,4
1,<environment.Job instance at 0x7effc0a37870>,4,17,[2 5],5,-1,23,-1,6
1,<environment.Job instance at 0x7effc1857af0>,5,21,[9 3],6,-1,27,-1,6
1,<environment.Job instance at 0x7effc0a379b0>,7,25,[9 4],8,-1,33,-1,8
1,<environment.Job instance at 0x7effc0a37c80>,10,12,[10  1],11,-1,26,-1,14
1,<environment.Job instance at 0x7effc0a37fa0>,14,17,[1 9],15,-1,33,-1,16
1,<environment.Job instance at 0x7effc0a3d0f0>,16,18,[8 1],17,-1,37,-1,19
1,<environment.Job instance at 0x7effc0a3d2d0>,19,28,[6 1],20,-1,48,-1,20
1,<environment.Job instance at 0x7effc0a37e60>,13,12,[10  1],14,-1,32,-1,20
1,<environment.Job instance at 0x7effc0a37dc0>,12,16,[9 4],13,-1,36,-1,20
1,<environment.Job instance at 0x7effc0a3d3c0>,24,18,[5 5],25,-1,43,-1,25
1,<environment.Job instance at 0x7effc0a3d7d0>,26,17,[2 6],27,-1,45,-1,28
1,<environment.Job instance at 0x7effc0a3da50>,28,18,[5 3],29,-1,47,-1,29
1,<environment.Job instance at 0x7effc0a3deb0>,31,13,[10  4],32,-1,46,-1,33
1,<environment.Job instance at 0x7effc0a3ddc0>,32,15,[8 4],33,-1,48,-1,33
1,<environment.Job instance at 0x7effc0a3b1e0>,33,24,[5 3],34,-1,58,-1,34
1,<environment.Job instance at 0x7effc0a3b0f0>,34,15,[5 6],35,-1,52,-1,37
1,<environment.Job instance at 0x7effc0a3b280>,38,12,[9 3],39,-1,51,-1,39
1,<environment.Job instance at 0x7effc0a3b730>,41,28,[9 4],42,-1,70,-1,42
1,<environment.Job instance at 0x7effc0a3bbe0>,44,12,[9 1],45,-1,57,-1,45
1,<environment.Job instance at 0x7effc0a3baa0>,45,15,[3 9],46,-1,61,-1,46
1,<environment.Job instance at 0x7effc0a3bd20>,47,17,[1 9],48,-1,65,-1,48
1,<environment.Job instance at 0x7effc0a3be10>,49,18,[7 5],50,-1,68,-1,50
1,<environment.Job instance at 0x7effc0a3bfa0>,50,17,[10  1],51,-1,68,-1,51
1,<environment.Job instance at 0x7effc0a320a0>,51,14,[5 8],52,-1,66,-1,52
1,<environment.Job instance at 0x7effc0a32140>,52,13,[7 2],53,-1,66,-1,53
1,<environment.Job instance at 0x7effc0a32280>,54,17,[7 2],55,-1,72,-1,55
1,<environment.Job instance at 0x7effc0a322d0>,56,21,[5 5],57,-1,78,-1,57
1,<environment.Job instance at 0x7effc0a327d0>,59,15,[10  2],60,-1,79,-1,64
1,<environment.Job instance at 0x7effc0a32e10>,64,16,[7 4],65,-1,81,-1,65
1,<environment.Job instance at 0x7effc0b5f1e0>,68,17,[9 5],69,-1,86,-1,69
1,<environment.Job instance at 0x7effc0b5f500>,71,18,[4 7],72,-1,90,-1,72
1,<environment.Job instance at 0x7effc0b5f3c0>,73,17,[9 1],74,-1,104,-1,87
1,<environment.Job instance at 0x7effc0b5feb0>,84,15,[10  2],85,-1,119,-1,104
1,<environment.Job instance at 0x7effc0b5f730>,74,22,[4 9],75,-1,169,-1,147
1,<environment.Job instance at 0x7effc0b5fdc0>,85,25,[1 6],86,-1,172,-1,147
1,<environment.Job instance at 0x7effc0b58cd0>,99,2,[1 9],100,-1,150,-1,148
1,<environment.Job instance at 0x7effc0b58910>,97,12,[5 9],98,-1,160,-1,148
1,<environment.Job instance at 0x7effc0b58dc0>,101,16,[3 9],102,-1,164,-1,148
1,<environment.Job instance at 0x7effc0b58eb0>,102,1,[5 9],103,-1,149,-1,148
1,<environment.Job instance at 0x7effc0b37230>,105,17,[10  3],106,-1,165,-1,148
1,<environment.Job instance at 0x7effc0b58b40>,104,13,[2 7],105,-1,161,-1,148
1,<environment.Job instance at 0x7effc0b37370>,107,24,[5 9],108,-1,174,-1,150
1,<environment.Job instance at 0x7effc0b372d0>,106,18,[6 4],107,-1,168,-1,150
1,<environment.Job instance at 0x7effc0b37410>,108,14,[6 4],109,-1,164,-1,150
1,<environment.Job instance at 0x7effc0b375f0>,111,28,[3 6],112,-1,178,-1,150
1,<environment.Job instance at 0x7effc0b37690>,112,14,[ 4 10],113,-1,164,-1,150
1,<environment.Job instance at 0x7effc0b58d20>,100,12,[5 6],101,-1,162,-1,150
1,<environment.Job instance at 0x7effc0a562d0>,115,16,[7 3],116,-1,166,-1,150
1,<environment.Job instance at 0x7effc0a56b90>,116,12,[8 4],117,-1,162,-1,150
1,<environment.Job instance at 0x7effc0a566e0>,117,16,[1 8],118,-1,166,-1,150
1,<environment.Job instance at 0x7effc0a56190>,119,26,[2 6],120,-1,177,-1,151
1,<environment.Job instance at 0x7effc0a56280>,120,20,[9 3],121,-1,171,-1,151
1,<environment.Job instance at 0x7effc0a561e0>,121,15,[8 4],122,-1,166,-1,151
1,<environment.Job instance at 0x7effc0a56500>,122,14,[9 2],123,-1,165,-1,151
1,<environment.Job instance at 0x7effc0a56370>,123,16,[2 6],124,-1,167,-1,151
1,<environment.Job instance at 0x7effc1b16f00>,125,17,[5 3],126,-1,168,-1,151
1,<environment.Job instance at 0x7effc0b587d0>,95,24,[8 3],96,-1,190,-1,166
1,<environment.Job instance at 0x7effc0a32d20>,7,25,[9 4],8,-1,42,-1,17
1,<environment.Job instance at 0x7effc119e2d0>,19,28,[6 1],20,-1,76,-1,48
1,<environment.Job instance at 0x7effc167a9b0>,22,18,[ 2 12],23,-1,68,-1,50
1,<environment.Job instance at 0x7effc1761fa0>,33,24,[5 3],34,-1,127,-1,103
1,<environment.Job instance at 0x7effc167c820>,37,2,[11  4],38,-1,109,-1,107
1,<environment.Job instance at 0x7effc0a23af0>,41,28,[9 4],42,-1,163,-1,135
1,<environment.Job instance at 0x7effc0a37640>,43,16,[ 1 12],44,-1,151,-1,135
1,<environment.Job instance at 0x7effc1301870>,48,19,[ 3 11],49,-1,168,-1,149
1,<environment.Job instance at 0x7effc1934eb0>,67,13,[14  4],68,-1,247,-1,234
1,<environment.Job instance at 0x7effc14dbd20>,83,2,[13  2],84,-1,290,-1,288
1,<environment.Job instance at 0x7effc1f5b2d0>,85,25,[1 6],86,-1,325,-1,300
1,<environment.Job instance at 0x7effc19ab0a0>,90,27,[11  2],91,-1,334,-1,307
1,<environment.Job instance at 0x7effc166cbe0>,95,24,[8 3],96,-1,340,-1,316
1,<environment.Job instance at 0x7effc1a2fc30>,107,24,[5 9],108,-1,399,-1,375
1,<environment.Job instance at 0x7effc1a2f8c0>,111,28,[3 6],112,-1,406,-1,378
1,<environment.Job instance at 0x7effc1c69d20>,119,26,[2 6],120,-1,439,-1,413
1,<environment.Job instance at 0x7effc072caa0>,127,1,[ 1 13],128,-1,447,-1,446
1,<environment.Job instance at 0x7effc072c730>,128,26,[8 2],129,-1,472,-1,446
1,<environment.Job instance at 0x7effc1998320>,135,25,[ 3 14],136,-1,502,-1,477
1,<environment.Job instance at 0x7effc131e1e0>,141,3,[ 4 13],142,-1,505,-1,502
1,<environment.Job instance at 0x7effc0eef910>,144,27,[13  3],145,-1,534,-1,507
1,<environment.Job instance at 0x7effc18574b0>,164,27,[6 1],165,-1,636,-1,609
1,<environment.Job instance at 0x7effc1857aa0>,166,17,[ 5 11],167,-1,626,-1,609
1,<environment.Job instance at 0x7effcac75f50>,15,16,[7 3],16,-1,39,-1,23
1,<environment.Job instance at 0x7effca75d7d0>,21,16,[ 5 11],22,-1,47,-1,31
1,<environment.Job instance at 0x7effcac75d70>,20,13,[12  1],21,-1,44,-1,31
1,<environment.Job instance at 0x7effca6a87d0>,8,18,[5 9],9,-1,49,-1,31
1,<environment.Job instance at 0x7effcac75960>,17,13,[10  4],18,-1,44,-1,31
1,<environment.Job instance at 0x7effca75d0a0>,22,16,[5 4],23,-1,47,-1,31
1,<environment.Job instance at 0x7effca75d460>,25,27,[4 5],26,-1,62,-1,35
1,<environment.Job instance at 0x7effc413eb40>,30,17,[9 2],31,-1,52,-1,35
1,<environment.Job instance at 0x7effc413ef00>,32,14,[7 3],33,-1,49,-1,35
1,<environment.Job instance at 0x7effca63c960>,36,25,[7 3],37,-1,87,-1,62
1,<environment.Job instance at 0x7effc413e820>,27,18,[1 6],28,-1,80,-1,62
1,<environment.Job instance at 0x7effc1c4f6e0>,47,21,[9 4],48,-1,84,-1,63
1,<environment.Job instance at 0x7effc1c9b370>,46,16,[9 2],47,-1,80,-1,64
1,<environment.Job instance at 0x7effc1d7eeb0>,48,21,[5 1],49,-1,85,-1,64
1,<environment.Job instance at 0x7effc1c4fe10>,45,14,[5 7],46,-1,78,-1,64
1,<environment.Job instance at 0x7effc1e71a00>,52,12,[1 9],53,-1,76,-1,64
1,<environment.Job instance at 0x7effc1e71fa0>,55,16,[4 9],56,-1,81,-1,65
1,<environment.Job instance at 0x7effc1e71aa0>,56,18,[5 5],57,-1,83,-1,65
1,<environment.Job instance at 0x7effc1e71230>,57,3,[ 1 10],58,-1,68,-1,65
1,<environment.Job instance at 0x7effc0dc6780>,59,20,[5 9],60,-1,85,-1,65
1,<environment.Job instance at 0x7effc0dc6a50>,60,17,[ 5 10],61,-1,82,-1,65
1,<environment.Job instance at 0x7effc0dc62d0>,61,14,[10  1],62,-1,79,-1,65
1,<environment.Job instance at 0x7effca63c0f0>,40,26,[6 4],41,-1,91,-1,65
1,<environment.Job instance at 0x7effc0dc6d20>,62,18,[3 8],63,-1,83,-1,65
1,<environment.Job instance at 0x7effc20e01e0>,65,3,[1 9],66,-1,70,-1,67
1,<environment.Job instance at 0x7effc20e0f00>,68,12,[3 9],69,-1,81,-1,69
1,<environment.Job instance at 0x7effc20e0820>,67,3,[1 6],68,-1,72,-1,69
1,<environment.Job instance at 0x7effc200e730>,72,18,[3 7],73,-1,94,-1,76
1,<environment.Job instance at 0x7effc1993690>,75,13,[9 1],76,-1,91,-1,78
1,<environment.Job instance at 0x7effc1102c80>,80,25,[5 3],81,-1,110,-1,85
1,<environment.Job instance at 0x7effc1ba47d0>,81,16,[11  2],82,-1,101,-1,85
1,<environment.Job instance at 0x7effc0d36a00>,77,15,[3 6],78,-1,102,-1,87
1,<environment.Job instance at 0x7effcab25d20>,83,13,[5 6],84,-1,100,-1,87
1,<environment.Job instance at 0x7effc1def690>,86,13,[8 1],87,-1,100,-1,87
1,<environment.Job instance at 0x7effc10ede60>,88,16,[10  3],89,-1,105,-1,89
1,<environment.Job instance at 0x7effc10edd70>,92,23,[3 7],93,-1,116,-1,93
1,<environment.Job instance at 0x7effc10ed140>,94,17,[2 7],95,-1,112,-1,95
1,<environment.Job instance at 0x7effc413e7d0>,31,2,[ 5 10],32,-1,101,-1,99
1,<environment.Job instance at 0x7effc10ed3c0>,89,28,[3 9],90,-1,128,-1,100
1,<environment.Job instance at 0x7effc10ed9b0>,95,14,[7 2],96,-1,114,-1,100
1,<environment.Job instance at 0x7effc20e9960>,97,16,[5 4],98,-1,116,-1,100
1,<environment.Job instance at 0x7effc20e9050>,99,18,[5 1],100,-1,118,-1,100
1,<environment.Job instance at 0x7effc20e9410>,100,16,[1 7],101,-1,118,-1,102
1,<environment.Job instance at 0x7effc13d55a0>,102,17,[6 4],103,-1,126,-1,109
1,<environment.Job instance at 0x7effc13d5460>,106,15,[5 6],107,-1,124,-1,109
1,<environment.Job instance at 0x7effc13d5690>,107,16,[11  1],108,-1,125,-1,109
1,<environment.Job instance at 0x7effc20e9d20>,98,17,[6 5],99,-1,129,-1,112
1,<environment.Job instance at 0x7effc20e98c0>,101,12,[2 6],102,-1,124,-1,112
1,<environment.Job instance at 0x7effc13d5dc0>,110,15,[1 8],111,-1,127,-1,112
1,<environment.Job instance at 0x7effc13d5320>,109,12,[3 9],110,-1,125,-1,113
1,<environment.Job instance at 0x7effc13d5c80>,114,14,[ 3 10],115,-1,129,-1,115
1,<environment.Job instance at 0x7effc0ec2050>,125,16,[10  3],126,-1,145,-1,129
1,<environment.Job instance at 0x7effc0ec2280>,129,17,[9 4],130,-1,147,-1,130
1,<environment.Job instance at 0x7effc13d5370>,112,18,[2 5],113,-1,152,-1,134
1,<environment.Job instance at 0x7effc1777870>,133,18,[4 5],134,-1,157,-1,139
1,<environment.Job instance at 0x7effc0a91b40>,1,24,[14  3],2,-1,26,-1,2
1,<environment.Job instance at 0x7effc413e9b0>,3,24,[10  2],4,-1,28,-1,4
1,<environment.Job instance at 0x7effc13d5140>,20,13,[12  1],21,-1,45,-1,32
1,<environment.Job instance at 0x7effc13d52d0>,21,16,[ 5 11],22,-1,48,-1,32
1,<environment.Job instance at 0x7effc16fbf00>,25,27,[4 5],26,-1,78,-1,51
1,<environment.Job instance at 0x7effc16fb550>,26,1,[12  2],27,-1,52,-1,51
1,<environment.Job instance at 0x7effc1fef230>,36,25,[7 3],37,-1,107,-1,82
1,<environment.Job instance at 0x7effc10ec320>,40,26,[6 4],41,-1,117,-1,91
1,<environment.Job instance at 0x7effc1a2fa50>,74,1,[13  5],75,-1,194,-1,193
1,<environment.Job instance at 0x7effc1993d70>,80,25,[5 3],81,-1,251,-1,226
1,<environment.Job instance at 0x7effc19ab3c0>,81,16,[11  2],82,-1,242,-1,226
1,<environment.Job instance at 0x7effc0745d20>,89,28,[3 9],90,-1,290,-1,262
1,<environment.Job instance at 0x7effc16b4690>,92,23,[3 7],93,-1,287,-1,264
1,<environment.Job instance at 0x7effc07d1230>,96,3,[ 5 14],97,-1,268,-1,265
1,<environment.Job instance at 0x7effc20dceb0>,107,16,[11  1],108,-1,317,-1,301
1,<environment.Job instance at 0x7effc1301870>,117,16,[ 5 13],118,-1,363,-1,347
1,<environment.Job instance at 0x7effc0a37a50>,119,2,[13  4],120,-1,351,-1,349
1,<environment.Job instance at 0x7effc16b6f50>,123,20,[ 5 12],124,-1,371,-1,351
1,<environment.Job instance at 0x7effc1761fa0>,124,2,[ 5 11],125,-1,353,-1,351
1,<environment.Job instance at 0x7effc173a5a0>,131,2,[ 5 11],132,-1,373,-1,371
1,<environment.Job instance at 0x7effca6ca0f0>,139,13,[ 4 14],140,-1,406,-1,393
1,<environment.Job instance at 0x7effc0b5f9b0>,146,16,[13  1],147,-1,427,-1,411
1,<environment.Job instance at 0x7effc0b7fcd0>,156,27,[2 9],157,-1,476,-1,449
1,<environment.Job instance at 0x7effc157a7d0>,163,14,[14  4],164,-1,489,-1,475
1,<environment.Job instance at 0x7effc19a5410>,165,3,[ 1 13],166,-1,478,-1,475
1,<environment.Job instance at 0x7effc0b9e230>,166,2,[14  2],167,-1,477,-1,475
1,<environment.Job instance at 0x7effc0b9e7d0>,167,15,[ 5 12],168,-1,490,-1,475
1,<environment.Job instance at 0x7effc0f76960>,1,27,[8 5],2,-1,30,-1,3
1,<environment.Job instance at 0x7effc0f76dc0>,7,18,[1 9],8,-1,27,-1,9
1,<environment.Job instance at 0x7effc0f76730>,8,16,[13  2],9,-1,25,-1,9
1,<environment.Job instance at 0x7effc0f76fa0>,12,18,[10  5],13,-1,32,-1,14
1,<environment.Job instance at 0x7effc0f76a50>,14,17,[10  5],15,-1,32,-1,15
1,<environment.Job instance at 0x7effc0f761e0>,15,18,[5 6],16,-1,34,-1,16
1,<environment.Job instance at 0x7effc0f710a0>,17,15,[ 4 10],18,-1,33,-1,18
1,<environment.Job instance at 0x7effc0f76370>,13,26,[7 1],14,-1,44,-1,18
1,<environment.Job instance at 0x7effc0f71dc0>,22,18,[9 1],23,-1,42,-1,24
1,<environment.Job instance at 0x7effc0f71960>,23,13,[3 9],24,-1,38,-1,25
1,<environment.Job instance at 0x7effc0f71550>,29,12,[5 8],30,-1,43,-1,31
1,<environment.Job instance at 0x7effc11e2500>,32,18,[1 9],33,-1,51,-1,33
1,<environment.Job instance at 0x7effc11e23c0>,34,18,[7 1],35,-1,53,-1,35
1,<environment.Job instance at 0x7effc11e24b0>,38,15,[3 8],39,-1,54,-1,39
1,<environment.Job instance at 0x7effc11e2eb0>,39,25,[3 6],40,-1,65,-1,40
1,<environment.Job instance at 0x7effc11e20a0>,40,13,[5 8],41,-1,54,-1,41
1,<environment.Job instance at 0x7effc0fcbaa0>,44,17,[8 5],45,-1,63,-1,46
1,<environment.Job instance at 0x7effc0fcb820>,46,16,[1 5],47,-1,63,-1,47
1,<environment.Job instance at 0x7effc0fcbc30>,48,13,[10  4],49,-1,62,-1,49
1,<environment.Job instance at 0x7effc0fcb500>,49,19,[2 5],50,-1,69,-1,50
1,<environment.Job instance at 0x7effc0fcb730>,54,18,[ 4 10],55,-1,73,-1,55
1,<environment.Job instance at 0x7effc0fcbcd0>,56,15,[ 3 10],57,-1,72,-1,57
1,<environment.Job instance at 0x7effc0fa40a0>,61,12,[5 8],62,-1,74,-1,62
1,<environment.Job instance at 0x7effc0fa43c0>,63,18,[9 2],64,-1,82,-1,64
1,<environment.Job instance at 0x7effc0fa45a0>,64,15,[6 2],65,-1,80,-1,65
1,<environment.Job instance at 0x7effc0fa4050>,66,16,[5 9],67,-1,83,-1,67
1,<environment.Job instance at 0x7effc0fa46e0>,68,24,[5 6],69,-1,93,-1,69
1,<environment.Job instance at 0x7effc2073e60>,71,17,[5 8],72,-1,89,-1,72
1,<environment.Job instance at 0x7effc2073910>,78,12,[10  3],79,-1,95,-1,83
1,<environment.Job instance at 0x7effc2073b40>,79,13,[10  4],80,-1,96,-1,83
1,<environment.Job instance at 0x7effc11e2d20>,41,16,[ 5 12],42,-1,99,-1,83
1,<environment.Job instance at 0x7effc2073550>,72,14,[14  5],73,-1,97,-1,83
1,<environment.Job instance at 0x7effc2073500>,80,20,[ 4 10],81,-1,104,-1,84
1,<environment.Job instance at 0x7effc11e2190>,45,17,[1 7],46,-1,101,-1,84
1,<environment.Job instance at 0x7effc2073320>,83,14,[ 4 10],84,-1,103,-1,89
1,<environment.Job instance at 0x7effc0750910>,86,24,[4 5],87,-1,113,-1,89
1,<environment.Job instance at 0x7effc0750320>,87,24,[4 8],88,-1,126,-1,102
1,<environment.Job instance at 0x7effc07d07d0>,97,18,[6 1],98,-1,120,-1,102
1,<environment.Job instance at 0x7effc07d0230>,96,16,[4 9],97,-1,118,-1,102
1,<environment.Job instance at 0x7effcab9e550>,102,23,[6 2],103,-1,126,-1,103
1,<environment.Job instance at 0x7effc20730a0>,74,16,[8 2],75,-1,123,-1,107
1,<environment.Job instance at 0x7effc07d0820>,99,15,[6 4],100,-1,129,-1,114
1,<environment.Job instance at 0x7effc1c82be0>,108,13,[4 8],109,-1,131,-1,118
1,<environment.Job instance at 0x7effca6cec30>,114,14,[ 5 10],115,-1,134,-1,120
1,<environment.Job instance at 0x7effca6ce870>,115,28,[ 4 12],116,-1,149,-1,121
1,<environment.Job instance at 0x7effca6cee60>,116,16,[4 8],117,-1,137,-1,121
1,<environment.Job instance at 0x7effc0df7050>,148,18,[10  4],149,-1,410,-1,392
1,<environment.Job instance at 0x7effc0df7af0>,150,25,[5 5],151,-1,417,-1,392
1,<environment.Job instance at 0x7effc1e1bd20>,161,17,[ 2 10],162,-1,409,-1,392
1,<environment.Job instance at 0x7effc1e1ba50>,162,16,[2 8],163,-1,408,-1,392
1,<environment.Job instance at 0x7effc1629e60>,166,15,[5 9],167,-1,407,-1,392
1,<environment.Job instance at 0x7effc0f71140>,0,2,[14  4],1,-1,3,-1,1
1,<environment.Job instance at 0x7effc0f714b0>,1,27,[8 5],2,-1,29,-1,2
1,<environment.Job instance at 0x7effc11e2780>,4,16,[11  4],5,-1,21,-1,5
1,<environment.Job instance at 0x7effc0fa42d0>,8,16,[13  2],9,-1,25,-1,9
1,<environment.Job instance at 0x7effc0fa4410>,11,14,[ 2 12],12,-1,26,-1,12
1,<environment.Job instance at 0x7effc2073a00>,13,26,[7 1],14,-1,46,-1,20
1,<environment.Job instance at 0x7effc0f76140>,39,25,[3 6],40,-1,134,-1,109
1,<environment.Job instance at 0x7effc1bf06e0>,41,16,[ 5 12],42,-1,125,-1,109
1,<environment.Job instance at 0x7effca6bfe60>,43,17,[13  5],44,-1,128,-1,111
1,<environment.Job instance at 0x7effca9ea0f0>,55,2,[ 3 11],56,-1,158,-1,156
1,<environment.Job instance at 0x7effc1ca7780>,62,3,[ 4 11],63,-1,185,-1,182
1,<environment.Job instance at 0x7effc10330f0>,68,24,[5 6],69,-1,236,-1,212
1,<environment.Job instance at 0x7effc1bb9410>,70,3,[ 3 12],71,-1,215,-1,212
1,<environment.Job instance at 0x7effc1a72410>,72,14,[14  5],73,-1,238,-1,224
1,<environment.Job instance at 0x7effc1a90b90>,86,24,[4 5],87,-1,309,-1,285
1,<environment.Job instance at 0x7effc1cb5c80>,87,24,[4 8],88,-1,309,-1,285
1,<environment.Job instance at 0x7effc0ecd5a0>,102,23,[6 2],103,-1,344,-1,321
1,<environment.Job instance at 0x7effc18f0870>,104,3,[ 1 12],105,-1,324,-1,321
1,<environment.Job instance at 0x7effc18f0e10>,105,14,[12  1],106,-1,335,-1,321
1,<environment.Job instance at 0x7effc15fa230>,113,1,[11  3],114,-1,344,-1,343
1,<environment.Job instance at 0x7effc18105f0>,115,28,[ 4 12],116,-1,374,-1,346
1,<environment.Job instance at 0x7effc0ac4f00>,119,1,[ 4 13],120,-1,375,-1,374
1,<environment.Job instance at 0x7effc0935fa0>,123,14,[ 2 11],124,-1,402,-1,388
1,<environment.Job instance at 0x7effc173dd70>,135,24,[5 2],136,-1,468,-1,444
1,<environment.Job instance at 0x7effc09cd640>,140,25,[6 2],141,-1,483,-1,458
1,<environment.Job instance at 0x7effc19b4e10>,149,13,[ 1 11],150,-1,491,-1,478
1,<environment.Job instance at 0x7effc17e7320>,150,25,[5 5],151,-1,515,-1,490
1,<environment.Job instance at 0x7effc1639eb0>,153,3,[ 4 11],154,-1,494,-1,491
1,<environment.Job instance at 0x7effc1ad60a0>,168,16,[14  4],169,-1,573,-1,557
1,<environment.Job instance at 0x7effc1dfca00>,0,15,[8 4],1,-1,17,-1,2
1,<environment.Job instance at 0x7effc0d431e0>,4,19,[ 5 10],5,-1,24,-1,5
1,<environment.Job instance at 0x7effc0d43cd0>,6,15,[3 9],7,-1,22,-1,7
1,<environment.Job instance at 0x7effc0d43640>,7,27,[8 5],8,-1,35,-1,8
1,<environment.Job instance at 0x7effc2097af0>,10,13,[8 3],11,-1,24,-1,11
1,<environment.Job instance at 0x7effc2097690>,15,15,[10  1],16,-1,33,-1,18
1,<environment.Job instance at 0x7effc2097d70>,20,20,[8 5],21,-1,41,-1,21
1,<environment.Job instance at 0x7effc1edea50>,24,16,[5 8],25,-1,41,-1,25
1,<environment.Job instance at 0x7effc1ede230>,25,25,[4 5],26,-1,51,-1,26
1,<environment.Job instance at 0x7effc1ede320>,30,18,[3 5],31,-1,49,-1,31
1,<environment.Job instance at 0x7effc10c1b90>,31,15,[3 7],32,-1,47,-1,32
1,<environment.Job instance at 0x7effc10c1fa0>,41,13,[3 5],42,-1,55,-1,42
1,<environment.Job instance at 0x7effc1fc35a0>,42,18,[4 8],43,-1,61,-1,43
1,<environment.Job instance at 0x7effc1fc3c30>,43,15,[ 2 10],44,-1,59,-1,44
1,<environment.Job instance at 0x7effc1fc3050>,46,13,[6 4],47,-1,60,-1,47
1,<environment.Job instance at 0x7effc1fc3cd0>,47,26,[ 3 10],48,-1,74,-1,48
1,<environment.Job instance at 0x7effc1fc3dc0>,48,12,[10  4],49,-1,61,-1,49
1,<environment.Job instance at 0x7effc1bdf960>,52,1,[2 6],53,-1,54,-1,53
1,<environment.Job instance at 0x7effc1bdff50>,54,1,[7 3],55,-1,56,-1,55
1,<environment.Job instance at 0x7effc0a33370>,60,12,[2 5],61,-1,73,-1,61
1,<environment.Job instance at 0x7effc0a331e0>,61,17,[7 4],62,-1,79,-1,62
1,<environment.Job instance at 0x7effc0a334b0>,63,14,[ 5 10],64,-1,78,-1,64
1,<environment.Job instance at 0x7effc0a33870>,65,13,[7 4],66,-1,79,-1,66
1,<environment.Job instance at 0x7effc0a332d0>,66,16,[3 8],67,-1,83,-1,67
1,<environment.Job instance at 0x7effc0d3bc80>,70,15,[5 5],71,-1,86,-1,71
1,<environment.Job instance at 0x7effc08b6c30>,72,17,[5 7],73,-1,90,-1,73
1,<environment.Job instance at 0x7effc08b6870>,78,12,[7 5],79,-1,91,-1,79
1,<environment.Job instance at 0x7effc073ddc0>,80,18,[9 3],81,-1,99,-1,81
1,<environment.Job instance at 0x7effc073d5a0>,81,17,[9 4],82,-1,99,-1,82
1,<environment.Job instance at 0x7effc0d5a9b0>,86,17,[4 8],87,-1,104,-1,87
1,<environment.Job instance at 0x7effc0d5ac80>,87,14,[5 6],88,-1,102,-1,88
1,<environment.Job instance at 0x7effc0d5acd0>,88,16,[8 4],89,-1,105,-1,89
1,<environment.Job instance at 0x7effc0d5a550>,89,17,[5 6],90,-1,107,-1,90
1,<environment.Job instance at 0x7effc207d870>,90,15,[3 7],91,-1,106,-1,91
1,<environment.Job instance at 0x7effc09079b0>,94,13,[10  1],95,-1,114,-1,101
1,<environment.Job instance at 0x7effc0db7c30>,101,18,[7 1],102,-1,120,-1,102
1,<environment.Job instance at 0x7effc0db7550>,102,15,[6 2],103,-1,129,-1,114
1,<environment.Job instance at 0x7effc15af5f0>,110,14,[8 2],111,-1,128,-1,114
1,<environment.Job instance at 0x7effc20fa820>,111,26,[7 2],112,-1,140,-1,114
1,<environment.Job instance at 0x7effca6275a0>,105,16,[3 5],106,-1,130,-1,114
1,<environment.Job instance at 0x7effc1fabeb0>,112,17,[1 5],113,-1,132,-1,115
1,<environment.Job instance at 0x7effc10c1870>,7,27,[8 5],8,-1,43,-1,16
1,<environment.Job instance at 0x7effc10c1d20>,9,3,[ 1 12],10,-1,19,-1,16
1,<environment.Job instance at 0x7effc1bdf6e0>,13,17,[13  3],14,-1,36,-1,19
1,<environment.Job instance at 0x7effc1bdf140>,14,3,[13  1],15,-1,22,-1,19
1,<environment.Job instance at 0x7effc0907690>,25,25,[4 5],26,-1,66,-1,41
1,<environment.Job instance at 0x7effc0a830f0>,28,1,[ 4 14],29,-1,47,-1,46
1,<environment.Job instance at 0x7effc20304b0>,40,2,[13  2],41,-1,76,-1,74
1,<environment.Job instance at 0x7effc12e8af0>,44,1,[12  5],45,-1,86,-1,85
1,<environment.Job instance at 0x7effc12e8050>,47,26,[ 3 10],48,-1,129,-1,103
1,<environment.Job instance at 0x7effc178fc80>,51,3,[12  2],52,-1,121,-1,118
1,<environment.Job instance at 0x7effc12ed820>,64,3,[14  3],65,-1,144,-1,141
1,<environment.Job instance at 0x7effc18106e0>,76,1,[11  3],77,-1,177,-1,176
1,<environment.Job instance at 0x7effc1f2c410>,83,14,[14  1],84,-1,215,-1,201
1,<environment.Job instance at 0x7effc15636e0>,92,17,[ 5 14],93,-1,259,-1,242
1,<environment.Job instance at 0x7effc1c9d410>,103,15,[ 2 12],104,-1,293,-1,278
1,<environment.Job instance at 0x7effc1033870>,108,2,[13  1],109,-1,311,-1,309
1,<environment.Job instance at 0x7effc17b60a0>,111,26,[7 2],112,-1,339,-1,313
1,<environment.Job instance at 0x7effc18e0c30>,121,23,[5 9],122,-1,385,-1,362
1,<environment.Job instance at 0x7effc18e0550>,123,3,[ 1 14],124,-1,365,-1,362
1,<environment.Job instance at 0x7effc1a70500>,126,1,[ 3 13],127,-1,364,-1,363
1,<environment.Job instance at 0x7effc2073d70>,138,26,[2 5],139,-1,437,-1,411
1,<environment.Job instance at 0x7effc0d5a500>,146,24,[2 9],147,-1,478,-1,454
1,<environment.Job instance at 0x7effc0d5ad20>,147,12,[ 2 12],148,-1,466,-1,454
1,<environment.Job instance at 0x7effc0d5a0a0>,148,14,[13  4],149,-1,468,-1,454
1,<environment.Job instance at 0x7effc0d5ae60>,149,20,[ 3 11],150,-1,474,-1,454
1,<environment.Job instance at 0x7effc19ce960>,166,1,[ 3 11],167,-1,520,-1,519
1,<environment.Job instance at 0x7effc074a460>,1,23,[1 8],2,-1,25,-1,2
1,<environment.Job instance at 0x7effca6be5f0>,3,16,[ 5 10],4,-1,20,-1,4
1,<environment.Job instance at 0x7effca6be370>,4,17,[3 5],5,-1,22,-1,5
1,<environment.Job instance at 0x7effca6be320>,5,15,[ 1 10],6,-1,21,-1,6
1,<environment.Job instance at 0x7effc09e9c30>,16,25,[8 1],17,-1,43,-1,18
1,<environment.Job instance at 0x7effc18b03c0>,23,16,[9 5],24,-1,40,-1,24
1,<environment.Job instance at 0x7effc18b0500>,24,28,[7 4],25,-1,53,-1,25
1,<environment.Job instance at 0x7effc18b0320>,25,20,[7 2],26,-1,46,-1,26
1,<environment.Job instance at 0x7effc18b05f0>,26,14,[10  3],27,-1,41,-1,27
1,<environment.Job instance at 0x7effc18b0690>,27,17,[5 6],28,-1,45,-1,28
1,<environment.Job instance at 0x7effc18b07d0>,29,17,[5 2],30,-1,47,-1,30
1,<environment.Job instance at 0x7effc09e9640>,17,18,[ 1 10],18,-1,52,-1,34
1,<environment.Job instance at 0x7effc18b09b0>,30,14,[6 1],31,-1,49,-1,35
1,<environment.Job instance at 0x7effc18b0e10>,34,19,[1 8],35,-1,55,-1,36
1,<environment.Job instance at 0x7effc18b0f50>,36,17,[8 4],37,-1,56,-1,39
1,<environment.Job instance at 0x7effc18a8050>,38,12,[ 1 10],39,-1,53,-1,41
1,<environment.Job instance at 0x7effc18b0c80>,33,15,[2 7],34,-1,58,-1,43
1,<environment.Job instance at 0x7effc18a85a0>,43,20,[4 5],44,-1,65,-1,45
1,<environment.Job instance at 0x7effc18a80a0>,40,13,[8 4],41,-1,58,-1,45
1,<environment.Job instance at 0x7effc18a86e0>,45,20,[5 5],46,-1,66,-1,46
1,<environment.Job instance at 0x7effc18a8870>,46,18,[7 3],47,-1,65,-1,47
1,<environment.Job instance at 0x7effc18a8910>,48,18,[1 5],49,-1,67,-1,49
1,<environment.Job instance at 0x7effc18a8a50>,50,16,[ 2 10],51,-1,68,-1,52
1,<environment.Job instance at 0x7effc18a8c30>,51,18,[3 9],52,-1,71,-1,53
1,<environment.Job instance at 0x7effca6b46e0>,63,26,[10  4],64,-1,92,-1,66
1,<environment.Job instance at 0x7effca6b4870>,62,12,[12  2],63,-1,85,-1,73
1,<environment.Job instance at 0x7effca6b4730>,61,25,[1 6],62,-1,98,-1,73
1,<environment.Job instance at 0x7effca6b4aa0>,65,24,[4 7],66,-1,97,-1,73
1,<environment.Job instance at 0x7effca6b45f0>,67,15,[1 8],68,-1,88,-1,73
1,<environment.Job instance at 0x7effca6b4c30>,69,15,[9 1],70,-1,88,-1,73
1,<environment.Job instance at 0x7effca6b4cd0>,70,12,[10  4],71,-1,85,-1,73
1,<environment.Job instance at 0x7effca6b49b0>,66,12,[6 2],67,-1,85,-1,73
1,<environment.Job instance at 0x7effca6b4d70>,71,15,[10  4],72,-1,88,-1,73
1,<environment.Job instance at 0x7effc18b0a50>,31,17,[9 3],32,-1,92,-1,75
1,<environment.Job instance at 0x7effca6b4910>,64,17,[5 5],65,-1,92,-1,75
1,<environment.Job instance at 0x7effc2001a50>,76,14,[9 2],77,-1,92,-1,78
1,<environment.Job instance at 0x7effc20327d0>,77,28,[7 2],78,-1,106,-1,78
1,<environment.Job instance at 0x7effca6d8730>,82,26,[9 1],83,-1,118,-1,92
1,<environment.Job instance at 0x7effca6d8370>,87,20,[10  2],88,-1,112,-1,92
1,<environment.Job instance at 0x7effca6d8e10>,88,14,[1 9],89,-1,106,-1,92
1,<environment.Job instance at 0x7effca6d8140>,86,3,[ 2 14],87,-1,95,-1,92
1,<environment.Job instance at 0x7effca6b4500>,59,15,[4 6],60,-1,107,-1,92
1,<environment.Job instance at 0x7effca6d8c30>,85,17,[9 3],86,-1,111,-1,94
1,<environment.Job instance at 0x7effc13b05f0>,91,13,[7 4],92,-1,110,-1,97
1,<environment.Job instance at 0x7effc1f03fa0>,97,27,[9 4],98,-1,125,-1,98
1,<environment.Job instance at 0x7effc1a61050>,99,15,[5 5],100,-1,115,-1,100
1,<environment.Job instance at 0x7effc1f27960>,100,15,[2 8],101,-1,116,-1,101
1,<environment.Job instance at 0x7effc193da50>,79,27,[ 3 10],80,-1,134,-1,107
1,<environment.Job instance at 0x7effc0e83140>,106,14,[2 6],107,-1,124,-1,110
1,<environment.Job instance at 0x7effc0c76c30>,105,15,[8 4],106,-1,126,-1,111
1,<environment.Job instance at 0x7effc0e83500>,108,17,[13  5],109,-1,128,-1,111
1,<environment.Job instance at 0x7effc0c761e0>,104,15,[10  1],105,-1,127,-1,112
1,<environment.Job instance at 0x7effc0e83320>,109,17,[5 4],110,-1,129,-1,112
1,<environment.Job instance at 0x7effc0e83640>,111,12,[2 8],112,-1,124,-1,112
1,<environment.Job instance at 0x7effc0e8da00>,112,15,[10  3],113,-1,128,-1,113
1,<environment.Job instance at 0x7effc0e8dfa0>,114,18,[9 3],115,-1,135,-1,117
1,<environment.Job instance at 0x7effc0e8d0a0>,115,16,[3 8],116,-1,133,-1,117
1,<environment.Job instance at 0x7effca6d8460>,84,21,[10  5],85,-1,138,-1,117
1,<environment.Job instance at 0x7effc0e833c0>,107,15,[6 2],108,-1,132,-1,117
1,<environment.Job instance at 0x7effc0e83190>,110,16,[1 6],111,-1,133,-1,117
1,<environment.Job instance at 0x7effc0e8ab40>,124,14,[5 6],125,-1,139,-1,125
1,<environment.Job instance at 0x7effc0e8aa00>,127,17,[ 5 10],128,-1,145,-1,128
1,<environment.Job instance at 0x7effc0e8a370>,130,15,[3 7],131,-1,147,-1,132
1,<environment.Job instance at 0x7effc1f27140>,102,18,[2 5],103,-1,152,-1,134
1,<environment.Job instance at 0x7effc0e8a6e0>,128,21,[2 5],129,-1,155,-1,134
1,<environment.Job instance at 0x7effc0e7cf00>,133,25,[ 1 10],134,-1,159,-1,134
1,<environment.Job instance at 0x7effc0e7c690>,134,14,[5 3],135,-1,152,-1,138
1,<environment.Job instance at 0x7effc0e7caa0>,141,18,[9 3],142,-1,160,-1,142
1,<environment.Job instance at 0x7effc1f1a960>,122,13,[13  5],123,-1,166,-1,153
1,<environment.Job instance at 0x7effc0e7c6e0>,137,19,[ 2 10],138,-1,172,-1,153
1,<environment.Job instance at 0x7effc0e91870>,147,3,[10  5],148,-1,157,-1,154
1,<environment.Job instance at 0x7effc0e91550>,148,18,[7 1],149,-1,172,-1,154
1,<environment.Job instance at 0x7effc0e91a00>,146,14,[9 3],147,-1,168,-1,154
1,<environment.Job instance at 0x7effc0e8ac80>,129,23,[5 7],130,-1,177,-1,154
1,<environment.Job instance at 0x7effc0e914b0>,150,12,[ 1 13],151,-1,166,-1,154
1,<environment.Job instance at 0x7effc0fdfeb0>,153,13,[10  4],154,-1,168,-1,155
1,<environment.Job instance at 0x7effc0e91960>,149,14,[1 8],150,-1,173,-1,159
1,<environment.Job instance at 0x7effc1463780>,157,15,[8 5],158,-1,174,-1,159
1,<environment.Job instance at 0x7effc1497a00>,159,21,[7 2],160,-1,181,-1,160
1,<environment.Job instance at 0x7effc1497280>,160,13,[4 9],161,-1,174,-1,161
1,<environment.Job instance at 0x7effc147fbe0>,162,16,[8 1],163,-1,179,-1,163
1,<environment.Job instance at 0x7effc09e9cd0>,1,23,[1 8],2,-1,25,-1,2
1,<environment.Job instance at 0x7effc18a8730>,6,13,[ 5 11],7,-1,20,-1,7
1,<environment.Job instance at 0x7effca6b4690>,16,25,[8 1],17,-1,58,-1,33
1,<environment.Job instance at 0x7effc0d5a6e0>,24,28,[7 4],25,-1,83,-1,55
1,<environment.Job instance at 0x7effca9ea0f0>,47,13,[14  1],48,-1,148,-1,135
1,<environment.Job instance at 0x7effc1cb5910>,56,2,[14  1],57,-1,173,-1,171
1,<environment.Job instance at 0x7effc0ecdaf0>,61,25,[1 6],62,-1,211,-1,186
1,<environment.Job instance at 0x7effc0ecd410>,62,12,[12  2],63,-1,198,-1,186
1,<environment.Job instance at 0x7effc0ecdbe0>,63,26,[10  4],64,-1,215,-1,189
1,<environment.Job instance at 0x7effc1f2cf00>,65,24,[4 7],66,-1,223,-1,199
1,<environment.Job instance at 0x7effc1ae8be0>,74,13,[ 5 11],75,-1,251,-1,238
1,<environment.Job instance at 0x7effc09cd640>,79,27,[ 3 10],80,-1,277,-1,250
1,<environment.Job instance at 0x7effc1b50690>,77,28,[7 2],78,-1,283,-1,255
1,<environment.Job instance at 0x7effc1779e10>,82,26,[9 1],83,-1,281,-1,255
1,<environment.Job instance at 0x7effc0e4ec30>,86,3,[ 2 14],87,-1,259,-1,256
1,<environment.Job instance at 0x7effc09f7050>,97,27,[9 4],98,-1,328,-1,301
1,<environment.Job instance at 0x7effc0a33960>,108,17,[13  5],109,-1,352,-1,335
1,<environment.Job instance at 0x7effc20972d0>,122,13,[13  5],123,-1,414,-1,401
1,<environment.Job instance at 0x7effc20978c0>,125,2,[ 2 12],126,-1,413,-1,411
1,<environment.Job instance at 0x7effcaba0280>,129,23,[5 7],130,-1,452,-1,429
1,<environment.Job instance at 0x7effc0eabfa0>,136,12,[14  2],137,-1,462,-1,450
1,<environment.Job instance at 0x7effc0eab550>,138,1,[ 5 14],139,-1,453,-1,452
1,<environment.Job instance at 0x7effca6beaf0>,133,25,[ 1 10],134,-1,482,-1,457
1,<environment.Job instance at 0x7effc0cb0870>,150,12,[ 1 13],151,-1,504,-1,492
1,<environment.Job instance at 0x7effc0ea5500>,155,2,[11  4],156,-1,508,-1,506
1,<environment.Job instance at 0x7effc0ecc780>,164,14,[ 1 12],165,-1,553,-1,539
1,<environment.Job instance at 0x7effc0cce820>,166,23,[ 5 12],167,-1,566,-1,543
1,<environment.Job instance at 0x7effc08b00f0>,5,12,[10  3],6,-1,19,-1,7
1,<environment.Job instance at 0x7effc08b0550>,7,1,[7 1],8,-1,9,-1,8
1,<environment.Job instance at 0x7effc08b05f0>,9,14,[2 5],10,-1,24,-1,10
1,<environment.Job instance at 0x7effc08b04b0>,11,16,[1 5],12,-1,28,-1,12
1,<environment.Job instance at 0x7effc13ae640>,12,18,[1 5],13,-1,31,-1,13
1,<environment.Job instance at 0x7effc13ae230>,13,15,[2 8],14,-1,29,-1,14
1,<environment.Job instance at 0x7effc0d5a190>,6,16,[1 7],7,-1,31,-1,15
1,<environment.Job instance at 0x7effc1e7baa0>,18,16,[6 5],19,-1,42,-1,26
1,<environment.Job instance at 0x7effc1e7b5a0>,23,1,[ 4 12],24,-1,27,-1,26
1,<environment.Job instance at 0x7effc1e7be60>,20,25,[6 2],21,-1,51,-1,26
1,<environment.Job instance at 0x7effc1a95c30>,27,16,[1 7],28,-1,46,-1,30
1,<environment.Job instance at 0x7effc19886e0>,30,16,[5 9],31,-1,54,-1,38
1,<environment.Job instance at 0x7effc1988730>,32,14,[10  5],33,-1,58,-1,44
1,<environment.Job instance at 0x7effc1e1ef00>,36,18,[1 8],37,-1,73,-1,55
1,<environment.Job instance at 0x7effc1e1e280>,37,27,[4 8],38,-1,82,-1,55
1,<environment.Job instance at 0x7effc1988c80>,31,18,[14  2],32,-1,76,-1,58
1,<environment.Job instance at 0x7effc08258c0>,40,15,[8 5],41,-1,73,-1,58
1,<environment.Job instance at 0x7effc1e1ea00>,35,15,[12  5],36,-1,80,-1,65
1,<environment.Job instance at 0x7effc1d79960>,48,18,[6 4],49,-1,83,-1,65
1,<environment.Job instance at 0x7effc0a23640>,52,15,[9 5],53,-1,82,-1,67
1,<environment.Job instance at 0x7effc1988d20>,34,17,[4 9],35,-1,88,-1,71
1,<environment.Job instance at 0x7effc0a23f50>,56,18,[4 9],57,-1,89,-1,71
1,<environment.Job instance at 0x7effc0a23aa0>,59,13,[9 3],60,-1,84,-1,71
1,<environment.Job instance at 0x7effc0a235a0>,57,18,[5 3],58,-1,93,-1,75
1,<environment.Job instance at 0x7effc197af00>,63,18,[ 5 13],64,-1,96,-1,78
1,<environment.Job instance at 0x7effc1327910>,60,12,[2 6],61,-1,90,-1,78
1,<environment.Job instance at 0x7effc13270a0>,62,16,[8 1],63,-1,94,-1,78
1,<environment.Job instance at 0x7effc197a730>,66,16,[2 7],67,-1,96,-1,80
1,<environment.Job instance at 0x7effc0df55f0>,70,17,[5 8],71,-1,100,-1,83
1,<environment.Job instance at 0x7effc0df5fa0>,69,17,[3 5],70,-1,105,-1,88
1,<environment.Job instance at 0x7effc0df5190>,74,18,[6 5],75,-1,107,-1,89
1,<environment.Job instance at 0x7effc0df5f50>,77,13,[6 1],78,-1,102,-1,89
1,<environment.Job instance at 0x7effc0df5c30>,76,17,[5 1],77,-1,106,-1,89
1,<environment.Job instance at 0x7effc0eb9b90>,79,16,[5 5],80,-1,105,-1,89
1,<environment.Job instance at 0x7effc0eb9640>,82,17,[3 5],83,-1,106,-1,89
1,<environment.Job instance at 0x7effc0eb9a00>,83,13,[2 7],84,-1,102,-1,89
1,<environment.Job instance at 0x7effc0eb9780>,85,18,[4 9],86,-1,108,-1,90
1,<environment.Job instance at 0x7effc0eb9050>,86,14,[8 5],87,-1,104,-1,90
1,<environment.Job instance at 0x7effc17c00f0>,88,18,[6 5],89,-1,109,-1,91
1,<environment.Job instance at 0x7effc0df5370>,71,14,[7 5],72,-1,106,-1,92
1,<environment.Job instance at 0x7effc17c0960>,93,18,[6 1],94,-1,113,-1,95
1,<environment.Job instance at 0x7effc17c0c30>,94,16,[1 6],95,-1,111,-1,95
1,<environment.Job instance at 0x7effc1fd8190>,95,16,[10  1],96,-1,113,-1,97
1,<environment.Job instance at 0x7effca64c370>,97,14,[ 3 12],98,-1,112,-1,98
1,<environment.Job instance at 0x7effc08f67d0>,98,14,[5 5],99,-1,113,-1,99
1,<environment.Job instance at 0x7effca6be780>,96,21,[10  4],97,-1,120,-1,99
1,<environment.Job instance at 0x7effc136dc80>,103,15,[8 2],104,-1,121,-1,106
1,<environment.Job instance at 0x7effcac65960>,105,23,[7 3],106,-1,129,-1,106
1,<environment.Job instance at 0x7effc0dd3c80>,107,20,[8 3],108,-1,130,-1,110
1,<environment.Job instance at 0x7effc10e97d0>,109,22,[9 1],110,-1,133,-1,111
1,<environment.Job instance at 0x7effc12ee230>,111,16,[1 7],112,-1,128,-1,112
1,<environment.Job instance at 0x7effc0ecdd20>,118,18,[5 9],119,-1,137,-1,119
1,<environment.Job instance at 0x7effca755d70>,116,12,[1 9],117,-1,132,-1,120
1,<environment.Job instance at 0x7effc0fc67d0>,120,3,[1 9],121,-1,124,-1,121
1,<environment.Job instance at 0x7effc1c72410>,122,16,[4 7],123,-1,139,-1,123
1,<environment.Job instance at 0x7effc1c72780>,123,16,[5 9],124,-1,140,-1,124
1,<environment.Job instance at 0x7effc1b01050>,124,16,[3 5],125,-1,141,-1,125
1,<environment.Job instance at 0x7effc18efb90>,125,15,[ 3 10],126,-1,141,-1,126
1,<environment.Job instance at 0x7effc1e7b8c0>,24,21,[5 2],25,-1,147,-1,126
1,<environment.Job instance at 0x7effc1c725f0>,126,12,[1 5],127,-1,139,-1,127
1,<environment.Job instance at 0x7effc0a69910>,131,12,[7 5],132,-1,144,-1,132
1,<environment.Job instance at 0x7effc0ec20f0>,132,26,[9 3],133,-1,159,-1,133
1,<environment.Job instance at 0x7effc0ec27d0>,133,12,[8 2],134,-1,146,-1,134
1,<environment.Job instance at 0x7effc1452370>,135,15,[8 3],136,-1,151,-1,136
1,<environment.Job instance at 0x7effc12c7aa0>,119,16,[8 4],120,-1,152,-1,136
1,<environment.Job instance at 0x7effc0f29eb0>,137,13,[9 2],138,-1,154,-1,141
1,<environment.Job instance at 0x7effc1b8d190>,142,12,[9 4],143,-1,155,-1,143
1,<environment.Job instance at 0x7effc13e2550>,143,14,[5 9],144,-1,158,-1,144
1,<environment.Job instance at 0x7effcace25a0>,145,18,[6 4],146,-1,164,-1,146
1,<environment.Job instance at 0x7effc0e8c550>,147,22,[6 4],148,-1,170,-1,148
1,<environment.Job instance at 0x7effc1beaeb0>,150,15,[4 9],151,-1,166,-1,151
1,<environment.Job instance at 0x7effc1d89500>,154,17,[9 5],155,-1,172,-1,155
1,<environment.Job instance at 0x7effc1904640>,156,12,[9 2],157,-1,169,-1,157
1,<environment.Job instance at 0x7effc18be730>,157,18,[3 7],158,-1,176,-1,158
1,<environment.Job instance at 0x7effc1ba4410>,163,12,[ 4 10],164,-1,181,-1,169
1,<environment.Job instance at 0x7effc11d23c0>,165,19,[10  1],166,-1,188,-1,169
1,<environment.Job instance at 0x7effc197a320>,2,1,[ 4 11],3,-1,4,-1,3
1,<environment.Job instance at 0x7effc08b0050>,14,3,[ 1 12],15,-1,33,-1,30
1,<environment.Job instance at 0x7effc2095870>,20,25,[6 2],21,-1,78,-1,53
1,<environment.Job instance at 0x7effca6a9d70>,22,3,[14  1],23,-1,56,-1,53
1,<environment.Job instance at 0x7effc17e7320>,23,1,[ 4 12],24,-1,54,-1,53
1,<environment.Job instance at 0x7effca6bfe60>,31,18,[14  2],32,-1,87,-1,69
1,<environment.Job instance at 0x7effc0d5a500>,35,15,[12  5],36,-1,101,-1,86
1,<environment.Job instance at 0x7effc0d5aaf0>,37,27,[4 8],38,-1,133,-1,106
1,<environment.Job instance at 0x7effc0d5af50>,38,20,[ 4 13],39,-1,126,-1,106
1,<environment.Job instance at 0x7effc08a0640>,63,18,[ 5 13],64,-1,191,-1,173
1,<environment.Job instance at 0x7effc0b33f50>,97,14,[ 3 12],98,-1,317,-1,303
1,<environment.Job instance at 0x7effc08292d0>,105,23,[7 3],106,-1,350,-1,327
1,<environment.Job instance at 0x7effc1944a00>,112,18,[ 3 13],113,-1,347,-1,329
1,<environment.Job instance at 0x7effc0740500>,132,26,[9 3],133,-1,429,-1,403
1,<environment.Job instance at 0x7effca9f9460>,136,3,[12  4],137,-1,418,-1,415
1,<environment.Job instance at 0x7effc10e9910>,146,15,[ 1 11],147,-1,465,-1,450
1,<environment.Job instance at 0x7effc07768c0>,158,12,[14  5],159,-1,509,-1,497
1,<environment.Job instance at 0x7effc1a2f730>,168,23,[1 5],169,-1,572,-1,549
1,<environment.Job instance at 0x7effc112ffa0>,1,17,[8 4],2,-1,19,-1,2
1,<environment.Job instance at 0x7effc112f960>,3,18,[10  4],4,-1,22,-1,4
1,<environment.Job instance at 0x7effc112f4b0>,7,20,[5 3],8,-1,30,-1,10
1,<environment.Job instance at 0x7effc112f730>,5,12,[1 8],6,-1,22,-1,10
1,<environment.Job instance at 0x7effcaa32f50>,10,16,[10  2],11,-1,27,-1,11
1,<environment.Job instance at 0x7effc112f6e0>,11,16,[ 2 10],12,-1,28,-1,12
1,<environment.Job instance at 0x7effc0f29960>,13,16,[1 9],14,-1,30,-1,14
1,<environment.Job instance at 0x7effc0f29280>,14,1,[4 6],15,-1,16,-1,15
1,<environment.Job instance at 0x7effc0f298c0>,15,15,[2 8],16,-1,31,-1,16
1,<environment.Job instance at 0x7effc0f291e0>,20,17,[1 7],21,-1,38,-1,21
1,<environment.Job instance at 0x7effc0f29f50>,21,13,[8 2],22,-1,35,-1,22
1,<environment.Job instance at 0x7effc0f29aa0>,22,15,[6 2],23,-1,38,-1,23
1,<environment.Job instance at 0x7effc0f29780>,25,16,[2 9],26,-1,42,-1,26
1,<environment.Job instance at 0x7effc0f29dc0>,26,12,[7 4],27,-1,39,-1,27
1,<environment.Job instance at 0x7effc1de95a0>,29,13,[ 1 10],30,-1,43,-1,30
1,<environment.Job instance at 0x7effc1639d70>,46,13,[4 9],47,-1,77,-1,64
1,<environment.Job instance at 0x7effc10ed960>,43,18,[1 7],44,-1,85,-1,67
1,<environment.Job instance at 0x7effc1639f00>,51,18,[5 6],52,-1,86,-1,68
1,<environment.Job instance at 0x7effc206e320>,54,14,[ 4 10],55,-1,84,-1,70
1,<environment.Job instance at 0x7effc1de9d20>,35,17,[14  3],36,-1,87,-1,70
1,<environment.Job instance at 0x7effc10ed640>,42,24,[7 2],43,-1,94,-1,70
1,<environment.Job instance at 0x7effc206eeb0>,56,15,[1 6],57,-1,85,-1,70
1,<environment.Job instance at 0x7effc206e5f0>,59,14,[2 7],60,-1,84,-1,70
1,<environment.Job instance at 0x7effc0f29c80>,24,17,[12  2],25,-1,87,-1,70
1,<environment.Job instance at 0x7effc206e3c0>,57,18,[3 8],58,-1,88,-1,70
1,<environment.Job instance at 0x7effc206e820>,62,16,[3 7],63,-1,89,-1,73
1,<environment.Job instance at 0x7effc206eb40>,63,15,[9 4],64,-1,88,-1,73
1,<environment.Job instance at 0x7effc206eb90>,55,16,[6 5],56,-1,89,-1,73
1,<environment.Job instance at 0x7effc206e6e0>,66,14,[7 3],67,-1,88,-1,74
1,<environment.Job instance at 0x7effc1625550>,72,16,[6 4],73,-1,90,-1,74
1,<environment.Job instance at 0x7effc13bb9b0>,71,14,[1 8],72,-1,88,-1,74
1,<environment.Job instance at 0x7effc1591190>,73,12,[10  2],74,-1,86,-1,74
1,<environment.Job instance at 0x7effc1e6b410>,76,18,[ 2 10],77,-1,95,-1,77
1,<environment.Job instance at 0x7effc1729050>,80,15,[8 4],81,-1,97,-1,82
1,<environment.Job instance at 0x7effc1009640>,82,17,[1 7],83,-1,100,-1,83
1,<environment.Job instance at 0x7effc10090f0>,83,14,[7 2],84,-1,98,-1,84
1,<environment.Job instance at 0x7effc1009aa0>,81,18,[7 3],82,-1,107,-1,89
1,<environment.Job instance at 0x7effc1009780>,91,21,[8 4],92,-1,119,-1,98
1,<environment.Job instance at 0x7effc1009320>,92,16,[1 7],93,-1,114,-1,98
1,<environment.Job instance at 0x7effc10094b0>,95,18,[4 5],96,-1,120,-1,102
1,<environment.Job instance at 0x7effc10098c0>,90,17,[5 2],91,-1,123,-1,106
1,<environment.Job instance at 0x7effc1988410>,67,18,[2 8],68,-1,125,-1,107
1,<environment.Job instance at 0x7effc10092d0>,97,18,[2 7],98,-1,125,-1,107
1,<environment.Job instance at 0x7effc1e6ba50>,75,27,[1 5],76,-1,135,-1,108
1,<environment.Job instance at 0x7effc1f7d640>,104,20,[8 2],105,-1,129,-1,109
1,<environment.Job instance at 0x7effc1f7d320>,105,14,[4 9],106,-1,123,-1,109
1,<environment.Job instance at 0x7effc0eb4820>,109,13,[2 6],110,-1,123,-1,110
1,<environment.Job instance at 0x7effc1a57c30>,110,21,[10  5],111,-1,132,-1,111
1,<environment.Job instance at 0x7effc160e5f0>,113,19,[7 1],114,-1,133,-1,114
1,<environment.Job instance at 0x7effc160eaf0>,114,12,[9 5],115,-1,127,-1,115
1,<environment.Job instance at 0x7effc1033dc0>,122,16,[9 2],123,-1,140,-1,124
1,<environment.Job instance at 0x7effc1777320>,131,15,[9 3],132,-1,147,-1,132
1,<environment.Job instance at 0x7effc1777190>,132,17,[4 9],133,-1,150,-1,133
1,<environment.Job instance at 0x7effc1777640>,134,24,[7 3],135,-1,159,-1,135
1,<environment.Job instance at 0x7effc1724aa0>,136,21,[5 3],137,-1,159,-1,138
1,<environment.Job instance at 0x7effc2068730>,138,16,[1 7],139,-1,155,-1,139
1,<environment.Job instance at 0x7effc1a9b410>,16,17,[13  4],17,-1,64,-1,47
1,<environment.Job instance at 0x7effc160ec30>,19,17,[ 1 11],20,-1,68,-1,51
1,<environment.Job instance at 0x7effc17240f0>,24,17,[12  2],25,-1,83,-1,66
1,<environment.Job instance at 0x7effc112f0a0>,32,1,[ 1 11],33,-1,92,-1,91
1,<environment.Job instance at 0x7effc1bfd0a0>,34,12,[ 3 12],35,-1,108,-1,96
1,<environment.Job instance at 0x7effca9f9d70>,35,17,[14  3],36,-1,113,-1,96
1,<environment.Job instance at 0x7effca9f9870>,37,24,[1 8],38,-1,138,-1,114
1,<environment.Job instance at 0x7effc0740500>,44,27,[5 1],45,-1,153,-1,126
1,<environment.Job instance at 0x7effc0740780>,45,1,[ 5 12],46,-1,127,-1,126
1,<environment.Job instance at 0x7effca9f9370>,42,24,[7 2],43,-1,157,-1,133
1,<environment.Job instance at 0x7effc09e40a0>,48,3,[13  2],49,-1,136,-1,133
1,<environment.Job instance at 0x7effc0829640>,60,3,[13  5],61,-1,177,-1,174
1,<environment.Job instance at 0x7effc0b333c0>,65,3,[14  3],66,-1,197,-1,194
1,<environment.Job instance at 0x7effc1208870>,75,27,[1 5],76,-1,261,-1,234
1,<environment.Job instance at 0x7effcab26820>,79,3,[13  3],80,-1,252,-1,249
1,<environment.Job instance at 0x7effc1900be0>,115,1,[ 3 11],116,-1,376,-1,375
1,<environment.Job instance at 0x7effc1bf0eb0>,126,23,[ 1 13],127,-1,417,-1,394
1,<environment.Job instance at 0x7effc1bf0b40>,127,2,[ 2 11],128,-1,396,-1,394
1,<environment.Job instance at 0x7effc1323a50>,134,24,[7 3],135,-1,439,-1,415
1,<environment.Job instance at 0x7effc09f75f0>,144,19,[ 5 12],145,-1,479,-1,460
1,<environment.Job instance at 0x7effc1636460>,145,27,[2 8],146,-1,494,-1,467
1,<environment.Job instance at 0x7effc4156c30>,149,1,[ 4 13],150,-1,470,-1,469
1,<environment.Job instance at 0x7effc41567d0>,152,24,[5 7],153,-1,504,-1,480
1,<environment.Job instance at 0x7effc183bd20>,159,23,[6 1],160,-1,522,-1,499
1,<environment.Job instance at 0x7effc0fc86e0>,160,1,[11  4],161,-1,500,-1,499
1,<environment.Job instance at 0x7effc0ea2280>,166,23,[ 2 10],167,-1,539,-1,516
1,<environment.Job instance at 0x7effc1031910>,7,17,[5 6],8,-1,26,-1,9
1,<environment.Job instance at 0x7effc10310f0>,9,14,[ 2 10],10,-1,24,-1,10
1,<environment.Job instance at 0x7effc1cb9af0>,16,13,[2 7],17,-1,30,-1,17
1,<environment.Job instance at 0x7effc1cb9f50>,18,14,[2 8],19,-1,33,-1,19
1,<environment.Job instance at 0x7effc1031b90>,20,18,[5 6],21,-1,39,-1,21
1,<environment.Job instance at 0x7effc10525f0>,22,14,[5 3],23,-1,37,-1,23
1,<environment.Job instance at 0x7effc08c5be0>,23,13,[10  5],24,-1,37,-1,24
1,<environment.Job instance at 0x7effc1c8fe60>,25,15,[10  4],26,-1,41,-1,26
1,<environment.Job instance at 0x7effc1cbb500>,26,26,[5 7],27,-1,53,-1,27
1,<environment.Job instance at 0x7effc075cfa0>,34,14,[5 2],35,-1,49,-1,35
1,<environment.Job instance at 0x7effc07c9190>,8,15,[3 5],9,-1,50,-1,35
1,<environment.Job instance at 0x7effc0737280>,37,14,[6 1],38,-1,53,-1,39
1,<environment.Job instance at 0x7effc0737410>,39,20,[3 9],40,-1,60,-1,40
1,<environment.Job instance at 0x7effc07374b0>,40,16,[4 9],41,-1,57,-1,41
1,<environment.Job instance at 0x7effc07375f0>,41,23,[8 4],42,-1,65,-1,42
1,<environment.Job instance at 0x7effc0737500>,42,17,[3 6],43,-1,60,-1,43
1,<environment.Job instance at 0x7effc0737d70>,43,14,[5 4],44,-1,58,-1,44
1,<environment.Job instance at 0x7effc0731eb0>,55,27,[6 2],56,-1,92,-1,65
1,<environment.Job instance at 0x7effc0731e60>,57,15,[10  5],58,-1,80,-1,65
1,<environment.Job instance at 0x7effc073a230>,51,17,[7 4],52,-1,82,-1,65
1,<environment.Job instance at 0x7effc0731410>,60,17,[8 2],61,-1,88,-1,71
1,<environment.Job instance at 0x7effc0731b40>,59,18,[5 2],60,-1,89,-1,71
1,<environment.Job instance at 0x7effc1541820>,5,13,[9 1],6,-1,84,-1,71
1,<environment.Job instance at 0x7effc074c870>,63,15,[5 2],64,-1,86,-1,71
1,<environment.Job instance at 0x7effc1b21050>,68,18,[5 3],69,-1,89,-1,71
1,<environment.Job instance at 0x7effc07231e0>,69,12,[9 5],70,-1,83,-1,71
1,<environment.Job instance at 0x7effc0723280>,70,12,[5 7],71,-1,83,-1,71
1,<environment.Job instance at 0x7effc0723050>,71,18,[1 7],72,-1,90,-1,72
1,<environment.Job instance at 0x7effc0757190>,82,13,[5 8],83,-1,96,-1,83
1,<environment.Job instance at 0x7effc0757910>,90,12,[9 3],91,-1,106,-1,94
1,<environment.Job instance at 0x7effc0757e60>,94,18,[ 4 10],95,-1,113,-1,95
1,<environment.Job instance at 0x7effc1031960>,0,15,[ 1 11],1,-1,16,-1,1
1,<environment.Job instance at 0x7effc1031280>,1,2,[11  4],2,-1,4,-1,2
1,<environment.Job instance at 0x7effc1031e10>,2,3,[14  5],3,-1,6,-1,3
1,<environment.Job instance at 0x7effc0fc8d70>,26,26,[5 7],27,-1,95,-1,69
1,<environment.Job instance at 0x7effc0fc8eb0>,29,13,[ 2 14],30,-1,82,-1,69
1,<environment.Job instance at 0x7effc183ba50>,36,3,[ 4 11],37,-1,91,-1,88
1,<environment.Job instance at 0x7effc1ca7f00>,44,3,[11  3],45,-1,119,-1,116
1,<environment.Job instance at 0x7effc4156410>,46,2,[ 2 12],47,-1,120,-1,118
1,<environment.Job instance at 0x7effc0ce9be0>,41,23,[8 4],42,-1,155,-1,132
1,<environment.Job instance at 0x7effc1323d20>,55,27,[6 2],56,-1,174,-1,147
1,<environment.Job instance at 0x7effc1bf0d70>,58,3,[ 3 12],59,-1,154,-1,151
1,<environment.Job instance at 0x7effc0a23910>,75,1,[ 4 14],76,-1,230,-1,229
1,<environment.Job instance at 0x7effc0b07190>,86,14,[ 5 11],87,-1,263,-1,249
1,<environment.Job instance at 0x7effc1b50910>,89,22,[14  5],90,-1,274,-1,252
1,<environment.Job instance at 0x7effc15590a0>,92,12,[11  2],93,-1,270,-1,258
1,<environment.Job instance at 0x7effc14af690>,107,25,[6 5],108,-1,333,-1,308
1,<environment.Job instance at 0x7effc09ce140>,118,25,[5 7],119,-1,360,-1,335
1,<environment.Job instance at 0x7effc09ceaa0>,119,13,[ 3 12],120,-1,348,-1,335
1,<environment.Job instance at 0x7effc09e4cd0>,128,3,[12  5],129,-1,358,-1,355
1,<environment.Job instance at 0x7effc0740780>,135,26,[14  3],136,-1,411,-1,385
1,<environment.Job instance at 0x7effca9f9050>,137,28,[6 3],138,-1,427,-1,399
1,<environment.Job instance at 0x7effc0c18730>,146,2,[14  2],147,-1,421,-1,419
1,<environment.Job instance at 0x7effc1777410>,147,3,[13  2],148,-1,422,-1,419
1,<environment.Job instance at 0x7effc1f7d730>,159,18,[13  1],160,-1,476,-1,458
1,<environment.Job instance at 0x7effc1009c30>,162,25,[2 8],163,-1,496,-1,471
1,<environment.Job instance at 0x7effc174ec30>,164,15,[ 3 14],165,-1,486,-1,471
1,<environment.Job instance at 0x7effca9ea7d0>,3,16,[10  1],4,-1,21,-1,5
1,<environment.Job instance at 0x7effc1515e10>,4,17,[4 8],5,-1,22,-1,5
1,<environment.Job instance at 0x7effc0bc1be0>,7,14,[9 1],8,-1,25,-1,11
1,<environment.Job instance at 0x7effc0bc1460>,14,19,[6 5],15,-1,34,-1,15
1,<environment.Job instance at 0x7effc0bc10f0>,15,18,[4 5],16,-1,34,-1,16
1,<environment.Job instance at 0x7effc076a140>,20,20,[7 1],21,-1,41,-1,21
1,<environment.Job instance at 0x7effc18bedc0>,26,14,[8 2],27,-1,41,-1,27
1,<environment.Job instance at 0x7effc116ed70>,28,12,[6 1],29,-1,44,-1,32
1,<environment.Job instance at 0x7effc0bc1690>,10,27,[3 8],11,-1,59,-1,32
1,<environment.Job instance at 0x7effc116e500>,31,17,[ 3 10],32,-1,52,-1,35
1,<environment.Job instance at 0x7effc1426d70>,32,12,[3 6],33,-1,47,-1,35
1,<environment.Job instance at 0x7effc113fd70>,35,13,[3 7],36,-1,49,-1,36
1,<environment.Job instance at 0x7effc1d62320>,34,17,[4 5],35,-1,54,-1,37
1,<environment.Job instance at 0x7effc1763960>,42,28,[1 7],43,-1,74,-1,46
1,<environment.Job instance at 0x7effc1bd6e60>,47,16,[7 4],48,-1,67,-1,51
1,<environment.Job instance at 0x7effc16448c0>,43,16,[5 5],44,-1,71,-1,55
1,<environment.Job instance at 0x7effc0bc1f00>,11,16,[ 3 14],12,-1,71,-1,55
1,<environment.Job instance at 0x7effc1bd6370>,48,12,[8 2],49,-1,67,-1,55
1,<environment.Job instance at 0x7effc090cd70>,51,17,[ 3 10],52,-1,72,-1,55
1,<environment.Job instance at 0x7effc090cdc0>,52,14,[1 7],53,-1,69,-1,55
1,<environment.Job instance at 0x7effc0d07730>,56,15,[9 4],57,-1,72,-1,57
1,<environment.Job instance at 0x7effc0995910>,57,17,[8 2],58,-1,77,-1,60
1,<environment.Job instance at 0x7effc0ef0410>,61,15,[6 1],62,-1,78,-1,63
1,<environment.Job instance at 0x7effc0ef0a50>,63,16,[9 3],64,-1,80,-1,64
1,<environment.Job instance at 0x7effc1bdc5a0>,65,16,[ 5 10],66,-1,82,-1,66
1,<environment.Job instance at 0x7effc1bdc320>,66,12,[1 9],67,-1,85,-1,73
1,<environment.Job instance at 0x7effc090c460>,54,27,[3 7],55,-1,107,-1,80
1,<environment.Job instance at 0x7effc1141c30>,45,26,[ 4 10],46,-1,110,-1,84
1,<environment.Job instance at 0x7effc1bdc640>,68,19,[5 8],69,-1,103,-1,84
1,<environment.Job instance at 0x7effc091f460>,72,18,[10  4],73,-1,102,-1,84
1,<environment.Job instance at 0x7effc091fb40>,73,16,[1 8],74,-1,100,-1,84
1,<environment.Job instance at 0x7effc091f550>,74,17,[6 4],75,-1,101,-1,84
1,<environment.Job instance at 0x7effc0ef0b90>,62,18,[5 5],63,-1,105,-1,87
1,<environment.Job instance at 0x7effc165cd70>,85,16,[ 3 10],86,-1,116,-1,100
1,<environment.Job instance at 0x7effc1b94c80>,86,18,[5 7],87,-1,119,-1,101
1,<environment.Job instance at 0x7effc1d6ad70>,90,19,[3 8],91,-1,121,-1,102
1,<environment.Job instance at 0x7effc136dcd0>,146,17,[10  5],147,-1,1411,-1,1394
1,<environment.Job instance at 0x7effc1bba5f0>,156,22,[9 5],157,-1,1416,-1,1394
1,<environment.Job instance at 0x7effc0eb1500>,97,27,[3 7],98,-1,1421,-1,1394
1,<environment.Job instance at 0x7effc1bba730>,158,24,[7 4],159,-1,1418,-1,1394
1,<environment.Job instance at 0x7effc143b2d0>,119,16,[ 1 10],120,-1,1410,-1,1394
1,<environment.Job instance at 0x7effc113f190>,0,12,[ 3 11],1,-1,13,-1,1
1,<environment.Job instance at 0x7effc113f640>,1,28,[1 5],2,-1,30,-1,2
1,<environment.Job instance at 0x7effc1bc4b90>,10,27,[3 8],11,-1,49,-1,22
1,<environment.Job instance at 0x7effc1bc4fa0>,11,16,[ 3 14],12,-1,38,-1,22
1,<environment.Job instance at 0x7effc1fae870>,21,1,[12  2],22,-1,40,-1,39
1,<environment.Job instance at 0x7effc1763c80>,40,23,[ 1 12],41,-1,115,-1,92
1,<environment.Job instance at 0x7effc0757eb0>,42,28,[1 7],43,-1,128,-1,100
1,<environment.Job instance at 0x7effc0723140>,45,26,[ 4 10],46,-1,140,-1,114
1,<environment.Job instance at 0x7effc10b6140>,49,22,[12  5],50,-1,136,-1,114
1,<environment.Job instance at 0x7effc0c18410>,54,27,[3 7],55,-1,156,-1,129
1,<environment.Job instance at 0x7effc1d06cd0>,87,28,[8 3],88,-1,290,-1,262
1,<environment.Job instance at 0x7effc1d59aa0>,92,22,[13  5],93,-1,297,-1,275
1,<environment.Job instance at 0x7effc1d59500>,93,28,[10  5],94,-1,308,-1,280
1,<environment.Job instance at 0x7effc0fae5a0>,97,27,[3 7],98,-1,322,-1,295
1,<environment.Job instance at 0x7effc0aa3640>,106,27,[13  1],107,-1,349,-1,322
1,<environment.Job instance at 0x7effc0a2f2d0>,115,25,[2 7],116,-1,374,-1,349
1,<environment.Job instance at 0x7effc1724eb0>,117,17,[ 5 14],118,-1,366,-1,349
1,<environment.Job instance at 0x7effc0c61b90>,141,26,[6 3],142,-1,442,-1,416
1,<environment.Job instance at 0x7effc0c61cd0>,147,1,[ 5 12],148,-1,433,-1,432
1,<environment.Job instance at 0x7effc0b24c80>,149,3,[12  2],150,-1,441,-1,438
1,<environment.Job instance at 0x7effc10c6aa0>,151,3,[11  1],152,-1,442,-1,439
1,<environment.Job instance at 0x7effc0da9a50>,155,27,[8 5],156,-1,483,-1,456
1,<environment.Job instance at 0x7effc0dce780>,158,24,[7 4],159,-1,490,-1,466
1,<environment.Job instance at 0x7effca855e60>,167,13,[ 2 13],168,-1,501,-1,488
1,<environment.Job instance at 0x7effc0a684b0>,168,17,[ 1 13],169,-1,505,-1,488
1,<environment.Job instance at 0x7effc137d3c0>,10,20,[9 2],11,-1,32,-1,12
1,<environment.Job instance at 0x7effc137db90>,12,17,[4 7],13,-1,30,-1,13
1,<environment.Job instance at 0x7effc137dc80>,13,18,[2 9],14,-1,32,-1,14
1,<environment.Job instance at 0x7effc137de10>,14,15,[9 1],15,-1,48,-1,33
1,<environment.Job instance at 0x7effc1156910>,23,13,[2 7],24,-1,46,-1,33
1,<environment.Job instance at 0x7effc13b6b90>,24,19,[1 7],25,-1,52,-1,33
1,<environment.Job instance at 0x7effc1c141e0>,27,17,[7 2],28,-1,50,-1,33
1,<environment.Job instance at 0x7effc09a6c80>,34,25,[7 4],35,-1,62,-1,37
1,<environment.Job instance at 0x7effc1547d20>,35,22,[9 2],36,-1,59,-1,37
1,<environment.Job instance at 0x7effc0ccef50>,36,28,[6 2],37,-1,65,-1,37
1,<environment.Job instance at 0x7effc0dab820>,38,19,[2 5],39,-1,58,-1,39
1,<environment.Job instance at 0x7effca6cac30>,41,21,[7 2],42,-1,63,-1,42
1,<environment.Job instance at 0x7effc0eefb90>,56,16,[9 3],57,-1,112,-1,96
1,<environment.Job instance at 0x7effc0eefe10>,58,16,[8 3],59,-1,112,-1,96
1,<environment.Job instance at 0x7effc0eefa00>,54,17,[10  1],55,-1,113,-1,96
1,<environment.Job instance at 0x7effc0b6fbe0>,62,26,[5 7],63,-1,153,-1,127
1,<environment.Job instance at 0x7effc1559c80>,69,18,[10  5],70,-1,156,-1,138
1,<environment.Job instance at 0x7effc076ae10>,72,20,[10  4],73,-1,158,-1,138
1,<environment.Job instance at 0x7effc15593c0>,64,28,[9 1],65,-1,167,-1,139
1,<environment.Job instance at 0x7effc1706460>,75,16,[ 3 10],76,-1,155,-1,139
1,<environment.Job instance at 0x7effc1156d70>,16,26,[ 4 10],17,-1,165,-1,139
1,<environment.Job instance at 0x7effc1559190>,74,14,[1 9],75,-1,153,-1,139
1,<environment.Job instance at 0x7effc1706870>,79,14,[8 4],80,-1,153,-1,139
1,<environment.Job instance at 0x7effc172caf0>,77,13,[10  1],78,-1,152,-1,139
1,<environment.Job instance at 0x7effc104d5f0>,82,12,[ 3 10],83,-1,151,-1,139
1,<environment.Job instance at 0x7effc1559fa0>,65,19,[3 8],66,-1,158,-1,139
1,<environment.Job instance at 0x7effc0de1050>,83,16,[7 2],84,-1,156,-1,140
1,<environment.Job instance at 0x7effc0a76be0>,87,20,[10  3],88,-1,160,-1,140
1,<environment.Job instance at 0x7effc0c958c0>,89,28,[10  4],90,-1,168,-1,140
1,<environment.Job instance at 0x7effc1139d20>,92,13,[3 5],93,-1,156,-1,143
1,<environment.Job instance at 0x7effc1652d20>,94,17,[5 9],95,-1,175,-1,158
1,<environment.Job instance at 0x7effc173a4b0>,101,17,[ 5 10],102,-1,187,-1,170
1,<environment.Job instance at 0x7effc0821730>,140,15,[ 3 10],141,-1,428,-1,413
1,<environment.Job instance at 0x7effc08214b0>,142,16,[5 8],143,-1,429,-1,413
1,<environment.Job instance at 0x7effc0821140>,146,17,[4 9],147,-1,432,-1,415
1,<environment.Job instance at 0x7effc0821fa0>,147,18,[3 7],148,-1,433,-1,415
1,<environment.Job instance at 0x7effc1bc7460>,115,25,[10  3],116,-1,531,-1,506
1,<environment.Job instance at 0x7effc0b6ff00>,1,24,[ 3 14],2,-1,26,-1,2
1,<environment.Job instance at 0x7effc1770be0>,8,13,[14  1],9,-1,22,-1,9
1,<environment.Job instance at 0x7effc1d81fa0>,11,15,[ 3 13],12,-1,27,-1,12
1,<environment.Job instance at 0x7effc14e3f00>,16,26,[ 4 10],17,-1,54,-1,28
1,<environment.Job instance at 0x7effc14e35f0>,21,3,[ 2 12],22,-1,34,-1,31
1,<environment.Job instance at 0x7effc1c1fbe0>,25,13,[13  4],26,-1,57,-1,44
1,<environment.Job instance at 0x7effc1c1f500>,26,25,[ 3 12],27,-1,69,-1,44
1,<environment.Job instance at 0x7effc18a6280>,34,25,[7 4],35,-1,94,-1,69
1,<environment.Job instance at 0x7effc1a778c0>,36,28,[6 2],37,-1,97,-1,69
1,<environment.Job instance at 0x7effc0c18410>,40,1,[ 2 11],41,-1,72,-1,71
1,<environment.Job instance at 0x7effc15595f0>,42,14,[ 4 14],43,-1,88,-1,74
1,<environment.Job instance at 0x7effc113faa0>,50,18,[ 2 13],51,-1,98,-1,80
1,<environment.Job instance at 0x7effc1b04500>,57,3,[12  2],58,-1,105,-1,102
1,<environment.Job instance at 0x7effc1227f00>,62,26,[5 7],63,-1,157,-1,131
1,<environment.Job instance at 0x7effc14010f0>,64,28,[9 1],65,-1,170,-1,142
1,<environment.Job instance at 0x7effc1ffa8c0>,68,28,[5 2],69,-1,188,-1,160
1,<environment.Job instance at 0x7effc12449b0>,73,3,[11  4],74,-1,181,-1,178
1,<environment.Job instance at 0x7effc0cd2d70>,80,2,[ 5 14],81,-1,213,-1,211
1,<environment.Job instance at 0x7effc1bbb410>,89,28,[10  4],90,-1,287,-1,259
1,<environment.Job instance at 0x7effc1bf0640>,95,3,[11  1],96,-1,267,-1,264
1,<environment.Job instance at 0x7effc12ee730>,100,1,[ 1 14],101,-1,293,-1,292
1,<environment.Job instance at 0x7effc0ea6d20>,108,28,[2 8],109,-1,353,-1,325
1,<environment.Job instance at 0x7effc0ea61e0>,109,13,[ 5 12],110,-1,338,-1,325
1,<environment.Job instance at 0x7effc124fd20>,116,2,[12  3],117,-1,343,-1,341
1,<environment.Job instance at 0x7effcac6ca50>,115,25,[10  3],116,-1,382,-1,357
1,<environment.Job instance at 0x7effc10fdbe0>,124,3,[14  3],125,-1,375,-1,372
1,<environment.Job instance at 0x7effc0f9c910>,129,15,[13  3],130,-1,405,-1,390
1,<environment.Job instance at 0x7effc0f9c0f0>,130,24,[7 2],131,-1,416,-1,392
1,<environment.Job instance at 0x7effc0d98b90>,132,25,[7 5],133,-1,417,-1,392
1,<environment.Job instance at 0x7effc0e7a870>,136,3,[12  5],137,-1,409,-1,406
1,<environment.Job instance at 0x7effc10fa2d0>,152,24,[2 9],153,-1,527,-1,503
1,<environment.Job instance at 0x7effc13a2410>,1,17,[4 6],2,-1,19,-1,2
1,<environment.Job instance at 0x7effc13a2af0>,4,14,[10  2],5,-1,20,-1,6
1,<environment.Job instance at 0x7effc12f3dc0>,7,3,[3 5],8,-1,11,-1,8
1,<environment.Job instance at 0x7effc12f3d70>,8,13,[ 5 13],9,-1,22,-1,9
1,<environment.Job instance at 0x7effc13a2140>,5,23,[1 8],6,-1,32,-1,9
1,<environment.Job instance at 0x7effc12f3500>,13,14,[8 4],14,-1,29,-1,15
1,<environment.Job instance at 0x7effc12f3a00>,14,18,[2 6],15,-1,33,-1,15
1,<environment.Job instance at 0x7effc12f3b40>,15,18,[4 6],16,-1,34,-1,16
1,<environment.Job instance at 0x7effc12f3c80>,17,18,[3 5],18,-1,36,-1,18
1,<environment.Job instance at 0x7effc12f34b0>,18,19,[3 9],19,-1,38,-1,19
1,<environment.Job instance at 0x7effc12f35f0>,21,18,[1 8],22,-1,40,-1,22
1,<environment.Job instance at 0x7effc0fb0b40>,23,17,[6 4],24,-1,41,-1,24
1,<environment.Job instance at 0x7effc0fb0910>,24,26,[8 5],25,-1,51,-1,25
1,<environment.Job instance at 0x7effc0fb0d20>,25,12,[9 4],26,-1,40,-1,28
1,<environment.Job instance at 0x7effc07234b0>,27,17,[4 8],28,-1,45,-1,28
1,<environment.Job instance at 0x7effc0723370>,33,24,[3 7],34,-1,58,-1,34
1,<environment.Job instance at 0x7effc0723b90>,34,16,[10  1],35,-1,51,-1,35
1,<environment.Job instance at 0x7effc0723780>,35,18,[7 3],36,-1,54,-1,36
1,<environment.Job instance at 0x7effc0a88eb0>,39,18,[3 7],40,-1,58,-1,40
1,<environment.Job instance at 0x7effc0a88a50>,45,18,[6 3],46,-1,64,-1,46
1,<environment.Job instance at 0x7effc0a885a0>,48,18,[5 8],49,-1,69,-1,51
1,<environment.Job instance at 0x7effc0a88c80>,51,18,[10  3],52,-1,74,-1,56
1,<environment.Job instance at 0x7effc1d66960>,56,13,[9 3],57,-1,70,-1,57
1,<environment.Job instance at 0x7effc1d66b90>,57,14,[10  2],58,-1,72,-1,58
1,<environment.Job instance at 0x7effc1d66e10>,58,15,[4 6],59,-1,74,-1,59
1,<environment.Job instance at 0x7effc1d66d20>,66,18,[6 4],67,-1,85,-1,67
1,<environment.Job instance at 0x7effc1427820>,67,18,[ 5 10],68,-1,86,-1,68
1,<environment.Job instance at 0x7effc0f74550>,71,27,[4 5],72,-1,99,-1,72
1,<environment.Job instance at 0x7effc0f745f0>,72,14,[5 7],73,-1,87,-1,73
1,<environment.Job instance at 0x7effc0f74f50>,73,15,[7 4],74,-1,89,-1,74
1,<environment.Job instance at 0x7effc0f74af0>,74,14,[3 5],75,-1,89,-1,75
1,<environment.Job instance at 0x7effc0f74140>,75,18,[1 8],76,-1,94,-1,76
1,<environment.Job instance at 0x7effc0f74a50>,76,27,[10  5],77,-1,104,-1,77
1,<environment.Job instance at 0x7effc1b3e280>,79,13,[5 7],80,-1,93,-1,80
1,<environment.Job instance at 0x7effc1b3e050>,80,15,[10  1],81,-1,96,-1,81
1,<environment.Job instance at 0x7effc1b3e320>,81,15,[2 9],82,-1,97,-1,82
1,<environment.Job instance at 0x7effc1b3e1e0>,82,17,[5 5],83,-1,100,-1,83
1,<environment.Job instance at 0x7effc1b3e910>,85,17,[9 3],86,-1,103,-1,86
1,<environment.Job instance at 0x7effc1b3ed20>,90,15,[8 1],91,-1,107,-1,92
1,<environment.Job instance at 0x7effc0fa1b90>,97,14,[6 1],98,-1,112,-1,98
1,<environment.Job instance at 0x7effc1b94af0>,98,15,[7 3],99,-1,114,-1,99
1,<environment.Job instance at 0x7effc1b94aa0>,100,14,[5 5],101,-1,115,-1,101
1,<environment.Job instance at 0x7effc12445f0>,110,16,[3 9],111,-1,129,-1,113
1,<environment.Job instance at 0x7effc1244e10>,111,16,[5 2],112,-1,129,-1,113
1,<environment.Job instance at 0x7effc1244960>,112,1,[7 3],113,-1,114,-1,113
1,<environment.Job instance at 0x7effc12443c0>,113,21,[9 1],114,-1,135,-1,114
1,<environment.Job instance at 0x7effc12440a0>,114,18,[2 6],115,-1,133,-1,115
1,<environment.Job instance at 0x7effc1244eb0>,115,23,[4 8],116,-1,139,-1,116
1,<environment.Job instance at 0x7effc09db1e0>,117,17,[8 3],118,-1,135,-1,118
1,<environment.Job instance at 0x7effc1b941e0>,120,16,[2 8],121,-1,141,-1,125
1,<environment.Job instance at 0x7effc1b94fa0>,121,27,[6 2],122,-1,157,-1,130
1,<environment.Job instance at 0x7effc12fd3c0>,55,25,[ 4 10],56,-1,155,-1,130
1,<environment.Job instance at 0x7effcac6a960>,129,12,[11  3],130,-1,144,-1,132
1,<environment.Job instance at 0x7effcac6a050>,130,13,[6 4],131,-1,145,-1,132
1,<environment.Job instance at 0x7effcac6a820>,127,12,[ 3 10],128,-1,144,-1,132
1,<environment.Job instance at 0x7effcac47500>,133,17,[10  2],134,-1,152,-1,135
1,<environment.Job instance at 0x7effc1b94a00>,123,13,[13  1],124,-1,148,-1,135
1,<environment.Job instance at 0x7effc1125730>,142,22,[8 5],143,-1,168,-1,146
1,<environment.Job instance at 0x7effc1125be0>,143,27,[6 5],144,-1,173,-1,146
1,<environment.Job instance at 0x7effc14272d0>,5,23,[1 8],6,-1,42,-1,19
1,<environment.Job instance at 0x7effc0f74b90>,8,13,[ 5 13],9,-1,32,-1,19
1,<environment.Job instance at 0x7effc1b3e6e0>,12,3,[ 5 13],13,-1,23,-1,20
1,<environment.Job instance at 0x7effc1589b90>,24,26,[8 5],25,-1,68,-1,42
1,<environment.Job instance at 0x7effc13bc730>,33,24,[3 7],34,-1,98,-1,74
1,<environment.Job instance at 0x7effc17161e0>,41,3,[14  4],42,-1,97,-1,94
1,<environment.Job instance at 0x7effcac6ca50>,42,16,[ 4 12],43,-1,110,-1,94
1,<environment.Job instance at 0x7effc1414eb0>,46,15,[14  5],47,-1,113,-1,98
1,<environment.Job instance at 0x7effc0ea6dc0>,55,25,[ 4 10],56,-1,175,-1,150
1,<environment.Job instance at 0x7effc1fbcaf0>,59,16,[ 3 12],60,-1,167,-1,151
1,<environment.Job instance at 0x7effc12f3230>,68,2,[ 5 11],69,-1,175,-1,173
1,<environment.Job instance at 0x7effc12f3af0>,71,27,[4 5],72,-1,217,-1,190
1,<environment.Job instance at 0x7effc1244be0>,76,27,[10  5],77,-1,263,-1,236
1,<environment.Job instance at 0x7effc0907370>,86,14,[13  3],87,-1,265,-1,251
1,<environment.Job instance at 0x7effc14e3e60>,99,2,[ 5 11],100,-1,301,-1,299
1,<environment.Job instance at 0x7effc197eaf0>,115,23,[4 8],116,-1,366,-1,343
1,<environment.Job instance at 0x7effc197e0f0>,119,13,[ 3 14],120,-1,356,-1,343
1,<environment.Job instance at 0x7effc197e960>,121,27,[6 2],122,-1,386,-1,359
1,<environment.Job instance at 0x7effc197e3c0>,123,13,[13  1],124,-1,372,-1,359
1,<environment.Job instance at 0x7effc131f0a0>,129,12,[11  3],130,-1,386,-1,374
1,<environment.Job instance at 0x7effc131fd70>,138,27,[9 1],139,-1,451,-1,424
1,<environment.Job instance at 0x7effc0d07d20>,141,16,[14  3],142,-1,440,-1,424
1,<environment.Job instance at 0x7effc0d07be0>,143,27,[6 5],144,-1,454,-1,427
1,<environment.Job instance at 0x7effc0d07d70>,145,26,[6 1],146,-1,456,-1,430
1,<environment.Job instance at 0x7effc0d07730>,150,26,[4 5],151,-1,477,-1,451
1,<environment.Job instance at 0x7effc1eedeb0>,157,15,[12  1],158,-1,496,-1,481
1,<environment.Job instance at 0x7effc0d07410>,159,23,[4 6],160,-1,508,-1,485
1,<environment.Job instance at 0x7effc0d07870>,160,1,[ 2 14],161,-1,486,-1,485
1,<environment.Job instance at 0x7effc1379050>,2,16,[2 9],3,-1,20,-1,4
1,<environment.Job instance at 0x7effc1379280>,4,15,[9 3],5,-1,20,-1,5
1,<environment.Job instance at 0x7effc13790a0>,5,15,[4 8],6,-1,21,-1,6
1,<environment.Job instance at 0x7effc1e69eb0>,3,16,[1 8],4,-1,23,-1,7
1,<environment.Job instance at 0x7effc13795f0>,7,25,[9 5],8,-1,33,-1,8
1,<environment.Job instance at 0x7effc1394460>,21,14,[9 1],22,-1,36,-1,22
1,<environment.Job instance at 0x7effc1394730>,22,13,[8 3],23,-1,36,-1,23
1,<environment.Job instance at 0x7effc13945a0>,23,15,[4 9],24,-1,39,-1,24
1,<environment.Job instance at 0x7effc1394870>,25,14,[6 2],26,-1,40,-1,26
1,<environment.Job instance at 0x7effc1394a50>,26,18,[2 5],27,-1,45,-1,27
1,<environment.Job instance at 0x7effc1394af0>,28,27,[4 6],29,-1,56,-1,29
1,<environment.Job instance at 0x7effc13950f0>,33,12,[10  3],34,-1,47,-1,35
1,<environment.Job instance at 0x7effc13952d0>,34,14,[10  2],35,-1,51,-1,37
1,<environment.Job instance at 0x7effc1e98d70>,41,18,[1 6],42,-1,60,-1,42
1,<environment.Job instance at 0x7effc1e98870>,43,14,[8 5],44,-1,58,-1,44
1,<environment.Job instance at 0x7effc1e985a0>,45,18,[5 8],46,-1,64,-1,46
1,<environment.Job instance at 0x7effc1e981e0>,47,16,[3 5],48,-1,64,-1,48
1,<environment.Job instance at 0x7effc1eafd70>,49,18,[5 6],50,-1,68,-1,50
1,<environment.Job instance at 0x7effc1e98190>,52,16,[ 2 13],53,-1,83,-1,67
1,<environment.Job instance at 0x7effc1eaf370>,58,16,[10  1],59,-1,83,-1,67
1,<environment.Job instance at 0x7effc1eaff50>,55,16,[2 7],56,-1,87,-1,71
1,<environment.Job instance at 0x7effc131a4b0>,63,16,[8 3],64,-1,92,-1,76
1,<environment.Job instance at 0x7effc1eafc80>,50,26,[ 5 14],51,-1,103,-1,77
1,<environment.Job instance at 0x7effc1307dc0>,65,18,[4 6],66,-1,95,-1,77
1,<environment.Job instance at 0x7effc1eaf140>,56,16,[4 6],57,-1,96,-1,80
1,<environment.Job instance at 0x7effc07e2640>,69,20,[8 1],70,-1,101,-1,81
1,<environment.Job instance at 0x7effc12471e0>,70,28,[5 3],71,-1,109,-1,81
1,<environment.Job instance at 0x7effc07fde60>,75,17,[5 8],76,-1,98,-1,81
1,<environment.Job instance at 0x7effc07faa00>,80,18,[2 5],81,-1,99,-1,81
1,<environment.Job instance at 0x7effc12f5410>,66,15,[5 2],67,-1,97,-1,82
1,<environment.Job instance at 0x7effc07fddc0>,77,12,[2 8],78,-1,94,-1,82
1,<environment.Job instance at 0x7effc07fa3c0>,81,12,[10  4],82,-1,94,-1,82
1,<environment.Job instance at 0x7effc07fa230>,82,16,[5 1],83,-1,100,-1,84
1,<environment.Job instance at 0x7effc07fa9b0>,84,16,[3 6],85,-1,101,-1,85
1,<environment.Job instance at 0x7effc07fad20>,85,14,[2 6],86,-1,100,-1,86
1,<environment.Job instance at 0x7effc07fab90>,86,18,[3 5],87,-1,105,-1,87
1,<environment.Job instance at 0x7effc0801230>,93,27,[6 3],94,-1,121,-1,94
1,<environment.Job instance at 0x7effc0801370>,94,14,[5 6],95,-1,109,-1,95
1,<environment.Job instance at 0x7effc0801050>,95,14,[7 3],96,-1,110,-1,96
1,<environment.Job instance at 0x7effc0801410>,96,15,[9 1],97,-1,112,-1,97
1,<environment.Job instance at 0x7effc1eb2730>,98,17,[7 3],99,-1,116,-1,99
1,<environment.Job instance at 0x7effc1eb2fa0>,99,15,[1 7],100,-1,115,-1,100
1,<environment.Job instance at 0x7effc1e84cd0>,102,16,[8 2],103,-1,119,-1,103
1,<environment.Job instance at 0x7effc12cb550>,103,17,[4 5],104,-1,121,-1,104
1,<environment.Job instance at 0x7effc0819050>,105,14,[10  5],106,-1,120,-1,106
1,<environment.Job instance at 0x7effc0819cd0>,108,14,[9 1],109,-1,123,-1,109
1,<environment.Job instance at 0x7effc0819fa0>,109,28,[3 9],110,-1,142,-1,114
1,<environment.Job instance at 0x7effc08195a0>,111,18,[ 3 10],112,-1,132,-1,114
1,<environment.Job instance at 0x7effc0819e10>,110,13,[10  2],111,-1,127,-1,114
1,<environment.Job instance at 0x7effc0819c80>,115,25,[10  4],116,-1,141,-1,116
1,<environment.Job instance at 0x7effc0819460>,113,16,[5 3],114,-1,133,-1,117
1,<environment.Job instance at 0x7effc0819b40>,116,17,[ 5 10],117,-1,134,-1,117
1,<environment.Job instance at 0x7effc08198c0>,117,17,[1 9],118,-1,135,-1,118
1,<environment.Job instance at 0x7effc0819eb0>,118,17,[1 7],119,-1,136,-1,119
1,<environment.Job instance at 0x7effc1eb3320>,123,17,[6 4],124,-1,141,-1,124
1,<environment.Job instance at 0x7effc1eb3500>,124,16,[2 6],125,-1,141,-1,125
1,<environment.Job instance at 0x7effc1eb34b0>,130,18,[7 3],131,-1,149,-1,131
1,<environment.Job instance at 0x7effc1e9c410>,133,17,[5 8],134,-1,151,-1,134
1,<environment.Job instance at 0x7effc1ea1550>,139,22,[ 4 10],140,-1,162,-1,140
1,<environment.Job instance at 0x7effc12c7280>,142,17,[5 5],143,-1,160,-1,143
1,<environment.Job instance at 0x7effc12c7d70>,144,12,[10  5],145,-1,158,-1,146
1,<environment.Job instance at 0x7effc0819320>,112,12,[13  5],113,-1,162,-1,150
1,<environment.Job instance at 0x7effc12c7500>,145,20,[7 3],146,-1,172,-1,152
1,<environment.Job instance at 0x7effc08009b0>,150,18,[6 2],151,-1,170,-1,152
1,<environment.Job instance at 0x7effc1eb3550>,125,28,[5 2],126,-1,180,-1,152
1,<environment.Job instance at 0x7effc0800af0>,149,18,[3 7],150,-1,172,-1,154
1,<environment.Job instance at 0x7effc0800370>,153,12,[3 7],154,-1,167,-1,155
1,<environment.Job instance at 0x7effc08007d0>,157,17,[2 8],158,-1,175,-1,158
1,<environment.Job instance at 0x7effc0800c80>,156,13,[9 2],157,-1,172,-1,159
1,<environment.Job instance at 0x7effc0d79af0>,161,16,[10  2],162,-1,178,-1,162
1,<environment.Job instance at 0x7effc1c7a140>,163,16,[1 7],164,-1,180,-1,164
1,<environment.Job instance at 0x7effca683550>,164,16,[12  4],165,-1,181,-1,165
1,<environment.Job instance at 0x7effc08001e0>,158,14,[4 8],159,-1,179,-1,165
1,<environment.Job instance at 0x7effc12a05a0>,166,15,[7 1],167,-1,183,-1,168
1,<environment.Job instance at 0x7effc1ea1050>,141,15,[5 6],142,-1,183,-1,168
1,<environment.Job instance at 0x7effc12a0320>,168,16,[11  4],169,-1,185,-1,169
1,<environment.Job instance at 0x7effc1eaf5a0>,8,2,[ 1 13],9,-1,11,-1,9
1,<environment.Job instance at 0x7effc07e2730>,7,25,[9 5],8,-1,45,-1,20
1,<environment.Job instance at 0x7effc08010a0>,15,15,[ 3 14],16,-1,37,-1,22
1,<environment.Job instance at 0x7effc0819a00>,18,15,[ 5 14],19,-1,39,-1,24
1,<environment.Job instance at 0x7effc0800a50>,27,2,[ 1 11],28,-1,54,-1,52
1,<environment.Job instance at 0x7effc12a0050>,28,27,[4 6],29,-1,95,-1,68
1,<environment.Job instance at 0x7effc0d07960>,50,26,[ 5 14],51,-1,149,-1,123
1,<environment.Job instance at 0x7effc0d07140>,52,16,[ 2 13],53,-1,152,-1,136
1,<environment.Job instance at 0x7effc0d07550>,53,27,[2 5],54,-1,165,-1,138
1,<environment.Job instance at 0x7effc197e640>,70,28,[5 3],71,-1,234,-1,206
1,<environment.Job instance at 0x7effc197eaa0>,73,1,[13  4],74,-1,208,-1,207
1,<environment.Job instance at 0x7effc14e3370>,93,27,[6 3],94,-1,316,-1,289
1,<environment.Job instance at 0x7effc159a9b0>,100,2,[11  1],101,-1,296,-1,294
1,<environment.Job instance at 0x7effc12f1c80>,109,28,[3 9],110,-1,366,-1,338
1,<environment.Job instance at 0x7effc12440f0>,112,12,[13  5],113,-1,351,-1,339
1,<environment.Job instance at 0x7effc12f3f00>,115,25,[10  4],116,-1,393,-1,368
1,<environment.Job instance at 0x7effc1fbc690>,125,28,[5 2],126,-1,424,-1,396
1,<environment.Job instance at 0x7effc0a9f500>,164,16,[12  4],165,-1,554,-1,538
1,<environment.Job instance at 0x7effc1b3ea50>,168,16,[11  4],169,-1,560,-1,544
1,<environment.Job instance at 0x7effc1eac7d0>,3,26,[9 5],4,-1,30,-1,4
1,<environment.Job instance at 0x7effc0d790f0>,12,16,[ 5 10],13,-1,29,-1,13
1,<environment.Job instance at 0x7effc12cbd20>,16,13,[ 1 10],17,-1,31,-1,18
1,<environment.Job instance at 0x7effc12cb140>,20,14,[10  2],21,-1,35,-1,21
1,<environment.Job instance at 0x7effc12cb640>,21,13,[ 2 13],22,-1,35,-1,22
1,<environment.Job instance at 0x7effc12cb230>,24,19,[3 6],25,-1,44,-1,25
1,<environment.Job instance at 0x7effc12cbaa0>,25,17,[5 3],26,-1,43,-1,26
1,<environment.Job instance at 0x7effc12cbe10>,27,13,[2 9],28,-1,41,-1,28
1,<environment.Job instance at 0x7effc12bd230>,29,17,[8 4],30,-1,47,-1,30
1,<environment.Job instance at 0x7effc12bd690>,30,15,[4 8],31,-1,46,-1,31
1,<environment.Job instance at 0x7effc12bdc30>,31,16,[3 6],32,-1,48,-1,32
1,<environment.Job instance at 0x7effc12bd410>,32,12,[11  5],33,-1,45,-1,33
1,<environment.Job instance at 0x7effc12cb5f0>,17,18,[7 4],18,-1,54,-1,36
1,<environment.Job instance at 0x7effc12bdaf0>,41,15,[5 5],42,-1,57,-1,42
1,<environment.Job instance at 0x7effc12bd4b0>,42,16,[3 5],43,-1,59,-1,43
1,<environment.Job instance at 0x7effc12c4780>,43,18,[8 4],44,-1,62,-1,44
1,<environment.Job instance at 0x7effc12c4be0>,46,14,[6 5],47,-1,61,-1,47
1,<environment.Job instance at 0x7effc12c4410>,48,15,[7 4],49,-1,65,-1,50
1,<environment.Job instance at 0x7effc12c4500>,50,15,[2 7],51,-1,66,-1,51
1,<environment.Job instance at 0x7effc12c4820>,51,12,[5 8],52,-1,65,-1,53
1,<environment.Job instance at 0x7effc12c4aa0>,54,13,[5 6],55,-1,68,-1,55
1,<environment.Job instance at 0x7effc12a05f0>,64,17,[ 3 11],65,-1,83,-1,66
1,<environment.Job instance at 0x7effc12a01e0>,66,24,[8 4],67,-1,91,-1,67
1,<environment.Job instance at 0x7effc12a06e0>,67,17,[8 3],68,-1,85,-1,68
1,<environment.Job instance at 0x7effc1ea6320>,69,15,[3 9],70,-1,85,-1,70
1,<environment.Job instance at 0x7effc12a0910>,65,16,[9 5],66,-1,89,-1,73
1,<environment.Job instance at 0x7effc1ea6e60>,74,22,[10  1],75,-1,100,-1,78
1,<environment.Job instance at 0x7effc1ea62d0>,80,18,[1 5],81,-1,99,-1,81
1,<environment.Job instance at 0x7effc1ea68c0>,77,17,[12  1],78,-1,121,-1,104
1,<environment.Job instance at 0x7effc1eaedc0>,92,28,[9 3],93,-1,132,-1,104
1,<environment.Job instance at 0x7effc1eaef00>,95,18,[5 9],96,-1,122,-1,104
1,<environment.Job instance at 0x7effc1eaea00>,94,16,[8 3],95,-1,123,-1,107
1,<environment.Job instance at 0x7effc12c4960>,3,26,[9 5],4,-1,30,-1,4
1,<environment.Job instance at 0x7effc1ea6cd0>,6,3,[ 2 12],7,-1,10,-1,7
1,<environment.Job instance at 0x7effc11089b0>,8,16,[12  5],9,-1,25,-1,9
1,<environment.Job instance at 0x7effc1565050>,9,25,[4 9],10,-1,35,-1,10
1,<environment.Job instance at 0x7effc176f320>,13,2,[ 3 12],14,-1,16,-1,14
1,<environment.Job instance at 0x7effc0dcf2d0>,19,18,[14  4],20,-1,38,-1,20
1,<environment.Job instance at 0x7effc0e29dc0>,21,13,[ 2 13],22,-1,35,-1,22
1,<environment.Job instance at 0x7effc12e86e0>,22,3,[ 2 14],23,-1,26,-1,23
1,<environment.Job instance at 0x7effcac65910>,32,12,[11  5],33,-1,69,-1,57
1,<environment.Job instance at 0x7effc12444b0>,59,13,[11  2],60,-1,169,-1,156
1,<environment.Job instance at 0x7effc1244be0>,62,2,[ 5 13],63,-1,163,-1,161
1,<environment.Job instance at 0x7effc07c7140>,64,17,[ 3 11],65,-1,180,-1,163
1,<environment.Job instance at 0x7effca8dd960>,66,24,[8 4],67,-1,192,-1,168
1,<environment.Job instance at 0x7effc0c3adc0>,73,1,[ 5 11],74,-1,187,-1,186
1,<environment.Job instance at 0x7effc1b7f550>,77,17,[12  1],78,-1,209,-1,192
1,<environment.Job instance at 0x7effc1cbed70>,82,15,[ 2 13],83,-1,220,-1,205
1,<environment.Job instance at 0x7effc0bf2af0>,85,1,[14  4],86,-1,218,-1,217
1,<environment.Job instance at 0x7effc1e7bbe0>,92,28,[9 3],93,-1,262,-1,234
1,<environment.Job instance at 0x7effc0c5d8c0>,99,17,[ 2 13],100,-1,269,-1,252
1,<environment.Job instance at 0x7effc0c1f640>,105,18,[14  5],106,-1,298,-1,280
1,<environment.Job instance at 0x7effc1636640>,107,3,[12  1],108,-1,290,-1,287
1,<environment.Job instance at 0x7effc07552d0>,117,27,[9 3],118,-1,351,-1,324
1,<environment.Job instance at 0x7effc10cff50>,119,16,[14  4],120,-1,340,-1,324
1,<environment.Job instance at 0x7effc07556e0>,120,3,[ 3 13],121,-1,327,-1,324
1,<environment.Job instance at 0x7effc14b2960>,140,1,[ 1 11],141,-1,409,-1,408
1,<environment.Job instance at 0x7effc14b49b0>,150,3,[14  3],151,-1,451,-1,448
1,<environment.Job instance at 0x7effcad48050>,4,16,[10  5],5,-1,23,-1,7
1,<environment.Job instance at 0x7effcad48820>,6,16,[ 2 10],7,-1,25,-1,9
1,<environment.Job instance at 0x7effcad48c30>,9,16,[3 8],10,-1,27,-1,11
1,<environment.Job instance at 0x7effc1122eb0>,10,15,[7 3],11,-1,26,-1,11
1,<environment.Job instance at 0x7effc1122af0>,11,18,[4 9],12,-1,31,-1,13
1,<environment.Job instance at 0x7effc1900460>,22,17,[ 5 13],23,-1,67,-1,50
1,<environment.Job instance at 0x7effc1900fa0>,26,18,[6 5],27,-1,70,-1,52
1,<environment.Job instance at 0x7effca9f9a00>,32,16,[5 8],33,-1,68,-1,52
1,<environment.Job instance at 0x7effca9f9460>,33,22,[7 2],34,-1,74,-1,52
1,<environment.Job instance at 0x7effc19004b0>,30,13,[1 7],31,-1,65,-1,52
1,<environment.Job instance at 0x7effca9f9d70>,38,14,[ 5 10],39,-1,66,-1,52
1,<environment.Job instance at 0x7effc091f3c0>,16,1,[ 5 14],17,-1,35,-1,34
1,<environment.Job instance at 0x7effc08cb460>,17,18,[ 5 13],18,-1,52,-1,34
1,<environment.Job instance at 0x7effc14b4140>,22,17,[ 5 13],23,-1,70,-1,53
1,<environment.Job instance at 0x7effc14b4460>,23,12,[ 5 12],24,-1,65,-1,53
1,<environment.Job instance at 0x7effc10cff50>,41,18,[14  1],42,-1,137,-1,119
1,<environment.Job instance at 0x7effc0c1ff00>,48,18,[ 1 13],49,-1,163,-1,145
1,<environment.Job instance at 0x7effc1e7bc30>,55,26,[ 2 12],56,-1,211,-1,185
1,<environment.Job instance at 0x7effc0bf2af0>,61,21,[ 5 14],62,-1,226,-1,205
1,<environment.Job instance at 0x7effc1e6b780>,62,1,[ 4 14],63,-1,206,-1,205
1,<environment.Job instance at 0x7effc1244a00>,70,22,[13  5],71,-1,266,-1,244
1,<environment.Job instance at 0x7effca645a50>,79,2,[ 3 11],80,-1,267,-1,265
1,<environment.Job instance at 0x7effc0a9fe10>,88,14,[ 2 14],89,-1,303,-1,289
1,<environment.Job instance at 0x7effc15656e0>,97,17,[ 4 11],98,-1,364,-1,347
1,<environment.Job instance at 0x7effc1565c80>,98,12,[ 4 12],99,-1,359,-1,347
1,<environment.Job instance at 0x7effc0e3b960>,106,16,[ 5 14],107,-1,381,-1,365
1,<environment.Job instance at 0x7effc0e3bdc0>,111,14,[13  1],112,-1,410,-1,396
1,<environment.Job instance at 0x7effc1059b40>,124,28,[8 3],125,-1,493,-1,465
1,<environment.Job instance at 0x7effc10594b0>,128,27,[6 4],129,-1,492,-1,465
1,<environment.Job instance at 0x7effc2092190>,146,24,[5 6],147,-1,527,-1,503
1,<environment.Job instance at 0x7effc10f7730>,152,25,[ 5 11],153,-1,545,-1,520
1,<environment.Job instance at 0x7effc1c8e0a0>,163,13,[ 3 13],164,-1,575,-1,562
1,<environment.Job instance at 0x7f4c639e16e0>,0,18,[ 2 10],1,-1,20,-1,2
1,<environment.Job instance at 0x7f4c5a3f1a50>,3,18,[ 3 10],4,-1,22,-1,4
1,<environment.Job instance at 0x7f4c5a3f1be0>,4,18,[10  4],5,-1,23,-1,5
1,<environment.Job instance at 0x7f4c5a3f1af0>,5,13,[5 9],6,-1,19,-1,6
1,<environment.Job instance at 0x7f4c5a3f1c80>,6,12,[11  4],7,-1,19,-1,7
1,<environment.Job instance at 0x7f4c5a3f1dc0>,8,17,[ 2 10],9,-1,26,-1,9
1,<environment.Job instance at 0x7f4c5a3f1f00>,9,17,[ 4 10],10,-1,27,-1,10
1,<environment.Job instance at 0x7f4c5a3f42d0>,13,13,[1 8],14,-1,27,-1,14
1,<environment.Job instance at 0x7f4c5a3f4410>,14,12,[3 7],15,-1,27,-1,15
1,<environment.Job instance at 0x7f4c5a3f46e0>,18,16,[8 5],19,-1,35,-1,19
1,<environment.Job instance at 0x7f4c5a3f4eb0>,26,22,[2 9],27,-1,49,-1,27
1,<environment.Job instance at 0x7f4c5a3f7190>,31,17,[4 9],32,-1,49,-1,32
1,<environment.Job instance at 0x7f4c5a3f7550>,32,17,[9 3],33,-1,50,-1,33
1,<environment.Job instance at 0x7f4c5a3f78c0>,35,16,[8 1],36,-1,52,-1,36
1,<environment.Job instance at 0x7f4c5a3f7870>,37,14,[5 5],38,-1,52,-1,38
1,<environment.Job instance at 0x7f4c5a3f7aa0>,39,18,[5 8],40,-1,58,-1,40
1,<environment.Job instance at 0x7f4c5a3f90a0>,43,28,[6 4],44,-1,72,-1,44
1,<environment.Job instance at 0x7f4c5a3f91e0>,44,17,[ 5 12],45,-1,62,-1,45
1,<environment.Job instance at 0x7f4c5a3f9190>,45,16,[6 2],46,-1,62,-1,46
1,<environment.Job instance at 0x7f4c639e18c0>,1,15,[ 1 14],2,-1,63,-1,48
1,<environment.Job instance at 0x7f4c5a3f95f0>,50,27,[9 1],51,-1,78,-1,51
1,<environment.Job instance at 0x7f4c5a3f9b40>,53,18,[ 4 12],54,-1,72,-1,54
1,<environment.Job instance at 0x7f4c5a3f9c30>,54,14,[1 7],55,-1,69,-1,55
1,<environment.Job instance at 0x7f4c5a3f9af0>,55,17,[4 7],56,-1,73,-1,56
1,<environment.Job instance at 0x7f4c5a3f9d20>,56,18,[4 5],57,-1,75,-1,57
1,<environment.Job instance at 0x7f4c5a3f9eb0>,59,14,[ 2 10],60,-1,74,-1,60
1,<environment.Job instance at 0x7f4c5a3fd280>,62,20,[9 1],63,-1,84,-1,64
1,<environment.Job instance at 0x7f4c5a3fd5a0>,67,26,[5 4],68,-1,94,-1,68
1,<environment.Job instance at 0x7f4c5a3fd910>,68,22,[5 6],69,-1,91,-1,69
1,<environment.Job instance at 0x7f4c5a3fd870>,69,13,[7 2],70,-1,83,-1,70
1,<environment.Job instance at 0x7f4c5a3fda00>,70,18,[5 5],71,-1,89,-1,71
1,<environment.Job instance at 0x7f4c5a3fdb40>,72,14,[9 1],73,-1,87,-1,73
1,<environment.Job instance at 0x7f4c5a3fdcd0>,76,13,[1 5],77,-1,90,-1,77
1,<environment.Job instance at 0x7f4c5a3fe140>,77,15,[4 7],78,-1,93,-1,78
1,<environment.Job instance at 0x7f4c5a3fe050>,78,19,[8 4],79,-1,98,-1,79
1,<environment.Job instance at 0x7f4c5a3fe280>,79,17,[2 7],80,-1,97,-1,80
1,<environment.Job instance at 0x7f4c63a27910>,91,16,[5 8],92,-1,108,-1,92
1,<environment.Job instance at 0x7f4c5a3e8c30>,95,23,[3 7],96,-1,123,-1,100
1,<environment.Job instance at 0x7f4c5a3fd190>,63,15,[1 5],64,-1,115,-1,100
1,<environment.Job instance at 0x7f4c5a3e8a50>,100,18,[7 5],101,-1,119,-1,101
1,<environment.Job instance at 0x7f4c5a466820>,103,17,[5 6],104,-1,122,-1,105
1,<environment.Job instance at 0x7f4c5a57e690>,108,20,[5 7],109,-1,133,-1,113
1,<environment.Job instance at 0x7f4c5a3e8640>,102,27,[ 3 13],103,-1,140,-1,113
1,<environment.Job instance at 0x7f4c5a3fe3c0>,81,17,[ 4 14],82,-1,130,-1,113
1,<environment.Job instance at 0x7f4c5a59a550>,104,17,[5 4],105,-1,130,-1,113
1,<environment.Job instance at 0x7f4c5a494640>,116,15,[9 2],117,-1,132,-1,117
1,<environment.Job instance at 0x7f4c5a4839b0>,110,20,[5 7],111,-1,138,-1,118
1,<environment.Job instance at 0x7f4c5a494190>,117,18,[ 3 12],118,-1,136,-1,118
1,<environment.Job instance at 0x7f4c5a494230>,119,16,[1 8],120,-1,136,-1,120
1,<environment.Job instance at 0x7f4c5a494b40>,121,18,[11  5],122,-1,140,-1,122
1,<environment.Job instance at 0x7f4c5a419910>,122,14,[14  1],123,-1,137,-1,123
1,<environment.Job instance at 0x7f4c5a512050>,111,18,[ 3 13],112,-1,309,-1,291
1,<environment.Job instance at 0x7f4c5a4a0320>,158,16,[3 9],159,-1,307,-1,291
1,<environment.Job instance at 0x7f4c5a4a0230>,167,18,[5 2],168,-1,346,-1,328
1,<environment.Job instance at 0x7f4c5a548140>,168,18,[4 6],169,-1,346,-1,328
1,<environment.Job instance at 0x7f4c5a425550>,171,14,[5 3],172,-1,342,-1,328
1,<environment.Job instance at 0x7f4c5a452320>,172,1,[ 5 10],173,-1,329,-1,328
1,<environment.Job instance at 0x7f4c5a49f370>,173,12,[1 7],174,-1,340,-1,328
1,<environment.Job instance at 0x7f4c5a3ce820>,175,25,[3 9],176,-1,353,-1,328
1,<environment.Job instance at 0x7f4c5a42c690>,177,13,[ 4 10],178,-1,341,-1,328
1,<environment.Job instance at 0x7f4c5a4a0640>,166,22,[11  3],167,-1,350,-1,328
1,<environment.Job instance at 0x7f4c5a3f4500>,1,15,[ 1 14],2,-1,17,-1,2
1,<environment.Job instance at 0x7f4c5a3f7730>,6,12,[11  4],7,-1,19,-1,7
1,<environment.Job instance at 0x7f4c5a476cd0>,19,17,[12  3],20,-1,67,-1,50
1,<environment.Job instance at 0x7f4c5a519230>,22,2,[12  3],23,-1,62,-1,60
1,<environment.Job instance at 0x7f4c5a3e1960>,43,28,[6 4],44,-1,166,-1,138
1,<environment.Job instance at 0x7f4c5a3e1fa0>,44,17,[ 5 12],45,-1,155,-1,138
1,<environment.Job instance at 0x7f4c5a3f1e10>,50,27,[9 1],51,-1,179,-1,152
1,<environment.Job instance at 0x7f4c5a387050>,52,3,[ 3 11],53,-1,155,-1,152
1,<environment.Job instance at 0x7f4c5a3877d0>,53,18,[ 4 12],54,-1,170,-1,152
1,<environment.Job instance at 0x7f4c5a387e10>,60,24,[ 3 10],61,-1,209,-1,185
1,<environment.Job instance at 0x7f4c5a38e2d0>,67,26,[5 4],68,-1,226,-1,200
1,<environment.Job instance at 0x7f4c5a38ec80>,81,17,[ 4 14],82,-1,256,-1,239
1,<environment.Job instance at 0x7f4c5a38ea00>,85,19,[14  4],86,-1,260,-1,241
1,<environment.Job instance at 0x7f4c5a3905a0>,95,23,[3 7],96,-1,294,-1,271
1,<environment.Job instance at 0x7f4c5a390b40>,102,27,[ 3 13],103,-1,316,-1,289
1,<environment.Job instance at 0x7f4c5a393320>,111,18,[ 3 13],112,-1,333,-1,315
1,<environment.Job instance at 0x7f4c5a3935f0>,117,18,[ 3 12],118,-1,348,-1,330
1,<environment.Job instance at 0x7f4c5a393870>,121,18,[11  5],122,-1,359,-1,341
1,<environment.Job instance at 0x7f4c5a3939b0>,122,14,[14  1],123,-1,355,-1,341
1,<environment.Job instance at 0x7f4c5a3952d0>,135,15,[ 3 14],136,-1,411,-1,396
1,<environment.Job instance at 0x7f4c5a395410>,137,12,[14  5],138,-1,408,-1,396
1,<environment.Job instance at 0x7f4c5a399960>,166,22,[11  3],167,-1,533,-1,511
1,<environment.Job instance at 0x7f4c5a399e10>,175,25,[3 9],176,-1,605,-1,580
1,<environment.Job instance at 0x7f4c5a3876e0>,5,17,[10  5],6,-1,23,-1,6
1,<environment.Job instance at 0x7f4c59d8d9b0>,6,26,[9 1],7,-1,33,-1,7
1,<environment.Job instance at 0x7f4c59dcc500>,8,14,[8 5],9,-1,23,-1,9
1,<environment.Job instance at 0x7f4c59dcc280>,9,17,[9 2],10,-1,28,-1,11
1,<environment.Job instance at 0x7f4c59dcca00>,12,14,[8 4],13,-1,27,-1,13
1,<environment.Job instance at 0x7f4c59dcb820>,10,18,[5 1],11,-1,31,-1,13
1,<environment.Job instance at 0x7f4c59dd6b90>,14,17,[10  5],15,-1,33,-1,16
1,<environment.Job instance at 0x7f4c59dd62d0>,16,23,[5 8],17,-1,40,-1,17
1,<environment.Job instance at 0x7f4c59dcc550>,15,16,[ 3 10],16,-1,34,-1,18
1,<environment.Job instance at 0x7f4c59d8e960>,22,14,[9 2],23,-1,38,-1,24
1,<environment.Job instance at 0x7f4c59dd4d70>,24,17,[10  2],25,-1,42,-1,25
1,<environment.Job instance at 0x7f4c59e60190>,25,17,[5 9],26,-1,43,-1,26
1,<environment.Job instance at 0x7f4c59e51050>,23,27,[5 3],24,-1,53,-1,26
1,<environment.Job instance at 0x7f4c59e600f0>,28,22,[9 2],29,-1,53,-1,31
1,<environment.Job instance at 0x7f4c59e60cd0>,31,18,[ 5 11],32,-1,50,-1,32
1,<environment.Job instance at 0x7f4c59e60dc0>,32,17,[10  4],33,-1,50,-1,33
1,<environment.Job instance at 0x7f4c59e60fa0>,33,12,[5 1],34,-1,46,-1,34
1,<environment.Job instance at 0x7f4c59e60550>,30,17,[2 9],31,-1,51,-1,34
1,<environment.Job instance at 0x7f4c59e64460>,35,17,[8 1],36,-1,54,-1,37
1,<environment.Job instance at 0x7f4c59e64550>,36,16,[7 2],37,-1,53,-1,37
1,<environment.Job instance at 0x7f4c59e64410>,37,18,[ 1 10],38,-1,56,-1,38
1,<environment.Job instance at 0x7f4c59e64690>,38,28,[7 4],39,-1,67,-1,39
1,<environment.Job instance at 0x7f4c59e697d0>,45,17,[3 5],46,-1,63,-1,46
1,<environment.Job instance at 0x7f4c59e69690>,46,15,[ 5 10],47,-1,62,-1,47
1,<environment.Job instance at 0x7f4c59e69190>,48,16,[14  3],49,-1,65,-1,49
1,<environment.Job instance at 0x7f4c59e69230>,50,15,[7 4],51,-1,66,-1,51
1,<environment.Job instance at 0x7f4c59e695a0>,49,12,[5 4],50,-1,63,-1,51
1,<environment.Job instance at 0x7f4c59c77550>,52,16,[8 5],53,-1,69,-1,53
1,<environment.Job instance at 0x7f4c59c08f00>,53,12,[3 8],54,-1,66,-1,54
1,<environment.Job instance at 0x7f4c63a582d0>,55,12,[2 6],56,-1,68,-1,56
1,<environment.Job instance at 0x7f4c59c13640>,58,18,[3 8],59,-1,77,-1,59
1,<environment.Job instance at 0x7f4c59c13690>,59,16,[9 4],60,-1,76,-1,60
1,<environment.Job instance at 0x7f4c59c13d20>,61,16,[7 4],62,-1,78,-1,62
1,<environment.Job instance at 0x7f4c69a68b40>,63,18,[1 6],64,-1,82,-1,64
1,<environment.Job instance at 0x7f4c63b53140>,64,15,[9 5],65,-1,82,-1,67
1,<environment.Job instance at 0x7f4c59a776e0>,67,16,[2 8],68,-1,84,-1,68
1,<environment.Job instance at 0x7f4c59bb4730>,66,17,[2 6],67,-1,85,-1,68
1,<environment.Job instance at 0x7f4c59af5730>,68,12,[9 2],69,-1,81,-1,69
1,<environment.Job instance at 0x7f4c59a77190>,70,18,[8 5],71,-1,89,-1,71
1,<environment.Job instance at 0x7f4c599858c0>,71,3,[1 8],72,-1,75,-1,72
1,<environment.Job instance at 0x7f4c59a44dc0>,72,13,[2 5],73,-1,86,-1,73
1,<environment.Job instance at 0x7f4c59a43140>,74,17,[1 9],75,-1,99,-1,82
1,<environment.Job instance at 0x7f4c59bb6140>,83,21,[9 5],84,-1,105,-1,84
1,<environment.Job instance at 0x7f4c599a7320>,84,18,[10  2],85,-1,103,-1,85
1,<environment.Job instance at 0x7f4c599a7460>,86,22,[6 1],87,-1,109,-1,87
1,<environment.Job instance at 0x7f4c599a46e0>,81,19,[ 3 14],82,-1,106,-1,87
1,<environment.Job instance at 0x7f4c599a4780>,87,14,[3 5],88,-1,103,-1,89
1,<environment.Job instance at 0x7f4c599a4910>,6,26,[9 1],7,-1,39,-1,13
1,<environment.Job instance at 0x7f4c59fb8be0>,16,23,[5 8],17,-1,62,-1,39
1,<environment.Job instance at 0x7f4c59eb3730>,21,2,[12  1],22,-1,48,-1,46
1,<environment.Job instance at 0x7f4c59eb0370>,23,27,[5 3],24,-1,87,-1,60
1,<environment.Job instance at 0x7f4c59eb0500>,29,3,[ 4 12],30,-1,79,-1,76
1,<environment.Job instance at 0x7f4c59e93870>,31,18,[ 5 11],32,-1,96,-1,78
1,<environment.Job instance at 0x7f4c59dcd550>,38,28,[7 4],39,-1,152,-1,124
1,<environment.Job instance at 0x7f4c5a399af0>,44,28,[9 1],45,-1,173,-1,145
1,<environment.Job instance at 0x7f4c5a3995f0>,48,16,[14  3],49,-1,161,-1,145
1,<environment.Job instance at 0x7f4c5a395cd0>,60,28,[7 3],61,-1,247,-1,219
1,<environment.Job instance at 0x7f4c5a393e60>,78,12,[12  2],79,-1,302,-1,290
1,<environment.Job instance at 0x7f4c5a393be0>,81,19,[ 3 14],82,-1,325,-1,306
1,<environment.Job instance at 0x7f4c5a393e10>,82,2,[14  5],83,-1,308,-1,306
1,<environment.Job instance at 0x7f4c5a393b40>,85,12,[12  4],86,-1,321,-1,309
1,<environment.Job instance at 0x7f4c5a3936e0>,91,18,[ 5 14],92,-1,330,-1,312
1,<environment.Job instance at 0x7f4c59c2eeb0>,98,1,[ 5 14],99,-1,330,-1,329
1,<environment.Job instance at 0x7f4c59bb8460>,103,3,[14  5],104,-1,364,-1,361
1,<environment.Job instance at 0x7f4c59dc0410>,108,17,[12  1],109,-1,382,-1,365
1,<environment.Job instance at 0x7f4c59ba49b0>,112,1,[13  3],113,-1,383,-1,382
1,<environment.Job instance at 0x7f4c59d8da50>,122,27,[ 2 13],123,-1,447,-1,420
1,<environment.Job instance at 0x7f4c59ba1d20>,128,1,[12  5],129,-1,442,-1,441
1,<environment.Job instance at 0x7f4c59b9bfa0>,141,18,[ 4 13],142,-1,511,-1,493
1,<environment.Job instance at 0x7f4c59b960a0>,147,16,[ 5 13],148,-1,526,-1,510
1,<environment.Job instance at 0x7f4c59c10b40>,154,18,[13  2],155,-1,557,-1,539
1,<environment.Job instance at 0x7f4c59b8faf0>,160,18,[11  4],161,-1,570,-1,552
1,<environment.Job instance at 0x7f4c59b58aa0>,4,22,[1 9],5,-1,27,-1,5
1,<environment.Job instance at 0x7f4c59b58230>,7,13,[ 1 10],8,-1,21,-1,8
1,<environment.Job instance at 0x7f4c59b5e3c0>,3,12,[8 5],4,-1,21,-1,9
1,<environment.Job instance at 0x7f4c59b58f50>,9,18,[ 2 10],10,-1,29,-1,11
1,<environment.Job instance at 0x7f4c59b58e60>,10,17,[7 1],11,-1,28,-1,11
1,<environment.Job instance at 0x7f4c59b58af0>,11,18,[3 8],12,-1,31,-1,13
1,<environment.Job instance at 0x7f4c59b55cd0>,15,20,[3 8],16,-1,37,-1,17
1,<environment.Job instance at 0x7f4c59b55f50>,20,18,[4 8],21,-1,39,-1,21
1,<environment.Job instance at 0x7f4c59cd8190>,25,18,[ 3 10],26,-1,45,-1,27
1,<environment.Job instance at 0x7f4c59cd8280>,27,13,[4 9],28,-1,41,-1,28
1,<environment.Job instance at 0x7f4c59cd8dc0>,32,17,[9 1],33,-1,54,-1,37
1,<environment.Job instance at 0x7f4c59cd8140>,37,20,[5 2],38,-1,58,-1,38
1,<environment.Job instance at 0x7f4c59cd86e0>,40,16,[1 9],41,-1,57,-1,41
1,<environment.Job instance at 0x7f4c59c2b370>,39,17,[2 6],40,-1,58,-1,41
1,<environment.Job instance at 0x7f4c59c2b140>,42,17,[4 6],43,-1,60,-1,43
1,<environment.Job instance at 0x7f4c59c2bd70>,44,13,[14  5],45,-1,120,-1,107
1,<environment.Job instance at 0x7f4c59c2b280>,51,18,[5 7],52,-1,125,-1,107
1,<environment.Job instance at 0x7f4c59c49910>,55,25,[3 7],56,-1,133,-1,108
1,<environment.Job instance at 0x7f4c59c49280>,57,14,[10  3],58,-1,122,-1,108
1,<environment.Job instance at 0x7f4c59c49aa0>,58,13,[8 2],59,-1,122,-1,109
1,<environment.Job instance at 0x7f4c59c494b0>,63,1,[5 2],64,-1,110,-1,109
1,<environment.Job instance at 0x7f4c59c496e0>,56,13,[1 6],57,-1,127,-1,114
1,<environment.Job instance at 0x7f4c59c491e0>,65,16,[10  5],66,-1,130,-1,114
1,<environment.Job instance at 0x7f4c59c49640>,66,13,[8 4],67,-1,127,-1,114
1,<environment.Job instance at 0x7f4c59c49690>,68,21,[9 5],69,-1,136,-1,115
1,<environment.Job instance at 0x7f4c59c49eb0>,70,17,[9 4],71,-1,137,-1,120
1,<environment.Job instance at 0x7f4c59c10c30>,72,12,[8 5],73,-1,134,-1,122
1,<environment.Job instance at 0x7f4c59c105f0>,77,16,[2 6],78,-1,145,-1,129
1,<environment.Job instance at 0x7f4c59c108c0>,79,16,[ 5 13],80,-1,147,-1,131
1,<environment.Job instance at 0x7f4c59ce5320>,83,17,[1 8],84,-1,150,-1,133
1,<environment.Job instance at 0x7f4c59c49b90>,64,12,[13  3],65,-1,145,-1,133
1,<environment.Job instance at 0x7f4c59cd8be0>,35,27,[5 5],36,-1,161,-1,134
1,<environment.Job instance at 0x7f4c59ce5780>,84,14,[ 3 14],85,-1,149,-1,135
1,<environment.Job instance at 0x7f4c59ce5fa0>,88,12,[ 2 10],89,-1,157,-1,145
1,<environment.Job instance at 0x7f4c59ce5960>,92,17,[10  3],93,-1,162,-1,145
1,<environment.Job instance at 0x7f4c59ce5b40>,85,24,[3 9],86,-1,169,-1,145
1,<environment.Job instance at 0x7f4c59ce55a0>,93,13,[9 5],94,-1,158,-1,145
1,<environment.Job instance at 0x7f4c59ce5190>,95,1,[12  4],96,-1,152,-1,151
1,<environment.Job instance at 0x7f4c59c20190>,101,15,[14  1],102,-1,166,-1,151
1,<environment.Job instance at 0x7f4c59c203c0>,102,27,[5 5],103,-1,179,-1,152
1,<environment.Job instance at 0x7f4c59c49c30>,67,14,[9 1],68,-1,166,-1,152
1,<environment.Job instance at 0x7f4c59c20280>,103,14,[3 6],104,-1,166,-1,152
1,<environment.Job instance at 0x7f4c59c205f0>,106,15,[ 5 10],107,-1,167,-1,152
1,<environment.Job instance at 0x7f4c59b55370>,17,27,[9 5],18,-1,179,-1,152
1,<environment.Job instance at 0x7f4c59c20f50>,104,25,[1 7],105,-1,178,-1,153
1,<environment.Job instance at 0x7f4c59c2b690>,43,27,[7 5],44,-1,242,-1,215
1,<environment.Job instance at 0x7f4c59aedc30>,116,27,[5 8],117,-1,253,-1,226
1,<environment.Job instance at 0x7f4c5999d2d0>,147,23,[10  4],148,-1,352,-1,329
1,<environment.Job instance at 0x7f4c59afa5f0>,151,17,[5 7],152,-1,346,-1,329
1,<environment.Job instance at 0x7f4c59b34a50>,159,17,[ 5 10],160,-1,462,-1,445
1,<environment.Job instance at 0x7f4c59cd8a50>,1,25,[10  4],2,-1,27,-1,2
1,<environment.Job instance at 0x7f4c59a80be0>,13,24,[3 6],14,-1,54,-1,30
1,<environment.Job instance at 0x7f4c5a8dbdc0>,17,27,[9 5],18,-1,60,-1,33
1,<environment.Job instance at 0x7f4c63a09b90>,23,2,[ 3 14],24,-1,52,-1,50
1,<environment.Job instance at 0x7f4c59b10640>,34,3,[ 3 12],35,-1,86,-1,83
1,<environment.Job instance at 0x7f4c59b0ba00>,35,27,[5 5],36,-1,127,-1,100
1,<environment.Job instance at 0x7f4c59b760a0>,38,13,[14  4],39,-1,114,-1,101
1,<environment.Job instance at 0x7f4c59b7a5f0>,43,27,[7 5],44,-1,147,-1,120
1,<environment.Job instance at 0x7f4c59b5eaf0>,44,13,[14  5],45,-1,133,-1,120
1,<environment.Job instance at 0x7f4c59c103c0>,55,25,[3 7],56,-1,202,-1,177
1,<environment.Job instance at 0x7f4c59ce5410>,60,1,[ 4 12],61,-1,192,-1,191
1,<environment.Job instance at 0x7f4c59b911e0>,64,12,[13  3],65,-1,207,-1,195
1,<environment.Job instance at 0x7f4c59d8de10>,69,3,[12  1],70,-1,225,-1,222
1,<environment.Job instance at 0x7f4c59d712d0>,79,16,[ 5 13],80,-1,264,-1,248
1,<environment.Job instance at 0x7f4c599a3460>,84,14,[ 3 14],85,-1,280,-1,266
1,<environment.Job instance at 0x7f4c599a35a0>,85,24,[3 9],86,-1,293,-1,269
1,<environment.Job instance at 0x7f4c59cdc5f0>,95,1,[12  4],96,-1,308,-1,307
1,<environment.Job instance at 0x7f4c59cdcd20>,101,15,[14  1],102,-1,339,-1,324
1,<environment.Job instance at 0x7f4c59bc7690>,102,27,[5 5],103,-1,354,-1,327
1,<environment.Job instance at 0x7f4c59bc7f00>,104,25,[1 7],105,-1,355,-1,330
1,<environment.Job instance at 0x7f4c59bc76e0>,116,27,[5 8],117,-1,417,-1,390
1,<environment.Job instance at 0x7f4c59bc7b40>,121,24,[4 8],122,-1,430,-1,406
1,<environment.Job instance at 0x7f4c59ce44b0>,131,1,[11  1],132,-1,430,-1,429
1,<environment.Job instance at 0x7f4c59ce4eb0>,141,24,[1 9],142,-1,493,-1,469
1,<environment.Job instance at 0x7f4c59b96e60>,147,23,[10  4],148,-1,539,-1,516
1,<environment.Job instance at 0x7f4c59b96aa0>,153,3,[ 5 13],154,-1,527,-1,524
1,<environment.Job instance at 0x7f4c59b96b90>,156,17,[13  2],157,-1,554,-1,537
1,<environment.Job instance at 0x7f4c59b96550>,157,1,[11  4],158,-1,538,-1,537
1,<environment.Job instance at 0x7f4c59d2f460>,162,17,[ 2 12],163,-1,575,-1,558
1,<environment.Job instance at 0x7f4c59d2f730>,165,24,[10  2],166,-1,597,-1,573
1,<environment.Job instance at 0x7f4c59d2fdc0>,169,27,[14  1],170,-1,619,-1,592
1,<environment.Job instance at 0x7f4c59d2fc80>,172,2,[11  4],173,-1,601,-1,599
1,<environment.Job instance at 0x7f4c59d2fc30>,175,12,[11  5],176,-1,638,-1,626
1,<environment.Job instance at 0x7f4c59cc4780>,0,14,[8 4],1,-1,16,-1,2
1,<environment.Job instance at 0x7f4c59e26780>,3,18,[6 1],4,-1,22,-1,4
1,<environment.Job instance at 0x7f4c59e26550>,4,12,[4 7],5,-1,17,-1,5
1,<environment.Job instance at 0x7f4c5a0f90a0>,6,14,[10  4],7,-1,21,-1,7
1,<environment.Job instance at 0x7f4c59b870f0>,1,12,[5 9],2,-1,20,-1,8
1,<environment.Job instance at 0x7f4c5a0f9b40>,16,16,[2 6],17,-1,34,-1,18
1,<environment.Job instance at 0x7f4c5a0f9eb0>,20,18,[5 9],21,-1,39,-1,21
1,<environment.Job instance at 0x7f4c5a859190>,23,18,[ 1 10],24,-1,42,-1,24
1,<environment.Job instance at 0x7f4c5a859320>,24,14,[7 5],25,-1,39,-1,25
1,<environment.Job instance at 0x7f4c5a859820>,29,14,[9 5],30,-1,44,-1,30
1,<environment.Job instance at 0x7f4c5a0f9640>,17,18,[3 6],18,-1,51,-1,33
1,<environment.Job instance at 0x7f4c5a859c80>,36,17,[ 1 10],37,-1,58,-1,41
1,<environment.Job instance at 0x7f4c5a8596e0>,31,17,[14  3],32,-1,79,-1,62
1,<environment.Job instance at 0x7f4c5a845050>,38,16,[9 2],39,-1,78,-1,62
1,<environment.Job instance at 0x7f4c5a851140>,55,24,[8 3],56,-1,86,-1,62
1,<environment.Job instance at 0x7f4c5a845d20>,51,15,[1 9],52,-1,79,-1,64
1,<environment.Job instance at 0x7f4c5a845690>,2,3,[11  3],3,-1,6,-1,3
1,<environment.Job instance at 0x7f4c59d2f8c0>,11,15,[ 2 14],12,-1,31,-1,16
1,<environment.Job instance at 0x7f4c59d2f910>,15,12,[ 3 13],16,-1,29,-1,17
1,<environment.Job instance at 0x7f4c59b962d0>,31,17,[14  3],32,-1,79,-1,62
1,<environment.Job instance at 0x7f4c59ce4230>,34,15,[ 2 13],35,-1,79,-1,64
1,<environment.Job instance at 0x7f4c59ce4f00>,37,3,[12  4],38,-1,82,-1,79
1,<environment.Job instance at 0x7f4c59ce42d0>,39,28,[1 8],40,-1,124,-1,96
1,<environment.Job instance at 0x7f4c59ce4f50>,48,18,[13  3],49,-1,132,-1,114
1,<environment.Job instance at 0x7f4c59cdc870>,55,24,[8 3],56,-1,186,-1,162
1,<environment.Job instance at 0x7f4c59eb0500>,71,13,[12  4],72,-1,219,-1,206
1,<environment.Job instance at 0x7f4c59c3d870>,74,24,[4 5],75,-1,246,-1,222
1,<environment.Job instance at 0x7f4c59c2be60>,109,23,[6 5],110,-1,384,-1,361
1,<environment.Job instance at 0x7f4c5a802c30>,120,27,[6 4],121,-1,419,-1,392
1,<environment.Job instance at 0x7f4c5a802280>,121,1,[11  4],122,-1,393,-1,392
1,<environment.Job instance at 0x7f4c637c6370>,132,24,[1 6],133,-1,450,-1,426
1,<environment.Job instance at 0x7f4c5aa8e460>,144,3,[ 2 12],145,-1,489,-1,486
1,<environment.Job instance at 0x7f4c5aa6ea50>,151,2,[ 3 14],152,-1,506,-1,504
1,<environment.Job instance at 0x7f4c5aa6e910>,156,13,[12  4],157,-1,535,-1,522
1,<environment.Job instance at 0x7f4c5aa86410>,157,27,[9 3],158,-1,550,-1,523
1,<environment.Job instance at 0x7f4c59a98d20>,166,12,[ 2 11],167,-1,563,-1,551
1,<environment.Job instance at 0x7f4c5a6eca50>,168,24,[4 7],169,-1,590,-1,566
1,<environment.Job instance at 0x7f4c5a42a500>,174,18,[ 4 11],175,-1,596,-1,578
1,<environment.Job instance at 0x7f4c5a839410>,0,20,[4 6],1,-1,21,-1,1
1,<environment.Job instance at 0x7f4c5cfc9460>,12,17,[ 2 10],13,-1,31,-1,14
1,<environment.Job instance at 0x7f4c5cfc9960>,14,12,[9 1],15,-1,27,-1,15
1,<environment.Job instance at 0x7f4c5cfc94b0>,16,13,[4 7],17,-1,30,-1,17
1,<environment.Job instance at 0x7f4c5cfc9230>,18,20,[3 8],19,-1,39,-1,19
1,<environment.Job instance at 0x7f4c5cfc95a0>,21,21,[4 7],22,-1,43,-1,22
1,<environment.Job instance at 0x7f4c5ae402d0>,13,15,[5 5],14,-1,38,-1,23
1,<environment.Job instance at 0x7f4c5cfe8140>,29,19,[5 5],30,-1,49,-1,30
1,<environment.Job instance at 0x7f4c5cfe8550>,31,18,[4 8],32,-1,51,-1,33
1,<environment.Job instance at 0x7f4c5cfe8dc0>,36,12,[2 7],37,-1,49,-1,37
1,<environment.Job instance at 0x7f4c5cfe8190>,32,15,[4 8],33,-1,52,-1,37
1,<environment.Job instance at 0x7f4c5cfe8320>,37,14,[ 4 10],38,-1,53,-1,39
1,<environment.Job instance at 0x7f4c5cfe8910>,35,12,[10  1],36,-1,61,-1,49
1,<environment.Job instance at 0x7f4c5af9f5a0>,46,18,[10  2],47,-1,67,-1,49
1,<environment.Job instance at 0x7f4c5af9f730>,38,18,[4 6],39,-1,67,-1,49
1,<environment.Job instance at 0x7f4c5af9fcd0>,48,17,[9 5],49,-1,66,-1,49
1,<environment.Job instance at 0x7f4c6370b3c0>,50,16,[ 3 10],51,-1,67,-1,51
1,<environment.Job instance at 0x7f4c6370b460>,51,16,[5 7],52,-1,68,-1,52
1,<environment.Job instance at 0x7f4c6370b5a0>,55,14,[4 6],56,-1,86,-1,72
1,<environment.Job instance at 0x7f4c5aa00690>,57,27,[ 2 11],58,-1,99,-1,72
1,<environment.Job instance at 0x7f4c5aa009b0>,66,14,[6 4],67,-1,86,-1,72
1,<environment.Job instance at 0x7f4c5aa00b40>,65,12,[8 5],66,-1,84,-1,72
1,<environment.Job instance at 0x7f4c5aa00730>,68,17,[3 7],69,-1,89,-1,72
1,<environment.Job instance at 0x7f4c5af9f0a0>,43,13,[7 4],44,-1,100,-1,87
1,<environment.Job instance at 0x7f4c5cfc9c30>,20,24,[10  4],21,-1,111,-1,87
1,<environment.Job instance at 0x7f4c5abe2500>,73,12,[7 4],74,-1,99,-1,87
1,<environment.Job instance at 0x7f4c5aa00d20>,67,3,[7 5],68,-1,93,-1,90
1,<environment.Job instance at 0x7f4c5abe26e0>,79,1,[5 7],80,-1,91,-1,90
1,<environment.Job instance at 0x7f4c5abe25f0>,74,3,[ 3 10],75,-1,98,-1,95
1,<environment.Job instance at 0x7f4c5abe2280>,80,14,[ 2 10],81,-1,109,-1,95
1,<environment.Job instance at 0x7f4c5abe2410>,72,17,[6 4],73,-1,112,-1,95
1,<environment.Job instance at 0x7f4c5abe2230>,83,18,[5 5],84,-1,113,-1,95
1,<environment.Job instance at 0x7f4c5abe2640>,82,16,[ 3 10],83,-1,111,-1,95
1,<environment.Job instance at 0x7f4c5abe2e60>,81,3,[3 9],82,-1,98,-1,95
1,<environment.Job instance at 0x7f4c5abe23c0>,86,13,[3 9],87,-1,110,-1,97
1,<environment.Job instance at 0x7f4c5abe2550>,84,16,[5 5],85,-1,119,-1,103
1,<environment.Job instance at 0x7f4c5a7d5e60>,89,18,[9 5],90,-1,122,-1,104
1,<environment.Job instance at 0x7f4c5abe2dc0>,85,17,[ 3 10],86,-1,121,-1,104
1,<environment.Job instance at 0x7f4c5abe2c30>,88,18,[1 5],89,-1,122,-1,104
1,<environment.Job instance at 0x7f4c5a7d5e10>,90,19,[4 5],91,-1,123,-1,104
1,<environment.Job instance at 0x7f4c5cfe82d0>,30,15,[10  4],31,-1,119,-1,104
1,<environment.Job instance at 0x7f4c5a7d5500>,92,13,[9 4],93,-1,117,-1,104
1,<environment.Job instance at 0x7f4c5a7d5a00>,94,16,[2 7],95,-1,120,-1,104
1,<environment.Job instance at 0x7f4c5a7d5870>,96,13,[5 5],97,-1,117,-1,104
1,<environment.Job instance at 0x7f4c5a7d58c0>,98,16,[8 3],99,-1,120,-1,104
1,<environment.Job instance at 0x7f4c5a7d5140>,100,23,[9 4],101,-1,127,-1,104
1,<environment.Job instance at 0x7f4c59e1c5f0>,101,21,[8 2],102,-1,125,-1,104
1,<environment.Job instance at 0x7f4c5a975eb0>,102,21,[5 7],103,-1,125,-1,104
1,<environment.Job instance at 0x7f4c5a15a690>,104,17,[9 2],105,-1,122,-1,105
1,<environment.Job instance at 0x7f4c5a971f50>,105,18,[5 5],106,-1,124,-1,106
1,<environment.Job instance at 0x7f4c5a658730>,108,28,[10  4],109,-1,156,-1,128
1,<environment.Job instance at 0x7f4c5a7d5280>,93,12,[2 6],94,-1,142,-1,130
1,<environment.Job instance at 0x7f4c5a188730>,116,18,[8 3],117,-1,149,-1,131
1,<environment.Job instance at 0x7f4c5a07b870>,120,26,[4 9],121,-1,157,-1,131
1,<environment.Job instance at 0x7f4c5aba9d70>,114,14,[9 1],115,-1,146,-1,132
1,<environment.Job instance at 0x7f4c5a907e10>,125,18,[1 8],126,-1,154,-1,136
1,<environment.Job instance at 0x7f4c63b51140>,127,23,[5 3],128,-1,159,-1,136
1,<environment.Job instance at 0x7f4c5a6094b0>,128,16,[9 4],129,-1,153,-1,137
1,<environment.Job instance at 0x7f4c59e87aa0>,113,18,[7 1],114,-1,156,-1,138
1,<environment.Job instance at 0x7f4c59d8a910>,118,17,[12  1],119,-1,156,-1,139
1,<environment.Job instance at 0x7f4c5a310730>,122,16,[13  1],123,-1,155,-1,139
1,<environment.Job instance at 0x7f4c5a8b30f0>,131,18,[11  2],132,-1,157,-1,139
1,<environment.Job instance at 0x7f4c5a907550>,126,13,[9 3],127,-1,152,-1,139
1,<environment.Job instance at 0x7f4c5a8b3460>,133,24,[ 5 11],134,-1,163,-1,139
1,<environment.Job instance at 0x7f4c5a8b3230>,134,13,[2 6],135,-1,152,-1,139
1,<environment.Job instance at 0x7f4c63b51dc0>,129,15,[5 7],130,-1,154,-1,139
1,<environment.Job instance at 0x7f4c5a8b3eb0>,136,18,[7 4],137,-1,157,-1,139
1,<environment.Job instance at 0x7f4c5a8b3be0>,135,14,[ 1 10],136,-1,154,-1,140
1,<environment.Job instance at 0x7f4c5a8b3730>,132,12,[ 5 13],133,-1,156,-1,144
1,<environment.Job instance at 0x7f4c5af85690>,140,13,[11  2],141,-1,161,-1,148
1,<environment.Job instance at 0x7f4c5af85eb0>,138,14,[1 7],139,-1,162,-1,148
1,<environment.Job instance at 0x7f4c5a8b3a50>,130,14,[1 5],131,-1,162,-1,148
1,<environment.Job instance at 0x7f4c5a685b40>,144,14,[5 3],145,-1,162,-1,148
1,<environment.Job instance at 0x7f4c5af85d70>,139,18,[6 4],140,-1,167,-1,149
1,<environment.Job instance at 0x7f4c5af85910>,142,14,[3 9],143,-1,164,-1,150
1,<environment.Job instance at 0x7f4c59d894b0>,150,14,[10  1],151,-1,165,-1,151
1,<environment.Job instance at 0x7f4c5a6851e0>,147,16,[ 3 12],148,-1,167,-1,151
1,<environment.Job instance at 0x7f4c5a3b0eb0>,149,17,[9 2],150,-1,172,-1,155
1,<environment.Job instance at 0x7f4c5a003cd0>,153,22,[5 2],154,-1,177,-1,155
1,<environment.Job instance at 0x7f4c5a3b5910>,155,17,[3 6],156,-1,173,-1,156
1,<environment.Job instance at 0x7f4c5a3b5050>,154,18,[5 6],155,-1,175,-1,157
1,<environment.Job instance at 0x7f4c5a30ee60>,160,16,[ 2 10],161,-1,179,-1,163
1,<environment.Job instance at 0x7f4c63a0a9b0>,157,13,[4 5],158,-1,177,-1,164
1,<environment.Job instance at 0x7f4c63a0a140>,158,12,[ 4 10],159,-1,177,-1,165
1,<environment.Job instance at 0x7f4c5a2f6d20>,162,15,[5 9],163,-1,180,-1,165
1,<environment.Job instance at 0x7f4c59e8f6e0>,165,18,[ 5 10],166,-1,190,-1,172
1,<environment.Job instance at 0x7f4c5af85aa0>,141,13,[6 3],142,-1,185,-1,172
1,<environment.Job instance at 0x7f4c5a88e5f0>,169,12,[9 4],170,-1,184,-1,172
1,<environment.Job instance at 0x7f4c59e8f690>,164,14,[6 4],165,-1,189,-1,175
1,<environment.Job instance at 0x7f4c5a1a3e60>,177,18,[3 8],178,-1,196,-1,178
1,<environment.Job instance at 0x7f4c5af9f6e0>,3,14,[ 1 11],4,-1,18,-1,4
1,<environment.Job instance at 0x7f4c6370b690>,5,16,[ 2 11],6,-1,22,-1,6
1,<environment.Job instance at 0x7f4c5aa00a50>,8,2,[13  3],9,-1,11,-1,9
1,<environment.Job instance at 0x7f4c5a99f9b0>,22,17,[ 2 11],23,-1,56,-1,39
1,<environment.Job instance at 0x7f4c5a1a3780>,24,1,[ 2 11],25,-1,40,-1,39
1,<environment.Job instance at 0x7f4c5a30e5a0>,20,24,[10  4],21,-1,64,-1,40
1,<environment.Job instance at 0x7f4c59a98a50>,39,1,[ 5 14],40,-1,95,-1,94
1,<environment.Job instance at 0x7f4c5aa8ef50>,57,27,[ 2 11],58,-1,201,-1,174
1,<environment.Job instance at 0x7f4c59c84370>,59,3,[11  2],60,-1,182,-1,179
1,<environment.Job instance at 0x7f4c5a8b6500>,62,1,[12  5],63,-1,185,-1,184
1,<environment.Job instance at 0x7f4c59c10dc0>,100,23,[9 4],101,-1,361,-1,338
1,<environment.Job instance at 0x7f4c59dd20f0>,108,28,[10  4],109,-1,401,-1,373
1,<environment.Job instance at 0x7f4c5999d5f0>,118,17,[12  1],119,-1,413,-1,396
1,<environment.Job instance at 0x7f4c59cdc050>,120,26,[4 9],121,-1,439,-1,413
1,<environment.Job instance at 0x7f4c59cdc8c0>,122,16,[13  1],123,-1,429,-1,413
1,<environment.Job instance at 0x7f4c59cdc640>,127,23,[5 3],128,-1,451,-1,428
1,<environment.Job instance at 0x7f4c59ce4d70>,131,18,[11  2],132,-1,457,-1,439
1,<environment.Job instance at 0x7f4c59ce4280>,132,12,[ 5 13],133,-1,451,-1,439
1,<environment.Job instance at 0x7f4c59ce4640>,133,24,[ 5 11],134,-1,463,-1,439
1,<environment.Job instance at 0x7f4c59ce4a00>,140,13,[11  2],141,-1,487,-1,474
1,<environment.Job instance at 0x7f4c59d2f730>,147,16,[ 3 12],148,-1,518,-1,502
1,<environment.Job instance at 0x7f4c5a1892d0>,166,25,[6 3],167,-1,623,-1,598
1,<environment.Job instance at 0x7f4c5a21ff50>,173,2,[14  3],174,-1,610,-1,608
1,<environment.Job instance at 0x7f4c5a80be10>,174,1,[14  5],175,-1,609,-1,608
1,<environment.Job instance at 0x7f4c59e73a00>,1,18,[10  5],2,-1,20,-1,2
1,<environment.Job instance at 0x7f4c59e736e0>,5,18,[9 2],6,-1,26,-1,8
1,<environment.Job instance at 0x7f4c59b70550>,11,21,[4 9],12,-1,33,-1,12
1,<environment.Job instance at 0x7f4c59e73b40>,7,20,[1 8],8,-1,32,-1,12
1,<environment.Job instance at 0x7f4c59b70140>,13,16,[8 1],14,-1,32,-1,16
1,<environment.Job instance at 0x7f4c59b70820>,15,23,[8 4],16,-1,39,-1,16
1,<environment.Job instance at 0x7f4c59b706e0>,17,20,[5 7],18,-1,38,-1,18
1,<environment.Job instance at 0x7f4c59b70190>,18,16,[4 8],19,-1,35,-1,19
1,<environment.Job instance at 0x7f4c59b705a0>,20,15,[2 8],21,-1,36,-1,21
1,<environment.Job instance at 0x7f4c59f0e280>,25,16,[10  5],26,-1,44,-1,28
1,<environment.Job instance at 0x7f4c59f0e7d0>,29,18,[2 7],30,-1,48,-1,30
1,<environment.Job instance at 0x7f4c59f0e9b0>,30,15,[4 7],31,-1,46,-1,31
1,<environment.Job instance at 0x7f4c59f0eb40>,33,16,[9 4],34,-1,50,-1,34
1,<environment.Job instance at 0x7f4c59f0ef00>,34,13,[8 2],35,-1,48,-1,35
1,<environment.Job instance at 0x7f4c5a3a2050>,40,24,[7 2],41,-1,65,-1,41
1,<environment.Job instance at 0x7f4c5a3a2370>,42,15,[ 2 10],43,-1,58,-1,43
1,<environment.Job instance at 0x7f4c5a3a28c0>,44,17,[8 1],45,-1,62,-1,45
1,<environment.Job instance at 0x7f4c5a003460>,46,19,[2 9],47,-1,66,-1,47
1,<environment.Job instance at 0x7f4c5a0035f0>,48,20,[ 1 10],49,-1,69,-1,49
1,<environment.Job instance at 0x7f4c5a003690>,49,18,[2 7],50,-1,68,-1,50
1,<environment.Job instance at 0x7f4c5a003050>,51,18,[3 8],52,-1,70,-1,52
1,<environment.Job instance at 0x7f4c5a0032d0>,53,14,[ 4 10],54,-1,68,-1,54
1,<environment.Job instance at 0x7f4c59d94f00>,54,15,[4 8],55,-1,70,-1,55
1,<environment.Job instance at 0x7f4c59d94320>,56,16,[1 6],57,-1,73,-1,57
1,<environment.Job instance at 0x7f4c59d94af0>,59,17,[ 1 10],60,-1,77,-1,60
1,<environment.Job instance at 0x7f4c5a622a00>,67,13,[9 1],68,-1,81,-1,68
1,<environment.Job instance at 0x7f4c5a14b280>,77,17,[10  4],78,-1,111,-1,94
1,<environment.Job instance at 0x7f4c5a14b820>,74,13,[4 8],75,-1,108,-1,95
1,<environment.Job instance at 0x7f4c5a14b5f0>,73,23,[7 4],74,-1,118,-1,95
1,<environment.Job instance at 0x7f4c5a14bf00>,81,14,[9 4],82,-1,110,-1,96
1,<environment.Job instance at 0x7f4c59f0e550>,27,16,[1 7],28,-1,112,-1,96
1,<environment.Job instance at 0x7f4c5a14b910>,85,18,[7 5],86,-1,114,-1,96
1,<environment.Job instance at 0x7f4c5a623730>,89,18,[ 2 10],90,-1,131,-1,113
1,<environment.Job instance at 0x7f4c5a623a00>,94,18,[10  2],95,-1,131,-1,113
1,<environment.Job instance at 0x7f4c59d94550>,3,1,[12  4],4,-1,5,-1,4
1,<environment.Job instance at 0x7f4c5a6237d0>,10,2,[ 2 12],11,-1,13,-1,11
1,<environment.Job instance at 0x7f4c59e73190>,15,23,[8 4],16,-1,49,-1,26
1,<environment.Job instance at 0x7f4c63a09550>,24,15,[11  1],25,-1,60,-1,45
1,<environment.Job instance at 0x7f4c5abe28c0>,31,20,[ 5 13],32,-1,87,-1,67
1,<environment.Job instance at 0x7f4c5cfe8a00>,40,24,[7 2],41,-1,121,-1,97
1,<environment.Job instance at 0x7f4c5aaa20f0>,45,15,[ 1 12],46,-1,131,-1,116
1,<environment.Job instance at 0x7f4c5aa869b0>,58,2,[ 1 13],59,-1,170,-1,168
1,<environment.Job instance at 0x7f4c5a458370>,60,28,[ 2 14],61,-1,202,-1,174
1,<environment.Job instance at 0x7f4c638d79b0>,61,28,[5 1],62,-1,202,-1,174
1,<environment.Job instance at 0x7f4c5a478b90>,73,23,[7 4],74,-1,236,-1,213
1,<environment.Job instance at 0x7f4c5a27d2d0>,78,18,[13  5],79,-1,244,-1,226
1,<environment.Job instance at 0x7f4c5af96640>,83,3,[13  5],84,-1,253,-1,250
1,<environment.Job instance at 0x7f4c598055a0>,86,27,[5 2],87,-1,290,-1,263
1,<environment.Job instance at 0x7f4c59890e60>,87,14,[ 3 14],88,-1,277,-1,263
1,<environment.Job instance at 0x7f4c5ad34320>,104,28,[4 5],105,-1,359,-1,331
1,<environment.Job instance at 0x7f4c5a4703c0>,107,2,[ 5 13],108,-1,334,-1,332
1,<environment.Job instance at 0x7f4c59ec21e0>,111,25,[10  1],112,-1,371,-1,346
1,<environment.Job instance at 0x7f4c59e9de10>,127,25,[9 4],128,-1,447,-1,422
1,<environment.Job instance at 0x7f4c5975d4b0>,139,28,[6 1],140,-1,504,-1,476
1,<environment.Job instance at 0x7f4c5975de60>,142,18,[ 2 12],143,-1,496,-1,478
1,<environment.Job instance at 0x7f4c5ac66140>,153,24,[5 3],154,-1,542,-1,518
1,<environment.Job instance at 0x7f4c5adffe10>,157,2,[11  4],158,-1,531,-1,529
1,<environment.Job instance at 0x7f4c5adff8c0>,161,28,[9 4],162,-1,582,-1,554
1,<environment.Job instance at 0x7f4c5adff870>,163,16,[ 1 12],164,-1,570,-1,554
1,<environment.Job instance at 0x7f4c5adffaf0>,168,19,[ 3 11],169,-1,583,-1,564
1,<environment.Job instance at 0x7f4c5a2f88c0>,4,16,[7 4],5,-1,21,-1,5
1,<environment.Job instance at 0x7f4c5a2f8960>,8,17,[9 5],9,-1,28,-1,11
1,<environment.Job instance at 0x7f4c5a2f86e0>,11,18,[4 7],12,-1,30,-1,12
1,<environment.Job instance at 0x7f4c5a2f8d20>,13,17,[9 1],14,-1,31,-1,14
1,<environment.Job instance at 0x7f4c5a2f8820>,14,22,[4 9],15,-1,37,-1,15
1,<environment.Job instance at 0x7f4c5a2f8b90>,16,21,[5 5],17,-1,38,-1,17
1,<environment.Job instance at 0x7f4c5a88d870>,19,15,[3 9],20,-1,35,-1,20
1,<environment.Job instance at 0x7f4c5a88d140>,24,15,[10  2],25,-1,40,-1,25
1,<environment.Job instance at 0x7f4c5a88dbe0>,25,25,[1 6],26,-1,51,-1,26
1,<environment.Job instance at 0x7f4c5a88d050>,27,15,[6 2],28,-1,43,-1,28
1,<environment.Job instance at 0x7f4c5abc5190>,32,20,[ 5 10],33,-1,53,-1,33
1,<environment.Job instance at 0x7f4c638e1550>,34,12,[9 1],35,-1,47,-1,35
1,<environment.Job instance at 0x7f4c638e16e0>,35,24,[8 3],36,-1,60,-1,36
1,<environment.Job instance at 0x7f4c638e1410>,36,14,[6 4],37,-1,51,-1,37
1,<environment.Job instance at 0x7f4c638e13c0>,37,12,[5 9],38,-1,50,-1,38
1,<environment.Job instance at 0x7f4c5a4193c0>,41,16,[3 9],42,-1,58,-1,42
1,<environment.Job instance at 0x7f4c5a419fa0>,44,13,[2 7],45,-1,58,-1,45
1,<environment.Job instance at 0x7f4c5a4190f0>,45,17,[10  3],46,-1,63,-1,46
1,<environment.Job instance at 0x7f4c5a419cd0>,46,18,[6 4],47,-1,65,-1,47
1,<environment.Job instance at 0x7f4c5a419230>,47,24,[5 9],48,-1,72,-1,48
1,<environment.Job instance at 0x7f4c5a419a00>,48,14,[6 4],49,-1,63,-1,49
1,<environment.Job instance at 0x7f4c5a419c80>,51,28,[3 6],52,-1,80,-1,52
1,<environment.Job instance at 0x7f4c5a6c8780>,52,14,[ 4 10],53,-1,67,-1,53
1,<environment.Job instance at 0x7f4c5a6c8410>,55,16,[7 3],56,-1,72,-1,56
1,<environment.Job instance at 0x7f4c5a6c8a00>,57,16,[1 8],58,-1,74,-1,58
1,<environment.Job instance at 0x7f4c5a6c8280>,59,26,[2 6],60,-1,86,-1,60
1,<environment.Job instance at 0x7f4c5a6c8690>,60,20,[9 3],61,-1,81,-1,61
1,<environment.Job instance at 0x7f4c5a6c8910>,61,15,[8 4],62,-1,77,-1,62
1,<environment.Job instance at 0x7f4c5a6c8500>,62,14,[9 2],63,-1,77,-1,63
1,<environment.Job instance at 0x7f4c5a6c8960>,63,16,[2 6],64,-1,80,-1,64
1,<environment.Job instance at 0x7f4c5a6c8820>,65,17,[5 3],66,-1,83,-1,66
1,<environment.Job instance at 0x7f4c5aa64460>,68,26,[8 2],69,-1,95,-1,69
1,<environment.Job instance at 0x7f4c5aa649b0>,72,16,[9 2],73,-1,89,-1,73
1,<environment.Job instance at 0x7f4c5aa64a00>,73,18,[4 6],74,-1,92,-1,74
1,<environment.Job instance at 0x7f4c5aa642d0>,74,13,[2 8],75,-1,88,-1,75
1,<environment.Job instance at 0x7f4c5aa64820>,76,17,[3 7],77,-1,94,-1,77
1,<environment.Job instance at 0x7f4c5a57bf00>,79,17,[5 7],80,-1,97,-1,80
1,<environment.Job instance at 0x7f4c5a57bd70>,82,18,[7 4],83,-1,101,-1,83
1,<environment.Job instance at 0x7f4c5a57b280>,83,14,[ 2 10],84,-1,98,-1,84
1,<environment.Job instance at 0x7f4c5a57beb0>,93,16,[3 8],94,-1,111,-1,95
1,<environment.Job instance at 0x7f4c59b96050>,98,16,[3 8],99,-1,142,-1,126
1,<environment.Job instance at 0x7f4c59b96c80>,102,17,[9 4],103,-1,143,-1,126
1,<environment.Job instance at 0x7f4c5a2d4cd0>,106,17,[ 5 11],107,-1,143,-1,126
1,<environment.Job instance at 0x7f4c5a2d4780>,105,14,[4 8],106,-1,148,-1,134
1,<environment.Job instance at 0x7f4c5a2d40a0>,109,16,[10  5],110,-1,150,-1,134
1,<environment.Job instance at 0x7f4c5abc5cd0>,7,13,[14  4],8,-1,21,-1,8
1,<environment.Job instance at 0x7f4c5a2d4960>,23,2,[13  2],24,-1,55,-1,53
1,<environment.Job instance at 0x7f4c635bfd70>,25,25,[1 6],26,-1,90,-1,65
1,<environment.Job instance at 0x7f4c5adff640>,30,27,[11  2],31,-1,110,-1,83
1,<environment.Job instance at 0x7f4c5adff8c0>,35,24,[8 3],36,-1,114,-1,90
1,<environment.Job instance at 0x7f4c5ac66eb0>,47,24,[5 9],48,-1,157,-1,133
1,<environment.Job instance at 0x7f4c5ac66af0>,51,28,[3 6],52,-1,166,-1,138
1,<environment.Job instance at 0x7f4c5a1555a0>,59,26,[2 6],60,-1,198,-1,172
1,<environment.Job instance at 0x7f4c59f4aa50>,67,1,[ 1 13],68,-1,196,-1,195
1,<environment.Job instance at 0x7f4c597e6870>,68,26,[8 2],69,-1,235,-1,209
1,<environment.Job instance at 0x7f4c5a66ba00>,75,25,[ 3 14],76,-1,251,-1,226
1,<environment.Job instance at 0x7f4c59882730>,81,3,[ 4 13],82,-1,249,-1,246
1,<environment.Job instance at 0x7f4c598825a0>,84,27,[13  3],85,-1,283,-1,256
1,<environment.Job instance at 0x7f4c5a4926e0>,104,27,[6 1],105,-1,376,-1,349
1,<environment.Job instance at 0x7f4c5a481eb0>,106,17,[ 5 11],107,-1,366,-1,349
1,<environment.Job instance at 0x7f4c5a458690>,111,24,[14  3],112,-1,388,-1,364
1,<environment.Job instance at 0x7f4c63965aa0>,113,24,[10  2],114,-1,404,-1,380
1,<environment.Job instance at 0x7f4c5a9fddc0>,130,13,[12  1],131,-1,447,-1,434
1,<environment.Job instance at 0x7f4c5a9fd9b0>,131,16,[ 5 11],132,-1,450,-1,434
1,<environment.Job instance at 0x7f4c5a9fdc80>,135,27,[4 5],136,-1,479,-1,452
1,<environment.Job instance at 0x7f4c5a395fa0>,136,1,[12  2],137,-1,453,-1,452
1,<environment.Job instance at 0x7f4c5a9b70f0>,146,25,[7 3],147,-1,509,-1,484
1,<environment.Job instance at 0x7f4c635b1c30>,150,26,[6 4],151,-1,516,-1,490
1,<environment.Job instance at 0x7f4c598815a0>,2,18,[3 7],3,-1,21,-1,3
1,<environment.Job instance at 0x7f4c59881820>,5,13,[9 1],6,-1,21,-1,8
1,<environment.Job instance at 0x7f4c59881a50>,8,14,[ 1 10],9,-1,23,-1,9
1,<environment.Job instance at 0x7f4c59881780>,7,15,[3 6],8,-1,25,-1,10
1,<environment.Job instance at 0x7f4c59881c30>,10,25,[5 3],11,-1,36,-1,11
1,<environment.Job instance at 0x7f4c5a59e280>,18,16,[10  3],19,-1,35,-1,19
1,<environment.Job instance at 0x7f4c5a59e370>,19,28,[3 9],20,-1,48,-1,20
1,<environment.Job instance at 0x7f4c5a59e730>,22,23,[3 7],23,-1,46,-1,23
1,<environment.Job instance at 0x7f4c5a59e4b0>,24,17,[2 7],25,-1,42,-1,25
1,<environment.Job instance at 0x7f4c5a59ec80>,27,16,[5 4],28,-1,44,-1,28
1,<environment.Job instance at 0x7f4c5a59ed70>,28,17,[6 5],29,-1,46,-1,29
1,<environment.Job instance at 0x7f4c5a59ecd0>,29,18,[5 1],30,-1,48,-1,30
1,<environment.Job instance at 0x7f4c5a59ee60>,30,16,[1 7],31,-1,47,-1,31
1,<environment.Job instance at 0x7f4c5a59ef00>,31,12,[2 6],32,-1,45,-1,33
1,<environment.Job instance at 0x7f4c5a59edc0>,32,17,[6 4],33,-1,50,-1,33
1,<environment.Job instance at 0x7f4c5a56d410>,36,15,[5 6],37,-1,52,-1,37
1,<environment.Job instance at 0x7f4c5a56d7d0>,40,15,[1 8],41,-1,56,-1,41
1,<environment.Job instance at 0x7f4c5a56d910>,41,16,[5 5],42,-1,58,-1,42
1,<environment.Job instance at 0x7f4c5a56d550>,42,18,[2 5],43,-1,61,-1,43
1,<environment.Job instance at 0x7f4c5a56daa0>,44,14,[ 3 10],45,-1,59,-1,45
1,<environment.Job instance at 0x7f4c5a57cbe0>,59,17,[9 4],60,-1,77,-1,60
1,<environment.Job instance at 0x7f4c5a57cd20>,60,13,[10  1],61,-1,76,-1,63
1,<environment.Job instance at 0x7f4c5a57ce10>,63,18,[4 5],64,-1,82,-1,64
1,<environment.Job instance at 0x7f4c5a564050>,65,15,[1 5],66,-1,81,-1,66
1,<environment.Job instance at 0x7f4c5a564280>,66,16,[5 6],67,-1,83,-1,67
1,<environment.Job instance at 0x7f4c5a57c550>,53,20,[ 5 12],54,-1,92,-1,72
1,<environment.Job instance at 0x7f4c5a57c2d0>,55,16,[10  3],56,-1,88,-1,72
1,<environment.Job instance at 0x7f4c5a564e10>,78,16,[ 5 10],79,-1,102,-1,86
1,<environment.Job instance at 0x7f4c5a56dcd0>,47,16,[ 5 13],48,-1,102,-1,86
1,<environment.Job instance at 0x7f4c5a564960>,76,16,[13  1],77,-1,102,-1,86
1,<environment.Job instance at 0x7f4c5a564e60>,77,15,[10  4],78,-1,101,-1,86
1,<environment.Job instance at 0x7f4c5a598410>,85,13,[5 4],86,-1,99,-1,86
1,<environment.Job instance at 0x7f4c5a598730>,86,27,[2 9],87,-1,114,-1,87
1,<environment.Job instance at 0x7f4c5a598870>,89,18,[10  2],90,-1,109,-1,91
1,<environment.Job instance at 0x7f4c5a598910>,88,18,[ 5 10],89,-1,118,-1,100
1,<environment.Job instance at 0x7f4c5a598be0>,92,22,[8 1],93,-1,122,-1,100
1,<environment.Job instance at 0x7f4c5a598fa0>,98,16,[9 1],99,-1,119,-1,103
1,<environment.Job instance at 0x7f4c59a6b870>,101,27,[8 5],102,-1,132,-1,105
1,<environment.Job instance at 0x7f4c5985a910>,104,16,[11  4],105,-1,121,-1,105
1,<environment.Job instance at 0x7f4c5a598c80>,93,14,[14  4],94,-1,120,-1,106
1,<environment.Job instance at 0x7f4c59a59eb0>,105,14,[1 7],106,-1,120,-1,106
1,<environment.Job instance at 0x7f4c5a598aa0>,90,13,[2 8],91,-1,121,-1,108
1,<environment.Job instance at 0x7f4c5985a500>,107,18,[1 9],108,-1,126,-1,108
1,<environment.Job instance at 0x7f4c59a6faf0>,114,17,[10  5],115,-1,145,-1,128
1,<environment.Job instance at 0x7f4c59853370>,115,18,[5 6],116,-1,146,-1,128
1,<environment.Job instance at 0x7f4c5a598f00>,97,15,[ 5 12],98,-1,149,-1,134
1,<environment.Job instance at 0x7f4c5a562370>,122,18,[9 1],123,-1,154,-1,136
1,<environment.Job instance at 0x7f4c5a562050>,123,13,[3 9],124,-1,149,-1,136
1,<environment.Job instance at 0x7f4c5a598d20>,94,13,[5 8],95,-1,149,-1,136
1,<environment.Job instance at 0x7f4c5a562550>,125,3,[6 4],126,-1,139,-1,136
1,<environment.Job instance at 0x7f4c5a562460>,124,15,[2 7],125,-1,151,-1,136
1,<environment.Job instance at 0x7f4c5a562960>,129,12,[5 8],130,-1,151,-1,139
1,<environment.Job instance at 0x7f4c5a562b40>,132,18,[1 9],133,-1,172,-1,154
1,<environment.Job instance at 0x7f4c5a5851e0>,138,15,[3 8],139,-1,169,-1,154
1,<environment.Job instance at 0x7f4c5a585410>,139,25,[3 6],140,-1,179,-1,154
1,<environment.Job instance at 0x7f4c5af56690>,112,18,[10  5],113,-1,172,-1,154
1,<environment.Job instance at 0x7f4c5a56d190>,4,1,[13  5],5,-1,6,-1,5
1,<environment.Job instance at 0x7f4c5a57c230>,10,25,[5 3],11,-1,42,-1,17
1,<environment.Job instance at 0x7f4c5a564460>,11,16,[11  2],12,-1,33,-1,17
1,<environment.Job instance at 0x7f4c5985a320>,19,28,[3 9],20,-1,73,-1,45
1,<environment.Job instance at 0x7f4c5a562fa0>,22,23,[3 7],23,-1,71,-1,48
1,<environment.Job instance at 0x7f4c5a585b90>,26,3,[ 5 14],27,-1,54,-1,51
1,<environment.Job instance at 0x7f4c5a578be0>,37,16,[11  1],38,-1,100,-1,84
1,<environment.Job instance at 0x7f4c598813c0>,47,16,[ 5 13],48,-1,146,-1,130
1,<environment.Job instance at 0x7f4c59881fa0>,49,2,[13  4],50,-1,133,-1,131
1,<environment.Job instance at 0x7f4c59da1410>,53,20,[ 5 12],54,-1,153,-1,133
1,<environment.Job instance at 0x7f4c5a6a5b40>,54,2,[ 5 11],55,-1,135,-1,133
1,<environment.Job instance at 0x7f4c5aad3910>,61,2,[ 5 11],62,-1,155,-1,153
1,<environment.Job instance at 0x7f4c635b11e0>,69,13,[ 4 14],70,-1,187,-1,174
1,<environment.Job instance at 0x7f4c5a9b7370>,76,16,[13  1],77,-1,217,-1,201
1,<environment.Job instance at 0x7f4c6391e8c0>,86,27,[2 9],87,-1,266,-1,239
1,<environment.Job instance at 0x7f4c5a6229b0>,93,14,[14  4],94,-1,272,-1,258
1,<environment.Job instance at 0x7f4c59eb0aa0>,95,3,[ 1 13],96,-1,261,-1,258
1,<environment.Job instance at 0x7f4c59aba370>,96,2,[14  2],97,-1,260,-1,258
1,<environment.Job instance at 0x7f4c59eb0370>,97,15,[ 5 12],98,-1,273,-1,258
1,<environment.Job instance at 0x7f4c6370b730>,100,2,[14  4],101,-1,270,-1,268
1,<environment.Job instance at 0x7f4c5cfc9370>,101,27,[8 5],102,-1,302,-1,275
1,<environment.Job instance at 0x7f4c5ae4bc30>,104,16,[11  4],105,-1,293,-1,277
1,<environment.Job instance at 0x7f4c5a458b90>,108,16,[13  2],109,-1,297,-1,281
1,<environment.Job instance at 0x7f4c5a481d70>,111,14,[ 2 12],112,-1,309,-1,295
1,<environment.Job instance at 0x7f4c5981f500>,113,26,[7 1],114,-1,338,-1,312
1,<environment.Job instance at 0x7f4c5a4703c0>,139,25,[3 6],140,-1,436,-1,411
1,<environment.Job instance at 0x7f4c597e6780>,141,16,[ 5 12],142,-1,427,-1,411
1,<environment.Job instance at 0x7f4c597e6230>,143,17,[13  5],144,-1,434,-1,417
1,<environment.Job instance at 0x7f4c599f45f0>,155,2,[ 3 11],156,-1,453,-1,451
1,<environment.Job instance at 0x7f4c5ac66f00>,162,3,[ 4 11],163,-1,490,-1,487
1,<environment.Job instance at 0x7f4c5adff690>,168,24,[5 6],169,-1,543,-1,519
1,<environment.Job instance at 0x7f4c5adffb40>,170,3,[ 3 12],171,-1,522,-1,519
1,<environment.Job instance at 0x7f4c5adffeb0>,172,14,[14  5],173,-1,533,-1,519
1,<environment.Job instance at 0x7f4c5abbbb90>,0,20,[ 4 10],1,-1,21,-1,1
1,<environment.Job instance at 0x7f4c5ad8b410>,3,14,[ 4 10],4,-1,18,-1,4
1,<environment.Job instance at 0x7f4c5a9713c0>,6,24,[4 5],7,-1,31,-1,7
1,<environment.Job instance at 0x7f4c5a971870>,7,24,[4 8],8,-1,32,-1,8
1,<environment.Job instance at 0x7f4c5ac5ea00>,16,16,[4 9],17,-1,33,-1,17
1,<environment.Job instance at 0x7f4c5abc7550>,17,18,[6 1],18,-1,36,-1,18
1,<environment.Job instance at 0x7f4c5a1cd960>,19,15,[6 4],20,-1,35,-1,20
1,<environment.Job instance at 0x7f4c5a1cd320>,22,23,[6 2],23,-1,46,-1,23
1,<environment.Job instance at 0x7f4c59e515a0>,26,17,[1 6],27,-1,44,-1,27
1,<environment.Job instance at 0x7f4c59e51410>,27,13,[9 4],28,-1,42,-1,29
1,<environment.Job instance at 0x7f4c59e88b90>,32,18,[6 5],33,-1,51,-1,33
1,<environment.Job instance at 0x7f4c59e88190>,34,14,[ 5 10],35,-1,49,-1,35
1,<environment.Job instance at 0x7f4c5a88ef00>,36,16,[4 8],37,-1,53,-1,37
1,<environment.Job instance at 0x7f4c5a88ec30>,37,15,[4 8],38,-1,53,-1,38
1,<environment.Job instance at 0x7f4c5a88eaf0>,38,15,[1 6],39,-1,54,-1,39
1,<environment.Job instance at 0x7f4c5a1bbfa0>,44,17,[1 6],45,-1,62,-1,45
1,<environment.Job instance at 0x7f4c5a1bb460>,45,14,[3 8],46,-1,60,-1,46
1,<environment.Job instance at 0x7f4c5a1bb9b0>,46,17,[4 6],47,-1,64,-1,47
1,<environment.Job instance at 0x7f4c597e72d0>,48,18,[10  1],49,-1,67,-1,49
1,<environment.Job instance at 0x7f4c5a1bb140>,50,15,[4 7],51,-1,66,-1,51
1,<environment.Job instance at 0x7f4c59fcf910>,52,17,[ 1 10],53,-1,70,-1,53
1,<environment.Job instance at 0x7f4c59a90dc0>,53,15,[8 4],54,-1,69,-1,54
1,<environment.Job instance at 0x7f4c5a492500>,54,13,[1 9],55,-1,68,-1,55
1,<environment.Job instance at 0x7f4c599fe0f0>,55,24,[5 2],56,-1,80,-1,56
1,<environment.Job instance at 0x7f4c599ce0a0>,60,25,[6 2],61,-1,86,-1,61
1,<environment.Job instance at 0x7f4c599e3820>,61,17,[9 4],62,-1,79,-1,62
1,<environment.Job instance at 0x7f4c5af6e1e0>,65,14,[4 8],66,-1,80,-1,66
1,<environment.Job instance at 0x7f4c5af6e3c0>,66,12,[9 1],67,-1,79,-1,67
1,<environment.Job instance at 0x7f4c5af6e0f0>,68,18,[10  4],69,-1,87,-1,69
1,<environment.Job instance at 0x7f4c5af6e280>,69,13,[ 1 11],70,-1,83,-1,70
1,<environment.Job instance at 0x7f4c5af6e460>,70,25,[5 5],71,-1,96,-1,71
1,<environment.Job instance at 0x7f4c5af6e410>,71,13,[9 3],72,-1,85,-1,72
1,<environment.Job instance at 0x7f4c599d4640>,75,19,[2 8],76,-1,95,-1,76
1,<environment.Job instance at 0x7f4c5cfe8a50>,76,16,[ 1 10],77,-1,93,-1,77
1,<environment.Job instance at 0x7f4c5a6f0c80>,79,15,[ 5 10],80,-1,95,-1,80
1,<environment.Job instance at 0x7f4c5a6f05f0>,81,17,[ 2 10],82,-1,99,-1,82
1,<environment.Job instance at 0x7f4c59c24230>,82,16,[2 8],83,-1,99,-1,83
1,<environment.Job instance at 0x7f4c59c24af0>,85,18,[4 6],86,-1,104,-1,86
1,<environment.Job instance at 0x7f4c59c24820>,86,15,[5 9],87,-1,102,-1,87
1,<environment.Job instance at 0x7f4c59c24d20>,89,17,[ 1 10],90,-1,107,-1,90
1,<environment.Job instance at 0x7f4c59c24e60>,90,15,[8 4],91,-1,106,-1,91
1,<environment.Job instance at 0x7f4c59c24870>,91,12,[8 1],92,-1,104,-1,92
1,<environment.Job instance at 0x7f4c59c24960>,92,13,[5 3],93,-1,106,-1,93
1,<environment.Job instance at 0x7f4c59c24cd0>,94,19,[ 5 10],95,-1,114,-1,95
1,<environment.Job instance at 0x7f4c59c22690>,96,15,[3 9],97,-1,112,-1,97
1,<environment.Job instance at 0x7f4c59c22a50>,97,27,[8 5],98,-1,125,-1,98
1,<environment.Job instance at 0x7f4c5a711cd0>,100,13,[8 3],101,-1,114,-1,101
1,<environment.Job instance at 0x7f4c5af56af0>,105,15,[10  1],106,-1,121,-1,106
1,<environment.Job instance at 0x7f4c5af56cd0>,110,20,[8 5],111,-1,131,-1,111
1,<environment.Job instance at 0x7f4c5af56190>,113,2,[6 2],114,-1,116,-1,114
1,<environment.Job instance at 0x7f4c5a1cde10>,28,13,[4 8],29,-1,127,-1,114
1,<environment.Job instance at 0x7f4c5af56be0>,114,16,[5 8],115,-1,131,-1,115
1,<environment.Job instance at 0x7f4c5af4b190>,115,25,[4 5],116,-1,141,-1,116
1,<environment.Job instance at 0x7f4c5af4b2d0>,120,18,[3 5],121,-1,139,-1,121
1,<environment.Job instance at 0x7f4c5af60cd0>,132,18,[4 8],133,-1,151,-1,133
1,<environment.Job instance at 0x7f4c5af60eb0>,133,15,[ 2 10],134,-1,151,-1,136
1,<environment.Job instance at 0x7f4c5af4beb0>,128,12,[6 4],129,-1,149,-1,137
1,<environment.Job instance at 0x7f4c5af4baa0>,121,15,[3 7],122,-1,152,-1,137
1,<environment.Job instance at 0x7f4c59c21af0>,151,17,[7 4],152,-1,169,-1,152
1,<environment.Job instance at 0x7f4c5af60c80>,136,13,[6 4],137,-1,169,-1,156
1,<environment.Job instance at 0x7f4c59c21280>,155,13,[7 4],156,-1,170,-1,157
1,<environment.Job instance at 0x7f4c59c211e0>,156,16,[3 8],157,-1,173,-1,157
1,<environment.Job instance at 0x7f4c5af60d70>,131,13,[3 5],132,-1,183,-1,170
1,<environment.Job instance at 0x7f4c59c21780>,161,1,[5 3],162,-1,171,-1,170
1,<environment.Job instance at 0x7f4c59c21500>,164,12,[7 1],165,-1,182,-1,170
1,<environment.Job instance at 0x7f4c59c21410>,166,1,[11  3],167,-1,171,-1,170
1,<environment.Job instance at 0x7f4c59c357d0>,167,1,[8 4],168,-1,171,-1,170
1,<environment.Job instance at 0x7f4c59c35410>,168,12,[7 5],169,-1,182,-1,170
1,<environment.Job instance at 0x7f4c59c21870>,163,3,[7 1],164,-1,173,-1,170
1,<environment.Job instance at 0x7f4c59c241e0>,88,16,[14  4],89,-1,186,-1,170
1,<environment.Job instance at 0x7f4c59c35500>,170,18,[9 3],171,-1,192,-1,174
1,<environment.Job instance at 0x7f4c59c35460>,171,17,[9 4],172,-1,191,-1,174
1,<environment.Job instance at 0x7f4c5af609b0>,137,26,[ 3 10],138,-1,201,-1,175
1,<environment.Job instance at 0x7f4c59c21190>,165,3,[ 1 10],166,-1,178,-1,175
1,<environment.Job instance at 0x7f4c59fc6aa0>,176,17,[4 8],177,-1,194,-1,177
1,<environment.Job instance at 0x7f4c5a7111e0>,173,14,[14  1],174,-1,191,-1,177
1,<environment.Job instance at 0x7f4c59fd05f0>,177,14,[5 6],178,-1,192,-1,178
1,<environment.Job instance at 0x7f4c5aecffa0>,178,16,[8 4],179,-1,196,-1,180
1,<environment.Job instance at 0x7f4c5af6ed20>,6,24,[4 5],7,-1,44,-1,20
1,<environment.Job instance at 0x7f4c59c24a50>,7,24,[4 8],8,-1,45,-1,21
1,<environment.Job instance at 0x7f4c59c2c9b0>,22,23,[6 2],23,-1,67,-1,44
1,<environment.Job instance at 0x7f4c5af7a8c0>,24,3,[ 1 12],25,-1,47,-1,44
1,<environment.Job instance at 0x7f4c59c2c0f0>,25,14,[12  1],26,-1,58,-1,44
1,<environment.Job instance at 0x7f4c5a46c7d0>,33,1,[11  3],34,-1,63,-1,62
1,<environment.Job instance at 0x7f4c5a63da50>,35,28,[ 4 12],36,-1,91,-1,63
1,<environment.Job instance at 0x7f4c59f2a8c0>,39,1,[ 4 13],40,-1,91,-1,90
1,<environment.Job instance at 0x7f4c59f2a2d0>,43,14,[ 2 11],44,-1,119,-1,105
1,<environment.Job instance at 0x7f4c5a578460>,55,24,[5 2],56,-1,183,-1,159
1,<environment.Job instance at 0x7f4c5a585f00>,60,25,[6 2],61,-1,211,-1,186
1,<environment.Job instance at 0x7f4c5a564190>,69,13,[ 1 11],70,-1,218,-1,205
1,<environment.Job instance at 0x7f4c5a5649b0>,70,25,[5 5],71,-1,233,-1,208
1,<environment.Job instance at 0x7f4c5a57c230>,73,3,[ 4 11],74,-1,211,-1,208
1,<environment.Job instance at 0x7f4c598fb3c0>,88,16,[14  4],89,-1,286,-1,270
1,<environment.Job instance at 0x7f4c5abc7f50>,97,27,[8 5],98,-1,339,-1,312
1,<environment.Job instance at 0x7f4c5abc77d0>,99,3,[ 1 12],100,-1,315,-1,312
1,<environment.Job instance at 0x7f4c5abc7a50>,103,17,[13  3],104,-1,337,-1,320
1,<environment.Job instance at 0x7f4c5abc7370>,104,3,[13  1],105,-1,323,-1,320
1,<environment.Job instance at 0x7f4c59e51cd0>,115,25,[4 5],116,-1,377,-1,352
1,<environment.Job instance at 0x7f4c59e51280>,118,1,[ 4 14],119,-1,364,-1,363
1,<environment.Job instance at 0x7f4c59e88b40>,130,2,[13  2],131,-1,392,-1,390
1,<environment.Job instance at 0x7f4c59e88500>,134,1,[12  5],135,-1,398,-1,397
1,<environment.Job instance at 0x7f4c5a88e0f0>,137,26,[ 3 10],138,-1,441,-1,415
1,<environment.Job instance at 0x7f4c5a461aa0>,141,3,[12  2],142,-1,434,-1,431
1,<environment.Job instance at 0x7f4c5abbb5f0>,154,3,[14  3],155,-1,456,-1,453
1,<environment.Job instance at 0x7f4c597d2500>,166,1,[11  3],167,-1,502,-1,501
1,<environment.Job instance at 0x7f4c599a5690>,173,14,[14  1],174,-1,541,-1,527
1,<environment.Job instance at 0x7f4c597a0690>,11,18,[7 1],12,-1,31,-1,13
1,<environment.Job instance at 0x7f4c597a0910>,13,15,[ 2 12],14,-1,29,-1,14
1,<environment.Job instance at 0x7f4c597a0960>,15,16,[3 5],16,-1,32,-1,16
1,<environment.Job instance at 0x7f4c597a0e60>,19,14,[7 3],20,-1,34,-1,20
1,<environment.Job instance at 0x7f4c597a0fa0>,20,14,[8 2],21,-1,35,-1,21
1,<environment.Job instance at 0x7f4c597a0eb0>,21,26,[7 2],22,-1,48,-1,22
1,<environment.Job instance at 0x7f4c5979c0a0>,22,17,[1 5],23,-1,40,-1,23
1,<environment.Job instance at 0x7f4c5979c1e0>,24,18,[4 8],25,-1,43,-1,25
1,<environment.Job instance at 0x7f4c5979c550>,27,15,[6 1],28,-1,43,-1,28
1,<environment.Job instance at 0x7f4c5979c690>,28,15,[10  2],29,-1,44,-1,29
1,<environment.Job instance at 0x7f4c5979c4b0>,29,13,[4 7],30,-1,43,-1,30
1,<environment.Job instance at 0x7f4c5979c820>,31,23,[5 9],32,-1,55,-1,32
1,<environment.Job instance at 0x7f4c5979ca00>,32,14,[5 2],33,-1,47,-1,33
1,<environment.Job instance at 0x7f4c5979ceb0>,37,22,[2 9],38,-1,60,-1,38
1,<environment.Job instance at 0x7f4c5978a1e0>,40,13,[5 8],41,-1,58,-1,45
1,<environment.Job instance at 0x7f4c5978a4b0>,43,15,[ 3 10],44,-1,62,-1,47
1,<environment.Job instance at 0x7f4c5978a820>,45,14,[7 5],46,-1,61,-1,47
1,<environment.Job instance at 0x7f4c5978a7d0>,47,16,[8 4],48,-1,64,-1,48
1,<environment.Job instance at 0x7f4c5978a780>,46,20,[8 2],47,-1,68,-1,48
1,<environment.Job instance at 0x7f4c5978ac30>,50,15,[10  5],51,-1,67,-1,52
1,<environment.Job instance at 0x7f4c5978ab40>,52,12,[8 2],53,-1,71,-1,59
1,<environment.Job instance at 0x7f4c597c3370>,59,20,[ 3 11],60,-1,80,-1,60
1,<environment.Job instance at 0x7f4c5978a140>,41,16,[5 2],42,-1,78,-1,62
1,<environment.Job instance at 0x7f4c597c32d0>,58,14,[13  4],59,-1,76,-1,62
1,<environment.Job instance at 0x7f4c597c3500>,61,16,[8 4],62,-1,82,-1,66
1,<environment.Job instance at 0x7f4c597c3a00>,67,16,[8 4],68,-1,84,-1,68
1,<environment.Job instance at 0x7f4c597c3280>,57,12,[ 2 12],58,-1,91,-1,79
1,<environment.Job instance at 0x7f4c5978f1e0>,73,13,[10  3],74,-1,92,-1,79
1,<environment.Job instance at 0x7f4c5978a8c0>,48,26,[2 5],49,-1,105,-1,79
1,<environment.Job instance at 0x7f4c597c3cd0>,70,15,[1 8],71,-1,96,-1,81
1,<environment.Job instance at 0x7f4c5978f910>,80,12,[9 4],81,-1,93,-1,81
1,<environment.Job instance at 0x7f4c5978f5f0>,77,14,[4 7],78,-1,95,-1,81
1,<environment.Job instance at 0x7f4c5978f9b0>,81,23,[1 8],82,-1,106,-1,83
1,<environment.Job instance at 0x7f4c5978f820>,78,1,[3 6],79,-1,89,-1,88
1,<environment.Job instance at 0x7f4c5978fbe0>,83,16,[ 5 10],84,-1,104,-1,88
1,<environment.Job instance at 0x7f4c5978fc80>,85,15,[ 1 10],86,-1,103,-1,88
1,<environment.Job instance at 0x7f4c5978faf0>,82,14,[3 7],83,-1,102,-1,88
1,<environment.Job instance at 0x7f4c597a7140>,91,13,[5 8],92,-1,112,-1,99
1,<environment.Job instance at 0x7f4c5978fd20>,86,13,[ 5 11],87,-1,112,-1,99
1,<environment.Job instance at 0x7f4c597a7820>,97,18,[ 1 10],98,-1,117,-1,99
1,<environment.Job instance at 0x7f4c597a7780>,98,12,[6 3],99,-1,111,-1,99
1,<environment.Job instance at 0x7f4c597a73c0>,92,14,[6 2],93,-1,118,-1,104
1,<environment.Job instance at 0x7f4c597bc140>,103,16,[9 5],104,-1,120,-1,104
1,<environment.Job instance at 0x7f4c5ab114b0>,104,28,[7 4],105,-1,134,-1,106
1,<environment.Job instance at 0x7f4c59c15960>,105,20,[7 2],106,-1,126,-1,106
1,<environment.Job instance at 0x7f4c5af3d5a0>,106,14,[10  3],107,-1,123,-1,109
1,<environment.Job instance at 0x7f4c5af3df50>,109,17,[5 2],110,-1,127,-1,110
1,<environment.Job instance at 0x7f4c5af3d1e0>,111,17,[9 3],112,-1,137,-1,120
1,<environment.Job instance at 0x7f4c5af3da00>,113,15,[2 7],114,-1,137,-1,122
1,<environment.Job instance at 0x7f4c59f985a0>,114,19,[1 8],115,-1,144,-1,125
1,<environment.Job instance at 0x7f4c59858550>,116,17,[8 4],117,-1,143,-1,126
1,<environment.Job instance at 0x7f4c5af3da50>,108,2,[7 1],109,-1,129,-1,127
1,<environment.Job instance at 0x7f4c597a7690>,96,25,[8 1],97,-1,154,-1,129
1,<environment.Job instance at 0x7f4c59c71e60>,120,13,[8 4],121,-1,144,-1,131
1,<environment.Job instance at 0x7f4c59c4c1e0>,123,20,[4 5],124,-1,151,-1,131
1,<environment.Job instance at 0x7f4c59fa4aa0>,125,20,[5 5],126,-1,151,-1,131
1,<environment.Job instance at 0x7f4c5af3dbe0>,107,17,[5 6],108,-1,149,-1,132
1,<environment.Job instance at 0x7f4c59b70c30>,126,18,[7 3],127,-1,150,-1,132
1,<environment.Job instance at 0x7f4c5984f1e0>,130,16,[ 2 10],131,-1,148,-1,132
1,<environment.Job instance at 0x7f4c5a031820>,131,18,[3 9],132,-1,150,-1,132
1,<environment.Job instance at 0x7f4c59a72c80>,127,13,[14  1],128,-1,150,-1,137
1,<environment.Job instance at 0x7f4c5a018550>,133,15,[1 5],134,-1,154,-1,139
1,<environment.Job instance at 0x7f4c59b7aa00>,128,18,[1 5],129,-1,157,-1,139
1,<environment.Job instance at 0x7f4c59fa21e0>,138,13,[8 5],139,-1,154,-1,141
1,<environment.Job instance at 0x7f4c5a0216e0>,141,25,[1 6],142,-1,167,-1,142
1,<environment.Job instance at 0x7f4c5a021eb0>,144,17,[5 5],145,-1,163,-1,146
1,<environment.Job instance at 0x7f4c59c4ee60>,149,15,[9 1],150,-1,166,-1,151
1,<environment.Job instance at 0x7f4c59c4ef50>,150,12,[10  4],151,-1,163,-1,151
1,<environment.Job instance at 0x7f4c59c4eaa0>,151,15,[10  4],152,-1,167,-1,152
1,<environment.Job instance at 0x7f4c597c3050>,56,24,[2 9],57,-1,181,-1,157
1,<environment.Job instance at 0x7f4c59c55140>,159,27,[ 3 10],160,-1,187,-1,160
1,<environment.Job instance at 0x7f4c5a0106e0>,162,26,[9 1],163,-1,221,-1,195
1,<environment.Job instance at 0x7f4c5a1804b0>,167,20,[10  2],168,-1,215,-1,195
1,<environment.Job instance at 0x7f4c5a0161e0>,157,28,[7 2],158,-1,223,-1,195
1,<environment.Job instance at 0x7f4c597a0be0>,2,17,[ 5 14],3,-1,20,-1,3
1,<environment.Job instance at 0x7f4c597c3dc0>,13,15,[ 2 12],14,-1,31,-1,16
1,<environment.Job instance at 0x7f4c5ab11780>,18,2,[13  1],19,-1,44,-1,42
1,<environment.Job instance at 0x7f4c5a3b6370>,21,26,[7 2],22,-1,85,-1,59
1,<environment.Job instance at 0x7f4c5a02d230>,33,3,[ 1 14],34,-1,98,-1,95
1,<environment.Job instance at 0x7f4c5af77a00>,36,1,[ 3 13],37,-1,100,-1,99
1,<environment.Job instance at 0x7f4c59c4e190>,31,23,[5 9],32,-1,140,-1,117
1,<environment.Job instance at 0x7f4c5a7a7e60>,48,26,[2 5],49,-1,163,-1,137
1,<environment.Job instance at 0x7f4c5abbb780>,56,24,[2 9],57,-1,196,-1,172
1,<environment.Job instance at 0x7f4c5cfe81e0>,57,12,[ 2 12],58,-1,184,-1,172
1,<environment.Job instance at 0x7f4c5cfe8fa0>,58,14,[13  4],59,-1,186,-1,172
1,<environment.Job instance at 0x7f4c5a02b870>,59,20,[ 3 11],60,-1,192,-1,172
1,<environment.Job instance at 0x7f4c59e887d0>,76,1,[ 3 11],77,-1,224,-1,223
1,<environment.Job instance at 0x7f4c59e88640>,81,23,[1 8],82,-1,262,-1,239
1,<environment.Job instance at 0x7f4c5a1cd8c0>,86,13,[ 5 11],87,-1,270,-1,257
1,<environment.Job instance at 0x7f4c59e510f0>,96,25,[8 1],97,-1,327,-1,302
1,<environment.Job instance at 0x7f4c5a971b90>,104,28,[7 4],105,-1,340,-1,312
1,<environment.Job instance at 0x7f4c5a56daf0>,127,13,[14  1],128,-1,416,-1,403
1,<environment.Job instance at 0x7f4c5a5649b0>,136,2,[14  1],137,-1,437,-1,435
1,<environment.Job instance at 0x7f4c5a562640>,141,25,[1 6],142,-1,478,-1,453
1,<environment.Job instance at 0x7f4c5a5620f0>,142,12,[12  2],143,-1,465,-1,453
1,<environment.Job instance at 0x7f4c5a5852d0>,143,26,[10  4],144,-1,482,-1,456
1,<environment.Job instance at 0x7f4c5a57aaa0>,145,24,[4 7],146,-1,481,-1,457
1,<environment.Job instance at 0x7f4c5a5815a0>,154,13,[ 5 11],155,-1,504,-1,491
1,<environment.Job instance at 0x7f4c5a581050>,157,28,[7 2],158,-1,528,-1,500
1,<environment.Job instance at 0x7f4c5a581410>,159,27,[ 3 10],160,-1,541,-1,514
1,<environment.Job instance at 0x7f4c5a63da50>,162,26,[9 1],163,-1,543,-1,517
1,<environment.Job instance at 0x7f4c5a9b77d0>,166,3,[ 2 14],167,-1,530,-1,527
1,<environment.Job instance at 0x7f4c59c2c9b0>,177,27,[9 4],178,-1,610,-1,583
1,<environment.Job instance at 0x7f4c5a9ae690>,2,18,[2 5],3,-1,21,-1,3
1,<environment.Job instance at 0x7f4c5a865aa0>,4,15,[10  1],5,-1,21,-1,6
1,<environment.Job instance at 0x7f4c5a865910>,6,14,[2 6],7,-1,21,-1,7
1,<environment.Job instance at 0x7f4c59dc05f0>,5,15,[8 4],6,-1,22,-1,7
1,<environment.Job instance at 0x7f4c5a865dc0>,10,16,[1 6],11,-1,28,-1,12
1,<environment.Job instance at 0x7f4c5a865a50>,12,15,[10  3],13,-1,30,-1,15
1,<environment.Job instance at 0x7f4c5a865230>,14,18,[9 3],15,-1,33,-1,15
1,<environment.Job instance at 0x7f4c5a8656e0>,15,16,[3 8],16,-1,33,-1,17
1,<environment.Job instance at 0x7f4c599f41e0>,19,14,[4 7],20,-1,34,-1,20
1,<environment.Job instance at 0x7f4c599f48c0>,20,14,[1 7],21,-1,35,-1,21
1,<environment.Job instance at 0x7f4c5cfc5370>,27,17,[ 5 10],28,-1,46,-1,29
1,<environment.Job instance at 0x7f4c5cfc5550>,29,23,[5 7],30,-1,53,-1,30
1,<environment.Job instance at 0x7f4c5cfc5190>,28,21,[2 5],29,-1,56,-1,35
1,<environment.Job instance at 0x7f4c5acf7b40>,41,18,[9 3],42,-1,66,-1,48
1,<environment.Job instance at 0x7f4c5cfc5690>,33,25,[ 1 10],34,-1,73,-1,48
1,<environment.Job instance at 0x7f4c5acf7a00>,37,19,[ 2 10],38,-1,106,-1,87
1,<environment.Job instance at 0x7f4c59d8ea50>,53,13,[10  4],54,-1,100,-1,87
1,<environment.Job instance at 0x7f4c59867e10>,57,15,[8 5],58,-1,103,-1,88
1,<environment.Job instance at 0x7f4c59d8e780>,48,18,[7 1],49,-1,106,-1,88
1,<environment.Job instance at 0x7f4c598672d0>,67,21,[10  4],68,-1,168,-1,147
1,<environment.Job instance at 0x7f4c59b80be0>,73,14,[6 4],74,-1,161,-1,147
1,<environment.Job instance at 0x7f4c59b80370>,75,12,[10  3],76,-1,162,-1,150
1,<environment.Job instance at 0x7f4c59b80410>,76,16,[1 7],77,-1,166,-1,150
1,<environment.Job instance at 0x7f4c59867460>,66,23,[ 5 12],67,-1,173,-1,150
1,<environment.Job instance at 0x7f4c59b80fa0>,79,14,[2 5],80,-1,164,-1,150
1,<environment.Job instance at 0x7f4c59b800f0>,81,16,[1 5],82,-1,166,-1,150
1,<environment.Job instance at 0x7f4c59b80e10>,82,18,[1 5],83,-1,168,-1,150
1,<environment.Job instance at 0x7f4c5aee96e0>,83,15,[2 8],84,-1,165,-1,150
1,<environment.Job instance at 0x7f4c5a1c11e0>,104,17,[4 9],105,-1,253,-1,236
1,<environment.Job instance at 0x7f4c59f720a0>,101,18,[14  2],102,-1,255,-1,237
1,<environment.Job instance at 0x7f4c59b6e910>,106,18,[1 8],107,-1,255,-1,237
1,<environment.Job instance at 0x7f4c597e43c0>,107,27,[4 8],108,-1,264,-1,237
1,<environment.Job instance at 0x7f4c59873e60>,108,20,[ 4 13],109,-1,258,-1,238
1,<environment.Job instance at 0x7f4c59ab95a0>,122,15,[9 5],123,-1,296,-1,281
1,<environment.Job instance at 0x7f4c5a854550>,140,17,[5 8],141,-1,369,-1,352
1,<environment.Job instance at 0x7f4c5ad86320>,146,17,[5 1],147,-1,369,-1,352
1,<environment.Job instance at 0x7f4c5ae58050>,133,18,[ 5 13],134,-1,370,-1,352
1,<environment.Job instance at 0x7f4c5ad863c0>,144,18,[6 5],145,-1,370,-1,352
1,<environment.Job instance at 0x7f4c5a7ae4b0>,149,16,[5 5],150,-1,369,-1,353
1,<environment.Job instance at 0x7f4c59786eb0>,155,18,[4 9],156,-1,375,-1,357
1,<environment.Job instance at 0x7f4c59d8ef50>,8,17,[13  5],9,-1,33,-1,16
1,<environment.Job instance at 0x7f4c636425f0>,22,13,[13  5],23,-1,79,-1,66
1,<environment.Job instance at 0x7f4c5a2cfc80>,25,2,[ 2 12],26,-1,80,-1,78
1,<environment.Job instance at 0x7f4c59b89780>,29,23,[5 7],30,-1,106,-1,83
1,<environment.Job instance at 0x7f4c59d68960>,33,25,[ 1 10],34,-1,138,-1,113
1,<environment.Job instance at 0x7f4c59c77fa0>,36,12,[14  2],37,-1,125,-1,113
1,<environment.Job instance at 0x7f4c59884640>,38,1,[ 5 14],39,-1,114,-1,113
1,<environment.Job instance at 0x7f4c5aee9730>,50,12,[ 1 13],51,-1,158,-1,146
1,<environment.Job instance at 0x7f4c59c21140>,55,2,[11  4],56,-1,162,-1,160
1,<environment.Job instance at 0x7f4c59f2a910>,64,14,[ 1 12],65,-1,198,-1,184
1,<environment.Job instance at 0x7f4c59f2ab40>,66,23,[ 5 12],67,-1,215,-1,192
1,<environment.Job instance at 0x7f4c5a5812d0>,72,1,[ 4 11],73,-1,210,-1,209
1,<environment.Job instance at 0x7f4c5a5620f0>,84,3,[ 1 12],85,-1,244,-1,241
1,<environment.Job instance at 0x7f4c5a564910>,90,25,[6 2],91,-1,296,-1,271
1,<environment.Job instance at 0x7f4c5a57c5a0>,92,3,[14  1],93,-1,274,-1,271
1,<environment.Job instance at 0x7f4c5a57cc30>,93,1,[ 4 12],94,-1,272,-1,271
1,<environment.Job instance at 0x7f4c598fbaa0>,101,18,[14  2],102,-1,312,-1,294
1,<environment.Job instance at 0x7f4c5a3bd370>,105,15,[12  5],106,-1,315,-1,300
1,<environment.Job instance at 0x7f4c5abc7910>,108,20,[ 4 13],109,-1,334,-1,314
1,<environment.Job instance at 0x7f4c5abc7be0>,107,27,[4 8],108,-1,353,-1,326
1,<environment.Job instance at 0x7f4c59e88a50>,133,18,[ 5 13],134,-1,420,-1,402
1,<environment.Job instance at 0x7f4c5a02d3c0>,167,14,[ 3 12],168,-1,550,-1,536
1,<environment.Job instance at 0x7f4c59c6cc80>,175,23,[7 3],176,-1,583,-1,560
1,<environment.Job instance at 0x7f4c5a7977d0>,1,16,[1 7],2,-1,18,-1,2
1,<environment.Job instance at 0x7f4c5a797780>,8,18,[5 9],9,-1,27,-1,9
1,<environment.Job instance at 0x7f4c5a797e60>,9,16,[8 4],10,-1,29,-1,13
1,<environment.Job instance at 0x7f4c5a797a50>,13,16,[5 9],14,-1,30,-1,14
1,<environment.Job instance at 0x7f4c5a7975f0>,14,16,[3 5],15,-1,31,-1,15
1,<environment.Job instance at 0x7f4c5a797b40>,15,15,[ 3 10],16,-1,31,-1,16
1,<environment.Job instance at 0x7f4c5a797870>,12,16,[4 7],13,-1,37,-1,21
1,<environment.Job instance at 0x7f4c5a43ecd0>,22,26,[9 3],23,-1,49,-1,23
1,<environment.Job instance at 0x7f4c5a43e190>,25,15,[8 3],26,-1,43,-1,28
1,<environment.Job instance at 0x7f4c5a43e6e0>,27,13,[9 2],28,-1,43,-1,30
1,<environment.Job instance at 0x7f4c5a798190>,35,18,[6 4],36,-1,54,-1,36
1,<environment.Job instance at 0x7f4c5a7980a0>,37,22,[6 4],38,-1,60,-1,38
1,<environment.Job instance at 0x7f4c5a798f50>,38,13,[7 2],39,-1,52,-1,39
1,<environment.Job instance at 0x7f4c5a798870>,40,15,[4 9],41,-1,56,-1,41
1,<environment.Job instance at 0x7f4c5a937410>,44,17,[9 5],45,-1,62,-1,45
1,<environment.Job instance at 0x7f4c5a937be0>,46,12,[9 2],47,-1,59,-1,47
1,<environment.Job instance at 0x7f4c596ce9b0>,47,18,[3 7],48,-1,70,-1,52
1,<environment.Job instance at 0x7f4c596ce2d0>,51,17,[7 1],52,-1,71,-1,54
1,<environment.Job instance at 0x7f4c596ce550>,54,18,[ 2 10],55,-1,73,-1,55
1,<environment.Job instance at 0x7f4c596ceeb0>,55,19,[10  1],56,-1,75,-1,56
1,<environment.Job instance at 0x7f4c596cecd0>,56,14,[2 9],57,-1,71,-1,57
1,<environment.Job instance at 0x7f4c596ceaa0>,58,23,[1 5],59,-1,83,-1,60
1,<environment.Job instance at 0x7f4c596ce410>,53,12,[ 4 10],54,-1,73,-1,61
1,<environment.Job instance at 0x7f4c596d8a00>,61,17,[8 4],62,-1,80,-1,63
1,<environment.Job instance at 0x7f4c596d8050>,63,18,[10  4],64,-1,82,-1,64
1,<environment.Job instance at 0x7f4c596d8aa0>,64,14,[ 4 10],65,-1,79,-1,65
1,<environment.Job instance at 0x7f4c596ce870>,48,12,[14  5],49,-1,81,-1,69
1,<environment.Job instance at 0x7f4c596d8a50>,67,20,[5 3],68,-1,89,-1,69
1,<environment.Job instance at 0x7f4c596d8c30>,71,16,[ 2 10],72,-1,88,-1,72
1,<environment.Job instance at 0x7f4c596d8780>,70,16,[10  2],71,-1,88,-1,72
1,<environment.Job instance at 0x7f4c5a798550>,32,12,[9 4],33,-1,85,-1,73
1,<environment.Job instance at 0x7f4c596aa6e0>,73,16,[1 9],74,-1,93,-1,77
1,<environment.Job instance at 0x7f4c596aa280>,76,17,[13  4],77,-1,94,-1,77
1,<environment.Job instance at 0x7f4c5a798eb0>,36,15,[ 1 11],37,-1,94,-1,79
1,<environment.Job instance at 0x7f4c596aaaf0>,78,13,[7 4],79,-1,92,-1,79
1,<environment.Job instance at 0x7f4c596d8190>,62,15,[1 9],63,-1,94,-1,79
1,<environment.Job instance at 0x7f4c596aa8c0>,80,17,[1 7],81,-1,99,-1,82
1,<environment.Job instance at 0x7f4c596aa410>,82,15,[6 2],83,-1,98,-1,83
1,<environment.Job instance at 0x7f4c596aaeb0>,84,17,[12  2],85,-1,102,-1,85
1,<environment.Job instance at 0x7f4c5a415370>,85,16,[2 9],86,-1,125,-1,109
1,<environment.Job instance at 0x7f4c5a9380f0>,95,17,[14  3],96,-1,128,-1,111
1,<environment.Job instance at 0x7f4c5a938a50>,97,24,[1 8],98,-1,135,-1,111
1,<environment.Job instance at 0x7f4c5a44b0f0>,102,24,[7 2],103,-1,136,-1,112
1,<environment.Job instance at 0x7f4c596aae60>,79,17,[ 1 11],80,-1,129,-1,112
1,<environment.Job instance at 0x7f4c59664dc0>,104,27,[5 1],105,-1,139,-1,112
1,<environment.Job instance at 0x7f4c596aa640>,75,15,[2 8],76,-1,127,-1,112
1,<environment.Job instance at 0x7f4c5a4159b0>,86,12,[7 4],87,-1,126,-1,114
1,<environment.Job instance at 0x7f4c5a44bdc0>,103,18,[1 7],104,-1,133,-1,115
1,<environment.Job instance at 0x7f4c5a437a50>,111,18,[5 6],112,-1,133,-1,115
1,<environment.Job instance at 0x7f4c5a437a00>,114,14,[ 4 10],115,-1,129,-1,115
1,<environment.Job instance at 0x7f4c59a9a820>,115,16,[6 5],116,-1,134,-1,118
1,<environment.Job instance at 0x7f4c63a86550>,106,13,[4 9],107,-1,133,-1,120
1,<environment.Job instance at 0x7f4c5a08c280>,122,16,[3 7],123,-1,143,-1,127
1,<environment.Job instance at 0x7f4c5a335be0>,117,18,[3 8],118,-1,145,-1,127
1,<environment.Job instance at 0x7f4c5aa64b40>,123,15,[9 4],124,-1,146,-1,131
1,<environment.Job instance at 0x7f4c5ad4d910>,127,18,[2 8],128,-1,150,-1,132
1,<environment.Job instance at 0x7f4c5ae88f50>,126,14,[7 3],127,-1,150,-1,136
1,<environment.Job instance at 0x7f4c5a50e5f0>,131,14,[1 8],132,-1,151,-1,137
1,<environment.Job instance at 0x7f4c5abc1910>,132,16,[6 4],133,-1,153,-1,137
1,<environment.Job instance at 0x7f4c5992ea50>,119,14,[2 7],120,-1,151,-1,137
1,<environment.Job instance at 0x7f4c59695730>,135,27,[1 5],136,-1,164,-1,137
1,<environment.Job instance at 0x7f4c5aa82140>,140,15,[8 4],141,-1,156,-1,141
1,<environment.Job instance at 0x7f4c5adda820>,141,18,[7 3],142,-1,160,-1,142
1,<environment.Job instance at 0x7f4c596957d0>,136,18,[ 2 10],137,-1,161,-1,143
1,<environment.Job instance at 0x7f4c59808690>,99,13,[9 4],100,-1,156,-1,143
1,<environment.Job instance at 0x7f4c5aab46e0>,142,17,[1 7],143,-1,160,-1,143
1,<environment.Job instance at 0x7f4c59c495a0>,147,15,[ 3 10],148,-1,167,-1,152
1,<environment.Job instance at 0x7f4c59c49a50>,148,12,[10  1],149,-1,164,-1,152
1,<environment.Job instance at 0x7f4c59c49be0>,149,12,[4 6],150,-1,165,-1,153
1,<environment.Job instance at 0x7f4c59c498c0>,150,17,[5 2],151,-1,170,-1,153
1,<environment.Job instance at 0x7f4c59c49910>,151,21,[8 4],152,-1,176,-1,155
1,<environment.Job instance at 0x7f4c5a437cd0>,116,15,[1 6],117,-1,171,-1,156
1,<environment.Job instance at 0x7f4c59c49f00>,152,16,[1 7],153,-1,172,-1,156
1,<environment.Job instance at 0x7f4c5a144050>,155,18,[4 5],156,-1,174,-1,156
1,<environment.Job instance at 0x7f4c5af030f0>,133,12,[10  2],134,-1,169,-1,157
1,<environment.Job instance at 0x7f4c5a144b90>,157,18,[2 7],158,-1,176,-1,158
1,<environment.Job instance at 0x7f4c5a482050>,160,15,[6 1],161,-1,180,-1,165
1,<environment.Job instance at 0x7f4c59648960>,164,20,[8 2],165,-1,185,-1,165
1,<environment.Job instance at 0x7f4c596485a0>,165,14,[4 9],166,-1,180,-1,166
1,<environment.Job instance at 0x7f4c5aaddd70>,170,21,[10  5],171,-1,195,-1,174
1,<environment.Job instance at 0x7f4c596fc140>,173,19,[7 1],174,-1,193,-1,174
1,<environment.Job instance at 0x7f4c5a43e820>,2,18,[ 3 13],3,-1,21,-1,3
1,<environment.Job instance at 0x7f4c59c49410>,26,3,[12  4],27,-1,74,-1,71
1,<environment.Job instance at 0x7f4c5ad4d140>,22,26,[9 3],23,-1,103,-1,77
1,<environment.Job instance at 0x7f4c5964e2d0>,36,15,[ 1 11],37,-1,118,-1,103
1,<environment.Job instance at 0x7f4c5a1e4960>,48,12,[14  5],49,-1,160,-1,148
1,<environment.Job instance at 0x7f4c59867f50>,58,23,[1 5],59,-1,220,-1,197
1,<environment.Job instance at 0x7f4c59867370>,59,2,[12  2],60,-1,199,-1,197
1,<environment.Job instance at 0x7f4c59df4e10>,76,17,[13  4],77,-1,277,-1,260
1,<environment.Job instance at 0x7f4c59df45f0>,79,17,[ 1 11],80,-1,285,-1,268
1,<environment.Job instance at 0x7f4c59df46e0>,84,17,[12  2],85,-1,308,-1,291
1,<environment.Job instance at 0x7f4c5a9380a0>,92,1,[ 1 11],93,-1,310,-1,309
1,<environment.Job instance at 0x7f4c5a938c80>,94,12,[ 3 12],95,-1,333,-1,321
1,<environment.Job instance at 0x7f4c5a9381e0>,95,17,[14  3],96,-1,338,-1,321
1,<environment.Job instance at 0x7f4c5a938b90>,97,24,[1 8],98,-1,363,-1,339
1,<environment.Job instance at 0x7f4c5a938a00>,102,24,[7 2],103,-1,366,-1,342
1,<environment.Job instance at 0x7f4c5a9385f0>,104,27,[5 1],105,-1,378,-1,351
1,<environment.Job instance at 0x7f4c596750f0>,105,1,[ 5 12],106,-1,352,-1,351
1,<environment.Job instance at 0x7f4c596755a0>,108,3,[13  2],109,-1,358,-1,355
1,<environment.Job instance at 0x7f4c59675690>,120,3,[13  5],121,-1,400,-1,397
1,<environment.Job instance at 0x7f4c5a447cd0>,125,3,[14  3],126,-1,431,-1,428
1,<environment.Job instance at 0x7f4c5a447500>,135,27,[1 5],136,-1,490,-1,463
1,<environment.Job instance at 0x7f4c5a4474b0>,139,3,[13  3],140,-1,482,-1,479
1,<environment.Job instance at 0x7f4c5a6442d0>,2,16,[9 2],3,-1,23,-1,7
1,<environment.Job instance at 0x7f4c5a644a50>,8,12,[ 4 10],9,-1,21,-1,9
1,<environment.Job instance at 0x7f4c597023c0>,11,15,[9 3],12,-1,27,-1,12
1,<environment.Job instance at 0x7f4c59702690>,12,17,[4 9],13,-1,30,-1,13
1,<environment.Job instance at 0x7f4c59702320>,14,24,[7 3],15,-1,39,-1,15
1,<environment.Job instance at 0x7f4c59702910>,15,13,[7 2],16,-1,29,-1,16
1,<environment.Job instance at 0x7f4c59702730>,16,21,[5 3],17,-1,38,-1,17
1,<environment.Job instance at 0x7f4c59702960>,17,22,[1 9],18,-1,40,-1,18
1,<environment.Job instance at 0x7f4c59702a00>,18,16,[1 7],19,-1,35,-1,19
1,<environment.Job instance at 0x7f4c59702b40>,20,12,[10  5],21,-1,33,-1,21
1,<environment.Job instance at 0x7f4c59702c80>,21,16,[10  1],22,-1,38,-1,22
1,<environment.Job instance at 0x7f4c59702dc0>,23,17,[8 3],24,-1,41,-1,24
1,<environment.Job instance at 0x7f4c59702e60>,25,27,[2 8],26,-1,53,-1,26
1,<environment.Job instance at 0x7f4c5a6aa820>,32,24,[5 7],33,-1,57,-1,33
1,<environment.Job instance at 0x7f4c5a6aaa00>,36,15,[ 1 10],37,-1,52,-1,37
1,<environment.Job instance at 0x7f4c5a6aae10>,39,23,[6 1],40,-1,63,-1,40
1,<environment.Job instance at 0x7f4c598cb280>,42,18,[ 3 10],43,-1,61,-1,43
1,<environment.Job instance at 0x7f4c598cb190>,44,18,[ 3 10],45,-1,63,-1,45
1,<environment.Job instance at 0x7f4c598cb4b0>,46,23,[ 2 10],47,-1,70,-1,47
1,<environment.Job instance at 0x7f4c598cbaf0>,50,15,[ 1 11],51,-1,66,-1,51
1,<environment.Job instance at 0x7f4c598d10f0>,55,13,[9 1],56,-1,70,-1,57
1,<environment.Job instance at 0x7f4c598d1460>,57,17,[5 6],58,-1,75,-1,58
1,<environment.Job instance at 0x7f4c598d1410>,58,15,[3 5],59,-1,74,-1,59
1,<environment.Job instance at 0x7f4c598d11e0>,59,14,[ 2 10],60,-1,74,-1,60
1,<environment.Job instance at 0x7f4c598d1780>,62,15,[8 3],63,-1,78,-1,63
1,<environment.Job instance at 0x7f4c5a6440a0>,6,23,[ 1 13],7,-1,87,-1,64
1,<environment.Job instance at 0x7f4c598d1aa0>,64,12,[2 9],65,-1,78,-1,66
1,<environment.Job instance at 0x7f4c598d1cd0>,69,12,[7 4],70,-1,82,-1,70
1,<environment.Job instance at 0x7f4c598d1f00>,70,18,[5 6],71,-1,89,-1,71
1,<environment.Job instance at 0x7f4c5abb3c80>,72,14,[5 3],73,-1,87,-1,73
1,<environment.Job instance at 0x7f4c596cfc80>,73,13,[10  5],74,-1,87,-1,74
1,<environment.Job instance at 0x7f4c5abd3f50>,75,15,[10  4],76,-1,91,-1,76
1,<environment.Job instance at 0x7f4c596ee140>,76,26,[5 7],77,-1,103,-1,77
1,<environment.Job instance at 0x7f4c5aec9910>,82,13,[6 3],83,-1,96,-1,83
1,<environment.Job instance at 0x7f4c5a9ddaf0>,84,14,[5 2],85,-1,99,-1,85
1,<environment.Job instance at 0x7f4c5a9ddb40>,87,14,[6 1],88,-1,102,-1,88
1,<environment.Job instance at 0x7f4c5a9dd370>,88,12,[5 3],89,-1,101,-1,89
1,<environment.Job instance at 0x7f4c5a9dde60>,89,20,[3 9],90,-1,110,-1,90
1,<environment.Job instance at 0x7f4c5a9ddc30>,90,16,[4 9],91,-1,107,-1,91
1,<environment.Job instance at 0x7f4c5a9ddcd0>,91,23,[8 4],92,-1,115,-1,92
1,<environment.Job instance at 0x7f4c5a56a1e0>,92,17,[3 6],93,-1,110,-1,93
1,<environment.Job instance at 0x7f4c5aef0a00>,101,17,[7 4],102,-1,119,-1,102
1,<environment.Job instance at 0x7f4c59aaf410>,103,16,[1 9],104,-1,120,-1,104
1,<environment.Job instance at 0x7f4c59aaf640>,107,15,[10  5],108,-1,125,-1,110
1,<environment.Job instance at 0x7f4c59aaf960>,110,17,[8 2],111,-1,130,-1,113
1,<environment.Job instance at 0x7f4c59ab8f50>,115,14,[9 4],116,-1,130,-1,116
1,<environment.Job instance at 0x7f4c59ab8c30>,113,15,[5 2],114,-1,136,-1,121
1,<environment.Job instance at 0x7f4c59ab84b0>,119,12,[9 5],120,-1,138,-1,126
1,<environment.Job instance at 0x7f4c598460a0>,109,18,[5 2],110,-1,144,-1,126
1,<environment.Job instance at 0x7f4c5970c6e0>,121,18,[1 7],122,-1,149,-1,131
1,<environment.Job instance at 0x7f4c59aaf280>,105,27,[6 2],106,-1,158,-1,131
1,<environment.Job instance at 0x7f4c5af1f6e0>,132,13,[5 8],133,-1,146,-1,133
1,<environment.Job instance at 0x7f4c5af1f460>,134,18,[7 1],135,-1,153,-1,135
1,<environment.Job instance at 0x7f4c59ab4f00>,136,14,[ 5 11],137,-1,151,-1,137
1,<environment.Job instance at 0x7f4c59ab8370>,120,12,[5 7],121,-1,152,-1,140
1,<environment.Job instance at 0x7f4c59ab4280>,139,22,[14  5],140,-1,170,-1,148
1,<environment.Job instance at 0x7f4c5a421640>,145,12,[10  4],146,-1,160,-1,148
1,<environment.Job instance at 0x7f4c5a43d3c0>,146,13,[7 3],147,-1,162,-1,149
1,<environment.Job instance at 0x7f4c5a43d280>,144,18,[ 4 10],145,-1,167,-1,149
1,<environment.Job instance at 0x7f4c5a421fa0>,148,22,[10  4],149,-1,176,-1,154
1,<environment.Job instance at 0x7f4c59bca5a0>,151,21,[5 8],152,-1,175,-1,154
1,<environment.Job instance at 0x7f4c59bf6780>,95,14,[8 2],96,-1,169,-1,155
1,<environment.Job instance at 0x7f4c596c83c0>,154,18,[3 8],155,-1,173,-1,155
1,<environment.Job instance at 0x7f4c596c7140>,150,18,[1 7],151,-1,183,-1,165
1,<environment.Job instance at 0x7f4c598d48c0>,164,15,[10  3],165,-1,187,-1,172
1,<environment.Job instance at 0x7f4c596fff50>,160,16,[8 3],161,-1,190,-1,174
1,<environment.Job instance at 0x7f4c5a42ed70>,168,25,[5 7],169,-1,199,-1,174
1,<environment.Job instance at 0x7f4c5a6c8140>,171,14,[4 6],172,-1,188,-1,174
1,<environment.Job instance at 0x7f4c5a9b2780>,177,16,[6 3],178,-1,195,-1,179
1,<environment.Job instance at 0x7f4c598cbcd0>,6,23,[ 1 13],7,-1,30,-1,7
1,<environment.Job instance at 0x7f4c5a6a9050>,7,2,[ 2 11],8,-1,10,-1,8
1,<environment.Job instance at 0x7f4c59ab8050>,14,24,[7 3],15,-1,45,-1,21
1,<environment.Job instance at 0x7f4c596ffd20>,24,19,[ 5 12],25,-1,58,-1,39
1,<environment.Job instance at 0x7f4c5a644280>,25,27,[2 8],26,-1,66,-1,39
1,<environment.Job instance at 0x7f4c5a77fe10>,29,1,[ 4 13],30,-1,53,-1,52
1,<environment.Job instance at 0x7f4c5a77fd70>,32,24,[5 7],33,-1,91,-1,67
1,<environment.Job instance at 0x7f4c635572d0>,40,1,[11  4],41,-1,75,-1,74
1,<environment.Job instance at 0x7f4c5a77f050>,39,23,[6 1],40,-1,110,-1,87
1,<environment.Job instance at 0x7f4c5965b3c0>,46,23,[ 2 10],47,-1,114,-1,91
1,<environment.Job instance at 0x7f4c5965b4b0>,50,15,[ 1 11],51,-1,118,-1,103
1,<environment.Job instance at 0x7f4c5965b870>,51,2,[11  4],52,-1,105,-1,103
1,<environment.Job instance at 0x7f4c5965bdc0>,52,3,[14  5],53,-1,106,-1,103
1,<environment.Job instance at 0x7f4c596755f0>,76,26,[5 7],77,-1,237,-1,211
1,<environment.Job instance at 0x7f4c596753c0>,79,13,[ 2 14],80,-1,226,-1,213
1,<environment.Job instance at 0x7f4c59df4b90>,86,3,[ 4 11],87,-1,235,-1,232
1,<environment.Job instance at 0x7f4c59df4e10>,91,23,[8 4],92,-1,276,-1,253
1,<environment.Job instance at 0x7f4c59df47d0>,94,3,[11  3],95,-1,256,-1,253
1,<environment.Job instance at 0x7f4c5965a9b0>,96,2,[ 2 12],97,-1,269,-1,267
1,<environment.Job instance at 0x7f4c59867f50>,105,27,[6 2],106,-1,333,-1,306
1,<environment.Job instance at 0x7f4c63b51be0>,108,3,[ 3 12],109,-1,309,-1,306
1,<environment.Job instance at 0x7f4c5a177640>,125,1,[ 4 14],126,-1,376,-1,375
1,<environment.Job instance at 0x7f4c5a9aba50>,136,14,[ 5 11],137,-1,408,-1,394
1,<environment.Job instance at 0x7f4c5af76e60>,139,22,[14  5],140,-1,428,-1,406
1,<environment.Job instance at 0x7f4c5a21c0a0>,142,12,[11  2],143,-1,424,-1,412
1,<environment.Job instance at 0x7f4c5abc2b40>,157,25,[6 5],158,-1,472,-1,447
1,<environment.Job instance at 0x7f4c59b76460>,168,25,[5 7],169,-1,504,-1,479
1,<environment.Job instance at 0x7f4c5cfc11e0>,169,13,[ 3 12],170,-1,492,-1,479
1,<environment.Job instance at 0x7f4c596fc730>,178,3,[12  5],179,-1,496,-1,493
1,<environment.Job instance at 0x7f4c5a78b8c0>,1,14,[8 5],2,-1,16,-1,2
1,<environment.Job instance at 0x7f4c5a78b640>,2,18,[5 8],3,-1,21,-1,3
1,<environment.Job instance at 0x7f4c59dc93c0>,6,3,[10  1],7,-1,10,-1,7
1,<environment.Job instance at 0x7f4c59dc9410>,7,28,[6 3],8,-1,36,-1,8
1,<environment.Job instance at 0x7f4c5a29eeb0>,11,19,[3 6],12,-1,34,-1,15
1,<environment.Job instance at 0x7f4c5a15c640>,19,17,[8 2],20,-1,37,-1,20
1,<environment.Job instance at 0x7f4c5aa1f820>,21,19,[3 9],22,-1,41,-1,22
1,<environment.Job instance at 0x7f4c5ae4e3c0>,25,17,[10  2],26,-1,43,-1,26
1,<environment.Job instance at 0x7f4c59ce41e0>,26,17,[4 9],27,-1,44,-1,27
1,<environment.Job instance at 0x7f4c5a29e230>,14,18,[1 9],15,-1,46,-1,28
1,<environment.Job instance at 0x7f4c5a02d3c0>,34,15,[ 3 14],35,-1,58,-1,43
1,<environment.Job instance at 0x7f4c59dc90a0>,10,18,[5 5],11,-1,61,-1,43
1,<environment.Job instance at 0x7f4c59dc03c0>,38,16,[6 1],39,-1,59,-1,43
1,<environment.Job instance at 0x7f4c5a4ef910>,32,25,[2 8],33,-1,68,-1,43
1,<environment.Job instance at 0x7f4c5a02dd20>,35,16,[6 1],36,-1,62,-1,46
1,<environment.Job instance at 0x7f4c59dc0c30>,40,12,[ 3 11],41,-1,58,-1,46
1,<environment.Job instance at 0x7f4c59dc0640>,43,16,[10  1],44,-1,62,-1,46
1,<environment.Job instance at 0x7f4c5a66ddc0>,46,15,[3 5],47,-1,62,-1,47
1,<environment.Job instance at 0x7f4c5a66d5a0>,47,14,[9 1],48,-1,62,-1,48
1,<environment.Job instance at 0x7f4c5a66da00>,50,27,[3 8],51,-1,78,-1,51
1,<environment.Job instance at 0x7f4c5a66d870>,48,14,[4 7],49,-1,66,-1,52
1,<environment.Job instance at 0x7f4c5a73b280>,51,16,[ 3 14],52,-1,69,-1,53
1,<environment.Job instance at 0x7f4c5a66d0f0>,54,19,[6 5],55,-1,74,-1,55
1,<environment.Job instance at 0x7f4c59dc0460>,44,17,[4 8],45,-1,73,-1,56
1,<environment.Job instance at 0x7f4c5cfc50a0>,55,18,[4 5],56,-1,74,-1,56
1,<environment.Job instance at 0x7f4c5a917eb0>,60,20,[7 1],61,-1,96,-1,76
1,<environment.Job instance at 0x7f4c5ad56230>,69,16,[1 8],70,-1,92,-1,76
1,<environment.Job instance at 0x7f4c5ad56690>,71,17,[ 3 10],72,-1,93,-1,76
1,<environment.Job instance at 0x7f4c5ad56d20>,74,17,[4 5],75,-1,95,-1,78
1,<environment.Job instance at 0x7f4c5ad563c0>,75,13,[3 7],76,-1,91,-1,78
1,<environment.Job instance at 0x7f4c5a7d6cd0>,81,13,[ 3 10],82,-1,95,-1,82
1,<environment.Job instance at 0x7f4c5a7d6c30>,82,28,[1 7],83,-1,111,-1,83
1,<environment.Job instance at 0x7f4c5a7d60a0>,83,16,[5 5],84,-1,100,-1,84
1,<environment.Job instance at 0x7f4c63bc7dc0>,84,18,[7 5],85,-1,103,-1,85
1,<environment.Job instance at 0x7f4c63bc7230>,87,16,[7 4],88,-1,108,-1,92
1,<environment.Job instance at 0x7f4c63bc74b0>,91,17,[ 3 10],92,-1,109,-1,92
1,<environment.Job instance at 0x7f4c63bc7a50>,89,22,[12  5],90,-1,115,-1,93
1,<environment.Job instance at 0x7f4c5a9c84b0>,94,27,[3 7],95,-1,122,-1,95
1,<environment.Job instance at 0x7f4c5a9c8500>,96,15,[9 4],97,-1,112,-1,97
1,<environment.Job instance at 0x7f4c5a9c8410>,97,17,[8 2],98,-1,115,-1,98
1,<environment.Job instance at 0x7f4c5a9c8050>,103,16,[9 3],104,-1,125,-1,109
1,<environment.Job instance at 0x7f4c5a9c8af0>,106,12,[1 9],107,-1,122,-1,110
1,<environment.Job instance at 0x7f4c5a9c82d0>,108,19,[5 8],109,-1,130,-1,111
1,<environment.Job instance at 0x7f4c63a27460>,109,12,[10  3],110,-1,123,-1,111
1,<environment.Job instance at 0x7f4c5a9c8190>,105,16,[ 5 10],106,-1,128,-1,112
1,<environment.Job instance at 0x7f4c5af03230>,112,18,[10  4],113,-1,150,-1,132
1,<environment.Job instance at 0x7f4c5a7d6c80>,80,23,[ 1 12],81,-1,155,-1,132
1,<environment.Job instance at 0x7f4c5af03eb0>,114,17,[6 4],115,-1,150,-1,133
1,<environment.Job instance at 0x7f4c5af035a0>,118,13,[8 3],119,-1,147,-1,134
1,<environment.Job instance at 0x7f4c5af03e60>,113,16,[1 8],114,-1,150,-1,134
1,<environment.Job instance at 0x7f4c5af03be0>,117,12,[5 5],118,-1,146,-1,134
1,<environment.Job instance at 0x7f4c5af038c0>,125,16,[ 3 10],126,-1,150,-1,134
1,<environment.Job instance at 0x7f4c5af039b0>,126,18,[5 7],127,-1,152,-1,134
1,<environment.Job instance at 0x7f4c59b89a50>,127,28,[8 3],128,-1,165,-1,137
1,<environment.Job instance at 0x7f4c59b89fa0>,129,15,[3 7],130,-1,152,-1,137
1,<environment.Job instance at 0x7f4c59b891e0>,130,19,[3 8],131,-1,156,-1,137
1,<environment.Job instance at 0x7f4c59b89870>,133,28,[10  5],134,-1,165,-1,137
1,<environment.Job instance at 0x7f4c59b89190>,134,16,[4 6],135,-1,153,-1,137
1,<environment.Job instance at 0x7f4c59b89f00>,135,15,[5 5],136,-1,152,-1,137
1,<environment.Job instance at 0x7f4c5af03c80>,124,12,[5 5],125,-1,149,-1,137
1,<environment.Job instance at 0x7f4c59b897d0>,136,14,[1 8],137,-1,151,-1,137
1,<environment.Job instance at 0x7f4c5adf5a00>,5,26,[14  3],6,-1,32,-1,6
1,<environment.Job instance at 0x7f4c5a02dcd0>,7,28,[6 3],8,-1,43,-1,15
1,<environment.Job instance at 0x7f4c5a7d67d0>,16,2,[14  2],17,-1,34,-1,32
1,<environment.Job instance at 0x7f4c63a27eb0>,17,3,[13  2],18,-1,35,-1,32
1,<environment.Job instance at 0x7f4c597959b0>,29,18,[13  1],30,-1,76,-1,58
1,<environment.Job instance at 0x7f4c5aa2be60>,32,25,[2 8],33,-1,107,-1,82
1,<environment.Job instance at 0x7f4c5a140d20>,34,15,[ 3 14],35,-1,97,-1,82
1,<environment.Job instance at 0x7f4c5a854780>,40,12,[ 3 11],41,-1,109,-1,97
1,<environment.Job instance at 0x7f4c5965a9b0>,41,28,[1 5],42,-1,125,-1,97
1,<environment.Job instance at 0x7f4c59df40f0>,50,27,[3 8],51,-1,164,-1,137
1,<environment.Job instance at 0x7f4c59df4280>,51,16,[ 3 14],52,-1,153,-1,137
1,<environment.Job instance at 0x7f4c5a447cd0>,61,1,[12  2],62,-1,159,-1,158
1,<environment.Job instance at 0x7f4c5965be60>,80,23,[ 1 12],81,-1,246,-1,223
1,<environment.Job instance at 0x7f4c5a77f9b0>,82,28,[1 7],83,-1,269,-1,241
1,<environment.Job instance at 0x7f4c5a77ff50>,85,26,[ 4 10],86,-1,267,-1,241
1,<environment.Job instance at 0x7f4c5a77fd20>,89,22,[12  5],90,-1,264,-1,242
1,<environment.Job instance at 0x7f4c5a644280>,94,27,[3 7],95,-1,297,-1,270
1,<environment.Job instance at 0x7f4c5a66d1e0>,127,28,[8 3],128,-1,427,-1,399
1,<environment.Job instance at 0x7f4c5cfc51e0>,132,22,[13  5],133,-1,437,-1,415
1,<environment.Job instance at 0x7f4c5ad00b40>,133,28,[10  5],134,-1,461,-1,433
1,<environment.Job instance at 0x7f4c5ad00c30>,137,27,[3 7],138,-1,468,-1,441
1,<environment.Job instance at 0x7f4c5ad00aa0>,146,27,[13  1],147,-1,495,-1,468
1,<environment.Job instance at 0x7f4c59869230>,155,25,[2 7],156,-1,527,-1,502
1,<environment.Job instance at 0x7f4c59869690>,157,17,[ 5 14],158,-1,519,-1,502
1,<environment.Job instance at 0x7f4c5a57a550>,1,26,[6 3],2,-1,28,-1,2
1,<environment.Job instance at 0x7f4c5a57a280>,3,17,[10  5],4,-1,21,-1,4
1,<environment.Job instance at 0x7f4c5a57af00>,6,17,[10  5],7,-1,24,-1,7
1,<environment.Job instance at 0x7f4c5aac8730>,12,17,[4 9],13,-1,30,-1,13
1,<environment.Job instance at 0x7f4c5aac8410>,15,27,[8 5],16,-1,43,-1,16
1,<environment.Job instance at 0x7f4c5aac80f0>,16,22,[9 5],17,-1,39,-1,17
1,<environment.Job instance at 0x7f4c5aac8f00>,17,17,[5 5],18,-1,35,-1,18
1,<environment.Job instance at 0x7f4c5aac8370>,18,24,[7 4],19,-1,43,-1,19
1,<environment.Job instance at 0x7f4c5aac8910>,19,18,[1 5],20,-1,38,-1,20
1,<environment.Job instance at 0x7f4c5aac89b0>,21,14,[10  4],22,-1,38,-1,24
1,<environment.Job instance at 0x7f4c5aac87d0>,23,13,[6 4],24,-1,37,-1,24
1,<environment.Job instance at 0x7f4c5a93feb0>,43,18,[2 9],44,-1,65,-1,47
1,<environment.Job instance at 0x7f4c5a93f910>,40,20,[9 2],41,-1,73,-1,53
1,<environment.Job instance at 0x7f4c5a93fa00>,41,15,[ 3 13],42,-1,100,-1,85
1,<environment.Job instance at 0x7f4c5af2ba50>,57,17,[7 2],58,-1,102,-1,85
1,<environment.Job instance at 0x7f4c59d7e190>,56,25,[ 3 12],57,-1,110,-1,85
1,<environment.Job instance at 0x7f4c59de51e0>,64,25,[7 4],65,-1,110,-1,85
1,<environment.Job instance at 0x7f4c5aa59910>,68,19,[2 5],69,-1,104,-1,85
1,<environment.Job instance at 0x7f4c5a3b0aa0>,53,13,[2 7],54,-1,101,-1,88
1,<environment.Job instance at 0x7f4c59de50f0>,71,21,[7 2],72,-1,109,-1,88
1,<environment.Job instance at 0x7f4c59d6bc30>,73,22,[10  1],74,-1,111,-1,89
1,<environment.Job instance at 0x7f4c63b4fb40>,72,14,[ 4 14],73,-1,104,-1,90
1,<environment.Job instance at 0x7f4c5a60eaf0>,76,18,[10  3],77,-1,110,-1,92
1,<environment.Job instance at 0x7f4c5a9eee10>,77,16,[3 9],78,-1,108,-1,92
1,<environment.Job instance at 0x7f4c5ac66aa0>,80,18,[ 2 13],81,-1,110,-1,92
1,<environment.Job instance at 0x7f4c5a93f410>,42,17,[4 7],43,-1,114,-1,97
1,<environment.Job instance at 0x7f4c59de5e10>,66,28,[6 2],67,-1,125,-1,97
1,<environment.Job instance at 0x7f4c5a24b140>,84,17,[10  1],85,-1,114,-1,97
1,<environment.Job instance at 0x7f4c59ea5a00>,31,24,[ 3 14],32,-1,121,-1,97
1,<environment.Job instance at 0x7f4c5a6097d0>,82,17,[1 9],83,-1,114,-1,97
1,<environment.Job instance at 0x7f4c5d027690>,86,16,[9 3],87,-1,113,-1,97
1,<environment.Job instance at 0x7f4c5aea3460>,46,26,[ 4 10],47,-1,125,-1,99
1,<environment.Job instance at 0x7f4c5a565a50>,92,26,[5 7],93,-1,133,-1,107
1,<environment.Job instance at 0x7f4c5a5653c0>,93,17,[5 8],94,-1,125,-1,108
1,<environment.Job instance at 0x7f4c5a359320>,94,28,[9 1],95,-1,136,-1,108
1,<environment.Job instance at 0x7f4c5a359a50>,95,19,[3 8],96,-1,127,-1,108
1,<environment.Job instance at 0x7f4c5a5fb7d0>,98,28,[5 2],99,-1,141,-1,113
1,<environment.Job instance at 0x7f4c5a5fba00>,99,18,[10  5],100,-1,131,-1,113
1,<environment.Job instance at 0x7f4c5aef6a50>,102,20,[10  4],103,-1,133,-1,113
1,<environment.Job instance at 0x7f4c5d027c80>,88,16,[8 3],89,-1,132,-1,116
1,<environment.Job instance at 0x7f4c5aef6c30>,105,16,[ 3 10],106,-1,133,-1,117
1,<environment.Job instance at 0x7f4c5aef68c0>,104,14,[1 9],105,-1,131,-1,117
1,<environment.Job instance at 0x7f4c5aef6640>,107,13,[10  1],108,-1,130,-1,117
1,<environment.Job instance at 0x7f4c5965a8c0>,109,14,[8 4],110,-1,131,-1,117
1,<environment.Job instance at 0x7f4c5965a910>,111,15,[2 7],112,-1,134,-1,119
1,<environment.Job instance at 0x7f4c5965ac80>,112,12,[ 3 10],113,-1,131,-1,119
1,<environment.Job instance at 0x7f4c5a1065f0>,113,16,[7 2],114,-1,135,-1,119
1,<environment.Job instance at 0x7f4c5a106640>,114,14,[7 2],115,-1,133,-1,119
1,<environment.Job instance at 0x7f4c5a106820>,116,13,[9 1],117,-1,132,-1,119
1,<environment.Job instance at 0x7f4c59a77820>,117,20,[10  3],118,-1,139,-1,119
1,<environment.Job instance at 0x7f4c59a77910>,119,28,[10  4],120,-1,149,-1,121
1,<environment.Job instance at 0x7f4c5974b320>,128,18,[5 2],129,-1,152,-1,134
1,<environment.Job instance at 0x7f4c5aaccb90>,129,1,[6 5],130,-1,137,-1,136
1,<environment.Job instance at 0x7f4c5a57a0a0>,131,17,[ 5 10],132,-1,153,-1,136
1,<environment.Job instance at 0x7f4c5a84acd0>,124,17,[5 9],125,-1,153,-1,136
1,<environment.Job instance at 0x7f4c59fe5410>,133,12,[10  1],134,-1,148,-1,136
1,<environment.Job instance at 0x7f4c599ea4b0>,134,15,[10  1],135,-1,151,-1,136
1,<environment.Job instance at 0x7f4c59de5b90>,65,22,[9 2],66,-1,158,-1,136
1,<environment.Job instance at 0x7f4c5a584f50>,136,14,[2 7],137,-1,151,-1,137
1,<environment.Job instance at 0x7f4c59ec1f00>,148,16,[5 9],149,-1,198,-1,182
1,<environment.Job instance at 0x7f4c59a7db90>,167,16,[ 2 10],168,-1,264,-1,248
1,<environment.Job instance at 0x7f4c5a0956e0>,165,14,[3 5],166,-1,264,-1,250
1,<environment.Job instance at 0x7f4c59ec14b0>,145,25,[10  3],146,-1,297,-1,272
1,<environment.Job instance at 0x7f4c5a93f550>,172,16,[5 8],173,-1,288,-1,272
1,<environment.Job instance at 0x7f4c5a93f960>,174,18,[2 9],175,-1,290,-1,272
1,<environment.Job instance at 0x7f4c5a93f1e0>,176,17,[4 9],177,-1,290,-1,273
1,<environment.Job instance at 0x7f4c5a93f870>,177,18,[3 7],178,-1,291,-1,273
1,<environment.Job instance at 0x7f4c5aac85a0>,1,26,[6 3],2,-1,28,-1,2
1,<environment.Job instance at 0x7f4c59d7e5f0>,7,1,[ 5 12],8,-1,9,-1,8
1,<environment.Job instance at 0x7f4c5d027730>,9,3,[12  2],10,-1,17,-1,14
1,<environment.Job instance at 0x7f4c5a565140>,11,3,[11  1],12,-1,18,-1,15
1,<environment.Job instance at 0x7f4c5a5fbeb0>,15,27,[8 5],16,-1,46,-1,19
1,<environment.Job instance at 0x7f4c5a106550>,18,24,[7 4],19,-1,43,-1,19
1,<environment.Job instance at 0x7f4c5a93ffa0>,27,13,[ 2 13],28,-1,63,-1,50
1,<environment.Job instance at 0x7f4c5a93f5a0>,28,17,[ 1 13],29,-1,67,-1,50
1,<environment.Job instance at 0x7f4c59979e60>,29,2,[12  1],30,-1,52,-1,50
1,<environment.Job instance at 0x7f4c59979230>,31,24,[ 3 14],32,-1,76,-1,52
1,<environment.Job instance at 0x7f4c59979eb0>,38,13,[14  1],39,-1,69,-1,56
1,<environment.Job instance at 0x7f4c59869780>,41,15,[ 3 13],42,-1,74,-1,59
1,<environment.Job instance at 0x7f4c59869320>,46,26,[ 4 10],47,-1,124,-1,98
1,<environment.Job instance at 0x7f4c59869d20>,51,3,[ 2 12],52,-1,104,-1,101
1,<environment.Job instance at 0x7f4c5ad00460>,55,13,[13  4],56,-1,127,-1,114
1,<environment.Job instance at 0x7f4c5ad00cd0>,56,25,[ 3 12],57,-1,139,-1,114
1,<environment.Job instance at 0x7f4c5ad00280>,64,25,[7 4],65,-1,158,-1,133
1,<environment.Job instance at 0x7f4c69a68b40>,66,28,[6 2],67,-1,164,-1,136
1,<environment.Job instance at 0x7f4c63a27140>,70,1,[ 2 11],71,-1,139,-1,138
1,<environment.Job instance at 0x7f4c5a7b10f0>,72,14,[ 4 14],73,-1,153,-1,139
1,<environment.Job instance at 0x7f4c5a67b5a0>,80,18,[ 2 13],81,-1,191,-1,173
1,<environment.Job instance at 0x7f4c5a675c80>,87,3,[12  2],88,-1,198,-1,195
1,<environment.Job instance at 0x7f4c5a661af0>,92,26,[5 7],93,-1,259,-1,233
1,<environment.Job instance at 0x7f4c5a6645f0>,94,28,[9 1],95,-1,261,-1,233
1,<environment.Job instance at 0x7f4c5a75c280>,98,28,[5 2],99,-1,280,-1,252
1,<environment.Job instance at 0x7f4c5a730690>,103,3,[11  4],104,-1,259,-1,256
1,<environment.Job instance at 0x7f4c5a4c55a0>,110,2,[ 5 14],111,-1,304,-1,302
1,<environment.Job instance at 0x7f4c5a3d5f00>,119,28,[10  4],120,-1,380,-1,352
1,<environment.Job instance at 0x7f4c5a4045a0>,125,3,[11  1],126,-1,359,-1,356
1,<environment.Job instance at 0x7f4c5a3fe0f0>,130,1,[ 1 14],131,-1,386,-1,385
1,<environment.Job instance at 0x7f4c5a4b4f50>,138,28,[2 8],139,-1,446,-1,418
1,<environment.Job instance at 0x7f4c5a3fc690>,139,13,[ 5 12],140,-1,431,-1,418
1,<environment.Job instance at 0x7f4c5a3fbc80>,146,2,[12  3],147,-1,440,-1,438
1,<environment.Job instance at 0x7f4c5a3fb500>,145,25,[10  3],146,-1,478,-1,453
1,<environment.Job instance at 0x7f4c5a4c68c0>,154,3,[14  3],155,-1,471,-1,468
1,<environment.Job instance at 0x7f4c5a7497d0>,159,15,[13  3],160,-1,498,-1,483
1,<environment.Job instance at 0x7f4c5a770870>,160,24,[7 2],161,-1,509,-1,485
1,<environment.Job instance at 0x7f4c5a770a00>,162,25,[7 5],163,-1,512,-1,487
1,<environment.Job instance at 0x7f4c59be65f0>,166,3,[12  5],167,-1,504,-1,501
1,<environment.Job instance at 0x7f4c5a4c84b0>,0,13,[9 4],1,-1,16,-1,3
1,<environment.Job instance at 0x7f4c5a4c80a0>,3,1,[9 4],4,-1,5,-1,4
1,<environment.Job instance at 0x7f4c59bf3820>,4,15,[ 5 10],5,-1,20,-1,5
1,<environment.Job instance at 0x7f4c5a4c8190>,2,24,[2 9],3,-1,29,-1,5
1,<environment.Job instance at 0x7f4c59bf35f0>,7,16,[5 7],8,-1,24,-1,8
1,<environment.Job instance at 0x7f4c59bf3910>,9,18,[1 9],10,-1,28,-1,10
1,<environment.Job instance at 0x7f4c59bf31e0>,10,16,[9 3],11,-1,29,-1,13
1,<environment.Job instance at 0x7f4c59bf3b40>,12,17,[8 1],13,-1,30,-1,13
1,<environment.Job instance at 0x7f4c59bf3230>,16,15,[5 5],17,-1,32,-1,17
1,<environment.Job instance at 0x7f4c59bf3550>,17,16,[5 9],18,-1,34,-1,18
1,<environment.Job instance at 0x7f4c59bf3a50>,18,16,[7 3],19,-1,35,-1,19
1,<environment.Job instance at 0x7f4c59bf3cd0>,19,20,[5 3],20,-1,40,-1,20
1,<environment.Job instance at 0x7f4c59bf3640>,21,17,[4 6],22,-1,39,-1,22
1,<environment.Job instance at 0x7f4c63549370>,24,14,[10  2],25,-1,40,-1,26
1,<environment.Job instance at 0x7f4c63549690>,25,23,[1 8],26,-1,51,-1,28
1,<environment.Job instance at 0x7f4c63549870>,34,18,[2 6],35,-1,54,-1,36
1,<environment.Job instance at 0x7f4c63549dc0>,37,18,[3 5],38,-1,56,-1,38
1,<environment.Job instance at 0x7f4c635495a0>,35,18,[4 6],36,-1,56,-1,38
1,<environment.Job instance at 0x7f4c635494b0>,38,19,[3 9],39,-1,59,-1,40
1,<environment.Job instance at 0x7f4c59bef7d0>,41,18,[1 8],42,-1,60,-1,42
1,<environment.Job instance at 0x7f4c59befc30>,43,17,[6 4],44,-1,61,-1,44
1,<environment.Job instance at 0x7f4c59bef1e0>,44,26,[8 5],45,-1,71,-1,45
1,<environment.Job instance at 0x7f4c59befb40>,47,17,[4 8],48,-1,65,-1,48
1,<environment.Job instance at 0x7f4c59cfd5f0>,51,13,[ 5 10],52,-1,65,-1,52
1,<environment.Job instance at 0x7f4c59bef960>,39,12,[1 5],40,-1,65,-1,53
1,<environment.Job instance at 0x7f4c59cfd2d0>,53,24,[3 7],54,-1,78,-1,54
1,<environment.Job instance at 0x7f4c59cfd7d0>,54,16,[10  1],55,-1,72,-1,56
1,<environment.Job instance at 0x7f4c59cfd6e0>,55,18,[7 3],56,-1,74,-1,56
1,<environment.Job instance at 0x7f4c5a8f6cd0>,59,18,[3 7],60,-1,78,-1,60
1,<environment.Job instance at 0x7f4c5a8f68c0>,65,18,[6 3],66,-1,84,-1,66
1,<environment.Job instance at 0x7f4c5a8f6690>,68,18,[5 8],69,-1,87,-1,69
1,<environment.Job instance at 0x7f4c5abec4b0>,71,18,[10  3],72,-1,92,-1,74
1,<environment.Job instance at 0x7f4c5abec960>,75,25,[ 4 10],76,-1,101,-1,76
1,<environment.Job instance at 0x7f4c5abec9b0>,76,13,[9 3],77,-1,90,-1,77
1,<environment.Job instance at 0x7f4c5abec190>,77,14,[10  2],78,-1,92,-1,78
1,<environment.Job instance at 0x7f4c5abec640>,78,15,[4 6],79,-1,94,-1,79
1,<environment.Job instance at 0x7f4c5abecaa0>,86,18,[6 4],87,-1,105,-1,87
1,<environment.Job instance at 0x7f4c5a7491e0>,87,18,[ 5 10],88,-1,106,-1,88
1,<environment.Job instance at 0x7f4c5a749410>,88,2,[ 5 11],89,-1,91,-1,89
1,<environment.Job instance at 0x7f4c5a7494b0>,90,17,[5 2],91,-1,108,-1,91
1,<environment.Job instance at 0x7f4c5a7495f0>,91,27,[4 5],92,-1,119,-1,92
1,<environment.Job instance at 0x7f4c5a749190>,92,14,[5 7],93,-1,107,-1,93
1,<environment.Job instance at 0x7f4c5a749fa0>,95,18,[1 8],96,-1,114,-1,96
1,<environment.Job instance at 0x7f4c5a7499b0>,101,15,[2 9],102,-1,122,-1,107
1,<environment.Job instance at 0x7f4c59bc8550>,105,17,[9 3],106,-1,128,-1,111
1,<environment.Job instance at 0x7f4c5abec550>,73,15,[5 6],74,-1,126,-1,111
1,<environment.Job instance at 0x7f4c5a8f6c80>,66,15,[14  5],67,-1,126,-1,111
1,<environment.Job instance at 0x7f4c59bc8730>,106,14,[13  3],107,-1,125,-1,111
1,<environment.Job instance at 0x7f4c59bc8a00>,107,21,[2 8],108,-1,132,-1,111
1,<environment.Job instance at 0x7f4c5abd00a0>,118,15,[7 3],119,-1,151,-1,136
1,<environment.Job instance at 0x7f4c5ae9aaa0>,108,17,[8 2],109,-1,156,-1,139
1,<environment.Job instance at 0x7f4c59eef6e0>,130,16,[3 9],131,-1,155,-1,139
1,<environment.Job instance at 0x7f4c59eef550>,132,1,[7 3],133,-1,140,-1,139
1,<environment.Job instance at 0x7f4c59eef780>,133,21,[9 1],134,-1,160,-1,139
1,<environment.Job instance at 0x7f4c59eef190>,135,23,[4 8],136,-1,162,-1,139
1,<environment.Job instance at 0x7f4c59bc8dc0>,110,15,[8 1],111,-1,154,-1,139
1,<environment.Job instance at 0x7f4c59eef140>,134,18,[2 6],135,-1,159,-1,141
1,<environment.Job instance at 0x7f4c63549280>,2,24,[2 9],3,-1,29,-1,5
1,<environment.Job instance at 0x7f4c5a7427d0>,25,23,[1 8],26,-1,98,-1,75
1,<environment.Job instance at 0x7f4c5a742190>,28,13,[ 5 13],29,-1,88,-1,75
1,<environment.Job instance at 0x7f4c5a497a00>,32,3,[ 5 13],33,-1,85,-1,82
1,<environment.Job instance at 0x7f4c5a404500>,44,26,[8 5],45,-1,157,-1,131
1,<environment.Job instance at 0x7f4c5a3d5780>,53,24,[3 7],54,-1,166,-1,142
1,<environment.Job instance at 0x7f4c5a697910>,61,3,[14  4],62,-1,173,-1,170
1,<environment.Job instance at 0x7f4c5a697cd0>,62,16,[ 4 12],63,-1,186,-1,170
1,<environment.Job instance at 0x7f4c5a6846e0>,66,15,[14  5],67,-1,189,-1,174
1,<environment.Job instance at 0x7f4c5a7b19b0>,75,25,[ 4 10],76,-1,245,-1,220
1,<environment.Job instance at 0x7f4c63a27eb0>,79,16,[ 3 12],80,-1,239,-1,223
1,<environment.Job instance at 0x7f4c5a0b9cd0>,88,2,[ 5 11],89,-1,243,-1,241
1,<environment.Job instance at 0x7f4c59a77e10>,91,27,[4 5],92,-1,282,-1,255
1,<environment.Job instance at 0x7f4c59ced550>,96,27,[10  5],97,-1,328,-1,301
1,<environment.Job instance at 0x7f4c5a50ee60>,106,14,[13  3],107,-1,334,-1,320
1,<environment.Job instance at 0x7f4c5a1f7d70>,119,2,[ 5 11],120,-1,371,-1,369
1,<environment.Job instance at 0x7f4c5a7edb40>,135,23,[4 8],136,-1,445,-1,422
1,<environment.Job instance at 0x7f4c5a2ff780>,139,13,[ 3 14],140,-1,435,-1,422
1,<environment.Job instance at 0x7f4c59784dc0>,141,27,[6 2],142,-1,450,-1,423
1,<environment.Job instance at 0x7f4c59784fa0>,143,13,[13  1],144,-1,436,-1,423
1,<environment.Job instance at 0x7f4c596aacd0>,149,12,[11  3],150,-1,453,-1,441
1,<environment.Job instance at 0x7f4c5a7d24b0>,158,27,[9 1],159,-1,510,-1,483
1,<environment.Job instance at 0x7f4c59f06b40>,161,16,[14  3],162,-1,506,-1,490
1,<environment.Job instance at 0x7f4c5ac525a0>,163,27,[6 5],164,-1,522,-1,495
1,<environment.Job instance at 0x7f4c635c8aa0>,165,26,[6 1],166,-1,525,-1,499
1,<environment.Job instance at 0x7f4c63a850f0>,170,26,[4 5],171,-1,556,-1,530
1,<environment.Job instance at 0x7f4c5a6956e0>,177,15,[12  1],178,-1,575,-1,560
1,<environment.Job instance at 0x7f4c5aec9730>,4,17,[7 5],5,-1,22,-1,5
1,<environment.Job instance at 0x7f4c596c72d0>,6,14,[ 4 10],7,-1,21,-1,7
1,<environment.Job instance at 0x7f4c596c73c0>,12,16,[2 9],13,-1,29,-1,13
1,<environment.Job instance at 0x7f4c596c7050>,13,16,[1 8],14,-1,30,-1,14
1,<environment.Job instance at 0x7f4c596c77d0>,14,15,[9 3],15,-1,30,-1,15
1,<environment.Job instance at 0x7f4c596c75f0>,15,15,[4 8],16,-1,31,-1,16
1,<environment.Job instance at 0x7f4c596c76e0>,17,25,[9 5],18,-1,43,-1,18
1,<environment.Job instance at 0x7f4c596c7f00>,20,15,[2 9],21,-1,36,-1,21
1,<environment.Job instance at 0x7f4c5a7d6730>,31,14,[9 1],32,-1,47,-1,33
1,<environment.Job instance at 0x7f4c5a7d6820>,33,15,[4 9],34,-1,49,-1,34
1,<environment.Job instance at 0x7f4c5a7d6c80>,36,18,[2 5],37,-1,55,-1,37
1,<environment.Job instance at 0x7f4c5a7d6b40>,38,27,[4 6],39,-1,66,-1,39
1,<environment.Job instance at 0x7f4c5a7d60f0>,32,13,[8 3],33,-1,53,-1,40
1,<environment.Job instance at 0x7f4c5a7d6140>,43,12,[10  3],44,-1,57,-1,45
1,<environment.Job instance at 0x7f4c5a92d4b0>,48,13,[4 6],49,-1,62,-1,49
1,<environment.Job instance at 0x7f4c5a74ca50>,51,18,[1 6],52,-1,70,-1,52
1,<environment.Job instance at 0x7f4c5a74caa0>,52,17,[5 2],53,-1,70,-1,53
1,<environment.Job instance at 0x7f4c5a74cf50>,53,14,[8 5],54,-1,68,-1,54
1,<environment.Job instance at 0x7f4c5a7d6fa0>,44,14,[10  2],45,-1,68,-1,54
1,<environment.Job instance at 0x7f4c5a74c6e0>,55,18,[5 8],56,-1,76,-1,58
1,<environment.Job instance at 0x7f4c5a74c5f0>,59,18,[5 6],60,-1,78,-1,60
1,<environment.Job instance at 0x7f4c598cf500>,75,18,[4 6],76,-1,94,-1,76
1,<environment.Job instance at 0x7f4c5a74cbe0>,57,16,[3 5],58,-1,95,-1,79
1,<environment.Job instance at 0x7f4c598cf280>,79,20,[8 1],80,-1,100,-1,80
1,<environment.Job instance at 0x7f4c598cf370>,80,28,[5 3],81,-1,109,-1,81
1,<environment.Job instance at 0x7f4c5aef8af0>,85,17,[5 8],86,-1,103,-1,86
1,<environment.Job instance at 0x7f4c5a74ca00>,62,16,[ 2 13],63,-1,104,-1,88
1,<environment.Job instance at 0x7f4c5abbefa0>,66,16,[4 6],67,-1,104,-1,88
1,<environment.Job instance at 0x7f4c598cf5f0>,78,14,[3 9],79,-1,102,-1,88
1,<environment.Job instance at 0x7f4c5a427e60>,94,16,[3 6],95,-1,112,-1,96
1,<environment.Job instance at 0x7f4c598cfdc0>,73,16,[8 3],74,-1,112,-1,96
1,<environment.Job instance at 0x7f4c5ae82c30>,91,12,[10  4],92,-1,111,-1,99
1,<environment.Job instance at 0x7f4c5ae82b40>,90,18,[2 5],91,-1,121,-1,103
1,<environment.Job instance at 0x7f4c596c8b40>,103,27,[6 3],104,-1,131,-1,104
1,<environment.Job instance at 0x7f4c596c7e60>,0,1,[ 2 14],1,-1,2,-1,1
1,<environment.Job instance at 0x7f4c5ae82780>,17,25,[9 5],18,-1,63,-1,38
1,<environment.Job instance at 0x7f4c598cfd20>,18,2,[ 1 13],19,-1,40,-1,38
1,<environment.Job instance at 0x7f4c63a850f0>,25,15,[ 3 14],26,-1,58,-1,43
1,<environment.Job instance at 0x7f4c63a85370>,28,15,[ 5 14],29,-1,70,-1,55
1,<environment.Job instance at 0x7f4c5a4348c0>,37,2,[ 1 11],38,-1,88,-1,86
1,<environment.Job instance at 0x7f4c5a7d2640>,38,27,[4 6],39,-1,127,-1,100
1,<environment.Job instance at 0x7f4c596ee5a0>,60,26,[ 5 14],61,-1,182,-1,156
1,<environment.Job instance at 0x7f4c5a93f050>,62,16,[ 2 13],63,-1,175,-1,159
1,<environment.Job instance at 0x7f4c59eb0b40>,63,27,[2 5],64,-1,196,-1,169
1,<environment.Job instance at 0x7f4c5a3b00a0>,80,28,[5 3],81,-1,252,-1,224
1,<environment.Job instance at 0x7f4c5d027aa0>,83,1,[13  4],84,-1,228,-1,227
1,<environment.Job instance at 0x7f4c5a675aa0>,103,27,[6 3],104,-1,337,-1,310
1,<environment.Job instance at 0x7f4c5a697cd0>,110,2,[11  1],111,-1,338,-1,336
1,<environment.Job instance at 0x7f4c5a3d5e60>,119,28,[3 9],120,-1,407,-1,379
1,<environment.Job instance at 0x7f4c5a4b7460>,122,12,[13  5],123,-1,391,-1,379
1,<environment.Job instance at 0x7f4c5a404dc0>,125,25,[10  4],126,-1,427,-1,402
1,<environment.Job instance at 0x7f4c5a696a50>,135,28,[5 2],136,-1,452,-1,424
1,<environment.Job instance at 0x7f4c5a2ff2d0>,174,16,[12  4],175,-1,581,-1,565
1,<environment.Job instance at 0x7f4c5a2ff910>,178,16,[11  4],179,-1,597,-1,581
1,<environment.Job instance at 0x7f4c5a82ddc0>,3,26,[9 5],4,-1,30,-1,4
1,<environment.Job instance at 0x7f4c59b5e640>,12,16,[ 5 10],13,-1,30,-1,14
1,<environment.Job instance at 0x7f4c59b5e0f0>,16,13,[ 1 10],17,-1,31,-1,18
1,<environment.Job instance at 0x7f4c5a0c5eb0>,20,14,[10  2],21,-1,35,-1,21
1,<environment.Job instance at 0x7f4c59b5e690>,17,18,[7 4],18,-1,40,-1,22
1,<environment.Job instance at 0x7f4c5a0c54b0>,24,19,[3 6],25,-1,45,-1,26
1,<environment.Job instance at 0x7f4c5af52e10>,29,17,[8 4],30,-1,47,-1,30
1,<environment.Job instance at 0x7f4c5af52aa0>,30,15,[4 8],31,-1,46,-1,31
1,<environment.Job instance at 0x7f4c5af520a0>,31,16,[3 6],32,-1,48,-1,32
1,<environment.Job instance at 0x7f4c5af52af0>,32,12,[11  5],33,-1,45,-1,33
1,<environment.Job instance at 0x7f4c5af52a50>,36,16,[6 2],37,-1,53,-1,37
1,<environment.Job instance at 0x7f4c5af525a0>,38,14,[3 7],39,-1,53,-1,39
1,<environment.Job instance at 0x7f4c5a551eb0>,40,3,[5 6],41,-1,44,-1,41
1,<environment.Job instance at 0x7f4c5a551500>,41,15,[5 5],42,-1,57,-1,42
1,<environment.Job instance at 0x7f4c5a551140>,42,16,[3 5],43,-1,59,-1,43
1,<environment.Job instance at 0x7f4c5a551410>,43,18,[8 4],44,-1,62,-1,44
1,<environment.Job instance at 0x7f4c5a551050>,46,14,[6 5],47,-1,61,-1,47
1,<environment.Job instance at 0x7f4c5a551aa0>,47,13,[9 3],48,-1,61,-1,48
1,<environment.Job instance at 0x7f4c5a5512d0>,48,15,[7 4],49,-1,64,-1,49
1,<environment.Job instance at 0x7f4c5a551640>,50,15,[2 7],51,-1,66,-1,51
1,<environment.Job instance at 0x7f4c5a551c30>,54,13,[5 6],55,-1,68,-1,55
1,<environment.Job instance at 0x7f4c5a449fa0>,59,13,[11  2],60,-1,73,-1,60
1,<environment.Job instance at 0x7f4c5a449500>,63,2,[7 1],64,-1,66,-1,64
1,<environment.Job instance at 0x7f4c5a4499b0>,64,17,[ 3 11],65,-1,82,-1,65
1,<environment.Job instance at 0x7f4c5a449230>,65,16,[9 5],66,-1,82,-1,66
1,<environment.Job instance at 0x7f4c5a449cd0>,66,24,[8 4],67,-1,91,-1,67
1,<environment.Job instance at 0x7f4c5a449870>,67,17,[8 3],68,-1,85,-1,68
1,<environment.Job instance at 0x7f4c59b8f910>,69,15,[3 9],70,-1,85,-1,70
1,<environment.Job instance at 0x7f4c59b8f730>,74,22,[10  1],75,-1,97,-1,75
1,<environment.Job instance at 0x7f4c59b8f8c0>,79,15,[3 5],80,-1,95,-1,80
1,<environment.Job instance at 0x7f4c596b4910>,80,18,[1 5],81,-1,99,-1,81
1,<environment.Job instance at 0x7f4c596b4230>,81,12,[7 4],82,-1,94,-1,82
1,<environment.Job instance at 0x7f4c5af52370>,25,17,[5 3],26,-1,193,-1,176
1,<environment.Job instance at 0x7f4c5a7117d0>,103,13,[10  4],104,-1,189,-1,176
1,<environment.Job instance at 0x7f4c596b4820>,92,28,[9 3],93,-1,221,-1,193
1,<environment.Job instance at 0x7f4c5a711be0>,105,18,[14  5],106,-1,309,-1,291
1,<environment.Job instance at 0x7f4c5a31e2d0>,119,16,[14  4],120,-1,307,-1,291
1,<environment.Job instance at 0x7f4c5a8955f0>,125,15,[10  4],126,-1,306,-1,291
1,<environment.Job instance at 0x7f4c5a895a50>,126,18,[1 6],127,-1,309,-1,291
1,<environment.Job instance at 0x7f4c63b4f230>,134,18,[7 4],135,-1,329,-1,311
1,<environment.Job instance at 0x7f4c5a8959b0>,122,14,[8 5],123,-1,326,-1,312
1,<environment.Job instance at 0x7f4c5a8a85a0>,117,27,[9 3],118,-1,342,-1,315
1,<environment.Job instance at 0x7f4c5a8b2690>,138,12,[9 1],139,-1,327,-1,315
1,<environment.Job instance at 0x7f4c5a298c80>,137,18,[ 1 10],138,-1,333,-1,315
1,<environment.Job instance at 0x7f4c5a1e9aa0>,135,15,[7 5],136,-1,383,-1,368
1,<environment.Job instance at 0x7f4c5af79af0>,158,22,[8 3],159,-1,396,-1,374
1,<environment.Job instance at 0x7f4c5a1f7370>,174,16,[10  5],175,-1,421,-1,405
1,<environment.Job instance at 0x7f4c5a1f7190>,164,13,[10  4],165,-1,422,-1,409
1,<environment.Job instance at 0x7f4c5a758640>,160,14,[3 8],161,-1,423,-1,409
1,<environment.Job instance at 0x7f4c63b53690>,176,16,[ 2 10],177,-1,428,-1,412
1,<environment.Job instance at 0x7f4c59b8f9b0>,3,26,[9 5],4,-1,30,-1,4
1,<environment.Job instance at 0x7f4c596b4f00>,6,3,[ 2 12],7,-1,10,-1,7
1,<environment.Job instance at 0x7f4c5a0cb2d0>,8,16,[12  5],9,-1,25,-1,9
1,<environment.Job instance at 0x7f4c59752230>,9,25,[4 9],10,-1,35,-1,10
1,<environment.Job instance at 0x7f4c59667640>,13,2,[ 3 12],14,-1,16,-1,14
1,<environment.Job instance at 0x7f4c5a7a9e10>,19,18,[14  4],20,-1,38,-1,20
1,<environment.Job instance at 0x7f4c5a0d05f0>,21,13,[ 2 13],22,-1,35,-1,22
1,<environment.Job instance at 0x7f4c596b1050>,22,3,[ 2 14],23,-1,26,-1,23
1,<environment.Job instance at 0x7f4c5adb9be0>,32,12,[11  5],33,-1,69,-1,57
1,<environment.Job instance at 0x7f4c5a6d5c80>,59,13,[11  2],60,-1,169,-1,156
1,<environment.Job instance at 0x7f4c5ad9deb0>,62,2,[ 5 13],63,-1,163,-1,161
1,<environment.Job instance at 0x7f4c5ad94e60>,64,17,[ 3 11],65,-1,180,-1,163
1,<environment.Job instance at 0x7f4c5ad942d0>,66,24,[8 4],67,-1,192,-1,168
1,<environment.Job instance at 0x7f4c5ad71a00>,73,1,[ 5 11],74,-1,187,-1,186
1,<environment.Job instance at 0x7f4c59d3dc30>,77,17,[12  1],78,-1,209,-1,192
1,<environment.Job instance at 0x7f4c59d19f00>,82,15,[ 2 13],83,-1,220,-1,205
1,<environment.Job instance at 0x7f4c5a005f50>,85,1,[14  4],86,-1,218,-1,217
1,<environment.Job instance at 0x7f4c5a6c6910>,92,28,[9 3],93,-1,262,-1,234
1,<environment.Job instance at 0x7f4c5ae23be0>,99,17,[ 2 13],100,-1,269,-1,252
1,<environment.Job instance at 0x7f4c5ae148c0>,105,18,[14  5],106,-1,298,-1,280
1,<environment.Job instance at 0x7f4c5ae14910>,107,3,[12  1],108,-1,290,-1,287
1,<environment.Job instance at 0x7f4c5ae09cd0>,117,27,[9 3],118,-1,351,-1,324
1,<environment.Job instance at 0x7f4c5a8025f0>,119,16,[14  4],120,-1,340,-1,324
1,<environment.Job instance at 0x7f4c5a8029b0>,120,3,[ 3 13],121,-1,327,-1,324
1,<environment.Job instance at 0x7f4c59f7b410>,140,1,[ 1 11],141,-1,409,-1,408
1,<environment.Job instance at 0x7f4c5aded190>,150,3,[14  3],151,-1,451,-1,448
1,<environment.Job instance at 0x7f4c59f59320>,1,18,[4 9],2,-1,20,-1,2
1,<environment.Job instance at 0x7f4c59f59eb0>,5,14,[4 7],6,-1,20,-1,6
1,<environment.Job instance at 0x7f4c59f5b690>,11,14,[4 7],12,-1,26,-1,12
1,<environment.Job instance at 0x7f4c59f5b4b0>,14,17,[5 4],15,-1,32,-1,15
1,<environment.Job instance at 0x7f4c59f5b500>,16,18,[6 5],17,-1,35,-1,17
1,<environment.Job instance at 0x7f4c59f5b3c0>,17,14,[10  5],18,-1,35,-1,21
1,<environment.Job instance at 0x7f4c59f57280>,22,16,[5 8],23,-1,39,-1,23
1,<environment.Job instance at 0x7f4c59f577d0>,23,22,[7 2],24,-1,46,-1,24
1,<environment.Job instance at 0x7f4c59f57690>,25,16,[7 2],26,-1,42,-1,26
1,<environment.Job instance at 0x7f4c59f575f0>,28,14,[ 5 10],29,-1,43,-1,29
1,<environment.Job instance at 0x7f4c59f63640>,34,13,[ 2 10],35,-1,48,-1,35
1,<environment.Job instance at 0x7f4c59f63460>,36,18,[5 5],37,-1,55,-1,37
1,<environment.Job instance at 0x7f4c59f630f0>,37,18,[9 5],38,-1,56,-1,38
1,<environment.Job instance at 0x7f4c59f63230>,43,19,[7 4],44,-1,64,-1,45
1,<environment.Job instance at 0x7f4c59f6e4b0>,44,18,[9 3],45,-1,76,-1,58
1,<environment.Job instance at 0x7f4c59f6ea00>,45,26,[ 2 12],46,-1,91,-1,65
1,<environment.Job instance at 0x7f4c59f6e0f0>,54,13,[10  2],55,-1,78,-1,65
1,<environment.Job instance at 0x7f4c59f6e870>,48,12,[3 9],49,-1,80,-1,68
1,<environment.Job instance at 0x7f4c59f7f500>,57,17,[9 1],58,-1,89,-1,72
1,<environment.Job instance at 0x7f4c59f7fd20>,58,17,[2 5],59,-1,89,-1,72
1,<environment.Job instance at 0x7f4c59f7f820>,60,22,[13  5],61,-1,95,-1,73
1,<environment.Job instance at 0x7f4c59f7f640>,61,19,[3 5],62,-1,92,-1,73
1,<environment.Job instance at 0x7f4c59f7f910>,63,18,[9 5],64,-1,92,-1,74
1,<environment.Job instance at 0x7f4c59f5a5a0>,67,17,[4 6],68,-1,91,-1,74
1,<environment.Job instance at 0x7f4c59f7f550>,64,18,[1 5],65,-1,92,-1,74
1,<environment.Job instance at 0x7f4c59f5ae60>,72,12,[ 4 10],73,-1,86,-1,74
1,<environment.Job instance at 0x7f4c59f6bd70>,74,16,[8 4],75,-1,91,-1,75
1,<environment.Job instance at 0x7f4c59f58f50>,96,16,[ 5 14],97,-1,329,-1,313
1,<environment.Job instance at 0x7f4c59f58aa0>,91,21,[ 5 10],92,-1,338,-1,317
1,<environment.Job instance at 0x7f4c5a3c1190>,108,17,[5 8],109,-1,334,-1,317
1,<environment.Job instance at 0x7f4c59d26eb0>,117,22,[4 7],118,-1,339,-1,317
1,<environment.Job instance at 0x7f4c59d266e0>,118,27,[6 4],119,-1,344,-1,317
1,<environment.Job instance at 0x7f4c59f6bd20>,81,18,[ 1 10],82,-1,335,-1,317
1,<environment.Job instance at 0x7f4c59d268c0>,122,13,[7 3],123,-1,333,-1,320
1,<environment.Job instance at 0x7f4c59f195f0>,129,17,[5 2],130,-1,342,-1,325
1,<environment.Job instance at 0x7f4c59f951e0>,130,18,[3 7],131,-1,343,-1,325
1,<environment.Job instance at 0x7f4c59670820>,139,12,[5 5],140,-1,358,-1,346
1,<environment.Job instance at 0x7f4c5ad6db90>,141,18,[ 5 10],142,-1,364,-1,346
1,<environment.Job instance at 0x7f4c59fb4b90>,144,12,[10  3],145,-1,358,-1,346
1,<environment.Job instance at 0x7f4c59c59410>,133,13,[8 2],134,-1,359,-1,346
1,<environment.Job instance at 0x7f4c59f2b0a0>,114,28,[8 3],115,-1,374,-1,346
1,<environment.Job instance at 0x7f4c5a137c80>,142,25,[ 5 11],143,-1,371,-1,346
1,<environment.Job instance at 0x7f4c59c59f00>,134,14,[1 7],135,-1,360,-1,346
1,<environment.Job instance at 0x7f4c5a8a5550>,169,18,[7 4],170,-1,440,-1,422
1,<environment.Job instance at 0x7f4c59f57320>,6,1,[ 5 14],7,-1,8,-1,7
1,<environment.Job instance at 0x7f4c5a8d3c80>,7,18,[ 5 13],8,-1,26,-1,8
1,<environment.Job instance at 0x7f4c59668e60>,12,17,[ 5 13],13,-1,37,-1,20
1,<environment.Job instance at 0x7f4c5a1428c0>,13,12,[ 5 12],14,-1,32,-1,20
1,<environment.Job instance at 0x7f4c59f59cd0>,31,18,[14  1],32,-1,96,-1,78
1,<environment.Job instance at 0x7f4c59f63c30>,38,18,[ 1 13],39,-1,114,-1,96
1,<environment.Job instance at 0x7f4c59f6b3c0>,45,26,[ 2 12],46,-1,154,-1,128
1,<environment.Job instance at 0x7f4c59f58780>,51,21,[ 5 14],52,-1,166,-1,145
1,<environment.Job instance at 0x7f4c59f58190>,52,1,[ 4 14],53,-1,146,-1,145
1,<environment.Job instance at 0x7f4c5a00a2d0>,60,22,[13  5],61,-1,206,-1,184
1,<environment.Job instance at 0x7f4c5a6c69b0>,69,2,[ 3 11],70,-1,203,-1,201
1,<environment.Job instance at 0x7f4c5a6d5820>,78,14,[ 2 14],79,-1,251,-1,237
1,<environment.Job instance at 0x7f4c59683a00>,87,17,[ 4 11],88,-1,297,-1,280
1,<environment.Job instance at 0x7f4c5a449a50>,88,12,[ 4 12],89,-1,292,-1,280
1,<environment.Job instance at 0x7f4c5a379e60>,96,16,[ 5 14],97,-1,316,-1,300
1,<environment.Job instance at 0x7f4c59752140>,101,14,[13  1],102,-1,339,-1,325
1,<environment.Job instance at 0x7f4c59f7bc30>,114,28,[8 3],115,-1,415,-1,387
1,<environment.Job instance at 0x7f4c59f7b550>,118,27,[6 4],119,-1,417,-1,390
1,<environment.Job instance at 0x7f4c59f67f00>,136,24,[5 6],137,-1,461,-1,437
1,<environment.Job instance at 0x7f4c597c8a50>,142,25,[ 5 11],143,-1,476,-1,451
1,<environment.Job instance at 0x7f4c59f7e1e0>,153,13,[ 3 13],154,-1,514,-1,501
1,<environment.Job instance at 0x7f4c59f7e780>,167,2,[13  5],168,-1,548,-1,546
1,<environment.Job instance at 0x7f4c5ae0cb90>,170,3,[12  1],171,-1,564,-1,561
1,<environment.Job instance at 0x7f4c5ae0c7d0>,178,3,[14  5],179,-1,587,-1,584
1,<environment.Job instance at 0x7f4c5a00ffa0>,1,15,[9 1],2,-1,18,-1,3
1,<environment.Job instance at 0x7f4c5a6f1cd0>,5,18,[3 5],6,-1,24,-1,6
1,<environment.Job instance at 0x7f4c5a6f1aa0>,6,27,[4 9],7,-1,34,-1,7
1,<environment.Job instance at 0x7f4c5a6f1a00>,9,17,[1 9],10,-1,27,-1,10
1,<environment.Job instance at 0x7f4c5a6fe410>,11,18,[8 3],12,-1,30,-1,12
1,<environment.Job instance at 0x7f4c5a70c9b0>,12,16,[4 9],13,-1,29,-1,13
1,<environment.Job instance at 0x7f4c5971ddc0>,32,13,[ 4 11],33,-1,96,-1,83
1,<environment.Job instance at 0x7f4c599382d0>,34,15,[8 1],35,-1,98,-1,83
1,<environment.Job instance at 0x7f4c5a71b690>,40,15,[5 4],41,-1,98,-1,83
1,<environment.Job instance at 0x7f4c598b5e10>,41,15,[ 4 10],42,-1,98,-1,83
1,<environment.Job instance at 0x7f4c59920690>,27,13,[4 5],28,-1,96,-1,83
1,<environment.Job instance at 0x7f4c5a4f6f50>,43,14,[12  2],44,-1,97,-1,83
1,<environment.Job instance at 0x7f4c598b5640>,42,18,[4 6],43,-1,104,-1,86
1,<environment.Job instance at 0x7f4c598b9820>,46,13,[9 1],47,-1,100,-1,87
1,<environment.Job instance at 0x7f4c5a4ed910>,39,12,[6 3],40,-1,99,-1,87
1,<environment.Job instance at 0x7f4c598b90a0>,49,12,[5 9],50,-1,99,-1,87
1,<environment.Job instance at 0x7f4c598a74b0>,38,15,[3 7],39,-1,102,-1,87
1,<environment.Job instance at 0x7f4c5a6f93c0>,50,15,[7 1],51,-1,102,-1,87
1,<environment.Job instance at 0x7f4c5a501320>,47,18,[9 5],48,-1,105,-1,87
1,<environment.Job instance at 0x7f4c598b0320>,53,13,[9 4],54,-1,100,-1,87
1,<environment.Job instance at 0x7f4c598b06e0>,55,14,[ 3 10],56,-1,101,-1,87
1,<environment.Job instance at 0x7f4c598b01e0>,57,23,[8 5],58,-1,118,-1,95
1,<environment.Job instance at 0x7f4c598b0690>,59,15,[ 5 10],60,-1,111,-1,96
1,<environment.Job instance at 0x7f4c598b0050>,64,25,[1 9],65,-1,121,-1,96
1,<environment.Job instance at 0x7f4c598b0870>,54,18,[5 2],55,-1,114,-1,96
1,<environment.Job instance at 0x7f4c598b0f00>,63,15,[5 6],64,-1,111,-1,96
1,<environment.Job instance at 0x7f4c598b0140>,69,17,[6 1],70,-1,113,-1,96
1,<environment.Job instance at 0x7f4c598c1aa0>,72,12,[ 3 10],73,-1,108,-1,96
1,<environment.Job instance at 0x7f4c598b7500>,79,21,[6 4],80,-1,132,-1,111
1,<environment.Job instance at 0x7f4c598c1d20>,75,22,[ 4 13],76,-1,137,-1,115
1,<environment.Job instance at 0x7f4c598b7640>,81,15,[5 7],82,-1,130,-1,115
1,<environment.Job instance at 0x7f4c5afbba50>,166,17,[ 5 10],167,-1,2016,-1,1999
1,<environment.Job instance at 0x7f4c5a70c7d0>,0,17,[ 4 12],1,-1,18,-1,1
1,<environment.Job instance at 0x7f4c5a501820>,6,27,[4 9],7,-1,44,-1,17
1,<environment.Job instance at 0x7f4c5afa3af0>,15,13,[11  5],16,-1,48,-1,35
1,<environment.Job instance at 0x7f4c5af8d230>,16,24,[8 3],17,-1,62,-1,38
1,<environment.Job instance at 0x7f4c598b0a50>,18,12,[ 4 11],19,-1,50,-1,38
1,<environment.Job instance at 0x7f4c5af9f050>,21,3,[ 3 11],22,-1,50,-1,47
1,<environment.Job instance at 0x7f4c5af90320>,32,13,[ 4 11],33,-1,106,-1,93
1,<environment.Job instance at 0x7f4c5af8c870>,43,14,[12  2],44,-1,155,-1,141
1,<environment.Job instance at 0x7f4c59f7e870>,57,23,[8 5],58,-1,230,-1,207
1,<environment.Job instance at 0x7f4c59f7eaf0>,60,1,[14  2],61,-1,209,-1,208
1,<environment.Job instance at 0x7f4c59f7e050>,62,13,[ 2 14],63,-1,222,-1,209
1,<environment.Job instance at 0x7f4c59f7ec80>,64,25,[1 9],65,-1,249,-1,224
1,<environment.Job instance at 0x7f4c597c88c0>,75,22,[ 4 13],76,-1,265,-1,243
1,<environment.Job instance at 0x7f4c5a449820>,91,3,[12  1],92,-1,307,-1,304
1,<environment.Job instance at 0x7f4c5a005f50>,100,18,[12  5],101,-1,354,-1,336
1,<environment.Job instance at 0x7f4c5a03df50>,103,14,[ 4 11],104,-1,359,-1,345
1,<environment.Job instance at 0x7f4c5a802a00>,107,25,[ 2 11],108,-1,385,-1,360
1,<environment.Job instance at 0x7f4c5a8027d0>,109,18,[14  1],110,-1,381,-1,363
1,<environment.Job instance at 0x7f4c5a00a8c0>,111,1,[12  5],112,-1,364,-1,363
1,<environment.Job instance at 0x7f4c59f587d0>,115,28,[8 3],116,-1,422,-1,394
1,<environment.Job instance at 0x7f4c59f58a50>,116,13,[14  3],117,-1,407,-1,394
1,<environment.Job instance at 0x7f4c59f59af0>,123,26,[5 5],124,-1,443,-1,417
1,<environment.Job instance at 0x7f4c5a142910>,130,14,[12  5],131,-1,459,-1,445
1,<environment.Job instance at 0x7f4c59fa2c30>,135,25,[8 4],136,-1,493,-1,468
1,<environment.Job instance at 0x7f4c59fb4140>,136,26,[5 5],137,-1,494,-1,468
1,<environment.Job instance at 0x7f4c5a7a5410>,150,1,[ 3 11],151,-1,500,-1,499
1,<environment.Job instance at 0x7f4c5ad77140>,153,14,[ 3 12],154,-1,531,-1,517
1,<environment.Job instance at 0x7f4c5969f780>,161,23,[5 8],162,-1,581,-1,558
1,<environment.Job instance at 0x7f4c5997de10>,164,3,[ 5 11],165,-1,561,-1,558
1,<environment.Job instance at 0x7f4c5a3797d0>,165,17,[14  2],166,-1,575,-1,558
1,<environment.Job instance at 0x7f4c5a452870>,172,24,[5 5],179,-1,618,-1,594
1,<environment.Job instance at 0x7f9afd7df6e0>,0,18,[ 2 10],1,-1,20,-1,2
1,<environment.Job instance at 0x7f9af41efa50>,3,18,[ 3 10],4,-1,22,-1,4
1,<environment.Job instance at 0x7f9af41efbe0>,4,18,[10  4],5,-1,23,-1,5
1,<environment.Job instance at 0x7f9af41efaf0>,5,13,[5 9],6,-1,19,-1,6
1,<environment.Job instance at 0x7f9af41efc80>,6,12,[11  4],7,-1,19,-1,7
1,<environment.Job instance at 0x7f9af41efdc0>,8,17,[ 2 10],9,-1,26,-1,9
1,<environment.Job instance at 0x7f9af41eff00>,9,17,[ 4 10],10,-1,27,-1,10
1,<environment.Job instance at 0x7f9af41f22d0>,13,13,[1 8],14,-1,27,-1,14
1,<environment.Job instance at 0x7f9af41f2730>,18,16,[8 5],19,-1,35,-1,19
1,<environment.Job instance at 0x7f9af41f2870>,19,17,[12  3],20,-1,37,-1,20
1,<environment.Job instance at 0x7f9af41f2b90>,23,18,[5 2],24,-1,42,-1,24
1,<environment.Job instance at 0x7f9af41f2eb0>,26,22,[2 9],27,-1,49,-1,27
1,<environment.Job instance at 0x7f9af41f5370>,31,17,[4 9],32,-1,49,-1,32
1,<environment.Job instance at 0x7f9af41f50f0>,32,17,[9 3],33,-1,50,-1,33
1,<environment.Job instance at 0x7f9af41f58c0>,35,16,[8 1],36,-1,52,-1,36
1,<environment.Job instance at 0x7f9af41f57d0>,37,14,[5 5],38,-1,52,-1,38
1,<environment.Job instance at 0x7f9af41f5be0>,38,12,[3 6],39,-1,51,-1,39
1,<environment.Job instance at 0x7f9af41f5a50>,39,18,[5 8],40,-1,58,-1,40
1,<environment.Job instance at 0x7f9af41f5d20>,41,14,[6 1],42,-1,56,-1,42
1,<environment.Job instance at 0x7f9af41f5d70>,42,14,[8 4],43,-1,57,-1,43
1,<environment.Job instance at 0x7f9af41f5e10>,43,28,[6 4],44,-1,72,-1,44
1,<environment.Job instance at 0x7f9afd7df8c0>,1,15,[ 1 14],2,-1,64,-1,49
1,<environment.Job instance at 0x7f9af41f7b40>,55,17,[4 7],56,-1,73,-1,56
1,<environment.Job instance at 0x7f9af41f7c80>,56,18,[4 5],57,-1,76,-1,58
1,<environment.Job instance at 0x7f9af41f7f50>,59,14,[ 2 10],60,-1,75,-1,61
1,<environment.Job instance at 0x7f9af41f91e0>,62,20,[9 1],63,-1,83,-1,63
1,<environment.Job instance at 0x7f9af41f93c0>,63,15,[1 5],64,-1,79,-1,64
1,<environment.Job instance at 0x7f9af41f9640>,67,26,[5 4],68,-1,94,-1,68
1,<environment.Job instance at 0x7f9af41f9870>,68,22,[5 6],69,-1,91,-1,69
1,<environment.Job instance at 0x7f9af41f97d0>,69,13,[7 2],70,-1,83,-1,70
1,<environment.Job instance at 0x7f9af41f9960>,70,18,[5 5],71,-1,89,-1,71
1,<environment.Job instance at 0x7f9af41f9aa0>,72,14,[9 1],73,-1,87,-1,73
1,<environment.Job instance at 0x7f9af41f9c30>,76,13,[1 5],77,-1,90,-1,77
1,<environment.Job instance at 0x7f9af41fc0a0>,77,15,[4 7],78,-1,93,-1,78
1,<environment.Job instance at 0x7f9af41fc140>,78,19,[8 4],79,-1,98,-1,79
1,<environment.Job instance at 0x7f9af41fc1e0>,79,17,[2 7],80,-1,97,-1,80
1,<environment.Job instance at 0x7f9af41fc460>,82,3,[10  1],83,-1,86,-1,83
1,<environment.Job instance at 0x7f9af41f7e10>,60,24,[ 3 10],61,-1,108,-1,84
1,<environment.Job instance at 0x7f9af41fcaf0>,91,16,[5 8],92,-1,116,-1,100
1,<environment.Job instance at 0x7f9af42475f0>,95,23,[3 7],96,-1,123,-1,100
1,<environment.Job instance at 0x7f9af41e65f0>,100,18,[7 5],101,-1,127,-1,109
1,<environment.Job instance at 0x7f9af4299c80>,115,14,[9 1],116,-1,148,-1,134
1,<environment.Job instance at 0x7f9af4422460>,111,18,[ 3 13],112,-1,152,-1,134
1,<environment.Job instance at 0x7f9af42d87d0>,116,15,[9 2],117,-1,149,-1,134
1,<environment.Job instance at 0x7f9af42927d0>,110,20,[5 7],111,-1,154,-1,134
1,<environment.Job instance at 0x7f9af41e6910>,102,27,[ 3 13],103,-1,161,-1,134
1,<environment.Job instance at 0x7f9af43124b0>,119,16,[1 8],120,-1,150,-1,134
1,<environment.Job instance at 0x7f9af4312410>,121,18,[11  5],122,-1,152,-1,134
1,<environment.Job instance at 0x7f9af437ccd0>,130,16,[9 3],131,-1,183,-1,167
1,<environment.Job instance at 0x7f9af41f2280>,1,15,[ 1 14],2,-1,17,-1,2
1,<environment.Job instance at 0x7f9af41f55f0>,6,12,[11  4],7,-1,19,-1,7
1,<environment.Job instance at 0x7f9afd825910>,19,17,[12  3],20,-1,67,-1,50
1,<environment.Job instance at 0x7f9af43391e0>,22,2,[12  3],23,-1,62,-1,60
1,<environment.Job instance at 0x7f9af41e34b0>,43,28,[6 4],44,-1,166,-1,138
1,<environment.Job instance at 0x7f9af41dfc80>,44,17,[ 5 12],45,-1,155,-1,138
1,<environment.Job instance at 0x7f9af42010f0>,50,27,[9 1],51,-1,179,-1,152
1,<environment.Job instance at 0x7f9af4201e10>,52,3,[ 3 11],53,-1,155,-1,152
1,<environment.Job instance at 0x7f9af4201410>,53,18,[ 4 12],54,-1,170,-1,152
1,<environment.Job instance at 0x7f9af41ef960>,60,24,[ 3 10],61,-1,209,-1,185
1,<environment.Job instance at 0x7f9af41885f0>,67,26,[5 4],68,-1,226,-1,200
1,<environment.Job instance at 0x7f9af4188f00>,81,17,[ 4 14],82,-1,256,-1,239
1,<environment.Job instance at 0x7f9af418e230>,85,19,[14  4],86,-1,260,-1,241
1,<environment.Job instance at 0x7f9af418e8c0>,95,23,[3 7],96,-1,294,-1,271
1,<environment.Job instance at 0x7f9af418efa0>,102,27,[ 3 13],103,-1,316,-1,289
1,<environment.Job instance at 0x7f9af4192640>,111,18,[ 3 13],112,-1,333,-1,315
1,<environment.Job instance at 0x7f9af4192910>,117,18,[ 3 12],118,-1,348,-1,330
1,<environment.Job instance at 0x7f9af4192b90>,121,18,[11  5],122,-1,359,-1,341
1,<environment.Job instance at 0x7f9af4192cd0>,122,14,[14  1],123,-1,355,-1,341
1,<environment.Job instance at 0x7f9af41965f0>,135,15,[ 3 14],136,-1,411,-1,396
1,<environment.Job instance at 0x7f9af4196730>,137,12,[14  5],138,-1,408,-1,396
1,<environment.Job instance at 0x7f9af4198c80>,166,22,[11  3],167,-1,533,-1,511
1,<environment.Job instance at 0x7f9af419b6e0>,179,23,[2 8],180,-1,586,-1,563
1,<environment.Job instance at 0x7f9af419b2d0>,175,25,[3 9],176,-1,597,-1,572
1,<environment.Job instance at 0x7f9af419b5f0>,183,26,[9 1],187,-1,598,-1,572
1,<environment.Job instance at 0x7f9af3bd0410>,2,14,[8 4],3,-1,19,-1,5
1,<environment.Job instance at 0x7f9af3bd0820>,8,2,[ 3 10],9,-1,13,-1,11
1,<environment.Job instance at 0x7f9af3bd00f0>,5,16,[ 3 10],6,-1,35,-1,19
1,<environment.Job instance at 0x7f9af3b8e140>,13,27,[5 3],14,-1,49,-1,22
1,<environment.Job instance at 0x7f9af3b8eaf0>,12,14,[9 2],13,-1,36,-1,22
1,<environment.Job instance at 0x7f9af3bd0eb0>,6,23,[5 8],7,-1,59,-1,36
1,<environment.Job instance at 0x7f9af3b8e190>,14,17,[10  2],15,-1,55,-1,38
1,<environment.Job instance at 0x7f9af3bcc7d0>,18,22,[9 2],19,-1,62,-1,40
1,<environment.Job instance at 0x7f9af3bd05f0>,4,17,[10  5],5,-1,57,-1,40
1,<environment.Job instance at 0x7f9af3bcc730>,21,18,[ 5 11],22,-1,58,-1,40
1,<environment.Job instance at 0x7f9af3bd1230>,22,17,[10  4],23,-1,57,-1,40
1,<environment.Job instance at 0x7f9af3d13a00>,20,17,[2 9],21,-1,60,-1,43
1,<environment.Job instance at 0x7f9af3b8d690>,26,16,[7 2],27,-1,62,-1,46
1,<environment.Job instance at 0x7f9af3b8ea50>,15,17,[5 9],16,-1,63,-1,46
1,<environment.Job instance at 0x7f9af3b8d140>,25,17,[8 1],26,-1,63,-1,46
1,<environment.Job instance at 0x7f9af3c5e370>,33,15,[5 6],34,-1,73,-1,58
1,<environment.Job instance at 0x7f9af3c5e460>,34,28,[9 1],35,-1,87,-1,59
1,<environment.Job instance at 0x7f9af3c5e3c0>,35,17,[3 5],36,-1,123,-1,106
1,<environment.Job instance at 0x7f9af3c5e960>,36,15,[ 5 10],37,-1,128,-1,113
1,<environment.Job instance at 0x7f9af3b8d1e0>,24,13,[5 9],25,-1,126,-1,113
1,<environment.Job instance at 0x7f9af3b8d910>,27,18,[ 1 10],28,-1,131,-1,113
1,<environment.Job instance at 0x7f9af3bcc460>,16,13,[5 1],17,-1,126,-1,113
1,<environment.Job instance at 0x7f9af3c5ea00>,39,12,[5 4],40,-1,126,-1,114
1,<environment.Job instance at 0x7f9af3c5eb90>,38,16,[14  3],39,-1,130,-1,114
1,<environment.Job instance at 0x7f9af3c63050>,42,16,[8 5],43,-1,130,-1,114
1,<environment.Job instance at 0x7f9af3c632d0>,41,13,[3 6],42,-1,127,-1,114
1,<environment.Job instance at 0x7f9af3c63230>,43,12,[3 8],44,-1,126,-1,114
1,<environment.Job instance at 0x7f9af3c63820>,45,12,[2 6],46,-1,126,-1,114
1,<environment.Job instance at 0x7f9af3c63a50>,48,18,[3 8],49,-1,222,-1,204
1,<environment.Job instance at 0x7f9af3c63eb0>,50,28,[7 3],51,-1,232,-1,204
1,<environment.Job instance at 0x7f9af3c63370>,49,16,[9 4],50,-1,221,-1,205
1,<environment.Job instance at 0x7f9af3c630f0>,44,14,[8 5],45,-1,221,-1,207
1,<environment.Job instance at 0x7f9af3c680f0>,53,18,[1 6],54,-1,226,-1,208
1,<environment.Job instance at 0x7f9af3c685a0>,60,18,[8 5],61,-1,239,-1,221
1,<environment.Job instance at 0x7f9af3c688c0>,59,1,[8 3],60,-1,222,-1,221
1,<environment.Job instance at 0x7f9af3c68370>,57,16,[2 8],58,-1,241,-1,225
1,<environment.Job instance at 0x7f9af3c68730>,64,17,[1 9],65,-1,242,-1,225
1,<environment.Job instance at 0x7f9af3dfd190>,71,19,[ 3 14],72,-1,244,-1,225
1,<environment.Job instance at 0x7f9af3d867d0>,73,21,[9 5],74,-1,258,-1,237
1,<environment.Job instance at 0x7f9af3876640>,74,18,[10  2],75,-1,255,-1,237
1,<environment.Job instance at 0x7f9af3b96960>,75,12,[12  4],76,-1,249,-1,237
1,<environment.Job instance at 0x7f9af3a735a0>,76,22,[6 1],77,-1,259,-1,237
1,<environment.Job instance at 0x7f9af3b8d500>,28,28,[7 4],29,-1,265,-1,237
1,<environment.Job instance at 0x7f9af3d65f50>,67,1,[1 7],68,-1,240,-1,239
1,<environment.Job instance at 0x7f9af3a08780>,81,18,[ 5 14],82,-1,257,-1,239
1,<environment.Job instance at 0x7f9af3a08f00>,82,17,[8 2],83,-1,263,-1,246
1,<environment.Job instance at 0x7f9af3a58e60>,83,18,[7 5],84,-1,266,-1,248
1,<environment.Job instance at 0x7f9af3a08aa0>,78,21,[5 1],79,-1,269,-1,248
1,<environment.Job instance at 0x7f9af3a13960>,89,13,[5 7],90,-1,261,-1,248
1,<environment.Job instance at 0x7f9afd856280>,92,2,[9 4],93,-1,250,-1,248
1,<environment.Job instance at 0x7f9afd860d70>,91,16,[6 2],92,-1,264,-1,248
1,<environment.Job instance at 0x7f9af3a13910>,87,14,[4 7],88,-1,263,-1,249
1,<environment.Job instance at 0x7f9afd821230>,96,13,[3 6],97,-1,262,-1,249
1,<environment.Job instance at 0x7f9af3933c30>,99,14,[5 7],100,-1,264,-1,250
1,<environment.Job instance at 0x7f9af3d5cd70>,68,12,[12  2],69,-1,263,-1,251
1,<environment.Job instance at 0x7f9af3933870>,100,13,[7 4],101,-1,264,-1,251
1,<environment.Job instance at 0x7f9af3842690>,104,18,[ 5 10],105,-1,270,-1,252
1,<environment.Job instance at 0x7f9af378e230>,106,16,[5 7],107,-1,268,-1,252
1,<environment.Job instance at 0x7f9af3801230>,103,18,[9 2],104,-1,283,-1,265
1,<environment.Job instance at 0x7f9af378ec80>,108,15,[2 5],109,-1,280,-1,265
1,<environment.Job instance at 0x7f9af37a6960>,117,17,[7 5],118,-1,287,-1,270
1,<environment.Job instance at 0x7f9af3789c80>,120,14,[2 8],121,-1,284,-1,270
1,<environment.Job instance at 0x7f9af37897d0>,121,15,[10  3],122,-1,285,-1,270
1,<environment.Job instance at 0x7f9af37a6140>,116,15,[7 3],117,-1,287,-1,272
1,<environment.Job instance at 0x7f9af37a3e10>,124,16,[8 3],125,-1,289,-1,273
1,<environment.Job instance at 0x7f9af37a31e0>,129,17,[4 8],130,-1,292,-1,275
1,<environment.Job instance at 0x7f9af37a6aa0>,115,18,[9 5],116,-1,293,-1,275
1,<environment.Job instance at 0x7f9af37a3780>,130,14,[ 3 10],131,-1,289,-1,275
1,<environment.Job instance at 0x7f9af37dd1e0>,98,17,[12  1],99,-1,293,-1,276
1,<environment.Job instance at 0x7f9af37a3a00>,127,14,[7 1],128,-1,291,-1,277
1,<environment.Job instance at 0x7f9af37a3320>,133,15,[7 4],134,-1,292,-1,277
1,<environment.Job instance at 0x7f9af37a2230>,148,14,[10  4],149,-1,323,-1,309
1,<environment.Job instance at 0x7f9af37a35a0>,131,18,[ 4 13],132,-1,328,-1,310
1,<environment.Job instance at 0x7f9af37a52d0>,151,15,[3 5],152,-1,325,-1,310
1,<environment.Job instance at 0x7f9af37a5690>,155,17,[6 3],156,-1,327,-1,310
1,<environment.Job instance at 0x7f9af37a5d20>,156,20,[6 2],157,-1,331,-1,311
1,<environment.Job instance at 0x7f9af37a5e10>,158,17,[2 8],159,-1,328,-1,311
1,<environment.Job instance at 0x7f9af37a5b40>,150,18,[11  4],151,-1,330,-1,312
1,<environment.Job instance at 0x7f9afda7b3c0>,161,14,[3 6],162,-1,326,-1,312
1,<environment.Job instance at 0x7f9af37a2aa0>,141,16,[2 8],142,-1,328,-1,312
1,<environment.Job instance at 0x7f9af37a0b40>,166,15,[10  5],167,-1,339,-1,324
1,<environment.Job instance at 0x7f9af37a0b90>,167,16,[ 3 10],168,-1,340,-1,324
1,<environment.Job instance at 0x7f9af37a0820>,168,16,[3 6],169,-1,340,-1,324
1,<environment.Job instance at 0x7f9af37a4410>,6,23,[5 8],7,-1,45,-1,22
1,<environment.Job instance at 0x7f9af419b410>,11,2,[12  1],12,-1,24,-1,22
1,<environment.Job instance at 0x7f9af419b3c0>,13,27,[5 3],14,-1,53,-1,26
1,<environment.Job instance at 0x7f9af4198eb0>,19,3,[ 4 12],20,-1,38,-1,35
1,<environment.Job instance at 0x7f9af4198fa0>,21,18,[ 5 11],22,-1,53,-1,35
1,<environment.Job instance at 0x7f9af4198640>,28,28,[7 4],29,-1,117,-1,89
1,<environment.Job instance at 0x7f9af41980a0>,34,28,[9 1],35,-1,138,-1,110
1,<environment.Job instance at 0x7f9af4196b40>,38,16,[14  3],39,-1,126,-1,110
1,<environment.Job instance at 0x7f9af41962d0>,50,28,[7 3],51,-1,206,-1,178
1,<environment.Job instance at 0x7f9af4192820>,68,12,[12  2],69,-1,266,-1,254
1,<environment.Job instance at 0x7f9af41926e0>,71,19,[ 3 14],72,-1,280,-1,261
1,<environment.Job instance at 0x7f9af4192550>,72,2,[14  5],73,-1,263,-1,261
1,<environment.Job instance at 0x7f9af4192d70>,75,12,[12  4],76,-1,283,-1,271
1,<environment.Job instance at 0x7f9af418ec80>,81,18,[ 5 14],82,-1,292,-1,274
1,<environment.Job instance at 0x7f9af418e730>,88,1,[ 5 14],89,-1,310,-1,309
1,<environment.Job instance at 0x7f9af418e320>,93,3,[14  5],94,-1,327,-1,324
1,<environment.Job instance at 0x7f9af4187dc0>,98,17,[12  1],99,-1,358,-1,341
1,<environment.Job instance at 0x7f9af41879b0>,102,1,[13  3],103,-1,345,-1,344
1,<environment.Job instance at 0x7f9af39fde60>,112,27,[ 2 13],113,-1,420,-1,393
1,<environment.Job instance at 0x7f9af3e26410>,118,1,[12  5],119,-1,415,-1,414
1,<environment.Job instance at 0x7f9af39957d0>,131,18,[ 4 13],132,-1,485,-1,467
1,<environment.Job instance at 0x7f9af3afd730>,137,16,[ 5 13],138,-1,513,-1,497
1,<environment.Job instance at 0x7f9af39a32d0>,144,18,[13  2],145,-1,532,-1,514
1,<environment.Job instance at 0x7f9af3a1ef00>,150,18,[11  4],151,-1,545,-1,527
1,<environment.Job instance at 0x7f9af39a71e0>,174,24,[3 6],184,-1,652,-1,628
1,<environment.Job instance at 0x7f9af37c6a50>,0,18,[4 8],1,-1,19,-1,1
1,<environment.Job instance at 0x7f9af391c3c0>,5,18,[ 3 10],6,-1,25,-1,7
1,<environment.Job instance at 0x7f9af38ca140>,6,21,[6 1],7,-1,28,-1,7
1,<environment.Job instance at 0x7f9af391b500>,12,17,[9 1],13,-1,31,-1,14
1,<environment.Job instance at 0x7f9af391ca50>,13,18,[8 1],14,-1,33,-1,15
1,<environment.Job instance at 0x7f9af391b2d0>,15,27,[5 5],16,-1,43,-1,16
1,<environment.Job instance at 0x7f9af391bfa0>,16,22,[2 8],17,-1,40,-1,18
1,<environment.Job instance at 0x7f9af391b3c0>,19,17,[2 6],20,-1,37,-1,20
1,<environment.Job instance at 0x7f9af391beb0>,20,16,[1 9],21,-1,37,-1,21
1,<environment.Job instance at 0x7f9af391b870>,22,17,[4 6],23,-1,40,-1,23
1,<environment.Job instance at 0x7f9af391b9b0>,23,27,[7 5],24,-1,51,-1,24
1,<environment.Job instance at 0x7f9af39120f0>,28,14,[2 7],29,-1,43,-1,29
1,<environment.Job instance at 0x7f9af3912140>,29,17,[5 1],30,-1,47,-1,30
1,<environment.Job instance at 0x7f9af3912a50>,31,18,[5 7],32,-1,50,-1,32
1,<environment.Job instance at 0x7f9af3912e60>,35,25,[3 7],36,-1,61,-1,36
1,<environment.Job instance at 0x7f9af3912870>,37,14,[10  3],38,-1,52,-1,38
1,<environment.Job instance at 0x7f9af390f910>,45,16,[10  5],46,-1,68,-1,52
1,<environment.Job instance at 0x7f9af3909cd0>,50,17,[9 4],51,-1,99,-1,82
1,<environment.Job instance at 0x7f9af3912820>,33,16,[3 5],34,-1,113,-1,97
1,<environment.Job instance at 0x7f9af3909f50>,57,16,[2 6],58,-1,113,-1,97
1,<environment.Job instance at 0x7f9af390faf0>,48,21,[9 5],49,-1,118,-1,97
1,<environment.Job instance at 0x7f9af391b0a0>,17,20,[5 2],18,-1,130,-1,110
1,<environment.Job instance at 0x7f9af3906c30>,65,24,[3 9],66,-1,176,-1,152
1,<environment.Job instance at 0x7f9af3906870>,64,14,[ 3 14],65,-1,166,-1,152
1,<environment.Job instance at 0x7f9af3906320>,76,2,[9 2],77,-1,154,-1,152
1,<environment.Job instance at 0x7f9af3906cd0>,74,15,[ 1 10],75,-1,167,-1,152
1,<environment.Job instance at 0x7f9af3909960>,59,16,[ 5 13],60,-1,168,-1,152
1,<environment.Job instance at 0x7f9af3903140>,80,13,[3 8],81,-1,168,-1,155
1,<environment.Job instance at 0x7f9af3903370>,81,15,[14  1],82,-1,170,-1,155
1,<environment.Job instance at 0x7f9af3903190>,82,27,[5 5],83,-1,182,-1,155
1,<environment.Job instance at 0x7f9af39060a0>,73,13,[9 5],74,-1,168,-1,155
1,<environment.Job instance at 0x7f9af39038c0>,83,14,[3 6],84,-1,169,-1,155
1,<environment.Job instance at 0x7f9af3980af0>,96,27,[5 8],97,-1,237,-1,210
1,<environment.Job instance at 0x7f9af3876410>,180,18,[5 9],181,-1,621,-1,603
1,<environment.Job instance at 0x7f9afd886b40>,149,27,[14  1],150,-1,633,-1,606
1,<environment.Job instance at 0x7f9af390f820>,3,2,[ 3 14],4,-1,6,-1,4
1,<environment.Job instance at 0x7f9afd948b90>,14,3,[ 3 12],15,-1,34,-1,31
1,<environment.Job instance at 0x7f9af3c15780>,15,27,[5 5],16,-1,62,-1,35
1,<environment.Job instance at 0x7f9af43f35a0>,18,13,[14  4],19,-1,49,-1,36
1,<environment.Job instance at 0x7f9af3817af0>,24,13,[14  5],25,-1,60,-1,47
1,<environment.Job instance at 0x7f9af37f40f0>,23,27,[7 5],24,-1,91,-1,64
1,<environment.Job instance at 0x7f9af3ba6320>,35,25,[3 7],36,-1,119,-1,94
1,<environment.Job instance at 0x7f9af3a974b0>,40,1,[ 4 12],41,-1,108,-1,107
1,<environment.Job instance at 0x7f9af397a140>,44,12,[13  3],45,-1,133,-1,121
1,<environment.Job instance at 0x7f9af3975370>,49,3,[12  1],50,-1,142,-1,139
1,<environment.Job instance at 0x7f9af3ba3370>,59,16,[ 5 13],60,-1,192,-1,176
1,<environment.Job instance at 0x7f9af3985640>,64,14,[ 3 14],65,-1,198,-1,184
1,<environment.Job instance at 0x7f9af39e7aa0>,65,24,[3 9],66,-1,225,-1,201
1,<environment.Job instance at 0x7f9af3b1cf50>,75,1,[12  4],76,-1,231,-1,230
1,<environment.Job instance at 0x7f9af39713c0>,81,15,[14  1],82,-1,254,-1,239
1,<environment.Job instance at 0x7f9af3971e10>,82,27,[5 5],83,-1,272,-1,245
1,<environment.Job instance at 0x7f9af39715a0>,84,25,[1 7],85,-1,277,-1,252
1,<environment.Job instance at 0x7f9af396d690>,96,27,[5 8],97,-1,335,-1,308
1,<environment.Job instance at 0x7f9af396d780>,101,24,[4 8],102,-1,348,-1,324
1,<environment.Job instance at 0x7f9af3964aa0>,111,1,[11  1],112,-1,346,-1,345
1,<environment.Job instance at 0x7f9af3961a50>,121,24,[1 9],122,-1,408,-1,384
1,<environment.Job instance at 0x7f9af3961c30>,127,23,[10  4],128,-1,421,-1,398
1,<environment.Job instance at 0x7f9af395bf50>,133,3,[ 5 13],134,-1,415,-1,412
1,<environment.Job instance at 0x7f9af395bb90>,136,17,[13  2],137,-1,442,-1,425
1,<environment.Job instance at 0x7f9af395b0f0>,137,1,[11  4],138,-1,426,-1,425
1,<environment.Job instance at 0x7f9af395bd20>,142,17,[ 2 12],143,-1,461,-1,444
1,<environment.Job instance at 0x7f9af395bf00>,145,24,[10  2],146,-1,483,-1,459
1,<environment.Job instance at 0x7f9af39576e0>,149,27,[14  1],150,-1,504,-1,477
1,<environment.Job instance at 0x7f9af3957fa0>,152,2,[11  4],153,-1,486,-1,484
1,<environment.Job instance at 0x7f9af3957780>,155,12,[11  5],156,-1,522,-1,510
1,<environment.Job instance at 0x7f9af39574b0>,156,27,[4 5],157,-1,537,-1,510
1,<environment.Job instance at 0x7f9af3954050>,162,3,[11  3],163,-1,537,-1,534
1,<environment.Job instance at 0x7f9af3954870>,171,15,[ 2 14],172,-1,576,-1,561
1,<environment.Job instance at 0x7f9af3a13af0>,175,12,[ 3 13],176,-1,588,-1,576
1,<environment.Job instance at 0x7f9af4053500>,5,17,[ 5 10],6,-1,24,-1,7
1,<environment.Job instance at 0x7f9af407d410>,8,16,[9 2],9,-1,25,-1,9
1,<environment.Job instance at 0x7f9af3ede410>,16,14,[9 2],17,-1,31,-1,17
1,<environment.Job instance at 0x7f9af3ede460>,17,17,[3 8],18,-1,35,-1,18
1,<environment.Job instance at 0x7f9af3edef50>,29,14,[4 9],30,-1,65,-1,51
1,<environment.Job instance at 0x7f9af4043690>,36,18,[9 4],37,-1,69,-1,51
1,<environment.Job instance at 0x7f9af4d22f50>,6,17,[ 1 10],7,-1,108,-1,91
1,<environment.Job instance at 0x7f9af4043eb0>,46,13,[3 9],47,-1,104,-1,91
1,<environment.Job instance at 0x7f9af40439b0>,47,14,[2 5],48,-1,110,-1,96
1,<environment.Job instance at 0x7f9af404d320>,52,15,[2 5],53,-1,111,-1,96
1,<environment.Job instance at 0x7f9af4043c30>,42,15,[10  1],43,-1,111,-1,96
1,<environment.Job instance at 0x7f9af4043a00>,48,16,[6 5],49,-1,112,-1,96
1,<environment.Job instance at 0x7f9af404d690>,54,16,[9 2],55,-1,112,-1,96
1,<environment.Job instance at 0x7f9af404d140>,53,14,[4 8],54,-1,110,-1,96
1,<environment.Job instance at 0x7f9af404d640>,56,15,[9 1],57,-1,111,-1,96
1,<environment.Job instance at 0x7f9af3edebe0>,25,24,[8 3],26,-1,145,-1,121
1,<environment.Job instance at 0x7f9af3c3a0f0>,69,16,[10  2],70,-1,137,-1,121
1,<environment.Job instance at 0x7f9af404d820>,58,13,[6 1],59,-1,134,-1,121
1,<environment.Job instance at 0x7f9af3c3a4b0>,74,15,[7 3],75,-1,138,-1,123
1,<environment.Job instance at 0x7f9af3c085a0>,90,27,[6 4],91,-1,261,-1,234
1,<environment.Job instance at 0x7f9af40400f0>,100,18,[ 5 10],101,-1,290,-1,272
1,<environment.Job instance at 0x7f9af3ecf410>,179,19,[5 5],180,-1,666,-1,647
1,<environment.Job instance at 0x7f9af3c3a7d0>,79,23,[6 5],80,-1,670,-1,647
1,<environment.Job instance at 0x7f9af4003910>,182,15,[4 8],183,-1,663,-1,648
1,<environment.Job instance at 0x7f9af40033c0>,184,14,[3 8],185,-1,662,-1,648
1,<environment.Job instance at 0x7f9af3edeaf0>,1,17,[14  3],2,-1,19,-1,2
1,<environment.Job instance at 0x7f9af40435a0>,4,15,[ 2 13],5,-1,20,-1,5
1,<environment.Job instance at 0x7f9af3b6f690>,7,3,[12  4],8,-1,11,-1,8
1,<environment.Job instance at 0x7f9af3b81c80>,9,28,[1 8],10,-1,51,-1,23
1,<environment.Job instance at 0x7f9af3c276e0>,18,18,[13  3],19,-1,44,-1,26
1,<environment.Job instance at 0x7f9af3c3ab40>,25,24,[8 3],26,-1,89,-1,65
1,<environment.Job instance at 0x7f9af3c19190>,41,13,[12  4],42,-1,126,-1,113
1,<environment.Job instance at 0x7f9af3c195f0>,44,24,[4 5],45,-1,153,-1,129
1,<environment.Job instance at 0x7f9af395b9b0>,79,23,[6 5],80,-1,290,-1,267
1,<environment.Job instance at 0x7f9af39615f0>,91,1,[11  4],92,-1,296,-1,295
1,<environment.Job instance at 0x7f9af3961aa0>,90,27,[6 4],91,-1,334,-1,307
1,<environment.Job instance at 0x7f9af3971dc0>,102,24,[1 6],103,-1,349,-1,325
1,<environment.Job instance at 0x7f9af3a1e730>,114,3,[ 2 12],115,-1,393,-1,390
1,<environment.Job instance at 0x7f9af3975460>,121,2,[ 3 14],122,-1,415,-1,413
1,<environment.Job instance at 0x7f9af3978460>,126,13,[12  4],127,-1,437,-1,424
1,<environment.Job instance at 0x7f9af39789b0>,127,27,[9 3],128,-1,457,-1,430
1,<environment.Job instance at 0x7f9af38ca780>,136,12,[ 2 11],137,-1,465,-1,453
1,<environment.Job instance at 0x7f9af3931370>,138,24,[4 7],139,-1,492,-1,468
1,<environment.Job instance at 0x7f9af3969fa0>,144,18,[ 4 11],145,-1,498,-1,480
1,<environment.Job instance at 0x7f9af391b050>,149,3,[14  1],150,-1,506,-1,503
1,<environment.Job instance at 0x7f9af37da690>,153,14,[ 1 11],154,-1,521,-1,507
1,<environment.Job instance at 0x7f9af3d8e3c0>,155,16,[ 2 11],156,-1,525,-1,509
1,<environment.Job instance at 0x7f9af39977d0>,158,2,[13  3],159,-1,517,-1,515
1,<environment.Job instance at 0x7f9af453e7d0>,170,24,[10  4],171,-1,595,-1,571
1,<environment.Job instance at 0x7f9af437e7d0>,172,17,[ 2 11],173,-1,588,-1,571
1,<environment.Job instance at 0x7f9af437eeb0>,174,1,[ 2 11],175,-1,572,-1,571
1,<environment.Job instance at 0x7f9afd3ae9b0>,2,16,[3 8],3,-1,19,-1,3
1,<environment.Job instance at 0x7f9afd3aeaa0>,6,18,[10  2],7,-1,26,-1,8
1,<environment.Job instance at 0x7f9afd3ae730>,8,17,[9 5],9,-1,26,-1,9
1,<environment.Job instance at 0x7f9afd3ae370>,9,16,[7 2],10,-1,26,-1,10
1,<environment.Job instance at 0x7f9afd3aee10>,10,16,[ 3 10],11,-1,27,-1,11
1,<environment.Job instance at 0x7f9afd3ae6e0>,11,16,[5 7],12,-1,28,-1,12
1,<environment.Job instance at 0x7f9af47c9410>,25,12,[8 5],26,-1,38,-1,26
1,<environment.Job instance at 0x7f9af47c9af0>,26,14,[6 4],27,-1,41,-1,27
1,<environment.Job instance at 0x7f9af47c9730>,28,17,[3 7],29,-1,46,-1,29
1,<environment.Job instance at 0x7f9af4d836e0>,31,17,[2 7],32,-1,50,-1,33
1,<environment.Job instance at 0x7f9af4d834b0>,33,12,[7 4],34,-1,46,-1,34
1,<environment.Job instance at 0x7f9af4d83820>,32,17,[6 4],33,-1,51,-1,34
1,<environment.Job instance at 0x7f9af4d83190>,40,14,[ 2 10],41,-1,55,-1,41
1,<environment.Job instance at 0x7f9af4d83140>,42,16,[ 3 10],43,-1,59,-1,43
1,<environment.Job instance at 0x7f9af4d83780>,43,18,[5 5],44,-1,62,-1,44
1,<environment.Job instance at 0x7f9af47d7050>,44,16,[5 5],45,-1,61,-1,45
1,<environment.Job instance at 0x7f9af47d7870>,45,17,[ 3 10],46,-1,64,-1,47
1,<environment.Job instance at 0x7f9af47d70a0>,48,18,[1 5],49,-1,67,-1,49
1,<environment.Job instance at 0x7f9af47d75a0>,49,18,[9 5],50,-1,68,-1,50
1,<environment.Job instance at 0x7f9af47d7a00>,50,19,[4 5],51,-1,70,-1,51
1,<environment.Job instance at 0x7f9af47d7460>,52,13,[9 4],53,-1,68,-1,55
1,<environment.Job instance at 0x7f9af47d74b0>,56,13,[5 5],57,-1,72,-1,59
1,<environment.Job instance at 0x7f9af476b550>,59,1,[5 4],60,-1,61,-1,60
1,<environment.Job instance at 0x7f9af476b280>,60,23,[9 4],61,-1,84,-1,61
1,<environment.Job instance at 0x7f9af476b050>,58,16,[8 3],59,-1,77,-1,61
1,<environment.Job instance at 0x7f9af476b4b0>,61,21,[8 2],62,-1,84,-1,63
1,<environment.Job instance at 0x7f9af476bfa0>,63,1,[10  1],64,-1,65,-1,64
1,<environment.Job instance at 0x7f9af476b690>,64,17,[9 2],65,-1,82,-1,65
1,<environment.Job instance at 0x7f9af476b820>,65,18,[5 5],66,-1,84,-1,66
1,<environment.Job instance at 0x7f9af476b640>,72,18,[4 7],73,-1,91,-1,73
1,<environment.Job instance at 0x7f9af476b460>,62,21,[5 7],63,-1,96,-1,75
1,<environment.Job instance at 0x7f9af476b2d0>,68,28,[10  4],69,-1,105,-1,77
1,<environment.Job instance at 0x7f9af4de25a0>,73,18,[7 1],74,-1,95,-1,77
1,<environment.Job instance at 0x7f9af476b870>,74,14,[9 1],75,-1,110,-1,96
1,<environment.Job instance at 0x7f9af4975320>,80,26,[4 9],81,-1,125,-1,99
1,<environment.Job instance at 0x7f9af4975e10>,87,23,[5 3],88,-1,124,-1,101
1,<environment.Job instance at 0x7f9af49755f0>,88,16,[9 4],89,-1,117,-1,101
1,<environment.Job instance at 0x7f9af49751e0>,91,18,[11  2],92,-1,119,-1,101
1,<environment.Job instance at 0x7f9af4975cd0>,93,24,[ 5 11],94,-1,125,-1,101
1,<environment.Job instance at 0x7f9af4de2690>,76,18,[8 3],77,-1,119,-1,101
1,<environment.Job instance at 0x7f9af49750a0>,95,14,[ 1 10],96,-1,115,-1,101
1,<environment.Job instance at 0x7f9af4de2dc0>,78,17,[12  1],79,-1,118,-1,101
1,<environment.Job instance at 0x7f9af4975500>,86,13,[9 3],87,-1,114,-1,101
1,<environment.Job instance at 0x7f9af4975be0>,82,16,[13  1],83,-1,117,-1,101
1,<environment.Job instance at 0x7f9af49bdbe0>,96,18,[7 4],97,-1,119,-1,101
1,<environment.Job instance at 0x7f9af49755a0>,94,13,[2 6],95,-1,114,-1,101
1,<environment.Job instance at 0x7f9af49bd8c0>,100,13,[11  2],101,-1,114,-1,101
1,<environment.Job instance at 0x7f9afd92a960>,101,13,[6 3],102,-1,115,-1,102
1,<environment.Job instance at 0x7f9af3fcc320>,102,14,[3 9],103,-1,117,-1,103
1,<environment.Job instance at 0x7f9af49bda50>,99,18,[6 4],100,-1,123,-1,105
1,<environment.Job instance at 0x7f9af4de6550>,104,14,[5 3],105,-1,127,-1,113
1,<environment.Job instance at 0x7f9af42e6050>,109,17,[9 2],110,-1,134,-1,117
1,<environment.Job instance at 0x7f9af42e6370>,110,14,[10  1],111,-1,132,-1,118
1,<environment.Job instance at 0x7f9af42e6eb0>,113,22,[5 2],114,-1,142,-1,120
1,<environment.Job instance at 0x7f9afd92a4b0>,107,16,[ 3 12],108,-1,138,-1,122
1,<environment.Job instance at 0x7f9af42e6fa0>,114,18,[5 6],115,-1,141,-1,123
1,<environment.Job instance at 0x7f9af43dee10>,118,12,[ 4 10],119,-1,141,-1,129
1,<environment.Job instance at 0x7f9af3ded410>,120,16,[ 2 10],121,-1,151,-1,135
1,<environment.Job instance at 0x7f9af4452410>,122,15,[5 9],123,-1,152,-1,137
1,<environment.Job instance at 0x7f9af39a3500>,125,18,[ 5 10],126,-1,155,-1,137
1,<environment.Job instance at 0x7f9af43de140>,115,17,[3 6],116,-1,155,-1,138
1,<environment.Job instance at 0x7f9af3cd8be0>,124,14,[6 4],125,-1,153,-1,139
1,<environment.Job instance at 0x7f9af4400e10>,129,12,[9 4],130,-1,151,-1,139
1,<environment.Job instance at 0x7f9af4975fa0>,92,12,[ 5 13],93,-1,151,-1,139
1,<environment.Job instance at 0x7f9af44a5d20>,137,18,[3 8],138,-1,158,-1,140
1,<environment.Job instance at 0x7f9af44a51e0>,138,16,[7 2],139,-1,156,-1,140
1,<environment.Job instance at 0x7f9af4733dc0>,141,18,[10  5],142,-1,160,-1,142
1,<environment.Job instance at 0x7f9afd886e10>,145,18,[9 2],146,-1,164,-1,146
1,<environment.Job instance at 0x7f9af48a2320>,147,20,[1 8],148,-1,168,-1,148
1,<environment.Job instance at 0x7f9af3a0e6e0>,151,21,[4 9],152,-1,173,-1,152
1,<environment.Job instance at 0x7f9af3b88a00>,126,25,[6 3],127,-1,181,-1,156
1,<environment.Job instance at 0x7f9af3a0ebe0>,153,16,[8 1],154,-1,172,-1,156
1,<environment.Job instance at 0x7f9af3a0e0a0>,156,12,[3 9],157,-1,169,-1,157
1,<environment.Job instance at 0x7f9af3d795a0>,157,20,[5 7],158,-1,178,-1,158
1,<environment.Job instance at 0x7f9af3d79140>,158,16,[4 8],159,-1,175,-1,159
1,<environment.Job instance at 0x7f9af3d796e0>,159,18,[6 1],160,-1,178,-1,160
1,<environment.Job instance at 0x7f9af3d79460>,160,15,[2 8],161,-1,178,-1,163
1,<environment.Job instance at 0x7f9af45a5910>,165,16,[10  5],166,-1,182,-1,166
1,<environment.Job instance at 0x7f9af3a082d0>,167,16,[1 7],168,-1,184,-1,168
1,<environment.Job instance at 0x7f9af44c6dc0>,169,18,[2 7],170,-1,188,-1,170
1,<environment.Job instance at 0x7f9af4508460>,170,15,[4 7],171,-1,186,-1,171
1,<environment.Job instance at 0x7f9af42ed550>,182,15,[ 2 10],183,-1,207,-1,192
1,<environment.Job instance at 0x7f9afd92a3c0>,17,27,[ 2 11],18,-1,75,-1,48
1,<environment.Job instance at 0x7f9af42e67d0>,19,3,[11  2],20,-1,51,-1,48
1,<environment.Job instance at 0x7f9af44007d0>,22,1,[12  5],23,-1,54,-1,53
1,<environment.Job instance at 0x7f9af38ca500>,60,23,[9 4],61,-1,229,-1,206
1,<environment.Job instance at 0x7f9afd7df870>,68,28,[10  4],69,-1,268,-1,240
1,<environment.Job instance at 0x7f9af3954460>,78,17,[12  1],79,-1,286,-1,269
1,<environment.Job instance at 0x7f9af3954820>,80,26,[4 9],81,-1,298,-1,272
1,<environment.Job instance at 0x7f9af39543c0>,82,16,[13  1],83,-1,288,-1,272
1,<environment.Job instance at 0x7f9af3c19e10>,87,23,[5 3],88,-1,310,-1,287
1,<environment.Job instance at 0x7f9af3c19cd0>,91,18,[11  2],92,-1,320,-1,302
1,<environment.Job instance at 0x7f9af3c199b0>,92,12,[ 5 13],93,-1,314,-1,302
1,<environment.Job instance at 0x7f9af3c19500>,93,24,[ 5 11],94,-1,326,-1,302
1,<environment.Job instance at 0x7f9af3c42500>,100,13,[11  2],101,-1,357,-1,344
1,<environment.Job instance at 0x7f9af3c3ae10>,107,16,[ 3 12],108,-1,389,-1,373
1,<environment.Job instance at 0x7f9af3edecd0>,126,25,[6 3],127,-1,485,-1,460
1,<environment.Job instance at 0x7f9af46f8d70>,133,2,[14  3],134,-1,480,-1,478
1,<environment.Job instance at 0x7f9af46f8e10>,134,1,[14  5],135,-1,479,-1,478
1,<environment.Job instance at 0x7f9af40d4b40>,143,1,[12  4],144,-1,501,-1,500
1,<environment.Job instance at 0x7f9af49bde60>,150,2,[ 2 12],151,-1,529,-1,527
1,<environment.Job instance at 0x7f9af49bdc80>,155,23,[8 4],156,-1,575,-1,552
1,<environment.Job instance at 0x7f9af4d4cbe0>,164,15,[11  1],165,-1,602,-1,587
1,<environment.Job instance at 0x7f9af37ad410>,1,18,[3 8],2,-1,20,-1,2
1,<environment.Job instance at 0x7f9af37ad2d0>,3,14,[ 4 10],4,-1,18,-1,4
1,<environment.Job instance at 0x7f9af4694460>,6,16,[1 6],7,-1,23,-1,7
1,<environment.Job instance at 0x7f9af39a3410>,9,17,[ 1 10],10,-1,27,-1,10
1,<environment.Job instance at 0x7f9af39a31e0>,11,28,[5 1],12,-1,40,-1,12
1,<environment.Job instance at 0x7f9af39a37d0>,17,13,[9 1],18,-1,31,-1,18
1,<environment.Job instance at 0x7f9af4872820>,15,15,[3 5],16,-1,33,-1,18
1,<environment.Job instance at 0x7f9af474acd0>,23,23,[7 4],24,-1,47,-1,24
1,<environment.Job instance at 0x7f9af474a4b0>,25,12,[2 8],26,-1,38,-1,26
1,<environment.Job instance at 0x7f9af474a140>,26,12,[9 5],27,-1,39,-1,27
1,<environment.Job instance at 0x7f9af474a280>,27,17,[10  4],28,-1,45,-1,28
1,<environment.Job instance at 0x7f9af474a730>,35,18,[7 5],36,-1,77,-1,59
1,<environment.Job instance at 0x7f9af3fcc050>,48,18,[5 8],49,-1,82,-1,64
1,<environment.Job instance at 0x7f9afd92af00>,36,27,[5 2],37,-1,91,-1,64
1,<environment.Job instance at 0x7f9afd92a2d0>,39,18,[ 2 10],40,-1,82,-1,64
1,<environment.Job instance at 0x7f9af3fccc80>,47,15,[5 8],48,-1,79,-1,64
1,<environment.Job instance at 0x7f9af3bcec30>,54,28,[4 5],55,-1,92,-1,64
1,<environment.Job instance at 0x7f9af3bcee60>,53,14,[ 5 10],54,-1,82,-1,68
1,<environment.Job instance at 0x7f9af3bce9b0>,56,17,[3 5],57,-1,87,-1,70
1,<environment.Job instance at 0x7f9af3bce280>,60,13,[5 6],61,-1,83,-1,70
1,<environment.Job instance at 0x7f9af3bce0a0>,61,25,[10  1],62,-1,95,-1,70
1,<environment.Job instance at 0x7f9af3bce140>,62,12,[10  4],63,-1,82,-1,70
1,<environment.Job instance at 0x7f9af3bcec80>,64,13,[ 5 10],65,-1,88,-1,75
1,<environment.Job instance at 0x7f9af3bceb40>,58,15,[5 8],59,-1,90,-1,75
1,<environment.Job instance at 0x7f9af474a5f0>,29,15,[2 6],30,-1,92,-1,77
1,<environment.Job instance at 0x7f9af474aaf0>,22,13,[9 1],23,-1,90,-1,77
1,<environment.Job instance at 0x7f9af3d79e10>,73,17,[5 9],74,-1,101,-1,84
1,<environment.Job instance at 0x7f9af3d792d0>,68,18,[5 5],69,-1,102,-1,84
1,<environment.Job instance at 0x7f9af477e370>,75,21,[9 3],76,-1,105,-1,84
1,<environment.Job instance at 0x7f9af4676230>,79,14,[5 4],80,-1,99,-1,85
1,<environment.Job instance at 0x7f9af4676d20>,82,16,[9 4],83,-1,112,-1,96
1,<environment.Job instance at 0x7f9af4676820>,84,17,[1 9],85,-1,115,-1,98
1,<environment.Job instance at 0x7f9af3d79a00>,70,16,[7 5],71,-1,119,-1,103
1,<environment.Job instance at 0x7f9af4676b40>,86,18,[8 1],87,-1,121,-1,103
1,<environment.Job instance at 0x7f9af3f487d0>,91,13,[7 4],92,-1,116,-1,103
1,<environment.Job instance at 0x7f9af3f48410>,92,18,[ 2 12],93,-1,121,-1,103
1,<environment.Job instance at 0x7f9af3f48820>,94,18,[5 5],95,-1,124,-1,106
1,<environment.Job instance at 0x7f9af477e5f0>,76,15,[3 5],77,-1,121,-1,106
1,<environment.Job instance at 0x7f9af3f48cd0>,95,3,[7 5],96,-1,109,-1,106
1,<environment.Job instance at 0x7f9af3f48870>,97,12,[2 8],98,-1,118,-1,106
1,<environment.Job instance at 0x7f9af3f48500>,98,18,[5 3],99,-1,125,-1,107
1,<environment.Job instance at 0x7f9af3f485f0>,99,12,[4 6],100,-1,119,-1,107
1,<environment.Job instance at 0x7f9af45089b0>,100,13,[2 6],101,-1,120,-1,107
1,<environment.Job instance at 0x7f9af4508f50>,101,13,[10  4],102,-1,120,-1,107
1,<environment.Job instance at 0x7f9af477e4b0>,77,25,[9 4],78,-1,132,-1,107
1,<environment.Job instance at 0x7f9af4508910>,102,15,[8 4],103,-1,122,-1,107
1,<environment.Job instance at 0x7f9af4508410>,103,24,[5 3],104,-1,132,-1,108
1,<environment.Job instance at 0x7f9af4676870>,83,12,[10  1],84,-1,120,-1,108
1,<environment.Job instance at 0x7f9af49926e0>,104,15,[5 6],105,-1,124,-1,109
1,<environment.Job instance at 0x7f9af3a547d0>,105,1,[5 9],106,-1,110,-1,109
1,<environment.Job instance at 0x7f9af4424190>,106,17,[2 5],107,-1,126,-1,109
1,<environment.Job instance at 0x7f9af4424690>,107,2,[11  4],108,-1,111,-1,109
1,<environment.Job instance at 0x7f9af4424dc0>,108,12,[9 3],109,-1,121,-1,109
1,<environment.Job instance at 0x7f9af3f48190>,96,17,[2 6],97,-1,126,-1,109
1,<environment.Job instance at 0x7f9af4600d20>,109,13,[6 4],110,-1,125,-1,112
1,<environment.Job instance at 0x7f9af3ba3190>,111,28,[9 4],112,-1,141,-1,113
1,<environment.Job instance at 0x7f9af36c9820>,113,16,[ 1 12],114,-1,131,-1,115
1,<environment.Job instance at 0x7f9af3a3d050>,115,15,[3 9],116,-1,133,-1,118
1,<environment.Job instance at 0x7f9af3bce320>,65,15,[8 1],66,-1,133,-1,118
1,<environment.Job instance at 0x7f9af3b967d0>,118,19,[ 3 11],119,-1,138,-1,119
1,<environment.Job instance at 0x7f9af3f48690>,89,28,[6 1],90,-1,147,-1,119
1,<environment.Job instance at 0x7f9af3b96aa0>,119,18,[7 5],120,-1,138,-1,120
1,<environment.Job instance at 0x7f9af367aaf0>,126,21,[5 5],127,-1,148,-1,127
1,<environment.Job instance at 0x7f9af3ada820>,130,12,[7 4],131,-1,147,-1,135
1,<environment.Job instance at 0x7f9af3b965a0>,117,17,[1 9],118,-1,152,-1,135
1,<environment.Job instance at 0x7f9af359b690>,133,15,[3 9],134,-1,150,-1,135
1,<environment.Job instance at 0x7f9af35fea50>,132,3,[8 1],133,-1,138,-1,135
1,<environment.Job instance at 0x7f9af35fec80>,131,1,[4 5],132,-1,136,-1,135
1,<environment.Job instance at 0x7f9afd3f8a00>,134,16,[7 4],135,-1,151,-1,135
1,<environment.Job instance at 0x7f9af477e460>,8,2,[ 1 13],9,-1,11,-1,9
1,<environment.Job instance at 0x7f9af3540d20>,10,28,[ 2 14],11,-1,48,-1,20
1,<environment.Job instance at 0x7f9af3540a50>,11,28,[5 1],12,-1,48,-1,20
1,<environment.Job instance at 0x7f9af3c42050>,23,23,[7 4],24,-1,85,-1,62
1,<environment.Job instance at 0x7f9af3c42370>,28,18,[13  5],29,-1,89,-1,71
1,<environment.Job instance at 0x7f9af4975640>,33,3,[13  5],34,-1,92,-1,89
1,<environment.Job instance at 0x7f9af38cac30>,36,27,[5 2],37,-1,129,-1,102
1,<environment.Job instance at 0x7f9af47d7640>,37,14,[ 3 14],38,-1,116,-1,102
1,<environment.Job instance at 0x7f9af3bf3eb0>,54,28,[4 5],55,-1,198,-1,170
1,<environment.Job instance at 0x7f9af3bd7500>,57,2,[ 5 13],58,-1,173,-1,171
1,<environment.Job instance at 0x7f9af3bd7fa0>,61,25,[10  1],62,-1,210,-1,185
1,<environment.Job instance at 0x7f9af3ffef00>,77,25,[9 4],78,-1,286,-1,261
1,<environment.Job instance at 0x7f9af3a82d70>,89,28,[6 1],90,-1,341,-1,313
1,<environment.Job instance at 0x7f9af499c690>,92,18,[ 2 12],93,-1,331,-1,313
1,<environment.Job instance at 0x7f9af368daa0>,103,24,[5 3],104,-1,385,-1,361
1,<environment.Job instance at 0x7f9af443a870>,107,2,[11  4],108,-1,364,-1,362
1,<environment.Job instance at 0x7f9af363d550>,111,28,[9 4],112,-1,411,-1,383
1,<environment.Job instance at 0x7f9af3bd8a00>,113,16,[ 1 12],114,-1,399,-1,383
1,<environment.Job instance at 0x7f9af35da320>,118,19,[ 3 11],119,-1,417,-1,398
1,<environment.Job instance at 0x7f9af3644320>,137,13,[14  4],138,-1,497,-1,484
1,<environment.Job instance at 0x7f9af3677cd0>,153,2,[13  2],154,-1,554,-1,552
1,<environment.Job instance at 0x7f9af3603c30>,155,25,[1 6],156,-1,591,-1,566
1,<environment.Job instance at 0x7f9af3ab0aa0>,160,27,[11  2],161,-1,597,-1,570
1,<environment.Job instance at 0x7f9afd8099b0>,165,24,[8 3],166,-1,613,-1,589
1,<environment.Job instance at 0x7f9af35a54b0>,177,24,[5 9],178,-1,663,-1,639
1,<environment.Job instance at 0x7f9afd34c500>,0,20,[9 3],1,-1,22,-1,2
1,<environment.Job instance at 0x7f9afd34c1e0>,1,15,[8 4],2,-1,17,-1,2
1,<environment.Job instance at 0x7f9afd34c5a0>,2,14,[9 2],3,-1,18,-1,4
1,<environment.Job instance at 0x7f9afd34c9b0>,5,17,[5 3],6,-1,23,-1,6
1,<environment.Job instance at 0x7f9afd34cbe0>,6,12,[2 7],7,-1,19,-1,7
1,<environment.Job instance at 0x7f9afd34c780>,8,26,[8 2],9,-1,35,-1,9
1,<environment.Job instance at 0x7f9afd34ce60>,10,13,[4 6],11,-1,24,-1,11
1,<environment.Job instance at 0x7f9afd34cb40>,12,16,[9 2],13,-1,29,-1,13
1,<environment.Job instance at 0x7f9afd34caa0>,13,18,[4 6],14,-1,32,-1,14
1,<environment.Job instance at 0x7f9afd34c6e0>,14,13,[2 8],15,-1,28,-1,15
1,<environment.Job instance at 0x7f9afd34c820>,16,17,[3 7],17,-1,34,-1,17
1,<environment.Job instance at 0x7f9afd34ceb0>,3,16,[2 6],4,-1,35,-1,19
1,<environment.Job instance at 0x7f9afd34c550>,19,17,[5 7],20,-1,37,-1,20
1,<environment.Job instance at 0x7f9af412c370>,22,18,[7 4],23,-1,42,-1,24
1,<environment.Job instance at 0x7f9af412c500>,29,15,[3 9],30,-1,45,-1,30
1,<environment.Job instance at 0x7f9af412ca50>,23,14,[ 2 10],24,-1,46,-1,32
1,<environment.Job instance at 0x7f9af4bbe8c0>,33,16,[3 8],34,-1,51,-1,35
1,<environment.Job instance at 0x7f9af412c3c0>,34,13,[10  5],35,-1,49,-1,36
1,<environment.Job instance at 0x7f9af47fb640>,46,17,[ 5 11],47,-1,65,-1,48
1,<environment.Job instance at 0x7f9afd34cdc0>,7,1,[ 1 13],8,-1,21,-1,20
1,<environment.Job instance at 0x7f9afd34c320>,8,26,[8 2],9,-1,47,-1,21
1,<environment.Job instance at 0x7f9af3681dc0>,15,25,[ 3 14],16,-1,59,-1,34
1,<environment.Job instance at 0x7f9af367e7d0>,21,3,[ 4 13],22,-1,57,-1,54
1,<environment.Job instance at 0x7f9af3680c80>,24,27,[13  3],25,-1,91,-1,64
1,<environment.Job instance at 0x7f9af37372d0>,44,27,[6 1],45,-1,181,-1,154
1,<environment.Job instance at 0x7f9af490bf50>,46,17,[ 5 11],47,-1,171,-1,154
1,<environment.Job instance at 0x7f9af4263c30>,51,24,[14  3],52,-1,193,-1,169
1,<environment.Job instance at 0x7f9af3a820f0>,53,24,[10  2],54,-1,209,-1,185
1,<environment.Job instance at 0x7f9af3ba1dc0>,70,13,[12  1],71,-1,248,-1,235
1,<environment.Job instance at 0x7f9af3bdb410>,71,16,[ 5 11],72,-1,251,-1,235
1,<environment.Job instance at 0x7f9af3bf3eb0>,75,27,[4 5],76,-1,279,-1,252
1,<environment.Job instance at 0x7f9af3bc48c0>,76,1,[12  2],77,-1,253,-1,252
1,<environment.Job instance at 0x7f9af4d33d70>,86,25,[7 3],87,-1,315,-1,290
1,<environment.Job instance at 0x7f9af3aa4b40>,90,26,[6 4],91,-1,328,-1,302
1,<environment.Job instance at 0x7f9af443ca00>,124,1,[13  5],125,-1,405,-1,404
1,<environment.Job instance at 0x7f9af43376e0>,130,25,[5 3],131,-1,451,-1,426
1,<environment.Job instance at 0x7f9af4337140>,131,16,[11  2],132,-1,442,-1,426
1,<environment.Job instance at 0x7f9af38209b0>,139,28,[3 9],140,-1,490,-1,462
1,<environment.Job instance at 0x7f9af3820960>,142,23,[3 7],143,-1,486,-1,463
1,<environment.Job instance at 0x7f9af4223dc0>,146,3,[ 5 14],147,-1,471,-1,468
1,<environment.Job instance at 0x7f9af43fca00>,157,16,[11  1],158,-1,522,-1,506
1,<environment.Job instance at 0x7f9af48f72d0>,167,16,[ 5 13],168,-1,567,-1,551
1,<environment.Job instance at 0x7f9af48cd6e0>,169,2,[13  4],170,-1,568,-1,566
1,<environment.Job instance at 0x7f9af443b9b0>,174,2,[ 5 11],182,-1,570,-1,568
1,<environment.Job instance at 0x7f9af4cf12d0>,1,16,[4 6],2,-1,18,-1,2
1,<environment.Job instance at 0x7f9af38e6870>,7,15,[10  4],8,-1,24,-1,9
1,<environment.Job instance at 0x7f9af38e6b90>,12,14,[3 7],13,-1,27,-1,13
1,<environment.Job instance at 0x7f9af38e6d20>,14,1,[4 8],15,-1,16,-1,15
1,<environment.Job instance at 0x7f9af38e6e10>,15,13,[5 4],16,-1,29,-1,16
1,<environment.Job instance at 0x7f9af38e6dc0>,16,27,[2 9],17,-1,44,-1,17
1,<environment.Job instance at 0x7f9af4407cd0>,8,16,[ 5 10],9,-1,33,-1,17
1,<environment.Job instance at 0x7f9af38e6fa0>,18,18,[ 5 10],19,-1,38,-1,20
1,<environment.Job instance at 0x7f9af3f42190>,19,18,[10  2],20,-1,38,-1,20
1,<environment.Job instance at 0x7f9af3f420a0>,22,22,[8 1],23,-1,46,-1,24
1,<environment.Job instance at 0x7f9af3f42550>,23,14,[14  4],24,-1,38,-1,24
1,<environment.Job instance at 0x7f9af3f42370>,26,2,[14  2],27,-1,29,-1,27
1,<environment.Job instance at 0x7f9af3f42910>,27,15,[ 5 12],28,-1,43,-1,28
1,<environment.Job instance at 0x7f9af3f426e0>,28,16,[9 1],29,-1,45,-1,29
1,<environment.Job instance at 0x7f9af3f42c80>,31,27,[8 5],32,-1,59,-1,32
1,<environment.Job instance at 0x7f9af3f42fa0>,34,16,[11  4],35,-1,51,-1,35
1,<environment.Job instance at 0x7f9af3f3b140>,35,14,[1 7],36,-1,50,-1,36
1,<environment.Job instance at 0x7f9af3f3b1e0>,37,18,[1 9],38,-1,56,-1,38
1,<environment.Job instance at 0x7f9af3f3b370>,42,18,[10  5],43,-1,61,-1,43
1,<environment.Job instance at 0x7f9af3f3b550>,43,26,[7 1],44,-1,70,-1,44
1,<environment.Job instance at 0x7f9af3f3b820>,44,17,[10  5],45,-1,62,-1,45
1,<environment.Job instance at 0x7f9af3f3b8c0>,45,18,[5 6],46,-1,64,-1,46
1,<environment.Job instance at 0x7f9af3f3ba00>,47,15,[ 4 10],48,-1,64,-1,49
1,<environment.Job instance at 0x7f9af3f3bf50>,52,18,[9 1],53,-1,72,-1,54
1,<environment.Job instance at 0x7f9af3f30320>,54,15,[2 7],55,-1,70,-1,55
1,<environment.Job instance at 0x7f9af3f30190>,56,13,[1 6],57,-1,74,-1,61
1,<environment.Job instance at 0x7f9af3f30e10>,68,15,[3 8],69,-1,84,-1,69
1,<environment.Job instance at 0x7f9af3f2a140>,69,25,[3 6],70,-1,95,-1,70
1,<environment.Job instance at 0x7f9af3f3b640>,41,14,[ 2 12],42,-1,86,-1,72
1,<environment.Job instance at 0x7f9af3f2a1e0>,71,16,[ 5 12],72,-1,88,-1,72
1,<environment.Job instance at 0x7f9af3f2a5a0>,73,17,[13  5],74,-1,91,-1,74
1,<environment.Job instance at 0x7f9af3f2a410>,74,17,[8 5],75,-1,92,-1,75
1,<environment.Job instance at 0x7f9af3f2a0f0>,75,17,[1 7],76,-1,93,-1,76
1,<environment.Job instance at 0x7f9af3f3be10>,53,13,[3 9],54,-1,89,-1,76
1,<environment.Job instance at 0x7f9af3f305f0>,59,12,[5 8],60,-1,90,-1,78
1,<environment.Job instance at 0x7f9af3f2a640>,77,2,[5 2],78,-1,84,-1,82
1,<environment.Job instance at 0x7f9af3f2a7d0>,78,13,[10  4],79,-1,95,-1,82
1,<environment.Job instance at 0x7f9af3f2a870>,76,16,[1 5],77,-1,98,-1,82
1,<environment.Job instance at 0x7f9af3f2ad70>,84,18,[ 4 10],85,-1,103,-1,85
1,<environment.Job instance at 0x7f9af3f2adc0>,86,15,[ 3 10],87,-1,104,-1,89
1,<environment.Job instance at 0x7f9af3f2a6e0>,79,19,[2 5],80,-1,117,-1,98
1,<environment.Job instance at 0x7f9af3f2aa00>,81,12,[7 2],82,-1,110,-1,98
1,<environment.Job instance at 0x7f9af3f1bc80>,93,18,[9 2],94,-1,117,-1,99
1,<environment.Job instance at 0x7f9af3f1b910>,96,16,[5 9],97,-1,115,-1,99
1,<environment.Job instance at 0x7f9af3f1b870>,98,24,[5 6],99,-1,125,-1,101
1,<environment.Job instance at 0x7f9af3f1ba50>,101,17,[5 8],102,-1,119,-1,102
1,<environment.Job instance at 0x7f9af3f1bd20>,102,14,[14  5],103,-1,117,-1,103
1,<environment.Job instance at 0x7f9afd34c640>,104,16,[8 2],105,-1,123,-1,107
1,<environment.Job instance at 0x7f9af38f55f0>,106,14,[4 7],107,-1,121,-1,107
1,<environment.Job instance at 0x7f9afd3afb40>,103,14,[3 6],104,-1,121,-1,107
1,<environment.Job instance at 0x7f9af3f1b370>,94,15,[6 2],95,-1,123,-1,108
1,<environment.Job instance at 0x7f9af4221140>,105,1,[4 9],106,-1,109,-1,108
1,<environment.Job instance at 0x7f9af38f5550>,108,12,[10  3],109,-1,121,-1,109
1,<environment.Job instance at 0x7f9af38f5460>,109,13,[10  4],110,-1,123,-1,110
1,<environment.Job instance at 0x7f9af38f5280>,110,20,[ 4 10],111,-1,131,-1,111
1,<environment.Job instance at 0x7f9af42354b0>,112,16,[6 1],113,-1,131,-1,115
1,<environment.Job instance at 0x7f9af3f308c0>,62,18,[1 9],63,-1,134,-1,116
1,<environment.Job instance at 0x7f9af4226d20>,116,24,[4 5],117,-1,141,-1,117
1,<environment.Job instance at 0x7f9af38c4f50>,117,24,[4 8],118,-1,142,-1,118
1,<environment.Job instance at 0x7f9af38df3c0>,120,2,[3 5],121,-1,123,-1,121
1,<environment.Job instance at 0x7f9af38dfe60>,121,12,[3 5],122,-1,134,-1,122
1,<environment.Job instance at 0x7f9af38df5f0>,122,2,[1 9],123,-1,125,-1,123
1,<environment.Job instance at 0x7f9af3f29320>,126,16,[4 9],127,-1,143,-1,127
1,<environment.Job instance at 0x7f9af3f294b0>,127,18,[6 1],128,-1,146,-1,128
1,<environment.Job instance at 0x7f9af3f291e0>,128,14,[5 4],129,-1,143,-1,129
1,<environment.Job instance at 0x7f9af3f29550>,129,15,[6 4],130,-1,145,-1,130
1,<environment.Job instance at 0x7f9af3f29870>,132,23,[6 2],133,-1,156,-1,133
1,<environment.Job instance at 0x7f9af3f29c80>,136,17,[1 6],137,-1,154,-1,137
1,<environment.Job instance at 0x7f9af3f29b40>,137,13,[9 4],138,-1,151,-1,138
1,<environment.Job instance at 0x7f9af3f2b2d0>,142,18,[6 5],143,-1,161,-1,143
1,<environment.Job instance at 0x7f9af3f2b0a0>,144,14,[ 5 10],145,-1,159,-1,145
1,<environment.Job instance at 0x7f9af3f2b460>,146,16,[4 8],147,-1,163,-1,147
1,<environment.Job instance at 0x7f9af3f2be10>,155,14,[3 8],156,-1,181,-1,167
1,<environment.Job instance at 0x7f9af3f2beb0>,156,17,[4 6],157,-1,184,-1,167
1,<environment.Job instance at 0x7f9af3f2b960>,150,1,[7 5],151,-1,168,-1,167
1,<environment.Job instance at 0x7f9af3f2bd20>,158,18,[10  1],159,-1,185,-1,167
1,<environment.Job instance at 0x7f9af3f1a230>,160,15,[4 7],161,-1,182,-1,167
1,<environment.Job instance at 0x7f9af3f1a3c0>,162,17,[ 1 10],163,-1,184,-1,167
1,<environment.Job instance at 0x7f9af3f1a410>,163,15,[8 4],164,-1,182,-1,167
1,<environment.Job instance at 0x7f9af3f1a550>,165,24,[5 2],166,-1,203,-1,179
1,<environment.Job instance at 0x7f9af3f1aa00>,170,25,[6 2],171,-1,206,-1,181
1,<environment.Job instance at 0x7f9af3f2b820>,148,15,[1 6],149,-1,200,-1,185
1,<environment.Job instance at 0x7f9af3f1aaa0>,171,17,[9 4],172,-1,202,-1,185
1,<environment.Job instance at 0x7f9af3f1ad20>,175,14,[4 8],176,-1,199,-1,185
1,<environment.Job instance at 0x7f9af3f1adc0>,176,12,[9 1],177,-1,197,-1,185
1,<environment.Job instance at 0x7f9af3f1af00>,178,18,[10  4],179,-1,203,-1,185
1,<environment.Job instance at 0x7f9af3f1a8c0>,179,13,[ 1 11],180,-1,198,-1,185
1,<environment.Job instance at 0x7f9af3f17280>,180,25,[5 5],181,-1,210,-1,185
1,<environment.Job instance at 0x7f9af3f17500>,181,13,[9 3],182,-1,198,-1,185
1,<environment.Job instance at 0x7f9af3f17a50>,185,19,[2 8],186,-1,208,-1,189
1,<environment.Job instance at 0x7f9af3f17aa0>,186,16,[ 1 10],187,-1,205,-1,189
1,<environment.Job instance at 0x7f9af3f30910>,6,16,[13  1],7,-1,23,-1,7
1,<environment.Job instance at 0x7f9af38f75f0>,16,27,[2 9],17,-1,52,-1,25
1,<environment.Job instance at 0x7f9af3f29e60>,23,14,[14  4],24,-1,70,-1,56
1,<environment.Job instance at 0x7f9af3f1a780>,25,3,[ 1 13],26,-1,59,-1,56
1,<environment.Job instance at 0x7f9af3f2bc80>,26,2,[14  2],27,-1,58,-1,56
1,<environment.Job instance at 0x7f9af3f2b320>,27,15,[ 5 12],28,-1,71,-1,56
1,<environment.Job instance at 0x7f9af38e6320>,30,2,[14  4],31,-1,67,-1,65
1,<environment.Job instance at 0x7f9af38e6460>,31,27,[8 5],32,-1,99,-1,72
1,<environment.Job instance at 0x7f9af4dd8aa0>,34,16,[11  4],35,-1,90,-1,74
1,<environment.Job instance at 0x7f9af42a4460>,38,16,[13  2],39,-1,94,-1,78
1,<environment.Job instance at 0x7f9af48f72d0>,41,14,[ 2 12],42,-1,106,-1,92
1,<environment.Job instance at 0x7f9af4584a50>,43,26,[7 1],44,-1,135,-1,109
1,<environment.Job instance at 0x7f9af3820960>,69,25,[3 6],70,-1,232,-1,207
1,<environment.Job instance at 0x7f9af39b6960>,71,16,[ 5 12],72,-1,223,-1,207
1,<environment.Job instance at 0x7f9af39b6a00>,73,17,[13  5],74,-1,237,-1,220
1,<environment.Job instance at 0x7f9af445cf00>,85,2,[ 3 11],86,-1,260,-1,258
1,<environment.Job instance at 0x7f9af3ccff00>,92,3,[ 4 11],93,-1,294,-1,291
1,<environment.Job instance at 0x7f9af3d25870>,98,24,[5 6],99,-1,345,-1,321
1,<environment.Job instance at 0x7f9af359d1e0>,100,3,[ 3 12],101,-1,324,-1,321
1,<environment.Job instance at 0x7f9af4317b40>,102,14,[14  5],103,-1,335,-1,321
1,<environment.Job instance at 0x7f9af45a4f00>,116,24,[4 5],117,-1,408,-1,384
1,<environment.Job instance at 0x7f9af47d7be0>,117,24,[4 8],118,-1,410,-1,386
1,<environment.Job instance at 0x7f9af3ba1c30>,132,23,[6 2],133,-1,447,-1,424
1,<environment.Job instance at 0x7f9af3ba18c0>,134,3,[ 1 12],135,-1,427,-1,424
1,<environment.Job instance at 0x7f9af4422320>,135,14,[12  1],136,-1,438,-1,424
1,<environment.Job instance at 0x7f9af3ffef00>,143,1,[11  3],144,-1,446,-1,445
1,<environment.Job instance at 0x7f9af3a82d70>,145,28,[ 4 12],146,-1,475,-1,447
1,<environment.Job instance at 0x7f9af3ff9cd0>,149,1,[ 4 13],150,-1,475,-1,474
1,<environment.Job instance at 0x7f9af36cd910>,153,14,[ 2 11],154,-1,503,-1,489
1,<environment.Job instance at 0x7f9af35da050>,165,24,[5 2],166,-1,566,-1,542
1,<environment.Job instance at 0x7f9af38cc0f0>,170,25,[6 2],171,-1,580,-1,555
1,<environment.Job instance at 0x7f9af35f8cd0>,179,13,[ 1 11],180,-1,588,-1,575
1,<environment.Job instance at 0x7f9af35f88c0>,180,25,[5 5],181,-1,612,-1,587
1,<environment.Job instance at 0x7f9af3603870>,183,3,[ 4 11],184,-1,591,-1,588
1,<environment.Job instance at 0x7f9af41d8b40>,1,17,[ 2 10],2,-1,20,-1,3
1,<environment.Job instance at 0x7f9af368af00>,3,12,[3 9],4,-1,16,-1,4
1,<environment.Job instance at 0x7f9af3eb09b0>,5,18,[4 6],6,-1,24,-1,6
1,<environment.Job instance at 0x7f9af3eb0be0>,6,15,[5 9],7,-1,22,-1,7
1,<environment.Job instance at 0x7f9af389a4b0>,2,16,[2 8],3,-1,23,-1,7
1,<environment.Job instance at 0x7f9af384e3c0>,9,17,[ 1 10],10,-1,28,-1,11
1,<environment.Job instance at 0x7f9af41c51e0>,11,12,[8 1],12,-1,24,-1,12
1,<environment.Job instance at 0x7f9af41cb9b0>,14,19,[ 5 10],15,-1,34,-1,15
1,<environment.Job instance at 0x7f9af41cbaf0>,16,15,[3 9],17,-1,32,-1,17
1,<environment.Job instance at 0x7f9af3c17780>,17,27,[8 5],18,-1,45,-1,18
1,<environment.Job instance at 0x7f9af3c17d70>,20,13,[8 3],21,-1,34,-1,21
1,<environment.Job instance at 0x7f9af368a6e0>,10,15,[8 4],11,-1,37,-1,22
1,<environment.Job instance at 0x7f9af38f5c30>,25,15,[10  1],26,-1,43,-1,28
1,<environment.Job instance at 0x7f9af38c5690>,30,20,[8 5],31,-1,51,-1,31
1,<environment.Job instance at 0x7f9af41c3d70>,34,16,[5 8],35,-1,51,-1,35
1,<environment.Job instance at 0x7f9af38c5eb0>,35,25,[4 5],36,-1,61,-1,36
1,<environment.Job instance at 0x7f9af41cdfa0>,40,18,[3 5],41,-1,59,-1,41
1,<environment.Job instance at 0x7f9af41cdc80>,41,15,[3 7],42,-1,57,-1,42
1,<environment.Job instance at 0x7f9af4951410>,57,26,[ 3 10],58,-1,84,-1,58
1,<environment.Job instance at 0x7f9af47d40a0>,52,18,[4 8],53,-1,88,-1,70
1,<environment.Job instance at 0x7f9af49b6780>,58,12,[10  4],59,-1,82,-1,70
1,<environment.Job instance at 0x7f9af49e7cd0>,61,3,[12  2],62,-1,73,-1,70
1,<environment.Job instance at 0x7f9af49e2f00>,54,1,[12  5],55,-1,71,-1,70
1,<environment.Job instance at 0x7f9af49e2780>,53,15,[ 2 10],54,-1,85,-1,70
1,<environment.Job instance at 0x7f9af49e7fa0>,62,1,[2 6],63,-1,71,-1,70
1,<environment.Job instance at 0x7f9af42936e0>,66,2,[5 9],67,-1,72,-1,70
1,<environment.Job instance at 0x7f9af44b4500>,67,2,[5 8],68,-1,72,-1,70
1,<environment.Job instance at 0x7f9af37ec0f0>,68,3,[6 2],69,-1,73,-1,70
1,<environment.Job instance at 0x7f9af4d5ff00>,69,2,[10  1],70,-1,72,-1,70
1,<environment.Job instance at 0x7f9af4d5fc80>,70,12,[2 5],71,-1,83,-1,71
1,<environment.Job instance at 0x7f9af4d5f820>,71,17,[7 4],72,-1,89,-1,72
1,<environment.Job instance at 0x7f9af4291780>,73,14,[ 5 10],74,-1,88,-1,74
1,<environment.Job instance at 0x7f9af42917d0>,76,16,[3 8],77,-1,93,-1,77
1,<environment.Job instance at 0x7f9af4291370>,80,15,[5 5],81,-1,114,-1,99
1,<environment.Job instance at 0x7f9af4d6daf0>,91,17,[9 4],92,-1,117,-1,100
1,<environment.Job instance at 0x7f9af4d646e0>,90,18,[9 3],91,-1,118,-1,100
1,<environment.Job instance at 0x7f9af4d6d3c0>,93,14,[14  1],94,-1,116,-1,102
1,<environment.Job instance at 0x7f9af492ef00>,82,17,[5 7],83,-1,119,-1,102
1,<environment.Job instance at 0x7f9af42a6870>,97,14,[5 6],98,-1,116,-1,102
1,<environment.Job instance at 0x7f9af4937b90>,99,17,[5 6],100,-1,119,-1,102
1,<environment.Job instance at 0x7f9af42a3e10>,98,16,[8 4],99,-1,118,-1,102
1,<environment.Job instance at 0x7f9af4937aa0>,100,15,[3 7],101,-1,118,-1,103
1,<environment.Job instance at 0x7f9af4d630a0>,102,17,[ 5 14],103,-1,125,-1,108
1,<environment.Job instance at 0x7f9af4d63a00>,106,15,[4 6],107,-1,126,-1,111
1,<environment.Job instance at 0x7f9af4d5d7d0>,110,12,[3 8],111,-1,123,-1,111
1,<environment.Job instance at 0x7f9af4d63960>,104,13,[10  1],105,-1,125,-1,112
1,<environment.Job instance at 0x7f9af4d5d5a0>,111,18,[7 1],112,-1,131,-1,113
1,<environment.Job instance at 0x7f9af4d5d820>,113,15,[ 2 12],114,-1,134,-1,119
1,<environment.Job instance at 0x7f9af42a6820>,96,17,[4 8],97,-1,138,-1,121
1,<environment.Job instance at 0x7f9af4d63dc0>,107,13,[7 1],108,-1,136,-1,123
1,<environment.Job instance at 0x7f9af4d449b0>,122,17,[1 5],123,-1,140,-1,123
1,<environment.Job instance at 0x7f9af4d44fa0>,121,26,[7 2],122,-1,149,-1,123
1,<environment.Job instance at 0x7f9af4d44c80>,124,18,[4 8],125,-1,147,-1,129
1,<environment.Job instance at 0x7f9af4d5daa0>,115,16,[3 5],116,-1,159,-1,143
1,<environment.Job instance at 0x7f9af4d44a00>,128,15,[10  2],129,-1,158,-1,143
1,<environment.Job instance at 0x7f9af4d44460>,131,23,[5 9],132,-1,166,-1,143
1,<environment.Job instance at 0x7f9af4d44370>,132,14,[5 2],133,-1,157,-1,143
1,<environment.Job instance at 0x7f9af4d46870>,137,22,[2 9],138,-1,169,-1,147
1,<environment.Job instance at 0x7f9af4d44af0>,129,13,[4 7],130,-1,160,-1,147
1,<environment.Job instance at 0x7f9af4d44aa0>,127,15,[6 1],128,-1,162,-1,147
1,<environment.Job instance at 0x7f9af4d46960>,140,13,[5 8],141,-1,161,-1,148
1,<environment.Job instance at 0x7f9af4d46af0>,143,15,[ 3 10],144,-1,163,-1,148
1,<environment.Job instance at 0x7f9af4d462d0>,141,16,[5 2],142,-1,164,-1,148
1,<environment.Job instance at 0x7f9af4d46370>,145,14,[7 5],146,-1,162,-1,148
1,<environment.Job instance at 0x7f9af4d70c30>,146,20,[8 2],147,-1,168,-1,148
1,<environment.Job instance at 0x7f9af4d70050>,147,16,[8 4],148,-1,164,-1,148
1,<environment.Job instance at 0x7f9af4d702d0>,148,26,[2 5],149,-1,175,-1,149
1,<environment.Job instance at 0x7f9af4d70500>,150,15,[10  5],151,-1,166,-1,151
1,<environment.Job instance at 0x7f9af4470c30>,157,12,[ 2 12],158,-1,177,-1,165
1,<environment.Job instance at 0x7f9af4470af0>,156,24,[2 9],157,-1,190,-1,166
1,<environment.Job instance at 0x7f9af4470280>,159,20,[ 3 11],160,-1,186,-1,166
1,<environment.Job instance at 0x7f9af4469f50>,161,16,[8 4],162,-1,188,-1,172
1,<environment.Job instance at 0x7f9af4469cd0>,162,1,[1 5],163,-1,177,-1,176
1,<environment.Job instance at 0x7f9af4470eb0>,158,14,[13  4],159,-1,191,-1,177
1,<environment.Job instance at 0x7f9af4469af0>,167,16,[8 4],168,-1,193,-1,177
1,<environment.Job instance at 0x7f9af44690a0>,170,15,[1 8],171,-1,193,-1,178
1,<environment.Job instance at 0x7f9af44690f0>,165,15,[9 1],166,-1,194,-1,179
1,<environment.Job instance at 0x7f9af4470e60>,153,12,[8 2],154,-1,203,-1,191
1,<environment.Job instance at 0x7f9af39d00f0>,180,12,[9 4],181,-1,203,-1,191
1,<environment.Job instance at 0x7f9af492e0f0>,181,23,[1 8],182,-1,214,-1,191
1,<environment.Job instance at 0x7f9af4937910>,182,14,[3 7],183,-1,205,-1,191
1,<environment.Job instance at 0x7f9af354f230>,183,16,[ 5 10],184,-1,208,-1,192
1,<environment.Job instance at 0x7f9af41c5140>,184,17,[3 5],185,-1,209,-1,192
1,<environment.Job instance at 0x7f9af39a78c0>,185,15,[ 1 10],186,-1,207,-1,192
1,<environment.Job instance at 0x7f9af41ed690>,186,13,[ 5 11],187,-1,205,-1,192
1,<environment.Job instance at 0x7f9af4937050>,8,16,[14  4],9,-1,35,-1,19
1,<environment.Job instance at 0x7f9af4d44c30>,17,27,[8 5],18,-1,90,-1,63
1,<environment.Job instance at 0x7f9af4d700a0>,19,3,[ 1 12],20,-1,66,-1,63
1,<environment.Job instance at 0x7f9af4469410>,23,17,[13  3],24,-1,84,-1,67
1,<environment.Job instance at 0x7f9af389a370>,24,3,[13  1],25,-1,70,-1,67
1,<environment.Job instance at 0x7f9afd707d70>,35,25,[4 5],36,-1,128,-1,103
1,<environment.Job instance at 0x7f9af3f2bc80>,38,1,[ 4 14],39,-1,107,-1,106
1,<environment.Job instance at 0x7f9af3f30c80>,50,2,[13  2],51,-1,141,-1,139
1,<environment.Job instance at 0x7f9af3f3b500>,54,1,[12  5],55,-1,144,-1,143
1,<environment.Job instance at 0x7f9af3f42cd0>,57,26,[ 3 10],58,-1,187,-1,161
1,<environment.Job instance at 0x7f9af41cb7d0>,61,3,[12  2],62,-1,179,-1,176
1,<environment.Job instance at 0x7f9af424b3c0>,74,3,[14  3],75,-1,206,-1,203
1,<environment.Job instance at 0x7f9af38f50a0>,86,1,[11  3],87,-1,240,-1,239
1,<environment.Job instance at 0x7f9af3d31c30>,93,14,[14  1],94,-1,278,-1,264
1,<environment.Job instance at 0x7f9af39b6e60>,102,17,[ 5 14],103,-1,322,-1,305
1,<environment.Job instance at 0x7f9af4c0f500>,113,15,[ 2 12],114,-1,355,-1,340
1,<environment.Job instance at 0x7f9af368a870>,118,2,[13  1],119,-1,369,-1,367
1,<environment.Job instance at 0x7f9af3eb0280>,121,26,[7 2],122,-1,404,-1,378
1,<environment.Job instance at 0x7f9af3b39e60>,131,23,[5 9],132,-1,439,-1,416
1,<environment.Job instance at 0x7f9af384e5a0>,133,3,[ 1 14],134,-1,419,-1,416
1,<environment.Job instance at 0x7f9af44ea5a0>,136,1,[ 3 13],137,-1,417,-1,416
1,<environment.Job instance at 0x7f9af35deaf0>,148,26,[2 5],149,-1,489,-1,463
1,<environment.Job instance at 0x7f9af4d2e780>,156,24,[2 9],157,-1,528,-1,504
1,<environment.Job instance at 0x7f9af4d2efa0>,157,12,[ 2 12],158,-1,516,-1,504
1,<environment.Job instance at 0x7f9af4d2e6e0>,158,14,[13  4],159,-1,518,-1,504
1,<environment.Job instance at 0x7f9af4d2e190>,159,20,[ 3 11],160,-1,524,-1,504
1,<environment.Job instance at 0x7f9af36a2460>,176,1,[ 3 11],177,-1,571,-1,570
1,<environment.Job instance at 0x7f9af36a25a0>,181,23,[1 8],182,-1,609,-1,586
1,<environment.Job instance at 0x7f9af404b5a0>,186,13,[ 5 11],187,-1,614,-1,601
1,<environment.Job instance at 0x7f9af46ab780>,4,2,[1 5],5,-1,7,-1,5
1,<environment.Job instance at 0x7f9af46ab500>,6,25,[8 1],7,-1,32,-1,7
1,<environment.Job instance at 0x7f9af46aba50>,7,18,[ 1 10],8,-1,26,-1,8
1,<environment.Job instance at 0x7f9af46ab960>,8,12,[6 3],9,-1,21,-1,9
1,<environment.Job instance at 0x7f9af46abf00>,13,16,[9 5],14,-1,30,-1,14
1,<environment.Job instance at 0x7f9af46abe60>,14,28,[7 4],15,-1,43,-1,15
1,<environment.Job instance at 0x7f9af46abc30>,15,20,[7 2],16,-1,36,-1,16
1,<environment.Job instance at 0x7f9af46a20a0>,16,14,[10  3],17,-1,31,-1,17
1,<environment.Job instance at 0x7f9af46a2140>,17,17,[5 6],18,-1,35,-1,18
1,<environment.Job instance at 0x7f9af46a25a0>,21,17,[9 3],22,-1,39,-1,22
1,<environment.Job instance at 0x7f9af46a24b0>,23,15,[2 7],24,-1,40,-1,25
1,<environment.Job instance at 0x7f9af46a2910>,24,19,[1 8],25,-1,44,-1,25
1,<environment.Job instance at 0x7f9af46a2960>,26,17,[8 4],27,-1,44,-1,27
1,<environment.Job instance at 0x7f9af46a2e10>,30,13,[8 4],31,-1,44,-1,31
1,<environment.Job instance at 0x7f9af46a2c30>,32,12,[7 3],33,-1,45,-1,33
1,<environment.Job instance at 0x7f9af469c140>,33,20,[4 5],34,-1,54,-1,34
1,<environment.Job instance at 0x7f9af469c280>,35,20,[5 5],36,-1,56,-1,36
1,<environment.Job instance at 0x7f9af469c460>,36,18,[7 3],37,-1,55,-1,37
1,<environment.Job instance at 0x7f9af469c500>,38,18,[1 5],39,-1,57,-1,39
1,<environment.Job instance at 0x7f9af469c640>,40,16,[ 2 10],41,-1,57,-1,41
1,<environment.Job instance at 0x7f9af469c820>,41,18,[3 9],42,-1,60,-1,42
1,<environment.Job instance at 0x7f9af469c8c0>,43,15,[1 5],44,-1,59,-1,44
1,<environment.Job instance at 0x7f9af469cf00>,48,13,[8 5],49,-1,63,-1,50
1,<environment.Job instance at 0x7f9af46d6140>,51,25,[1 6],52,-1,77,-1,52
1,<environment.Job instance at 0x7f9af46d63c0>,54,17,[5 5],55,-1,72,-1,55
1,<environment.Job instance at 0x7f9af46d6460>,55,24,[4 7],56,-1,80,-1,56
1,<environment.Job instance at 0x7f9af46d65a0>,57,15,[1 8],58,-1,73,-1,58
1,<environment.Job instance at 0x7f9af469ccd0>,49,15,[4 6],50,-1,80,-1,65
1,<environment.Job instance at 0x7f9af46d67d0>,60,12,[10  4],61,-1,78,-1,66
1,<environment.Job instance at 0x7f9af46d61e0>,53,26,[10  4],54,-1,97,-1,71
1,<environment.Job instance at 0x7f9af46d00a0>,68,3,[4 5],69,-1,74,-1,71
1,<environment.Job instance at 0x7f9af46d6f00>,69,27,[ 3 10],70,-1,98,-1,71
1,<environment.Job instance at 0x7f9af46d0140>,70,13,[3 7],71,-1,84,-1,71
1,<environment.Job instance at 0x7f9af46d6e10>,65,3,[2 8],66,-1,74,-1,71
1,<environment.Job instance at 0x7f9af46d6d70>,66,14,[9 2],67,-1,86,-1,72
1,<environment.Job instance at 0x7f9af46d0320>,72,26,[9 1],73,-1,101,-1,75
1,<environment.Job instance at 0x7f9af46d01e0>,74,21,[10  5],75,-1,96,-1,75
1,<environment.Job instance at 0x7f9af46d0960>,78,14,[1 9],79,-1,94,-1,80
1,<environment.Job instance at 0x7f9af46d0460>,75,17,[9 3],76,-1,97,-1,80
1,<environment.Job instance at 0x7f9af46d6e60>,67,28,[7 2],68,-1,112,-1,84
1,<environment.Job instance at 0x7f9af46d0780>,77,20,[10  2],78,-1,104,-1,84
1,<environment.Job instance at 0x7f9af46d6960>,61,15,[10  4],62,-1,101,-1,86
1,<environment.Job instance at 0x7f9af46a1230>,86,14,[8 3],87,-1,101,-1,87
1,<environment.Job instance at 0x7f9af46a11e0>,87,27,[9 4],88,-1,115,-1,88
1,<environment.Job instance at 0x7f9af46a1320>,89,15,[5 5],90,-1,106,-1,91
1,<environment.Job instance at 0x7f9af46a15a0>,92,18,[2 5],93,-1,112,-1,94
1,<environment.Job instance at 0x7f9af46a1910>,94,15,[10  1],95,-1,112,-1,97
1,<environment.Job instance at 0x7f9af46a1500>,90,15,[2 8],91,-1,115,-1,100
1,<environment.Job instance at 0x7f9af46a1cd0>,99,17,[5 4],100,-1,122,-1,105
1,<environment.Job instance at 0x7f9af46d0910>,79,12,[5 1],80,-1,124,-1,112
1,<environment.Job instance at 0x7f9af46a1d70>,102,15,[10  3],103,-1,132,-1,117
1,<environment.Job instance at 0x7f9af46a1a00>,95,15,[8 4],96,-1,134,-1,119
1,<environment.Job instance at 0x7f9af46a1b40>,98,17,[13  5],99,-1,136,-1,119
1,<environment.Job instance at 0x7f9af46a1eb0>,104,18,[9 3],105,-1,138,-1,120
1,<environment.Job instance at 0x7f9af46c8780>,110,14,[1 7],111,-1,134,-1,120
1,<environment.Job instance at 0x7f9af46c80f0>,109,14,[4 7],110,-1,134,-1,120
1,<environment.Job instance at 0x7f9af46c8550>,114,14,[5 6],115,-1,134,-1,120
1,<environment.Job instance at 0x7f9af3bb9d70>,117,17,[ 5 10],118,-1,139,-1,122
1,<environment.Job instance at 0x7f9af49841e0>,118,21,[2 5],119,-1,144,-1,123
1,<environment.Job instance at 0x7f9af3a95640>,119,23,[5 7],120,-1,146,-1,123
1,<environment.Job instance at 0x7f9af46c8190>,112,13,[13  5],113,-1,193,-1,180
1,<environment.Job instance at 0x7f9af3db0cd0>,123,25,[ 1 10],124,-1,205,-1,180
1,<environment.Job instance at 0x7f9af3dc2b40>,131,18,[9 3],132,-1,198,-1,180
1,<environment.Job instance at 0x7f9af489e8c0>,132,14,[5 5],133,-1,194,-1,180
1,<environment.Job instance at 0x7f9af3d7aaf0>,134,13,[4 7],135,-1,200,-1,187
1,<environment.Job instance at 0x7f9af3d7ad70>,138,18,[7 1],139,-1,205,-1,187
1,<environment.Job instance at 0x7f9af3d7a550>,139,14,[1 8],140,-1,201,-1,187
1,<environment.Job instance at 0x7f9af4b7deb0>,141,12,[4 6],142,-1,200,-1,188
1,<environment.Job instance at 0x7f9af4b7daf0>,143,13,[10  4],144,-1,201,-1,188
1,<environment.Job instance at 0x7f9af49d8d20>,147,15,[8 5],148,-1,203,-1,188
1,<environment.Job instance at 0x7f9af3e3eb90>,149,21,[7 2],150,-1,209,-1,188
1,<environment.Job instance at 0x7f9af3e3ec30>,150,13,[4 9],151,-1,201,-1,188
1,<environment.Job instance at 0x7f9af3e3ee10>,152,16,[8 1],153,-1,204,-1,188
1,<environment.Job instance at 0x7f9af3e3e0f0>,153,14,[6 1],154,-1,202,-1,188
1,<environment.Job instance at 0x7f9af3d7aeb0>,136,14,[9 3],137,-1,202,-1,188
1,<environment.Job instance at 0x7f9af3e3eaf0>,154,14,[ 1 12],155,-1,202,-1,188
1,<environment.Job instance at 0x7f9afd3f8d70>,157,21,[10  4],158,-1,210,-1,189
1,<environment.Job instance at 0x7f9af3e3ea00>,156,23,[ 5 12],157,-1,212,-1,189
1,<environment.Job instance at 0x7f9af34f3320>,160,13,[6 3],161,-1,202,-1,189
1,<environment.Job instance at 0x7f9af34f36e0>,161,21,[1 7],162,-1,210,-1,189
1,<environment.Job instance at 0x7f9af3d855f0>,163,14,[6 4],164,-1,203,-1,189
1,<environment.Job instance at 0x7f9af3d85280>,166,16,[1 7],167,-1,225,-1,209
1,<environment.Job instance at 0x7f9af4b8b1e0>,173,15,[2 8],174,-1,225,-1,210
1,<environment.Job instance at 0x7f9af46c8500>,106,14,[6 2],107,-1,224,-1,210
1,<environment.Job instance at 0x7f9af3d4d3c0>,170,12,[4 5],171,-1,222,-1,210
1,<environment.Job instance at 0x7f9af3d4dd70>,172,18,[1 5],173,-1,228,-1,210
1,<environment.Job instance at 0x7f9af3d4f230>,177,13,[ 5 10],178,-1,223,-1,210
1,<environment.Job instance at 0x7f9af3d4f190>,178,16,[6 5],179,-1,226,-1,210
1,<environment.Job instance at 0x7f9af44d65a0>,180,25,[6 2],181,-1,235,-1,210
1,<environment.Job instance at 0x7f9af3d737d0>,184,21,[5 2],185,-1,232,-1,211
1,<environment.Job instance at 0x7f9af46a2d20>,6,25,[8 1],7,-1,42,-1,17
1,<environment.Job instance at 0x7f9af4974690>,14,28,[7 4],15,-1,51,-1,23
1,<environment.Job instance at 0x7f9af35c80a0>,37,13,[14  1],38,-1,112,-1,99
1,<environment.Job instance at 0x7f9af36a4b90>,46,2,[14  1],47,-1,134,-1,132
1,<environment.Job instance at 0x7f9af36a2460>,51,25,[1 6],52,-1,173,-1,148
1,<environment.Job instance at 0x7f9af36a22d0>,52,12,[12  2],53,-1,160,-1,148
1,<environment.Job instance at 0x7f9af36a2690>,53,26,[10  4],54,-1,177,-1,151
1,<environment.Job instance at 0x7f9af36b6820>,55,24,[4 7],56,-1,183,-1,159
1,<environment.Job instance at 0x7f9af4d2edc0>,64,13,[ 5 11],65,-1,206,-1,193
1,<environment.Job instance at 0x7f9af4d2e6e0>,67,28,[7 2],68,-1,240,-1,212
1,<environment.Job instance at 0x7f9af35d9640>,69,27,[ 3 10],70,-1,243,-1,216
1,<environment.Job instance at 0x7f9af35deaa0>,72,26,[9 1],73,-1,256,-1,230
1,<environment.Job instance at 0x7f9af35de550>,76,3,[ 2 14],77,-1,233,-1,230
1,<environment.Job instance at 0x7f9af4299190>,87,27,[9 4],88,-1,291,-1,264
1,<environment.Job instance at 0x7f9af4c85550>,98,17,[13  5],99,-1,327,-1,310
1,<environment.Job instance at 0x7f9af41d6f00>,112,13,[13  5],113,-1,386,-1,373
1,<environment.Job instance at 0x7f9af39b62d0>,115,2,[ 2 12],116,-1,376,-1,374
1,<environment.Job instance at 0x7f9af39b6690>,119,23,[5 7],120,-1,429,-1,406
1,<environment.Job instance at 0x7f9af3d31190>,126,12,[14  2],127,-1,431,-1,419
1,<environment.Job instance at 0x7f9af41c3960>,128,1,[ 5 14],129,-1,422,-1,421
1,<environment.Job instance at 0x7f9af41cd1e0>,123,25,[ 1 10],124,-1,462,-1,437
1,<environment.Job instance at 0x7f9af38c5190>,140,12,[ 1 13],141,-1,472,-1,460
1,<environment.Job instance at 0x7f9af424b500>,145,2,[11  4],146,-1,485,-1,483
1,<environment.Job instance at 0x7f9af41cb190>,154,14,[ 1 12],155,-1,532,-1,518
1,<environment.Job instance at 0x7f9af41cb910>,156,23,[ 5 12],157,-1,543,-1,520
1,<environment.Job instance at 0x7f9af3f3bcd0>,162,1,[ 4 11],163,-1,539,-1,538
1,<environment.Job instance at 0x7f9af3f2bf50>,174,3,[ 1 12],175,-1,588,-1,585
1,<environment.Job instance at 0x7f9af3bf3eb0>,180,25,[6 2],181,-1,644,-1,619
1,<environment.Job instance at 0x7f9af3e9e910>,0,16,[5 9],1,-1,17,-1,1
1,<environment.Job instance at 0x7f9af4383910>,2,14,[10  5],3,-1,19,-1,5
1,<environment.Job instance at 0x7f9af43834b0>,6,18,[1 8],7,-1,25,-1,7
1,<environment.Job instance at 0x7f9af4383fa0>,7,27,[4 8],8,-1,35,-1,8
1,<environment.Job instance at 0x7f9af45e8fa0>,22,15,[9 5],23,-1,38,-1,23
1,<environment.Job instance at 0x7f9af45e8dc0>,26,18,[4 9],27,-1,45,-1,27
1,<environment.Job instance at 0x7f9af45e8eb0>,18,18,[6 4],19,-1,46,-1,28
1,<environment.Job instance at 0x7f9af4383a00>,10,15,[8 5],11,-1,48,-1,33
1,<environment.Job instance at 0x7f9afd373500>,27,18,[5 3],28,-1,51,-1,33
1,<environment.Job instance at 0x7f9af40772d0>,40,17,[5 8],41,-1,63,-1,46
1,<environment.Job instance at 0x7f9afd3739b0>,32,16,[8 1],33,-1,66,-1,50
1,<environment.Job instance at 0x7f9af4077dc0>,46,17,[5 1],47,-1,67,-1,50
1,<environment.Job instance at 0x7f9af40770a0>,44,18,[6 5],45,-1,68,-1,50
1,<environment.Job instance at 0x7f9af3d48870>,49,16,[5 5],50,-1,66,-1,50
1,<environment.Job instance at 0x7f9af4c87370>,82,18,[ 3 13],83,-1,984,-1,966
1,<environment.Job instance at 0x7f9af4d13050>,143,18,[10  4],144,-1,984,-1,966
1,<environment.Job instance at 0x7f9af3b0adc0>,102,26,[9 3],103,-1,1032,-1,1006
1,<environment.Job instance at 0x7f9af4ba0e60>,144,14,[ 4 10],145,-1,1020,-1,1006
1,<environment.Job instance at 0x7f9af4c8cc30>,124,17,[9 5],125,-1,1023,-1,1006
1,<environment.Job instance at 0x7f9af41b9b90>,153,16,[1 9],154,-1,1022,-1,1006
1,<environment.Job instance at 0x7f9af45e8640>,1,18,[14  2],2,-1,20,-1,2
1,<environment.Job instance at 0x7f9afd373050>,5,15,[12  5],6,-1,21,-1,6
1,<environment.Job instance at 0x7f9af40775a0>,8,20,[ 4 13],9,-1,29,-1,9
1,<environment.Job instance at 0x7f9afd373550>,7,27,[4 8],8,-1,44,-1,17
1,<environment.Job instance at 0x7f9af454a460>,33,18,[ 5 13],34,-1,103,-1,85
1,<environment.Job instance at 0x7f9af3f1b550>,67,14,[ 3 12],68,-1,228,-1,214
1,<environment.Job instance at 0x7f9af3f42690>,75,23,[7 3],76,-1,261,-1,238
1,<environment.Job instance at 0x7f9af38c59b0>,82,18,[ 3 13],83,-1,259,-1,241
1,<environment.Job instance at 0x7f9af39b6b40>,102,26,[9 3],103,-1,341,-1,315
1,<environment.Job instance at 0x7f9af445a8c0>,106,3,[12  4],107,-1,321,-1,318
1,<environment.Job instance at 0x7f9af3b0ae10>,116,15,[ 1 11],117,-1,374,-1,359
1,<environment.Job instance at 0x7f9af35de820>,128,12,[14  5],129,-1,415,-1,403
1,<environment.Job instance at 0x7f9af36b6280>,138,23,[1 5],139,-1,471,-1,448
1,<environment.Job instance at 0x7f9af36b6730>,139,2,[12  2],140,-1,450,-1,448
1,<environment.Job instance at 0x7f9af36a4eb0>,156,17,[13  4],157,-1,556,-1,539
1,<environment.Job instance at 0x7f9af46ab410>,159,17,[ 1 11],160,-1,560,-1,543
1,<environment.Job instance at 0x7f9af35c8b40>,164,17,[12  2],165,-1,586,-1,569
1,<environment.Job instance at 0x7f9af3e3e410>,172,1,[ 1 11],173,-1,600,-1,599
1,<environment.Job instance at 0x7f9af3d4f870>,174,12,[ 3 12],175,-1,611,-1,599
1,<environment.Job instance at 0x7f9af3d4f910>,175,17,[14  3],176,-1,616,-1,599
1,<environment.Job instance at 0x7f9af34ee870>,177,1,[ 5 12],186,-1,602,-1,601
1,<environment.Job instance at 0x7f9af46a1140>,179,3,[13  2],189,-1,605,-1,602
1,<environment.Job instance at 0x7f9af349c2d0>,1,18,[5 6],2,-1,20,-1,2
1,<environment.Job instance at 0x7f9af349c640>,5,16,[6 5],6,-1,22,-1,6
1,<environment.Job instance at 0x7f9af34aaa00>,6,15,[1 6],7,-1,22,-1,7
1,<environment.Job instance at 0x7f9af34aa230>,7,18,[3 8],8,-1,26,-1,8
1,<environment.Job instance at 0x7f9af34aacd0>,12,16,[3 7],13,-1,29,-1,13
1,<environment.Job instance at 0x7f9af34aa960>,13,15,[9 4],14,-1,30,-1,15
1,<environment.Job instance at 0x7f9af34aabe0>,17,18,[2 8],18,-1,36,-1,18
1,<environment.Job instance at 0x7f9af45b8b90>,21,14,[1 8],22,-1,36,-1,22
1,<environment.Job instance at 0x7f9af45b8d20>,22,16,[6 4],23,-1,39,-1,23
1,<environment.Job instance at 0x7f9af45b8cd0>,23,12,[10  2],24,-1,38,-1,26
1,<environment.Job instance at 0x7f9af45b8e60>,26,18,[ 2 10],27,-1,45,-1,27
1,<environment.Job instance at 0x7f9af45b85a0>,25,27,[1 5],26,-1,55,-1,28
1,<environment.Job instance at 0x7f9af45b8910>,30,15,[8 4],31,-1,46,-1,31
1,<environment.Job instance at 0x7f9af45b14b0>,31,18,[7 3],32,-1,51,-1,33
1,<environment.Job instance at 0x7f9af45b8050>,32,17,[1 7],33,-1,50,-1,33
1,<environment.Job instance at 0x7f9af45b1050>,37,15,[ 3 10],38,-1,53,-1,38
1,<environment.Job instance at 0x7f9af45b13c0>,38,12,[10  1],39,-1,52,-1,40
1,<environment.Job instance at 0x7f9af45b1eb0>,40,17,[5 2],41,-1,58,-1,41
1,<environment.Job instance at 0x7f9af45b1230>,41,21,[8 4],42,-1,63,-1,42
1,<environment.Job instance at 0x7f9af45b1c30>,42,16,[1 7],43,-1,59,-1,43
1,<environment.Job instance at 0x7f9af45b1b90>,45,18,[4 5],46,-1,64,-1,46
1,<environment.Job instance at 0x7f9af45b10a0>,46,12,[2 8],47,-1,59,-1,47
1,<environment.Job instance at 0x7f9af45b1c80>,47,18,[2 7],48,-1,66,-1,48
1,<environment.Job instance at 0x7f9af45155f0>,50,15,[6 1],51,-1,66,-1,51
1,<environment.Job instance at 0x7f9af4515320>,54,20,[8 2],55,-1,75,-1,55
1,<environment.Job instance at 0x7f9af4515b90>,55,14,[4 9],56,-1,70,-1,56
1,<environment.Job instance at 0x7f9af34a8910>,60,21,[10  5],61,-1,85,-1,64
1,<environment.Job instance at 0x7f9af459ba50>,63,19,[7 1],64,-1,83,-1,64
1,<environment.Job instance at 0x7f9af47f0190>,72,16,[9 2],73,-1,89,-1,73
1,<environment.Job instance at 0x7f9af3eb5fa0>,78,12,[ 4 10],79,-1,91,-1,79
1,<environment.Job instance at 0x7f9af3d25f00>,81,15,[9 3],82,-1,97,-1,82
1,<environment.Job instance at 0x7f9af4245910>,82,17,[4 9],83,-1,100,-1,83
1,<environment.Job instance at 0x7f9af3c8a4b0>,84,24,[7 3],85,-1,109,-1,85
1,<environment.Job instance at 0x7f9af3c8a050>,86,21,[5 3],87,-1,108,-1,87
1,<environment.Job instance at 0x7f9af352beb0>,87,22,[1 9],88,-1,110,-1,88
1,<environment.Job instance at 0x7f9af352b7d0>,88,16,[1 7],89,-1,105,-1,89
1,<environment.Job instance at 0x7f9af4681c30>,90,12,[10  5],91,-1,104,-1,92
1,<environment.Job instance at 0x7f9af3957d70>,91,16,[10  1],92,-1,109,-1,93
1,<environment.Job instance at 0x7f9af4949dc0>,93,17,[8 3],94,-1,111,-1,94
1,<environment.Job instance at 0x7f9af4a50460>,112,18,[ 3 10],113,-1,131,-1,113
1,<environment.Job instance at 0x7f9af41755f0>,102,24,[5 7],103,-1,138,-1,114
1,<environment.Job instance at 0x7f9af440c230>,109,23,[6 1],110,-1,137,-1,114
1,<environment.Job instance at 0x7f9af4a508c0>,113,16,[8 1],114,-1,130,-1,114
1,<environment.Job instance at 0x7f9af4a50730>,114,18,[ 3 10],115,-1,134,-1,116
1,<environment.Job instance at 0x7f9af42814b0>,119,15,[4 9],120,-1,135,-1,120
1,<environment.Job instance at 0x7f9af3c726e0>,127,17,[5 6],128,-1,145,-1,128
1,<environment.Job instance at 0x7f9af3c64b90>,116,23,[ 2 10],117,-1,152,-1,129
1,<environment.Job instance at 0x7f9af3c723c0>,128,15,[3 5],129,-1,144,-1,129
1,<environment.Job instance at 0x7f9af4949460>,94,19,[ 5 12],95,-1,149,-1,130
1,<environment.Job instance at 0x7f9af45950a0>,129,14,[ 2 10],130,-1,147,-1,133
1,<environment.Job instance at 0x7f9af3c87960>,136,13,[2 7],137,-1,150,-1,137
1,<environment.Job instance at 0x7f9af3c87820>,138,14,[2 8],139,-1,158,-1,144
1,<environment.Job instance at 0x7f9af361c2d0>,140,18,[5 6],141,-1,162,-1,144
1,<environment.Job instance at 0x7f9af3c87230>,137,3,[1 5],138,-1,147,-1,144
1,<environment.Job instance at 0x7f9af3c6d910>,132,15,[8 3],133,-1,161,-1,146
1,<environment.Job instance at 0x7f9af3c87e10>,139,12,[7 4],140,-1,158,-1,146
1,<environment.Job instance at 0x7f9af361c640>,143,13,[10  5],144,-1,159,-1,146
1,<environment.Job instance at 0x7f9af363c5f0>,145,15,[10  4],146,-1,161,-1,146
1,<environment.Job instance at 0x7f9af3cabbe0>,146,26,[5 7],147,-1,173,-1,147
1,<environment.Job instance at 0x7f9af361caf0>,142,14,[5 3],143,-1,163,-1,149
1,<environment.Job instance at 0x7f9af361a4b0>,152,13,[6 3],153,-1,166,-1,153
1,<environment.Job instance at 0x7f9af361a460>,158,12,[5 3],159,-1,171,-1,159
1,<environment.Job instance at 0x7f9af3cabb90>,149,13,[ 2 14],150,-1,172,-1,159
1,<environment.Job instance at 0x7f9af361a190>,159,20,[3 9],160,-1,181,-1,161
1,<environment.Job instance at 0x7f9af361a3c0>,160,16,[4 9],161,-1,177,-1,161
1,<environment.Job instance at 0x7f9af45ade10>,161,23,[8 4],162,-1,185,-1,162
1,<environment.Job instance at 0x7f9af45addc0>,162,17,[3 6],163,-1,180,-1,163
1,<environment.Job instance at 0x7f9af361aa50>,154,14,[5 2],155,-1,178,-1,164
1,<environment.Job instance at 0x7f9af4281f00>,120,15,[ 1 11],121,-1,181,-1,166
1,<environment.Job instance at 0x7f9af3618910>,171,17,[7 4],172,-1,193,-1,176
1,<environment.Job instance at 0x7f9af34a8780>,177,15,[10  5],178,-1,193,-1,178
1,<environment.Job instance at 0x7f9af34a8a50>,179,18,[5 2],180,-1,198,-1,180
1,<environment.Job instance at 0x7f9af349a4b0>,180,17,[8 2],181,-1,198,-1,181
1,<environment.Job instance at 0x7f9af3618d20>,173,16,[1 9],174,-1,200,-1,184
1,<environment.Job instance at 0x7f9af349ad70>,183,15,[5 2],184,-1,199,-1,184
1,<environment.Job instance at 0x7f9af349ac80>,185,14,[9 4],186,-1,200,-1,186
1,<environment.Job instance at 0x7f9af349a780>,186,12,[7 2],187,-1,199,-1,187
1,<environment.Job instance at 0x7f9af349a730>,188,18,[5 3],189,-1,207,-1,189
1,<environment.Job instance at 0x7f9af4699910>,10,3,[13  5],11,-1,14,-1,11
1,<environment.Job instance at 0x7f9af352bc30>,15,3,[14  3],16,-1,39,-1,36
1,<environment.Job instance at 0x7f9af3c6da00>,25,27,[1 5],26,-1,110,-1,83
1,<environment.Job instance at 0x7f9af363c190>,29,3,[13  3],30,-1,89,-1,86
1,<environment.Job instance at 0x7f9af34974b0>,65,1,[ 3 11],66,-1,205,-1,204
1,<environment.Job instance at 0x7f9af3497410>,76,23,[ 1 13],77,-1,249,-1,226
1,<environment.Job instance at 0x7f9af3497c30>,77,2,[ 2 11],78,-1,228,-1,226
1,<environment.Job instance at 0x7f9af4518dc0>,84,24,[7 3],85,-1,272,-1,248
1,<environment.Job instance at 0x7f9af4518500>,94,19,[ 5 12],95,-1,307,-1,288
1,<environment.Job instance at 0x7f9af4518780>,95,27,[2 8],96,-1,328,-1,301
1,<environment.Job instance at 0x7f9af4518a50>,99,1,[ 4 13],100,-1,304,-1,303
1,<environment.Job instance at 0x7f9af45d7640>,102,24,[5 7],103,-1,332,-1,308
1,<environment.Job instance at 0x7f9af45d7eb0>,109,23,[6 1],110,-1,352,-1,329
1,<environment.Job instance at 0x7f9af45d7320>,110,1,[11  4],111,-1,330,-1,329
1,<environment.Job instance at 0x7f9af45d7a50>,116,23,[ 2 10],117,-1,369,-1,346
1,<environment.Job instance at 0x7f9af45d7370>,120,15,[ 1 11],121,-1,366,-1,351
1,<environment.Job instance at 0x7f9af45d7050>,121,2,[11  4],122,-1,353,-1,351
1,<environment.Job instance at 0x7f9af451bf50>,122,3,[14  5],123,-1,354,-1,351
1,<environment.Job instance at 0x7f9af34a9460>,146,26,[5 7],147,-1,507,-1,481
1,<environment.Job instance at 0x7f9af34a9d20>,149,13,[ 2 14],150,-1,494,-1,481
1,<environment.Job instance at 0x7f9af34a95f0>,156,3,[ 4 11],157,-1,494,-1,491
1,<environment.Job instance at 0x7f9af3490050>,161,23,[8 4],162,-1,539,-1,516
1,<environment.Job instance at 0x7f9af3490cd0>,164,3,[11  3],165,-1,527,-1,524
1,<environment.Job instance at 0x7f9af34906e0>,166,2,[ 2 12],167,-1,529,-1,527
1,<environment.Job instance at 0x7f9af3490870>,170,27,[6 2],176,-1,570,-1,543
1,<environment.Job instance at 0x7f9af3490460>,173,3,[ 3 12],179,-1,546,-1,543
1,<environment.Job instance at 0x7f9af45bdd20>,1,18,[1 7],2,-1,20,-1,2
1,<environment.Job instance at 0x7f9af3f57820>,14,18,[7 1],15,-1,33,-1,15
1,<environment.Job instance at 0x7f9af3f690f0>,24,18,[ 4 10],25,-1,44,-1,26
1,<environment.Job instance at 0x7f9af3f69500>,25,12,[10  4],26,-1,38,-1,26
1,<environment.Job instance at 0x7f9af3f69690>,28,22,[10  4],29,-1,54,-1,32
1,<environment.Job instance at 0x7f9af3f69cd0>,34,18,[3 8],35,-1,53,-1,35
1,<environment.Job instance at 0x7f9af3f69eb0>,37,25,[6 5],38,-1,63,-1,38
1,<environment.Job instance at 0x7f9af3a32640>,40,16,[8 3],41,-1,57,-1,41
1,<environment.Job instance at 0x7f9af3a1b9b0>,44,15,[10  3],45,-1,60,-1,45
1,<environment.Job instance at 0x7f9af3a1b780>,47,13,[5 6],48,-1,61,-1,48
1,<environment.Job instance at 0x7f9af3a1b5f0>,48,25,[5 7],49,-1,74,-1,49
1,<environment.Job instance at 0x7f9af45c8b90>,57,16,[6 3],58,-1,74,-1,58
1,<environment.Job instance at 0x7f9af49cc410>,60,14,[7 5],61,-1,75,-1,61
1,<environment.Job instance at 0x7f9af41b4140>,61,14,[8 5],62,-1,76,-1,62
1,<environment.Job instance at 0x7f9af487cc30>,62,18,[5 8],63,-1,81,-1,63
1,<environment.Job instance at 0x7f9af3f695f0>,5,1,[ 4 14],6,-1,7,-1,6
1,<environment.Job instance at 0x7f9af3f7fc80>,16,14,[ 5 11],17,-1,36,-1,22
1,<environment.Job instance at 0x7f9af3f7fbe0>,19,22,[14  5],20,-1,46,-1,24
1,<environment.Job instance at 0x7f9af3490be0>,22,12,[11  2],23,-1,37,-1,25
1,<environment.Job instance at 0x7f9af34a9460>,37,25,[6 5],38,-1,89,-1,64
1,<environment.Job instance at 0x7f9af451b3c0>,48,25,[5 7],49,-1,127,-1,102
1,<environment.Job instance at 0x7f9af451b5f0>,49,13,[ 3 12],50,-1,115,-1,102
1,<environment.Job instance at 0x7f9af451b550>,58,3,[12  5],59,-1,122,-1,119
1,<environment.Job instance at 0x7f9af45d75a0>,65,26,[14  3],66,-1,177,-1,151
1,<environment.Job instance at 0x7f9af45d70f0>,67,28,[6 3],68,-1,195,-1,167
1,<environment.Job instance at 0x7f9af45d7410>,76,2,[14  2],77,-1,177,-1,175
1,<environment.Job instance at 0x7f9af45d7870>,77,3,[13  2],78,-1,178,-1,175
1,<environment.Job instance at 0x7f9af45181e0>,89,18,[13  1],90,-1,242,-1,224
1,<environment.Job instance at 0x7f9af4518730>,92,25,[2 8],93,-1,263,-1,238
1,<environment.Job instance at 0x7f9af3497460>,94,15,[ 3 14],95,-1,253,-1,238
1,<environment.Job instance at 0x7f9af3497640>,100,12,[ 3 11],101,-1,270,-1,258
1,<environment.Job instance at 0x7f9af34975f0>,101,28,[1 5],102,-1,286,-1,258
1,<environment.Job instance at 0x7f9af3497230>,111,16,[ 3 14],112,-1,321,-1,305
1,<environment.Job instance at 0x7f9af34977d0>,110,27,[3 8],111,-1,334,-1,307
1,<environment.Job instance at 0x7f9af4adf0f0>,121,1,[12  2],122,-1,327,-1,326
1,<environment.Job instance at 0x7f9af45cb230>,140,23,[ 1 12],141,-1,420,-1,397
1,<environment.Job instance at 0x7f9af4699910>,142,28,[1 7],143,-1,439,-1,411
1,<environment.Job instance at 0x7f9af4c8cdc0>,145,26,[ 4 10],146,-1,437,-1,411
1,<environment.Job instance at 0x7f9af45b1b40>,149,22,[12  5],150,-1,438,-1,416
1,<environment.Job instance at 0x7f9af45b8a50>,154,27,[3 7],155,-1,472,-1,445
1,<environment.Job instance at 0x7f9af3eea6e0>,187,28,[8 3],188,-1,618,-1,590
1,<environment.Job instance at 0x7f9af3f4bdc0>,0,19,[3 8],1,-1,20,-1,1
1,<environment.Job instance at 0x7f9af3737d20>,4,16,[4 6],5,-1,22,-1,6
1,<environment.Job instance at 0x7f9af3737fa0>,7,27,[3 7],8,-1,35,-1,8
1,<environment.Job instance at 0x7f9af3bf7550>,12,16,[7 5],13,-1,29,-1,13
1,<environment.Job instance at 0x7f9af3bf78c0>,14,17,[5 2],15,-1,32,-1,15
1,<environment.Job instance at 0x7f9af3bf7370>,18,18,[2 5],19,-1,37,-1,19
1,<environment.Job instance at 0x7f9af3bf7870>,21,18,[ 5 10],22,-1,40,-1,22
1,<environment.Job instance at 0x7f9af3f4bcd0>,5,15,[5 5],6,-1,37,-1,22
1,<environment.Job instance at 0x7f9afd38e960>,28,17,[7 4],29,-1,53,-1,36
1,<environment.Job instance at 0x7f9afd3addc0>,56,17,[10  5],57,-1,86,-1,69
1,<environment.Job instance at 0x7f9afd3adb40>,53,17,[10  5],54,-1,106,-1,89
1,<environment.Job instance at 0x7f9afd3adf50>,65,27,[8 5],66,-1,116,-1,89
1,<environment.Job instance at 0x7f9afd3ada50>,62,17,[4 9],63,-1,106,-1,89
1,<environment.Job instance at 0x7f9af4a380f0>,51,26,[6 3],52,-1,116,-1,90
1,<environment.Job instance at 0x7f9af42933c0>,69,18,[1 5],70,-1,108,-1,90
1,<environment.Job instance at 0x7f9af4293e60>,71,14,[10  4],72,-1,104,-1,90
1,<environment.Job instance at 0x7f9af3bf7140>,2,22,[13  5],3,-1,25,-1,3
1,<environment.Job instance at 0x7f9afd38e780>,3,28,[10  5],4,-1,32,-1,4
1,<environment.Job instance at 0x7f9af38d43c0>,7,27,[3 7],8,-1,47,-1,20
1,<environment.Job instance at 0x7f9af4293500>,16,27,[13  1],17,-1,54,-1,27
1,<environment.Job instance at 0x7f9af3737140>,25,25,[2 7],26,-1,78,-1,53
1,<environment.Job instance at 0x7f9af3eea5a0>,27,17,[ 5 14],28,-1,70,-1,53
1,<environment.Job instance at 0x7f9af4514190>,51,26,[6 3],52,-1,160,-1,134
1,<environment.Job instance at 0x7f9af440cf00>,57,1,[ 5 12],58,-1,150,-1,149
1,<environment.Job instance at 0x7f9af45cb230>,59,3,[12  2],60,-1,152,-1,149
1,<environment.Job instance at 0x7f9af352bc30>,61,3,[11  1],62,-1,153,-1,150
1,<environment.Job instance at 0x7f9af3c8c1e0>,65,27,[8 5],66,-1,193,-1,166
1,<environment.Job instance at 0x7f9af4df3a00>,68,24,[7 4],69,-1,193,-1,169
1,<environment.Job instance at 0x7f9af4d4d050>,77,13,[ 2 13],78,-1,199,-1,186
1,<environment.Job instance at 0x7f9af34a8c30>,78,17,[ 1 13],79,-1,203,-1,186
1,<environment.Job instance at 0x7f9af3d489b0>,79,2,[12  1],80,-1,188,-1,186
1,<environment.Job instance at 0x7f9afd373d70>,81,24,[ 3 14],82,-1,211,-1,187
1,<environment.Job instance at 0x7f9af3497780>,88,13,[14  1],89,-1,217,-1,204
1,<environment.Job instance at 0x7f9af34979b0>,91,15,[ 3 13],92,-1,222,-1,207
1,<environment.Job instance at 0x7f9af3497d70>,96,26,[ 4 10],97,-1,259,-1,233
1,<environment.Job instance at 0x7f9af45181e0>,101,3,[ 2 12],102,-1,252,-1,249
1,<environment.Job instance at 0x7f9af4518eb0>,105,13,[13  4],106,-1,275,-1,262
1,<environment.Job instance at 0x7f9af45180a0>,106,25,[ 3 12],107,-1,287,-1,262
1,<environment.Job instance at 0x7f9af45d7640>,114,25,[7 4],115,-1,305,-1,280
1,<environment.Job instance at 0x7f9af45d7be0>,116,28,[6 2],117,-1,308,-1,280
1,<environment.Job instance at 0x7f9af45d70f0>,120,1,[ 2 11],121,-1,285,-1,284
1,<environment.Job instance at 0x7f9af45d7f50>,122,14,[ 4 14],123,-1,300,-1,286
1,<environment.Job instance at 0x7f9af451b050>,130,18,[ 2 13],131,-1,339,-1,321
1,<environment.Job instance at 0x7f9af451b870>,137,3,[12  2],138,-1,346,-1,343
1,<environment.Job instance at 0x7f9af451b230>,142,26,[5 7],143,-1,396,-1,370
1,<environment.Job instance at 0x7f9af34a9a00>,144,28,[9 1],145,-1,403,-1,375
1,<environment.Job instance at 0x7f9af34a9c80>,148,28,[5 2],149,-1,417,-1,389
1,<environment.Job instance at 0x7f9af34a9140>,153,3,[11  4],154,-1,395,-1,392
1,<environment.Job instance at 0x7f9af3a1bf00>,160,2,[ 5 14],161,-1,443,-1,441
1,<environment.Job instance at 0x7f9af3f57960>,169,28,[10  4],170,-1,532,-1,504
1,<environment.Job instance at 0x7f9af4b76820>,175,3,[11  1],176,-1,511,-1,508
1,<environment.Job instance at 0x7f9af4b76cd0>,180,1,[ 1 14],181,-1,540,-1,539
1,<environment.Job instance at 0x7f9af44303c0>,188,28,[2 8],189,-1,598,-1,570
1,<environment.Job instance at 0x7f9af4255960>,1,17,[5 5],2,-1,19,-1,2
1,<environment.Job instance at 0x7f9af4255e10>,4,17,[1 5],5,-1,22,-1,5
1,<environment.Job instance at 0x7f9af4255c80>,8,16,[5 9],9,-1,25,-1,9
1,<environment.Job instance at 0x7f9af42552d0>,10,12,[4 6],11,-1,30,-1,18
1,<environment.Job instance at 0x7f9af3df0780>,18,14,[8 5],19,-1,33,-1,19
1,<environment.Job instance at 0x7f9af3df01e0>,22,25,[7 5],23,-1,48,-1,23
1,<environment.Job instance at 0x7f9af39e0cd0>,23,17,[2 5],24,-1,41,-1,24
1,<environment.Job instance at 0x7f9af39e03c0>,24,17,[2 6],25,-1,42,-1,25
1,<environment.Job instance at 0x7f9af39e0730>,25,14,[3 5],26,-1,40,-1,26
1,<environment.Job instance at 0x7f9af39e0be0>,27,16,[ 2 10],28,-1,44,-1,28
1,<environment.Job instance at 0x7f9af39e00f0>,29,14,[3 9],30,-1,44,-1,30
1,<environment.Job instance at 0x7f9af39e0960>,30,15,[ 3 10],31,-1,47,-1,32
1,<environment.Job instance at 0x7f9af4608230>,32,16,[5 8],33,-1,49,-1,33
1,<environment.Job instance at 0x7f9af4608af0>,34,18,[2 9],35,-1,53,-1,35
1,<environment.Job instance at 0x7f9af4608e10>,36,17,[4 9],37,-1,54,-1,37
1,<environment.Job instance at 0x7f9af4608d70>,37,18,[3 7],38,-1,56,-1,38
1,<environment.Job instance at 0x7f9af49df140>,40,13,[9 4],41,-1,54,-1,41
1,<environment.Job instance at 0x7f9af49dfaa0>,42,24,[2 9],43,-1,67,-1,43
1,<environment.Job instance at 0x7f9af49dfc80>,44,15,[ 5 10],45,-1,60,-1,45
1,<environment.Job instance at 0x7f9af49dfc30>,47,16,[5 7],48,-1,64,-1,48
1,<environment.Job instance at 0x7f9af3d95c30>,49,18,[1 9],50,-1,68,-1,50
1,<environment.Job instance at 0x7f9af3d956e0>,50,16,[9 3],51,-1,67,-1,51
1,<environment.Job instance at 0x7f9af39e0c30>,31,12,[10  5],32,-1,64,-1,52
1,<environment.Job instance at 0x7f9af3d95730>,52,17,[8 1],53,-1,72,-1,55
1,<environment.Job instance at 0x7f9af3c89c80>,57,16,[5 9],58,-1,74,-1,58
1,<environment.Job instance at 0x7f9af459b4b0>,59,20,[5 3],60,-1,80,-1,60
1,<environment.Job instance at 0x7f9af3fa3730>,61,17,[4 6],62,-1,79,-1,62
1,<environment.Job instance at 0x7f9af363cbe0>,64,14,[10  2],65,-1,79,-1,65
1,<environment.Job instance at 0x7f9af363c8c0>,65,23,[1 8],66,-1,89,-1,66
1,<environment.Job instance at 0x7f9af44678c0>,74,18,[2 6],75,-1,93,-1,75
1,<environment.Job instance at 0x7f9af480db40>,75,18,[4 6],76,-1,94,-1,76
1,<environment.Job instance at 0x7f9af3709fa0>,77,18,[3 5],78,-1,96,-1,78
1,<environment.Job instance at 0x7f9af4748c80>,78,19,[3 9],79,-1,98,-1,79
1,<environment.Job instance at 0x7f9af46895a0>,81,18,[1 8],82,-1,100,-1,82
1,<environment.Job instance at 0x7f9af3bd1d70>,83,17,[6 4],84,-1,101,-1,84
1,<environment.Job instance at 0x7f9af3bd1c30>,84,26,[8 5],85,-1,111,-1,85
1,<environment.Job instance at 0x7f9af413e320>,87,17,[4 8],88,-1,105,-1,88
1,<environment.Job instance at 0x7f9af3bebeb0>,90,22,[6 2],91,-1,113,-1,91
1,<environment.Job instance at 0x7f9af3c70dc0>,91,13,[ 5 10],92,-1,105,-1,92
1,<environment.Job instance at 0x7f9af345a820>,93,24,[3 7],94,-1,118,-1,94
1,<environment.Job instance at 0x7f9af4d4f780>,94,16,[10  1],95,-1,111,-1,95
1,<environment.Job instance at 0x7f9af4d4fb90>,95,18,[7 3],96,-1,114,-1,96
1,<environment.Job instance at 0x7f9af3f694b0>,99,18,[3 7],100,-1,118,-1,100
1,<environment.Job instance at 0x7f9af3c8db90>,105,18,[6 3],106,-1,133,-1,115
1,<environment.Job instance at 0x7f9af3a1b230>,115,25,[ 4 10],116,-1,141,-1,116
1,<environment.Job instance at 0x7f9afd6d7140>,113,15,[5 6],114,-1,132,-1,117
1,<environment.Job instance at 0x7f9afd6d7870>,116,13,[9 3],117,-1,142,-1,129
1,<environment.Job instance at 0x7f9af42edd20>,119,16,[ 3 12],120,-1,145,-1,129
1,<environment.Job instance at 0x7f9af42ed730>,126,18,[6 4],127,-1,147,-1,129
1,<environment.Job instance at 0x7f9af38f4960>,127,18,[ 5 10],128,-1,147,-1,129
1,<environment.Job instance at 0x7f9af3c8d4b0>,106,15,[14  5],107,-1,161,-1,146
1,<environment.Job instance at 0x7f9af3fdb0f0>,136,27,[10  5],137,-1,284,-1,257
1,<environment.Job instance at 0x7f9af4b727d0>,146,14,[13  3],147,-1,346,-1,332
1,<environment.Job instance at 0x7f9af3c7a140>,6,2,[12  3],7,-1,9,-1,7
1,<environment.Job instance at 0x7f9af39e0b90>,5,25,[10  3],6,-1,58,-1,33
1,<environment.Job instance at 0x7f9af3c89320>,14,3,[14  3],15,-1,36,-1,33
1,<environment.Job instance at 0x7f9af4c5a640>,19,15,[13  3],20,-1,53,-1,38
1,<environment.Job instance at 0x7f9af4c5a960>,20,24,[7 2],21,-1,62,-1,38
1,<environment.Job instance at 0x7f9af4c5a4b0>,22,25,[7 5],23,-1,66,-1,41
1,<environment.Job instance at 0x7f9af3edb640>,26,3,[12  5],27,-1,56,-1,53
1,<environment.Job instance at 0x7f9af44dc1e0>,42,24,[2 9],43,-1,180,-1,156
1,<environment.Job instance at 0x7f9af34bf140>,65,23,[1 8],66,-1,267,-1,244
1,<environment.Job instance at 0x7f9af4c250f0>,68,13,[ 5 13],69,-1,257,-1,244
1,<environment.Job instance at 0x7f9af4b54140>,72,3,[ 5 13],73,-1,251,-1,248
1,<environment.Job instance at 0x7f9af3cec140>,84,26,[8 5],85,-1,324,-1,298
1,<environment.Job instance at 0x7f9af3954050>,93,24,[3 7],94,-1,354,-1,330
1,<environment.Job instance at 0x7f9af3eded20>,101,3,[14  4],102,-1,353,-1,350
1,<environment.Job instance at 0x7f9af45e26e0>,102,16,[ 4 12],103,-1,366,-1,350
1,<environment.Job instance at 0x7f9af3c0c960>,106,15,[14  5],107,-1,369,-1,354
1,<environment.Job instance at 0x7f9af34943c0>,115,25,[ 4 10],116,-1,417,-1,392
1,<environment.Job instance at 0x7f9af3d71370>,119,16,[ 3 12],120,-1,423,-1,407
1,<environment.Job instance at 0x7f9af3d71c80>,128,2,[ 5 11],129,-1,429,-1,427
1,<environment.Job instance at 0x7f9af4949e60>,131,27,[4 5],132,-1,474,-1,447
1,<environment.Job instance at 0x7f9af3681b40>,136,27,[10  5],137,-1,505,-1,478
1,<environment.Job instance at 0x7f9af49dda00>,146,14,[13  3],147,-1,525,-1,511
1,<environment.Job instance at 0x7f9af46289b0>,159,2,[ 5 11],160,-1,551,-1,549
1,<environment.Job instance at 0x7f9af3931eb0>,3,17,[10  2],4,-1,22,-1,5
1,<environment.Job instance at 0x7f9af3931870>,5,18,[8 1],6,-1,24,-1,6
1,<environment.Job instance at 0x7f9af403f8c0>,7,17,[2 9],8,-1,25,-1,8
1,<environment.Job instance at 0x7f9af403f500>,8,27,[9 1],9,-1,36,-1,9
1,<environment.Job instance at 0x7f9af403f910>,9,12,[9 3],10,-1,22,-1,10
1,<environment.Job instance at 0x7f9af403f780>,12,22,[8 5],13,-1,35,-1,13
1,<environment.Job instance at 0x7f9af403fe10>,13,27,[6 5],14,-1,41,-1,14
1,<environment.Job instance at 0x7f9af3b6df50>,15,26,[6 1],16,-1,42,-1,16
1,<environment.Job instance at 0x7f9af3b6d0a0>,16,16,[10  2],17,-1,34,-1,18
1,<environment.Job instance at 0x7f9af4b69af0>,18,15,[5 7],19,-1,34,-1,19
1,<environment.Job instance at 0x7f9af4b690a0>,19,14,[9 3],20,-1,34,-1,20
1,<environment.Job instance at 0x7f9af4b69500>,20,26,[4 5],21,-1,47,-1,21
1,<environment.Job instance at 0x7f9af4b69460>,21,16,[7 3],22,-1,38,-1,22
1,<environment.Job instance at 0x7f9af3931af0>,23,17,[9 1],24,-1,41,-1,24
1,<environment.Job instance at 0x7f9af4b69c80>,25,18,[8 2],26,-1,44,-1,26
1,<environment.Job instance at 0x7f9af3b6d870>,17,15,[7 3],18,-1,42,-1,27
1,<environment.Job instance at 0x7f9af44ee550>,34,17,[7 5],35,-1,52,-1,35
1,<environment.Job instance at 0x7f9af40331e0>,36,14,[ 4 10],37,-1,51,-1,37
1,<environment.Job instance at 0x7f9af40f8870>,43,16,[1 8],44,-1,61,-1,45
1,<environment.Job instance at 0x7f9afd94d730>,45,15,[4 8],46,-1,61,-1,46
1,<environment.Job instance at 0x7f9af45cd4b0>,47,25,[9 5],48,-1,73,-1,48
1,<environment.Job instance at 0x7f9af45d0640>,50,15,[2 9],51,-1,66,-1,51
1,<environment.Job instance at 0x7f9af40f8eb0>,41,2,[1 6],42,-1,58,-1,56
1,<environment.Job instance at 0x7f9af45fea00>,55,15,[ 3 14],56,-1,72,-1,57
1,<environment.Job instance at 0x7f9af416f9b0>,58,15,[ 5 14],59,-1,75,-1,60
1,<environment.Job instance at 0x7f9af497c0a0>,44,15,[9 3],45,-1,76,-1,61
1,<environment.Job instance at 0x7f9af416f1e0>,60,14,[1 8],61,-1,76,-1,62
1,<environment.Job instance at 0x7f9af40f89b0>,42,16,[2 9],43,-1,79,-1,63
1,<environment.Job instance at 0x7f9af416f4b0>,57,12,[5 6],58,-1,75,-1,63
1,<environment.Job instance at 0x7f9af416f460>,63,15,[4 9],64,-1,79,-1,64
1,<environment.Job instance at 0x7f9af44ef140>,61,14,[9 1],62,-1,83,-1,69
1,<environment.Job instance at 0x7f9af44efe10>,65,14,[6 2],66,-1,83,-1,69
1,<environment.Job instance at 0x7f9af3672cd0>,68,27,[4 6],69,-1,96,-1,69
1,<environment.Job instance at 0x7f9af41310a0>,74,14,[10  2],75,-1,97,-1,83
1,<environment.Job instance at 0x7f9af3c72190>,81,18,[1 6],82,-1,101,-1,83
1,<environment.Job instance at 0x7f9af36221e0>,82,17,[5 2],83,-1,101,-1,84
1,<environment.Job instance at 0x7f9af42acb90>,85,18,[5 8],86,-1,104,-1,86
1,<environment.Job instance at 0x7f9af42ac5f0>,87,16,[3 5],88,-1,104,-1,88
1,<environment.Job instance at 0x7f9af46892d0>,89,18,[5 6],90,-1,108,-1,90
1,<environment.Job instance at 0x7f9af42ac460>,83,14,[8 5],84,-1,112,-1,98
1,<environment.Job instance at 0x7f9af4d4b690>,92,16,[ 2 13],93,-1,115,-1,99
1,<environment.Job instance at 0x7f9af466e550>,95,16,[2 7],96,-1,115,-1,99
1,<environment.Job instance at 0x7f9af49dda00>,8,27,[9 1],9,-1,51,-1,24
1,<environment.Job instance at 0x7f9af3733960>,11,16,[14  3],12,-1,40,-1,24
1,<environment.Job instance at 0x7f9afd9bd3c0>,13,27,[6 5],14,-1,51,-1,24
1,<environment.Job instance at 0x7f9af4920140>,15,26,[6 1],16,-1,50,-1,24
1,<environment.Job instance at 0x7f9af3edbcd0>,20,26,[4 5],21,-1,73,-1,47
1,<environment.Job instance at 0x7f9af3fa3190>,27,15,[12  1],28,-1,85,-1,70
1,<environment.Job instance at 0x7f9af3edb280>,29,23,[4 6],30,-1,103,-1,80
1,<environment.Job instance at 0x7f9af493a870>,30,1,[ 2 14],31,-1,81,-1,80
1,<environment.Job instance at 0x7f9af4640370>,48,2,[ 1 13],49,-1,153,-1,151
1,<environment.Job instance at 0x7f9af4640140>,47,25,[9 5],48,-1,177,-1,152
1,<environment.Job instance at 0x7f9af36e1230>,55,15,[ 3 14],56,-1,184,-1,169
1,<environment.Job instance at 0x7f9af3fcc960>,58,15,[ 5 14],59,-1,185,-1,170
1,<environment.Job instance at 0x7f9af4798d20>,67,2,[ 1 11],68,-1,211,-1,209
1,<environment.Job instance at 0x7f9af4be0690>,68,27,[4 6],69,-1,239,-1,212
1,<environment.Job instance at 0x7f9af4872910>,90,26,[ 5 14],91,-1,299,-1,273
1,<environment.Job instance at 0x7f9af3fe9f50>,92,16,[ 2 13],93,-1,293,-1,277
1,<environment.Job instance at 0x7f9af3fe9a50>,93,27,[2 5],94,-1,304,-1,277
1,<environment.Job instance at 0x7f9af33d9140>,110,28,[5 3],111,-1,367,-1,339
1,<environment.Job instance at 0x7f9af4422be0>,113,1,[13  4],114,-1,343,-1,342
1,<environment.Job instance at 0x7f9af33c9dc0>,133,27,[6 3],134,-1,462,-1,435
1,<environment.Job instance at 0x7f9af3a82d20>,140,2,[11  1],141,-1,442,-1,440
1,<environment.Job instance at 0x7f9af3a1c9b0>,149,28,[3 9],150,-1,511,-1,483
1,<environment.Job instance at 0x7f9af4d3d7d0>,152,12,[13  5],153,-1,503,-1,491
1,<environment.Job instance at 0x7f9af38d77d0>,155,25,[10  4],156,-1,537,-1,512
1,<environment.Job instance at 0x7f9af4507b90>,165,28,[5 2],166,-1,576,-1,548
1,<environment.Job instance at 0x7f9af4d4ce60>,6,13,[9 2],7,-1,20,-1,7
1,<environment.Job instance at 0x7f9af4d4cb90>,7,17,[2 8],8,-1,25,-1,8
1,<environment.Job instance at 0x7f9af4d4c730>,8,14,[4 8],9,-1,23,-1,9
1,<environment.Job instance at 0x7f9af4d4cdc0>,10,13,[9 1],11,-1,27,-1,14
1,<environment.Job instance at 0x7f9af4d4c690>,14,16,[12  4],15,-1,31,-1,15
1,<environment.Job instance at 0x7f9afd374e60>,16,15,[7 1],17,-1,32,-1,17
1,<environment.Job instance at 0x7f9afd374fa0>,17,13,[ 5 10],18,-1,31,-1,18
1,<environment.Job instance at 0x7f9afd374dc0>,18,16,[11  4],19,-1,35,-1,19
1,<environment.Job instance at 0x7f9afd374820>,23,26,[9 5],24,-1,50,-1,24
1,<environment.Job instance at 0x7f9afd3748c0>,28,16,[12  5],29,-1,46,-1,30
1,<environment.Job instance at 0x7f9afd374960>,29,25,[4 9],30,-1,55,-1,30
1,<environment.Job instance at 0x7f9afd374d70>,31,16,[1 8],32,-1,55,-1,39
1,<environment.Job instance at 0x7f9af4808500>,32,16,[ 5 10],33,-1,55,-1,39
1,<environment.Job instance at 0x7f9af4808320>,37,18,[7 4],38,-1,67,-1,49
1,<environment.Job instance at 0x7f9af4940c80>,40,14,[10  2],41,-1,63,-1,49
1,<environment.Job instance at 0x7f9af363c500>,45,17,[5 3],46,-1,81,-1,64
1,<environment.Job instance at 0x7f9af363c230>,49,17,[8 4],50,-1,81,-1,64
1,<environment.Job instance at 0x7f9af4d4c7d0>,13,16,[1 7],14,-1,80,-1,64
1,<environment.Job instance at 0x7f9af49405f0>,44,19,[3 6],45,-1,83,-1,64
1,<environment.Job instance at 0x7f9afd3740a0>,22,15,[4 5],23,-1,79,-1,64
1,<environment.Job instance at 0x7f9af3cabfa0>,56,16,[6 2],57,-1,80,-1,64
1,<environment.Job instance at 0x7f9af363c6e0>,51,16,[3 6],52,-1,80,-1,64
1,<environment.Job instance at 0x7f9af3cab230>,59,12,[3 8],60,-1,76,-1,64
1,<environment.Job instance at 0x7f9af3cab5f0>,61,15,[5 5],62,-1,79,-1,64
1,<environment.Job instance at 0x7f9af3cab910>,62,16,[3 5],63,-1,80,-1,64
1,<environment.Job instance at 0x7f9af3cabaa0>,63,18,[8 4],64,-1,82,-1,64
1,<environment.Job instance at 0x7f9af3c70c30>,66,14,[6 5],67,-1,81,-1,67
1,<environment.Job instance at 0x7f9af3c70b90>,67,13,[9 3],68,-1,81,-1,68
1,<environment.Job instance at 0x7f9af3c70910>,68,15,[7 4],69,-1,84,-1,69
1,<environment.Job instance at 0x7f9af3cab5a0>,58,14,[3 7],59,-1,92,-1,78
1,<environment.Job instance at 0x7f9af3c705f0>,84,17,[ 3 11],85,-1,122,-1,105
1,<environment.Job instance at 0x7f9af3c70b40>,85,16,[9 5],86,-1,121,-1,105
1,<environment.Job instance at 0x7f9af3fa9c30>,86,24,[8 4],87,-1,129,-1,105
1,<environment.Job instance at 0x7f9af3fa97d0>,87,17,[8 3],88,-1,123,-1,106
1,<environment.Job instance at 0x7f9af3fa95f0>,94,22,[10  1],95,-1,129,-1,107
1,<environment.Job instance at 0x7f9af4ccd9b0>,97,17,[12  1],98,-1,133,-1,116
1,<environment.Job instance at 0x7f9af363c8c0>,50,15,[4 8],51,-1,131,-1,116
1,<environment.Job instance at 0x7f9af4ccd370>,100,18,[1 5],101,-1,136,-1,118
1,<environment.Job instance at 0x7f9af4ccd410>,99,15,[3 5],100,-1,133,-1,118
1,<environment.Job instance at 0x7f9af4ccd730>,101,12,[7 4],102,-1,130,-1,118
1,<environment.Job instance at 0x7f9af4ccdd70>,102,15,[ 2 13],103,-1,133,-1,118
1,<environment.Job instance at 0x7f9af363c730>,52,12,[11  5],53,-1,134,-1,122
1,<environment.Job instance at 0x7f9af4ccd8c0>,98,15,[ 3 10],99,-1,137,-1,122
1,<environment.Job instance at 0x7f9af48c3640>,114,16,[8 3],115,-1,138,-1,122
1,<environment.Job instance at 0x7f9af459b190>,115,18,[5 9],116,-1,142,-1,124
1,<environment.Job instance at 0x7f9af48c3c80>,109,17,[5 3],110,-1,141,-1,124
1,<environment.Job instance at 0x7f9af490fa00>,119,17,[ 2 13],120,-1,141,-1,124
1,<environment.Job instance at 0x7f9af3985320>,121,13,[8 4],122,-1,137,-1,124
1,<environment.Job instance at 0x7f9af45adc80>,112,28,[9 3],113,-1,152,-1,124
1,<environment.Job instance at 0x7f9af4ccd7d0>,122,15,[4 5],123,-1,139,-1,124
1,<environment.Job instance at 0x7f9af3c7bfa0>,117,14,[7 2],118,-1,138,-1,124
1,<environment.Job instance at 0x7f9af3c700f0>,70,15,[2 7],71,-1,140,-1,125
1,<environment.Job instance at 0x7f9af4ccd0f0>,124,14,[5 3],125,-1,139,-1,125
1,<environment.Job instance at 0x7f9af4ccd190>,123,13,[10  4],124,-1,138,-1,125
1,<environment.Job instance at 0x7f9af4bfe280>,130,17,[10  3],131,-1,151,-1,134
1,<environment.Job instance at 0x7f9af4bfe140>,134,18,[5 8],135,-1,153,-1,135
1,<environment.Job instance at 0x7f9af4bfe960>,136,12,[9 2],137,-1,149,-1,137
1,<environment.Job instance at 0x7f9af4bfee60>,137,27,[9 3],138,-1,165,-1,138
1,<environment.Job instance at 0x7f9af4bfe190>,139,16,[14  4],140,-1,158,-1,142
1,<environment.Job instance at 0x7f9af4bfeb40>,135,12,[2 7],136,-1,155,-1,143
1,<environment.Job instance at 0x7f9af3bd1b40>,145,15,[10  4],146,-1,163,-1,148
1,<environment.Job instance at 0x7f9af3bd1a50>,146,18,[1 6],147,-1,166,-1,148
1,<environment.Job instance at 0x7f9af4927f50>,14,16,[12  4],15,-1,49,-1,33
1,<environment.Job instance at 0x7f9af48c39b0>,18,16,[11  4],19,-1,54,-1,38
1,<environment.Job instance at 0x7f9af4ccd550>,23,26,[9 5],24,-1,78,-1,52
1,<environment.Job instance at 0x7f9af4bfe2d0>,26,3,[ 2 12],27,-1,57,-1,54
1,<environment.Job instance at 0x7f9af3bd10a0>,28,16,[12  5],29,-1,70,-1,54
1,<environment.Job instance at 0x7f9af4bfe870>,29,25,[4 9],30,-1,81,-1,56
1,<environment.Job instance at 0x7f9af411e4b0>,33,2,[ 3 12],34,-1,68,-1,66
1,<environment.Job instance at 0x7f9af4906dc0>,39,18,[14  4],40,-1,105,-1,87
1,<environment.Job instance at 0x7f9af44add20>,41,13,[ 2 13],42,-1,102,-1,89
1,<environment.Job instance at 0x7f9af44ad550>,42,3,[ 2 14],43,-1,92,-1,89
1,<environment.Job instance at 0x7f9af3a82870>,52,12,[11  5],53,-1,135,-1,123
1,<environment.Job instance at 0x7f9af3f02c30>,79,13,[11  2],80,-1,245,-1,232
1,<environment.Job instance at 0x7f9af3fcc230>,82,2,[ 5 13],83,-1,244,-1,242
1,<environment.Job instance at 0x7f9af3fcc460>,84,17,[ 3 11],85,-1,261,-1,244
1,<environment.Job instance at 0x7f9af36e1280>,86,24,[8 4],87,-1,273,-1,249
1,<environment.Job instance at 0x7f9af3beddc0>,93,1,[ 5 11],94,-1,266,-1,265
1,<environment.Job instance at 0x7f9af3b942d0>,97,17,[12  1],98,-1,285,-1,268
1,<environment.Job instance at 0x7f9af3fa3190>,102,15,[ 2 13],103,-1,302,-1,287
1,<environment.Job instance at 0x7f9af361b870>,105,1,[14  4],106,-1,300,-1,299
1,<environment.Job instance at 0x7f9af3733190>,112,28,[9 3],113,-1,346,-1,318
1,<environment.Job instance at 0x7f9af4d4bb90>,119,17,[ 2 13],120,-1,349,-1,332
1,<environment.Job instance at 0x7f9af45d04b0>,125,18,[14  5],126,-1,380,-1,362
1,<environment.Job instance at 0x7f9af45d0320>,127,3,[12  1],128,-1,376,-1,373
1,<environment.Job instance at 0x7f9af3c7a780>,137,27,[9 3],138,-1,445,-1,418
1,<environment.Job instance at 0x7f9af3c7af50>,139,16,[14  4],140,-1,434,-1,418
1,<environment.Job instance at 0x7f9af3c7ac30>,140,3,[ 3 13],141,-1,421,-1,418
1,<environment.Job instance at 0x7f9af3872050>,160,1,[ 1 11],161,-1,509,-1,508
1,<environment.Job instance at 0x7f9af3872dc0>,170,3,[14  3],171,-1,557,-1,554
1,<environment.Job instance at 0x7f9af38b0050>,4,16,[10  5],5,-1,21,-1,5
1,<environment.Job instance at 0x7f9af4df70a0>,6,16,[ 2 10],7,-1,23,-1,7
1,<environment.Job instance at 0x7f9af4df75f0>,9,16,[3 8],10,-1,26,-1,10
1,<environment.Job instance at 0x7f9af4df77d0>,10,15,[7 3],11,-1,26,-1,11
1,<environment.Job instance at 0x7f9af4df75a0>,11,18,[4 9],12,-1,30,-1,12
1,<environment.Job instance at 0x7f9af3aab190>,15,14,[4 7],16,-1,32,-1,18
1,<environment.Job instance at 0x7f9af3aab500>,18,13,[9 1],19,-1,32,-1,19
1,<environment.Job instance at 0x7f9af3aabcd0>,19,2,[10  4],20,-1,22,-1,20
1,<environment.Job instance at 0x7f9af3aabb40>,20,2,[10  1],21,-1,23,-1,21
1,<environment.Job instance at 0x7f9af3aab410>,21,14,[4 7],22,-1,36,-1,22
1,<environment.Job instance at 0x7f9af3aab280>,22,17,[ 5 13],23,-1,40,-1,23
1,<environment.Job instance at 0x7f9af3aabc80>,23,12,[ 5 12],24,-1,36,-1,24
1,<environment.Job instance at 0x7f9af3aab550>,24,17,[5 4],25,-1,42,-1,25
1,<environment.Job instance at 0x7f9af3aab320>,25,3,[6 3],26,-1,29,-1,26
1,<environment.Job instance at 0x7f9af3d0af00>,26,18,[6 5],27,-1,45,-1,27
1,<environment.Job instance at 0x7f9af3cee910>,27,14,[10  5],28,-1,42,-1,28
1,<environment.Job instance at 0x7f9af348f550>,28,3,[8 5],29,-1,32,-1,29
1,<environment.Job instance at 0x7f9af42a4550>,29,1,[3 7],30,-1,31,-1,30
1,<environment.Job instance at 0x7f9af4503e10>,30,13,[1 7],31,-1,44,-1,31
1,<environment.Job instance at 0x7f9af474e5f0>,32,16,[5 8],33,-1,49,-1,33
1,<environment.Job instance at 0x7f9af3aabd20>,17,18,[ 5 13],18,-1,51,-1,33
1,<environment.Job instance at 0x7f9af3cf3a00>,33,22,[7 2],34,-1,58,-1,36
1,<environment.Job instance at 0x7f9af4c37690>,35,16,[7 2],36,-1,52,-1,36
1,<environment.Job instance at 0x7f9af4c37550>,39,3,[7 1],40,-1,43,-1,40
1,<environment.Job instance at 0x7f9af4c37f50>,43,15,[5 5],44,-1,59,-1,44
1,<environment.Job instance at 0x7f9af4407780>,44,13,[ 2 10],45,-1,61,-1,48
1,<environment.Job instance at 0x7f9afd883dc0>,49,14,[1 9],50,-1,64,-1,50
1,<environment.Job instance at 0x7f9af4449460>,50,14,[7 3],51,-1,65,-1,51
1,<environment.Job instance at 0x7f9af4449320>,51,16,[2 9],52,-1,68,-1,52
1,<environment.Job instance at 0x7f9af4449140>,52,16,[5 4],53,-1,69,-1,53
1,<environment.Job instance at 0x7f9af4449f00>,53,19,[7 4],54,-1,73,-1,54
1,<environment.Job instance at 0x7f9af4449370>,54,18,[9 3],55,-1,73,-1,55
1,<environment.Job instance at 0x7f9afd94a0a0>,56,14,[10  3],57,-1,79,-1,65
1,<environment.Job instance at 0x7f9afd8838c0>,47,18,[9 5],48,-1,84,-1,66
1,<environment.Job instance at 0x7f9af445a5f0>,67,17,[9 1],68,-1,85,-1,68
1,<environment.Job instance at 0x7f9af3490320>,63,15,[6 1],64,-1,86,-1,71
1,<environment.Job instance at 0x7f9af45735f0>,55,26,[ 2 12],56,-1,97,-1,71
1,<environment.Job instance at 0x7f9af445a0a0>,68,17,[2 5],69,-1,88,-1,71
1,<environment.Job instance at 0x7f9af4af5960>,73,18,[9 5],74,-1,109,-1,91
1,<environment.Job instance at 0x7f9af4af5c30>,72,1,[ 1 10],73,-1,92,-1,91
1,<environment.Job instance at 0x7f9afd883d70>,46,18,[5 5],47,-1,109,-1,91
1,<environment.Job instance at 0x7f9af33ee280>,70,22,[13  5],71,-1,114,-1,92
1,<environment.Job instance at 0x7f9af4af5b90>,77,17,[4 6],78,-1,110,-1,93
1,<environment.Job instance at 0x7f9af49c8aa0>,84,16,[8 4],85,-1,109,-1,93
1,<environment.Job instance at 0x7f9af49c8e10>,82,12,[ 4 10],83,-1,107,-1,95
1,<environment.Job instance at 0x7f9af49b1050>,89,15,[9 1],90,-1,110,-1,95
1,<environment.Job instance at 0x7f9af47ccd70>,90,22,[10  2],91,-1,117,-1,95
1,<environment.Job instance at 0x7f9af46a2050>,91,18,[ 1 10],92,-1,114,-1,96
1,<environment.Job instance at 0x7f9af3c7b280>,93,16,[10  5],94,-1,124,-1,108
1,<environment.Job instance at 0x7f9af42fac80>,94,17,[3 9],95,-1,126,-1,109
1,<environment.Job instance at 0x7f9af4a561e0>,88,14,[ 2 14],89,-1,123,-1,109
1,<environment.Job instance at 0x7f9af4d5cfa0>,92,14,[4 7],93,-1,123,-1,109
1,<environment.Job instance at 0x7f9af4456280>,98,12,[ 4 12],99,-1,122,-1,110
1,<environment.Job instance at 0x7f9af4456be0>,99,15,[2 6],100,-1,125,-1,110
1,<environment.Job instance at 0x7f9af4c87af0>,97,17,[ 4 11],98,-1,127,-1,110
1,<environment.Job instance at 0x7f9af3da2f00>,102,17,[6 4],103,-1,128,-1,111
1,<environment.Job instance at 0x7f9af4456140>,100,2,[1 7],101,-1,118,-1,116
1,<environment.Job instance at 0x7f9af45ddaf0>,105,17,[5 9],106,-1,137,-1,120
1,<environment.Job instance at 0x7f9af45ddc30>,106,16,[ 5 14],107,-1,136,-1,120
1,<environment.Job instance at 0x7f9af4975410>,101,21,[ 5 10],102,-1,141,-1,120
1,<environment.Job instance at 0x7f9af4bbebe0>,107,17,[10  1],108,-1,137,-1,120
1,<environment.Job instance at 0x7f9af3c25910>,108,15,[3 6],109,-1,135,-1,120
1,<environment.Job instance at 0x7f9af34b6870>,109,22,[2 7],110,-1,143,-1,121
1,<environment.Job instance at 0x7f9af3c5b2d0>,110,15,[10  3],111,-1,137,-1,122
1,<environment.Job instance at 0x7f9af3ba2f00>,111,14,[13  1],112,-1,137,-1,123
1,<environment.Job instance at 0x7f9af3ba2a00>,114,14,[5 1],115,-1,137,-1,123
1,<environment.Job instance at 0x7f9af3c5b0a0>,112,19,[1 6],113,-1,142,-1,123
1,<environment.Job instance at 0x7f9af3cadc80>,118,17,[5 8],119,-1,140,-1,123
1,<environment.Job instance at 0x7f9af3cad640>,120,16,[8 5],121,-1,140,-1,124
1,<environment.Job instance at 0x7f9af3cad6e0>,122,16,[5 8],123,-1,140,-1,124
1,<environment.Job instance at 0x7f9af3cad0f0>,124,28,[8 3],125,-1,153,-1,125
1,<environment.Job instance at 0x7f9af3bc44b0>,127,22,[4 7],128,-1,151,-1,129
1,<environment.Job instance at 0x7f9af3ae0500>,128,27,[6 4],129,-1,158,-1,131
1,<environment.Job instance at 0x7f9af475a0a0>,140,18,[3 7],141,-1,159,-1,141
1,<environment.Job instance at 0x7f9af475a1e0>,139,17,[5 2],140,-1,160,-1,143
1,<environment.Job instance at 0x7f9af475a7d0>,143,13,[8 2],144,-1,158,-1,145
1,<environment.Job instance at 0x7f9af41475a0>,144,14,[1 7],145,-1,160,-1,146
1,<environment.Job instance at 0x7f9af4147be0>,146,24,[5 6],147,-1,171,-1,147
1,<environment.Job instance at 0x7f9af4147af0>,147,14,[6 2],148,-1,164,-1,150
1,<environment.Job instance at 0x7f9af41470f0>,151,18,[ 5 10],152,-1,170,-1,152
1,<environment.Job instance at 0x7f9af4147eb0>,154,12,[10  3],155,-1,167,-1,155
1,<environment.Job instance at 0x7f9af41472d0>,152,25,[ 5 11],153,-1,185,-1,160
1,<environment.Job instance at 0x7f9af40633c0>,159,15,[ 5 10],160,-1,175,-1,160
1,<environment.Job instance at 0x7f9af4063af0>,157,18,[8 1],158,-1,178,-1,160
1,<environment.Job instance at 0x7f9af4063690>,158,13,[2 8],159,-1,174,-1,161
1,<environment.Job instance at 0x7f9af4b860f0>,162,21,[5 6],163,-1,186,-1,165
1,<environment.Job instance at 0x7f9af4b86050>,170,17,[9 3],171,-1,188,-1,171
1,<environment.Job instance at 0x7f9af4b86820>,163,13,[ 3 13],164,-1,190,-1,177
1,<environment.Job instance at 0x7f9af3a1e870>,175,15,[2 8],176,-1,192,-1,177
1,<environment.Job instance at 0x7f9af3a1e0f0>,176,15,[4 6],177,-1,193,-1,178
1,<environment.Job instance at 0x7f9af3a1e190>,179,18,[7 4],180,-1,201,-1,183
1,<environment.Job instance at 0x7f9af489edc0>,61,21,[ 5 14],62,-1,207,-1,186
1,<environment.Job instance at 0x7f9af3a1e910>,178,12,[9 4],179,-1,198,-1,186
1,<environment.Job instance at 0x7f9af4e35e60>,186,15,[5 5],187,-1,202,-1,187
1,<environment.Job instance at 0x7f9af4b86870>,16,1,[ 5 14],17,-1,35,-1,34
1,<environment.Job instance at 0x7f9af3c7a910>,17,18,[ 5 13],18,-1,52,-1,34
1,<environment.Job instance at 0x7f9af3c7a410>,22,17,[ 5 13],23,-1,70,-1,53
1,<environment.Job instance at 0x7f9af3c7ab90>,23,12,[ 5 12],24,-1,65,-1,53
1,<environment.Job instance at 0x7f9af439beb0>,41,18,[14  1],42,-1,137,-1,119
1,<environment.Job instance at 0x7f9af3ad6eb0>,48,18,[ 1 13],49,-1,163,-1,145
1,<environment.Job instance at 0x7f9af3adc2d0>,55,26,[ 2 12],56,-1,211,-1,185
1,<environment.Job instance at 0x7f9af37e9cd0>,61,21,[ 5 14],62,-1,226,-1,205
1,<environment.Job instance at 0x7f9af3acf500>,62,1,[ 4 14],63,-1,206,-1,205
1,<environment.Job instance at 0x7f9af355beb0>,70,22,[13  5],71,-1,266,-1,244
1,<environment.Job instance at 0x7f9af354e9b0>,79,2,[ 3 11],80,-1,267,-1,265
1,<environment.Job instance at 0x7f9af35559b0>,88,14,[ 2 14],89,-1,303,-1,289
1,<environment.Job instance at 0x7f9af3548140>,97,17,[ 4 11],98,-1,364,-1,347
1,<environment.Job instance at 0x7f9af3575050>,98,12,[ 4 12],99,-1,359,-1,347
1,<environment.Job instance at 0x7f9af3560410>,106,16,[ 5 14],107,-1,381,-1,365
1,<environment.Job instance at 0x7f9af3c6ceb0>,111,14,[13  1],112,-1,410,-1,396
1,<environment.Job instance at 0x7f9af3c6eaa0>,124,28,[8 3],125,-1,493,-1,465
1,<environment.Job instance at 0x7f9af4cc23c0>,128,27,[6 4],129,-1,492,-1,465
1,<environment.Job instance at 0x7f9af3c47410>,146,24,[5 6],147,-1,527,-1,503
1,<environment.Job instance at 0x7f9af3add0a0>,152,25,[ 5 11],153,-1,545,-1,520
1,<environment.Job instance at 0x7f9af45fab90>,163,13,[ 3 13],164,-1,575,-1,562
1,<environment.Job instance at 0x7f9af3c3b910>,1,15,[9 1],2,-1,19,-1,4
1,<environment.Job instance at 0x7f9af3c3b320>,5,18,[3 5],6,-1,24,-1,6
1,<environment.Job instance at 0x7f9af3c3b2d0>,6,27,[4 9],7,-1,34,-1,7
1,<environment.Job instance at 0x7f9af3c3bfa0>,8,15,[2 9],9,-1,24,-1,9
1,<environment.Job instance at 0x7f9af3c3b7d0>,9,17,[1 9],10,-1,27,-1,10
1,<environment.Job instance at 0x7f9af3c3b3c0>,11,18,[8 3],12,-1,30,-1,12
1,<environment.Job instance at 0x7f9af3c3bc30>,12,16,[4 9],13,-1,29,-1,13
1,<environment.Job instance at 0x7f9af3ae0a50>,22,16,[6 1],23,-1,39,-1,23
1,<environment.Job instance at 0x7f9af3699780>,24,18,[1 6],25,-1,43,-1,25
1,<environment.Job instance at 0x7f9af3f15cd0>,26,12,[10  3],27,-1,60,-1,48
1,<environment.Job instance at 0x7f9af3d00a00>,34,15,[8 1],35,-1,63,-1,48
1,<environment.Job instance at 0x7f9af44ec780>,32,13,[ 4 11],33,-1,61,-1,48
1,<environment.Job instance at 0x7f9af3d22960>,37,15,[5 2],38,-1,63,-1,48
1,<environment.Job instance at 0x7f9af4147960>,38,15,[3 7],39,-1,63,-1,48
1,<environment.Job instance at 0x7f9af3f155a0>,29,18,[4 9],30,-1,66,-1,48
1,<environment.Job instance at 0x7f9af3d31be0>,41,15,[ 4 10],42,-1,64,-1,49
1,<environment.Job instance at 0x7f9af3d317d0>,42,18,[4 6],43,-1,67,-1,49
1,<environment.Job instance at 0x7f9af3d31b40>,43,14,[12  2],44,-1,63,-1,49
1,<environment.Job instance at 0x7f9af44ec0a0>,33,14,[5 1],34,-1,63,-1,49
1,<environment.Job instance at 0x7f9af3d22a50>,40,15,[5 4],41,-1,64,-1,49
1,<environment.Job instance at 0x7f9af3d221e0>,39,12,[6 3],40,-1,61,-1,49
1,<environment.Job instance at 0x7f9af3d31b90>,48,12,[5 3],49,-1,61,-1,49
1,<environment.Job instance at 0x7f9af3ae0190>,16,24,[8 3],17,-1,73,-1,49
1,<environment.Job instance at 0x7f9af3b8d320>,49,12,[5 9],50,-1,62,-1,50
1,<environment.Job instance at 0x7f9af3b8d640>,50,15,[7 1],51,-1,66,-1,51
1,<environment.Job instance at 0x7f9af3d31eb0>,51,16,[1 5],52,-1,68,-1,52
1,<environment.Job instance at 0x7f9af3d31a00>,47,18,[9 5],48,-1,73,-1,55
1,<environment.Job instance at 0x7f9af3b8dfa0>,53,13,[9 4],54,-1,68,-1,55
1,<environment.Job instance at 0x7f9af3b8df50>,55,14,[ 3 10],56,-1,70,-1,56
1,<environment.Job instance at 0x7f9af3625870>,57,23,[8 5],58,-1,81,-1,58
1,<environment.Job instance at 0x7f9af4c7d7d0>,59,15,[ 5 10],60,-1,75,-1,60
1,<environment.Job instance at 0x7f9af4cd9c80>,69,17,[6 1],70,-1,90,-1,73
1,<environment.Job instance at 0x7f9af4cd90a0>,71,14,[6 3],72,-1,88,-1,74
1,<environment.Job instance at 0x7f9af4cd9fa0>,70,17,[ 5 10],71,-1,92,-1,75
1,<environment.Job instance at 0x7f9af4cd9780>,75,22,[ 4 13],76,-1,183,-1,161
1,<environment.Job instance at 0x7f9af4cd9500>,76,18,[10  1],77,-1,179,-1,161
1,<environment.Job instance at 0x7f9af3bafd20>,90,12,[5 3],91,-1,173,-1,161
1,<environment.Job instance at 0x7f9af4cd91e0>,72,12,[ 3 10],73,-1,173,-1,161
1,<environment.Job instance at 0x7f9af439b0a0>,95,16,[9 2],96,-1,177,-1,161
1,<environment.Job instance at 0x7f9af42cdeb0>,97,12,[7 5],98,-1,173,-1,161
1,<environment.Job instance at 0x7f9af3baf730>,92,15,[5 6],93,-1,176,-1,161
1,<environment.Job instance at 0x7f9af47c2140>,100,18,[12  5],101,-1,179,-1,161
1,<environment.Job instance at 0x7f9af3d394b0>,108,17,[1 8],109,-1,205,-1,188
1,<environment.Job instance at 0x7f9af33eee60>,112,16,[2 5],113,-1,211,-1,195
1,<environment.Job instance at 0x7f9af42f76e0>,114,16,[5 5],115,-1,211,-1,195
1,<environment.Job instance at 0x7f9af42f7460>,115,28,[8 3],116,-1,223,-1,195
1,<environment.Job instance at 0x7f9af3d31370>,0,17,[ 4 12],1,-1,18,-1,1
1,<environment.Job instance at 0x7f9af42f7f50>,6,27,[4 9],7,-1,44,-1,17
1,<environment.Job instance at 0x7f9af33fb190>,15,13,[11  5],16,-1,48,-1,35
1,<environment.Job instance at 0x7f9af33e4a00>,16,24,[8 3],17,-1,62,-1,38
1,<environment.Job instance at 0x7f9af33e4d20>,18,12,[ 4 11],19,-1,50,-1,38
1,<environment.Job instance at 0x7f9af33e4640>,21,3,[ 3 11],22,-1,50,-1,47
1,<environment.Job instance at 0x7f9af45beaf0>,32,13,[ 4 11],33,-1,106,-1,93
1,<environment.Job instance at 0x7f9af458baa0>,43,14,[12  2],44,-1,155,-1,141
1,<environment.Job instance at 0x7f9af45777d0>,57,23,[8 5],58,-1,230,-1,207
1,<environment.Job instance at 0x7f9af36b35a0>,60,1,[14  2],61,-1,209,-1,208
1,<environment.Job instance at 0x7f9af39c52d0>,62,13,[ 2 14],63,-1,222,-1,209
1,<environment.Job instance at 0x7f9af36b0780>,64,25,[1 9],65,-1,249,-1,224
1,<environment.Job instance at 0x7f9af47b0d20>,75,22,[ 4 13],76,-1,265,-1,243
1,<environment.Job instance at 0x7f9af3f32320>,91,3,[12  1],92,-1,307,-1,304
1,<environment.Job instance at 0x7f9af45db4b0>,100,18,[12  5],101,-1,354,-1,336
1,<environment.Job instance at 0x7f9af42d5e10>,103,14,[ 4 11],104,-1,359,-1,345
1,<environment.Job instance at 0x7f9af4306730>,107,25,[ 2 11],108,-1,385,-1,360
1,<environment.Job instance at 0x7f9af3def0a0>,109,18,[14  1],110,-1,381,-1,363
1,<environment.Job instance at 0x7f9af4737280>,111,1,[12  5],112,-1,364,-1,363
1,<environment.Job instance at 0x7f9af487d320>,115,28,[8 3],116,-1,422,-1,394
1,<environment.Job instance at 0x7f9af487dc30>,116,13,[14  3],117,-1,407,-1,394
1,<environment.Job instance at 0x7f9af4c4e6e0>,123,26,[5 5],124,-1,443,-1,417
1,<environment.Job instance at 0x7f9af3672e10>,130,14,[12  5],131,-1,459,-1,445
1,<environment.Job instance at 0x7f9af4573230>,135,25,[8 4],136,-1,493,-1,468
1,<environment.Job instance at 0x7f9af487ff50>,136,26,[5 5],137,-1,494,-1,468
1,<environment.Job instance at 0x7f9af4cd7870>,150,1,[ 3 11],151,-1,500,-1,499
1,<environment.Job instance at 0x7f9afd883f00>,153,14,[ 3 12],154,-1,531,-1,517
1,<environment.Job instance at 0x7f9af438d8c0>,161,23,[5 8],162,-1,581,-1,558
1,<environment.Job instance at 0x7f9af47da6e0>,164,3,[ 5 11],165,-1,561,-1,558
1,<environment.Job instance at 0x7f9af37ec8c0>,165,17,[14  2],166,-1,575,-1,558
1,<environment.Job instance at 0x7f9af37df780>,172,24,[5 5],179,-1,618,-1,594
1,<environment.Job instance at 0x7f9af4cc7280>,173,28,[6 2],187,-1,622,-1,594
1,<environment.Job instance at 0x7f9af44ad050>,4,25,[5 5],5,-1,30,-1,5
1,<environment.Job instance at 0x7f9af44ad7d0>,5,14,[9 5],6,-1,20,-1,6
1,<environment.Job instance at 0x7f9af44ade10>,7,18,[8 5],8,-1,27,-1,9
1,<environment.Job instance at 0x7f9af429fe60>,21,17,[4 8],22,-1,46,-1,29
1,<environment.Job instance at 0x7f9af4c8d8c0>,25,22,[6 3],26,-1,51,-1,29
1,<environment.Job instance at 0x7f9af4c8d6e0>,1,28,[12  4],2,-1,30,-1,2
1,<environment.Job instance at 0x7f9af4867aa0>,4,25,[5 5],5,-1,31,-1,6
1,<environment.Job instance at 0x7f9af457db40>,6,13,[14  4],7,-1,20,-1,7
1,<environment.Job instance at 0x7f9af4e35f00>,10,13,[12  5],11,-1,24,-1,11
1,<environment.Job instance at 0x7f9af4cb4960>,12,27,[6 2],13,-1,47,-1,20
1,<environment.Job instance at 0x7f9af4cb4a50>,14,26,[8 4],15,-1,46,-1,20
1,<environment.Job instance at 0x7f9af413f9b0>,24,23,[6 3],25,-1,66,-1,43
1,<environment.Job instance at 0x7f9af4126230>,33,28,[8 5],34,-1,103,-1,75
1,<environment.Job instance at 0x7f9af4c8ffa0>,39,23,[2 9],40,-1,120,-1,97
1,<environment.Job instance at 0x7f9af4c8faf0>,41,14,[ 4 12],42,-1,111,-1,97
1,<environment.Job instance at 0x7f9af34ae780>,48,16,[ 2 12],49,-1,130,-1,114
1,<environment.Job instance at 0x7f9af38b0b90>,51,26,[13  2],52,-1,153,-1,127
1,<environment.Job instance at 0x7f9af38b05f0>,57,23,[10  2],58,-1,184,-1,161
1,<environment.Job instance at 0x7f9af4573870>,63,23,[5 6],64,-1,184,-1,161
1,<environment.Job instance at 0x7f9af4d24c80>,77,26,[8 3],78,-1,232,-1,206
1,<environment.Job instance at 0x7f9af3f32f00>,81,14,[ 3 12],82,-1,225,-1,211
1,<environment.Job instance at 0x7f9af458b870>,114,3,[11  1],115,-1,364,-1,361
1,<environment.Job instance at 0x7f9af33e45a0>,122,27,[5 1],123,-1,407,-1,380
1,<environment.Job instance at 0x7f9af3aab870>,141,13,[14  3],142,-1,450,-1,437
1,<environment.Job instance at 0x7f9af3aabeb0>,142,16,[11  3],143,-1,453,-1,437
1,<environment.Job instance at 0x7f9af3aaba50>,160,24,[4 8],161,-1,543,-1,519
1,<environment.Job instance at 0x7f9af4a564b0>,164,13,[ 5 14],165,-1,545,-1,532
