iteration,job object,job ID,job Length,job ressource requirement,job enter time,job start time,job finish time,job waiting time,current time
1,<environment.Job instance at 0x153d1b371d70>,1,2,[ 2 10],2,13,15,11,13
1,<environment.Job instance at 0x153d15cc3500>,1,3,[6 1],3,10,13,7,10
1,<environment.Job instance at 0x153d185055a0>,0,17,[ 1 10],3,10,27,7,10
1,<environment.Job instance at 0x153d136afbe0>,2,3,[9 1],3,20,23,17,20
1,<environment.Job instance at 0x153d136703c0>,1,2,[ 2 10],2,13,15,11,13
1,<environment.Job instance at 0x153d16233c30>,0,17,[ 1 10],3,10,27,7,10
1,<environment.Job instance at 0x153d1c4b4910>,2,3,[9 1],3,20,23,17,20
1,<environment.Job instance at 0x153d124fee10>,0,13,[ 2 10],1,3,16,2,3
1,<environment.Job instance at 0x153d1863b870>,1,2,[ 2 10],2,16,18,14,13
1,<environment.Job instance at 0x153d177e9a50>,0,17,[ 1 10],3,10,27,7,10
1,<environment.Job instance at 0x153d161dbb40>,0,13,[ 2 10],1,3,16,2,3
1,<environment.Job instance at 0x153d161dbcd0>,1,2,[ 2 10],2,16,18,14,13
1,<environment.Job instance at 0x153d12ee9640>,0,17,[ 1 10],3,10,27,7,10
1,<environment.Job instance at 0x153d13768aa0>,2,3,[9 1],3,9,12,6,9
1,<environment.Job instance at 0x153d12750b40>,0,13,[ 2 10],1,3,16,2,3
1,<environment.Job instance at 0x153d1a6bcd20>,0,3,[6 2],1,6,9,5,6
1,<environment.Job instance at 0x153d1809cfa0>,0,3,[6 2],1,6,9,5,6
1,<environment.Job instance at 0x153d168ff4b0>,0,2,[1 7],1,13,15,12,13
1,<environment.Job instance at 0x153d173b7eb0>,0,3,[6 2],1,1,4,0,1
1,<environment.Job instance at 0x153d13949870>,1,3,[6 1],3,10,13,7,10
1,<environment.Job instance at 0x153d16aeb910>,0,13,[ 2 10],1,3,16,2,3
1,<environment.Job instance at 0x153d129978c0>,1,2,[ 2 10],2,16,18,14,10
1,<environment.Job instance at 0x153d195c6e60>,0,3,[6 2],1,6,9,5,6
1,<environment.Job instance at 0x153d1969b0f0>,0,17,[1 7],2,9,26,7,9
1,<environment.Job instance at 0x153d14032640>,1,3,[6 1],3,10,13,7,10
1,<environment.Job instance at 0x153d12af3a50>,0,13,[ 2 10],1,3,16,2,3
1,<environment.Job instance at 0x153d1a778500>,1,2,[ 2 10],2,16,18,14,10
1,<environment.Job instance at 0x153d11f82370>,0,3,[6 2],1,6,9,5,6
1,<environment.Job instance at 0x153d1a0cf460>,1,3,[6 1],3,9,12,6,9
1,<environment.Job instance at 0x153d137680f0>,0,17,[1 7],2,10,27,8,10
1,<environment.Job instance at 0x147d03626730>,0,17,[ 1 10],3,5,22,2,5
1,<environment.Job instance at 0x147d03591280>,8,13,[ 2 10],11,22,35,11,12
1,<environment.Job instance at 0x147d03591780>,7,3,[5 1],10,35,38,25,16
1,<environment.Job instance at 0x147d035915a0>,10,3,[7 2],14,38,41,24,16
1,<environment.Job instance at 0x147d035c27d0>,12,3,[6 2],16,41,44,25,17
1,<environment.Job instance at 0x147d0358af00>,14,1,[1 7],18,35,36,17,18
1,<environment.Job instance at 0x147d0358ad70>,17,3,[6 1],23,44,47,21,26
1,<environment.Job instance at 0x147d0358afa0>,16,17,[1 7],22,36,53,14,26
1,<environment.Job instance at 0x147d0358a820>,18,1,[5 2],25,47,48,22,28
1,<environment.Job instance at 0x147d0358ab90>,19,3,[8 1],26,48,51,22,29
1,<environment.Job instance at 0x147d0358e9b0>,23,3,[7 2],30,51,54,21,31
1,<environment.Job instance at 0x147d0357c050>,25,1,[6 1],34,54,55,20,39
1,<environment.Job instance at 0x147d036357d0>,29,13,[1 6],39,53,66,14,40
1,<environment.Job instance at 0x147d0352b370>,30,3,[1 8],41,66,69,25,41
1,<environment.Job instance at 0x147d0352b640>,35,3,[10  2],47,69,72,22,47
1,<environment.Job instance at 0x147d0352d190>,36,3,[1 6],48,72,75,24,53
1,<environment.Job instance at 0x147d0358a280>,21,22,[8 2],28,75,97,47,75
1,<environment.Job instance at 0x147d0295c230>,3,3,[1 6],5,5,8,0,5
1,<environment.Job instance at 0x147d0353b870>,2,1,[ 1 10],4,8,9,4,7
1,<environment.Job instance at 0x147d0358a280>,5,1,[2 9],7,10,11,3,10
1,<environment.Job instance at 0x147d02951370>,8,14,[5 1],10,13,27,3,13
1,<environment.Job instance at 0x147d027abc30>,9,15,[ 2 10],11,27,42,16,17
1,<environment.Job instance at 0x147d027c8870>,11,1,[1 8],18,18,19,0,18
1,<environment.Job instance at 0x147d027c85f0>,15,2,[10  1],24,42,44,18,24
1,<environment.Job instance at 0x147d027c8c30>,16,2,[2 7],25,44,46,19,30
1,<environment.Job instance at 0x147d027c6690>,19,3,[6 1],33,44,47,11,35
1,<environment.Job instance at 0x147d027c2050>,27,2,[9 2],44,47,49,3,45
1,<environment.Job instance at 0x147d027c2960>,29,1,[1 5],48,49,50,1,49
1,<environment.Job instance at 0x147d027c6460>,25,18,[1 7],41,51,69,10,51
1,<environment.Job instance at 0x147d0dee3dc0>,0,1,[10  2],1,1,2,0,1
1,<environment.Job instance at 0x147d014b13c0>,5,2,[1 5],8,9,11,1,9
1,<environment.Job instance at 0x147d014c1910>,7,3,[2 8],11,11,14,0,11
1,<environment.Job instance at 0x147d014b15a0>,4,1,[8 1],7,11,12,4,11
1,<environment.Job instance at 0x147d014c1eb0>,6,17,[9 2],10,15,32,5,15
1,<environment.Job instance at 0x147d014c1f50>,9,3,[8 1],17,32,35,15,18
1,<environment.Job instance at 0x147d014caf00>,15,18,[2 5],24,32,50,8,27
1,<environment.Job instance at 0x147d014c16e0>,11,3,[9 2],20,50,53,30,27
1,<environment.Job instance at 0x147d014befa0>,18,3,[8 1],28,35,38,7,30
1,<environment.Job instance at 0x147d014bea00>,19,3,[1 6],29,50,53,21,32
1,<environment.Job instance at 0x147d014f71e0>,22,1,[5 2],34,38,39,4,37
1,<environment.Job instance at 0x147d014d3320>,25,1,[ 2 10],38,53,54,15,40
1,<environment.Job instance at 0x147d01504320>,23,16,[1 9],36,54,70,18,44
1,<environment.Job instance at 0x147d0156fc30>,28,2,[1 7],45,70,72,25,48
1,<environment.Job instance at 0x147d0156f8c0>,29,2,[9 1],46,56,58,10,56
1,<environment.Job instance at 0x147d0039ee60>,2,1,[1 8],4,6,7,2,6
1,<environment.Job instance at 0x147d0357ca00>,0,2,[6 1],2,6,8,4,6
1,<environment.Job instance at 0x147d0020a960>,6,14,[5 1],10,11,25,1,11
1,<environment.Job instance at 0x147d0020a5f0>,8,3,[1 7],12,15,18,3,15
1,<environment.Job instance at 0x147d0020a8c0>,10,3,[1 5],14,20,23,6,20
1,<environment.Job instance at 0x147d0020cc30>,16,3,[10  2],25,26,29,1,26
1,<environment.Job instance at 0x147d0020caf0>,15,13,[9 1],22,35,48,13,35
1,<environment.Job instance at 0x147d0020e910>,23,17,[1 5],34,40,57,6,40
1,<environment.Job instance at 0x147d0020e9b0>,27,2,[5 1],39,48,50,9,43
1,<environment.Job instance at 0x147d0020e2d0>,29,3,[6 2],41,50,53,9,44
1,<environment.Job instance at 0x147d0020ea50>,28,12,[1 9],40,57,69,17,44
1,<environment.Job instance at 0x147d0020e550>,30,1,[ 1 10],42,69,70,27,48
1,<environment.Job instance at 0x147d0020e050>,26,3,[ 1 10],37,70,73,33,50
1,<environment.Job instance at 0x147d043dde60>,3,12,[2 6],4,9,21,5,9
1,<environment.Job instance at 0x147d043d5af0>,7,3,[9 2],19,21,24,2,20
1,<environment.Job instance at 0x147d03f82af0>,8,1,[10  1],20,24,25,4,21
1,<environment.Job instance at 0x147d043d54b0>,10,3,[6 1],23,26,29,3,26
1,<environment.Job instance at 0x147d03f09640>,9,2,[5 2],21,29,31,8,26
1,<environment.Job instance at 0x147cfb347050>,13,26,[2 9],26,35,61,9,35
1,<environment.Job instance at 0x147d0442cc80>,27,13,[2 9],45,61,74,16,51
1,<environment.Job instance at 0x147d03873e60>,22,18,[2 8],39,74,92,35,65
1,<environment.Job instance at 0x147cff365d70>,3,16,[7 1],8,9,25,1,9
1,<environment.Job instance at 0x147cff37fd70>,8,2,[8 2],14,25,27,11,15
1,<environment.Job instance at 0x147d04154cd0>,4,1,[7 1],9,27,28,18,18
1,<environment.Job instance at 0x147cff37feb0>,10,3,[1 8],17,21,24,4,21
1,<environment.Job instance at 0x147cff37cc80>,18,2,[1 5],29,32,34,3,32
1,<environment.Job instance at 0x147cff37bf50>,21,3,[5 2],33,36,39,3,36
1,<environment.Job instance at 0x147cff37b320>,22,2,[2 5],35,36,38,1,36
1,<environment.Job instance at 0x147cff338f00>,34,2,[5 1],47,48,50,1,48
1,<environment.Job instance at 0x147cff3986e0>,31,27,[5 1],44,56,83,12,56
1,<environment.Job instance at 0x147cfe22ef50>,2,18,[6 2],3,7,25,4,7
1,<environment.Job instance at 0x147cfe0a4140>,6,2,[2 8],10,10,12,0,10
1,<environment.Job instance at 0x147cfe0a4320>,7,12,[1 9],11,25,37,14,11
1,<environment.Job instance at 0x147cfe0a4550>,4,1,[6 2],8,37,38,29,12
1,<environment.Job instance at 0x147cfe0a4c80>,10,3,[8 2],14,38,41,24,14
1,<environment.Job instance at 0x147cfe0a4cd0>,12,2,[1 6],18,37,39,19,24
1,<environment.Job instance at 0x147cfe09d460>,17,3,[2 6],24,39,42,15,24
1,<environment.Job instance at 0x147cfe0a4dc0>,8,14,[ 2 10],12,42,56,30,27
1,<environment.Job instance at 0x147cfe09dcd0>,20,3,[1 9],29,56,59,27,30
1,<environment.Job instance at 0x147cfe1465a0>,26,2,[6 2],37,59,61,22,39
1,<environment.Job instance at 0x147cfe1a4960>,37,15,[7 2],49,61,76,12,54
1,<environment.Job instance at 0x147cfe03fa50>,0,25,[2 6],1,3,28,2,3
1,<environment.Job instance at 0x147cff398dc0>,2,2,[1 5],3,28,30,25,3
1,<environment.Job instance at 0x147d0250beb0>,7,1,[1 5],16,28,29,12,16
1,<environment.Job instance at 0x147d024d6eb0>,12,3,[1 6],24,30,33,6,26
1,<environment.Job instance at 0x147d00bf3410>,16,2,[10  1],28,33,35,5,28
1,<environment.Job instance at 0x147d008012d0>,19,3,[1 7],33,35,38,2,34
1,<environment.Job instance at 0x147d03ca2730>,22,1,[9 1],36,37,38,1,37
1,<environment.Job instance at 0x147d02503a50>,15,16,[1 7],27,44,60,17,44
1,<environment.Job instance at 0x147d00f1e0a0>,8,1,[5 2],12,13,14,1,13
1,<environment.Job instance at 0x147d00f1e730>,5,15,[10  1],8,14,29,6,14
1,<environment.Job instance at 0x147d0108b4b0>,9,3,[10  2],14,29,32,15,15
1,<environment.Job instance at 0x147d0108b640>,11,3,[5 1],17,32,35,15,17
1,<environment.Job instance at 0x147d0108b140>,12,13,[5 1],19,32,45,13,22
1,<environment.Job instance at 0x147d00e1b5f0>,18,3,[1 7],26,35,38,9,26
1,<environment.Job instance at 0x147d00d81050>,16,12,[1 8],23,38,50,15,27
1,<environment.Job instance at 0x147d010ed500>,22,1,[7 2],31,45,46,14,32
1,<environment.Job instance at 0x147d00e18190>,21,15,[10  2],30,50,65,20,36
1,<environment.Job instance at 0x147d010e83c0>,27,3,[10  2],37,65,68,28,42
1,<environment.Job instance at 0x147d010e86e0>,29,2,[2 8],43,68,70,25,47
1,<environment.Job instance at 0x147d0117d460>,35,2,[6 1],49,68,70,19,49
1,<environment.Job instance at 0x147d0346b820>,2,2,[2 7],3,3,5,0,3
1,<environment.Job instance at 0x147d01fec1e0>,5,16,[8 1],7,7,23,0,7
1,<environment.Job instance at 0x147d00df7c30>,3,3,[1 8],4,8,11,4,8
1,<environment.Job instance at 0x147d01e91370>,6,1,[9 2],8,23,24,15,10
1,<environment.Job instance at 0x147cff0c7690>,8,3,[2 7],10,11,14,1,11
1,<environment.Job instance at 0x147d0120b9b0>,12,3,[6 2],15,24,27,9,20
1,<environment.Job instance at 0x147d01220140>,19,14,[10  2],26,27,41,1,26
1,<environment.Job instance at 0x147d012208c0>,18,1,[5 2],25,41,42,16,28
1,<environment.Job instance at 0x147d01220c30>,21,14,[10  2],28,42,56,14,28
1,<environment.Job instance at 0x147d00d6f910>,17,2,[2 5],24,56,58,32,29
1,<environment.Job instance at 0x147d01220a00>,22,1,[1 5],29,41,42,12,30
1,<environment.Job instance at 0x147d02667320>,27,1,[1 5],38,56,57,18,39
1,<environment.Job instance at 0x147d02667820>,31,1,[7 1],42,57,58,15,43
1,<environment.Job instance at 0x147d02667a00>,32,13,[1 8],43,58,71,15,43
1,<environment.Job instance at 0x147d02667fa0>,30,2,[2 6],41,71,73,30,44
1,<environment.Job instance at 0x147d01219aa0>,34,1,[1 7],45,73,74,28,46
1,<environment.Job instance at 0x147d00d6d6e0>,23,1,[8 1],32,58,59,26,48
1,<environment.Job instance at 0x147d01219460>,33,3,[ 2 10],44,74,77,30,57
1,<environment.Job instance at 0x147d00c17820>,0,1,[2 9],2,5,6,3,5
1,<environment.Job instance at 0x147d00c0cc80>,2,2,[7 1],6,6,8,0,6
1,<environment.Job instance at 0x147d00c0e910>,1,2,[ 2 10],5,9,11,4,9
1,<environment.Job instance at 0x147d02667500>,4,2,[5 2],8,11,13,3,10
1,<environment.Job instance at 0x147cff0572d0>,3,3,[1 5],7,16,19,9,16
1,<environment.Job instance at 0x147cff057b90>,10,3,[9 2],16,18,21,2,18
1,<environment.Job instance at 0x147cff018460>,14,15,[5 2],23,23,38,0,23
1,<environment.Job instance at 0x147cff018500>,13,12,[10  1],21,38,50,17,23
1,<environment.Job instance at 0x147cff018410>,15,2,[10  1],26,50,52,24,31
1,<environment.Job instance at 0x147cff018d20>,25,1,[7 1],41,52,53,11,48
1,<environment.Job instance at 0x147cfee59af0>,30,3,[6 2],47,53,56,6,52
1,<environment.Job instance at 0x147cfee84e60>,0,1,[10  2],1,5,6,4,5
1,<environment.Job instance at 0x147cfee22f00>,2,3,[2 7],5,6,9,1,6
1,<environment.Job instance at 0x147d00d945a0>,1,3,[7 1],3,7,10,4,7
1,<environment.Job instance at 0x147cfe12f3c0>,6,3,[2 7],13,16,19,3,16
1,<environment.Job instance at 0x147cfe12fd20>,9,1,[1 8],17,19,20,2,18
1,<environment.Job instance at 0x147cfe12f730>,10,3,[ 1 10],18,20,23,2,18
1,<environment.Job instance at 0x147cfe22f2d0>,8,2,[1 9],16,23,25,7,21
1,<environment.Job instance at 0x147cfe155b40>,12,17,[2 5],23,25,42,2,25
1,<environment.Job instance at 0x147cfe1e43c0>,16,2,[2 6],30,42,44,12,34
1,<environment.Job instance at 0x147cfda060a0>,14,17,[9 1],27,44,61,17,34
1,<environment.Job instance at 0x147cfd98aaf0>,19,1,[1 9],36,44,45,8,36
1,<environment.Job instance at 0x147cfe079690>,22,3,[8 1],40,40,43,0,40
1,<environment.Job instance at 0x147cfe0af320>,24,13,[1 9],44,48,61,4,48
1,<environment.Job instance at 0x147cfe0afbe0>,25,12,[2 7],46,61,73,15,48
1,<environment.Job instance at 0x147cfe003fa0>,23,3,[2 5],42,73,76,31,48
1,<environment.Job instance at 0x147cfe072780>,26,1,[1 9],47,76,77,29,52
1,<environment.Job instance at 0x147d00b11410>,3,1,[5 2],5,6,7,1,6
1,<environment.Job instance at 0x147d032e1780>,6,3,[1 7],11,13,16,2,13
1,<environment.Job instance at 0x147d0417ed20>,10,14,[8 2],16,16,30,0,16
1,<environment.Job instance at 0x147d0417e1e0>,11,3,[9 2],17,30,33,13,22
1,<environment.Job instance at 0x147d02fa0fa0>,14,20,[5 1],21,33,53,12,26
1,<environment.Job instance at 0x147d00ae10a0>,22,2,[5 2],35,36,38,1,36
1,<environment.Job instance at 0x147d107280a0>,26,1,[6 1],40,53,54,13,41
1,<environment.Job instance at 0x147d00615d20>,24,2,[7 1],37,54,56,17,41
1,<environment.Job instance at 0x147d00f9aaf0>,23,14,[ 1 10],36,56,70,20,41
1,<environment.Job instance at 0x147d010e4c30>,1,3,[10  1],3,3,6,0,3
1,<environment.Job instance at 0x147cfc9bff50>,3,2,[6 1],5,6,8,1,5
1,<environment.Job instance at 0x147cfc9bf820>,5,1,[1 9],9,10,11,1,10
1,<environment.Job instance at 0x147cfc9bfa50>,6,1,[2 9],10,11,12,1,11
1,<environment.Job instance at 0x147cfc9bf050>,7,1,[2 9],11,12,13,1,12
1,<environment.Job instance at 0x147cfcae3410>,8,14,[1 6],14,17,31,3,17
1,<environment.Job instance at 0x147cfcb9c8c0>,16,1,[2 7],26,31,32,5,26
1,<environment.Job instance at 0x147cfc9bf7d0>,15,2,[7 1],24,27,29,3,27
1,<environment.Job instance at 0x147cfcab13c0>,22,12,[5 1],37,37,49,0,37
1,<environment.Job instance at 0x147cfca3afa0>,21,13,[8 2],32,49,62,17,38
1,<environment.Job instance at 0x147cfcaa0370>,25,24,[1 8],40,41,65,1,41
1,<environment.Job instance at 0x147cfcaa0c30>,27,1,[8 1],43,62,63,19,44
1,<environment.Job instance at 0x147cfcb68eb0>,28,2,[8 2],44,63,65,19,44
1,<environment.Job instance at 0x147cfcaa04b0>,23,12,[ 2 10],38,65,77,27,53
1,<environment.Job instance at 0x147cfcabcd20>,30,3,[2 9],46,77,80,31,63
1,<environment.Job instance at 0x147d02bb1be0>,4,17,[2 8],7,7,24,0,7
1,<environment.Job instance at 0x147d001c0140>,9,2,[5 1],13,13,15,0,13
1,<environment.Job instance at 0x147d02bb98c0>,15,1,[2 9],23,24,25,1,24
1,<environment.Job instance at 0x147d0303e690>,17,3,[2 7],26,26,29,0,26
1,<environment.Job instance at 0x147d014c1d20>,20,15,[5 1],29,30,45,1,30
1,<environment.Job instance at 0x147d02bb9b40>,16,1,[7 2],24,45,46,21,32
1,<environment.Job instance at 0x147d03c6e0f0>,25,2,[2 6],34,36,38,2,36
1,<environment.Job instance at 0x147d106860f0>,21,2,[2 9],30,38,40,8,38
1,<environment.Job instance at 0x147d03c6e4b0>,23,3,[1 5],32,40,43,8,38
1,<environment.Job instance at 0x147d02c7c1e0>,29,16,[5 1],39,46,62,7,40
1,<environment.Job instance at 0x147d0031a730>,31,3,[10  2],42,62,65,20,42
1,<environment.Job instance at 0x147d02c7c230>,28,2,[1 8],38,44,46,6,44
1,<environment.Job instance at 0x147d02aa1e10>,33,3,[1 6],45,46,49,1,45
1,<environment.Job instance at 0x147d02d5b550>,34,2,[5 2],46,49,51,3,46
1,<environment.Job instance at 0x147a291c3dc0>,0,17,[ 1 10],3,5,22,2,5
1,<environment.Job instance at 0x147a27f6d6e0>,8,13,[ 2 10],11,22,35,11,12
1,<environment.Job instance at 0x147a27f6dcd0>,7,3,[5 1],10,35,38,25,16
1,<environment.Job instance at 0x147a27f6d460>,10,3,[7 2],14,38,41,24,16
1,<environment.Job instance at 0x147a27f6d8c0>,12,3,[6 2],16,41,44,25,17
1,<environment.Job instance at 0x147a27f5ef00>,14,1,[1 7],18,35,36,17,18
1,<environment.Job instance at 0x147a27f06b40>,17,3,[6 1],23,44,47,21,26
1,<environment.Job instance at 0x147a2800c960>,16,17,[1 7],22,36,53,14,26
1,<environment.Job instance at 0x147a27f06550>,18,1,[5 2],25,47,48,22,28
1,<environment.Job instance at 0x147a27f06d20>,19,3,[8 1],26,48,51,22,29
1,<environment.Job instance at 0x147a27f03690>,23,3,[7 2],30,51,54,21,31
1,<environment.Job instance at 0x147a27f1f3c0>,25,1,[6 1],34,54,55,20,39
1,<environment.Job instance at 0x147a27f1f690>,29,13,[1 6],39,53,66,14,40
1,<environment.Job instance at 0x147a27f1fe60>,30,3,[1 8],41,66,69,25,41
1,<environment.Job instance at 0x147a27fbf1e0>,35,3,[10  2],47,69,72,22,47
1,<environment.Job instance at 0x147a27f1ee60>,36,3,[1 6],48,72,75,24,53
1,<environment.Job instance at 0x147a27f6f500>,21,22,[8 2],28,75,97,47,75
1,<environment.Job instance at 0x147a27f2d9b0>,3,3,[1 6],5,5,8,0,5
1,<environment.Job instance at 0x147a27f2d7d0>,2,1,[ 1 10],4,8,9,4,7
1,<environment.Job instance at 0x147a27107550>,5,1,[2 9],7,10,11,3,10
1,<environment.Job instance at 0x147a271073c0>,8,14,[5 1],10,13,27,3,13
1,<environment.Job instance at 0x147a27f6f500>,9,15,[ 2 10],11,27,42,16,17
1,<environment.Job instance at 0x147a27308500>,11,1,[1 8],18,18,19,0,18
1,<environment.Job instance at 0x147a27208370>,15,2,[10  1],24,42,44,18,24
1,<environment.Job instance at 0x147a27330cd0>,16,2,[2 7],25,44,46,19,30
1,<environment.Job instance at 0x147a27256960>,19,3,[6 1],33,44,47,11,35
1,<environment.Job instance at 0x147a271a6c30>,25,18,[1 7],41,46,64,5,45
1,<environment.Job instance at 0x147a271a3af0>,0,1,[10  2],1,1,2,0,1
1,<environment.Job instance at 0x147a1c7d5e60>,5,2,[1 5],8,9,11,1,9
1,<environment.Job instance at 0x147a1c7d5f00>,7,3,[2 8],11,11,14,0,11
1,<environment.Job instance at 0x147a1c7d5e10>,4,1,[8 1],7,11,12,4,11
1,<environment.Job instance at 0x147a1c7d5c80>,6,17,[9 2],10,15,32,5,15
1,<environment.Job instance at 0x147a1c7d82d0>,9,3,[8 1],17,32,35,15,18
1,<environment.Job instance at 0x147a1c7d8960>,15,18,[2 5],24,32,50,8,27
1,<environment.Job instance at 0x147a1c7d8e10>,19,3,[1 6],29,29,32,0,29
1,<environment.Job instance at 0x147a1c7d85a0>,11,3,[9 2],20,50,53,30,30
1,<environment.Job instance at 0x147a1c7d8cd0>,18,3,[8 1],28,35,38,7,32
1,<environment.Job instance at 0x147a1c7590f0>,22,1,[5 2],34,38,39,4,37
1,<environment.Job instance at 0x147a1c759550>,25,1,[ 2 10],38,53,54,15,40
1,<environment.Job instance at 0x147a1c759190>,23,16,[1 9],36,54,70,18,44
1,<environment.Job instance at 0x147a1c759910>,28,2,[1 7],45,50,52,5,48
1,<environment.Job instance at 0x147a1c759af0>,29,2,[9 1],46,56,58,10,56
1,<environment.Job instance at 0x147a1c75bfa0>,2,1,[1 8],4,6,7,2,6
1,<environment.Job instance at 0x147a1c75e190>,0,2,[6 1],2,6,8,4,6
1,<environment.Job instance at 0x147a1b4770a0>,6,14,[5 1],10,11,25,1,11
1,<environment.Job instance at 0x147a1b652dc0>,8,3,[1 7],12,15,18,3,15
1,<environment.Job instance at 0x147a1b58cf00>,10,3,[1 5],14,20,23,6,20
1,<environment.Job instance at 0x147a1b514820>,16,3,[10  2],25,26,29,1,26
1,<environment.Job instance at 0x147a1b62d960>,15,13,[9 1],22,35,48,13,35
1,<environment.Job instance at 0x147a1b579aa0>,23,17,[1 5],34,40,57,6,40
1,<environment.Job instance at 0x147a1b525eb0>,27,2,[5 1],39,48,50,9,43
1,<environment.Job instance at 0x147a1b525a50>,29,3,[6 2],41,50,53,9,44
1,<environment.Job instance at 0x147a1b5255a0>,28,12,[1 9],40,57,69,17,44
1,<environment.Job instance at 0x147a1b525640>,30,1,[ 1 10],42,69,70,27,48
1,<environment.Job instance at 0x147a1b525320>,26,3,[ 1 10],37,70,73,33,50
1,<environment.Job instance at 0x147a1b5253c0>,3,12,[2 6],4,9,21,5,9
1,<environment.Job instance at 0x147a28dfb4b0>,7,3,[9 2],19,21,24,2,20
1,<environment.Job instance at 0x147a288743c0>,8,1,[10  1],20,24,25,4,21
1,<environment.Job instance at 0x147a291444b0>,13,26,[2 9],26,30,56,4,30
1,<environment.Job instance at 0x147a28d811e0>,16,3,[1 6],32,56,59,24,36
1,<environment.Job instance at 0x147a290a1a00>,20,1,[5 1],37,40,41,3,40
1,<environment.Job instance at 0x147a28ce5230>,24,2,[6 1],42,43,45,1,43
1,<environment.Job instance at 0x147a27d26d20>,27,13,[2 9],45,59,72,14,53
1,<environment.Job instance at 0x147a27d39140>,2,15,[ 1 10],5,6,21,1,6
1,<environment.Job instance at 0x147a1a79d370>,5,2,[1 8],11,21,23,10,12
1,<environment.Job instance at 0x147a1a663280>,9,2,[5 2],15,21,23,6,15
1,<environment.Job instance at 0x147a1a5e2730>,3,16,[7 1],8,23,39,15,17
1,<environment.Job instance at 0x147a1a6835a0>,23,14,[ 1 10],36,39,53,3,36
1,<environment.Job instance at 0x147a1a683140>,27,2,[7 1],40,53,55,13,42
1,<environment.Job instance at 0x147a1a683d20>,28,2,[1 8],41,53,55,12,42
1,<environment.Job instance at 0x147a1a6fb9b0>,33,17,[1 9],46,55,72,9,46
1,<environment.Job instance at 0x147a1a6833c0>,25,3,[2 5],38,72,75,34,46
1,<environment.Job instance at 0x147a28845730>,1,13,[5 2],2,6,19,4,6
1,<environment.Job instance at 0x147a19341050>,3,14,[10  1],6,19,33,13,8
1,<environment.Job instance at 0x147a19345eb0>,8,14,[ 2 10],12,33,47,21,19
1,<environment.Job instance at 0x147a1933d870>,16,2,[10  2],23,47,49,24,26
1,<environment.Job instance at 0x147a1934aeb0>,18,2,[7 2],26,49,51,23,27
1,<environment.Job instance at 0x147a1933d7d0>,19,1,[9 1],28,51,52,23,32
1,<environment.Job instance at 0x147a192e5730>,22,2,[6 2],31,52,54,21,32
1,<environment.Job instance at 0x147a193070a0>,27,2,[10  1],38,54,56,16,38
1,<environment.Job instance at 0x147a19308190>,26,2,[6 2],37,56,58,19,42
1,<environment.Job instance at 0x147a19307190>,33,14,[ 2 10],44,58,72,14,46
1,<environment.Job instance at 0x147a19307b90>,35,1,[8 2],46,72,73,26,47
1,<environment.Job instance at 0x147a192f57d0>,1,2,[2 8],2,3,5,1,3
1,<environment.Job instance at 0x147a28e09230>,9,1,[1 7],20,24,25,4,24
1,<environment.Job instance at 0x147a277ad230>,14,2,[1 5],26,30,32,4,30
1,<environment.Job instance at 0x147a1b9c2a50>,19,3,[1 7],33,34,37,1,34
1,<environment.Job instance at 0x147a1b9ee190>,22,1,[9 1],36,37,38,1,37
1,<environment.Job instance at 0x147a1ba510a0>,25,3,[5 2],41,43,46,2,43
1,<environment.Job instance at 0x147a276925f0>,23,18,[1 8],37,43,61,6,43
1,<environment.Job instance at 0x147a1ba022d0>,27,1,[8 1],43,49,50,6,49
1,<environment.Job instance at 0x147a1b9eef00>,24,17,[10  1],38,61,78,23,51
1,<environment.Job instance at 0x147a1cd93960>,1,2,[7 1],2,2,4,0,2
1,<environment.Job instance at 0x147a1c102500>,4,3,[1 5],6,9,12,3,9
1,<environment.Job instance at 0x147a1c10b190>,8,1,[5 2],12,13,14,1,13
1,<environment.Job instance at 0x147a1c10b910>,10,3,[8 1],15,15,18,0,15
1,<environment.Job instance at 0x147a1c10bfa0>,12,13,[5 1],19,19,32,0,19
1,<environment.Job instance at 0x147a1c0fd0f0>,15,2,[9 2],22,32,34,10,22
1,<environment.Job instance at 0x147a1c0fdb90>,16,12,[1 8],23,23,35,0,23
1,<environment.Job instance at 0x147a1c10bf50>,11,3,[5 1],17,34,37,17,23
1,<environment.Job instance at 0x147a1c0fd2d0>,14,16,[1 5],21,35,51,14,25
1,<environment.Job instance at 0x147a1c0fdc30>,13,1,[1 7],20,51,52,31,26
1,<environment.Job instance at 0x147a1c1e9aa0>,22,1,[7 2],31,37,38,6,31
1,<environment.Job instance at 0x147a1c0eab40>,23,15,[7 2],32,38,53,6,32
1,<environment.Job instance at 0x147a1c2076e0>,25,22,[7 2],35,53,75,18,46
1,<environment.Job instance at 0x147a1c151640>,19,18,[1 8],27,52,70,25,48
1,<environment.Job instance at 0x147a1c281500>,31,3,[7 1],45,75,78,30,53
1,<environment.Job instance at 0x147a1c281f50>,34,2,[2 6],48,70,72,22,59
1,<environment.Job instance at 0x147a1be895a0>,4,22,[9 1],5,9,31,4,9
1,<environment.Job instance at 0x147a1d84d2d0>,6,1,[9 2],8,31,32,23,10
1,<environment.Job instance at 0x147a27eb0af0>,8,3,[2 7],10,32,35,22,12
1,<environment.Job instance at 0x147a27c378c0>,16,1,[7 1],23,32,33,9,24
1,<environment.Job instance at 0x147a1be653c0>,15,18,[2 8],19,35,53,16,24
1,<environment.Job instance at 0x147a1d84d140>,12,3,[6 2],15,33,36,18,27
1,<environment.Job instance at 0x147a1d37df50>,22,1,[1 5],29,30,31,1,30
1,<environment.Job instance at 0x147a1acd93c0>,20,1,[2 5],27,53,54,26,32
1,<environment.Job instance at 0x147a1c47a9b0>,26,1,[5 2],35,36,37,1,36
1,<environment.Job instance at 0x147a1c47a910>,28,2,[6 1],39,39,41,0,39
1,<environment.Job instance at 0x147a1c47ae10>,27,1,[1 5],38,53,54,15,39
1,<environment.Job instance at 0x147a1d396550>,31,1,[7 1],42,44,45,2,44
1,<environment.Job instance at 0x147a1d396a50>,32,13,[1 8],43,54,67,11,45
1,<environment.Job instance at 0x147a1d3973c0>,1,2,[ 2 10],5,8,10,3,8
1,<environment.Job instance at 0x147a1ac9e050>,6,1,[10  1],10,13,14,3,13
1,<environment.Job instance at 0x147a1ac9eaa0>,9,2,[2 9],14,14,16,0,14
1,<environment.Job instance at 0x147a1ac8f320>,11,14,[9 2],18,18,32,0,18
1,<environment.Job instance at 0x147a1ac9e370>,10,3,[9 2],16,32,35,16,26
1,<environment.Job instance at 0x147a1ac8f3c0>,16,1,[2 8],27,35,36,8,27
1,<environment.Job instance at 0x147a1ac8ffa0>,20,1,[2 9],34,36,37,2,34
1,<environment.Job instance at 0x147a1ac8f820>,19,17,[1 6],33,37,54,4,34
1,<environment.Job instance at 0x147a1ab70190>,21,2,[8 1],36,38,40,2,38
1,<environment.Job instance at 0x147a1ab70cd0>,24,3,[ 1 10],40,54,57,14,41
1,<environment.Job instance at 0x147a1ab70460>,26,2,[1 6],42,57,59,15,44
1,<environment.Job instance at 0x147a1ac8b2d0>,0,1,[10  2],1,2,3,1,2
1,<environment.Job instance at 0x147a19143960>,4,13,[10  1],10,13,26,3,13
1,<environment.Job instance at 0x147a1a43b370>,11,2,[1 5],19,26,28,7,19
1,<environment.Job instance at 0x147a1a3ddd70>,10,3,[ 1 10],18,28,31,10,19
1,<environment.Job instance at 0x147a19a73fa0>,7,18,[2 8],14,31,49,17,21
1,<environment.Job instance at 0x147a1bb122d0>,15,3,[7 2],28,31,34,3,29
1,<environment.Job instance at 0x147a18bf93c0>,16,2,[2 6],30,49,51,19,30
1,<environment.Job instance at 0x147a19b511e0>,19,1,[1 9],36,51,52,15,36
1,<environment.Job instance at 0x147a18bf9730>,20,18,[7 1],37,41,59,4,41
1,<environment.Job instance at 0x147a18c4ef00>,24,13,[1 9],44,52,65,8,46
1,<environment.Job instance at 0x147a19303c80>,2,2,[8 1],3,7,9,4,7
1,<environment.Job instance at 0x147a27999050>,6,3,[1 7],11,11,14,0,11
1,<environment.Job instance at 0x147a27999be0>,5,2,[1 9],9,14,16,5,14
1,<environment.Job instance at 0x147a27999e10>,9,3,[7 2],15,17,20,2,17
1,<environment.Job instance at 0x147a279c1140>,13,3,[2 6],20,21,24,1,21
1,<environment.Job instance at 0x147a279c1f50>,14,20,[5 1],21,24,44,3,24
1,<environment.Job instance at 0x147a279c1a50>,12,3,[8 1],18,44,47,26,29
1,<environment.Job instance at 0x147a28e0da50>,19,15,[8 1],29,47,62,18,33
1,<environment.Job instance at 0x147a1b4ea640>,24,2,[7 1],37,62,64,25,37
1,<environment.Job instance at 0x147a1b54adc0>,26,1,[6 1],40,64,65,24,45
1,<environment.Job instance at 0x147a1b50ef00>,32,14,[1 9],48,49,63,1,49
1,<environment.Job instance at 0x147a1b50e140>,33,15,[1 5],49,63,78,14,51
1,<environment.Job instance at 0x147a1b333870>,1,3,[10  1],3,4,7,1,4
1,<environment.Job instance at 0x147a17d44a00>,5,1,[1 9],9,10,11,1,10
1,<environment.Job instance at 0x147a1d83caa0>,0,1,[1 5],2,11,12,9,11
1,<environment.Job instance at 0x147a17d440a0>,9,2,[1 7],15,15,17,0,15
1,<environment.Job instance at 0x147a17d445f0>,6,1,[2 9],10,17,18,7,16
1,<environment.Job instance at 0x147a17f34b40>,11,2,[1 9],17,18,20,1,17
1,<environment.Job instance at 0x147a17d443c0>,8,14,[1 6],14,26,40,12,26
1,<environment.Job instance at 0x147a17eecc30>,16,1,[2 7],26,40,41,14,26
1,<environment.Job instance at 0x147a17f43e10>,15,2,[7 1],24,30,32,6,30
1,<environment.Job instance at 0x147a17e302d0>,20,18,[7 1],31,32,50,1,32
1,<environment.Job instance at 0x147a17e44c80>,24,1,[10  1],39,50,51,11,39
1,<environment.Job instance at 0x147a17e44140>,26,3,[1 7],41,42,45,1,42
1,<environment.Job instance at 0x147a17e445a0>,23,12,[ 2 10],38,51,63,13,42
1,<environment.Job instance at 0x147a17e420f0>,22,12,[5 1],37,63,75,26,46
1,<environment.Job instance at 0x147a17ddf500>,28,2,[8 2],44,75,77,31,48
1,<environment.Job instance at 0x147a276f9a50>,6,3,[9 1],9,10,13,1,10
1,<environment.Job instance at 0x147a276f9050>,8,3,[1 8],12,12,15,0,12
1,<environment.Job instance at 0x147a17dde140>,0,3,[1 8],2,15,18,13,13
1,<environment.Job instance at 0x147a1da04960>,14,2,[8 1],21,21,23,0,21
1,<environment.Job instance at 0x147a1da04aa0>,11,2,[2 8],15,21,23,6,21
1,<environment.Job instance at 0x147a2750b550>,18,1,[10  1],27,27,28,0,27
1,<environment.Job instance at 0x147a2748f140>,26,1,[9 1],35,35,36,0,35
1,<environment.Job instance at 0x147a1d5b1550>,25,2,[2 6],34,36,38,2,35
1,<environment.Job instance at 0x147a28b53aa0>,22,18,[2 7],31,38,56,7,38
1,<environment.Job instance at 0x147a1d9f43c0>,30,12,[ 2 10],41,56,68,15,41
1,<environment.Job instance at 0x147a2751d690>,33,3,[1 6],45,68,71,23,45
1,<environment.Job instance at 0x147a1d9f4a50>,32,1,[1 7],44,71,72,27,48
1,<environment.Job instance at 0x147a1b52ca50>,36,1,[9 2],49,68,69,19,52
1,<environment.Job instance at 0x147a27652960>,35,16,[8 1],48,69,85,21,60
1,<environment.Job instance at 0x147a1a451910>,0,17,[ 1 10],3,6,23,3,6
1,<environment.Job instance at 0x147a1a451780>,3,2,[1 7],6,23,25,17,8
1,<environment.Job instance at 0x147a280b1370>,5,3,[9 1],8,23,26,15,8
1,<environment.Job instance at 0x147a28b8b500>,9,2,[ 2 10],12,26,28,14,12
1,<environment.Job instance at 0x147a1a451e10>,8,13,[ 2 10],11,28,41,17,12
1,<environment.Job instance at 0x147a280b1b40>,7,3,[5 1],10,41,44,31,16
1,<environment.Job instance at 0x147a1b81ec80>,14,1,[1 7],18,25,26,7,19
1,<environment.Job instance at 0x147a286d6af0>,12,3,[6 2],16,44,47,28,19
1,<environment.Job instance at 0x147a1b81ef50>,17,3,[6 1],23,47,50,24,26
1,<environment.Job instance at 0x147a1b81ed20>,19,3,[8 1],26,50,53,24,26
1,<environment.Job instance at 0x147a1b81eaf0>,18,1,[5 2],25,41,42,16,27
1,<environment.Job instance at 0x147a1a86c0f0>,6,16,[2 7],9,42,58,33,29
1,<environment.Job instance at 0x147a19d55c80>,27,3,[2 8],37,58,61,21,39
1,<environment.Job instance at 0x147a19f98f00>,36,3,[1 6],48,61,64,13,53
1,<environment.Job instance at 0x147a19fcc0f0>,32,16,[9 1],43,61,77,18,53
1,<environment.Job instance at 0x147a19b58fa0>,3,3,[1 6],5,6,9,1,6
1,<environment.Job instance at 0x147a1b056b90>,6,2,[2 5],8,9,11,1,8
1,<environment.Job instance at 0x147a1b056050>,5,1,[2 9],7,11,12,4,8
1,<environment.Job instance at 0x147a19b58410>,2,1,[ 1 10],4,12,13,8,8
1,<environment.Job instance at 0x147a28ce3af0>,11,1,[1 8],18,20,21,2,20
1,<environment.Job instance at 0x147a1a930e60>,10,1,[ 1 10],17,21,22,4,21
1,<environment.Job instance at 0x147a28cef3c0>,15,2,[10  1],24,24,26,0,24
1,<environment.Job instance at 0x147a28ce3b40>,14,1,[7 2],22,26,27,4,26
1,<environment.Job instance at 0x147a1923f0a0>,22,2,[5 2],37,37,39,0,37
1,<environment.Job instance at 0x147a1cfee500>,21,17,[ 1 10],36,41,58,5,41
1,<environment.Job instance at 0x147a1922cdc0>,29,1,[1 5],48,58,59,10,48
1,<environment.Job instance at 0x147a1922c280>,27,2,[9 2],44,58,60,14,50
1,<environment.Job instance at 0x147a1922ca00>,25,18,[1 7],41,59,77,18,54
1,<environment.Job instance at 0x147a19230050>,0,1,[10  2],1,4,5,3,4
1,<environment.Job instance at 0x147a19230640>,2,2,[1 6],3,5,7,2,4
1,<environment.Job instance at 0x147a19230dc0>,1,1,[8 1],2,5,6,3,5
1,<environment.Job instance at 0x147a28a08be0>,5,2,[1 5],8,8,10,0,8
1,<environment.Job instance at 0x147a28a089b0>,8,2,[10  2],13,13,15,0,13
1,<environment.Job instance at 0x147a180e0730>,3,2,[2 6],6,15,17,9,13
1,<environment.Job instance at 0x147a19066d20>,10,3,[10  1],19,19,22,0,19
1,<environment.Job instance at 0x147a19066140>,9,3,[8 1],17,22,25,5,21
1,<environment.Job instance at 0x147a1b218550>,14,2,[9 1],23,25,27,2,23
1,<environment.Job instance at 0x147a1b14c280>,12,12,[1 7],21,23,35,2,23
1,<environment.Job instance at 0x147a1b218c80>,15,18,[2 5],24,35,53,11,24
1,<environment.Job instance at 0x147a1b14ce10>,11,3,[9 2],20,27,30,7,27
1,<environment.Job instance at 0x147a1949d7d0>,19,3,[1 6],29,53,56,24,29
1,<environment.Job instance at 0x147a184c1410>,20,15,[6 2],32,33,48,1,33
1,<environment.Job instance at 0x147a18519d20>,26,3,[7 1],39,48,51,9,39
1,<environment.Job instance at 0x147a1815f5a0>,25,1,[ 2 10],38,56,57,18,39
1,<environment.Job instance at 0x147a18184320>,24,18,[1 5],37,57,75,20,49
1,<environment.Job instance at 0x147a1949d410>,0,2,[6 1],2,6,8,4,6
1,<environment.Job instance at 0x147a1b3d3910>,7,2,[7 2],11,12,14,1,12
1,<environment.Job instance at 0x147a1d72e9b0>,16,3,[10  2],25,26,29,1,26
1,<environment.Job instance at 0x147a2797b410>,15,13,[9 1],22,29,42,7,27
1,<environment.Job instance at 0x147a1b3d3870>,18,12,[10  2],29,42,54,13,30
1,<environment.Job instance at 0x147a1c1f78c0>,25,1,[1 9],36,36,37,0,36
1,<environment.Job instance at 0x147a1b3fbb40>,30,1,[ 1 10],42,54,55,12,44
1,<environment.Job instance at 0x147a1b9ab5f0>,35,2,[8 2],48,55,57,7,51
1,<environment.Job instance at 0x147a1b396640>,32,3,[1 8],44,55,58,11,52
1,<environment.Job instance at 0x147a1b9ab690>,33,18,[ 2 10],46,58,76,12,53
1,<environment.Job instance at 0x147a1a2ee640>,0,2,[2 5],1,5,7,4,5
1,<environment.Job instance at 0x147a1a2ee320>,4,3,[2 6],5,7,10,2,5
1,<environment.Job instance at 0x147a188775a0>,6,26,[2 5],18,18,44,0,18
1,<environment.Job instance at 0x147a188774b0>,9,2,[5 2],21,21,23,0,21
1,<environment.Job instance at 0x147a188778c0>,7,3,[9 2],19,44,47,25,21
1,<environment.Job instance at 0x147a1c98caa0>,15,13,[ 2 10],31,47,60,16,32
1,<environment.Job instance at 0x147a1cda7460>,21,2,[2 8],38,60,62,22,38
1,<environment.Job instance at 0x147a28c924b0>,23,2,[9 2],40,62,64,22,44
1,<environment.Job instance at 0x147a1c321960>,24,2,[6 1],42,60,62,18,45
1,<environment.Job instance at 0x147a272ad320>,13,26,[2 9],26,64,90,38,64
1,<environment.Job instance at 0x147a284fff00>,0,3,[10  1],1,8,11,7,8
1,<environment.Job instance at 0x147a1927d910>,3,16,[7 1],8,11,27,3,8
1,<environment.Job instance at 0x147a1927d780>,8,2,[8 2],14,27,29,13,15
1,<environment.Job instance at 0x147a1927db40>,10,3,[1 8],17,17,20,0,17
1,<environment.Job instance at 0x147a1cf62640>,14,1,[1 5],24,25,26,1,25
1,<environment.Job instance at 0x147a1b3c7370>,18,2,[1 5],29,32,34,3,32
1,<environment.Job instance at 0x147a189a2aa0>,22,2,[2 5],35,36,38,1,36
1,<environment.Job instance at 0x147a1c582d70>,20,3,[8 2],32,36,39,4,36
1,<environment.Job instance at 0x147a1cbef370>,33,17,[1 9],46,47,64,1,47
1,<environment.Job instance at 0x147a1a3a1500>,32,17,[10  1],45,64,81,19,54
1,<environment.Job instance at 0x147a2868b320>,3,14,[10  1],6,7,21,1,7
1,<environment.Job instance at 0x147a21da65a0>,6,2,[2 8],10,21,23,11,10
1,<environment.Job instance at 0x147a21de2550>,7,12,[1 9],11,23,35,12,11
1,<environment.Job instance at 0x147a21da6dc0>,4,1,[6 2],8,21,22,13,11
1,<environment.Job instance at 0x147a21e14aa0>,12,2,[1 6],18,35,37,17,24
1,<environment.Job instance at 0x147a21e75280>,17,3,[2 6],24,37,40,13,24
1,<environment.Job instance at 0x147a21e5a780>,13,15,[6 1],19,29,44,10,29
1,<environment.Job instance at 0x147a18bd82d0>,28,1,[7 2],39,44,45,5,39
1,<environment.Job instance at 0x147a21d7c140>,27,2,[10  1],38,45,47,7,42
1,<environment.Job instance at 0x147a1b039d20>,37,15,[7 2],49,51,66,2,51
1,<environment.Job instance at 0x147a1b039500>,36,3,[10  1],47,66,69,19,54
1,<environment.Job instance at 0x147a17d5cf50>,5,3,[2 5],9,10,13,1,10
1,<environment.Job instance at 0x147a17dd3a00>,10,12,[6 1],21,22,34,1,22
1,<environment.Job instance at 0x147a17d5c0a0>,6,17,[1 7],12,22,39,10,22
1,<environment.Job instance at 0x147a17dd3500>,9,1,[1 7],20,39,40,19,29
1,<environment.Job instance at 0x147a1cf5e6e0>,18,3,[2 5],32,40,43,8,32
1,<environment.Job instance at 0x147a19fbb3c0>,22,1,[9 1],36,39,40,3,39
1,<environment.Job instance at 0x147a19f5b780>,26,1,[6 1],42,42,43,0,42
1,<environment.Job instance at 0x147a19b0e050>,29,13,[9 2],47,67,80,20,67
1,<environment.Job instance at 0x147a21da6e10>,1,2,[7 1],2,3,5,1,3
1,<environment.Job instance at 0x147a1d7ccbe0>,3,3,[10  2],5,5,8,0,5
1,<environment.Job instance at 0x147a17d5c050>,5,15,[10  1],8,8,23,0,8
1,<environment.Job instance at 0x147a1d7ccfa0>,7,1,[2 8],11,23,24,12,16
1,<environment.Job instance at 0x147a1d7ce140>,8,1,[5 2],12,23,24,11,16
1,<environment.Job instance at 0x147a1d7ce820>,14,16,[1 5],21,26,42,5,26
1,<environment.Job instance at 0x147a1d7cef00>,21,15,[10  2],30,42,57,12,31
1,<environment.Job instance at 0x147a1d7c3730>,27,3,[10  2],37,57,60,20,41
1,<environment.Job instance at 0x147a1d7ce320>,12,13,[5 1],19,60,73,41,45
1,<environment.Job instance at 0x147a1d7c3e10>,32,3,[10  2],46,73,76,27,50
1,<environment.Job instance at 0x147a1d7c3cd0>,30,17,[10  2],44,76,93,32,69
1,<environment.Job instance at 0x147a1d7b0aa0>,0,3,[2 8],1,1,4,0,1
1,<environment.Job instance at 0x147a1d7b0af0>,1,2,[5 2],2,2,4,0,2
1,<environment.Job instance at 0x147a17e87f00>,4,22,[9 1],5,6,28,1,6
1,<environment.Job instance at 0x147a1d7c3c80>,2,2,[2 7],3,28,30,25,6
1,<environment.Job instance at 0x147a193429b0>,7,2,[ 1 10],9,30,32,21,11
1,<environment.Job instance at 0x147a1a651eb0>,12,3,[6 2],15,32,35,17,17
1,<environment.Job instance at 0x147a192f38c0>,13,2,[1 6],17,23,25,6,23
1,<environment.Job instance at 0x147a1a85afa0>,16,1,[7 1],23,28,29,5,23
1,<environment.Job instance at 0x147a1a793d70>,18,1,[5 2],25,29,30,4,27
1,<environment.Job instance at 0x147a192bfeb0>,21,14,[10  2],28,35,49,7,28
1,<environment.Job instance at 0x147a192f9870>,22,1,[1 5],29,32,33,3,29
1,<environment.Job instance at 0x147a19562dc0>,17,2,[2 5],24,49,51,25,34
1,<environment.Job instance at 0x147a192f9f50>,23,1,[8 1],32,49,50,17,38
1,<environment.Job instance at 0x147a18be67d0>,25,2,[2 7],34,51,53,17,40
1,<environment.Job instance at 0x147a194a2f00>,30,2,[2 6],41,53,55,12,41
1,<environment.Job instance at 0x147a1a2703c0>,28,2,[6 1],39,50,52,11,41
1,<environment.Job instance at 0x147a1a9a42d0>,32,13,[1 8],43,55,68,12,43
1,<environment.Job instance at 0x147a19579f50>,9,26,[10  1],11,79,105,68,79
1,<environment.Job instance at 0x147a19f6be10>,3,3,[1 5],7,7,10,0,7
1,<environment.Job instance at 0x147a19e9ab90>,7,16,[10  2],11,11,27,0,11
1,<environment.Job instance at 0x147a19e9a140>,8,1,[8 2],13,27,28,14,13
1,<environment.Job instance at 0x147a19f6b1e0>,6,1,[10  1],10,28,29,18,18
1,<environment.Job instance at 0x147a19e9af50>,11,14,[9 2],18,29,43,11,23
1,<environment.Job instance at 0x147a19f18280>,15,2,[10  1],26,43,45,17,29
1,<environment.Job instance at 0x147a1be89910>,17,2,[7 2],30,45,47,15,30
1,<environment.Job instance at 0x147a1be2d0f0>,18,14,[10  1],31,47,61,16,34
1,<environment.Job instance at 0x147a29166af0>,21,2,[8 1],36,61,63,25,36
1,<environment.Job instance at 0x147a291fad20>,24,3,[ 1 10],40,63,66,23,43
1,<environment.Job instance at 0x147a291fa550>,26,2,[1 6],42,61,63,19,49
1,<environment.Job instance at 0x147a1cb43be0>,31,1,[2 8],48,66,67,18,49
1,<environment.Job instance at 0x147a27414b90>,0,1,[10  2],1,4,5,3,4
1,<environment.Job instance at 0x147a21eae690>,7,18,[2 8],14,21,39,7,21
1,<environment.Job instance at 0x147a220b8c30>,14,17,[9 1],27,39,56,12,28
1,<environment.Job instance at 0x147a21eaeaf0>,15,3,[7 2],28,29,32,1,29
1,<environment.Job instance at 0x147a221d9550>,16,2,[2 6],30,56,58,26,30
1,<environment.Job instance at 0x147a22115dc0>,19,1,[1 9],36,39,40,3,36
1,<environment.Job instance at 0x147a22034280>,17,2,[2 5],32,58,60,26,44
1,<environment.Job instance at 0x147a221d3780>,23,3,[2 5],42,58,61,16,44
1,<environment.Job instance at 0x147a221b5fa0>,22,3,[8 1],40,60,63,20,44
1,<environment.Job instance at 0x147a221b5690>,21,1,[1 7],38,47,48,9,47
1,<environment.Job instance at 0x147a21fee640>,26,1,[1 9],47,48,49,1,47
1,<environment.Job instance at 0x147a21f853c0>,12,17,[2 5],23,77,94,54,77
1,<environment.Job instance at 0x147a1c731e10>,2,2,[8 1],3,8,10,5,8
1,<environment.Job instance at 0x147a1a552cd0>,9,3,[7 2],15,16,19,1,16
1,<environment.Job instance at 0x147a1d9178c0>,12,3,[8 1],18,19,22,1,18
1,<environment.Job instance at 0x147a1c13c550>,10,14,[8 2],16,22,36,6,21
1,<environment.Job instance at 0x147a1c173690>,20,1,[6 2],30,36,37,6,30
1,<environment.Job instance at 0x147a28c71050>,22,2,[5 2],35,37,39,2,36
1,<environment.Job instance at 0x147a280ff0a0>,24,2,[7 1],37,39,41,2,37
1,<environment.Job instance at 0x147a27f1f8c0>,18,2,[10  1],27,41,43,14,38
1,<environment.Job instance at 0x147a28161a00>,26,1,[6 1],40,43,44,3,40
1,<environment.Job instance at 0x147a1b9fe0f0>,30,3,[9 1],45,45,48,0,45
1,<environment.Job instance at 0x147a1b9fe500>,31,17,[10  2],46,48,65,2,46
1,<environment.Job instance at 0x147a1b18bdc0>,32,14,[1 9],48,65,79,17,50
1,<environment.Job instance at 0x147a1b9fe640>,29,1,[2 9],44,79,80,35,53
1,<environment.Job instance at 0x147a1a554fa0>,16,1,[2 7],26,26,27,0,26
1,<environment.Job instance at 0x147a181099b0>,20,18,[7 1],31,40,58,9,40
1,<environment.Job instance at 0x147a1a5326e0>,26,3,[1 7],41,44,47,3,44
1,<environment.Job instance at 0x147a280bc9b0>,25,24,[1 8],40,47,71,7,47
1,<environment.Job instance at 0x147a27f2df50>,29,1,[1 7],45,71,72,26,47
1,<environment.Job instance at 0x147a17fa5f50>,7,3,[6 1],10,10,13,0,10
1,<environment.Job instance at 0x147a1c780910>,3,3,[8 1],6,13,16,7,10
1,<environment.Job instance at 0x147a1a3725a0>,10,2,[2 9],14,16,18,2,16
1,<environment.Job instance at 0x147a1a372460>,12,1,[2 6],17,18,19,1,17
1,<environment.Job instance at 0x147a1a37f0f0>,8,3,[1 8],12,21,24,9,21
1,<environment.Job instance at 0x147a1d27a050>,15,1,[2 9],23,24,25,1,24
1,<environment.Job instance at 0x147a17fea500>,19,15,[1 7],28,28,43,0,28
1,<environment.Job instance at 0x147a1aa44050>,24,3,[1 6],33,43,46,10,33
1,<environment.Job instance at 0x147a1958daf0>,25,2,[2 6],34,46,48,12,39
1,<environment.Job instance at 0x147a1b00f730>,31,3,[10  2],42,48,51,6,42
1,<environment.Job instance at 0x147a1b00f960>,32,1,[1 7],44,51,52,7,46
1,<environment.Job instance at 0x147a1a900500>,35,16,[8 1],48,61,77,13,61
1,<environment.Job instance at 0x147a276e48c0>,0,17,[ 1 10],3,5,22,2,5
1,<environment.Job instance at 0x147a1891c320>,8,13,[ 2 10],11,22,35,11,11
1,<environment.Job instance at 0x147a2bce0c80>,9,2,[ 2 10],12,35,37,23,12
1,<environment.Job instance at 0x147a1891c2d0>,10,3,[7 2],14,37,40,23,14
1,<environment.Job instance at 0x147a28b08190>,4,2,[6 1],7,40,42,33,16
1,<environment.Job instance at 0x147a1c3ad410>,12,3,[6 2],16,42,45,26,16
1,<environment.Job instance at 0x147a1c475d70>,14,1,[1 7],18,37,38,19,20
1,<environment.Job instance at 0x147a1c878fa0>,16,17,[1 7],22,38,55,16,26
1,<environment.Job instance at 0x147a19807460>,17,3,[6 1],23,45,48,22,27
1,<environment.Job instance at 0x147a27bd5be0>,18,1,[5 2],25,48,49,23,31
1,<environment.Job instance at 0x147a1891ccd0>,7,3,[5 1],10,49,52,39,31
1,<environment.Job instance at 0x147a27bd5050>,19,3,[8 1],26,52,55,26,32
1,<environment.Job instance at 0x147a27d26af0>,22,3,[2 6],29,55,58,26,34
1,<environment.Job instance at 0x147a190051e0>,23,3,[7 2],30,55,58,25,35
1,<environment.Job instance at 0x147a1918bc80>,27,3,[2 8],37,58,61,21,40
1,<environment.Job instance at 0x147a1918b550>,28,2,[1 9],38,61,63,23,40
1,<environment.Job instance at 0x147a27c545a0>,30,3,[1 8],41,63,66,22,42
1,<environment.Job instance at 0x147a27c54c80>,33,2,[5 1],44,58,60,14,45
1,<environment.Job instance at 0x147a29a767d0>,35,3,[10  2],47,66,69,19,47
1,<environment.Job instance at 0x147a18c4b0a0>,36,3,[1 6],48,69,72,21,49
1,<environment.Job instance at 0x147a18c4b730>,37,2,[2 7],49,72,74,23,50
1,<environment.Job instance at 0x147a29151230>,11,28,[1 9],15,74,102,59,74
1,<environment.Job instance at 0x147a29151c80>,3,3,[1 6],5,6,9,1,6
1,<environment.Job instance at 0x147a2885d370>,6,2,[2 5],8,9,11,1,8
1,<environment.Job instance at 0x147a18135c30>,5,1,[2 9],7,11,12,4,8
1,<environment.Job instance at 0x147a1904e190>,2,1,[ 1 10],4,12,13,8,8
1,<environment.Job instance at 0x147a27183370>,7,1,[1 7],9,13,14,4,9
1,<environment.Job instance at 0x147a27183190>,8,14,[5 1],10,16,30,6,16
1,<environment.Job instance at 0x147a19a39870>,13,1,[8 1],20,30,31,10,21
1,<environment.Job instance at 0x147a19a398c0>,14,1,[7 2],22,31,32,9,26
1,<environment.Job instance at 0x147a19a390a0>,16,2,[2 7],25,31,33,6,31
1,<environment.Job instance at 0x147a29a27fa0>,21,17,[ 1 10],36,37,54,1,37
1,<environment.Job instance at 0x147a1a6e59b0>,22,2,[5 2],37,54,56,17,39
1,<environment.Job instance at 0x147a1a6e5320>,23,2,[1 5],39,54,56,15,42
1,<environment.Job instance at 0x147a1a6e58c0>,24,2,[7 2],40,56,58,16,44
1,<environment.Job instance at 0x147a17c5e460>,27,2,[9 2],44,58,60,14,47
1,<environment.Job instance at 0x147a1a09da00>,29,1,[1 5],48,56,57,8,49
1,<environment.Job instance at 0x147a1a09d550>,28,15,[1 9],45,60,75,15,49
1,<environment.Job instance at 0x147a1d012cd0>,2,2,[1 6],3,3,5,0,3
1,<environment.Job instance at 0x147a1d631f00>,0,1,[10  2],1,5,6,4,3
1,<environment.Job instance at 0x147a274900a0>,1,1,[8 1],2,6,7,4,5
1,<environment.Job instance at 0x147a1d012910>,5,2,[1 5],8,13,15,5,13
1,<environment.Job instance at 0x147a19bde460>,8,2,[10  2],13,15,17,2,13
1,<environment.Job instance at 0x147a195e5320>,10,3,[10  1],19,19,22,0,19
1,<environment.Job instance at 0x147a1aa5b500>,9,3,[8 1],17,22,25,5,21
1,<environment.Job instance at 0x147a19c39960>,14,2,[9 1],23,25,27,2,23
1,<environment.Job instance at 0x147a19c397d0>,12,12,[1 7],21,24,36,3,24
1,<environment.Job instance at 0x147a19c39870>,13,16,[1 7],22,36,52,14,25
1,<environment.Job instance at 0x147a1c020410>,19,3,[1 6],29,52,55,23,29
1,<environment.Job instance at 0x147a1a911500>,21,1,[5 2],33,34,35,1,34
1,<environment.Job instance at 0x147a28fed870>,22,1,[5 2],34,42,43,8,42
1,<environment.Job instance at 0x147a1a294d20>,25,1,[ 2 10],38,55,56,17,42
1,<environment.Job instance at 0x147a1811ea00>,28,2,[1 7],45,56,58,11,49
1,<environment.Job instance at 0x147a1a294410>,26,3,[7 1],39,50,53,11,50
1,<environment.Job instance at 0x147a273d0d20>,2,1,[1 8],4,4,5,0,4
1,<environment.Job instance at 0x147a19bb0cd0>,0,2,[6 1],2,6,8,4,6
1,<environment.Job instance at 0x147a183e0910>,7,2,[7 2],11,12,14,1,12
1,<environment.Job instance at 0x147a182f3e10>,14,2,[ 2 10],20,20,22,0,20
1,<environment.Job instance at 0x147a182f3d20>,11,15,[1 5],15,22,37,7,20
1,<environment.Job instance at 0x147a191dd320>,16,3,[10  2],25,37,40,12,26
1,<environment.Job instance at 0x147a182d3500>,18,12,[10  2],29,40,52,11,30
1,<environment.Job instance at 0x147a2860deb0>,21,1,[1 6],32,52,53,20,34
1,<environment.Job instance at 0x147a2802cdc0>,26,3,[ 1 10],37,53,56,16,38
1,<environment.Job instance at 0x147a1943e280>,30,1,[ 1 10],42,56,57,14,44
1,<environment.Job instance at 0x147a283231e0>,28,12,[1 9],40,57,69,17,44
1,<environment.Job instance at 0x147a29a6c1e0>,35,2,[8 2],48,69,71,21,50
1,<environment.Job instance at 0x147a1943e5a0>,32,3,[1 8],44,69,72,25,51
1,<environment.Job instance at 0x147a1a562190>,0,2,[2 5],1,5,7,4,5
1,<environment.Job instance at 0x147a293f8730>,3,12,[2 6],4,7,19,3,5
1,<environment.Job instance at 0x147a1b633f50>,6,26,[2 5],18,19,45,1,18
1,<environment.Job instance at 0x147a1a662910>,9,2,[5 2],21,21,23,0,21
1,<environment.Job instance at 0x147a1a662730>,8,1,[10  1],20,45,46,25,21
1,<environment.Job instance at 0x147a1a0d5dc0>,16,3,[1 6],32,46,49,14,32
1,<environment.Job instance at 0x147a1a0d5be0>,17,2,[1 6],33,49,51,16,36
1,<environment.Job instance at 0x147a1d4efe10>,21,2,[2 8],38,51,53,13,38
1,<environment.Job instance at 0x147a1a0d5fa0>,18,2,[1 7],34,53,55,19,38
1,<environment.Job instance at 0x147a1d4efd70>,23,2,[9 2],40,46,48,6,41
1,<environment.Job instance at 0x147a1d4efb90>,24,2,[6 1],42,42,44,0,42
1,<environment.Job instance at 0x147a1d4efbe0>,20,1,[5 1],37,44,45,7,44
1,<environment.Job instance at 0x147a1a064460>,22,18,[2 8],39,55,73,16,44
1,<environment.Job instance at 0x147a180bbdc0>,25,1,[10  1],43,73,74,30,45
1,<environment.Job instance at 0x147a192d40f0>,4,1,[7 1],9,10,11,1,10
1,<environment.Job instance at 0x147a192d4050>,5,2,[1 8],11,11,13,0,11
1,<environment.Job instance at 0x147a1aa8f460>,13,3,[ 2 10],23,25,28,2,25
1,<environment.Job instance at 0x147a1ade5370>,17,2,[5 2],28,28,30,0,28
1,<environment.Job instance at 0x147a1aa8f0f0>,19,1,[7 2],30,33,34,3,33
1,<environment.Job instance at 0x147a1cf9cbe0>,21,3,[5 2],33,34,37,1,34
1,<environment.Job instance at 0x147a2907fdc0>,27,2,[7 1],40,41,43,1,41
1,<environment.Job instance at 0x147a19a0e2d0>,24,1,[6 2],37,43,44,6,42
1,<environment.Job instance at 0x147a19cbfc30>,28,2,[1 8],41,42,44,1,42
1,<environment.Job instance at 0x147a19cbf280>,30,3,[9 2],43,47,50,4,47
1,<environment.Job instance at 0x147a1c2d5af0>,33,17,[1 9],46,50,67,4,49
1,<environment.Job instance at 0x147a1c2d5370>,35,1,[6 1],49,50,51,1,50
1,<environment.Job instance at 0x147a1c2d5c30>,34,2,[5 1],47,51,53,4,50
1,<environment.Job instance at 0x147a21b22dc0>,4,1,[6 2],8,8,9,0,8
1,<environment.Job instance at 0x147a21b223c0>,8,14,[ 2 10],12,13,27,1,13
1,<environment.Job instance at 0x147a1c550780>,2,18,[6 2],3,27,45,24,17
1,<environment.Job instance at 0x147a27183140>,12,2,[1 6],18,27,29,9,20
1,<environment.Job instance at 0x147a27ddd050>,18,2,[7 2],26,45,47,19,28
1,<environment.Job instance at 0x147a18bf9f50>,24,1,[1 7],35,36,37,1,36
1,<environment.Job instance at 0x147a282f7e10>,27,2,[10  1],38,47,49,9,41
1,<environment.Job instance at 0x147a282f7c80>,26,2,[6 2],37,49,51,12,42
1,<environment.Job instance at 0x147a1c91aa00>,32,2,[8 1],43,51,53,8,44
1,<environment.Job instance at 0x147a1c91a2d0>,36,3,[10  1],47,53,56,6,52
1,<environment.Job instance at 0x147a198627d0>,37,15,[7 2],49,56,71,7,53
1,<environment.Job instance at 0x147a1b034c80>,5,3,[2 5],9,12,15,3,12
1,<environment.Job instance at 0x147a27232050>,15,16,[1 7],27,27,43,0,27
1,<environment.Job instance at 0x147a291b8500>,18,3,[2 5],32,43,46,11,34
1,<environment.Job instance at 0x147a291b89b0>,19,3,[1 7],33,46,49,13,34
1,<environment.Job instance at 0x147a291b8dc0>,16,2,[10  1],28,49,51,21,34
1,<environment.Job instance at 0x147a291b8690>,21,1,[8 1],35,36,37,1,36
1,<environment.Job instance at 0x147a291b8730>,23,18,[1 8],37,51,69,14,41
1,<environment.Job instance at 0x147a1af3cfa0>,27,1,[8 1],43,43,44,0,43
1,<environment.Job instance at 0x147a297cd730>,26,1,[6 1],42,44,45,2,43
1,<environment.Job instance at 0x147a18eedbe0>,2,1,[1 8],4,4,5,0,4
1,<environment.Job instance at 0x147a188d3140>,4,3,[1 5],6,6,9,0,6
1,<environment.Job instance at 0x147a19b6e8c0>,6,3,[7 2],10,10,13,0,10
1,<environment.Job instance at 0x147a19b6ec80>,7,1,[2 8],11,13,14,2,13
1,<environment.Job instance at 0x147a19b6ed70>,9,3,[10  2],14,14,17,0,14
1,<environment.Job instance at 0x147a19b6e6e0>,8,1,[5 2],12,17,18,5,15
1,<environment.Job instance at 0x147a188d34b0>,5,15,[10  1],8,18,33,10,18
1,<environment.Job instance at 0x147a221cc870>,13,1,[1 7],20,33,34,13,20
1,<environment.Job instance at 0x147a18851b90>,15,2,[9 2],22,33,35,11,24
1,<environment.Job instance at 0x147a289cdfa0>,17,15,[2 6],25,35,50,10,25
1,<environment.Job instance at 0x147a1946e3c0>,18,3,[1 7],26,50,53,24,27
1,<environment.Job instance at 0x147a188d4b90>,12,13,[5 1],19,35,48,16,27
1,<environment.Job instance at 0x147a1cd6db90>,20,2,[8 2],29,48,50,19,30
1,<environment.Job instance at 0x147a1ab4efa0>,23,15,[7 2],32,50,65,18,36
1,<environment.Job instance at 0x147a27e24280>,22,1,[7 2],31,65,66,34,40
1,<environment.Job instance at 0x147a17c69960>,19,18,[1 8],27,53,71,26,44
1,<environment.Job instance at 0x147a194fa960>,31,3,[7 1],45,66,69,21,45
1,<environment.Job instance at 0x147a18708e10>,34,2,[2 6],48,71,73,23,48
1,<environment.Job instance at 0x147a1b4d7e10>,35,2,[6 1],49,69,71,20,49
1,<environment.Job instance at 0x147a18708690>,33,15,[7 1],47,126,141,79,126
1,<environment.Job instance at 0x147a1bcedb90>,2,2,[2 7],3,7,9,4,7
1,<environment.Job instance at 0x147a18771a00>,4,22,[9 1],5,9,31,4,7
1,<environment.Job instance at 0x147a1962ab90>,8,3,[2 7],10,31,34,21,10
1,<environment.Job instance at 0x147a1a26c730>,11,12,[8 2],13,31,43,18,17
1,<environment.Job instance at 0x147a1c7466e0>,6,1,[9 2],8,43,44,35,23
1,<environment.Job instance at 0x147a1a49f730>,20,1,[2 5],27,34,35,7,27
1,<environment.Job instance at 0x147a1c8f9460>,22,1,[1 5],29,29,30,0,29
1,<environment.Job instance at 0x147a1a8cc780>,17,2,[2 5],24,35,37,11,29
1,<environment.Job instance at 0x147a1c9eeb90>,21,14,[10  2],28,44,58,16,29
1,<environment.Job instance at 0x147a198ae320>,24,2,[7 1],33,58,60,25,37
1,<environment.Job instance at 0x147a1a3ec140>,27,1,[1 5],38,40,41,2,40
1,<environment.Job instance at 0x147a1a3ec370>,26,1,[5 2],35,60,61,25,40
1,<environment.Job instance at 0x147a1c611730>,28,2,[6 1],39,61,63,22,45
1,<environment.Job instance at 0x147a17fdb0f0>,33,3,[ 2 10],44,63,66,19,46
1,<environment.Job instance at 0x147a1c611780>,29,18,[10  2],40,66,84,26,57
1,<environment.Job instance at 0x147a1819d870>,2,2,[7 1],6,6,8,0,6
1,<environment.Job instance at 0x147a1bb0e2d0>,4,2,[5 2],8,8,10,0,8
1,<environment.Job instance at 0x147a18f47be0>,1,2,[ 2 10],5,10,12,5,8
1,<environment.Job instance at 0x147a17ce2870>,3,3,[1 5],7,12,15,5,8
1,<environment.Job instance at 0x147a1bae8be0>,9,2,[2 9],14,15,17,1,14
1,<environment.Job instance at 0x147a1bae8d70>,7,16,[10  2],11,17,33,6,15
1,<environment.Job instance at 0x147a1bae8aa0>,11,14,[9 2],18,33,47,15,19
1,<environment.Job instance at 0x147a1bae8910>,5,1,[10  2],9,47,48,38,22
1,<environment.Job instance at 0x147a1bae8320>,16,1,[2 8],27,48,49,21,28
1,<environment.Job instance at 0x147a1bae8c80>,21,2,[8 1],36,48,50,12,37
1,<environment.Job instance at 0x147a1d592820>,19,17,[1 6],33,49,66,16,37
1,<environment.Job instance at 0x147a28d1f820>,23,2,[6 1],39,50,52,11,40
1,<environment.Job instance at 0x147a1aaeeeb0>,24,3,[ 1 10],40,66,69,26,43
1,<environment.Job instance at 0x147a272f6fa0>,28,3,[6 2],44,52,55,8,48
1,<environment.Job instance at 0x147a272ed910>,3,1,[8 1],6,8,9,2,8
1,<environment.Job instance at 0x147a1a0e8410>,4,13,[10  1],10,10,23,0,10
1,<environment.Job instance at 0x147a181ce1e0>,10,3,[ 1 10],18,23,26,5,18
1,<environment.Job instance at 0x147a28664460>,14,17,[9 1],27,27,44,0,27
1,<environment.Job instance at 0x147a19493e60>,19,1,[1 9],36,38,39,2,38
1,<environment.Job instance at 0x147a1c04e550>,18,16,[ 2 10],33,44,60,11,39
1,<environment.Job instance at 0x147a28f7a500>,21,1,[1 7],38,39,40,1,39
1,<environment.Job instance at 0x147a19647e10>,24,13,[1 9],44,60,73,16,45
1,<environment.Job instance at 0x147a1a8c3d70>,23,3,[2 5],42,73,76,31,56
1,<environment.Job instance at 0x147a27c5f320>,8,3,[9 1],13,13,16,0,13
1,<environment.Job instance at 0x147a27c5f2d0>,15,16,[10  2],22,24,40,2,24
1,<environment.Job instance at 0x147a1d35cd20>,11,3,[9 2],17,40,43,23,26
1,<environment.Job instance at 0x147a1da40690>,18,2,[10  1],27,43,45,16,27
1,<environment.Job instance at 0x147a1da40050>,21,1,[ 2 10],32,45,46,13,33
1,<environment.Job instance at 0x147a1bbaf500>,23,14,[ 1 10],36,46,60,10,36
1,<environment.Job instance at 0x147a1bbaf780>,24,2,[7 1],37,60,62,23,39
1,<environment.Job instance at 0x147a28645eb0>,28,16,[1 8],43,60,76,17,48
1,<environment.Job instance at 0x147a28645280>,29,1,[2 9],44,76,77,32,48
1,<environment.Job instance at 0x147a1d98a4b0>,31,17,[10  2],46,77,94,31,65
1,<environment.Job instance at 0x147a284578c0>,4,3,[8 1],7,11,14,4,11
1,<environment.Job instance at 0x147a282c6af0>,7,1,[2 9],11,14,15,3,14
1,<environment.Job instance at 0x147a193eb500>,8,14,[1 6],14,15,29,1,14
1,<environment.Job instance at 0x147a1b1c8730>,17,2,[1 6],27,29,31,2,27
1,<environment.Job instance at 0x147a2880d280>,14,17,[8 2],23,31,48,8,31
1,<environment.Job instance at 0x147a1b26e780>,18,3,[8 2],28,48,51,20,33
1,<environment.Job instance at 0x147a1d033690>,19,2,[7 1],30,51,53,21,34
1,<environment.Job instance at 0x147a1a5e2820>,22,12,[5 1],37,53,65,16,38
1,<environment.Job instance at 0x147a292071e0>,25,24,[1 8],40,40,64,0,40
1,<environment.Job instance at 0x147a28830b40>,30,3,[2 9],46,64,67,18,46
1,<environment.Job instance at 0x147a282be690>,20,18,[7 1],31,65,83,34,60
1,<environment.Job instance at 0x147a22196050>,4,17,[2 8],7,8,25,1,8
1,<environment.Job instance at 0x147a21ebd5a0>,11,2,[2 8],15,25,27,10,15
1,<environment.Job instance at 0x147a1b18a820>,22,18,[2 7],31,31,49,0,31
1,<environment.Job instance at 0x147a1878dd20>,23,3,[1 5],32,49,52,17,33
1,<environment.Job instance at 0x147a221ea190>,27,1,[ 2 10],36,52,53,16,36
1,<environment.Job instance at 0x147a21edcb90>,26,1,[9 1],35,49,50,14,38
1,<environment.Job instance at 0x147a1c9ae140>,28,2,[1 8],38,53,55,15,38
1,<environment.Job instance at 0x147a1c9ae460>,30,12,[ 2 10],41,55,67,14,41
1,<environment.Job instance at 0x147a19083910>,31,3,[10  2],42,67,70,25,44
1,<environment.Job instance at 0x147a18f21b90>,33,3,[1 6],45,70,73,25,46
1,<environment.Job instance at 0x147a19083af0>,32,1,[1 7],44,73,74,29,46
1,<environment.Job instance at 0x147a17e42f50>,0,17,[ 1 10],3,5,22,2,5
1,<environment.Job instance at 0x147a2921f5a0>,8,13,[ 2 10],11,22,35,11,12
1,<environment.Job instance at 0x147a1baea6e0>,12,3,[6 2],16,35,38,19,16
1,<environment.Job instance at 0x147a272c82d0>,10,3,[7 2],14,38,41,24,16
1,<environment.Job instance at 0x147a1bae9b90>,14,1,[1 7],18,35,36,17,18
1,<environment.Job instance at 0x147a28d05af0>,16,17,[1 7],22,36,53,14,25
1,<environment.Job instance at 0x147a28d05d20>,18,1,[5 2],25,41,42,16,26
1,<environment.Job instance at 0x147a28d05280>,17,3,[6 1],23,42,45,19,27
1,<environment.Job instance at 0x147a28d05e10>,19,3,[8 1],26,45,48,19,29
1,<environment.Job instance at 0x147a1aaee4b0>,23,3,[7 2],30,48,51,18,31
1,<environment.Job instance at 0x147a28d05730>,22,3,[2 6],29,53,56,24,31
1,<environment.Job instance at 0x147a2728ea50>,27,3,[2 8],37,56,59,19,42
1,<environment.Job instance at 0x147a28d1fb40>,28,2,[1 9],38,59,61,21,43
1,<environment.Job instance at 0x147a28d1f460>,31,3,[8 1],42,51,54,9,43
1,<environment.Job instance at 0x147a1872caf0>,33,2,[5 1],44,54,56,10,45
1,<environment.Job instance at 0x147a1872ce10>,35,3,[10  2],47,61,64,14,47
1,<environment.Job instance at 0x147a19423fa0>,36,3,[1 6],48,64,67,16,49
1,<environment.Job instance at 0x147a19423050>,37,2,[2 7],49,67,69,18,51
1,<environment.Job instance at 0x147a1872ce60>,32,16,[9 1],43,69,85,26,58
1,<environment.Job instance at 0x147a28d05b90>,20,21,[7 1],27,92,113,65,92
1,<environment.Job instance at 0x147a1b902050>,2,1,[ 1 10],4,4,5,0,4
1,<environment.Job instance at 0x147a1b902aa0>,3,3,[1 6],5,6,9,1,6
1,<environment.Job instance at 0x147a1b902460>,4,2,[2 8],6,9,11,3,8
1,<environment.Job instance at 0x147a19225910>,8,14,[5 1],10,11,25,1,11
1,<environment.Job instance at 0x147a28f20640>,9,15,[ 2 10],11,25,40,14,11
1,<environment.Job instance at 0x147a27d06910>,13,1,[8 1],20,40,41,20,20
1,<environment.Job instance at 0x147a1956e7d0>,21,17,[ 1 10],36,41,58,5,36
1,<environment.Job instance at 0x147a1956eb40>,22,2,[5 2],37,58,60,21,37
1,<environment.Job instance at 0x147a191199b0>,24,2,[7 2],40,60,62,20,42
1,<environment.Job instance at 0x147a27bd52d0>,27,2,[9 2],44,62,64,18,44
1,<environment.Job instance at 0x147a28b73a00>,26,2,[2 7],43,58,60,15,45
1,<environment.Job instance at 0x147a1b40b870>,28,15,[1 9],45,64,79,19,53
1,<environment.Job instance at 0x147a28f209b0>,2,2,[1 6],3,4,6,1,4
1,<environment.Job instance at 0x147a291c2c80>,4,1,[8 1],7,7,8,0,7
1,<environment.Job instance at 0x147a1821a690>,7,3,[2 8],11,11,14,0,11
1,<environment.Job instance at 0x147a1a03e050>,8,2,[10  2],13,17,19,4,17
1,<environment.Job instance at 0x147a1c260cd0>,11,3,[9 2],20,20,23,0,20
1,<environment.Job instance at 0x147a1b3c4a50>,10,3,[10  1],19,23,26,4,20
1,<environment.Job instance at 0x147a291c2280>,6,17,[9 2],10,26,43,16,21
1,<environment.Job instance at 0x147a1821ae60>,14,2,[9 1],23,43,45,20,24
1,<environment.Job instance at 0x147a19fe54b0>,18,3,[8 1],28,45,48,17,31
1,<environment.Job instance at 0x147a1cd25190>,22,1,[5 2],34,48,49,14,34
1,<environment.Job instance at 0x147a196bb3c0>,25,1,[ 2 10],38,49,50,11,40
1,<environment.Job instance at 0x147a284a1aa0>,24,18,[1 5],37,50,68,13,42
1,<environment.Job instance at 0x147a271efb40>,0,2,[6 1],2,4,6,2,4
1,<environment.Job instance at 0x147a271efe10>,2,1,[1 8],4,4,5,0,4
1,<environment.Job instance at 0x147a1cb23820>,5,1,[9 2],9,9,10,0,9
1,<environment.Job instance at 0x147a1b676820>,7,2,[7 2],11,11,13,0,11
1,<environment.Job instance at 0x147a274f7be0>,8,3,[1 7],12,12,15,0,12
1,<environment.Job instance at 0x147a1b676960>,10,3,[1 5],14,17,20,3,17
1,<environment.Job instance at 0x147a274f7b40>,11,15,[1 5],15,19,34,4,19
1,<environment.Job instance at 0x147a1c406960>,16,3,[10  2],25,34,37,9,28
1,<environment.Job instance at 0x147a21af2500>,19,18,[2 5],30,37,55,7,30
1,<environment.Job instance at 0x147a1d7821e0>,17,16,[6 1],27,37,53,10,34
1,<environment.Job instance at 0x147a21af2f00>,24,1,[1 8],35,55,56,20,36
1,<environment.Job instance at 0x147a182553c0>,30,1,[ 1 10],42,56,57,14,44
1,<environment.Job instance at 0x147a1a80f410>,32,3,[1 8],44,57,60,13,45
1,<environment.Job instance at 0x147a1a80fcd0>,33,18,[ 2 10],46,60,78,14,51
1,<environment.Job instance at 0x147a1a80f460>,35,2,[8 2],48,53,55,5,51
1,<environment.Job instance at 0x147a1903cc80>,34,3,[ 1 10],47,78,81,31,54
1,<environment.Job instance at 0x147a1d97e2d0>,23,17,[1 5],34,81,98,47,76
1,<environment.Job instance at 0x147a17fc2410>,1,1,[1 5],2,4,5,2,4
1,<environment.Job instance at 0x147a1b92fe60>,9,2,[5 2],21,21,23,0,21
1,<environment.Job instance at 0x147a1b92f190>,13,26,[2 9],26,26,52,0,26
1,<environment.Job instance at 0x147a193f8d70>,5,18,[ 1 10],17,52,70,35,43
1,<environment.Job instance at 0x147a1c2372d0>,18,2,[1 7],34,70,72,36,43
1,<environment.Job instance at 0x147a1ce07aa0>,24,2,[6 1],42,43,45,1,43
1,<environment.Job instance at 0x147a1859b7d0>,28,3,[9 1],49,70,73,21,51
1,<environment.Job instance at 0x147a1b92f320>,12,25,[1 8],25,72,97,47,69
1,<environment.Job instance at 0x147a1a4b5dc0>,0,3,[10  1],1,6,9,5,6
1,<environment.Job instance at 0x147a21afa0a0>,9,2,[5 2],15,15,17,0,15
1,<environment.Job instance at 0x147a21afacd0>,7,3,[10  2],13,19,22,6,19
1,<environment.Job instance at 0x147a21afa5f0>,10,3,[1 8],17,22,25,5,19
1,<environment.Job instance at 0x147a182803c0>,14,1,[1 5],24,26,27,2,26
1,<environment.Job instance at 0x147a18280870>,15,2,[1 9],25,27,29,2,26
1,<environment.Job instance at 0x147a21fa91e0>,17,2,[5 2],28,29,31,1,28
1,<environment.Job instance at 0x147a18280280>,18,2,[1 5],29,30,32,1,30
1,<environment.Job instance at 0x147a1ac8edc0>,20,3,[8 2],32,36,39,4,36
1,<environment.Job instance at 0x147a182f82d0>,24,1,[6 2],37,39,40,2,38
1,<environment.Job instance at 0x147a18979690>,27,2,[7 1],40,40,42,0,40
1,<environment.Job instance at 0x147a21fcd9b0>,31,27,[5 1],44,44,71,0,44
1,<environment.Job instance at 0x147a21fc9b90>,33,17,[1 9],46,47,64,1,47
1,<environment.Job instance at 0x147a21fc9370>,34,2,[5 1],47,64,66,17,49
1,<environment.Job instance at 0x147a21fcd730>,30,3,[9 2],43,71,74,28,50
1,<environment.Job instance at 0x147a21fc9460>,35,1,[6 1],49,74,75,25,52
1,<environment.Job instance at 0x147a1834f9b0>,23,14,[ 1 10],36,75,89,39,68
1,<environment.Job instance at 0x147a1b0e25f0>,2,18,[6 2],3,5,23,2,5
1,<environment.Job instance at 0x147a1b0e2320>,5,15,[2 7],9,11,26,2,11
1,<environment.Job instance at 0x147a29d02f00>,8,14,[ 2 10],12,26,40,14,13
1,<environment.Job instance at 0x147a1c471050>,12,2,[1 6],18,40,42,22,19
1,<environment.Job instance at 0x147a1c471dc0>,11,1,[6 2],16,23,24,7,22
1,<environment.Job instance at 0x147a1d3dc550>,20,3,[1 9],29,42,45,13,31
1,<environment.Job instance at 0x147a29a49550>,22,2,[6 2],31,40,42,9,33
1,<environment.Job instance at 0x147a29a49d20>,23,2,[2 6],34,45,47,11,34
1,<environment.Job instance at 0x147a27351640>,24,1,[1 7],35,47,48,12,35
1,<environment.Job instance at 0x147a282ae3c0>,25,2,[10  2],36,48,50,12,36
1,<environment.Job instance at 0x147a282aedc0>,26,2,[6 2],37,45,47,8,38
1,<environment.Job instance at 0x147a282ae9b0>,27,2,[10  1],38,50,52,12,38
1,<environment.Job instance at 0x147a1d5635f0>,13,15,[6 1],19,52,67,33,48
1,<environment.Job instance at 0x147a21e770a0>,36,3,[10  1],47,67,70,20,51
1,<environment.Job instance at 0x147a1a5585a0>,32,2,[8 1],43,70,72,27,52
1,<environment.Job instance at 0x147a21e77e10>,35,1,[8 2],46,72,73,26,56
1,<environment.Job instance at 0x147a290f7370>,0,25,[2 6],1,1,26,0,1
1,<environment.Job instance at 0x147a1becbd70>,10,12,[6 1],21,21,33,0,21
1,<environment.Job instance at 0x147a1a41b9b0>,11,12,[1 8],22,26,38,4,24
1,<environment.Job instance at 0x147a1bc2a050>,21,1,[8 1],35,35,36,0,35
1,<environment.Job instance at 0x147a1d00fb90>,24,17,[10  1],38,39,56,1,39
1,<environment.Job instance at 0x147a1bc2a730>,22,1,[9 1],36,56,57,20,40
1,<environment.Job instance at 0x147a1a5e4d70>,26,1,[6 1],42,57,58,15,49
1,<environment.Job instance at 0x147a198d4aa0>,28,22,[1 7],44,56,78,12,55
1,<environment.Job instance at 0x147a274afb90>,0,18,[7 2],1,4,22,3,4
1,<environment.Job instance at 0x147a28fc2190>,4,3,[1 5],6,9,12,3,9
1,<environment.Job instance at 0x147a27e413c0>,12,13,[5 1],19,22,35,3,20
1,<environment.Job instance at 0x147a27e41a50>,16,12,[1 8],23,23,35,0,23
1,<environment.Job instance at 0x147a19d6c410>,18,3,[1 7],26,35,38,9,27
1,<environment.Job instance at 0x147a19d6ceb0>,21,15,[10  2],30,38,53,8,31
1,<environment.Job instance at 0x147a27e41280>,14,16,[1 5],21,53,69,32,41
1,<environment.Job instance at 0x147a1b978a00>,27,3,[10  2],37,69,72,32,50
1,<environment.Job instance at 0x147a2869a500>,35,2,[6 1],49,53,55,4,51
1,<environment.Job instance at 0x147a2869a640>,32,3,[10  2],46,72,75,26,59
1,<environment.Job instance at 0x147a21b73460>,4,22,[9 1],5,5,27,0,5
1,<environment.Job instance at 0x147a21b73780>,6,1,[9 2],8,27,28,19,9
1,<environment.Job instance at 0x147a1c86ee60>,8,3,[2 7],10,28,31,18,10
1,<environment.Job instance at 0x147a1c86ec30>,11,12,[8 2],13,28,40,15,13
1,<environment.Job instance at 0x147a21dfe3c0>,13,2,[1 6],17,17,19,0,17
1,<environment.Job instance at 0x147a21dfe500>,15,18,[2 8],19,31,49,12,21
1,<environment.Job instance at 0x147a219a3870>,16,1,[7 1],23,40,41,17,25
1,<environment.Job instance at 0x147a27ac13c0>,18,1,[5 2],25,41,42,16,26
1,<environment.Job instance at 0x147a1c886d70>,20,1,[2 5],27,49,50,22,29
1,<environment.Job instance at 0x147a1ab3f6e0>,23,1,[8 1],32,42,43,10,35
1,<environment.Job instance at 0x147a1ba407d0>,26,1,[5 2],35,43,44,8,38
1,<environment.Job instance at 0x147a1c886780>,21,14,[10  2],28,50,64,22,38
1,<environment.Job instance at 0x147a187cd6e0>,25,2,[2 7],34,64,66,30,41
1,<environment.Job instance at 0x147a1cf56cd0>,30,2,[2 6],41,66,68,25,42
1,<environment.Job instance at 0x147a1cf56370>,33,3,[ 2 10],44,68,71,24,51
1,<environment.Job instance at 0x147a1c868550>,19,14,[10  2],26,71,85,45,66
1,<environment.Job instance at 0x147a1b328500>,3,3,[1 5],7,7,10,0,7
1,<environment.Job instance at 0x147a1b9785a0>,1,2,[ 2 10],5,10,12,5,7
1,<environment.Job instance at 0x147a1cf56a00>,4,2,[5 2],8,8,10,0,8
1,<environment.Job instance at 0x147a2228b730>,5,1,[10  2],9,15,16,6,15
1,<environment.Job instance at 0x147a2228b870>,9,2,[2 9],14,21,23,7,21
1,<environment.Job instance at 0x147a2228be10>,13,12,[10  1],21,23,35,2,21
1,<environment.Job instance at 0x147a2228b410>,11,14,[9 2],18,35,49,17,21
1,<environment.Job instance at 0x147a1b4b6c30>,16,1,[2 8],27,49,50,22,27
1,<environment.Job instance at 0x147a1951aa50>,15,2,[10  1],26,50,52,24,32
1,<environment.Job instance at 0x147a28f20d70>,20,1,[2 9],34,52,53,18,34
1,<environment.Job instance at 0x147a19d8bb40>,21,2,[8 1],36,52,54,16,36
1,<environment.Job instance at 0x147a17ed20a0>,22,2,[9 2],38,54,56,16,38
1,<environment.Job instance at 0x147a2228b910>,19,17,[1 6],33,53,70,20,45
1,<environment.Job instance at 0x147a18c8f780>,28,3,[6 2],44,56,59,12,45
1,<environment.Job instance at 0x147a17c6e9b0>,29,1,[10  1],46,70,71,24,51
1,<environment.Job instance at 0x147a18b7e5a0>,0,1,[10  2],1,1,2,0,1
1,<environment.Job instance at 0x147a28e57820>,6,3,[2 7],13,15,18,2,15
1,<environment.Job instance at 0x147a28e57690>,8,2,[1 9],16,18,20,2,16
1,<environment.Job instance at 0x147a28e57f50>,7,18,[2 8],14,20,38,6,19
1,<environment.Job instance at 0x147a28e572d0>,11,2,[1 5],19,38,40,19,22
1,<environment.Job instance at 0x147a27ca9c30>,12,17,[2 5],23,38,55,15,28
1,<environment.Job instance at 0x147a1bbf4d20>,19,1,[1 9],36,55,56,19,36
1,<environment.Job instance at 0x147a1a22f230>,20,18,[7 1],37,40,58,3,39
1,<environment.Job instance at 0x147a1a22f6e0>,21,1,[1 7],38,56,57,18,41
1,<environment.Job instance at 0x147a1adb3230>,24,13,[1 9],44,57,70,13,45
1,<environment.Job instance at 0x147a19861f50>,5,2,[1 9],9,10,12,1,10
1,<environment.Job instance at 0x147a1a0a47d0>,9,3,[7 2],15,15,18,0,15
1,<environment.Job instance at 0x147a19861e10>,6,3,[1 7],11,15,18,4,15
1,<environment.Job instance at 0x147a1b40bb40>,12,3,[8 1],18,18,21,0,18
1,<environment.Job instance at 0x147a1a0a48c0>,11,3,[9 2],17,21,24,4,18
1,<environment.Job instance at 0x147a1a0a42d0>,8,3,[9 1],13,24,27,11,18
1,<environment.Job instance at 0x147a19861960>,7,15,[ 1 10],12,27,42,15,19
1,<environment.Job instance at 0x147a1980ae60>,16,2,[9 1],23,42,44,19,25
1,<environment.Job instance at 0x147a27ad72d0>,18,2,[10  1],27,44,46,17,28
1,<environment.Job instance at 0x147a1b4f8140>,20,1,[6 2],30,46,47,16,33
1,<environment.Job instance at 0x147a1b07c8c0>,14,20,[5 1],21,47,67,26,40
1,<environment.Job instance at 0x147a19d3e0a0>,30,3,[9 1],45,67,70,22,46
1,<environment.Job instance at 0x147a1c281e10>,33,15,[1 5],49,49,64,0,49
1,<environment.Job instance at 0x147a1c281140>,32,14,[1 9],48,64,78,16,53
1,<environment.Job instance at 0x147a18fa77d0>,3,2,[6 1],5,6,8,1,6
1,<environment.Job instance at 0x147a18fa7e10>,1,3,[10  1],3,8,11,5,8
1,<environment.Job instance at 0x147a19eac7d0>,11,2,[1 9],17,17,19,0,17
1,<environment.Job instance at 0x147a19eac230>,9,2,[1 7],15,19,21,4,17
1,<environment.Job instance at 0x147a19eac690>,14,17,[8 2],23,23,40,0,23
1,<environment.Job instance at 0x147a19eac0a0>,16,1,[2 7],26,26,27,0,26
1,<environment.Job instance at 0x147a19eac320>,19,2,[7 1],30,40,42,10,31
1,<environment.Job instance at 0x147a2c47cf50>,21,13,[8 2],32,42,55,10,38
1,<environment.Job instance at 0x147a2c47cb90>,24,1,[10  1],39,55,56,16,42
1,<environment.Job instance at 0x147a219efc30>,30,3,[2 9],46,56,59,10,48
1,<environment.Job instance at 0x147a2c47c0a0>,23,12,[ 2 10],38,59,71,21,52
1,<environment.Job instance at 0x147a272c1190>,1,2,[10  2],3,4,6,1,4
1,<environment.Job instance at 0x147a24d849b0>,7,3,[6 1],10,14,17,4,14
1,<environment.Job instance at 0x147a24d843c0>,9,2,[5 1],13,17,19,4,14
1,<environment.Job instance at 0x147a24d84820>,8,3,[1 8],12,14,17,2,14
1,<environment.Job instance at 0x147a24d84410>,12,1,[2 6],17,17,18,0,17
1,<environment.Job instance at 0x147a24d84a50>,10,2,[2 9],14,20,22,6,20
1,<environment.Job instance at 0x147a21c0b960>,14,2,[8 1],21,21,23,0,21
1,<environment.Job instance at 0x147a21c0b690>,15,1,[2 9],23,24,25,1,24
1,<environment.Job instance at 0x147a21c0b780>,16,1,[7 2],24,29,30,5,29
1,<environment.Job instance at 0x147a1919f2d0>,18,1,[10  1],27,30,31,3,30
1,<environment.Job instance at 0x147a19c46640>,22,18,[2 7],31,32,50,1,32
1,<environment.Job instance at 0x147a21c0ba50>,23,3,[1 5],32,50,53,18,32
1,<environment.Job instance at 0x147a1a2b60a0>,24,3,[1 6],33,53,56,20,33
1,<environment.Job instance at 0x147a18398eb0>,28,2,[1 8],38,56,58,18,38
1,<environment.Job instance at 0x147a18398fa0>,29,16,[5 1],39,40,56,1,40
1,<environment.Job instance at 0x147a192939b0>,32,1,[1 7],44,58,59,14,44
1,<environment.Job instance at 0x147a1a511c80>,36,1,[9 2],49,56,57,7,50
1,<environment.Job instance at 0x147a18be23c0>,0,17,[ 1 10],3,5,22,2,5
1,<environment.Job instance at 0x147a184006e0>,5,3,[9 1],8,22,25,14,8
1,<environment.Job instance at 0x147a18400910>,8,13,[ 2 10],11,25,38,14,11
1,<environment.Job instance at 0x147a2777c0f0>,9,2,[ 2 10],12,38,40,26,12
1,<environment.Job instance at 0x147a2777caa0>,10,3,[7 2],14,40,43,26,14
1,<environment.Job instance at 0x147a1a342960>,4,2,[6 1],7,43,45,36,16
1,<environment.Job instance at 0x147a19e4eb90>,12,3,[6 2],16,45,48,29,30
1,<environment.Job instance at 0x147a19b8f140>,17,3,[6 1],23,48,51,25,30
1,<environment.Job instance at 0x147a1b328f00>,19,3,[8 1],26,51,54,25,30
1,<environment.Job instance at 0x147a18dc0370>,16,17,[1 7],22,40,57,18,31
1,<environment.Job instance at 0x147a182b6410>,23,3,[7 2],30,54,57,24,31
1,<environment.Job instance at 0x147a182b6d20>,22,3,[2 6],29,57,60,28,35
1,<environment.Job instance at 0x147a2835b370>,27,3,[2 8],37,60,63,23,40
1,<environment.Job instance at 0x147a2835b8c0>,28,2,[1 9],38,63,65,25,40
1,<environment.Job instance at 0x147a1babdd20>,30,3,[1 8],41,65,68,24,42
1,<environment.Job instance at 0x147a1babd8c0>,31,3,[8 1],42,57,60,15,45
1,<environment.Job instance at 0x147a1babd0f0>,34,3,[9 2],45,65,68,20,50
1,<environment.Job instance at 0x147a288e0b90>,36,3,[1 6],48,68,71,20,50
1,<environment.Job instance at 0x147a21d7b550>,15,14,[6 2],20,76,90,56,76
1,<environment.Job instance at 0x147a1d6cc280>,3,3,[1 6],5,6,9,1,6
1,<environment.Job instance at 0x147a19af9fa0>,6,2,[2 5],8,9,11,1,8
1,<environment.Job instance at 0x147a19af9dc0>,5,1,[2 9],7,11,12,4,8
1,<environment.Job instance at 0x147a1d6cc960>,2,1,[ 1 10],4,12,13,8,8
1,<environment.Job instance at 0x147a19af56e0>,7,1,[1 7],9,13,14,4,9
1,<environment.Job instance at 0x147a19af5b90>,8,14,[5 1],10,16,30,6,16
1,<environment.Job instance at 0x147a19b11fa0>,13,1,[8 1],20,30,31,10,20
1,<environment.Job instance at 0x147a19b11b40>,10,1,[ 1 10],17,31,32,14,21
1,<environment.Job instance at 0x147a1b103230>,14,1,[7 2],22,32,33,10,26
1,<environment.Job instance at 0x147a1b1038c0>,16,2,[2 7],25,32,34,7,31
1,<environment.Job instance at 0x147a24a04cd0>,21,17,[ 1 10],36,37,54,1,37
1,<environment.Job instance at 0x147a24a800f0>,23,2,[1 5],39,54,56,15,42
1,<environment.Job instance at 0x147a24993230>,22,2,[5 2],37,54,56,17,44
1,<environment.Job instance at 0x147a24a71500>,28,15,[1 9],45,56,71,11,47
1,<environment.Job instance at 0x147a195b8820>,27,2,[9 2],44,71,73,27,47
1,<environment.Job instance at 0x147a19cc50a0>,2,2,[1 6],3,4,6,1,4
1,<environment.Job instance at 0x147a1951e1e0>,10,3,[10  1],19,19,22,0,19
1,<environment.Job instance at 0x147a18d05280>,14,2,[9 1],23,23,25,0,23
1,<environment.Job instance at 0x147a17d28730>,13,16,[1 7],22,24,40,2,24
1,<environment.Job instance at 0x147a1a11e550>,17,3,[2 5],27,40,43,13,27
1,<environment.Job instance at 0x147a1d13d500>,16,2,[1 5],25,40,42,15,27
1,<environment.Job instance at 0x147a277177d0>,19,3,[1 6],29,43,46,14,29
1,<environment.Job instance at 0x147a17d9b460>,18,3,[8 1],28,30,33,2,30
1,<environment.Job instance at 0x147a24be1b40>,20,15,[6 2],32,42,57,10,32
1,<environment.Job instance at 0x147a18d05a00>,15,18,[2 5],24,46,64,22,35
1,<environment.Job instance at 0x147a1b7f0730>,27,1,[2 5],43,57,58,14,44
1,<environment.Job instance at 0x147a290b3320>,29,2,[9 1],46,64,66,18,46
1,<environment.Job instance at 0x147a2a4e98c0>,2,1,[1 8],4,4,5,0,4
1,<environment.Job instance at 0x147a1868ff50>,0,2,[6 1],2,6,8,4,6
1,<environment.Job instance at 0x147a286e8e10>,7,2,[7 2],11,12,14,1,12
1,<environment.Job instance at 0x147a18576a00>,14,2,[ 2 10],20,21,23,1,21
1,<environment.Job instance at 0x147a1d633be0>,17,16,[6 1],27,27,43,0,27
1,<environment.Job instance at 0x147a1afab0f0>,19,18,[2 5],30,30,48,0,30
1,<environment.Job instance at 0x147a1afabc30>,18,12,[10  2],29,48,60,19,35
1,<environment.Job instance at 0x147a28b0d5f0>,21,1,[1 6],32,60,61,28,35
1,<environment.Job instance at 0x147a1afabaf0>,20,1,[5 2],31,43,44,12,35
1,<environment.Job instance at 0x147a17f6f0a0>,24,1,[1 8],35,61,62,26,37
1,<environment.Job instance at 0x147a17f6f0f0>,26,3,[ 1 10],37,62,65,25,38
1,<environment.Job instance at 0x147a1d855f50>,32,3,[1 8],44,65,68,21,45
1,<environment.Job instance at 0x147a1d62c140>,30,1,[ 1 10],42,68,69,26,54
1,<environment.Job instance at 0x147a1d855b40>,34,3,[ 1 10],47,69,72,22,55
1,<environment.Job instance at 0x147a1d855960>,33,18,[ 2 10],46,72,90,26,67
1,<environment.Job instance at 0x147a18273a00>,1,1,[1 5],2,5,6,3,5
1,<environment.Job instance at 0x147a18273b90>,4,3,[2 6],5,6,9,1,5
1,<environment.Job instance at 0x147a21c45370>,6,26,[2 5],18,19,45,1,19
1,<environment.Job instance at 0x147a198e7aa0>,7,3,[9 2],19,45,48,26,19
1,<environment.Job instance at 0x147a1adf86e0>,11,1,[8 2],24,24,25,0,24
1,<environment.Job instance at 0x147a1aa0f5a0>,10,3,[6 1],23,26,29,3,26
1,<environment.Job instance at 0x147a18ef22d0>,15,13,[ 2 10],31,48,61,17,34
1,<environment.Job instance at 0x147a18ef2c80>,17,2,[1 6],33,45,47,12,36
1,<environment.Job instance at 0x147a18ef2050>,16,3,[1 6],32,61,64,29,40
1,<environment.Job instance at 0x147a1a9a8aa0>,5,18,[ 1 10],17,64,82,47,53
1,<environment.Job instance at 0x147a19532eb0>,25,1,[10  1],43,82,83,39,66
1,<environment.Job instance at 0x147a1adf8aa0>,13,26,[2 9],26,86,112,60,86
1,<environment.Job instance at 0x147a19d6ce10>,4,1,[7 1],9,12,13,3,12
1,<environment.Job instance at 0x147a1c0ce730>,7,3,[10  2],13,13,16,0,13
1,<environment.Job instance at 0x147a1b8a81e0>,5,2,[1 8],11,16,18,5,14
1,<environment.Job instance at 0x147a19fc8c30>,8,2,[8 2],14,16,18,2,14
1,<environment.Job instance at 0x147a1c0ce370>,6,1,[1 6],12,21,22,9,21
1,<environment.Job instance at 0x147a1b3b98c0>,13,3,[ 2 10],23,23,26,0,23
1,<environment.Job instance at 0x147a2492f870>,14,1,[1 5],24,26,27,2,25
1,<environment.Job instance at 0x147a21ffcc30>,16,17,[1 7],26,30,47,4,30
1,<environment.Job instance at 0x147a1999b8c0>,23,14,[ 1 10],36,47,61,11,36
1,<environment.Job instance at 0x147a2749ff00>,19,1,[7 2],30,37,38,7,37
1,<environment.Job instance at 0x147a271a6fa0>,21,3,[5 2],33,39,42,6,39
1,<environment.Job instance at 0x147a18184dc0>,27,2,[7 1],40,43,45,3,43
1,<environment.Job instance at 0x147a29294960>,25,3,[2 5],38,61,64,23,43
1,<environment.Job instance at 0x147a28456dc0>,34,2,[5 1],47,61,63,14,48
1,<environment.Job instance at 0x147a1a05e230>,32,17,[10  1],45,64,81,19,63
1,<environment.Job instance at 0x147a193f0d20>,4,1,[6 2],8,9,10,1,9
1,<environment.Job instance at 0x147a197b6820>,3,14,[10  1],6,11,25,5,11
1,<environment.Job instance at 0x147a1d5b1e60>,7,12,[1 9],11,25,37,14,12
1,<environment.Job instance at 0x147a1d5b1f50>,9,2,[6 2],13,37,39,24,13
1,<environment.Job instance at 0x147a1ab095f0>,11,1,[6 2],16,39,40,23,17
1,<environment.Job instance at 0x147a1baf02d0>,10,3,[8 2],14,40,43,26,19
1,<environment.Job instance at 0x147a21fcb0a0>,15,2,[6 1],22,25,27,3,22
1,<environment.Job instance at 0x147a21d91640>,16,2,[10  2],23,43,45,20,24
1,<environment.Job instance at 0x147a1aa3fbe0>,18,2,[7 2],26,45,47,19,26
1,<environment.Job instance at 0x147a28df9690>,20,3,[1 9],29,47,50,18,29
1,<environment.Job instance at 0x147a1ac5c690>,23,2,[2 6],34,37,39,3,35
1,<environment.Job instance at 0x147a279f73c0>,13,15,[6 1],19,47,62,28,35
1,<environment.Job instance at 0x147a187b5690>,29,3,[6 2],40,62,65,22,40
1,<environment.Job instance at 0x147a1a1b8dc0>,33,14,[ 2 10],44,65,79,21,51
1,<environment.Job instance at 0x147a18f7f640>,37,15,[7 2],49,79,94,30,65
1,<environment.Job instance at 0x147a2216c690>,5,3,[2 5],9,9,12,0,9
1,<environment.Job instance at 0x147a2216c910>,10,12,[6 1],21,21,33,0,21
1,<environment.Job instance at 0x147a1c7b80f0>,11,12,[1 8],22,22,34,0,22
1,<environment.Job instance at 0x147a199bf3c0>,15,16,[1 7],27,34,50,7,31
1,<environment.Job instance at 0x147a220a1870>,18,3,[2 5],32,50,53,18,32
1,<environment.Job instance at 0x147a19c13140>,20,3,[5 1],34,34,37,0,34
1,<environment.Job instance at 0x147a19e99c30>,22,1,[9 1],36,37,38,1,36
1,<environment.Job instance at 0x147a220be1e0>,27,1,[8 1],43,44,45,1,44
1,<environment.Job instance at 0x147a220be780>,28,22,[1 7],44,53,75,9,48
1,<environment.Job instance at 0x147a19092eb0>,26,1,[6 1],42,62,63,20,62
1,<environment.Job instance at 0x147a28425d20>,0,18,[7 2],1,9,27,8,9
1,<environment.Job instance at 0x147a27970140>,7,1,[2 8],11,12,13,1,12
1,<environment.Job instance at 0x147a27970190>,8,1,[5 2],12,27,28,15,14
1,<environment.Job instance at 0x147a27970b90>,9,3,[10  2],14,28,31,14,15
1,<environment.Job instance at 0x147a27970cd0>,12,13,[5 1],19,31,44,12,19
1,<environment.Job instance at 0x147a27970690>,10,3,[8 1],15,44,47,29,25
1,<environment.Job instance at 0x147a19984500>,15,2,[9 2],22,47,49,25,26
1,<environment.Job instance at 0x147a18f63e60>,19,18,[1 8],27,31,49,4,27
1,<environment.Job instance at 0x147a1a6bf4b0>,22,1,[7 2],31,49,50,18,33
1,<environment.Job instance at 0x147a1d7f1e60>,27,3,[10  2],37,50,53,13,38
1,<environment.Job instance at 0x147a1d7f1050>,26,1,[2 7],36,49,50,13,45
1,<environment.Job instance at 0x147a1d7f1820>,25,22,[7 2],35,53,75,18,46
1,<environment.Job instance at 0x147a1d197780>,34,2,[2 6],48,53,55,5,48
1,<environment.Job instance at 0x147a270ac690>,35,2,[6 1],49,75,77,26,51
1,<environment.Job instance at 0x147a19903870>,33,15,[7 1],47,77,92,30,66
1,<environment.Job instance at 0x147a2214c230>,4,22,[9 1],5,5,27,0,5
1,<environment.Job instance at 0x147a19459960>,2,2,[2 7],3,27,29,24,5
1,<environment.Job instance at 0x147a2214c320>,8,3,[2 7],10,29,32,19,10
1,<environment.Job instance at 0x147a2214c690>,7,2,[ 1 10],9,32,34,23,11
1,<environment.Job instance at 0x147a19f00780>,12,3,[6 2],15,27,30,12,15
1,<environment.Job instance at 0x147a17f34dc0>,18,1,[5 2],25,30,31,5,25
1,<environment.Job instance at 0x147a1c243c80>,16,1,[7 1],23,31,32,8,28
1,<environment.Job instance at 0x147a285ce410>,25,2,[2 7],34,35,37,1,35
1,<environment.Job instance at 0x147a24ad5870>,19,14,[10  2],26,37,51,11,35
1,<environment.Job instance at 0x147a21ba3cd0>,29,18,[10  2],40,51,69,11,42
1,<environment.Job instance at 0x147a21ba3aa0>,30,2,[2 6],41,69,71,28,43
1,<environment.Job instance at 0x147a27d06aa0>,34,1,[1 7],45,71,72,26,45
1,<environment.Job instance at 0x147a2861a230>,1,2,[ 2 10],5,6,8,1,6
1,<environment.Job instance at 0x147a2861a2d0>,3,3,[1 5],7,14,17,7,14
1,<environment.Job instance at 0x147a282d4af0>,16,1,[2 8],27,29,30,2,29
1,<environment.Job instance at 0x147a19d28230>,11,14,[9 2],18,31,45,13,31
1,<environment.Job instance at 0x147a27babfa0>,18,14,[10  1],31,45,59,14,32
1,<environment.Job instance at 0x147a1af661e0>,20,1,[2 9],34,59,60,25,34
1,<environment.Job instance at 0x147a1a3cde60>,22,2,[9 2],38,60,62,22,40
1,<environment.Job instance at 0x147a1a6fe0f0>,24,3,[ 1 10],40,62,65,22,41
1,<environment.Job instance at 0x147a1b7fdaa0>,25,1,[7 1],41,59,60,18,42
1,<environment.Job instance at 0x147a281321e0>,30,3,[6 2],47,65,68,18,48
1,<environment.Job instance at 0x147a28132780>,31,1,[2 8],48,65,66,17,48
1,<environment.Job instance at 0x147a1af66fa0>,19,17,[1 6],33,80,97,47,80
1,<environment.Job instance at 0x147a1bf100a0>,0,1,[10  2],1,3,4,2,3
1,<environment.Job instance at 0x147a27ea2320>,2,3,[2 7],5,6,9,1,6
1,<environment.Job instance at 0x147a24acb460>,3,1,[8 1],6,10,11,4,10
1,<environment.Job instance at 0x147a24acb4b0>,4,13,[10  1],10,11,24,1,11
1,<environment.Job instance at 0x147a24bcd5f0>,13,14,[9 2],24,26,40,2,26
1,<environment.Job instance at 0x147a24acbc80>,8,2,[1 9],16,40,42,24,27
1,<environment.Job instance at 0x147a24bcdfa0>,14,17,[9 1],27,40,57,13,29
1,<environment.Job instance at 0x147a24d67460>,16,2,[2 6],30,57,59,27,30
1,<environment.Job instance at 0x147a24bcdc80>,17,2,[2 5],32,59,61,27,33
1,<environment.Job instance at 0x147a1bdbb960>,24,13,[1 9],44,44,57,0,44
1,<environment.Job instance at 0x147a24d67500>,18,16,[ 2 10],33,61,77,28,52
1,<environment.Job instance at 0x147a21cb2b90>,8,3,[9 1],13,14,17,1,14
1,<environment.Job instance at 0x147a1ab71640>,9,3,[7 2],15,17,20,2,15
1,<environment.Job instance at 0x147a19b98d20>,15,16,[10  2],22,24,40,2,24
1,<environment.Job instance at 0x147a1bd9aa50>,12,3,[8 1],18,40,43,22,25
1,<environment.Job instance at 0x147a2853caf0>,17,2,[2 7],25,40,42,15,26
1,<environment.Job instance at 0x147a2853c050>,16,2,[9 1],23,43,45,20,30
1,<environment.Job instance at 0x147a1c57bcd0>,19,15,[8 1],29,45,60,16,32
1,<environment.Job instance at 0x147a24d00190>,21,1,[ 2 10],32,60,61,28,34
1,<environment.Job instance at 0x147a24c8ccd0>,32,14,[1 9],48,61,75,13,48
1,<environment.Job instance at 0x147a2981b2d0>,27,2,[2 9],42,51,53,9,51
1,<environment.Job instance at 0x147a1cc4d280>,31,17,[10  2],46,75,92,29,65
1,<environment.Job instance at 0x147a1d9d6cd0>,0,1,[1 5],2,5,6,3,5
1,<environment.Job instance at 0x147a1ab71fa0>,1,3,[10  1],3,6,9,3,5
1,<environment.Job instance at 0x147a19bbcaa0>,4,3,[8 1],7,14,17,7,14
1,<environment.Job instance at 0x147a19cc5460>,10,1,[2 7],16,17,18,1,17
1,<environment.Job instance at 0x147a1bedb3c0>,16,1,[2 7],26,26,27,0,26
1,<environment.Job instance at 0x147a1bedba00>,18,3,[8 2],28,28,31,0,28
1,<environment.Job instance at 0x147a24bc3a00>,21,13,[8 2],32,33,46,1,33
1,<environment.Job instance at 0x147a191251e0>,22,12,[5 1],37,46,58,9,37
1,<environment.Job instance at 0x147a1c1858c0>,25,24,[1 8],40,40,64,0,40
1,<environment.Job instance at 0x147a1c185460>,28,2,[8 2],44,58,60,14,44
1,<environment.Job instance at 0x147a29042e60>,30,3,[2 9],46,64,67,18,46
1,<environment.Job instance at 0x147a283c6820>,3,3,[8 1],6,11,14,5,11
1,<environment.Job instance at 0x147a21ba3fa0>,11,2,[2 8],15,22,24,7,22
1,<environment.Job instance at 0x147a1c4dd500>,16,1,[7 2],24,24,25,0,24
1,<environment.Job instance at 0x147a27d95a00>,18,1,[10  1],27,28,29,1,28
1,<environment.Job instance at 0x147a221c8e10>,15,1,[2 9],23,29,30,6,28
1,<environment.Job instance at 0x147a1ca88870>,17,3,[2 7],26,30,33,4,30
1,<environment.Job instance at 0x147a27c157d0>,25,2,[2 6],34,36,38,2,36
1,<environment.Job instance at 0x147a27c15f00>,26,1,[9 1],35,40,41,5,40
1,<environment.Job instance at 0x147a1a276c80>,28,2,[1 8],38,41,43,3,41
1,<environment.Job instance at 0x147a1a276b90>,31,3,[10  2],42,43,46,1,42
1,<environment.Job instance at 0x147a27c15190>,27,1,[ 2 10],36,46,47,10,43
1,<environment.Job instance at 0x147a1ba6b960>,34,2,[5 2],46,47,49,1,46
1,<environment.Job instance at 0x147a1ba6baa0>,33,3,[1 6],45,48,51,3,48
1,<environment.Job instance at 0x147a1ba6b320>,36,1,[9 2],49,52,53,3,52
1,<environment.Job instance at 0x147a1d7f4a50>,0,17,[ 1 10],3,5,22,2,5
1,<environment.Job instance at 0x147a17ea6a50>,8,13,[ 2 10],11,22,35,11,12
1,<environment.Job instance at 0x147a190ce550>,10,3,[7 2],14,35,38,21,14
1,<environment.Job instance at 0x147a2aa20280>,7,3,[5 1],10,38,41,28,16
1,<environment.Job instance at 0x147a1c0b67d0>,12,3,[6 2],16,41,44,25,18
1,<environment.Job instance at 0x147a188a1f50>,17,3,[6 1],23,44,47,21,24
1,<environment.Job instance at 0x147a1a51d500>,19,3,[8 1],26,47,50,21,27
1,<environment.Job instance at 0x147a28cb0730>,18,1,[5 2],25,38,39,13,30
1,<environment.Job instance at 0x147a278d0cd0>,25,1,[6 1],34,50,51,16,42
1,<environment.Job instance at 0x147a28ace780>,26,3,[9 1],36,51,54,15,42
1,<environment.Job instance at 0x147a1a0d50f0>,30,3,[1 8],41,43,46,2,43
1,<environment.Job instance at 0x147a1d3c09b0>,31,3,[8 1],42,54,57,12,43
1,<environment.Job instance at 0x147a19e7e500>,29,13,[1 6],39,46,59,7,46
1,<environment.Job instance at 0x147a27f7e140>,34,3,[9 2],45,57,60,12,46
1,<environment.Job instance at 0x147a27f7e320>,35,3,[10  2],47,60,63,13,50
1,<environment.Job instance at 0x147a27f7e2d0>,36,3,[1 6],48,63,66,15,52
1,<environment.Job instance at 0x147a27f7ed20>,32,16,[9 1],43,63,79,20,54
1,<environment.Job instance at 0x147a27f7e460>,37,2,[2 7],49,79,81,30,54
1,<environment.Job instance at 0x147a1ba5da50>,2,1,[ 1 10],4,5,6,1,5
1,<environment.Job instance at 0x147a1ba5d8c0>,4,2,[2 8],6,7,9,1,7
1,<environment.Job instance at 0x147a1846b140>,9,15,[ 2 10],11,11,26,0,11
1,<environment.Job instance at 0x147a1846b780>,5,1,[2 9],7,26,27,19,12
1,<environment.Job instance at 0x147a1ba5deb0>,0,14,[2 5],1,27,41,26,17
1,<environment.Job instance at 0x147a282bb050>,11,1,[1 8],18,41,42,23,18
1,<environment.Job instance at 0x147a22032a00>,14,1,[7 2],22,29,30,7,29
1,<environment.Job instance at 0x147a282bbdc0>,12,16,[10  1],19,42,58,23,30
1,<environment.Job instance at 0x147a19961230>,25,18,[1 7],41,58,76,17,51
1,<environment.Job instance at 0x147a1846b960>,0,1,[10  2],1,2,3,1,2
1,<environment.Job instance at 0x147a1846b5a0>,2,2,[1 6],3,11,13,8,11
1,<environment.Job instance at 0x147a1ce485a0>,10,3,[10  1],19,22,25,3,22
1,<environment.Job instance at 0x147a1ce488c0>,15,18,[2 5],24,27,45,3,27
1,<environment.Job instance at 0x147a27747410>,26,3,[7 1],39,39,42,0,39
1,<environment.Job instance at 0x147a277479b0>,24,18,[1 5],37,42,60,5,39
1,<environment.Job instance at 0x147a277472d0>,25,1,[ 2 10],38,60,61,22,40
1,<environment.Job instance at 0x147a275369b0>,27,1,[2 5],43,48,49,5,48
1,<environment.Job instance at 0x147a27747230>,23,16,[1 9],36,61,77,25,48
1,<environment.Job instance at 0x147a1d2c6870>,2,1,[1 8],4,5,6,1,5
1,<environment.Job instance at 0x147a21d002d0>,0,2,[6 1],2,6,8,4,6
1,<environment.Job instance at 0x147a1828bc30>,3,2,[2 5],6,9,11,3,9
1,<environment.Job instance at 0x147a1828b230>,6,14,[5 1],10,11,25,1,11
1,<environment.Job instance at 0x147a1828b910>,5,1,[9 2],9,25,26,16,12
1,<environment.Job instance at 0x147a1828b190>,10,3,[1 5],14,15,18,1,15
1,<environment.Job instance at 0x147a2ab929b0>,11,15,[1 5],15,18,33,3,17
1,<environment.Job instance at 0x147a17e8d410>,20,1,[5 2],31,36,37,5,36
1,<environment.Job instance at 0x147a293327d0>,23,17,[1 5],34,37,54,3,37
1,<environment.Job instance at 0x147a19ba40a0>,25,1,[1 9],36,54,55,18,39
1,<environment.Job instance at 0x147a1c98d4b0>,26,3,[ 1 10],37,55,58,18,40
1,<environment.Job instance at 0x147a182937d0>,27,2,[5 1],39,40,42,1,40
1,<environment.Job instance at 0x147a18293410>,28,12,[1 9],40,58,70,18,41
1,<environment.Job instance at 0x147a18293af0>,29,3,[6 2],41,42,45,1,41
1,<environment.Job instance at 0x147a2737cc30>,30,1,[ 1 10],42,70,71,28,42
1,<environment.Job instance at 0x147a29332d70>,19,18,[2 5],30,86,104,56,86
1,<environment.Job instance at 0x147a1c0c1320>,0,2,[2 5],1,7,9,6,7
1,<environment.Job instance at 0x147a24d94a50>,9,2,[5 2],21,21,23,0,21
1,<environment.Job instance at 0x147a1b3c4c30>,8,1,[10  1],20,23,24,3,23
1,<environment.Job instance at 0x147a24d94d20>,12,25,[1 8],25,29,54,4,29
1,<environment.Job instance at 0x147a1b3c4dc0>,10,3,[6 1],23,34,37,11,34
1,<environment.Job instance at 0x147a1bd42140>,17,2,[1 6],33,54,56,21,35
1,<environment.Job instance at 0x147a27eb00f0>,23,2,[9 2],40,42,44,2,42
1,<environment.Job instance at 0x147a27eb08c0>,25,1,[10  1],43,56,57,13,43
1,<environment.Job instance at 0x147a27eb0140>,26,2,[6 1],44,46,48,2,46
1,<environment.Job instance at 0x147a27e49820>,15,13,[ 2 10],31,57,70,26,46
1,<environment.Job instance at 0x147a27eb03c0>,27,13,[2 9],45,70,83,25,65
1,<environment.Job instance at 0x147a21e86dc0>,1,2,[1 5],2,6,8,4,6
1,<environment.Job instance at 0x147a1c868c30>,2,15,[ 1 10],5,10,25,5,10
1,<environment.Job instance at 0x147a24d6acd0>,4,1,[7 1],9,25,26,16,11
1,<environment.Job instance at 0x147a1953fa50>,12,2,[2 7],21,25,27,4,22
1,<environment.Job instance at 0x147a19128d20>,14,1,[1 5],24,27,28,3,25
1,<environment.Job instance at 0x147a1cab52d0>,13,3,[ 2 10],23,28,31,5,25
1,<environment.Job instance at 0x147a17e4ab40>,15,2,[1 9],25,31,33,6,26
1,<environment.Job instance at 0x147a24e9b730>,18,2,[1 5],29,33,35,4,29
1,<environment.Job instance at 0x147a24aa2190>,22,2,[2 5],35,36,38,1,36
1,<environment.Job instance at 0x147a1bee8e60>,24,1,[6 2],37,38,39,1,38
1,<environment.Job instance at 0x147a1bee8280>,26,14,[2 5],39,39,53,0,39
1,<environment.Job instance at 0x147a1973e960>,30,3,[9 2],43,53,56,10,43
1,<environment.Job instance at 0x147a1973efa0>,28,2,[1 8],41,53,55,12,46
1,<environment.Job instance at 0x147a24bcc280>,34,2,[5 1],47,48,50,1,48
1,<environment.Job instance at 0x147a299254b0>,35,1,[6 1],49,50,51,1,49
1,<environment.Job instance at 0x147a1c8680a0>,3,16,[7 1],8,56,72,48,49
1,<environment.Job instance at 0x147a1d43b6e0>,2,18,[6 2],3,4,22,1,4
1,<environment.Job instance at 0x147a1d43bb40>,5,15,[2 7],9,12,27,3,12
1,<environment.Job instance at 0x147a282d8a50>,7,12,[1 9],11,27,39,16,12
1,<environment.Job instance at 0x147a24f7a820>,9,2,[6 2],13,22,24,9,14
1,<environment.Job instance at 0x147a275188c0>,15,2,[6 1],22,24,26,2,22
1,<environment.Job instance at 0x147a1b58cfa0>,17,3,[2 6],24,39,42,15,25
1,<environment.Job instance at 0x147a2849db40>,8,14,[ 2 10],12,42,56,30,35
1,<environment.Job instance at 0x147a1980be60>,27,2,[10  1],38,56,58,18,38
1,<environment.Job instance at 0x147a1980bb40>,28,1,[7 2],39,41,42,2,41
1,<environment.Job instance at 0x147a1a4a3a50>,33,14,[ 2 10],44,58,72,14,46
1,<environment.Job instance at 0x147a19c1feb0>,37,15,[7 2],49,72,87,23,58
1,<environment.Job instance at 0x147a1a6839b0>,4,3,[2 5],6,8,11,2,8
1,<environment.Job instance at 0x147a1a683370>,5,3,[2 5],9,13,16,4,13
1,<environment.Job instance at 0x147a1a6837d0>,6,17,[1 7],12,19,36,7,19
1,<environment.Job instance at 0x147a1a6830a0>,10,12,[6 1],21,22,34,1,22
1,<environment.Job instance at 0x147a1a976d20>,12,3,[1 6],24,36,39,12,26
1,<environment.Job instance at 0x147a1a683af0>,8,2,[5 1],19,34,36,15,33
1,<environment.Job instance at 0x147a1d53cd20>,25,3,[5 2],41,41,44,0,41
1,<environment.Job instance at 0x147a1a3cd0a0>,27,1,[8 1],43,44,45,1,44
1,<environment.Job instance at 0x147a2b92fc30>,23,18,[1 8],37,44,62,7,44
1,<environment.Job instance at 0x147a1b1ab320>,29,13,[9 2],47,50,63,3,50
1,<environment.Job instance at 0x147a1c960aa0>,1,2,[7 1],2,4,6,2,4
1,<environment.Job instance at 0x147a1d356a50>,4,3,[1 5],6,8,11,2,8
1,<environment.Job instance at 0x147a1d47ae60>,5,15,[10  1],8,12,27,4,12
1,<environment.Job instance at 0x147a21de7910>,7,1,[2 8],11,27,28,16,15
1,<environment.Job instance at 0x147a29c01870>,11,3,[5 1],17,27,30,10,18
1,<environment.Job instance at 0x147a27d42b90>,12,13,[5 1],19,28,41,9,20
1,<environment.Job instance at 0x147a1b62b780>,10,3,[8 1],15,41,44,26,20
1,<environment.Job instance at 0x147a27bf4be0>,14,16,[1 5],21,30,46,9,22
1,<environment.Job instance at 0x147a28693410>,18,3,[1 7],26,46,49,20,32
1,<environment.Job instance at 0x147a28693280>,23,15,[7 2],32,44,59,12,33
1,<environment.Job instance at 0x147a184afe60>,26,1,[2 7],36,49,50,13,37
1,<environment.Job instance at 0x147a184af1e0>,27,3,[10  2],37,59,62,22,37
1,<environment.Job instance at 0x147a24a7fbe0>,29,2,[2 8],43,50,52,7,44
1,<environment.Job instance at 0x147a27ace960>,32,3,[10  2],46,62,65,16,50
1,<environment.Job instance at 0x147a28693cd0>,19,18,[1 8],27,65,83,38,55
1,<environment.Job instance at 0x147a27aced70>,35,2,[6 1],49,65,67,16,59
1,<environment.Job instance at 0x147a184aff50>,25,22,[7 2],35,88,110,53,88
1,<environment.Job instance at 0x147a1b5674b0>,1,2,[5 2],2,4,6,2,4
1,<environment.Job instance at 0x147a28ef3eb0>,5,16,[8 1],7,8,24,1,8
1,<environment.Job instance at 0x147a17fddaa0>,0,3,[2 8],1,10,13,9,10
1,<environment.Job instance at 0x147a28b68820>,11,12,[8 2],13,24,36,11,20
1,<environment.Job instance at 0x147a19d6d0a0>,17,2,[2 5],24,24,26,0,24
1,<environment.Job instance at 0x147a290ad050>,20,1,[2 5],27,28,29,1,28
1,<environment.Job instance at 0x147a19d6d5a0>,18,1,[5 2],25,36,37,11,29
1,<environment.Job instance at 0x147a17c8aeb0>,22,1,[1 5],29,30,31,1,30
1,<environment.Job instance at 0x147a1c5fe3c0>,19,14,[10  2],26,37,51,11,30
1,<environment.Job instance at 0x147a28cf50f0>,25,2,[2 7],34,35,37,1,35
1,<environment.Job instance at 0x147a290ad640>,21,14,[10  2],28,51,65,23,37
1,<environment.Job instance at 0x147a278d0e60>,31,1,[7 1],42,65,66,23,42
1,<environment.Job instance at 0x147a1bbc7280>,30,2,[2 6],41,65,67,24,43
1,<environment.Job instance at 0x147a2833cfa0>,34,1,[1 7],45,67,68,22,47
1,<environment.Job instance at 0x147a278d0d70>,32,13,[1 8],43,68,81,25,56
1,<environment.Job instance at 0x147a1a51d2d0>,0,1,[2 9],2,4,5,2,4
1,<environment.Job instance at 0x147a19273460>,3,3,[1 5],7,12,15,5,12
1,<environment.Job instance at 0x147a19273d70>,9,2,[2 9],14,16,18,2,16
1,<environment.Job instance at 0x147a19273500>,10,3,[9 2],16,18,21,2,17
1,<environment.Job instance at 0x147a192739b0>,8,1,[8 2],13,21,22,8,17
1,<environment.Job instance at 0x147a287aaf00>,11,14,[9 2],18,22,36,4,18
1,<environment.Job instance at 0x147a287aacd0>,12,1,[1 5],19,19,20,0,19
1,<environment.Job instance at 0x147a287aa820>,13,12,[10  1],21,36,48,15,23
1,<environment.Job instance at 0x147a1b563960>,18,14,[10  1],31,48,62,17,33
1,<environment.Job instance at 0x147a1bddafa0>,30,3,[6 2],47,62,65,15,56
1,<environment.Job instance at 0x147a27349aa0>,2,3,[2 7],5,6,9,1,6
1,<environment.Job instance at 0x147a27349780>,4,13,[10  1],10,14,27,4,14
1,<environment.Job instance at 0x147a27de55f0>,8,2,[1 9],16,27,29,11,17
1,<environment.Job instance at 0x147a1d76c460>,11,2,[1 5],19,29,31,10,20
1,<environment.Job instance at 0x147a27349320>,13,14,[9 2],24,29,43,5,26
1,<environment.Job instance at 0x147a19e7beb0>,15,3,[7 2],28,43,46,15,28
1,<environment.Job instance at 0x147a1bec2050>,17,2,[2 5],32,43,45,11,34
1,<environment.Job instance at 0x147a1992d410>,16,2,[2 6],30,45,47,15,40
1,<environment.Job instance at 0x147a1992d3c0>,19,1,[1 9],36,47,48,11,45
1,<environment.Job instance at 0x147a1d183e10>,24,13,[1 9],44,48,61,4,46
1,<environment.Job instance at 0x147a1c31a820>,27,3,[ 1 10],48,61,64,13,49
1,<environment.Job instance at 0x147a21c5b6e0>,5,2,[1 9],9,10,12,1,10
1,<environment.Job instance at 0x147a18839fa0>,1,1,[1 5],2,12,13,10,12
1,<environment.Job instance at 0x147a21c5bc80>,7,15,[ 1 10],12,15,30,3,15
1,<environment.Job instance at 0x147a21c5b050>,9,3,[7 2],15,30,33,15,15
1,<environment.Job instance at 0x147a24b25370>,12,3,[8 1],18,33,36,15,19
1,<environment.Job instance at 0x147a21c5b410>,15,16,[10  2],22,36,52,14,27
1,<environment.Job instance at 0x147a24de8140>,17,2,[2 7],25,31,33,6,31
1,<environment.Job instance at 0x147a187abcd0>,20,1,[6 2],30,52,53,22,31
1,<environment.Job instance at 0x147a17cbeb90>,22,2,[5 2],35,53,55,18,35
1,<environment.Job instance at 0x147a19d10140>,21,1,[ 2 10],32,55,56,23,36
1,<environment.Job instance at 0x147a1b793cd0>,26,1,[6 1],40,56,57,16,41
1,<environment.Job instance at 0x147a1cd1e5f0>,23,14,[ 1 10],36,57,71,21,43
1,<environment.Job instance at 0x147a1b6065f0>,19,15,[8 1],29,71,86,42,64
1,<environment.Job instance at 0x147a1b793780>,28,16,[1 8],43,71,87,28,65
1,<environment.Job instance at 0x147a1af16410>,0,1,[1 5],2,4,5,2,4
1,<environment.Job instance at 0x147a19b98e10>,3,2,[6 1],5,7,9,2,7
1,<environment.Job instance at 0x147a1a976460>,1,3,[10  1],3,9,12,6,7
1,<environment.Job instance at 0x147a290c38c0>,4,3,[8 1],7,12,15,5,12
1,<environment.Job instance at 0x147a1b271b40>,9,2,[1 7],15,17,19,2,17
1,<environment.Job instance at 0x147a1b271780>,11,2,[1 9],17,20,22,3,20
1,<environment.Job instance at 0x147a1bcfd5f0>,13,3,[1 8],20,22,25,2,21
1,<environment.Job instance at 0x147a1bcfdcd0>,15,2,[7 1],24,24,26,0,24
1,<environment.Job instance at 0x147a1bcfd190>,16,1,[2 7],26,26,27,0,26
1,<environment.Job instance at 0x147a19cf9e10>,14,17,[8 2],23,28,45,5,28
1,<environment.Job instance at 0x147a2aa57910>,19,2,[7 1],30,45,47,15,32
1,<environment.Job instance at 0x147a2aa57140>,21,13,[8 2],32,47,60,15,32
1,<environment.Job instance at 0x147a1c7ca140>,28,2,[8 2],44,60,62,16,45
1,<environment.Job instance at 0x147a18174550>,27,1,[8 1],43,62,63,19,45
1,<environment.Job instance at 0x147a249fe8c0>,23,12,[ 2 10],38,63,75,25,50
1,<environment.Job instance at 0x147a2796e3c0>,1,2,[10  2],3,4,6,1,4
1,<environment.Job instance at 0x147a2796e4b0>,4,17,[2 8],7,8,25,1,8
1,<environment.Job instance at 0x147a2763a410>,6,3,[9 1],9,25,28,16,9
1,<environment.Job instance at 0x147a2763a3c0>,7,3,[6 1],10,11,14,1,11
1,<environment.Job instance at 0x147a1c6f8f50>,0,3,[1 8],2,25,28,23,12
1,<environment.Job instance at 0x147a2763ab40>,10,2,[2 9],14,28,30,14,15
1,<environment.Job instance at 0x147a28cc4e10>,13,3,[10  2],20,30,33,10,20
1,<environment.Job instance at 0x147a2763a6e0>,9,2,[5 1],13,21,23,8,21
1,<environment.Job instance at 0x147a21b7be60>,17,3,[2 7],26,33,36,7,27
1,<environment.Job instance at 0x147a27ddd320>,20,15,[5 1],29,33,48,4,29
1,<environment.Job instance at 0x147a27dbdb90>,15,1,[2 9],23,36,37,13,29
1,<environment.Job instance at 0x147a21dc4cd0>,22,18,[2 7],31,37,55,6,33
1,<environment.Job instance at 0x147a28d0ce60>,27,1,[ 2 10],36,55,56,19,38
1,<environment.Job instance at 0x147a28d0c190>,26,1,[9 1],35,56,57,21,38
1,<environment.Job instance at 0x147a27634690>,31,3,[10  2],42,57,60,15,43
1,<environment.Job instance at 0x147a1c404870>,34,2,[5 2],46,48,50,2,46
1,<environment.Job instance at 0x147a28d0ca00>,30,12,[ 2 10],41,60,72,19,47
1,<environment.Job instance at 0x147980867b40>,0,14,[2 5],1,1,15,0,1
1,<environment.Job instance at 0x1479add48f50>,8,14,[5 1],10,10,24,0,10
1,<environment.Job instance at 0x1479b40ab230>,6,17,[9 2],10,10,27,0,10
1,<environment.Job instance at 0x147983efb0a0>,15,18,[2 5],24,27,45,3,27
1,<environment.Job instance at 0x1479836927d0>,20,15,[6 2],32,32,47,0,32
1,<environment.Job instance at 0x1479802aefa0>,25,1,[ 2 10],38,276,277,238,276
1,<environment.Job instance at 0x147983552280>,3,16,[7 1],8,10,26,2,10
1,<environment.Job instance at 0x147983552e10>,1,13,[5 2],2,2,15,0,2
1,<environment.Job instance at 0x1479adda50f0>,2,18,[6 2],3,15,33,12,6
1,<environment.Job instance at 0x1479801e7820>,8,2,[5 1],19,1868,1870,1849,1868
1,<environment.Job instance at 0x147984146230>,0,18,[7 2],1,1,19,0,1
1,<environment.Job instance at 0x147983f81d20>,21,15,[10  2],30,38,53,8,38
1,<environment.Job instance at 0x1479879b4780>,9,3,[10  2],14,775,778,761,775
1,<environment.Job instance at 0x147983fd37d0>,5,16,[8 1],7,8,24,1,8
1,<environment.Job instance at 0x1479add528c0>,29,18,[10  2],40,68,86,28,68
1,<environment.Job instance at 0x1479add036e0>,13,2,[1 6],17,1302,1304,1285,1302
1,<environment.Job instance at 0x147983f04f00>,7,16,[10  2],11,11,27,0,11
1,<environment.Job instance at 0x147983f04a50>,11,14,[9 2],18,27,41,9,18
1,<environment.Job instance at 0x14798400e730>,16,1,[2 8],27,301,302,274,301
1,<environment.Job instance at 0x14797fd5d3c0>,12,17,[2 5],23,40,57,17,40
1,<environment.Job instance at 0x14797fd5d5a0>,9,1,[1 8],17,340,341,323,340
1,<environment.Job instance at 0x1479ae9cb960>,12,16,[2 5],18,18,34,0,18
1,<environment.Job instance at 0x1479ae9cb190>,14,17,[8 2],23,23,40,0,23
1,<environment.Job instance at 0x14797facdaa0>,1,14,[5 2],5,5,19,0,5
1,<environment.Job instance at 0x1479ae9a5c30>,12,18,[10  1],16,18,36,2,18
1,<environment.Job instance at 0x15081c2220f0>,3,18,[2 5],4,4,22,0,4
1,<environment.Job instance at 0x15081b445780>,8,15,[6 2],12,13,28,1,13
1,<environment.Job instance at 0x15081b54e2d0>,20,15,[9 2],33,38,53,5,38
1,<environment.Job instance at 0x15081f1d8fa0>,9,16,[7 1],18,18,34,0,18
1,<environment.Job instance at 0x15081b69ec80>,32,14,[2 5],49,68,82,19,68
1,<environment.Job instance at 0x15081f375cd0>,24,2,[1 5],39,638,640,599,638
1,<environment.Job instance at 0x15081f375a00>,1,13,[5 2],2,2,15,0,2
1,<environment.Job instance at 0x15081f38bb90>,2,18,[6 2],3,15,33,12,4
1,<environment.Job instance at 0x15081f29e550>,6,2,[2 8],10,142,144,132,142
1,<environment.Job instance at 0x150825ca9f00>,6,18,[10  2],10,11,29,1,11
1,<environment.Job instance at 0x15081b48a640>,13,12,[8 2],20,29,41,9,20
1,<environment.Job instance at 0x1508276afaf0>,21,16,[10  2],31,41,57,10,31
1,<environment.Job instance at 0x15081e425410>,23,2,[2 9],34,1130,1132,1096,1130
1,<environment.Job instance at 0x15081f1ae960>,17,1,[1 8],27,730,731,703,730
1,<environment.Job instance at 0x150825c72a00>,7,17,[8 2],13,14,31,1,14
1,<environment.Job instance at 0x15081b5bf050>,6,15,[5 1],9,9,24,0,9
1,<environment.Job instance at 0x15081b0ee0f0>,15,16,[5 1],19,19,35,0,19
1,<environment.Job instance at 0x15081b04af50>,21,16,[8 1],28,35,51,7,28
1,<environment.Job instance at 0x15081ae4a1e0>,41,15,[7 2],50,65,80,15,65
1,<environment.Job instance at 0x15081b043640>,26,2,[1 5],33,528,530,495,528
1,<environment.Job instance at 0x15081b549c80>,4,18,[10  1],6,6,24,0,6
1,<environment.Job instance at 0x15081b044460>,10,16,[7 1],14,24,40,10,19
1,<environment.Job instance at 0x15081af20870>,25,14,[7 2],35,40,54,5,40
1,<environment.Job instance at 0x15081e6e9050>,6,13,[10  2],14,14,27,0,14
1,<environment.Job instance at 0x15081f6603c0>,4,17,[9 1],8,9,26,1,9
1,<environment.Job instance at 0x15081b641d70>,11,2,[8 2],18,688,690,670,688
1,<environment.Job instance at 0x15081b83d280>,1,15,[10  2],3,3,18,0,3
1,<environment.Job instance at 0x154a9aef5af0>,5,3,[9 1],8,743,746,735,743
1,<environment.Job instance at 0x154a9dd04e10>,5,15,[9 2],13,13,28,0,13
1,<environment.Job instance at 0x154a9b6b0b40>,1,26,[2 5],8,9,35,1,9
1,<environment.Job instance at 0x154a9b6386e0>,14,16,[10  2],21,27,43,6,27
1,<environment.Job instance at 0x154a9ab2e9b0>,39,1,[6 1],60,90,91,30,90
1,<environment.Job instance at 0x154a9aaaef50>,20,15,[5 1],29,1662,1677,1633,1662
1,<environment.Job instance at 0x154a9e5b4960>,29,16,[5 1],39,1678,1694,1639,1678
1,<environment.Job instance at 0x154a9d9fb370>,5,3,[1 9],8,1890,1893,1882,1890
1,<environment.Job instance at 0x154a9d3d5370>,6,16,[6 1],8,8,24,0,8
1,<environment.Job instance at 0x154a9db6d140>,11,14,[7 2],15,15,29,0,15
1,<environment.Job instance at 0x154aa8092be0>,16,17,[5 2],22,29,46,7,24
1,<environment.Job instance at 0x154a9a7a08c0>,5,13,[7 2],8,8,21,0,8
1,<environment.Job instance at 0x154a9a9c5aa0>,7,18,[10  1],9,9,27,0,9
1,<environment.Job instance at 0x154a9d856320>,11,17,[10  2],16,27,44,11,16
1,<environment.Job instance at 0x14ec65b7e140>,10,16,[6 1],17,17,33,0,17
1,<environment.Job instance at 0x14ec6542c6e0>,50,1,[5 1],77,326,327,249,326
1,<environment.Job instance at 0x14ec65b7eb90>,14,1,[1 6],22,888,889,866,888
1,<environment.Job instance at 0x14ec68885c80>,0,18,[7 2],1,1,19,0,1
1,<environment.Job instance at 0x14ec65470f50>,6,18,[10  2],10,10,28,0,10
1,<environment.Job instance at 0x14ec6ae01b90>,16,2,[7 1],26,304,306,278,304
1,<environment.Job instance at 0x14ec60baf0a0>,21,17,[8 2],33,38,55,5,38
1,<environment.Job instance at 0x14ec64462cd0>,8,18,[2 7],11,13,31,2,13
1,<environment.Job instance at 0x14ec60ccc730>,7,2,[ 2 10],16,342,344,326,342
1,<environment.Job instance at 0x14ec6131adc0>,4,18,[10  1],6,6,24,0,6
1,<environment.Job instance at 0x14ec615bc140>,7,2,[10  2],9,2748,2750,2739,2748
1,<environment.Job instance at 0x14ec61fa2140>,5,13,[7 2],8,8,21,0,8
1,<environment.Job instance at 0x14ec651bca00>,8,20,[9 2],11,11,31,0,11
1,<environment.Job instance at 0x14ec62f6d730>,3,14,[5 1],9,9,23,0,9
1,<environment.Job instance at 0x14ec64514190>,2,19,[1 5],5,5,24,0,5
1,<environment.Job instance at 0x1475e0e951e0>,11,17,[9 2],20,20,37,0,20
1,<environment.Job instance at 0x1475dafcdaa0>,18,17,[10  1],28,37,54,9,37
1,<environment.Job instance at 0x1475d76d1d20>,24,18,[7 2],41,54,72,13,49
1,<environment.Job instance at 0x1475da631d70>,8,2,[1 5],16,210,212,194,210
1,<environment.Job instance at 0x1475d7910b90>,5,16,[8 1],7,7,23,0,7
1,<environment.Job instance at 0x1475db0e66e0>,20,17,[2 5],33,44,61,11,44
1,<environment.Job instance at 0x1475d80f0140>,56,15,[8 1],89,107,122,18,107
1,<environment.Job instance at 0x1475e0d9a5a0>,17,1,[1 8],27,225,226,198,225
1,<environment.Job instance at 0x1475dafcc780>,10,17,[10  2],16,16,33,0,16
1,<environment.Job instance at 0x1475dafccfa0>,14,3,[10  1],23,1438,1441,1415,1438
1,<environment.Job instance at 0x1475e1addd70>,1,14,[9 2],4,4,18,0,4
1,<environment.Job instance at 0x1475da2cf820>,2,14,[7 2],5,5,19,0,5
1,<environment.Job instance at 0x1475d6d609b0>,28,18,[6 2],47,62,80,15,62
1,<environment.Job instance at 0x1475d6d59a00>,11,17,[10  2],16,16,33,0,16
1,<environment.Job instance at 0x1475db1a6870>,3,14,[5 1],9,9,23,0,9
1,<environment.Job instance at 0x1475d6f81820>,0,17,[9 1],5,6,23,1,6
1,<environment.Job instance at 0x1475db4d14b0>,0,12,[6 1],1,1,13,0,1
1,<environment.Job instance at 0x1475db4d1d70>,5,16,[8 2],10,13,29,3,10
1,<environment.Job instance at 0x1475e1b55280>,36,18,[7 2],56,71,89,15,71
1,<environment.Job instance at 0x1475d700ea50>,11,3,[1 9],17,576,579,559,576
1,<environment.Job instance at 0x1475d700e820>,1,13,[8 1],4,4,17,0,4
1,<environment.Job instance at 0x1509cd3b7f50>,6,17,[9 2],10,10,27,0,10
1,<environment.Job instance at 0x1509c061faa0>,1,13,[5 2],2,2,15,0,2
1,<environment.Job instance at 0x1509c06fdc80>,2,18,[6 2],3,15,33,12,4
1,<environment.Job instance at 0x1509c28a0b90>,0,18,[7 2],1,1,19,0,1
1,<environment.Job instance at 0x1509cdff1f00>,12,13,[5 1],19,20,33,1,20
1,<environment.Job instance at 0x1509bfa29c80>,7,16,[10  2],11,11,27,0,11
1,<environment.Job instance at 0x1509cd3b7550>,11,14,[9 2],18,27,41,9,18
1,<environment.Job instance at 0x1509cd383640>,45,17,[2 5],73,112,129,39,112
1,<environment.Job instance at 0x1509c2cb2a00>,0,15,[5 1],1,1,16,0,1
1,<environment.Job instance at 0x1509c2cb22d0>,1,17,[5 2],2,2,19,0,2
1,<environment.Job instance at 0x1509bf5c4f00>,2,18,[9 1],5,6,24,1,6
1,<environment.Job instance at 0x1509c2833190>,20,13,[7 2],28,33,46,5,33
1,<environment.Job instance at 0x1509bf8fe4b0>,13,1,[1 5],17,170,171,153,170
1,<environment.Job instance at 0x1509bf7abaf0>,13,17,[5 2],18,18,35,0,18
1,<environment.Job instance at 0x1509bf333e10>,21,19,[9 2],30,35,54,5,34
1,<environment.Job instance at 0x1509bf7abf50>,15,3,[ 1 10],20,532,535,512,532
1,<environment.Job instance at 0x1509c29d5b40>,17,3,[7 2],22,551,554,529,551
1,<environment.Job instance at 0x1509ce0b1960>,14,19,[1 5],25,25,44,0,25
1,<environment.Job instance at 0x1509bf53daa0>,18,17,[9 1],35,36,53,1,36
1,<environment.Job instance at 0x1509bf0dc320>,0,16,[9 1],1,1,17,0,1
1,<environment.Job instance at 0x1509bfab0e10>,12,15,[7 1],23,24,39,1,24
1,<environment.Job instance at 0x14c1f5217f50>,8,18,[2 5],14,14,32,0,14
1,<environment.Job instance at 0x14c1f52022d0>,13,15,[6 2],22,22,37,0,22
1,<environment.Job instance at 0x14c1f5308410>,25,15,[9 2],43,43,58,0,43
1,<environment.Job instance at 0x14c1f5f29be0>,55,27,[5 2],83,1940,1967,1857,1940
1,<environment.Job instance at 0x14c1f52d51e0>,18,1,[ 2 10],28,2519,2520,2491,2519
1,<environment.Job instance at 0x14c1e792d230>,1,17,[10  2],4,4,21,0,4
1,<environment.Job instance at 0x14c1e7c9faa0>,36,18,[10  2],50,62,80,12,62
1,<environment.Job instance at 0x14c1e7ca1b90>,51,16,[10  2],71,96,112,25,96
1,<environment.Job instance at 0x14c1ea86d780>,7,3,[2 8],11,246,249,235,246
1,<environment.Job instance at 0x14c1e7827780>,12,17,[2 5],23,34,51,11,34
1,<environment.Job instance at 0x14c1e7b80820>,6,16,[6 1],8,8,24,0,8
1,<environment.Job instance at 0x14c1e7c9faa0>,2,14,[7 2],5,5,19,0,5
1,<environment.Job instance at 0x14c23c173280>,2,18,[9 1],5,7,25,2,7
1,<environment.Job instance at 0x14c22c16b0f0>,20,13,[7 2],28,35,48,7,35
1,<environment.Job instance at 0x14c1e7828500>,33,19,[2 5],46,60,79,14,60
1,<environment.Job instance at 0x14c1e93a4eb0>,2,18,[6 2],7,7,25,0,7
1,<environment.Job instance at 0x14c23c159aa0>,1,17,[7 1],2,2,19,0,2
1,<environment.Job instance at 0x14c1e72d4500>,18,18,[5 2],26,29,47,3,29
1,<environment.Job instance at 0x14c1e6f310f0>,0,17,[9 2],1,1,18,0,1
1,<environment.Job instance at 0x14c22c07ccd0>,2,17,[7 2],4,18,35,14,6
1,<environment.Job instance at 0x14c1f536d8c0>,3,18,[8 1],4,4,22,0,4
1,<environment.Job instance at 0x14c1f536daf0>,4,16,[7 2],5,22,38,17,9
1,<environment.Job instance at 0x14c1eb437a50>,3,16,[2 5],5,6,22,1,6
1,<environment.Job instance at 0x14c1ea6cf9b0>,21,17,[9 2],29,29,46,0,29
1,<environment.Job instance at 0x14c1f51e1e60>,35,15,[7 1],53,53,68,0,53
1,<environment.Job instance at 0x14c1ea6eb280>,10,1,[2 5],14,397,398,383,397
1,<environment.Job instance at 0x14c1f52d9960>,8,15,[6 1],15,16,31,1,16
1,<environment.Job instance at 0x14c1f5ead7d0>,5,3,[8 2],9,2779,2782,2770,2779
1,<environment.Job instance at 0x1545d235b550>,75,17,[9 2],110,203,220,93,203
1,<environment.Job instance at 0x1545d1d13af0>,5,3,[9 1],8,606,609,598,606
1,<environment.Job instance at 0x1545d1d2df50>,3,18,[2 5],4,4,22,0,4
1,<environment.Job instance at 0x1545dfb914b0>,8,15,[6 2],12,13,28,1,13
1,<environment.Job instance at 0x1545d166a9b0>,9,16,[7 1],18,20,36,2,20
1,<environment.Job instance at 0x1545d19d9f00>,54,17,[10  2],84,148,165,64,148
1,<environment.Job instance at 0x1545d243f640>,8,2,[1 5],16,840,842,824,840
1,<environment.Job instance at 0x1545df1f16e0>,6,18,[10  2],10,10,28,0,10
1,<environment.Job instance at 0x1545d55d37d0>,21,16,[10  2],31,31,47,0,31
1,<environment.Job instance at 0x1545d49305a0>,25,14,[9 2],38,47,61,9,40
1,<environment.Job instance at 0x1545d4930050>,28,15,[5 2],43,61,76,18,47
1,<environment.Job instance at 0x1545f81a7c80>,61,17,[9 1],97,106,123,9,106
1,<environment.Job instance at 0x1545d49300a0>,29,2,[10  1],46,414,416,368,414
1,<environment.Job instance at 0x1545d4935550>,6,15,[5 1],9,9,24,0,9
1,<environment.Job instance at 0x1545d1955870>,48,16,[6 1],58,95,111,37,95
1,<environment.Job instance at 0x1545d2480f50>,5,3,[8 2],7,411,414,404,411
1,<environment.Job instance at 0x1545f814e320>,1,17,[7 1],2,3,20,1,3
1,<environment.Job instance at 0x1545df1a6dc0>,36,18,[9 2],58,88,106,30,88
1,<environment.Job instance at 0x1545d18b1140>,69,15,[7 2],103,145,160,42,145
1,<environment.Job instance at 0x1545d53a5d20>,72,19,[9 2],110,163,182,53,163
1,<environment.Job instance at 0x1545dce999b0>,14,2,[2 5],21,549,551,528,549
1,<environment.Job instance at 0x1545d12500f0>,3,14,[5 1],9,9,23,0,9
1,<environment.Job instance at 0x1545d1249280>,75,2,[6 2],104,719,721,615,719
1,<environment.Job instance at 0x1545d17965f0>,14,16,[7 2],22,22,38,0,22
1,<environment.Job instance at 0x1545d179c5f0>,23,1,[1 5],38,476,477,438,476
1,<environment.Job instance at 0x1545d49aa730>,54,15,[5 1],81,2695,2710,2614,2695
1,<environment.Job instance at 0x1545dfb98c30>,68,17,[9 2],99,2710,2727,2611,2703
1,<environment.Job instance at 0x1545fa141870>,7,2,[1 5],12,2727,2729,2715,2727
1,<environment.Job instance at 0x1545df2058c0>,2,15,[7 1],3,3,18,0,3
1,<environment.Job instance at 0x1545d491a7d0>,10,24,[2 5],17,18,42,1,18
1,<environment.Job instance at 0x1545d55572d0>,0,14,[5 1],1,1,15,0,1
1,<environment.Job instance at 0x146aad27d960>,0,15,[6 2],2,2,17,0,2
1,<environment.Job instance at 0x146ab735d690>,12,15,[9 2],23,23,38,0,23
1,<environment.Job instance at 0x146ab68290a0>,6,3,[7 1],9,1210,1213,1201,1210
1,<environment.Job instance at 0x146aacc31820>,44,15,[6 1],59,95,110,36,95
1,<environment.Job instance at 0x146aafd830f0>,4,13,[9 2],7,7,20,0,7
1,<environment.Job instance at 0x146ab7101b40>,5,18,[7 2],11,20,38,9,11
1,<environment.Job instance at 0x146aafda2cd0>,26,15,[10  2],40,85,100,45,85
1,<environment.Job instance at 0x146aafb953c0>,1,15,[5 2],3,5,20,2,5
1,<environment.Job instance at 0x146ab739e960>,32,17,[2 5],53,71,88,18,71
1,<environment.Job instance at 0x146aace00c80>,80,17,[10  2],126,172,189,46,172
1,<environment.Job instance at 0x146ab739e870>,28,2,[1 9],46,481,483,435,481
1,<environment.Job instance at 0x146ab0debf00>,12,16,[2 5],18,19,35,1,19
1,<environment.Job instance at 0x146ab0debaa0>,14,17,[8 2],23,24,41,1,24
1,<environment.Job instance at 0x146ab0ab6690>,4,21,[2 5],5,6,27,1,6
1,<environment.Job instance at 0x146ab1b0ebe0>,7,2,[2 6],9,29,31,20,29
1,<environment.Job instance at 0x146aacf1c1e0>,20,2,[ 2 10],30,1362,1364,1332,1362
1,<environment.Job instance at 0x146aac6323c0>,14,16,[7 2],22,25,41,3,25
1,<environment.Job instance at 0x146ab689f550>,1,20,[10  2],4,5,25,1,5
1,<environment.Job instance at 0x146ab6797a00>,17,13,[8 1],29,30,43,1,30
1,<environment.Job instance at 0x146ab67ce960>,23,17,[6 1],38,43,60,5,40
1,<environment.Job instance at 0x146aafc1b1e0>,54,17,[9 2],79,79,96,0,79
1,<environment.Job instance at 0x146ab0b33780>,68,15,[7 1],103,104,119,1,104
1,<environment.Job instance at 0x146aae8d7140>,3,14,[6 2],4,4,18,0,4
1,<environment.Job instance at 0x146ab6764eb0>,0,16,[5 2],2,2,18,0,2
1,<environment.Job instance at 0x146ab0b5feb0>,1,12,[5 1],2,2,14,0,2
1,<environment.Job instance at 0x146ab66fb870>,8,17,[7 1],13,14,31,1,13
1,<environment.Job instance at 0x146ab7326780>,4,14,[10  2],7,7,21,0,7
1,<environment.Job instance at 0x1496c9c2e640>,5,15,[9 2],13,14,29,1,14
1,<environment.Job instance at 0x1496bbe5daf0>,9,15,[7 2],12,15,30,3,15
1,<environment.Job instance at 0x1496bf094fa0>,6,2,[8 2],9,1196,1198,1187,1196
1,<environment.Job instance at 0x1496bff54690>,16,17,[5 2],22,44,61,22,44
1,<environment.Job instance at 0x1496f8b1d7d0>,7,18,[10  1],9,9,27,0,9
1,<environment.Job instance at 0x1496bf0b40a0>,11,17,[10  2],16,27,44,11,18
1,<environment.Job instance at 0x1496bc0ee140>,4,16,[9 2],6,6,22,0,6
1,<environment.Job instance at 0x1496f81110f0>,13,17,[5 2],18,22,39,4,19
1,<environment.Job instance at 0x1496bcdc9050>,18,15,[7 2],23,39,54,16,29
1,<environment.Job instance at 0x1497102e20a0>,21,19,[9 2],30,54,73,24,44
1,<environment.Job instance at 0x1496bbb60280>,6,1,[8 1],11,1724,1725,1713,1724
1,<environment.Job instance at 0x1496bbcd56e0>,1,20,[10  2],4,4,24,0,4
1,<environment.Job instance at 0x1496f8185460>,23,17,[6 1],38,38,55,0,38
1,<environment.Job instance at 0x1496bce8fe60>,29,17,[8 2],45,55,72,10,45
1,<environment.Job instance at 0x1496bf19eb40>,12,1,[1 6],16,403,404,387,403
1,<environment.Job instance at 0x1496bf19e140>,2,15,[8 2],3,3,18,0,3
1,<environment.Job instance at 0x1496bc36caa0>,0,16,[8 2],1,1,17,0,1
1,<environment.Job instance at 0x1496bc4f1230>,12,17,[9 1],16,17,34,1,16
1,<environment.Job instance at 0x148152ec38c0>,1,15,[9 2],3,3,18,0,3
1,<environment.Job instance at 0x1481528035f0>,1,13,[5 2],2,2,15,0,2
1,<environment.Job instance at 0x148152efc1e0>,2,18,[6 2],3,15,33,12,4
1,<environment.Job instance at 0x1481527868c0>,5,16,[8 1],7,7,23,0,7
1,<environment.Job instance at 0x14816ca629b0>,9,16,[2 5],14,14,30,0,14
1,<environment.Job instance at 0x14816ca62230>,14,3,[ 1 10],20,1333,1336,1313,1333
1,<environment.Job instance at 0x14816c98c870>,14,19,[1 5],25,25,44,0,25
1,<environment.Job instance at 0x1481560ead70>,18,17,[9 1],35,36,53,1,36
1,<environment.Job instance at 0x14815249ffa0>,38,15,[2 6],59,77,92,18,77
1,<environment.Job instance at 0x1481563c4500>,0,17,[9 2],1,2,19,1,2
1,<environment.Job instance at 0x14815516ae10>,7,12,[9 2],11,19,31,8,14
1,<environment.Job instance at 0x1481552f16e0>,0,16,[9 1],1,2,18,1,2
1,<environment.Job instance at 0x148151eccd20>,43,17,[8 2],65,2134,2151,2069,2134
1,<environment.Job instance at 0x148155327780>,6,2,[6 1],11,2666,2668,2655,2666
1,<environment.Job instance at 0x148155327730>,8,3,[ 2 10],13,2895,2898,2882,2895
1,<environment.Job instance at 0x1481519c0aa0>,2,18,[2 7],3,3,21,0,3
1,<environment.Job instance at 0x14816ebbeaa0>,2,18,[8 2],4,4,22,0,4
1,<environment.Job instance at 0x148152401a50>,0,13,[9 2],1,1,14,0,1
1,<environment.Job instance at 0x149339952370>,101,15,[9 2],153,273,288,120,273
1,<environment.Job instance at 0x1493399541e0>,5,3,[9 1],8,926,929,918,926
1,<environment.Job instance at 0x149342eae460>,4,15,[1 5],5,6,21,1,6
1,<environment.Job instance at 0x149342e7e0f0>,24,27,[5 2],33,34,61,1,34
1,<environment.Job instance at 0x149342dc1640>,91,27,[5 1],134,250,277,116,250
1,<environment.Job instance at 0x1493437d3230>,14,1,[1 6],22,401,402,379,401
1,<environment.Job instance at 0x1493398f7e10>,6,18,[10  2],10,10,28,0,10
1,<environment.Job instance at 0x14933d0a0230>,25,14,[9 2],38,39,53,1,39
1,<environment.Job instance at 0x149339116e10>,28,15,[5 2],43,53,68,10,43
1,<environment.Job instance at 0x149339fcc640>,4,17,[10  2],6,6,23,0,6
1,<environment.Job instance at 0x14933c5a79b0>,4,18,[10  1],6,6,24,0,6
1,<environment.Job instance at 0x14938f56db40>,30,17,[5 2],42,56,73,14,56
1,<environment.Job instance at 0x1493614bfc80>,5,13,[7 2],8,8,21,0,8
1,<environment.Job instance at 0x1493439f76e0>,4,16,[9 1],6,7,23,1,7
1,<environment.Job instance at 0x14933d05cbe0>,3,14,[5 1],9,9,23,0,9
1,<environment.Job instance at 0x149338eee0f0>,3,18,[8 1],4,4,22,0,4
1,<environment.Job instance at 0x149338c332d0>,2,15,[7 1],3,4,19,1,4
1,<environment.Job instance at 0x14933d1f7e10>,3,14,[6 2],4,4,18,0,4
1,<environment.Job instance at 0x14933a052d20>,5,15,[2 6],8,9,24,1,9
1,<environment.Job instance at 0x14933994a050>,18,15,[9 1],23,24,39,1,24
1,<environment.Job instance at 0x14933c69e820>,16,16,[6 1],26,29,45,3,29
1,<environment.Job instance at 0x14933d51cdc0>,26,14,[5 2],39,56,70,17,56
1,<environment.Job instance at 0x14933cba0b40>,41,16,[5 2],62,62,78,0,62
1,<environment.Job instance at 0x14933d2170f0>,57,16,[7 1],80,116,132,36,116
1,<environment.Job instance at 0x1493394640f0>,11,3,[8 2],18,282,285,264,282
1,<environment.Job instance at 0x149339307190>,3,13,[8 2],7,7,20,0,7
1,<environment.Job instance at 0x149338c09f00>,7,2,[2 9],11,682,684,671,682
1,<environment.Job instance at 0x14f5fdf9a0f0>,2,16,[6 1],7,8,24,1,8
1,<environment.Job instance at 0x14f5d2dcf1e0>,0,16,[10  2],1,1,17,0,1
1,<environment.Job instance at 0x14f61c072f00>,4,14,[9 2],8,17,31,9,8
1,<environment.Job instance at 0x14f5fe1f4960>,7,15,[5 2],13,31,46,18,17
1,<environment.Job instance at 0x14f5d2cdb4b0>,9,1,[2 8],17,31,32,14,28
1,<environment.Job instance at 0x14f5fe3bc5f0>,38,17,[2 5],63,75,92,12,75
1,<environment.Job instance at 0x14f5d07d0be0>,39,14,[9 2],64,92,106,28,78
1,<environment.Job instance at 0x14f61c544460>,13,1,[2 9],24,402,403,378,402
1,<environment.Job instance at 0x14f5d3ce5dc0>,6,3,[1 7],11,62,65,51,62
1,<environment.Job instance at 0x14f5d0102320>,35,3,[1 5],52,1419,1422,1367,1419
1,<environment.Job instance at 0x14f5d3c34960>,1,14,[5 2],5,5,19,0,5
1,<environment.Job instance at 0x14f5cfa8ac30>,3,1,[1 5],9,9,10,0,9
1,<environment.Job instance at 0x14f5cfa8a230>,6,13,[10  2],14,14,27,0,14
1,<environment.Job instance at 0x14f5fe2782d0>,10,12,[9 1],22,684,696,662,684
1,<environment.Job instance at 0x14f5d39bb780>,16,2,[10  2],29,1079,1081,1050,1079
1,<environment.Job instance at 0x14f5d2cd4f00>,3,14,[6 1],6,6,20,0,6
1,<environment.Job instance at 0x14f5cf4ca370>,3,16,[2 5],5,6,22,1,6
1,<environment.Job instance at 0x14f5cf572b40>,21,17,[9 2],29,32,49,3,32
1,<environment.Job instance at 0x14f5d2ad87d0>,23,15,[6 2],36,45,60,9,45
1,<environment.Job instance at 0x14f5cf7ee910>,29,14,[6 2],44,65,79,21,65
1,<environment.Job instance at 0x14f5cf7c2fa0>,0,16,[5 2],2,2,18,0,2
1,<environment.Job instance at 0x14f5d2c34d70>,2,15,[8 2],3,3,18,0,3
1,<environment.Job instance at 0x14f5fd586460>,2,18,[2 7],3,3,21,0,3
1,<environment.Job instance at 0x14f5cfb84f00>,6,16,[8 2],7,7,23,0,7
1,<environment.Job instance at 0x14f5fd623be0>,12,25,[2 5],17,21,46,4,17
1,<environment.Job instance at 0x14f5fc0660a0>,5,20,[5 2],6,6,26,0,6
1,<environment.Job instance at 0x1454e9e75820>,4,12,[6 1],11,11,23,0,11
1,<environment.Job instance at 0x145514a30e10>,12,13,[10  1],20,21,34,1,21
1,<environment.Job instance at 0x145515710960>,6,15,[5 1],9,10,25,1,10
1,<environment.Job instance at 0x1454e6dcdd70>,15,16,[5 1],19,20,36,1,20
1,<environment.Job instance at 0x1454e7329dc0>,0,12,[6 1],1,1,13,0,1
1,<environment.Job instance at 0x1454e7c59b90>,4,17,[1 7],7,8,25,1,8
1,<environment.Job instance at 0x14551704be60>,0,16,[8 2],1,1,17,0,1
1,<environment.Job instance at 0x1455157797d0>,2,18,[8 2],4,4,22,0,4
1,<environment.Job instance at 0x1454e7430730>,1,18,[2 6],4,4,22,0,4
1,<environment.Job instance at 0x1454e70cdf00>,3,18,[9 1],5,5,23,0,5
1,<environment.Job instance at 0x1454e6cf3460>,0,19,[9 2],1,2,21,1,2
1,<environment.Job instance at 0x153f5910c4b0>,6,17,[10  1],8,10,27,2,10
1,<environment.Job instance at 0x153f5910c320>,12,18,[7 2],21,27,45,6,25
1,<environment.Job instance at 0x153f60c972d0>,77,18,[10  2],110,187,205,77,187
1,<environment.Job instance at 0x153f601d4a50>,99,15,[5 2],143,213,228,70,213
1,<environment.Job instance at 0x153f780995f0>,14,1,[1 8],24,488,489,464,488
1,<environment.Job instance at 0x153f59163910>,0,17,[2 5],3,3,20,0,3
1,<environment.Job instance at 0x153f58c67550>,1,14,[9 2],4,20,34,16,6
1,<environment.Job instance at 0x153f7bd44a00>,6,15,[9 2],9,9,24,0,9
1,<environment.Job instance at 0x153f5bdb5410>,1,17,[9 1],2,3,20,1,3
1,<environment.Job instance at 0x153f799a78c0>,1,15,[10  2],3,3,18,0,3
1,<environment.Job instance at 0x153f600d1550>,8,18,[5 2],16,16,34,0,16
1,<environment.Job instance at 0x153f59186960>,6,17,[9 1],15,15,32,0,15
1,<environment.Job instance at 0x153f6060b690>,12,15,[7 1],23,23,38,0,23
1,<environment.Job instance at 0x153f7bda6fa0>,28,16,[2 5],50,50,66,0,50
1,<environment.Job instance at 0x153f58636780>,0,14,[5 1],1,1,15,0,1
1,<environment.Job instance at 0x153f58a2c640>,1,17,[7 1],3,15,32,12,5
1,<environment.Job instance at 0x153f59004960>,4,14,[10  2],7,7,21,0,7
1,<environment.Job instance at 0x153f7a830320>,0,13,[9 2],1,1,14,0,1
1,<environment.Job instance at 0x153f58567e60>,19,18,[2 6],34,115,133,81,115
1,<environment.Job instance at 0x153f58e064b0>,21,13,[8 2],37,115,128,78,115
1,<environment.Job instance at 0x153f6011ca50>,120,13,[5 2],171,392,405,221,392
1,<environment.Job instance at 0x153f58dbbf00>,8,3,[1 6],11,410,413,399,410
1,<environment.Job instance at 0x153f5931c5a0>,21,16,[6 2],28,30,46,2,30
1,<environment.Job instance at 0x153f58716140>,29,16,[6 2],40,46,62,6,42
1,<environment.Job instance at 0x153f60c74e60>,38,15,[6 2],54,62,77,8,59
1,<environment.Job instance at 0x153f60b36640>,11,18,[9 1],15,15,33,0,15
1,<environment.Job instance at 0x153f59afe7d0>,0,19,[9 2],1,1,20,0,1
