iteration,job object,job ID,job Length,job ressource requirement,job enter time,job start time,job finish time,job waiting time,current time
1,<environment.Job instance at 0x14cb0058ab40>,6,18,[8 1],7,7,25,0,7
1,<environment.Job instance at 0x14caf6f80230>,1,13,[2 8],2,2,15,0,2
1,<environment.Job instance at 0x14caf4098190>,1,17,[6 1],3,3,20,0,3
1,<environment.Job instance at 0x14caf40d3c30>,1,12,[ 1 10],2,2,14,0,2
1,<environment.Job instance at 0x14caf4234190>,6,16,[10  2],9,14,30,5,9
1,<environment.Job instance at 0x14caf4234cd0>,4,2,[2 7],6,30,32,24,9
1,<environment.Job instance at 0x14caf89942d0>,2,3,[1 6],3,3,6,0,3
1,<environment.Job instance at 0x14caf41b7aa0>,4,12,[9 1],8,8,20,0,8
1,<environment.Job instance at 0x14cad5b18140>,0,2,[1 7],2,2,4,0,2
1,<environment.Job instance at 0x14caf41b7410>,1,3,[6 1],3,3,6,0,3
1,<environment.Job instance at 0x14cafe4d1230>,3,16,[2 5],6,6,22,0,6
1,<environment.Job instance at 0x14caf6ff0f00>,0,15,[2 9],2,2,17,0,2
1,<environment.Job instance at 0x14caf6ff08c0>,2,17,[8 1],6,6,23,0,6
1,<environment.Job instance at 0x14caf6f98870>,0,12,[9 1],1,1,13,0,1
1,<environment.Job instance at 0x14cad559c3c0>,0,13,[7 2],2,2,15,0,2
1,<environment.Job instance at 0x14caf42398c0>,4,2,[2 5],8,9,11,1,9
1,<environment.Job instance at 0x14caf42391e0>,1,14,[7 1],2,2,16,0,2
1,<environment.Job instance at 0x14caf7220dc0>,6,15,[7 1],9,9,24,0,9
1,<environment.Job instance at 0x14caf891f280>,2,12,[9 2],4,4,16,0,4
1,<environment.Job instance at 0x14cad5614dc0>,3,15,[10  2],5,16,31,11,5
1,<environment.Job instance at 0x14cad5ae4c30>,5,16,[8 1],7,31,47,24,25
1,<environment.Job instance at 0x14cad5b96e60>,5,18,[1 8],6,6,24,0,6
1,<environment.Job instance at 0x14cad5b8d640>,2,3,[2 5],3,1686,1689,1683,1686
1,<environment.Job instance at 0x14cad5533d70>,1,15,[1 7],5,5,20,0,5
1,<environment.Job instance at 0x14caf42dba50>,2,15,[2 7],3,3,18,0,3
1,<environment.Job instance at 0x14cad5685be0>,6,19,[ 1 10],8,18,37,10,9
1,<environment.Job instance at 0x147083f6a640>,0,12,[2 5],1,1,13,0,1
1,<environment.Job instance at 0x147083f6ab40>,6,18,[8 1],7,7,25,0,7
1,<environment.Job instance at 0x14707c40f910>,8,13,[6 1],9,25,38,16,12
1,<environment.Job instance at 0x14707c38fa00>,1,17,[6 1],3,3,20,0,3
1,<environment.Job instance at 0x14707c178370>,13,16,[10  2],19,25,41,6,25
1,<environment.Job instance at 0x1470615f4d70>,1,3,[2 9],2,2,5,0,2
1,<environment.Job instance at 0x1470617a8e10>,0,2,[2 8],1,1,3,0,1
1,<environment.Job instance at 0x1470617a8be0>,2,1,[2 9],5,5,6,0,5
1,<environment.Job instance at 0x1470617a8f00>,3,16,[8 2],6,6,22,0,6
1,<environment.Job instance at 0x1470617a8c30>,4,12,[9 1],8,22,34,14,8
1,<environment.Job instance at 0x1470616cd410>,0,15,[2 9],2,2,17,0,2
1,<environment.Job instance at 0x1470616cd460>,2,17,[8 1],6,6,23,0,6
1,<environment.Job instance at 0x147061037190>,0,13,[7 2],2,2,15,0,2
1,<environment.Job instance at 0x14707c0f3fa0>,8,14,[7 1],12,15,29,3,12
1,<environment.Job instance at 0x14707c0f3e10>,9,3,[ 2 10],14,29,32,15,14
1,<environment.Job instance at 0x14707c0f3870>,10,12,[2 8],15,15,27,0,15
1,<environment.Job instance at 0x1470614a9dc0>,6,15,[7 1],9,9,24,0,9
1,<environment.Job instance at 0x14707c3d3780>,12,13,[ 1 10],16,27,40,11,27
1,<environment.Job instance at 0x14707c212050>,14,17,[1 9],19,54,71,35,54
1,<environment.Job instance at 0x14706103c0f0>,4,15,[5 1],5,5,20,0,5
1,<environment.Job instance at 0x147081e48690>,13,18,[2 6],18,19,37,1,19
1,<environment.Job instance at 0x1470617c98c0>,3,15,[1 6],7,9,24,2,9
1,<environment.Job instance at 0x147061006230>,0,3,[5 1],3,3,6,0,3
1,<environment.Job instance at 0x147061006190>,1,15,[1 7],5,5,20,0,5
1,<environment.Job instance at 0x14707c3027d0>,9,17,[ 2 10],16,20,37,4,16
1,<environment.Job instance at 0x147061578af0>,1,13,[ 2 10],2,2,15,0,2
1,<environment.Job instance at 0x147061578b40>,4,15,[1 7],5,15,30,10,6
1,<environment.Job instance at 0x14706142f4b0>,6,14,[10  1],9,30,44,21,16
1,<environment.Job instance at 0x14707a4a40f0>,1,17,[7 1],2,2,19,0,2
1,<environment.Job instance at 0x14707a4a4b90>,3,16,[9 1],6,19,35,13,6
1,<environment.Job instance at 0x147081e29410>,4,15,[9 2],10,35,50,25,28
1,<environment.Job instance at 0x14706152a190>,4,18,[7 2],9,9,27,0,9
1,<environment.Job instance at 0x14707c32f280>,6,18,[10  1],16,27,45,11,16
1,<environment.Job instance at 0x1470833e9370>,6,16,[1 7],9,9,25,0,9
1,<environment.Job instance at 0x14707c34ce60>,4,3,[1 7],6,6,9,0,6
1,<environment.Job instance at 0x14707c34cb90>,5,18,[8 1],7,7,25,0,7
1,<environment.Job instance at 0x147060f17190>,0,17,[7 1],2,2,19,0,2
1,<environment.Job instance at 0x14707a99ea00>,3,12,[7 2],7,19,31,12,11
1,<environment.Job instance at 0x14707a99eb90>,6,14,[8 2],12,31,45,19,16
1,<environment.Job instance at 0x14706124f410>,0,13,[5 2],1,1,14,0,1
1,<environment.Job instance at 0x14706124f230>,5,12,[7 1],11,14,26,3,11
1,<environment.Job instance at 0x14706124fd20>,6,20,[8 2],12,26,46,14,17
1,<environment.Job instance at 0x14706124f780>,8,3,[1 9],14,46,49,32,46
1,<environment.Job instance at 0x1470814f0be0>,3,16,[7 2],4,4,20,0,4
1,<environment.Job instance at 0x1470814f0190>,5,18,[5 2],7,20,38,13,10
1,<environment.Job instance at 0x147060f6ef50>,11,15,[8 2],16,38,53,22,33
1,<environment.Job instance at 0x14707a6e1aa0>,2,16,[9 1],3,3,19,0,3
1,<environment.Job instance at 0x14707c34c4b0>,5,14,[7 2],7,19,33,12,7
1,<environment.Job instance at 0x14707c34cf50>,10,18,[6 2],16,33,51,17,25
1,<environment.Job instance at 0x1478762d6c30>,0,12,[2 5],1,1,13,0,1
1,<environment.Job instance at 0x14786e775e60>,6,18,[8 1],7,7,25,0,7
1,<environment.Job instance at 0x14786e7752d0>,8,13,[6 1],9,25,38,16,21
1,<environment.Job instance at 0x14786e77f0f0>,17,17,[6 1],23,38,55,15,26
1,<environment.Job instance at 0x14786e73bb40>,19,3,[6 2],26,56,59,30,56
1,<environment.Job instance at 0x14786ccda4b0>,1,12,[ 1 10],2,2,14,0,2
1,<environment.Job instance at 0x14786ccda280>,4,2,[2 7],6,14,16,8,6
1,<environment.Job instance at 0x14786ca55c80>,6,16,[10  2],9,16,32,7,9
1,<environment.Job instance at 0x147827b75c80>,3,16,[8 2],6,6,22,0,6
1,<environment.Job instance at 0x14786ca55320>,4,12,[9 1],8,22,34,14,8
1,<environment.Job instance at 0x147827ace050>,12,15,[2 9],22,34,49,12,22
1,<environment.Job instance at 0x147827ace780>,14,17,[8 1],26,34,51,8,26
1,<environment.Job instance at 0x147827ad0dc0>,0,12,[9 1],1,1,13,0,1
1,<environment.Job instance at 0x1478274b1460>,8,13,[7 2],12,13,26,1,12
1,<environment.Job instance at 0x1478274b1dc0>,16,14,[7 1],22,26,40,4,22
1,<environment.Job instance at 0x1478275208c0>,5,1,[2 5],6,45,46,39,45
1,<environment.Job instance at 0x14782738b960>,6,15,[7 1],9,9,24,0,9
1,<environment.Job instance at 0x14782738b3c0>,10,12,[9 2],14,24,36,10,14
1,<environment.Job instance at 0x14782738b190>,11,15,[10  2],15,36,51,21,22
1,<environment.Job instance at 0x1478274aec30>,12,15,[1 6],17,59,74,42,59
1,<environment.Job instance at 0x1478278b0370>,3,2,[1 9],8,8,10,0,8
1,<environment.Job instance at 0x1478278b0d70>,6,15,[2 7],13,13,28,0,13
1,<environment.Job instance at 0x1478278b06e0>,10,19,[ 1 10],18,28,47,10,18
1,<environment.Job instance at 0x1478278b0780>,12,3,[5 2],20,20,23,0,20
1,<environment.Job instance at 0x14786e674730>,14,13,[ 2 10],22,47,60,25,31
1,<environment.Job instance at 0x14786e674690>,18,3,[ 2 10],27,61,64,34,61
1,<environment.Job instance at 0x14786e4689b0>,2,2,[2 5],3,3,5,0,3
1,<environment.Job instance at 0x14786e468640>,6,18,[8 1],8,8,26,0,8
1,<environment.Job instance at 0x147874155b90>,14,12,[1 5],22,22,34,0,22
1,<environment.Job instance at 0x14786f41d230>,13,1,[9 1],21,99,100,78,99
1,<environment.Job instance at 0x14786f41dd70>,4,18,[7 2],9,9,27,0,9
1,<environment.Job instance at 0x1478272729b0>,6,18,[10  1],16,27,45,11,17
1,<environment.Job instance at 0x147827275500>,16,16,[1 7],29,45,61,16,32
1,<environment.Job instance at 0x1478741eb190>,0,17,[7 1],2,2,19,0,2
1,<environment.Job instance at 0x1478738905a0>,3,12,[7 2],7,19,31,12,8
1,<environment.Job instance at 0x147873890aa0>,6,14,[8 2],12,31,45,19,16
1,<environment.Job instance at 0x14786d7c0820>,13,13,[5 2],21,45,58,24,41
1,<environment.Job instance at 0x1478706c84b0>,0,12,[7 1],1,1,13,0,1
1,<environment.Job instance at 0x147827bb4640>,1,20,[8 2],2,13,33,11,10
1,<environment.Job instance at 0x1478270f6820>,18,2,[ 1 10],29,41,43,12,41
1,<environment.Job instance at 0x147827369b40>,2,18,[6 2],6,6,24,0,6
1,<environment.Job instance at 0x14782775a460>,11,3,[6 2],21,24,27,3,21
1,<environment.Job instance at 0x14782775a5a0>,13,3,[1 7],23,23,26,0,23
1,<environment.Job instance at 0x14782775ae60>,14,2,[9 2],25,27,29,2,25
1,<environment.Job instance at 0x14782775a640>,16,3,[1 7],28,28,31,0,28
1,<environment.Job instance at 0x14782775a780>,17,14,[1 6],29,31,45,2,29
1,<environment.Job instance at 0x1478277fa1e0>,1,26,[9 1],4,4,30,0,4
1,<environment.Job instance at 0x14786e5747d0>,10,15,[2 8],18,30,45,12,18
1,<environment.Job instance at 0x14786e574410>,11,16,[2 8],19,45,61,26,33
1,<environment.Job instance at 0x14786e74b410>,4,3,[1 6],7,7,10,0,7
1,<environment.Job instance at 0x14786e74bd70>,5,2,[8 2],8,8,10,0,8
1,<environment.Job instance at 0x14786e74bf50>,6,14,[9 1],10,10,24,0,10
1,<environment.Job instance at 0x1478273f7190>,13,15,[10  1],19,24,39,5,19
1,<environment.Job instance at 0x147827be8780>,4,16,[1 5],5,7,23,2,7
1,<environment.Job instance at 0x1478277966e0>,7,15,[7 2],8,9,24,1,9
1,<environment.Job instance at 0x147827787230>,14,1,[6 2],18,24,25,6,19
1,<environment.Job instance at 0x1478272d9780>,16,1,[6 2],21,25,26,4,21
1,<environment.Job instance at 0x14782748adc0>,17,1,[2 9],22,26,27,4,23
1,<environment.Job instance at 0x1478272d9870>,19,2,[10  1],24,27,29,3,24
1,<environment.Job instance at 0x147827796820>,6,17,[2 9],7,63,80,56,63
1,<environment.Job instance at 0x147827762500>,1,12,[6 1],2,2,14,0,2
1,<environment.Job instance at 0x147874189190>,8,15,[1 8],12,12,27,0,12
1,<environment.Job instance at 0x147874189870>,12,17,[9 2],18,18,35,0,18
1,<environment.Job instance at 0x1478741899b0>,13,1,[6 2],19,35,36,16,19
1,<environment.Job instance at 0x147874189af0>,14,2,[1 5],20,27,29,7,20
1,<environment.Job instance at 0x147874189c30>,15,1,[1 7],21,29,30,8,21
1,<environment.Job instance at 0x147874189d70>,16,3,[2 7],22,35,38,13,22
1,<environment.Job instance at 0x1478741a2320>,20,15,[7 1],27,36,51,9,27
1,<environment.Job instance at 0x1478741a30a0>,2,17,[2 7],4,4,21,0,4
1,<environment.Job instance at 0x14786f4373c0>,8,12,[9 2],10,21,33,11,10
1,<environment.Job instance at 0x147874179a50>,12,16,[10  2],14,33,49,19,20
1,<environment.Job instance at 0x14782762bdc0>,19,14,[6 1],23,49,63,26,44
1,<environment.Job instance at 0x147868030c80>,24,13,[10  1],28,63,76,35,47
1,<environment.Job instance at 0x147827174370>,4,16,[10  1],9,9,25,0,9
1,<environment.Job instance at 0x1478271747d0>,7,12,[7 1],14,25,37,11,14
1,<environment.Job instance at 0x1478273e1a50>,13,1,[7 1],26,37,38,11,26
1,<environment.Job instance at 0x14786e59cfa0>,15,14,[2 5],28,28,42,0,28
1,<environment.Job instance at 0x1528030b3640>,0,12,[2 5],1,1,13,0,1
1,<environment.Job instance at 0x1527fb557b40>,6,18,[8 1],7,7,25,0,7
1,<environment.Job instance at 0x1527fb557870>,8,13,[6 1],9,25,38,16,11
1,<environment.Job instance at 0x1527f95c3140>,0,15,[2 9],2,2,17,0,2
1,<environment.Job instance at 0x152800eea4b0>,2,17,[8 1],6,6,23,0,6
1,<environment.Job instance at 0x152800eeabe0>,6,12,[9 1],11,23,35,12,11
1,<environment.Job instance at 0x1527f9a82960>,14,13,[7 2],22,35,48,13,30
1,<environment.Job instance at 0x15280101a640>,22,14,[7 1],32,48,62,16,34
1,<environment.Job instance at 0x15280101a1e0>,24,12,[2 8],35,35,47,0,35
1,<environment.Job instance at 0x1527f8108410>,1,2,[2 6],2,3,5,1,3
1,<environment.Job instance at 0x15280059c0a0>,10,12,[9 2],14,14,26,0,14
1,<environment.Job instance at 0x1527f062bc80>,11,15,[10  2],15,26,41,11,15
1,<environment.Job instance at 0x1527f062b280>,13,16,[8 1],17,41,57,24,28
1,<environment.Job instance at 0x1527f062ba50>,22,2,[ 1 10],30,57,59,27,30
1,<environment.Job instance at 0x1527f0636780>,28,15,[9 2],37,64,79,27,64
1,<environment.Job instance at 0x1527f06365f0>,29,18,[2 6],38,79,97,41,71
1,<environment.Job instance at 0x1527f0194a00>,21,2,[2 9],35,130,132,95,130
1,<environment.Job instance at 0x1527f0194af0>,22,17,[ 2 10],36,132,149,96,130
1,<environment.Job instance at 0x1527f0194230>,3,15,[1 6],7,207,222,200,207
1,<environment.Job instance at 0x1527fb3c0af0>,1,13,[ 2 10],2,2,15,0,2
1,<environment.Job instance at 0x1527f03bf5f0>,6,14,[10  1],9,15,29,6,9
1,<environment.Job instance at 0x1527f03bffa0>,7,12,[7 1],10,29,41,19,21
1,<environment.Job instance at 0x1527f0390aa0>,20,15,[9 2],30,41,56,11,30
1,<environment.Job instance at 0x1527f9816550>,15,16,[1 6],19,54,70,35,54
1,<environment.Job instance at 0x1527fb24b9b0>,4,18,[7 2],9,9,27,0,9
1,<environment.Job instance at 0x1527fb24bd20>,6,18,[10  1],16,27,45,11,16
1,<environment.Job instance at 0x1527f8164b90>,12,2,[5 2],24,45,47,21,24
1,<environment.Job instance at 0x1527f81644b0>,14,14,[6 1],27,47,61,20,46
1,<environment.Job instance at 0x1527fb4b2370>,2,18,[5 2],3,3,21,0,3
1,<environment.Job instance at 0x1527fc1cf7d0>,5,18,[8 1],7,21,39,14,12
1,<environment.Job instance at 0x1527f03faa00>,16,17,[7 1],22,39,56,17,27
1,<environment.Job instance at 0x1527f019a6e0>,22,14,[8 2],32,56,70,24,52
1,<environment.Job instance at 0x1527fc1fa690>,18,3,[1 8],25,62,65,37,62
1,<environment.Job instance at 0x1527fb51d1e0>,0,13,[5 2],1,1,14,0,1
1,<environment.Job instance at 0x1527f0059eb0>,5,12,[7 1],11,14,26,3,11
1,<environment.Job instance at 0x1527f005b5a0>,12,3,[5 2],23,26,29,3,23
1,<environment.Job instance at 0x1527f005b6e0>,13,16,[7 2],24,29,45,5,24
1,<environment.Job instance at 0x1527f005b960>,15,18,[5 2],27,45,63,18,43
1,<environment.Job instance at 0x1527f077b3c0>,9,18,[ 1 10],16,848,866,832,848
1,<environment.Job instance at 0x1527f0739640>,0,14,[1 6],2,2,16,0,2
1,<environment.Job instance at 0x1527fbe9c050>,12,14,[1 6],19,20,34,1,20
1,<environment.Job instance at 0x1527fbe9c370>,15,26,[9 1],24,24,50,0,24
1,<environment.Job instance at 0x1527f016a6e0>,24,15,[2 8],38,50,65,12,38
1,<environment.Job instance at 0x15280059c820>,25,16,[2 8],39,65,81,26,52
1,<environment.Job instance at 0x1527f0464a50>,0,13,[ 2 10],2,2,15,0,2
1,<environment.Job instance at 0x1527f0565fa0>,10,16,[2 6],16,16,32,0,16
1,<environment.Job instance at 0x1527f0597460>,13,14,[9 1],20,32,46,12,20
1,<environment.Job instance at 0x1527f0597cd0>,20,15,[10  1],29,46,61,17,37
1,<environment.Job instance at 0x1527afe08dc0>,4,16,[1 5],5,5,21,0,5
1,<environment.Job instance at 0x1527afe08d70>,6,17,[2 9],7,21,38,14,11
1,<environment.Job instance at 0x1527f077bb90>,23,2,[ 1 10],30,38,40,8,34
1,<environment.Job instance at 0x1527f077bc80>,24,3,[2 5],31,40,43,9,34
1,<environment.Job instance at 0x1527f077b0a0>,25,12,[6 1],32,40,52,8,34
1,<environment.Job instance at 0x1528005b3f00>,8,16,[2 8],9,69,85,60,69
1,<environment.Job instance at 0x1527fbeaa9b0>,0,15,[1 8],2,2,17,0,2
1,<environment.Job instance at 0x1527affa1230>,5,1,[6 2],9,1060,1061,1051,1060
1,<environment.Job instance at 0x1527fb3c27d0>,0,13,[5 1],1,1,14,0,1
1,<environment.Job instance at 0x1527fbe75370>,2,14,[6 1],3,14,28,11,5
1,<environment.Job instance at 0x1527afdfa3c0>,7,13,[10  1],8,28,41,20,12
1,<environment.Job instance at 0x1527afdfacd0>,14,16,[10  1],19,41,57,22,28
1,<environment.Job instance at 0x1527afdfad20>,17,12,[7 1],24,57,69,33,43
1,<environment.Job instance at 0x1527affa70f0>,0,12,[1 5],1,1,13,0,1
1,<environment.Job instance at 0x1527affa7050>,1,13,[7 2],2,2,15,0,2
1,<environment.Job instance at 0x1527f03e0e10>,4,18,[1 5],7,13,31,6,11
1,<environment.Job instance at 0x1527f03e0a50>,11,2,[ 1 10],20,31,33,11,20
1,<environment.Job instance at 0x1527f03e0280>,12,16,[ 2 10],22,33,49,11,22
1,<environment.Job instance at 0x1527f03e0230>,13,3,[10  2],23,49,52,26,23
1,<environment.Job instance at 0x1527f03e0960>,14,2,[1 6],27,52,54,25,27
1,<environment.Job instance at 0x1527f03e0140>,15,3,[1 9],28,54,57,26,28
1,<environment.Job instance at 0x1527f07b7140>,18,3,[10  2],34,59,62,25,59
1,<environment.Job instance at 0x1527f017f3c0>,2,14,[2 8],3,3,17,0,3
1,<environment.Job instance at 0x1527f017faf0>,6,17,[2 8],7,17,34,10,7
1,<environment.Job instance at 0x1527f017fa00>,8,2,[ 1 10],10,34,36,24,10
1,<environment.Job instance at 0x1527f017f5a0>,9,3,[9 2],12,36,39,24,12
1,<environment.Job instance at 0x1527f017ffa0>,10,2,[5 1],13,13,15,0,13
1,<environment.Job instance at 0x1527f95b3be0>,11,17,[1 9],14,39,56,25,27
1,<environment.Job instance at 0x1527f95b3460>,20,15,[2 7],30,111,126,81,111
1,<environment.Job instance at 0x1527f8236230>,0,14,[1 5],1,2,16,1,2
1,<environment.Job instance at 0x1527f075c410>,5,16,[8 1],10,10,26,0,10
1,<environment.Job instance at 0x1527f075c140>,6,16,[1 6],11,19,35,8,19
1,<environment.Job instance at 0x1527f075c050>,13,3,[1 5],20,35,38,15,20
1,<environment.Job instance at 0x1527f075cbe0>,14,12,[2 9],22,38,50,16,22
1,<environment.Job instance at 0x15280064fc80>,21,17,[2 9],31,50,67,19,41
1,<environment.Job instance at 0x15280064f780>,24,17,[5 2],34,67,84,33,55
1,<environment.Job instance at 0x15280064f5a0>,19,1,[ 1 10],29,85,86,56,85
1,<environment.Job instance at 0x1527f9a63640>,4,16,[ 2 10],5,5,21,0,5
1,<environment.Job instance at 0x1527f9a63a00>,10,13,[2 8],13,21,34,8,13
1,<environment.Job instance at 0x1527f9a391e0>,15,17,[10  1],20,34,51,14,22
1,<environment.Job instance at 0x1527f9a39960>,23,15,[6 1],30,51,66,21,37
1,<environment.Job instance at 0x1527f9a39af0>,25,2,[1 5],32,51,53,19,37
1,<environment.Job instance at 0x1527f9a39b40>,27,14,[2 6],35,53,67,18,38
1,<environment.Job instance at 0x1527f9a397d0>,20,15,[5 2],26,111,126,85,111
1,<environment.Job instance at 0x14ecfb426640>,0,12,[2 5],1,1,13,0,1
1,<environment.Job instance at 0x14ecfb426b40>,6,18,[8 1],7,7,25,0,7
1,<environment.Job instance at 0x14ecf38b0460>,8,13,[6 1],9,25,38,16,12
1,<environment.Job instance at 0x14ecf388bb40>,17,17,[6 1],23,38,55,15,28
1,<environment.Job instance at 0x14ecf380beb0>,29,16,[10  2],39,55,71,16,42
1,<environment.Job instance at 0x14ecf3805910>,0,13,[7 2],2,2,15,0,2
1,<environment.Job instance at 0x14ecd8ab0be0>,8,14,[7 1],12,15,29,3,12
1,<environment.Job instance at 0x14ecf1e420a0>,23,3,[2 8],32,32,35,0,32
1,<environment.Job instance at 0x14ecf1e42230>,24,12,[9 2],34,35,47,1,34
1,<environment.Job instance at 0x14ecf1e42640>,25,15,[10  2],35,47,62,12,35
1,<environment.Job instance at 0x14ecf1e423c0>,27,16,[8 1],37,62,78,25,52
1,<environment.Job instance at 0x14ecf1e44fa0>,34,15,[5 1],45,79,94,34,79
1,<environment.Job instance at 0x14ecf1e42f00>,29,13,[2 9],40,94,107,54,94
1,<environment.Job instance at 0x14ecf00b50a0>,6,18,[2 6],8,16,34,8,16
1,<environment.Job instance at 0x14ecf003cfa0>,1,13,[ 2 10],2,2,15,0,2
1,<environment.Job instance at 0x14ecd84f0640>,6,14,[10  1],9,15,29,6,9
1,<environment.Job instance at 0x14ecd84f0500>,7,12,[7 1],10,29,41,19,12
1,<environment.Job instance at 0x14ecd84e78c0>,14,18,[8 1],18,41,59,23,30
1,<environment.Job instance at 0x14ecd84e70f0>,20,15,[9 2],30,59,74,29,45
1,<environment.Job instance at 0x14ecd84e7730>,22,12,[1 5],32,45,57,13,45
1,<environment.Job instance at 0x14ecf890bf00>,1,18,[10  1],6,6,24,0,6
1,<environment.Job instance at 0x14ecf89c50f0>,9,14,[6 1],17,24,38,7,17
1,<environment.Job instance at 0x14ecf89c5230>,11,16,[1 7],19,24,40,5,23
1,<environment.Job instance at 0x14ecf895de10>,0,17,[7 1],2,2,19,0,2
1,<environment.Job instance at 0x14ecf895d690>,6,14,[8 2],12,19,33,7,12
1,<environment.Job instance at 0x14ecf895dc30>,13,13,[5 2],21,33,46,12,21
1,<environment.Job instance at 0x14ecd862bf50>,14,3,[1 9],22,46,49,24,23
1,<environment.Job instance at 0x14ecd84d4be0>,18,12,[7 1],31,46,58,15,31
1,<environment.Job instance at 0x14ecd854f0a0>,28,18,[5 2],47,58,76,11,47
1,<environment.Job instance at 0x14ecf370bb90>,0,12,[2 9],3,3,15,0,3
1,<environment.Job instance at 0x14ecf4562a50>,3,15,[8 2],6,15,30,9,7
1,<environment.Job instance at 0x14ecd86506e0>,4,17,[10  1],8,30,47,22,18
1,<environment.Job instance at 0x14ecf92c45a0>,20,16,[9 1],33,47,63,14,37
1,<environment.Job instance at 0x14ecd854e050>,28,18,[6 2],46,63,81,17,53
1,<environment.Job instance at 0x14ecf356a230>,0,14,[1 6],2,2,16,0,2
1,<environment.Job instance at 0x14ecd83dd6e0>,12,14,[1 6],19,19,33,0,19
1,<environment.Job instance at 0x14ecd83ddd20>,17,2,[2 5],26,33,35,7,26
1,<environment.Job instance at 0x14ecd83dde60>,18,16,[2 9],27,35,51,8,27
1,<environment.Job instance at 0x14ecd83ddfa0>,19,12,[5 2],28,51,63,23,34
1,<environment.Job instance at 0x14ecd83df5a0>,24,15,[2 8],38,51,66,13,38
1,<environment.Job instance at 0x14ecf36e0870>,2,1,[1 8],5,5,6,0,5
1,<environment.Job instance at 0x14ecd83df640>,3,16,[2 6],6,6,22,0,6
1,<environment.Job instance at 0x14ecd8577140>,6,14,[9 1],10,22,36,12,10
1,<environment.Job instance at 0x14ecf00a7910>,13,15,[10  1],19,36,51,17,22
1,<environment.Job instance at 0x14ecfa437370>,27,17,[2 9],37,326,343,289,326
1,<environment.Job instance at 0x14ecfa4379b0>,29,16,[2 8],39,365,381,326,365
1,<environment.Job instance at 0x14ecf9250870>,3,2,[10  1],4,4,6,0,4
1,<environment.Job instance at 0x14ecfa8ca730>,4,2,[2 7],6,6,8,0,6
1,<environment.Job instance at 0x14ecd8920140>,5,1,[5 2],7,7,8,0,7
1,<environment.Job instance at 0x14ecf1e939b0>,6,1,[2 5],8,8,9,0,8
1,<environment.Job instance at 0x14ecf1e0e050>,7,2,[ 1 10],10,10,12,0,10
1,<environment.Job instance at 0x14ecfa8ca6e0>,8,3,[2 5],11,12,15,1,11
1,<environment.Job instance at 0x14ecf1e93640>,9,12,[6 1],12,12,24,0,12
1,<environment.Job instance at 0x14ecd86a1460>,10,2,[5 2],13,24,26,11,13
1,<environment.Job instance at 0x14ecf457bc30>,11,1,[7 1],16,26,27,10,16
1,<environment.Job instance at 0x14ecd858c410>,12,2,[7 1],17,27,29,10,17
1,<environment.Job instance at 0x14ecf457b370>,13,1,[7 2],18,29,30,11,18
1,<environment.Job instance at 0x14ecd8787230>,14,3,[10  2],19,30,33,11,19
1,<environment.Job instance at 0x14ecd8aeb370>,15,2,[5 2],20,24,26,4,20
1,<environment.Job instance at 0x14ecd8aeb550>,16,15,[1 8],22,33,48,11,22
1,<environment.Job instance at 0x14ecd8aebaa0>,20,17,[9 2],28,33,50,5,28
1,<environment.Job instance at 0x14ecf01699b0>,33,17,[2 7],44,50,67,6,45
1,<environment.Job instance at 0x14ecf0169320>,35,17,[9 1],46,67,84,21,60
1,<environment.Job instance at 0x14ecf0169730>,34,14,[1 6],45,748,762,703,748
1,<environment.Job instance at 0x14ecf416f280>,0,2,[2 6],1,2,4,1,2
1,<environment.Job instance at 0x14ecf0169730>,3,16,[10  2],4,4,20,0,4
1,<environment.Job instance at 0x14ecf0169910>,5,2,[1 6],7,20,22,13,8
1,<environment.Job instance at 0x14ecf0102320>,6,15,[2 6],9,22,37,13,9
1,<environment.Job instance at 0x14ecf00e66e0>,22,16,[10  1],29,37,53,8,29
1,<environment.Job instance at 0x14ecf00e6aa0>,25,12,[7 1],34,53,65,19,36
1,<environment.Job instance at 0x14ecf00e6b40>,30,18,[2 6],44,53,71,9,44
1,<environment.Job instance at 0x14ecf4203190>,1,13,[7 2],2,2,15,0,2
1,<environment.Job instance at 0x14ecf891fa50>,4,18,[1 5],7,8,26,1,8
1,<environment.Job instance at 0x14ecf891f960>,7,3,[2 9],14,26,29,12,14
1,<environment.Job instance at 0x14ecd86e3b90>,12,16,[ 2 10],22,29,45,7,22
1,<environment.Job instance at 0x14ecd81b50f0>,18,3,[10  2],34,45,48,11,34
1,<environment.Job instance at 0x14ecf4137370>,22,2,[6 2],41,48,50,7,41
1,<environment.Job instance at 0x14ecf4137140>,23,3,[9 1],42,50,53,8,42
1,<environment.Job instance at 0x14ecf4137c80>,24,14,[2 8],43,53,67,10,43
1,<environment.Job instance at 0x14ecf4137410>,28,17,[2 8],47,127,144,80,127
1,<environment.Job instance at 0x14ecd8364e10>,4,2,[2 9],7,7,9,0,7
1,<environment.Job instance at 0x14ecd8364eb0>,5,15,[2 8],12,13,28,1,13
1,<environment.Job instance at 0x14ecd8914e60>,7,13,[10  1],15,28,41,13,17
1,<environment.Job instance at 0x14ecd8b62730>,19,12,[7 1],36,41,53,5,36
1,<environment.Job instance at 0x14ecf1e0ec80>,1,17,[9 2],3,3,20,0,3
1,<environment.Job instance at 0x14ecd8b82a00>,7,13,[2 5],9,20,33,11,13
1,<environment.Job instance at 0x14ecd8511550>,14,14,[1 5],21,21,35,0,21
1,<environment.Job instance at 0x14ecd8382be0>,19,16,[8 1],30,33,49,3,30
1,<environment.Job instance at 0x14ecd83a0eb0>,26,16,[1 9],39,40,56,1,40
1,<environment.Job instance at 0x14ecf01b7e10>,28,12,[2 9],42,56,68,14,42
1,<environment.Job instance at 0x14ecd83a07d0>,22,3,[1 7],34,136,139,102,136
1,<environment.Job instance at 0x14ecf3803460>,2,2,[6 2],3,3,5,0,3
1,<environment.Job instance at 0x14ecf459f280>,3,17,[5 2],4,5,22,1,4
1,<environment.Job instance at 0x14ecd8724870>,6,3,[2 7],9,9,12,0,9
1,<environment.Job instance at 0x14ecd8724a50>,8,3,[8 2],11,22,25,11,11
1,<environment.Job instance at 0x14ecd8724050>,12,16,[ 2 10],15,25,41,10,15
1,<environment.Job instance at 0x14ecf89cf230>,18,13,[2 8],23,41,54,18,25
1,<environment.Job instance at 0x14ecf89cfe60>,20,1,[1 5],26,54,55,28,28
1,<environment.Job instance at 0x14ecf89cf640>,23,17,[10  1],30,55,72,25,43
1,<environment.Job instance at 0x14ecd87a31e0>,34,16,[1 8],43,106,122,63,106
1,<environment.Job instance at 0x14ecf36f57d0>,1,2,[5 1],2,3,5,1,3
1,<environment.Job instance at 0x14ecd87a3c30>,2,1,[1 7],3,5,6,2,5
1,<environment.Job instance at 0x14ecf360e3c0>,3,17,[9 1],6,6,23,0,6
1,<environment.Job instance at 0x14ecf360e820>,9,13,[6 1],14,23,36,9,19
1,<environment.Job instance at 0x14ecf0176e10>,2,13,[7 2],4,4,17,0,4
1,<environment.Job instance at 0x14ecf00a0be0>,4,15,[ 2 10],6,17,32,11,6
1,<environment.Job instance at 0x14ecf00b3370>,11,18,[6 1],15,32,50,17,21
1,<environment.Job instance at 0x14ecf00b3690>,16,16,[6 2],21,50,66,29,37
1,<environment.Job instance at 0x14ecf008f140>,29,17,[1 7],40,286,303,246,286
1,<environment.Job instance at 0x14ecd8a13870>,4,17,[1 6],11,11,28,0,11
1,<environment.Job instance at 0x14ecd8a13d70>,6,13,[2 9],16,28,41,12,16
1,<environment.Job instance at 0x14ecf3606cd0>,12,15,[10  1],23,41,56,18,28
1,<environment.Job instance at 0x14ecf88cfc80>,21,12,[6 2],33,56,68,23,48
1,<environment.Job instance at 0x14ecf88cf730>,27,14,[9 2],40,68,82,28,58
1,<environment.Job instance at 0x14ecf88cfb40>,29,16,[1 8],42,74,90,32,74
1,<environment.Job instance at 0x14c2e091fc30>,0,12,[2 5],1,1,13,0,1
1,<environment.Job instance at 0x14c2d8dc3c80>,6,18,[8 1],7,7,25,0,7
1,<environment.Job instance at 0x14c2d8d8d320>,18,2,[10  1],25,25,27,0,25
1,<environment.Job instance at 0x14c2d8d8d050>,19,3,[6 2],26,27,30,1,26
1,<environment.Job instance at 0x14c2d75b2460>,3,16,[8 2],6,6,22,0,6
1,<environment.Job instance at 0x14c2d75b2140>,4,12,[9 1],8,22,34,14,8
1,<environment.Job instance at 0x14c2d75b28c0>,14,17,[8 1],26,34,51,8,26
1,<environment.Job instance at 0x14c2d709eb40>,18,12,[9 1],31,51,63,20,34
1,<environment.Job instance at 0x14c2d6e3a730>,34,14,[7 1],52,63,77,11,58
1,<environment.Job instance at 0x14c2de766e60>,1,2,[2 6],2,2,4,0,2
1,<environment.Job instance at 0x14c2d73601e0>,9,3,[2 8],12,12,15,0,12
1,<environment.Job instance at 0x14c2d73602d0>,10,12,[9 2],14,15,27,1,14
1,<environment.Job instance at 0x14c2d73600f0>,11,15,[10  2],15,27,42,12,15
1,<environment.Job instance at 0x14c2d7360c80>,13,16,[8 1],17,42,58,25,29
1,<environment.Job instance at 0x14c2d7360140>,20,15,[5 1],25,58,73,33,44
1,<environment.Job instance at 0x14c2ddeca870>,29,18,[2 6],38,157,175,119,157
1,<environment.Job instance at 0x14c2b5af80a0>,0,3,[5 1],3,3,6,0,3
1,<environment.Job instance at 0x14c2b5af8370>,2,3,[ 2 10],6,6,9,0,6
1,<environment.Job instance at 0x14c2b5af8140>,3,2,[1 9],8,9,11,1,8
1,<environment.Job instance at 0x14c2b5af86e0>,5,3,[5 2],12,12,15,0,12
1,<environment.Job instance at 0x14c2b5af8500>,6,15,[2 7],13,14,29,1,14
1,<environment.Job instance at 0x14c2d414a190>,12,3,[5 2],20,20,23,0,20
1,<environment.Job instance at 0x14c2d414a640>,13,2,[ 1 10],21,29,31,8,21
1,<environment.Job instance at 0x14c2d414ae60>,14,13,[ 2 10],22,31,44,9,22
1,<environment.Job instance at 0x14c2d414a5a0>,15,1,[1 7],23,44,45,21,23
1,<environment.Job instance at 0x14c2d414a500>,20,12,[7 1],30,44,56,14,30
1,<environment.Job instance at 0x14c2b5d74280>,27,18,[8 1],38,56,74,18,45
1,<environment.Job instance at 0x14c2ddecaf00>,32,16,[9 1],46,74,90,28,61
1,<environment.Job instance at 0x14c2b59fc410>,1,3,[2 8],5,5,8,0,5
1,<environment.Job instance at 0x14c2b59f9f50>,4,18,[7 2],9,9,27,0,9
1,<environment.Job instance at 0x14c2b59f9690>,6,18,[10  1],16,27,45,11,16
1,<environment.Job instance at 0x14c2b59f2960>,18,2,[6 2],32,1630,1632,1598,1630
1,<environment.Job instance at 0x14c2ddeca280>,0,17,[7 1],2,2,19,0,2
1,<environment.Job instance at 0x14c2d41a0a00>,6,14,[8 2],12,19,33,7,12
1,<environment.Job instance at 0x14c2d41a0910>,9,14,[8 1],16,33,47,17,21
1,<environment.Job instance at 0x14c2d424c4b0>,18,12,[7 1],31,47,59,16,33
1,<environment.Job instance at 0x14c2d8c72640>,28,18,[5 2],47,59,77,12,50
1,<environment.Job instance at 0x14c2d8c72370>,31,12,[2 9],53,77,89,24,68
1,<environment.Job instance at 0x14c2d424c960>,13,13,[5 2],21,100,113,79,100
1,<environment.Job instance at 0x14c2d8cd3960>,9,18,[ 1 10],16,457,475,441,457
1,<environment.Job instance at 0x14c2d8bf51e0>,1,26,[9 1],4,4,30,0,4
1,<environment.Job instance at 0x14c2d8c08af0>,5,12,[5 2],8,30,42,22,15
1,<environment.Job instance at 0x14c2de8797d0>,18,3,[1 5],30,35,38,5,35
1,<environment.Job instance at 0x14c2de8795f0>,19,2,[1 9],31,42,44,11,35
1,<environment.Job instance at 0x14c2d41b0f50>,20,3,[2 8],32,38,41,6,35
1,<environment.Job instance at 0x14c2b5c036e0>,22,16,[2 6],36,44,60,8,37
1,<environment.Job instance at 0x14c2d4187640>,25,14,[9 1],40,60,74,20,45
1,<environment.Job instance at 0x14c2b59efaa0>,28,15,[1 5],43,60,75,17,56
1,<environment.Job instance at 0x14c2b5ea4230>,32,15,[10  1],49,75,90,26,61
1,<environment.Job instance at 0x14c2d8d15eb0>,2,18,[8 2],3,3,21,0,3
1,<environment.Job instance at 0x14c2b58a75f0>,6,17,[2 9],7,21,38,14,10
1,<environment.Job instance at 0x14c2b58a7be0>,17,1,[2 9],22,38,39,16,22
1,<environment.Job instance at 0x14c2b58a95a0>,21,1,[5 2],27,39,40,12,27
1,<environment.Job instance at 0x14c2b58a9820>,23,2,[ 1 10],30,40,42,10,30
1,<environment.Job instance at 0x14c2b58a9910>,24,3,[2 5],31,42,45,11,31
1,<environment.Job instance at 0x14c2b58a9aa0>,25,12,[6 1],32,42,54,10,32
1,<environment.Job instance at 0x14c2b58ab960>,36,17,[9 2],48,54,71,6,48
1,<environment.Job instance at 0x14c2b5830be0>,0,1,[2 6],1,1,2,0,1
1,<environment.Job instance at 0x14c2b58a7dc0>,2,17,[2 7],4,4,21,0,4
1,<environment.Job instance at 0x14c2de7bf8c0>,4,17,[9 1],6,21,38,15,9
1,<environment.Job instance at 0x14c2b5e86140>,12,16,[10  2],14,38,54,24,25
1,<environment.Job instance at 0x14c2b5e868c0>,17,13,[5 1],21,54,67,33,38
1,<environment.Job instance at 0x14c2b5e86410>,24,13,[10  1],28,67,80,39,51
1,<environment.Job instance at 0x14c2decd85a0>,0,12,[1 5],1,1,13,0,1
1,<environment.Job instance at 0x14c2decd8460>,1,13,[7 2],2,3,16,1,3
1,<environment.Job instance at 0x14c2d9784e60>,5,16,[1 5],11,13,29,2,12
1,<environment.Job instance at 0x14c2b58cb3c0>,12,16,[ 2 10],22,29,45,7,23
1,<environment.Job instance at 0x14c2d8c442d0>,21,2,[7 2],40,45,47,5,40
1,<environment.Job instance at 0x14c2b5b548c0>,23,3,[9 1],42,47,50,5,42
1,<environment.Job instance at 0x14c2b5b54fa0>,24,14,[2 8],43,50,64,7,43
1,<environment.Job instance at 0x14c2d72d1a00>,27,21,[1 8],46,64,85,18,56
1,<environment.Job instance at 0x14c2d72d1c80>,32,2,[5 1],53,56,58,3,56
1,<environment.Job instance at 0x14c2d72d11e0>,35,2,[2 9],57,85,87,28,58
1,<environment.Job instance at 0x14c2b55ff7d0>,0,15,[2 8],2,2,17,0,2
1,<environment.Job instance at 0x14c2d9755280>,2,13,[10  1],5,17,30,12,7
1,<environment.Job instance at 0x14c2b5b38640>,23,18,[5 1],38,38,56,0,38
1,<environment.Job instance at 0x14c2b5b38780>,24,15,[6 1],39,59,74,20,59
1,<environment.Job instance at 0x14c2b5b38870>,27,17,[9 2],43,74,91,31,71
1,<environment.Job instance at 0x14c2b5855eb0>,0,14,[1 5],1,1,15,0,1
1,<environment.Job instance at 0x14c2b5855fa0>,4,25,[8 1],9,9,34,0,9
1,<environment.Job instance at 0x14c2d41710a0>,9,14,[9 2],16,34,48,18,19
1,<environment.Job instance at 0x14c2b5b28b40>,18,12,[1 7],27,41,53,14,41
1,<environment.Job instance at 0x14c2b5ee6320>,20,19,[2 5],30,53,72,23,44
1,<environment.Job instance at 0x14c2b5ee62d0>,21,17,[2 9],31,72,89,41,60
1,<environment.Job instance at 0x14c2b5ee6410>,24,17,[5 2],34,89,106,55,84
1,<environment.Job instance at 0x14c2b56d5a00>,35,14,[8 2],47,106,120,59,91
1,<environment.Job instance at 0x14c2d979c410>,0,25,[9 1],1,1,26,0,1
1,<environment.Job instance at 0x14c2d979c280>,4,15,[5 2],6,26,41,20,12
1,<environment.Job instance at 0x14c2d8d32d20>,8,2,[2 9],11,41,43,30,14
1,<environment.Job instance at 0x14c2d8d32be0>,9,2,[1 5],12,14,16,2,14
1,<environment.Job instance at 0x14c2d8d32cd0>,10,16,[1 8],13,16,32,3,14
1,<environment.Job instance at 0x14c2d8d028c0>,13,17,[2 5],17,43,60,26,31
1,<environment.Job instance at 0x14c2de83de10>,15,15,[9 2],20,60,75,40,46
1,<environment.Job instance at 0x14c2dc970aa0>,19,17,[9 1],26,75,92,49,70
1,<environment.Job instance at 0x14c2b5ba3dc0>,42,13,[2 9],53,92,105,39,88
1,<environment.Job instance at 0x14c2b5f17e10>,5,3,[2 7],8,188,191,180,188
1,<environment.Job instance at 0x14c2d9a0aeb0>,0,14,[2 9],1,1,15,0,1
1,<environment.Job instance at 0x14c2d96cac30>,8,3,[5 2],9,15,18,6,9
1,<environment.Job instance at 0x14c2d96cb550>,12,13,[7 2],14,18,31,4,14
1,<environment.Job instance at 0x14c2d96cba50>,16,3,[2 5],19,20,23,1,20
1,<environment.Job instance at 0x14c2d96cbb40>,18,3,[7 2],21,31,34,10,21
1,<environment.Job instance at 0x14c2d96cbeb0>,20,2,[2 7],23,23,25,0,23
1,<environment.Job instance at 0x14c2d96cbfa0>,21,18,[6 1],25,34,52,9,25
1,<environment.Job instance at 0x14c2d96cbdc0>,22,15,[2 9],26,34,49,8,26
1,<environment.Job instance at 0x14c2d96de5f0>,27,1,[6 1],32,52,53,20,40
1,<environment.Job instance at 0x14c2d96de370>,28,2,[9 1],34,53,55,19,40
1,<environment.Job instance at 0x14c2d96de690>,29,19,[1 5],36,49,68,13,40
1,<environment.Job instance at 0x14c2d96de7d0>,30,1,[8 1],37,55,56,18,40
1,<environment.Job instance at 0x14c2d96de730>,31,1,[5 1],39,56,57,17,40
1,<environment.Job instance at 0x14c2d96de6e0>,32,2,[7 2],40,57,59,17,40
1,<environment.Job instance at 0x14c2d96aa230>,39,17,[1 7],50,68,85,18,58
1,<environment.Job instance at 0x14c2d8b1ca00>,0,17,[1 6],1,1,18,0,1
1,<environment.Job instance at 0x14c2d8b1cb90>,2,13,[2 9],6,18,31,12,6
1,<environment.Job instance at 0x14c2d72d9e10>,17,12,[6 2],23,31,43,8,23
1,<environment.Job instance at 0x14c2d7371870>,21,14,[7 1],28,43,57,15,28
1,<environment.Job instance at 0x14c2dc970640>,27,3,[5 2],34,57,60,23,47
1,<environment.Job instance at 0x14c2b597b370>,33,16,[2 9],42,60,76,18,47
1,<environment.Job instance at 0x14c2b597b780>,35,23,[9 1],46,76,99,30,70
1,<environment.Job instance at 0x14c2b597bbe0>,36,14,[ 1 10],47,250,264,203,250
1,<environment.Job instance at 0x14c2b599bf00>,2,13,[2 5],8,8,21,0,8
1,<environment.Job instance at 0x14c2b5d39c80>,3,15,[1 9],6,6,21,0,6
1,<environment.Job instance at 0x14c2b5d39a00>,13,15,[6 1],22,22,37,0,22
1,<environment.Job instance at 0x14c2b59cc0f0>,15,17,[10  1],26,37,54,11,26
1,<environment.Job instance at 0x14c2b592a690>,35,13,[8 2],56,289,302,233,289
1,<environment.Job instance at 0x14c2b592a870>,36,1,[7 1],57,302,303,245,290
1,<environment.Job instance at 0x14c2b59cc1e0>,25,12,[2 8],41,304,316,263,304
1,<environment.Job instance at 0x14c2b59ccaf0>,23,1,[1 7],38,317,318,279,317
1,<environment.Job instance at 0x14c2d72e4e10>,6,21,[9 1],11,11,32,0,11
1,<environment.Job instance at 0x14c2d72e4f00>,7,16,[1 6],12,12,28,0,12
1,<environment.Job instance at 0x14c2d72e4a50>,8,15,[10  2],13,32,47,19,18
1,<environment.Job instance at 0x14c2d72e33c0>,20,16,[9 2],30,47,63,17,35
1,<environment.Job instance at 0x14c2d72ae410>,30,14,[ 1 10],44,63,77,19,49
1,<environment.Job instance at 0x14c2d72aefa0>,35,18,[2 9],50,77,95,27,66
1,<environment.Job instance at 0x14c2d72c01e0>,39,17,[5 1],54,77,94,23,66
1,<environment.Job instance at 0x148a0f63b640>,0,12,[2 5],1,1,13,0,1
1,<environment.Job instance at 0x148a07adf820>,6,18,[8 1],7,7,25,0,7
1,<environment.Job instance at 0x148a07aa9320>,17,17,[6 1],23,25,42,2,23
1,<environment.Job instance at 0x148a07a1bb90>,35,2,[1 8],45,57,59,12,57
1,<environment.Job instance at 0x148a060308c0>,6,15,[2 9],12,12,27,0,12
1,<environment.Job instance at 0x148a06030e10>,7,1,[1 9],15,27,28,12,15
1,<environment.Job instance at 0x148a06030410>,8,17,[8 1],16,16,33,0,16
1,<environment.Job instance at 0x148a07a19230>,20,13,[7 2],32,33,46,1,32
1,<environment.Job instance at 0x148a07a19050>,28,14,[7 1],42,46,60,4,42
1,<environment.Job instance at 0x148a07a1a870>,35,2,[2 6],52,52,54,0,52
1,<environment.Job instance at 0x148a05db2050>,36,1,[1 5],53,54,55,1,53
1,<environment.Job instance at 0x148a05db2eb0>,37,2,[1 9],56,56,58,0,56
1,<environment.Job instance at 0x148a062d00a0>,38,1,[2 7],57,58,59,1,57
1,<environment.Job instance at 0x148a062d0370>,40,15,[7 1],59,60,75,1,59
1,<environment.Job instance at 0x148a062d0be0>,44,12,[9 2],64,95,107,31,95
1,<environment.Job instance at 0x148a062d0e10>,45,15,[10  2],65,107,122,42,95
1,<environment.Job instance at 0x148a041b13c0>,11,3,[5 2],16,16,19,0,16
1,<environment.Job instance at 0x148a041b10f0>,12,15,[9 2],17,19,34,2,17
1,<environment.Job instance at 0x148a041b1050>,13,18,[2 6],18,34,52,16,28
1,<environment.Job instance at 0x148a04156d20>,20,3,[7 2],28,39,42,11,39
1,<environment.Job instance at 0x148a04156be0>,21,2,[1 8],29,52,54,23,44
1,<environment.Job instance at 0x148a041a1be0>,6,18,[8 1],8,8,26,0,8
1,<environment.Job instance at 0x148a041a1fa0>,14,12,[1 5],22,22,34,0,22
1,<environment.Job instance at 0x148a041ec690>,25,18,[7 2],39,39,57,0,39
1,<environment.Job instance at 0x148a042f6c30>,27,18,[10  1],46,57,75,11,46
1,<environment.Job instance at 0x148a042f6050>,36,15,[2 8],58,75,90,17,61
1,<environment.Job instance at 0x1489ec6f0b40>,2,18,[5 2],3,3,21,0,3
1,<environment.Job instance at 0x1489ec6f0410>,5,18,[8 1],7,21,39,14,12
1,<environment.Job instance at 0x1489ec8bbc80>,13,12,[7 1],18,39,51,21,29
1,<environment.Job instance at 0x1489ec8d4050>,22,14,[8 2],32,51,65,19,36
1,<environment.Job instance at 0x148a05ffc0a0>,29,13,[5 2],41,65,78,24,49
1,<environment.Job instance at 0x148a04039cd0>,33,3,[1 7],49,49,52,0,49
1,<environment.Job instance at 0x148a0d590780>,42,16,[7 2],64,78,94,14,73
1,<environment.Job instance at 0x148a07a3e410>,0,12,[2 9],3,3,15,0,3
1,<environment.Job instance at 0x148a04098550>,3,15,[8 2],6,15,30,9,6
1,<environment.Job instance at 0x148a04098730>,4,17,[10  1],8,30,47,22,19
1,<environment.Job instance at 0x1489ecb41550>,17,3,[ 2 10],30,47,50,17,30
1,<environment.Job instance at 0x1489ecb417d0>,20,16,[9 1],33,50,66,17,37
1,<environment.Job instance at 0x148a0cb03640>,28,18,[6 2],46,66,84,20,62
1,<environment.Job instance at 0x148a0cb034b0>,39,3,[1 7],63,64,67,1,64
1,<environment.Job instance at 0x148a0876caa0>,42,3,[1 7],68,68,71,0,68
1,<environment.Job instance at 0x148a0876c3c0>,43,14,[1 6],69,71,85,2,69
1,<environment.Job instance at 0x148a0871ed20>,0,3,[6 1],3,3,6,0,3
1,<environment.Job instance at 0x1489ecb41410>,1,26,[9 1],4,6,32,2,4
1,<environment.Job instance at 0x148a079500a0>,5,12,[5 2],8,32,44,24,22
1,<environment.Job instance at 0x1489ec6b2be0>,16,3,[2 9],27,44,47,17,27
1,<environment.Job instance at 0x148a079f4a50>,17,1,[5 1],29,32,33,3,29
1,<environment.Job instance at 0x148a0f545280>,18,3,[1 5],30,33,36,3,30
1,<environment.Job instance at 0x148a04202d20>,19,2,[1 9],31,47,49,16,32
1,<environment.Job instance at 0x148a06098190>,22,16,[2 6],36,49,65,13,37
1,<environment.Job instance at 0x1489ecb2b460>,25,14,[9 1],40,65,79,25,50
1,<environment.Job instance at 0x1489ecb55640>,1,3,[2 8],2,2,5,0,2
1,<environment.Job instance at 0x148a079f9b40>,9,2,[10  1],14,14,16,0,14
1,<environment.Job instance at 0x148a079f95a0>,11,1,[5 2],17,17,18,0,17
1,<environment.Job instance at 0x148a060afb40>,14,3,[2 5],21,21,24,0,21
1,<environment.Job instance at 0x148a06087af0>,15,12,[6 1],22,22,34,0,22
1,<environment.Job instance at 0x148a08485eb0>,22,15,[1 8],32,33,48,1,33
1,<environment.Job instance at 0x1489eca59910>,27,1,[6 2],39,39,40,0,39
1,<environment.Job instance at 0x1489eca591e0>,28,2,[1 5],40,48,50,8,40
1,<environment.Job instance at 0x1489ec7bb230>,30,3,[2 7],42,50,53,8,42
1,<environment.Job instance at 0x148a078d4a00>,34,15,[7 1],47,47,62,0,47
1,<environment.Job instance at 0x1489ec7d4960>,39,17,[2 7],54,55,72,1,55
1,<environment.Job instance at 0x1489ec75b5a0>,41,17,[9 1],56,72,89,16,61
1,<environment.Job instance at 0x1489ec7b3d70>,49,16,[10  2],64,89,105,25,76
1,<environment.Job instance at 0x1489ec7b3c30>,51,2,[1 6],67,105,107,38,101
1,<environment.Job instance at 0x1489ec7c11e0>,0,13,[5 1],1,1,14,0,1
1,<environment.Job instance at 0x1489ec7b3c30>,2,14,[6 1],3,14,28,11,4
1,<environment.Job instance at 0x1489ec5dec80>,4,14,[2 8],5,5,19,0,5
1,<environment.Job instance at 0x1489ec5def50>,7,13,[10  1],8,28,41,20,12
1,<environment.Job instance at 0x1489ec5deeb0>,11,3,[7 1],16,41,44,25,16
1,<environment.Job instance at 0x1489ec5e1140>,12,3,[2 8],17,19,22,2,17
1,<environment.Job instance at 0x1489ec5e15a0>,13,3,[1 9],18,22,25,4,18
1,<environment.Job instance at 0x1489ec5e16e0>,14,16,[10  1],19,44,60,25,31
1,<environment.Job instance at 0x1489ec5e1730>,17,12,[7 1],24,60,72,36,43
1,<environment.Job instance at 0x1489ec5e3410>,28,13,[7 2],42,72,85,30,58
1,<environment.Job instance at 0x1489ec5e51e0>,39,16,[ 2 10],62,85,101,23,72
1,<environment.Job instance at 0x1489ec5661e0>,0,16,[2 7],1,1,17,0,1
1,<environment.Job instance at 0x148a084a8320>,8,14,[2 8],13,17,31,4,13
1,<environment.Job instance at 0x148a0ec66320>,11,21,[1 8],16,31,52,15,23
1,<environment.Job instance at 0x1489ecb2e870>,16,2,[5 1],23,23,25,0,23
1,<environment.Job instance at 0x1489ecb2e6e0>,18,3,[9 2],25,31,34,6,30
1,<environment.Job instance at 0x1489ecb2e230>,19,2,[2 9],27,52,54,25,30
1,<environment.Job instance at 0x148a0797f7d0>,20,15,[2 8],32,54,69,22,40
1,<environment.Job instance at 0x148a0797feb0>,22,13,[10  1],35,69,82,34,53
1,<environment.Job instance at 0x148a0797fd20>,27,2,[8 2],45,58,60,13,58
1,<environment.Job instance at 0x1489ec9a0730>,34,12,[7 1],56,87,99,31,87
1,<environment.Job instance at 0x148a08348dc0>,1,17,[9 2],3,3,20,0,3
1,<environment.Job instance at 0x148a0ea904b0>,7,13,[2 5],9,20,33,11,11
1,<environment.Job instance at 0x148a0cb99370>,17,17,[2 8],26,33,50,7,27
1,<environment.Job instance at 0x148a078635a0>,19,16,[8 1],30,31,47,1,31
1,<environment.Job instance at 0x148a0ce1d1e0>,23,14,[9 2],36,50,64,14,37
1,<environment.Job instance at 0x148a0ce1d960>,26,16,[1 9],39,64,80,25,56
1,<environment.Job instance at 0x1489ec4654b0>,33,1,[ 1 10],49,80,81,31,60
1,<environment.Job instance at 0x1489ec85b820>,34,19,[2 5],50,81,100,31,71
1,<environment.Job instance at 0x148a077f8c30>,35,17,[2 9],51,100,117,49,95
1,<environment.Job instance at 0x148a0f5146e0>,49,14,[8 2],67,117,131,50,109
1,<environment.Job instance at 0x148a0ce1d230>,1,13,[2 8],3,3,16,0,3
1,<environment.Job instance at 0x148a0415d870>,6,17,[10  1],10,16,33,6,10
1,<environment.Job instance at 0x1489ec6c23c0>,14,15,[6 1],20,33,48,13,20
1,<environment.Job instance at 0x1489ec6c2500>,15,2,[2 9],21,33,35,12,21
1,<environment.Job instance at 0x1489ec6c2820>,17,16,[1 8],23,35,51,12,23
1,<environment.Job instance at 0x1489ec6c2d70>,22,15,[9 2],30,48,63,18,34
1,<environment.Job instance at 0x1489ec6f8d70>,0,14,[2 9],1,1,15,0,1
1,<environment.Job instance at 0x148a087190f0>,12,13,[7 2],14,15,28,1,14
1,<environment.Job instance at 0x148a07a4f190>,14,15,[ 2 10],16,28,43,12,20
1,<environment.Job instance at 0x148a07a4f410>,21,18,[6 1],25,43,61,18,32
1,<environment.Job instance at 0x1489ec46a7d0>,30,1,[8 1],37,61,62,24,37
1,<environment.Job instance at 0x1489ec46a5f0>,31,1,[5 1],39,62,63,23,39
1,<environment.Job instance at 0x148a07a4f550>,22,15,[2 9],26,241,256,215,241
1,<environment.Job instance at 0x1489ecaa3be0>,2,3,[2 5],4,4,7,0,4
1,<environment.Job instance at 0x148a0876b0f0>,4,12,[5 2],7,7,19,0,7
1,<environment.Job instance at 0x1489ec7753c0>,12,1,[9 2],20,20,21,0,20
1,<environment.Job instance at 0x148a042d60a0>,13,1,[10  1],21,21,22,0,21
1,<environment.Job instance at 0x1489eca54640>,23,14,[9 1],34,44,58,10,44
1,<environment.Job instance at 0x148a0cb42eb0>,25,1,[6 2],37,58,59,21,44
1,<environment.Job instance at 0x148a086e45f0>,27,2,[2 7],39,58,60,19,44
1,<environment.Job instance at 0x148a086e4320>,28,3,[9 2],41,60,63,19,44
1,<environment.Job instance at 0x148a06b1e7d0>,30,17,[1 8],48,60,77,12,48
1,<environment.Job instance at 0x148a06b1e410>,31,2,[8 2],50,63,65,13,50
1,<environment.Job instance at 0x148a06b1e780>,32,17,[1 6],51,77,94,26,65
1,<environment.Job instance at 0x1489ec5889b0>,34,13,[2 9],56,94,107,38,78
1,<environment.Job instance at 0x1489ec78b5f0>,42,1,[8 2],65,78,79,13,78
1,<environment.Job instance at 0x1489ec837dc0>,43,2,[ 1 10],66,107,109,41,80
1,<environment.Job instance at 0x148a04046dc0>,5,14,[7 1],8,8,22,0,8
1,<environment.Job instance at 0x148a04046c80>,7,14,[9 2],10,22,36,12,10
1,<environment.Job instance at 0x148a0404b780>,17,16,[2 9],22,36,52,14,24
1,<environment.Job instance at 0x148a0404bd70>,19,23,[9 1],26,52,75,26,46
1,<environment.Job instance at 0x148a040573c0>,30,20,[8 1],40,82,102,42,82
1,<environment.Job instance at 0x148a0404b5a0>,20,14,[ 1 10],27,838,852,811,838
1,<environment.Job instance at 0x148a04057320>,3,2,[5 2],6,7,9,1,7
1,<environment.Job instance at 0x1489ec40a8c0>,18,3,[ 2 10],25,84,87,59,84
1,<environment.Job instance at 0x1489ec3fdd20>,21,2,[10  2],28,87,89,59,84
1,<environment.Job instance at 0x1489ec3fd0f0>,22,2,[1 7],29,89,91,60,84
1,<environment.Job instance at 0x1489ec3fd280>,23,3,[2 8],30,91,94,61,84
1,<environment.Job instance at 0x1489ec3fd5f0>,25,1,[7 1],34,89,90,55,84
1,<environment.Job instance at 0x1489ecaaaf50>,27,15,[1 9],36,94,109,58,84
1,<environment.Job instance at 0x1489ecaaa140>,28,3,[6 1],37,90,93,53,84
1,<environment.Job instance at 0x1489ecaaac30>,32,2,[10  2],43,109,111,66,84
1,<environment.Job instance at 0x1489ecaaa870>,33,1,[5 1],44,93,94,49,84
1,<environment.Job instance at 0x1489ecaaab90>,34,2,[8 2],45,111,113,66,84
1,<environment.Job instance at 0x1489ecaaaaf0>,39,17,[10  1],56,113,130,57,101
1,<environment.Job instance at 0x1489ec40a230>,17,13,[7 1],22,226,239,204,226
1,<environment.Job instance at 0x148a04282c80>,0,12,[2 8],1,1,13,0,1
1,<environment.Job instance at 0x148a0d4c50a0>,4,1,[ 2 10],5,13,14,8,6
1,<environment.Job instance at 0x148a0d4c5f50>,5,12,[2 8],8,14,26,6,8
1,<environment.Job instance at 0x148a0d4c5870>,6,3,[ 1 10],11,26,29,15,11
1,<environment.Job instance at 0x148a0d4c59b0>,7,1,[8 2],12,12,13,0,12
1,<environment.Job instance at 0x148a0d4c5140>,8,18,[9 1],13,29,47,16,18
1,<environment.Job instance at 0x148a077d9f00>,20,21,[9 1],31,47,68,16,39
1,<environment.Job instance at 0x148a09a237d0>,34,16,[9 2],50,68,84,18,55
1,<environment.Job instance at 0x148a08316410>,36,15,[6 1],53,84,99,31,81
1,<environment.Job instance at 0x1489ec6f6f50>,10,13,[8 2],16,167,180,151,167
1,<environment.Job instance at 0x148a0402e0f0>,5,3,[9 2],6,6,9,0,6
1,<environment.Job instance at 0x1489ec6cf8c0>,6,2,[1 8],7,7,9,0,7
1,<environment.Job instance at 0x1489ec6cf6e0>,7,26,[8 1],8,9,35,1,8
1,<environment.Job instance at 0x1489ec6cf500>,8,3,[2 5],9,9,12,0,9
1,<environment.Job instance at 0x1489ec6cfb90>,9,2,[8 1],10,35,37,25,10
1,<environment.Job instance at 0x1489ec6cfe10>,11,21,[9 2],12,37,58,25,29
1,<environment.Job instance at 0x1489ec6e44b0>,19,16,[5 2],23,58,74,35,45
1,<environment.Job instance at 0x1489ec6e4730>,24,1,[6 1],31,74,75,43,46
1,<environment.Job instance at 0x1489ec8a8aa0>,0,16,[7 1],1,1,17,0,1
1,<environment.Job instance at 0x1489ec8c5a50>,3,2,[5 1],4,17,19,13,4
1,<environment.Job instance at 0x1489ec8c5460>,9,15,[6 1],15,19,34,4,15
1,<environment.Job instance at 0x1489ec8c5c30>,11,17,[8 1],17,34,51,17,23
1,<environment.Job instance at 0x148a08738460>,21,15,[8 1],29,51,66,22,37
1,<environment.Job instance at 0x148a087386e0>,26,13,[7 2],40,66,79,26,62
1,<environment.Job instance at 0x148a043a3c30>,34,3,[1 9],51,62,65,11,62
1,<environment.Job instance at 0x148a043a3730>,35,17,[1 5],52,65,82,13,62
1,<environment.Job instance at 0x148a043a3640>,36,3,[8 1],54,79,82,25,62
1,<environment.Job instance at 0x148a043a3230>,37,1,[1 8],55,82,83,27,62
1,<environment.Job instance at 0x148a043a3f00>,38,1,[10  2],59,83,84,24,62
1,<environment.Job instance at 0x148a043a3050>,39,2,[2 6],60,84,86,24,62
1,<environment.Job instance at 0x148a043a3870>,40,1,[1 5],61,86,87,25,62
1,<environment.Job instance at 0x148a043b0c30>,41,3,[7 2],63,84,87,21,63
1,<environment.Job instance at 0x148a043b0b90>,44,3,[10  1],68,87,90,19,70
1,<environment.Job instance at 0x1489ec8c5960>,1,28,[2 5],3,4,32,1,4
1,<environment.Job instance at 0x1489ec6e4eb0>,3,1,[1 9],5,32,33,27,5
1,<environment.Job instance at 0x1489eca4fd20>,4,3,[6 2],6,6,9,0,6
1,<environment.Job instance at 0x15231d66dc30>,0,12,[2 5],1,1,13,0,1
1,<environment.Job instance at 0x152315b019b0>,6,18,[8 1],7,7,25,0,7
1,<environment.Job instance at 0x152315afa960>,8,13,[6 1],9,25,38,16,10
1,<environment.Job instance at 0x152315afaeb0>,10,13,[2 8],12,13,26,1,12
1,<environment.Job instance at 0x152315adbf00>,17,17,[6 1],23,38,55,15,31
1,<environment.Job instance at 0x152315ad0b40>,29,16,[10  2],39,55,71,16,42
1,<environment.Job instance at 0x152315a474b0>,0,15,[2 9],2,2,17,0,2
1,<environment.Job instance at 0x152315a47aa0>,2,17,[8 1],6,6,23,0,6
1,<environment.Job instance at 0x152315a47320>,6,12,[9 1],11,23,35,12,13
1,<environment.Job instance at 0x152313b6fe10>,14,13,[7 2],22,35,48,13,22
1,<environment.Job instance at 0x152315a492d0>,22,14,[7 1],32,48,62,16,34
1,<environment.Job instance at 0x152315a49b40>,28,2,[1 8],41,41,43,0,41
1,<environment.Job instance at 0x152314062f00>,34,15,[7 1],49,62,77,13,50
1,<environment.Job instance at 0x152314304f50>,43,13,[2 9],60,71,84,11,71
1,<environment.Job instance at 0x152314304320>,48,15,[5 1],65,77,92,12,77
1,<environment.Job instance at 0x1523143043c0>,49,18,[1 8],66,84,102,18,84
1,<environment.Job instance at 0x152314327b40>,56,15,[9 2],77,92,107,15,86
1,<environment.Job instance at 0x152314327500>,57,18,[2 6],78,125,143,47,125
1,<environment.Job instance at 0x15231031b870>,4,18,[7 2],9,9,27,0,9
1,<environment.Job instance at 0x15231031b8c0>,6,18,[10  1],16,27,45,11,16
1,<environment.Job instance at 0x1522e27481e0>,0,13,[5 2],1,1,14,0,1
1,<environment.Job instance at 0x1522e27482d0>,5,12,[7 1],11,14,26,3,11
1,<environment.Job instance at 0x1522e2748690>,6,20,[8 2],12,26,46,14,17
1,<environment.Job instance at 0x1522e27459b0>,13,16,[7 2],24,46,62,22,33
1,<environment.Job instance at 0x1522e273e6e0>,21,15,[8 2],36,62,77,26,48
1,<environment.Job instance at 0x15231599bb40>,32,1,[9 2],55,77,78,22,56
1,<environment.Job instance at 0x1523102e85f0>,36,1,[7 2],61,78,79,17,66
1,<environment.Job instance at 0x1523102e8af0>,38,16,[9 1],63,79,95,16,66
1,<environment.Job instance at 0x1523102e8b40>,41,14,[7 2],67,95,109,28,80
1,<environment.Job instance at 0x1523102d1b90>,45,3,[9 1],74,109,112,35,83
1,<environment.Job instance at 0x152315912d20>,46,18,[6 2],76,112,130,36,103
1,<environment.Job instance at 0x152315836690>,0,14,[1 6],2,2,16,0,2
1,<environment.Job instance at 0x152310318d70>,4,2,[6 1],6,6,8,0,6
1,<environment.Job instance at 0x152313dd0e60>,7,2,[5 2],12,12,14,0,12
1,<environment.Job instance at 0x1523166fe7d0>,8,3,[1 7],13,16,19,3,14
1,<environment.Job instance at 0x1523166fe050>,11,3,[1 7],18,19,22,1,18
1,<environment.Job instance at 0x1523166fe1e0>,12,14,[1 6],19,22,36,3,19
1,<environment.Job instance at 0x1523166fe9b0>,18,16,[2 9],27,36,52,9,27
1,<environment.Job instance at 0x1523143249b0>,19,12,[5 2],28,52,64,24,43
1,<environment.Job instance at 0x152313b6f370>,35,1,[1 8],55,55,56,0,55
1,<environment.Job instance at 0x15231028cdc0>,36,16,[2 6],56,56,72,0,56
1,<environment.Job instance at 0x15231cb160a0>,39,14,[9 1],60,72,86,12,60
1,<environment.Job instance at 0x1523163c90f0>,42,15,[1 5],63,72,87,9,64
1,<environment.Job instance at 0x1523158e55f0>,46,15,[10  1],69,87,102,18,74
1,<environment.Job instance at 0x152315928f00>,1,1,[1 5],2,2,3,0,2
1,<environment.Job instance at 0x152315928960>,2,18,[8 2],3,3,21,0,3
1,<environment.Job instance at 0x1523167b97d0>,6,17,[2 9],7,21,38,14,9
1,<environment.Job instance at 0x15231ab2e8c0>,9,3,[6 1],10,21,24,11,10
1,<environment.Job instance at 0x15231ab2ef00>,11,3,[2 8],12,12,15,0,12
1,<environment.Job instance at 0x15231ab2edc0>,12,2,[2 8],13,15,17,2,13
1,<environment.Job instance at 0x15231ab2e410>,13,3,[5 2],16,38,41,22,16
1,<environment.Job instance at 0x15231676ea50>,21,1,[5 2],27,38,39,11,27
1,<environment.Job instance at 0x15231676ecd0>,22,1,[2 5],28,39,40,11,28
1,<environment.Job instance at 0x15231676e0a0>,23,2,[ 1 10],30,41,43,11,30
1,<environment.Job instance at 0x152314b7f460>,24,3,[2 5],31,43,46,12,31
1,<environment.Job instance at 0x152314b7faa0>,25,12,[6 1],32,43,55,11,32
1,<environment.Job instance at 0x152314b7faf0>,27,1,[7 1],36,36,37,0,36
1,<environment.Job instance at 0x15231007aaa0>,33,3,[1 7],43,46,49,3,43
1,<environment.Job instance at 0x15231cadcd70>,34,19,[2 9],46,49,68,3,46
1,<environment.Job instance at 0x152315a16e10>,0,13,[5 1],1,1,14,0,1
1,<environment.Job instance at 0x152315a16230>,2,14,[6 1],3,14,28,11,6
1,<environment.Job instance at 0x1522e2709140>,7,13,[10  1],8,28,41,20,12
1,<environment.Job instance at 0x15231b585500>,11,3,[7 1],16,41,44,25,16
1,<environment.Job instance at 0x1522e27082d0>,12,3,[2 8],17,17,20,0,17
1,<environment.Job instance at 0x1522e2708be0>,14,16,[10  1],19,44,60,25,31
1,<environment.Job instance at 0x1522e2acbaa0>,27,12,[1 5],41,60,72,19,44
1,<environment.Job instance at 0x1522e2bdbd70>,32,16,[1 5],51,60,76,9,51
1,<environment.Job instance at 0x1523102c1f50>,39,16,[ 2 10],62,76,92,14,63
1,<environment.Job instance at 0x152315aa8500>,2,14,[2 8],3,3,17,0,3
1,<environment.Job instance at 0x1522e25ef8c0>,5,21,[1 8],6,17,38,11,9
1,<environment.Job instance at 0x1522e25f17d0>,18,1,[10  2],28,38,39,10,28
1,<environment.Job instance at 0x1522e25f1960>,19,3,[2 8],29,39,42,10,29
1,<environment.Job instance at 0x1522e25f1aa0>,20,15,[2 7],30,42,57,12,30
1,<environment.Job instance at 0x1522e25f1fa0>,28,12,[7 1],46,50,62,4,50
1,<environment.Job instance at 0x1522e2578d70>,0,14,[1 5],1,2,16,1,2
1,<environment.Job instance at 0x1523102ff820>,5,16,[8 1],10,10,26,0,10
1,<environment.Job instance at 0x15231031e960>,6,16,[1 6],11,16,32,5,11
1,<environment.Job instance at 0x15231031ed20>,7,2,[10  2],13,32,34,19,14
1,<environment.Job instance at 0x15231031e320>,9,14,[9 2],16,34,48,18,19
1,<environment.Job instance at 0x1523164a2b90>,18,12,[1 7],27,39,51,12,39
1,<environment.Job instance at 0x1523164a2410>,21,17,[2 9],31,51,68,20,41
1,<environment.Job instance at 0x1522e272c410>,24,17,[5 2],34,68,85,34,56
1,<environment.Job instance at 0x1522e2710a00>,35,14,[8 2],47,85,99,38,71
1,<environment.Job instance at 0x1522e2afa230>,44,17,[10  1],60,99,116,39,88
1,<environment.Job instance at 0x1522e29379b0>,49,15,[5 2],66,121,136,55,121
1,<environment.Job instance at 0x1523196b2e60>,52,15,[6 1],70,136,151,66,127
1,<environment.Job instance at 0x1523196b2410>,56,14,[2 6],75,129,143,54,129
1,<environment.Job instance at 0x1523196b2460>,58,17,[2 5],77,143,160,66,136
1,<environment.Job instance at 0x1522e27109b0>,33,16,[ 2 10],45,177,193,132,177
1,<environment.Job instance at 0x1522e273d640>,9,13,[6 1],14,14,27,0,14
1,<environment.Job instance at 0x15231d572370>,10,14,[5 2],19,205,219,186,205
1,<environment.Job instance at 0x15231ab7f500>,0,17,[1 6],1,1,18,0,1
1,<environment.Job instance at 0x1523140e0640>,2,13,[2 9],6,18,31,12,6
1,<environment.Job instance at 0x15231ab7fb40>,8,15,[10  1],13,31,46,18,18
1,<environment.Job instance at 0x1522e29bbdc0>,17,12,[6 2],23,46,58,23,37
1,<environment.Job instance at 0x1523100a1140>,23,14,[9 2],30,58,72,28,43
1,<environment.Job instance at 0x1523100a10a0>,25,16,[1 8],32,46,62,14,43
1,<environment.Job instance at 0x152314311910>,28,16,[7 1],35,72,88,37,59
1,<environment.Job instance at 0x1523100a3460>,35,23,[9 1],46,88,111,42,82
1,<environment.Job instance at 0x1523100a3a00>,39,2,[7 2],51,111,113,60,90
1,<environment.Job instance at 0x1523100a39b0>,43,3,[5 1],56,113,116,57,90
1,<environment.Job instance at 0x15231432e320>,44,3,[1 6],57,90,93,33,90
1,<environment.Job instance at 0x1523167b45f0>,0,3,[1 8],1,1,4,0,1
1,<environment.Job instance at 0x1523167b4820>,2,16,[9 1],4,4,20,0,4
1,<environment.Job instance at 0x1522e2b5fa00>,18,2,[8 1],28,43,45,15,43
1,<environment.Job instance at 0x152313ded6e0>,23,2,[2 7],36,43,45,7,43
1,<environment.Job instance at 0x1522e23ccfa0>,25,2,[10  2],38,45,47,7,43
1,<environment.Job instance at 0x1522e242ee10>,26,2,[1 7],39,47,49,8,43
1,<environment.Job instance at 0x15231c6a5b40>,27,3,[2 8],40,49,52,9,43
1,<environment.Job instance at 0x1522e239a0a0>,28,2,[6 2],41,47,49,6,43
1,<environment.Job instance at 0x15231c6799b0>,29,1,[7 1],44,49,50,5,44
1,<environment.Job instance at 0x15231c679d70>,30,2,[5 2],45,50,52,5,45
1,<environment.Job instance at 0x15231c6793c0>,31,15,[1 9],46,52,67,6,46
1,<environment.Job instance at 0x1522e2b19320>,32,3,[6 1],47,52,55,5,47
1,<environment.Job instance at 0x1522e2b19690>,33,2,[ 1 10],48,67,69,19,48
1,<environment.Job instance at 0x1522e2b19e10>,34,1,[7 1],49,55,56,6,49
1,<environment.Job instance at 0x1523157df9b0>,35,1,[2 6],52,69,70,17,52
1,<environment.Job instance at 0x1523157df190>,36,2,[10  2],53,70,72,17,53
1,<environment.Job instance at 0x1523157dfb40>,37,1,[5 1],54,56,57,2,54
1,<environment.Job instance at 0x152310217780>,41,15,[6 1],62,72,87,10,62
1,<environment.Job instance at 0x1522e23eb870>,43,17,[10  1],66,87,104,21,75
1,<environment.Job instance at 0x152310102f00>,0,12,[2 8],1,1,13,0,1
1,<environment.Job instance at 0x152310102640>,5,12,[2 8],8,13,25,5,8
1,<environment.Job instance at 0x1523101b1370>,6,3,[ 1 10],11,25,28,14,11
1,<environment.Job instance at 0x1523101b1320>,8,18,[9 1],13,28,46,15,17
1,<environment.Job instance at 0x1523101ac550>,22,15,[10  2],33,46,61,13,33
1,<environment.Job instance at 0x152314325460>,35,3,[ 2 10],51,61,64,10,51
1,<environment.Job instance at 0x152314325690>,36,15,[6 1],53,64,79,11,54
1,<environment.Job instance at 0x152314325a50>,39,1,[5 1],56,79,80,23,56
1,<environment.Job instance at 0x152314325eb0>,42,1,[2 9],61,64,65,3,61
1,<environment.Job instance at 0x152314304280>,45,1,[7 2],65,80,81,15,65
1,<environment.Job instance at 0x152314304410>,46,1,[10  1],66,81,82,15,66
1,<environment.Job instance at 0x152314304550>,47,3,[2 5],68,68,71,0,68
1,<environment.Job instance at 0x1523143047d0>,49,18,[2 9],70,82,100,12,74
1,<environment.Job instance at 0x1523142f72d0>,58,3,[2 5],79,100,103,21,80
1,<environment.Job instance at 0x1523101b1190>,10,13,[8 2],16,113,126,97,113
1,<environment.Job instance at 0x1523143181e0>,1,21,[9 2],2,2,23,0,2
1,<environment.Job instance at 0x1523101b15a0>,2,17,[7 2],3,23,40,20,11
1,<environment.Job instance at 0x1523140062d0>,9,16,[5 2],13,40,56,27,33
1,<environment.Job instance at 0x1522e2636cd0>,17,17,[1 8],25,42,59,17,42
1,<environment.Job instance at 0x1522e2636640>,19,16,[2 7],27,59,75,32,50
1,<environment.Job instance at 0x1522e2636690>,25,17,[5 2],34,66,83,32,66
1,<environment.Job instance at 0x1522e263a9b0>,30,17,[5 2],40,77,94,37,77
1,<environment.Job instance at 0x1522e263aaa0>,37,12,[2 9],49,245,257,196,245
1,<environment.Job instance at 0x152315896460>,0,16,[2 5],1,1,17,0,1
1,<environment.Job instance at 0x152310256870>,6,15,[8 1],9,9,24,0,9
1,<environment.Job instance at 0x1523158d6500>,19,3,[1 9],31,31,34,0,31
1,<environment.Job instance at 0x15231010fa50>,20,17,[1 5],32,34,51,2,32
1,<environment.Job instance at 0x1522e2595230>,24,2,[2 6],40,51,53,11,40
1,<environment.Job instance at 0x1522e25952d0>,28,18,[1 7],46,53,71,7,46
1,<environment.Job instance at 0x15231b4c85f0>,33,15,[ 2 10],54,71,86,17,65
1,<environment.Job instance at 0x15231b5780a0>,41,3,[2 5],65,86,89,21,66
1,<environment.Job instance at 0x15231b5786e0>,42,18,[5 2],67,86,104,19,75
1,<environment.Job instance at 0x15231b578a50>,46,3,[2 7],72,89,92,17,77
1,<environment.Job instance at 0x15231cf2ab90>,2,25,[9 1],3,3,28,0,3
1,<environment.Job instance at 0x152316380a00>,25,3,[1 9],32,41,44,9,41
1,<environment.Job instance at 0x1523163809b0>,26,2,[1 7],34,44,46,10,41
1,<environment.Job instance at 0x152316380b40>,27,3,[2 9],35,46,49,11,41
1,<environment.Job instance at 0x152316380cd0>,28,2,[6 1],36,41,43,5,41
1,<environment.Job instance at 0x152316380d20>,29,1,[5 1],37,43,44,6,41
1,<environment.Job instance at 0x152316380be0>,30,16,[2 6],38,49,65,11,41
1,<environment.Job instance at 0x152316382730>,32,14,[5 2],44,49,63,5,44
1,<environment.Job instance at 0x152314091910>,37,21,[10  2],52,65,86,13,57
1,<environment.Job instance at 0x152315a40550>,46,13,[2 9],67,86,99,19,73
1,<environment.Job instance at 0x152316380500>,1,18,[8 1],8,8,26,0,8
1,<environment.Job instance at 0x1523140b0780>,11,3,[9 2],24,26,29,2,25
1,<environment.Job instance at 0x152315a2ad20>,16,20,[7 2],29,29,49,0,29
1,<environment.Job instance at 0x15231abae9b0>,25,14,[ 2 10],40,49,63,9,44
1,<environment.Job instance at 0x1522e260c910>,39,16,[ 2 10],63,93,109,30,93
1,<environment.Job instance at 0x1522e28d2b90>,49,12,[7 2],79,109,121,30,93
1,<environment.Job instance at 0x152315a5b6e0>,2,16,[1 7],3,3,19,0,3
1,<environment.Job instance at 0x15231ac37b40>,3,17,[5 2],5,5,22,0,5
1,<environment.Job instance at 0x15231b4b9b90>,6,17,[8 1],9,22,39,13,11
1,<environment.Job instance at 0x15231b4b9a00>,10,15,[9 1],14,39,54,25,25
1,<environment.Job instance at 0x15231b4bcc30>,26,16,[1 5],33,33,49,0,33
1,<environment.Job instance at 0x15231b4bcd70>,27,3,[2 5],34,54,57,20,34
1,<environment.Job instance at 0x15231b4bce60>,28,3,[2 8],36,57,60,21,36
1,<environment.Job instance at 0x15522789bc30>,0,12,[2 5],1,1,13,0,1
1,<environment.Job instance at 0x15521fd3f870>,6,18,[8 1],7,7,25,0,7
1,<environment.Job instance at 0x15521fd3fb90>,8,13,[6 1],9,25,38,16,9
1,<environment.Job instance at 0x15521fd091e0>,17,17,[6 1],23,38,55,15,26
1,<environment.Job instance at 0x15521fc7ea00>,29,16,[10  2],39,55,71,16,42
1,<environment.Job instance at 0x15521dd978c0>,49,16,[8 2],66,71,87,5,69
1,<environment.Job instance at 0x15521e52e9b0>,0,12,[9 1],1,1,13,0,1
1,<environment.Job instance at 0x15521e237550>,8,13,[7 2],12,13,26,1,12
1,<environment.Job instance at 0x15521e237aa0>,16,14,[7 1],22,26,40,4,22
1,<environment.Job instance at 0x15521ddb6280>,18,12,[2 8],25,25,37,0,25
1,<environment.Job instance at 0x15521ddb6050>,26,1,[2 7],37,37,38,0,37
1,<environment.Job instance at 0x15521ddb6140>,27,1,[2 5],38,38,39,0,38
1,<environment.Job instance at 0x15521ddb66e0>,28,15,[7 1],39,40,55,1,39
1,<environment.Job instance at 0x15521e2991e0>,33,15,[10  2],45,77,92,32,77
1,<environment.Job instance at 0x15521e299280>,35,16,[8 1],47,92,108,45,79
1,<environment.Job instance at 0x15521e299c30>,42,15,[5 1],55,108,123,53,99
1,<environment.Job instance at 0x15521e299af0>,47,3,[2 5],63,588,591,525,588
1,<environment.Job instance at 0x15521e28c2d0>,50,15,[9 2],67,591,606,524,588
1,<environment.Job instance at 0x15521e01b780>,57,15,[1 6],77,612,627,535,612
1,<environment.Job instance at 0x15521c1540f0>,1,15,[1 7],5,5,20,0,5
1,<environment.Job instance at 0x15521c154280>,6,15,[2 7],13,20,35,7,13
1,<environment.Job instance at 0x15521c0c2140>,14,13,[ 2 10],22,35,48,13,22
1,<environment.Job instance at 0x15521c0c22d0>,17,15,[1 7],25,48,63,23,40
1,<environment.Job instance at 0x15521c04d0f0>,29,17,[1 6],41,63,80,22,51
1,<environment.Job instance at 0x15521c04d9b0>,30,17,[7 1],42,51,68,9,51
1,<environment.Job instance at 0x15521c0d2820>,46,18,[7 2],69,69,87,0,69
1,<environment.Job instance at 0x15521c0d2500>,48,18,[10  1],76,87,105,11,76
1,<environment.Job instance at 0x15520c97b5f0>,0,1,[6 2],1,1,2,0,1
1,<environment.Job instance at 0x15521fbd64b0>,1,3,[2 7],3,3,6,0,3
1,<environment.Job instance at 0x15520c971f50>,48,27,[1 7],75,1685,1712,1610,1685
1,<environment.Job instance at 0x155224e29370>,3,16,[2 6],6,6,22,0,6
1,<environment.Job instance at 0x155224e29d70>,6,14,[9 1],10,22,36,12,10
1,<environment.Job instance at 0x155224d43fa0>,2,17,[2 7],4,4,21,0,4
1,<environment.Job instance at 0x155224d43230>,4,17,[9 1],6,21,38,15,9
1,<environment.Job instance at 0x15521e314690>,8,12,[9 2],10,38,50,28,21
1,<environment.Job instance at 0x15520cfaacd0>,16,2,[7 2],20,50,52,30,28
1,<environment.Job instance at 0x15520cfaa730>,17,13,[5 1],21,52,65,31,36
1,<environment.Job instance at 0x15520ce1af50>,18,2,[1 8],22,36,38,14,36
1,<environment.Job instance at 0x15520ce1aaa0>,19,14,[6 1],23,65,79,42,50
1,<environment.Job instance at 0x15520ce1ae10>,24,13,[10  1],28,79,92,51,63
1,<environment.Job instance at 0x15520cf00be0>,34,12,[7 1],44,496,508,452,496
1,<environment.Job instance at 0x15520cf008c0>,36,3,[6 1],49,508,511,459,496
1,<environment.Job instance at 0x15520cf00c30>,37,3,[8 1],50,511,514,461,496
1,<environment.Job instance at 0x15520cf00780>,38,2,[7 1],52,514,516,462,496
1,<environment.Job instance at 0x15520cda8a00>,40,1,[7 1],56,516,517,460,496
1,<environment.Job instance at 0x15520cda86e0>,41,2,[5 1],57,517,519,460,496
1,<environment.Job instance at 0x15520cda81e0>,42,14,[2 5],58,496,510,438,496
1,<environment.Job instance at 0x15520cda8190>,43,3,[5 2],60,517,520,457,496
1,<environment.Job instance at 0x15520cda8500>,45,13,[7 2],62,520,533,458,504
1,<environment.Job instance at 0x15520cf7e230>,55,2,[ 1 10],80,533,535,453,530
1,<environment.Job instance at 0x15520cf7e1e0>,56,16,[ 2 10],82,535,551,453,530
1,<environment.Job instance at 0x15520ce1a2d0>,29,3,[2 8],37,559,562,522,559
1,<environment.Job instance at 0x15520ce10050>,0,16,[2 7],1,1,17,0,1
1,<environment.Job instance at 0x1552250825a0>,8,14,[2 8],13,17,31,4,13
1,<environment.Job instance at 0x15521fc51140>,10,27,[1 7],15,31,58,16,29
1,<environment.Job instance at 0x15521fc47460>,22,13,[10  1],35,58,71,23,42
1,<environment.Job instance at 0x15520cab3280>,26,15,[2 7],40,71,86,31,57
1,<environment.Job instance at 0x15521fb5d460>,27,2,[8 2],45,71,73,26,57
1,<environment.Job instance at 0x155225832d20>,31,3,[1 9],51,97,100,46,97
1,<environment.Job instance at 0x15520cb9dd70>,33,2,[7 2],55,100,102,45,97
1,<environment.Job instance at 0x15520cb9daa0>,34,12,[7 1],56,102,114,46,97
1,<environment.Job instance at 0x1552206c26e0>,1,12,[2 6],3,3,15,0,3
1,<environment.Job instance at 0x15520c8232d0>,6,16,[1 6],11,15,31,4,11
1,<environment.Job instance at 0x15520c823280>,7,2,[10  2],13,31,33,18,13
1,<environment.Job instance at 0x15520c8234b0>,8,3,[1 7],14,33,36,19,14
1,<environment.Job instance at 0x15520c8231e0>,9,14,[9 2],16,16,30,0,16
1,<environment.Job instance at 0x15520c823780>,10,1,[10  2],17,36,37,19,17
1,<environment.Job instance at 0x15520c8238c0>,11,2,[7 2],18,33,35,15,18
1,<environment.Job instance at 0x15520c823e60>,16,13,[1 9],24,37,50,13,24
1,<environment.Job instance at 0x15520c825370>,24,17,[5 2],34,50,67,16,38
1,<environment.Job instance at 0x15520c825820>,26,12,[ 1 10],37,67,79,30,50
1,<environment.Job instance at 0x15520c825910>,28,1,[1 6],40,50,51,10,50
1,<environment.Job instance at 0x15520c825cd0>,34,3,[7 1],46,79,82,33,66
1,<environment.Job instance at 0x15520c825d70>,35,14,[8 2],47,82,96,35,67
1,<environment.Job instance at 0x15520c825e10>,36,2,[1 9],49,79,81,30,67
1,<environment.Job instance at 0x15520c8270a0>,39,13,[2 8],53,81,94,28,69
1,<environment.Job instance at 0x15520c827be0>,49,15,[5 2],66,96,111,30,87
1,<environment.Job instance at 0x15520c827c30>,51,15,[7 2],69,111,126,42,97
1,<environment.Job instance at 0x15520c7a92d0>,52,15,[6 1],70,126,141,56,123
1,<environment.Job instance at 0x15520c7a9370>,60,15,[9 2],80,141,156,61,132
1,<environment.Job instance at 0x15520c7a9d20>,64,17,[9 1],86,156,173,70,145
1,<environment.Job instance at 0x15520c7a9780>,55,16,[1 8],73,191,207,118,191
1,<environment.Job instance at 0x15520c7af870>,0,3,[2 6],1,2,5,1,2
1,<environment.Job instance at 0x15520c825280>,2,13,[6 1],4,4,17,0,4
1,<environment.Job instance at 0x155220978320>,0,1,[1 9],1,1,2,0,1
1,<environment.Job instance at 0x155220978960>,4,16,[7 1],5,5,21,0,5
1,<environment.Job instance at 0x15521c1914b0>,9,16,[2 9],12,12,28,0,12
1,<environment.Job instance at 0x15521c191870>,11,23,[9 1],16,28,51,12,22
1,<environment.Job instance at 0x15521c191c30>,16,3,[6 1],23,23,26,0,23
1,<environment.Job instance at 0x15521c191dc0>,17,2,[10  1],24,51,53,27,24
1,<environment.Job instance at 0x15521c191fa0>,20,3,[1 6],27,28,31,1,27
1,<environment.Job instance at 0x15521fcf77d0>,5,2,[ 1 10],8,8,10,0,8
1,<environment.Job instance at 0x15520c6181e0>,13,15,[6 1],22,22,37,0,22
1,<environment.Job instance at 0x15520c618b90>,15,17,[10  1],26,37,54,11,26
1,<environment.Job instance at 0x155220a26d70>,57,12,[9 1],87,626,638,539,626
1,<environment.Job instance at 0x1552257b0d20>,1,15,[6 1],3,3,18,0,3
1,<environment.Job instance at 0x15522575d9b0>,9,14,[ 1 10],14,18,32,4,15
1,<environment.Job instance at 0x15520cd951e0>,18,17,[5 1],24,32,49,8,25
1,<environment.Job instance at 0x15520c981d20>,21,2,[1 8],27,32,34,5,27
1,<environment.Job instance at 0x15521e252820>,23,3,[2 5],29,34,37,5,29
1,<environment.Job instance at 0x155226cf0370>,24,2,[8 1],30,49,51,19,30
1,<environment.Job instance at 0x15520c97aa00>,27,17,[7 2],33,51,68,18,39
1,<environment.Job instance at 0x15520c97a4b0>,32,17,[ 2 10],39,68,85,29,58
1,<environment.Job instance at 0x15520cab38c0>,38,3,[7 1],50,85,88,35,59
1,<environment.Job instance at 0x15520ccae820>,41,3,[2 9],53,85,88,32,72
1,<environment.Job instance at 0x15520c97a8c0>,28,16,[5 2],34,109,125,75,109
1,<environment.Job instance at 0x1552206b0fa0>,50,17,[5 2],64,112,129,48,112
1,<environment.Job instance at 0x15520cbb6af0>,55,17,[5 2],70,125,142,55,122
1,<environment.Job instance at 0x15521c15ad20>,61,18,[10  2],78,142,160,64,131
1,<environment.Job instance at 0x15521fca7c80>,66,17,[7 1],84,160,177,76,153
1,<environment.Job instance at 0x15521fca77d0>,67,16,[8 2],85,177,193,92,173
1,<environment.Job instance at 0x15521e548b90>,47,1,[1 5],61,192,193,131,192
1,<environment.Job instance at 0x15520c90d8c0>,0,16,[7 1],1,1,17,0,1
1,<environment.Job instance at 0x15521fc41e10>,9,15,[6 1],15,17,32,2,15
1,<environment.Job instance at 0x15521fc26410>,11,17,[8 1],17,32,49,15,20
1,<environment.Job instance at 0x15521fc26e10>,21,15,[8 1],29,49,64,20,45
1,<environment.Job instance at 0x15521fc32140>,26,13,[7 2],40,64,77,24,48
1,<environment.Job instance at 0x15521fc32eb0>,34,3,[1 9],51,51,54,0,51
1,<environment.Job instance at 0x15521fc32b40>,35,17,[1 5],52,54,71,2,52
1,<environment.Job instance at 0x15521fc32d20>,36,3,[8 1],54,77,80,23,54
1,<environment.Job instance at 0x15521fc51280>,37,1,[1 8],55,71,72,16,55
1,<environment.Job instance at 0x15521fc51410>,38,1,[10  2],59,80,81,21,59
1,<environment.Job instance at 0x15521fc51550>,39,2,[2 6],60,72,74,12,60
1,<environment.Job instance at 0x15521fc51690>,40,1,[1 5],61,74,75,13,61
1,<environment.Job instance at 0x15521fc51eb0>,48,15,[ 2 10],74,81,96,7,80
1,<environment.Job instance at 0x15521fc51f50>,49,1,[1 9],75,96,97,21,80
1,<environment.Job instance at 0x15521fc51fa0>,50,3,[6 2],76,97,100,21,80
1,<environment.Job instance at 0x15521fc2b500>,1,3,[2 7],2,2,5,0,2
1,<environment.Job instance at 0x15521e551af0>,7,1,[9 1],11,12,13,1,12
1,<environment.Job instance at 0x15521e5512d0>,9,25,[9 1],13,13,38,0,13
1,<environment.Job instance at 0x15520caf6550>,13,13,[10  1],18,38,51,20,22
1,<environment.Job instance at 0x155226d611e0>,28,17,[10  1],38,51,68,13,39
1,<environment.Job instance at 0x15520ca092d0>,39,14,[5 2],54,68,82,14,61
1,<environment.Job instance at 0x15520ca09d20>,44,21,[10  2],62,82,103,20,74
1,<environment.Job instance at 0x15521e559410>,54,12,[5 2],79,103,115,24,88
1,<environment.Job instance at 0x15521e559500>,56,20,[9 1],81,115,135,34,106
1,<environment.Job instance at 0x15521c07eb90>,1,18,[8 1],8,8,26,0,8
1,<environment.Job instance at 0x15521e243640>,6,12,[2 9],17,17,29,0,17
1,<environment.Job instance at 0x15520cd30f50>,10,17,[6 2],22,29,46,7,22
1,<environment.Job instance at 0x15520cd30230>,20,13,[2 8],33,33,46,0,33
1,<environment.Job instance at 0x15520c8b7780>,39,16,[ 2 10],63,109,125,46,109
1,<environment.Job instance at 0x15520c8b7dc0>,49,12,[7 2],79,125,137,46,122
1,<environment.Job instance at 0x15520cc2ce60>,54,17,[5 2],85,137,154,52,130
1,<environment.Job instance at 0x15520cc2c460>,57,17,[8 1],89,154,171,65,142
1,<environment.Job instance at 0x15520c6f44b0>,0,13,[1 9],1,1,14,0,1
1,<environment.Job instance at 0x1552206af460>,2,15,[9 1],4,4,19,0,4
1,<environment.Job instance at 0x15520c80ef50>,7,19,[5 2],11,19,38,8,15
1,<environment.Job instance at 0x15520c822690>,13,15,[8 2],17,38,53,21,24
1,<environment.Job instance at 0x15520cf274b0>,11,2,[5 2],17,21,23,4,21
1,<environment.Job instance at 0x15520cf276e0>,15,3,[6 1],24,25,28,1,25
1,<environment.Job instance at 0x15520cf27af0>,17,2,[5 1],27,28,30,1,28
1,<environment.Job instance at 0x15520cf27d70>,19,1,[10  1],29,30,31,1,30
1,<environment.Job instance at 0x15520cf279b0>,21,3,[ 2 10],31,31,34,0,31
1,<environment.Job instance at 0x15520cf27aa0>,22,17,[2 9],33,34,51,1,33
1,<environment.Job instance at 0x15520cef9c30>,31,12,[5 1],42,42,54,0,42
1,<environment.Job instance at 0x15520cef9e60>,34,1,[10  2],47,54,55,7,47
1,<environment.Job instance at 0x15520cf06280>,36,13,[1 6],50,55,68,5,50
1,<environment.Job instance at 0x15520cf063c0>,38,17,[6 1],52,55,72,3,54
1,<environment.Job instance at 0x15520cf067d0>,43,12,[5 1],59,72,84,13,61
1,<environment.Job instance at 0x15520cf06a00>,44,16,[1 7],61,68,84,7,66
1,<environment.Job instance at 0x15520cf06c80>,46,17,[6 1],65,84,101,19,74
1,<environment.Job instance at 0x15520cf11230>,51,1,[1 5],71,85,86,14,85
1,<environment.Job instance at 0x15520cf111e0>,54,3,[2 9],74,91,94,17,91
1,<environment.Job instance at 0x15520cf11500>,55,15,[8 1],76,101,116,25,91
1,<environment.Job instance at 0x15520cf116e0>,60,2,[2 5],81,94,96,13,92
1,<environment.Job instance at 0x15520cf11820>,61,15,[7 2],82,116,131,34,104
1,<environment.Job instance at 0x154c1622b640>,0,12,[2 5],1,1,13,0,1
1,<environment.Job instance at 0x154c0e6bb0f0>,6,18,[8 1],7,7,25,0,7
1,<environment.Job instance at 0x154c0cbb5a50>,17,17,[6 1],23,25,42,2,23
1,<environment.Job instance at 0x154c0e68e3c0>,26,1,[2 7],35,49,50,14,49
1,<environment.Job instance at 0x154c0e68eaa0>,27,2,[2 7],36,50,52,14,49
1,<environment.Job instance at 0x154c0e68e320>,28,2,[2 7],37,52,54,15,49
1,<environment.Job instance at 0x154c0e68e7d0>,29,16,[10  2],39,54,70,15,49
1,<environment.Job instance at 0x154c0c98e690>,42,1,[10  1],56,70,71,14,56
1,<environment.Job instance at 0x154c0c9a6e60>,43,3,[7 2],57,71,74,14,57
1,<environment.Job instance at 0x154c0c9a6d20>,44,3,[1 8],58,71,74,13,58
1,<environment.Job instance at 0x154c0c9a6dc0>,45,3,[2 8],60,74,77,14,60
1,<environment.Job instance at 0x154c0c727500>,49,16,[8 2],66,74,90,8,66
1,<environment.Job instance at 0x154c0e36f910>,55,16,[2 5],76,86,102,10,86
1,<environment.Job instance at 0x154c0c9ab500>,58,15,[2 9],82,102,117,20,88
1,<environment.Job instance at 0x154c0c9aba00>,60,17,[8 1],86,90,107,4,88
1,<environment.Job instance at 0x154c0c9a22d0>,0,13,[7 2],2,2,15,0,2
1,<environment.Job instance at 0x154c0c9a2500>,8,14,[7 1],12,15,29,3,12
1,<environment.Job instance at 0x154c0cc305a0>,20,15,[7 1],29,29,44,0,29
1,<environment.Job instance at 0x154c0e5c4af0>,24,12,[9 2],34,44,56,10,34
1,<environment.Job instance at 0x154c0e5c4230>,25,15,[10  2],35,56,71,21,42
1,<environment.Job instance at 0x154c140fb870>,1,13,[ 2 10],2,2,15,0,2
1,<environment.Job instance at 0x154c080bfd70>,6,14,[10  1],9,15,29,6,9
1,<environment.Job instance at 0x154c080bf2d0>,7,12,[7 1],10,29,41,19,12
1,<environment.Job instance at 0x154c080bf550>,14,18,[8 1],18,41,59,23,30
1,<environment.Job instance at 0x154c082171e0>,20,15,[9 2],30,59,74,29,45
1,<environment.Job instance at 0x154c080ffbe0>,43,14,[6 1],67,74,88,7,71
1,<environment.Job instance at 0x154c08324c30>,0,17,[7 1],2,2,19,0,2
1,<environment.Job instance at 0x154c082d5eb0>,3,12,[7 2],7,19,31,12,7
1,<environment.Job instance at 0x154c082d5910>,6,14,[8 2],12,31,45,19,17
1,<environment.Job instance at 0x154c081f5820>,26,16,[7 2],44,45,61,1,44
1,<environment.Job instance at 0x154c0822f2d0>,28,18,[5 2],47,61,79,14,50
1,<environment.Job instance at 0x154c0822f7d0>,35,17,[10  1],58,79,96,21,67
1,<environment.Job instance at 0x154bcf31b140>,0,14,[1 6],2,2,16,0,2
1,<environment.Job instance at 0x154bcf317b40>,12,14,[1 6],19,19,33,0,19
1,<environment.Job instance at 0x154bcf317dc0>,15,26,[9 1],24,24,50,0,24
1,<environment.Job instance at 0x154bcf3135f0>,19,12,[5 2],28,50,62,22,35
1,<environment.Job instance at 0x154c082a6960>,36,16,[2 6],56,56,72,0,56
1,<environment.Job instance at 0x154c082a61e0>,39,14,[9 1],60,72,86,12,60
1,<environment.Job instance at 0x154c082ac460>,42,15,[1 5],63,72,87,9,64
1,<environment.Job instance at 0x154bcf204fa0>,46,15,[10  1],69,87,102,18,73
1,<environment.Job instance at 0x154c137c6780>,1,1,[2 9],2,3,4,1,3
1,<environment.Job instance at 0x154bcf545d20>,3,2,[10  1],4,4,6,0,4
1,<environment.Job instance at 0x154bcf545aa0>,7,2,[ 1 10],10,10,12,0,10
1,<environment.Job instance at 0x154bcf545190>,8,3,[2 5],11,12,15,1,11
1,<environment.Job instance at 0x154bcf545870>,9,12,[6 1],12,12,24,0,12
1,<environment.Job instance at 0x154c080c4f00>,16,15,[1 8],22,22,37,0,22
1,<environment.Job instance at 0x154c14126640>,0,12,[1 5],1,2,14,1,2
1,<environment.Job instance at 0x154c14126910>,4,18,[1 5],7,11,29,4,11
1,<environment.Job instance at 0x154c156ee7d0>,12,16,[ 2 10],22,29,45,7,22
1,<environment.Job instance at 0x154bcf3282d0>,13,3,[10  2],23,45,48,22,23
1,<environment.Job instance at 0x154bcf328230>,14,2,[1 6],27,48,50,21,27
1,<environment.Job instance at 0x154c15af5d70>,15,3,[1 9],28,50,53,22,28
1,<environment.Job instance at 0x154bcf416190>,28,17,[2 8],47,53,70,6,47
1,<environment.Job instance at 0x154c156e1c30>,29,2,[6 1],49,49,51,0,49
1,<environment.Job instance at 0x154c0e5948c0>,30,2,[ 1 10],50,70,72,20,50
1,<environment.Job instance at 0x154c156e1640>,31,3,[9 2],52,72,75,20,52
1,<environment.Job instance at 0x154c1632ecd0>,32,2,[5 1],53,53,55,0,53
1,<environment.Job instance at 0x154c0829a0a0>,33,17,[1 9],54,75,92,21,63
1,<environment.Job instance at 0x154bcf7bfdc0>,37,1,[5 1],63,63,64,0,63
1,<environment.Job instance at 0x154c080c7550>,38,13,[10  1],65,92,105,27,76
1,<environment.Job instance at 0x154c0d72ecd0>,50,12,[7 1],86,105,117,19,99
1,<environment.Job instance at 0x154c141c4550>,1,17,[9 2],3,3,20,0,3
1,<environment.Job instance at 0x154c140b2730>,15,12,[2 6],23,23,35,0,23
1,<environment.Job instance at 0x154c0e4c2820>,16,1,[9 1],25,35,36,10,25
1,<environment.Job instance at 0x154c0cbff910>,17,17,[2 8],26,36,53,10,26
1,<environment.Job instance at 0x154c156ee640>,20,16,[1 6],31,53,69,22,40
1,<environment.Job instance at 0x154c141afcd0>,25,2,[7 2],38,40,42,2,40
1,<environment.Job instance at 0x154c141af050>,27,3,[1 5],40,69,72,29,43
1,<environment.Job instance at 0x154c140a3eb0>,28,12,[2 9],42,72,84,30,55
1,<environment.Job instance at 0x154c0cc19a00>,34,19,[2 5],50,84,103,34,74
1,<environment.Job instance at 0x154c0cc19d20>,35,17,[2 9],51,103,120,52,102
1,<environment.Job instance at 0x154c0cbddeb0>,51,2,[7 2],70,120,122,50,117
1,<environment.Job instance at 0x154bcf3bb190>,58,17,[10  1],80,122,139,42,117
1,<environment.Job instance at 0x154c0e37c0f0>,64,3,[2 7],88,139,142,51,139
1,<environment.Job instance at 0x154c0e37c050>,65,15,[7 2],89,139,154,50,139
1,<environment.Job instance at 0x154c0e37c960>,66,15,[6 1],90,154,169,64,140
1,<environment.Job instance at 0x154c0e37c5a0>,67,2,[2 9],91,154,156,63,140
1,<environment.Job instance at 0x154c0e37c7d0>,68,2,[1 5],92,142,144,50,141
1,<environment.Job instance at 0x154c0e37ceb0>,69,16,[1 8],93,156,172,63,143
1,<environment.Job instance at 0x154c0cc250a0>,47,16,[ 2 10],65,206,222,141,206
1,<environment.Job instance at 0x154c0f0510a0>,23,14,[9 2],36,243,257,207,243
1,<environment.Job instance at 0x154c0f051320>,3,17,[9 1],6,6,23,0,6
1,<environment.Job instance at 0x154bcf1b8eb0>,9,13,[6 1],14,23,36,9,15
1,<environment.Job instance at 0x154c0e36fc80>,0,26,[1 6],1,2,28,1,2
1,<environment.Job instance at 0x154c08138be0>,3,23,[9 1],6,6,29,0,6
1,<environment.Job instance at 0x154c0824f140>,16,3,[9 1],26,29,32,3,26
1,<environment.Job instance at 0x154c0824fd70>,17,13,[2 5],28,32,45,4,28
1,<environment.Job instance at 0x154c1411d6e0>,18,2,[1 8],29,29,31,0,29
1,<environment.Job instance at 0x154c1411ddc0>,19,1,[2 6],30,45,46,15,30
1,<environment.Job instance at 0x154c1411dfa0>,20,2,[9 2],33,46,48,13,33
1,<environment.Job instance at 0x154bcf75baf0>,0,15,[6 1],2,2,17,0,2
1,<environment.Job instance at 0x154bcf374500>,2,17,[10  1],6,17,34,11,6
1,<environment.Job instance at 0x154bcf2dedc0>,22,13,[8 2],36,373,386,337,373
1,<environment.Job instance at 0x154bcf2f5550>,33,16,[1 6],52,382,398,330,382
1,<environment.Job instance at 0x154bcf2f5870>,37,3,[5 1],57,386,389,329,384
1,<environment.Job instance at 0x154bcf2f5a50>,40,2,[1 8],61,398,400,337,385
1,<environment.Job instance at 0x154bcf2f5cd0>,44,12,[9 1],67,389,401,322,385
1,<environment.Job instance at 0x154bcf2f5e60>,47,3,[ 2 10],71,401,404,330,400
1,<environment.Job instance at 0x154bcf2f5fa0>,48,15,[6 1],73,404,419,331,400
1,<environment.Job instance at 0x154bcf2cbcd0>,61,18,[2 9],90,417,435,327,417
1,<environment.Job instance at 0x154bcf2cb410>,70,3,[2 5],99,435,438,336,427
1,<environment.Job instance at 0x154bcf2cb050>,66,1,[7 1],95,464,465,369,464
1,<environment.Job instance at 0x154c0cbfb780>,1,21,[9 2],2,2,23,0,2
1,<environment.Job instance at 0x154c0e601f50>,2,17,[7 2],3,23,40,20,11
1,<environment.Job instance at 0x154c0e5e7d20>,9,16,[5 2],13,40,56,27,27
1,<environment.Job instance at 0x154c0cca6af0>,17,17,[1 8],25,27,44,2,27
1,<environment.Job instance at 0x154bcefb2fa0>,25,17,[5 2],34,127,144,93,127
1,<environment.Job instance at 0x154c0e623c30>,30,17,[5 2],40,131,148,91,131
1,<environment.Job instance at 0x154c0e4c95a0>,36,18,[10  2],48,148,166,100,137
1,<environment.Job instance at 0x154c0e4c9870>,38,15,[2 5],50,169,184,119,169
1,<environment.Job instance at 0x154c0e4c9460>,41,17,[7 1],54,169,186,115,169
1,<environment.Job instance at 0x154c0e4c94b0>,55,15,[6 1],75,191,206,116,191
1,<environment.Job instance at 0x154c0e4c9320>,57,17,[8 1],77,206,223,129,194
1,<environment.Job instance at 0x154c1418e960>,67,15,[8 1],89,223,238,134,217
1,<environment.Job instance at 0x154c15a94140>,0,1,[7 2],2,2,3,0,2
1,<environment.Job instance at 0x154c0e4a8c80>,3,3,[2 6],5,5,8,0,5
1,<environment.Job instance at 0x154c1526de60>,7,3,[1 9],11,11,14,0,11
1,<environment.Job instance at 0x154c0e4a8a00>,8,17,[1 5],12,14,31,2,12
1,<environment.Job instance at 0x154bcf68c2d0>,10,1,[1 8],15,31,32,16,15
1,<environment.Job instance at 0x154c0cc84690>,11,1,[10  2],19,32,33,13,19
1,<environment.Job instance at 0x154c0f35b050>,16,18,[1 7],26,33,51,7,26
1,<environment.Job instance at 0x154bcf011910>,70,16,[2 6],98,2597,2613,2499,2597
1,<environment.Job instance at 0x154bcf1a8a00>,0,14,[5 2],4,4,18,0,4
1,<environment.Job instance at 0x154bcf3955f0>,5,21,[10  2],12,18,39,6,12
1,<environment.Job instance at 0x154bcf3899b0>,15,12,[5 2],29,39,51,10,30
1,<environment.Job instance at 0x154bcf389f50>,23,2,[6 2],38,51,53,13,42
1,<environment.Job instance at 0x154bcf389f00>,24,3,[9 2],39,53,56,14,42
1,<environment.Job instance at 0x154bcf396410>,25,2,[1 6],46,46,48,0,46
1,<environment.Job instance at 0x154bcf396460>,26,18,[8 1],48,56,74,8,48
1,<environment.Job instance at 0x154bcf396f00>,35,17,[6 2],62,74,91,12,67
1,<environment.Job instance at 0x154bcf3b3c80>,48,2,[1 6],78,83,85,5,83
1,<environment.Job instance at 0x154bcf3b3d20>,50,14,[ 2 10],80,91,105,11,83
1,<environment.Job instance at 0x154bcf39d370>,2,16,[ 2 10],3,3,19,0,3
1,<environment.Job instance at 0x154c08133b40>,6,17,[9 2],9,19,36,10,9
1,<environment.Job instance at 0x154c08133dc0>,10,15,[7 1],17,36,51,19,22
1,<environment.Job instance at 0x154c0e3a74b0>,16,16,[1 7],23,24,40,1,24
1,<environment.Job instance at 0x154c0e3a7230>,22,13,[1 9],31,40,53,9,31
1,<environment.Job instance at 0x154c0e3a72d0>,24,15,[9 1],34,51,66,17,37
1,<environment.Job instance at 0x154c137f3af0>,29,19,[5 2],41,66,85,25,56
1,<environment.Job instance at 0x154c0c73b2d0>,0,16,[5 1],1,1,17,0,1
1,<environment.Job instance at 0x154c0f345a50>,3,15,[5 1],6,6,21,0,6
1,<environment.Job instance at 0x154c0f345f50>,5,1,[6 1],8,21,22,13,8
1,<environment.Job instance at 0x154c0f345910>,6,18,[8 2],9,22,40,13,11
1,<environment.Job instance at 0x154c0f345500>,9,3,[2 6],12,17,20,5,12
1,<environment.Job instance at 0x154c15272e60>,12,2,[2 6],15,20,22,5,15
1,<environment.Job instance at 0x154c15272af0>,14,18,[1 6],18,22,40,4,18
1,<environment.Job instance at 0x154c0e597c80>,15,2,[ 1 10],22,22,24,0,22
1,<environment.Job instance at 0x154c0e56d2d0>,16,3,[ 1 10],24,24,27,0,24
1,<environment.Job instance at 0x154c0e56d3c0>,17,1,[9 2],25,27,28,2,26
1,<environment.Job instance at 0x154c08042690>,2,3,[10  1],3,3,6,0,3
1,<environment.Job instance at 0x154c08042050>,4,17,[7 2],6,6,23,0,6
1,<environment.Job instance at 0x154c080422d0>,7,16,[6 1],10,23,39,13,19
1,<environment.Job instance at 0x154bcf35e5f0>,18,17,[1 5],26,29,46,3,29
1,<environment.Job instance at 0x154bcf34b730>,27,18,[10  1],35,46,64,11,35
1,<environment.Job instance at 0x154bcf1d70a0>,49,18,[5 2],63,196,214,133,196
1,<environment.Job instance at 0x154bcf1d7be0>,53,14,[10  1],69,214,228,145,202
1,<environment.Job instance at 0x154bcf1d7e60>,59,12,[7 2],77,228,240,151,228
1,<environment.Job instance at 0x154bcf33d280>,65,1,[8 1],85,240,241,155,228
1,<environment.Job instance at 0x154bcf33d320>,66,18,[10  1],86,241,259,155,230
1,<environment.Job instance at 0x154c080e0370>,0,16,[8 2],1,1,17,0,1
1,<environment.Job instance at 0x154c0e5d0f00>,3,13,[8 1],5,17,30,12,5
1,<environment.Job instance at 0x154c0f0a4370>,6,12,[9 1],8,30,42,22,14
1,<environment.Job instance at 0x154c0f0a2640>,22,13,[8 1],26,42,55,16,32
1,<environment.Job instance at 0x154c0f0a2c30>,27,17,[6 2],34,55,72,21,43
1,<environment.Job instance at 0x154c0f0a2d20>,28,3,[5 2],35,72,75,37,46
1,<environment.Job instance at 0x154c0f0a2f50>,29,15,[10  2],36,75,90,39,61
1,<environment.Job instance at 0x154bf946bc30>,0,12,[2 5],1,2,14,1,2
1,<environment.Job instance at 0x154bf18f8b90>,6,18,[8 1],7,7,25,0,7
1,<environment.Job instance at 0x154bf18bf190>,8,13,[6 1],9,25,38,16,13
1,<environment.Job instance at 0x154bf18d92d0>,17,17,[6 1],23,38,55,15,34
1,<environment.Job instance at 0x154bf18ce870>,29,16,[10  2],39,55,71,16,42
1,<environment.Job instance at 0x154befe48640>,1,14,[7 1],2,2,16,0,2
1,<environment.Job instance at 0x154befe5da00>,11,1,[2 7],17,17,18,0,17
1,<environment.Job instance at 0x154befe5d640>,13,15,[7 1],19,19,34,0,19
1,<environment.Job instance at 0x154befe5d0f0>,20,16,[8 1],27,34,50,7,28
1,<environment.Job instance at 0x154bef97efa0>,27,15,[5 1],35,50,65,15,42
1,<environment.Job instance at 0x154bef96d960>,42,15,[1 6],57,420,435,363,420
1,<environment.Job instance at 0x154bbe68a500>,0,17,[1 6],1,1,18,0,1
1,<environment.Job instance at 0x154bec093c80>,4,15,[9 2],10,10,25,0,10
1,<environment.Job instance at 0x154bbeac8b40>,16,2,[1 6],27,28,30,1,28
1,<environment.Job instance at 0x154bbeac8780>,17,18,[7 2],29,29,47,0,29
1,<environment.Job instance at 0x154bbeac8140>,19,18,[10  1],36,47,65,11,36
1,<environment.Job instance at 0x154bec091190>,0,12,[7 1],1,1,13,0,1
1,<environment.Job instance at 0x154bec0912d0>,1,20,[8 2],2,13,33,11,8
1,<environment.Job instance at 0x154bec11e730>,8,16,[7 2],14,33,49,19,23
1,<environment.Job instance at 0x154bec03b820>,64,3,[8 1],99,218,221,119,218
1,<environment.Job instance at 0x154bec03b2d0>,65,3,[8 1],103,221,224,118,218
1,<environment.Job instance at 0x154bec03bf00>,66,1,[10  1],104,224,225,120,218
1,<environment.Job instance at 0x154bec03baf0>,67,27,[1 7],105,225,252,120,223
1,<environment.Job instance at 0x154bec03be10>,68,15,[2 8],108,265,280,157,265
1,<environment.Job instance at 0x154bec03bfa0>,1,1,[2 6],3,3,4,0,3
1,<environment.Job instance at 0x154bec03be10>,2,2,[1 5],5,5,7,0,5
1,<environment.Job instance at 0x154bbe546230>,5,1,[5 1],9,9,10,0,9
1,<environment.Job instance at 0x154bbe546190>,6,3,[1 5],10,10,13,0,10
1,<environment.Job instance at 0x154bbe5462d0>,8,3,[2 8],12,13,16,1,12
1,<environment.Job instance at 0x154bbe5467d0>,10,16,[2 6],16,16,32,0,16
1,<environment.Job instance at 0x154bbe542500>,13,14,[9 1],20,32,46,12,20
1,<environment.Job instance at 0x154bf189d8c0>,3,16,[10  2],4,4,20,0,4
1,<environment.Job instance at 0x154bf6c7a8c0>,6,15,[2 6],9,20,35,11,18
1,<environment.Job instance at 0x154bf17b09b0>,48,3,[10  2],73,151,154,78,151
1,<environment.Job instance at 0x154bf17b0d20>,49,2,[1 6],77,154,156,77,151
1,<environment.Job instance at 0x154bbe716910>,52,1,[6 2],82,154,155,72,151
1,<environment.Job instance at 0x154bbe716230>,54,3,[5 1],88,155,158,67,151
1,<environment.Job instance at 0x154bbe7164b0>,55,1,[2 8],89,156,157,67,153
1,<environment.Job instance at 0x154bbe7166e0>,56,2,[7 2],90,158,160,68,153
1,<environment.Job instance at 0x154bbe716eb0>,57,2,[6 2],91,160,162,69,154
1,<environment.Job instance at 0x154bf17de5a0>,58,3,[9 1],92,162,165,70,154
1,<environment.Job instance at 0x154bf17de780>,59,14,[2 8],93,165,179,72,154
1,<environment.Job instance at 0x154bf17deaf0>,61,27,[1 7],95,179,206,84,177
1,<environment.Job instance at 0x154bf17de690>,68,17,[1 9],104,206,223,102,194
1,<environment.Job instance at 0x154bbe45a230>,0,15,[2 8],2,2,17,0,2
1,<environment.Job instance at 0x154bf8d2c910>,2,13,[10  1],5,17,30,12,7
1,<environment.Job instance at 0x154bef986eb0>,14,12,[7 1],26,30,42,4,26
1,<environment.Job instance at 0x154bbe54aaa0>,0,3,[5 2],2,2,5,0,2
1,<environment.Job instance at 0x154bbe536230>,1,13,[2 8],3,3,16,0,3
1,<environment.Job instance at 0x154bf2291f50>,14,15,[6 1],20,27,42,7,27
1,<environment.Job instance at 0x154bf2291910>,18,14,[2 6],25,32,46,7,32
1,<environment.Job instance at 0x154bf2291550>,20,17,[2 5],27,46,63,19,34
1,<environment.Job instance at 0x154bbe4f6dc0>,22,15,[9 2],30,63,78,33,49
1,<environment.Job instance at 0x154bbe4c2780>,30,3,[2 6],41,78,81,37,52
1,<environment.Job instance at 0x154bec16f050>,32,13,[6 1],44,78,91,34,62
1,<environment.Job instance at 0x154bbe3f51e0>,10,14,[5 2],19,67,81,48,67
1,<environment.Job instance at 0x154bbe728370>,0,1,[1 9],1,2,3,1,2
1,<environment.Job instance at 0x154bbe3f5cd0>,2,1,[6 1],3,3,4,0,3
1,<environment.Job instance at 0x154bbe728d70>,3,3,[5 2],4,4,7,0,4
1,<environment.Job instance at 0x154bbe7283c0>,4,16,[7 1],5,7,23,2,5
1,<environment.Job instance at 0x154bbe728550>,9,16,[2 9],12,13,29,1,13
1,<environment.Job instance at 0x154bf732fe10>,11,23,[9 1],16,29,52,13,23
1,<environment.Job instance at 0x154bf16f7f00>,25,13,[2 5],38,52,65,14,38
1,<environment.Job instance at 0x154bf732f820>,13,1,[5 2],18,1592,1593,1574,1592
1,<environment.Job instance at 0x154bbebd9230>,0,15,[6 1],2,3,18,1,3
1,<environment.Job instance at 0x154bf847c7d0>,2,17,[10  1],6,18,35,12,6
1,<environment.Job instance at 0x154bbe5d00f0>,44,12,[9 1],67,321,333,254,321
1,<environment.Job instance at 0x154bf897a5a0>,46,16,[9 2],70,333,349,263,324
1,<environment.Job instance at 0x154bf897ad70>,48,15,[6 1],73,349,364,276,341
1,<environment.Job instance at 0x154bbe8ef7d0>,56,14,[ 1 10],84,364,378,280,350
1,<environment.Job instance at 0x154bbe46c460>,75,16,[5 2],104,389,405,285,389
1,<environment.Job instance at 0x154bec1e7140>,76,2,[2 9],105,405,407,300,395
1,<environment.Job instance at 0x154bf25cf460>,16,3,[9 2],23,143,146,120,143
1,<environment.Job instance at 0x154bf25cf4b0>,17,17,[5 2],24,146,163,122,143
1,<environment.Job instance at 0x154bf25cfb90>,28,18,[10  2],38,163,181,125,152
1,<environment.Job instance at 0x154bf25cfe60>,34,16,[8 2],45,181,197,136,177
1,<environment.Job instance at 0x154bf25ea1e0>,47,15,[6 1],65,197,212,132,193
1,<environment.Job instance at 0x154bf25eae10>,56,2,[1 7],74,220,222,146,220
1,<environment.Job instance at 0x154bf25eaf50>,58,3,[5 2],78,220,223,142,220
1,<environment.Job instance at 0x154bf25eaf00>,59,15,[8 1],79,223,238,144,220
1,<environment.Job instance at 0x154bf25d3460>,64,13,[7 2],90,238,251,148,234
1,<environment.Job instance at 0x154bf25d3910>,73,17,[1 5],102,243,260,141,243
1,<environment.Job instance at 0x154bf25ebeb0>,8,3,[2 9],13,261,264,248,261
1,<environment.Job instance at 0x154bbea42a50>,4,3,[10  1],8,8,11,0,8
1,<environment.Job instance at 0x154bf72b7af0>,59,14,[5 2],84,975,989,891,975
1,<environment.Job instance at 0x154bf16d9fa0>,63,3,[2 7],89,979,982,890,979
1,<environment.Job instance at 0x154bf16d90a0>,64,21,[10  2],92,989,1010,897,981
1,<environment.Job instance at 0x154bf16d99b0>,66,3,[1 7],95,982,985,887,981
1,<environment.Job instance at 0x154bf16d9eb0>,74,12,[5 2],109,1010,1022,901,1006
1,<environment.Job instance at 0x154bf382e050>,0,20,[9 1],1,1,21,0,1
1,<environment.Job instance at 0x154bbe9822d0>,33,14,[ 2 10],50,1767,1781,1717,1767
1,<environment.Job instance at 0x154bf17567d0>,0,19,[5 2],1,1,20,0,1
1,<environment.Job instance at 0x154bf6a12a50>,1,2,[2 8],2,3,5,1,3
1,<environment.Job instance at 0x154bf6a25eb0>,6,15,[8 2],7,20,35,13,7
1,<environment.Job instance at 0x154bf6a41a00>,1,14,[6 1],3,3,17,0,3
1,<environment.Job instance at 0x154bf2549cd0>,6,14,[1 6],11,11,25,0,11
1,<environment.Job instance at 0x154bf25499b0>,10,17,[5 2],20,20,37,0,20
1,<environment.Job instance at 0x154bf92f2d70>,0,2,[1 8],1,1,3,0,1
1,<environment.Job instance at 0x154bf16ea230>,1,17,[6 1],2,2,19,0,2
1,<environment.Job instance at 0x154bf92f2500>,2,1,[8 1],3,19,20,16,3
1,<environment.Job instance at 0x154bf92f2410>,5,17,[2 7],8,8,25,0,8
1,<environment.Job instance at 0x154bf92f29b0>,6,12,[5 1],9,20,32,11,11
1,<environment.Job instance at 0x154bbe150190>,9,17,[6 1],15,32,49,17,20
1,<environment.Job instance at 0x154bbe150870>,16,3,[2 8],23,25,28,2,23
1,<environment.Job instance at 0x154bbe150370>,18,15,[8 1],26,49,64,23,35
1,<environment.Job instance at 0x154bec1e7910>,24,15,[7 2],32,64,79,32,50
1,<environment.Job instance at 0x154bf6941870>,35,13,[2 5],47,78,91,31,78
1,<environment.Job instance at 0x154bf6941690>,39,3,[9 1],54,91,94,37,83
1,<environment.Job instance at 0x154bbe926be0>,46,3,[1 7],63,91,94,28,87
1,<environment.Job instance at 0x154bbe926fa0>,48,17,[1 5],66,94,111,28,87
1,<environment.Job instance at 0x154bbe9267d0>,56,3,[2 5],74,94,97,20,91
1,<environment.Job instance at 0x154bbe926820>,57,18,[10  1],75,111,129,36,100
1,<environment.Job instance at 0x154bbe1ce5f0>,67,14,[9 2],89,129,143,40,125
1,<environment.Job instance at 0x154bbe651640>,71,16,[8 1],94,143,159,49,138
1,<environment.Job instance at 0x154bbe4657d0>,73,15,[8 2],96,159,174,63,152
1,<environment.Job instance at 0x154bbe7f4eb0>,79,18,[5 2],103,174,192,71,173
1,<environment.Job instance at 0x154bf1774820>,83,14,[10  1],109,192,206,83,180
1,<environment.Job instance at 0x154bbe150eb0>,10,3,[2 8],16,248,251,232,248
1,<environment.Job instance at 0x154bf92fad70>,0,3,[5 1],1,1,4,0,1
1,<environment.Job instance at 0x154bbe7ae550>,1,2,[8 1],3,4,6,1,3
1,<environment.Job instance at 0x154bbe55bcd0>,3,3,[8 2],5,6,9,1,5
1,<environment.Job instance at 0x154bbeb05aa0>,4,12,[7 2],7,9,21,2,7
1,<environment.Job instance at 0x154bbe193e60>,6,17,[6 2],11,21,38,10,12
1,<environment.Job instance at 0x154bbe19b3c0>,11,18,[10  1],16,38,56,22,27
1,<environment.Job instance at 0x154bbe19bd70>,20,14,[9 2],29,56,70,27,49
1,<environment.Job instance at 0x154bbe1ab460>,27,12,[9 1],38,70,82,32,53
1,<environment.Job instance at 0x154bbe1ab9b0>,35,17,[ 2 10],48,82,99,34,70
1,<environment.Job instance at 0x154bbe40ed70>,1,16,[7 2],2,2,18,0,2
1,<environment.Job instance at 0x154bbe40e870>,2,12,[9 1],3,18,30,15,3
1,<environment.Job instance at 0x154bf69a2410>,14,12,[2 8],25,30,42,5,25
1,<environment.Job instance at 0x154bf69a2500>,15,14,[10  2],26,42,56,16,27
1,<environment.Job instance at 0x154bf69a2640>,19,14,[9 2],33,56,70,23,43
1,<environment.Job instance at 0x154bbe53fe60>,26,16,[9 2],43,70,86,27,57
1,<environment.Job instance at 0x154bbe53faa0>,29,12,[5 1],48,86,98,38,80
1,<environment.Job instance at 0x154bbe587690>,38,13,[2 8],63,86,99,23,80
1,<environment.Job instance at 0x154bbe544870>,43,18,[7 2],70,98,116,28,88
1,<environment.Job instance at 0x154bef96d0a0>,50,13,[6 1],78,133,146,55,133
1,<environment.Job instance at 0x154bbe864dc0>,55,17,[9 1],84,146,163,62,134
1,<environment.Job instance at 0x154bbe17b230>,4,13,[ 1 10],7,7,20,0,7
1,<environment.Job instance at 0x154bbe464050>,6,13,[7 2],11,20,33,9,11
1,<environment.Job instance at 0x154bbe464f00>,18,12,[5 2],27,33,45,6,28
1,<environment.Job instance at 0x154bbe43d690>,23,17,[7 1],35,45,62,10,36
1,<environment.Job instance at 0x154bbe43d910>,25,15,[7 1],37,62,77,25,48
1,<environment.Job instance at 0x154bbe43d280>,31,17,[6 2],55,77,94,22,65
1,<environment.Job instance at 0x154bf18f5280>,46,13,[7 2],81,94,107,13,86
1,<environment.Job instance at 0x154bf18f5d70>,54,16,[5 2],95,107,123,12,97
1,<environment.Job instance at 0x154bf18f84b0>,60,18,[8 2],102,123,141,21,112
1,<environment.Job instance at 0x152542448640>,0,12,[2 5],1,1,13,0,1
1,<environment.Job instance at 0x15253a893a00>,6,18,[8 1],7,7,25,0,7
1,<environment.Job instance at 0x15253a8f1190>,8,13,[6 1],9,25,38,16,9
1,<environment.Job instance at 0x15253a8ad4b0>,17,17,[6 1],23,38,55,15,32
1,<environment.Job instance at 0x15253a8b3820>,29,16,[10  2],39,55,71,16,42
1,<environment.Job instance at 0x152538bc0b90>,3,2,[1 9],6,7,9,1,7
1,<environment.Job instance at 0x152538bc0460>,4,1,[2 7],7,9,10,2,8
1,<environment.Job instance at 0x152538bc0c80>,6,15,[7 1],9,9,24,0,9
1,<environment.Job instance at 0x152538e3c780>,14,17,[1 9],19,34,51,15,34
1,<environment.Job instance at 0x152538e3c500>,19,1,[8 2],24,51,52,27,37
1,<environment.Job instance at 0x152538e3c5a0>,22,2,[ 1 10],30,52,54,22,38
1,<environment.Job instance at 0x1524f3b75c30>,4,18,[7 2],9,9,27,0,9
1,<environment.Job instance at 0x1524f3b758c0>,6,18,[10  1],16,27,45,11,16
1,<environment.Job instance at 0x1524f3bea8c0>,15,15,[2 8],28,649,664,621,649
1,<environment.Job instance at 0x15253406b050>,39,2,[10  1],59,664,666,605,650
1,<environment.Job instance at 0x152534061f00>,43,3,[1 8],65,666,669,601,650
1,<environment.Job instance at 0x1525340615f0>,44,12,[7 2],67,650,662,583,650
1,<environment.Job instance at 0x152534061820>,45,2,[7 2],69,662,664,593,650
1,<environment.Job instance at 0x1525340612d0>,46,3,[ 2 10],71,669,672,598,650
1,<environment.Job instance at 0x1525340614b0>,47,14,[8 2],72,672,686,600,659
1,<environment.Job instance at 0x1525340c4910>,67,16,[7 2],104,686,702,582,678
1,<environment.Job instance at 0x1525340c4640>,72,12,[2 9],113,706,718,593,706
1,<environment.Job instance at 0x152541992c30>,61,16,[2 6],96,2320,2336,2224,2320
1,<environment.Job instance at 0x1525340b3820>,2,18,[8 2],3,3,21,0,3
1,<environment.Job instance at 0x1525340b3c30>,5,2,[ 1 10],6,21,23,15,6
1,<environment.Job instance at 0x1525340b34b0>,6,17,[2 9],7,23,40,16,11
1,<environment.Job instance at 0x1525340b3910>,11,3,[2 8],12,12,15,0,12
1,<environment.Job instance at 0x1524f355db40>,14,1,[6 2],18,40,41,22,19
1,<environment.Job instance at 0x1524f355d0f0>,16,1,[6 2],21,41,42,20,25
1,<environment.Job instance at 0x1524f355dc30>,21,1,[5 2],27,42,43,15,27
1,<environment.Job instance at 0x1524f3559460>,25,12,[6 1],32,43,55,11,34
1,<environment.Job instance at 0x15253e686f50>,32,15,[1 8],42,46,61,4,46
1,<environment.Job instance at 0x1524f37175a0>,0,12,[1 5],1,1,13,0,1
1,<environment.Job instance at 0x1524f3717690>,1,13,[7 2],2,5,18,3,5
1,<environment.Job instance at 0x15253408ef50>,10,26,[2 8],18,23,49,5,23
1,<environment.Job instance at 0x15253408e550>,16,16,[2 7],31,49,65,18,37
1,<environment.Job instance at 0x152538de7370>,26,27,[1 7],45,65,92,20,63
1,<environment.Job instance at 0x1524f371b370>,36,15,[2 8],62,92,107,30,81
1,<environment.Job instance at 0x15253a58d550>,42,15,[2 7],70,107,122,37,97
1,<environment.Job instance at 0x1524f38fc8c0>,0,14,[1 5],1,1,15,0,1
1,<environment.Job instance at 0x1524f35025f0>,5,16,[8 1],10,10,26,0,10
1,<environment.Job instance at 0x1524f35025a0>,6,16,[1 6],11,19,35,8,19
1,<environment.Job instance at 0x15253a6d2a50>,14,12,[2 9],22,35,47,13,24
1,<environment.Job instance at 0x15254037cd70>,17,2,[1 8],25,47,49,22,26
1,<environment.Job instance at 0x15253a6f5cd0>,18,12,[1 7],27,49,61,22,32
1,<environment.Job instance at 0x1524f3502870>,21,17,[2 9],31,61,78,30,55
1,<environment.Job instance at 0x15254038db90>,26,12,[ 1 10],37,78,90,41,71
1,<environment.Job instance at 0x15253a599c80>,33,16,[ 2 10],45,90,106,45,79
1,<environment.Job instance at 0x15254946f050>,44,17,[10  1],60,106,123,46,94
1,<environment.Job instance at 0x152534061730>,46,1,[10  2],63,123,124,60,95
1,<environment.Job instance at 0x1524f3563e60>,49,15,[5 2],66,124,139,58,121
1,<environment.Job instance at 0x1524f3802640>,56,14,[2 6],75,130,144,55,130
1,<environment.Job instance at 0x1524f34f1d20>,60,15,[9 2],80,144,159,64,130
1,<environment.Job instance at 0x1524f34f1c80>,64,17,[9 1],86,159,176,73,149
1,<environment.Job instance at 0x1524f34d4e60>,91,13,[10  1],119,176,189,57,171
1,<environment.Job instance at 0x152538e448c0>,0,14,[2 9],1,1,15,0,1
1,<environment.Job instance at 0x1524f34d16e0>,8,3,[5 2],9,15,18,6,9
1,<environment.Job instance at 0x1524f3519af0>,9,2,[8 2],10,18,20,8,10
1,<environment.Job instance at 0x1524f35193c0>,10,3,[2 8],11,15,18,4,11
1,<environment.Job instance at 0x15253a6c16e0>,11,2,[2 5],12,18,20,6,12
1,<environment.Job instance at 0x1524f3519690>,12,13,[7 2],14,20,33,6,14
1,<environment.Job instance at 0x15253a6e5e60>,14,15,[ 2 10],16,33,48,17,19
1,<environment.Job instance at 0x1525402cfa50>,17,17,[1 7],20,48,65,28,36
1,<environment.Job instance at 0x15253b582820>,26,16,[6 2],31,48,64,17,36
1,<environment.Job instance at 0x1525390f60f0>,31,1,[5 1],39,64,65,25,39
1,<environment.Job instance at 0x152538e58f00>,32,2,[7 2],40,65,67,25,40
1,<environment.Job instance at 0x1524f36aba50>,56,12,[5 2],77,367,379,290,367
1,<environment.Job instance at 0x1524f356fe60>,67,13,[7 2],94,386,399,292,386
1,<environment.Job instance at 0x152538e5d960>,71,14,[7 1],100,412,426,312,412
1,<environment.Job instance at 0x152538e5d730>,75,14,[9 1],104,426,440,322,413
1,<environment.Job instance at 0x15253b4e69b0>,39,17,[1 7],50,461,478,411,461
1,<environment.Job instance at 0x15253a8e7aa0>,0,17,[1 6],1,1,18,0,1
1,<environment.Job instance at 0x1524f33fd410>,8,15,[10  1],13,18,33,5,13
1,<environment.Job instance at 0x1524f33fdd70>,21,14,[7 1],28,33,47,5,28
1,<environment.Job instance at 0x1524f337f460>,23,14,[9 2],30,47,61,17,32
1,<environment.Job instance at 0x1524f3381280>,36,14,[ 1 10],47,61,75,14,49
1,<environment.Job instance at 0x1524f33810a0>,37,1,[5 2],48,75,76,27,49
1,<environment.Job instance at 0x1524f33818c0>,39,2,[7 2],51,76,78,25,52
1,<environment.Job instance at 0x1524f33819b0>,40,3,[6 1],53,78,81,25,53
1,<environment.Job instance at 0x1524f3381dc0>,43,3,[5 1],56,81,84,25,56
1,<environment.Job instance at 0x1524f3381f00>,44,3,[1 6],57,57,60,0,57
1,<environment.Job instance at 0x1524f3b0c320>,13,15,[6 1],22,22,37,0,22
1,<environment.Job instance at 0x1524f3b0c780>,15,17,[10  1],26,37,54,11,26
1,<environment.Job instance at 0x15253b1a64b0>,35,13,[8 2],56,223,236,167,223
1,<environment.Job instance at 0x1524f3594e60>,45,21,[9 1],71,236,257,165,228
1,<environment.Job instance at 0x15253b2b7fa0>,47,15,[10  2],73,257,272,184,243
1,<environment.Job instance at 0x15253b2b70f0>,57,12,[9 1],87,272,284,185,255
1,<environment.Job instance at 0x15253b2b7b90>,59,16,[9 2],90,284,300,194,276
1,<environment.Job instance at 0x15253a7b38c0>,74,18,[2 9],110,300,318,190,295
1,<environment.Job instance at 0x1525418e9a50>,78,17,[5 1],114,301,318,187,301
1,<environment.Job instance at 0x1525418e94b0>,83,3,[2 5],119,318,321,199,311
1,<environment.Job instance at 0x152540365820>,1,21,[9 2],2,2,23,0,2
1,<environment.Job instance at 0x152540365230>,2,17,[7 2],3,23,40,20,11
1,<environment.Job instance at 0x15253a614c80>,21,2,[1 5],30,48,50,18,48
1,<environment.Job instance at 0x15253a6149b0>,23,2,[9 1],32,48,50,16,48
1,<environment.Job instance at 0x15253a614190>,24,3,[9 2],33,50,53,17,48
1,<environment.Job instance at 0x1524f31cccd0>,25,17,[5 2],34,53,70,19,48
1,<environment.Job instance at 0x15254036b370>,35,1,[2 8],47,67,68,20,67
1,<environment.Job instance at 0x152538deafa0>,36,18,[10  2],48,70,88,22,67
1,<environment.Job instance at 0x15253c811280>,38,15,[2 5],50,88,103,38,82
1,<environment.Job instance at 0x15253c811780>,41,17,[7 1],54,97,114,43,97
1,<environment.Job instance at 0x15253c811370>,42,16,[8 2],55,114,130,59,106
1,<environment.Job instance at 0x15253b29b960>,55,15,[6 1],75,130,145,55,129
1,<environment.Job instance at 0x1524f351d500>,57,17,[8 1],77,145,162,68,133
1,<environment.Job instance at 0x1524f3bbf050>,67,15,[8 1],89,162,177,73,156
1,<environment.Job instance at 0x1524f3902eb0>,72,13,[7 2],100,177,190,77,174
1,<environment.Job instance at 0x15253f9609b0>,80,3,[1 9],111,191,194,80,191
1,<environment.Job instance at 0x1524f3634c80>,81,17,[1 5],112,194,211,82,191
1,<environment.Job instance at 0x1524f37201e0>,19,16,[2 7],27,220,236,193,220
1,<environment.Job instance at 0x1524f395d8c0>,3,18,[1 7],6,13,31,7,13
1,<environment.Job instance at 0x1524f39860f0>,8,15,[ 2 10],14,31,46,17,17
1,<environment.Job instance at 0x1524f3986b90>,17,18,[5 2],27,46,64,19,35
1,<environment.Job instance at 0x1524f3999f50>,33,13,[10  1],48,64,77,16,48
1,<environment.Job instance at 0x1524f39aec30>,44,15,[6 1],63,77,92,14,64
1,<environment.Job instance at 0x1524f368a870>,48,17,[10  1],68,92,109,24,80
1,<environment.Job instance at 0x1524f39882d0>,59,14,[5 2],84,109,123,25,94
1,<environment.Job instance at 0x1524f367ec80>,64,21,[10  2],92,123,144,31,115
1,<environment.Job instance at 0x15253a84c9b0>,67,14,[2 5],97,144,158,47,129
1,<environment.Job instance at 0x15253a8d6640>,74,12,[5 2],109,144,156,35,142
1,<environment.Job instance at 0x15253a8d55a0>,82,2,[6 2],118,156,158,38,153
1,<environment.Job instance at 0x1524f3986b40>,16,3,[2 5],25,159,162,134,159
1,<environment.Job instance at 0x1525403854b0>,0,2,[1 6],6,6,8,0,6
1,<environment.Job instance at 0x1524f3986460>,1,18,[8 1],8,8,26,0,8
1,<environment.Job instance at 0x1524f39bd2d0>,10,17,[6 2],22,26,43,4,22
1,<environment.Job instance at 0x15253f93e550>,15,1,[1 8],28,28,29,0,28
1,<environment.Job instance at 0x15253f93e320>,16,20,[7 2],29,43,63,14,34
1,<environment.Job instance at 0x1524f3816780>,1,15,[9 1],2,2,17,0,2
1,<environment.Job instance at 0x15253f9d6320>,2,12,[6 1],3,17,29,14,9
1,<environment.Job instance at 0x152534141370>,13,3,[1 8],17,17,20,0,17
1,<environment.Job instance at 0x15253a7c5910>,14,2,[2 8],20,20,22,0,20
1,<environment.Job instance at 0x152534077280>,15,17,[1 8],22,22,39,0,22
1,<environment.Job instance at 0x152534141140>,16,15,[10  1],23,39,54,16,25
1,<environment.Job instance at 0x15253b54fd70>,25,16,[7 2],34,54,70,20,43
1,<environment.Job instance at 0x152540302d20>,33,15,[5 1],46,70,85,24,56
1,<environment.Job instance at 0x15253b124c80>,38,3,[2 6],51,56,59,5,56
1,<environment.Job instance at 0x1524f3ad0730>,44,18,[1 6],58,59,77,1,58
1,<environment.Job instance at 0x1524f37bc780>,4,16,[10  2],7,7,23,0,7
1,<environment.Job instance at 0x1524f37bce60>,11,16,[5 2],16,23,39,7,16
1,<environment.Job instance at 0x1524f37a9050>,5,13,[2 5],7,7,20,0,7
1,<environment.Job instance at 0x152538e46d70>,7,16,[6 1],10,11,27,1,11
1,<environment.Job instance at 0x152538e1d230>,21,1,[8 2],29,29,30,0,29
1,<environment.Job instance at 0x152538e1d050>,22,2,[7 1],30,30,32,0,30
1,<environment.Job instance at 0x152538e1daa0>,23,1,[10  1],31,32,33,1,31
1,<environment.Job instance at 0x152538e1d1e0>,24,2,[ 1 10],32,33,35,1,32
1,<environment.Job instance at 0x152538e1dd70>,25,2,[1 8],33,35,37,2,33
1,<environment.Job instance at 0x152538e1ddc0>,26,3,[2 5],34,37,40,3,34
1,<environment.Job instance at 0x152538e1d5a0>,27,18,[10  1],35,40,58,5,35
1,<environment.Job instance at 0x152538e4ad20>,47,14,[ 2 10],61,1237,1251,1176,1237
1,<environment.Job instance at 0x152538dfae10>,59,12,[7 2],77,1251,1263,1174,1248
1,<environment.Job instance at 0x152538dfa550>,61,17,[6 2],81,1263,1280,1182,1258
1,<environment.Job instance at 0x1524f3a78fa0>,67,1,[8 2],87,1280,1281,1193,1258
1,<environment.Job instance at 0x1524f33ef0f0>,69,1,[5 1],89,1281,1282,1192,1258
1,<environment.Job instance at 0x1524f32df9b0>,71,3,[7 1],91,1282,1285,1191,1258
1,<environment.Job instance at 0x1524f3a81aa0>,75,14,[9 2],99,1285,1299,1186,1271
1,<environment.Job instance at 0x1524f3a81730>,76,16,[8 2],101,1299,1315,1198,1290
1,<environment.Job instance at 0x1524f3a81b90>,79,13,[8 1],105,1315,1328,1210,1308
1,<environment.Job instance at 0x1524f376ecd0>,0,3,[2 7],1,1,4,0,1
1,<environment.Job instance at 0x1524f3a03190>,3,16,[1 9],4,160,176,156,160
1,<environment.Job instance at 0x15253b136c80>,0,18,[2 9],1,2,20,1,2
1,<environment.Job instance at 0x152541899d70>,1,13,[2 8],3,20,33,17,4
1,<environment.Job instance at 0x15253a6d4cd0>,6,18,[7 2],10,20,38,10,11
1,<environment.Job instance at 0x15253a6d6b40>,20,14,[2 8],28,37,51,9,37
1,<environment.Job instance at 0x15253a6e7e10>,36,17,[ 1 10],55,58,75,3,58
1,<environment.Job instance at 0x15253a6c6460>,39,13,[7 2],61,75,88,14,69
1,<environment.Job instance at 0x15253a6c6be0>,45,14,[6 2],70,88,102,18,86
1,<environment.Job instance at 0x15253a6c6c30>,47,18,[10  2],72,102,120,30,91
1,<environment.Job instance at 0x15253a6c6e60>,51,12,[5 2],77,120,132,43,118
1,<environment.Job instance at 0x15253a6db190>,56,17,[7 1],85,132,149,47,129
1,<environment.Job instance at 0x152540361d20>,58,15,[7 1],87,155,170,68,155
1,<environment.Job instance at 0x15253a6ddaa0>,59,13,[5 2],93,170,183,77,159
1,<environment.Job instance at 0x15253a6dd690>,62,14,[7 1],99,186,200,87,186
1,<environment.Job instance at 0x15253a6dd280>,64,17,[6 2],105,200,217,95,191
1,<environment.Job instance at 0x15253a6e7e60>,37,13,[ 1 10],57,284,297,227,284
1,<environment.Job instance at 0x15253a6c6a00>,1,17,[6 1],3,3,20,0,3
1,<environment.Job instance at 0x1524f395aaa0>,5,13,[7 2],11,20,33,9,11
1,<environment.Job instance at 0x1524f3b8f0f0>,13,16,[5 2],25,33,49,8,25
1,<environment.Job instance at 0x1524f34f7640>,53,12,[1 7],82,221,233,139,221
1,<environment.Job instance at 0x15253a81baf0>,72,16,[10  1],106,233,249,127,229
1,<environment.Job instance at 0x15253a81b7d0>,1,16,[ 1 10],3,3,19,0,3
1,<environment.Job instance at 0x15253a81b3c0>,2,20,[10  2],4,19,39,15,10
1,<environment.Job instance at 0x1524f3bf8c30>,10,15,[7 2],16,39,54,23,26
1,<environment.Job instance at 0x1524f3be2820>,19,14,[2 7],33,39,53,6,33
1,<environment.Job instance at 0x1524f3be2cd0>,22,18,[6 1],36,54,72,18,43
1,<environment.Job instance at 0x1524f3be2fa0>,27,18,[8 1],42,72,90,30,61
1,<environment.Job instance at 0x1524f3bd5410>,29,16,[6 2],45,90,106,45,85
1,<environment.Job instance at 0x1524f3be9460>,45,1,[8 2],74,106,107,32,97
1,<environment.Job instance at 0x1524f3be93c0>,46,3,[7 1],76,107,110,31,97
1,<environment.Job instance at 0x1524f3be97d0>,47,3,[ 2 10],79,110,113,31,97
1,<environment.Job instance at 0x1524f3be9870>,48,3,[7 2],81,113,116,32,97
1,<environment.Job instance at 0x1524f3be95a0>,49,3,[9 2],83,116,119,33,97
1,<environment.Job instance at 0x1524f3be9aa0>,50,3,[1 6],86,97,100,11,97
1,<environment.Job instance at 0x1524f3be9960>,51,13,[1 5],87,113,126,26,97
1,<environment.Job instance at 0x1524f3be9af0>,52,1,[2 7],88,100,101,12,97
1,<environment.Job instance at 0x1524f3be9a50>,53,2,[2 5],89,101,103,12,97
1,<environment.Job instance at 0x1524f3be9b40>,54,3,[1 8],90,103,106,13,97
1,<environment.Job instance at 0x1524f3be9be0>,55,1,[10  2],91,126,127,35,98
1,<environment.Job instance at 0x1524f3be9c80>,57,17,[10  2],95,127,144,32,115
1,<environment.Job instance at 0x1524f3be9dc0>,59,12,[8 1],97,144,156,47,127
1,<environment.Job instance at 0x1524f3bcc910>,62,13,[8 1],104,156,169,52,140
1,<environment.Job instance at 0x1524f3bccb40>,64,17,[2 7],108,144,161,36,140
1,<environment.Job instance at 0x1524f3be9280>,43,3,[1 8],68,171,174,103,171
1,<environment.Job instance at 0x15154e77ac30>,0,12,[2 5],1,2,14,1,2
1,<environment.Job instance at 0x151546c19690>,6,18,[8 1],7,7,25,0,7
1,<environment.Job instance at 0x151546c190f0>,8,13,[6 1],9,25,38,16,12
1,<environment.Job instance at 0x151546beae60>,17,17,[6 1],23,38,55,15,26
1,<environment.Job instance at 0x151546b141e0>,29,16,[10  2],39,55,71,16,42
1,<environment.Job instance at 0x151545158d70>,2,12,[9 2],4,4,16,0,4
1,<environment.Job instance at 0x151545158320>,3,15,[10  2],5,16,31,11,5
1,<environment.Job instance at 0x15154517dd70>,5,16,[8 1],7,31,47,24,25
1,<environment.Job instance at 0x1514ffdd5280>,5,15,[2 8],8,8,23,0,8
1,<environment.Job instance at 0x1514ffdd5960>,6,16,[1 7],9,23,39,14,10
1,<environment.Job instance at 0x15154513c320>,0,2,[2 9],1,1,3,0,1
1,<environment.Job instance at 0x15154513c5f0>,2,18,[6 2],6,6,24,0,6
1,<environment.Job instance at 0x15154513cb90>,3,16,[1 5],8,8,24,0,8
1,<environment.Job instance at 0x1514fff00820>,17,14,[1 6],29,29,43,0,29
1,<environment.Job instance at 0x1514fff00be0>,20,26,[9 1],34,34,60,0,34
1,<environment.Job instance at 0x1515475ce140>,24,12,[5 2],38,60,72,22,49
1,<environment.Job instance at 0x15154bc244b0>,39,3,[2 8],62,62,65,0,62
1,<environment.Job instance at 0x15154bc24eb0>,41,16,[2 6],66,66,82,0,66
1,<environment.Job instance at 0x15154bc247d0>,44,14,[9 1],70,82,96,12,70
1,<environment.Job instance at 0x15154bc259b0>,46,2,[1 7],72,82,84,10,72
1,<environment.Job instance at 0x15154bc255a0>,47,15,[1 5],73,84,99,11,73
1,<environment.Job instance at 0x15154bc257d0>,48,3,[1 9],74,99,102,25,74
1,<environment.Job instance at 0x15154bc250f0>,49,2,[1 8],76,102,104,26,76
1,<environment.Job instance at 0x15154bc25050>,51,15,[10  1],79,104,119,25,90
1,<environment.Job instance at 0x15154bc25690>,1,3,[1 7],3,4,7,1,4
1,<environment.Job instance at 0x1514ff854dc0>,8,3,[2 7],12,12,15,0,12
1,<environment.Job instance at 0x1514ff8518c0>,12,15,[7 1],17,17,32,0,17
1,<environment.Job instance at 0x1514ff851d70>,17,17,[2 7],24,25,42,1,25
1,<environment.Job instance at 0x1514ff84dfa0>,19,17,[9 1],26,42,59,16,30
1,<environment.Job instance at 0x1514ff84de10>,23,12,[9 2],30,59,71,29,42
1,<environment.Job instance at 0x1514ff84d820>,27,16,[10  2],34,71,87,37,58
1,<environment.Job instance at 0x1515469dd500>,39,13,[10  1],48,87,100,39,74
1,<environment.Job instance at 0x1515469ddc80>,46,16,[10  1],59,100,116,41,87
1,<environment.Job instance at 0x1514ff7280a0>,54,18,[2 6],74,116,134,42,116
1,<environment.Job instance at 0x1514ff7e0190>,60,13,[7 2],82,132,145,50,132
1,<environment.Job instance at 0x1514ff769d20>,71,16,[ 2 10],102,145,161,43,132
1,<environment.Job instance at 0x1514ff772aa0>,75,16,[2 7],111,161,177,50,148
1,<environment.Job instance at 0x1514ff804b40>,83,14,[2 8],123,274,288,151,274
1,<environment.Job instance at 0x15154c608e10>,2,17,[1 9],4,5,22,1,5
1,<environment.Job instance at 0x15154bc92640>,10,3,[2 8],19,22,25,3,19
1,<environment.Job instance at 0x15154bc92d70>,11,15,[2 7],20,25,40,5,20
1,<environment.Job instance at 0x1514ffc0d8c0>,18,2,[7 2],35,35,37,0,35
1,<environment.Job instance at 0x1514ffc0df50>,19,12,[7 1],36,37,49,1,36
1,<environment.Job instance at 0x1514ffde2140>,0,25,[9 1],1,1,26,0,1
1,<environment.Job instance at 0x1514ffde24b0>,4,15,[5 2],6,26,41,20,12
1,<environment.Job instance at 0x1514ffd926e0>,13,17,[2 5],17,26,43,9,26
1,<environment.Job instance at 0x1514ffe37fa0>,25,13,[6 1],34,41,54,7,37
1,<environment.Job instance at 0x1514ffe37370>,34,17,[2 7],45,50,67,5,50
1,<environment.Job instance at 0x1514ffe37460>,35,13,[2 8],46,67,80,21,55
1,<environment.Job instance at 0x15154696dd20>,46,13,[10  1],59,80,93,21,73
1,<environment.Job instance at 0x1514ff80aa50>,60,13,[7 2],74,93,106,19,78
1,<environment.Job instance at 0x1514ff9a4eb0>,62,15,[ 2 10],76,106,121,30,92
1,<environment.Job instance at 0x1515475595f0>,63,3,[10  2],77,121,124,44,95
1,<environment.Job instance at 0x1514ffbbcf00>,64,3,[2 5],79,95,98,16,95
1,<environment.Job instance at 0x1514ffcce280>,74,16,[6 2],91,124,140,33,120
1,<environment.Job instance at 0x1514ffcce1e0>,75,1,[6 1],92,140,141,48,120
1,<environment.Job instance at 0x1514ffcce460>,76,2,[9 1],94,141,143,47,120
1,<environment.Job instance at 0x1514ffcce820>,77,19,[1 5],96,124,143,28,120
1,<environment.Job instance at 0x15154c5c2190>,87,17,[1 7],110,154,171,44,154
1,<environment.Job instance at 0x15154bce7460>,1,2,[2 7],3,3,5,0,3
1,<environment.Job instance at 0x1514ffe37780>,4,12,[5 2],7,7,19,0,7
1,<environment.Job instance at 0x15154c6cf500>,12,1,[9 2],20,20,21,0,20
1,<environment.Job instance at 0x1514ff836910>,13,1,[10  1],21,21,22,0,21
1,<environment.Job instance at 0x1514ffaf63c0>,28,3,[9 2],41,41,44,0,41
1,<environment.Job instance at 0x151544eed3c0>,30,17,[1 8],48,49,66,1,49
1,<environment.Job instance at 0x151544eedf00>,32,17,[1 6],51,66,83,15,60
1,<environment.Job instance at 0x1514ffacedc0>,40,15,[10  1],63,83,98,20,70
1,<environment.Job instance at 0x1514ffb83a50>,54,14,[ 2 10],79,158,172,79,158
1,<environment.Job instance at 0x1514ffb83aa0>,55,14,[9 2],80,172,186,92,163
1,<environment.Job instance at 0x1514fff13140>,65,16,[2 9],92,186,202,94,174
1,<environment.Job instance at 0x151544ef67d0>,82,2,[1 8],119,217,219,98,217
1,<environment.Job instance at 0x151544ef63c0>,83,1,[2 6],120,219,220,99,217
1,<environment.Job instance at 0x1514ff9a6960>,18,15,[2 5],29,362,377,333,362
1,<environment.Job instance at 0x15154c6c9aa0>,2,16,[9 1],4,4,20,0,4
1,<environment.Job instance at 0x1514ff6ffd20>,17,2,[1 6],27,95,97,68,95
1,<environment.Job instance at 0x1514ff6ffc30>,18,2,[8 1],28,95,97,67,95
1,<environment.Job instance at 0x1514ff6ffaf0>,19,1,[2 7],30,97,98,67,95
1,<environment.Job instance at 0x1514ff6fffa0>,21,13,[7 1],32,97,110,65,95
1,<environment.Job instance at 0x1514ff681230>,26,2,[1 7],39,98,100,59,95
1,<environment.Job instance at 0x1514ff681370>,28,2,[6 2],41,110,112,69,95
1,<environment.Job instance at 0x1514ff6814b0>,30,2,[5 2],45,112,114,67,95
1,<environment.Job instance at 0x1514ff6815f0>,31,15,[1 9],46,114,129,68,100
1,<environment.Job instance at 0x1514ff681af0>,41,15,[6 1],62,114,129,52,100
1,<environment.Job instance at 0x1514ff681c30>,43,17,[10  1],66,129,146,63,117
1,<environment.Job instance at 0x1514ff6876e0>,77,2,[ 2 10],116,776,778,660,776
1,<environment.Job instance at 0x1514ff6879b0>,79,1,[1 9],119,778,779,659,776
1,<environment.Job instance at 0x1514ff6877d0>,81,2,[1 8],121,779,781,658,776
1,<environment.Job instance at 0x1514ff687b40>,82,1,[1 9],123,781,782,658,776
1,<environment.Job instance at 0x1514ff687be0>,83,2,[ 2 10],125,782,784,657,776
1,<environment.Job instance at 0x1514ff687b90>,84,3,[9 1],126,778,781,652,776
1,<environment.Job instance at 0x1514ff687c80>,85,12,[9 1],127,784,796,657,776
1,<environment.Job instance at 0x1514ff684410>,53,12,[2 8],81,813,825,732,813
1,<environment.Job instance at 0x1514ff68d550>,1,15,[6 1],3,3,18,0,3
1,<environment.Job instance at 0x1514ff7e0280>,12,3,[2 5],18,18,21,0,18
1,<environment.Job instance at 0x1514ff7e0aa0>,13,2,[6 2],19,20,22,1,20
1,<environment.Job instance at 0x1514ffe625f0>,15,3,[2 9],21,22,25,1,21
1,<environment.Job instance at 0x1514ffe620a0>,16,1,[1 6],22,25,26,3,22
1,<environment.Job instance at 0x1514ffe62460>,17,1,[10  1],23,26,27,3,23
1,<environment.Job instance at 0x1514ffe62a50>,18,17,[5 1],24,27,44,3,24
1,<environment.Job instance at 0x1515469c5e60>,27,17,[7 2],33,45,62,12,45
1,<environment.Job instance at 0x151540096140>,34,16,[5 2],43,66,82,23,66
1,<environment.Job instance at 0x1515400967d0>,40,15,[6 2],52,82,97,30,76
1,<environment.Job instance at 0x151540096500>,44,16,[2 7],57,97,113,40,97
1,<environment.Job instance at 0x1514ffdd7b40>,50,17,[5 2],64,110,127,46,110
1,<environment.Job instance at 0x1514ffdd78c0>,55,17,[5 2],70,141,158,71,141
1,<environment.Job instance at 0x1514ffbb7550>,32,17,[ 2 10],39,193,210,154,193
1,<environment.Job instance at 0x1514ffa3f500>,3,3,[2 6],5,5,8,0,5
1,<environment.Job instance at 0x1514ffa3fe60>,7,3,[1 9],11,11,14,0,11
1,<environment.Job instance at 0x1514fffb23c0>,8,17,[1 5],12,14,31,2,12
1,<environment.Job instance at 0x15154bd0dcd0>,11,1,[10  2],19,31,32,12,19
1,<environment.Job instance at 0x1514ffbe0af0>,15,1,[2 8],24,32,33,8,24
1,<environment.Job instance at 0x1514ffbe0fa0>,16,18,[1 7],26,33,51,7,27
1,<environment.Job instance at 0x1515451ccd70>,0,20,[9 1],1,1,21,0,1
1,<environment.Job instance at 0x15154516b690>,12,2,[2 6],24,53,55,29,53
1,<environment.Job instance at 0x15154516b730>,14,12,[2 9],27,55,67,28,53
1,<environment.Job instance at 0x1514ffb17280>,30,3,[1 6],47,67,70,20,55
1,<environment.Job instance at 0x1514ffb17370>,33,14,[ 2 10],50,70,84,20,55
1,<environment.Job instance at 0x1514ffb29eb0>,1,15,[9 1],2,2,17,0,2
1,<environment.Job instance at 0x1514ff523640>,2,12,[6 1],3,17,29,14,3
1,<environment.Job instance at 0x1514ff523500>,3,13,[8 1],4,29,42,25,13
1,<environment.Job instance at 0x1514ff5252d0>,15,17,[1 8],22,22,39,0,22
1,<environment.Job instance at 0x1514ff525d20>,16,15,[10  1],23,42,57,19,28
1,<environment.Job instance at 0x1514ff518280>,25,16,[7 2],34,57,73,23,44
1,<environment.Job instance at 0x1514ffca4870>,30,16,[5 1],41,73,89,32,65
1,<environment.Job instance at 0x1514ff8dc0a0>,33,15,[5 1],46,73,88,27,66
1,<environment.Job instance at 0x1514ff5eafa0>,35,1,[6 1],48,89,90,41,66
1,<environment.Job instance at 0x1514ff5ea550>,36,18,[8 2],49,90,108,41,79
1,<environment.Job instance at 0x1514ffc86500>,39,3,[2 6],52,88,91,36,81
1,<environment.Job instance at 0x1515478c10f0>,3,16,[5 2],6,6,22,0,6
1,<environment.Job instance at 0x1514ff89c5a0>,3,2,[5 1],4,4,6,0,4
1,<environment.Job instance at 0x15154c7071e0>,11,2,[1 8],13,13,15,0,13
1,<environment.Job instance at 0x15154c7075f0>,13,18,[10  1],15,15,33,0,15
1,<environment.Job instance at 0x15154c70f320>,33,14,[ 2 10],41,137,151,96,137
1,<environment.Job instance at 0x15154c70f500>,35,18,[5 2],43,151,169,108,140
1,<environment.Job instance at 0x15154c70f870>,37,16,[1 6],46,151,167,105,140
1,<environment.Job instance at 0x15154c70f820>,39,14,[10  1],49,169,183,120,155
1,<environment.Job instance at 0x15154c70fe10>,45,12,[7 2],57,183,195,126,171
1,<environment.Job instance at 0x15154c71a190>,52,18,[10  1],66,195,213,129,184
1,<environment.Job instance at 0x15154c71aa50>,62,16,[8 2],81,213,229,132,200
1,<environment.Job instance at 0x15154c71ac30>,65,13,[8 1],85,229,242,144,213
1,<environment.Job instance at 0x15154c7155a0>,81,2,[1 6],103,221,223,118,221
1,<environment.Job instance at 0x15154c715500>,82,16,[1 9],104,229,245,125,221
1,<environment.Job instance at 0x15154c715780>,84,13,[8 1],106,282,295,176,282
1,<environment.Job instance at 0x15154c715d70>,89,17,[6 2],114,295,312,181,285
1,<environment.Job instance at 0x15154c715c80>,91,15,[10  2],116,312,327,196,298
1,<environment.Job instance at 0x1514ff974780>,9,3,[7 1],14,14,17,0,14
1,<environment.Job instance at 0x15154c65e2d0>,10,2,[ 1 10],15,17,19,2,15
1,<environment.Job instance at 0x15154c65ea00>,16,12,[7 2],22,36,48,14,36
1,<environment.Job instance at 0x15154c65e780>,17,1,[2 5],24,36,37,12,36
1,<environment.Job instance at 0x15154c65eb40>,19,3,[1 6],29,37,40,8,36
1,<environment.Job instance at 0x15154c65eaf0>,22,16,[7 2],32,48,64,16,36
1,<environment.Job instance at 0x15154c65ef50>,23,12,[9 1],33,64,76,31,47
1,<environment.Job instance at 0x15154694ea00>,35,12,[2 8],55,76,88,21,72
1,<environment.Job instance at 0x15154694e1e0>,38,12,[6 1],60,76,88,16,76
1,<environment.Job instance at 0x15154694e410>,40,14,[9 2],63,88,102,25,76
1,<environment.Job instance at 0x15154694eb90>,44,23,[9 1],70,102,125,32,96
1,<environment.Job instance at 0x15154694e640>,45,14,[10  1],71,125,139,54,110
1,<environment.Job instance at 0x15154694ef50>,47,16,[9 2],73,139,155,66,126
1,<environment.Job instance at 0x151546959fa0>,50,12,[5 1],78,155,167,77,155
1,<environment.Job instance at 0x1514ffbca190>,63,3,[6 1],99,167,170,68,158
1,<environment.Job instance at 0x1514ffbcac30>,64,18,[7 2],100,170,188,70,161
1,<environment.Job instance at 0x15154c65e5f0>,18,17,[ 1 10],26,193,210,167,193
1,<environment.Job instance at 0x151545c95c30>,76,17,[9 1],114,210,227,96,209
1,<environment.Job instance at 0x15154c6a8140>,80,17,[7 2],121,227,244,106,224
1,<environment.Job instance at 0x1514ff858be0>,81,13,[8 1],124,244,257,120,232
1,<environment.Job instance at 0x1514ffbca730>,72,2,[1 9],109,260,262,151,260
1,<environment.Job instance at 0x1514ff635eb0>,2,3,[ 2 10],6,6,9,0,6
1,<environment.Job instance at 0x1515451f5be0>,7,17,[ 1 10],15,17,34,2,17
1,<environment.Job instance at 0x1515451f5dc0>,16,14,[6 2],30,34,48,4,30
1,<environment.Job instance at 0x15154d7a2a00>,18,18,[10  2],32,48,66,16,37
1,<environment.Job instance at 0x15154d7a2280>,25,2,[5 2],42,66,68,24,42
1,<environment.Job instance at 0x15154bf58460>,27,17,[7 1],45,68,85,23,56
1,<environment.Job instance at 0x15154bf58910>,29,15,[7 1],47,85,100,38,71
1,<environment.Job instance at 0x15154bf580a0>,30,13,[5 2],53,100,113,47,84
1,<environment.Job instance at 0x15154bf584b0>,35,17,[6 2],65,113,130,48,101
1,<environment.Job instance at 0x1514ffd3e320>,46,17,[6 1],83,130,147,47,118
1,<environment.Job instance at 0x1514fffca050>,49,18,[2 8],88,118,136,30,118
1,<environment.Job instance at 0x1514ffd18b90>,56,2,[1 7],103,136,138,33,118
1,<environment.Job instance at 0x151546b578c0>,58,16,[5 2],105,147,163,42,136
1,<environment.Job instance at 0x151546b57280>,64,18,[8 2],112,163,181,51,152
1,<environment.Job instance at 0x1514ff84a230>,70,3,[2 5],124,152,155,28,152
1,<environment.Job instance at 0x1514ffa5dc30>,73,18,[7 2],129,181,199,52,170
1,<environment.Job instance at 0x1514ffab7780>,2,3,[2 6],3,3,6,0,3
1,<environment.Job instance at 0x1515478c05a0>,10,2,[9 1],11,11,13,0,11
1,<environment.Job instance at 0x1515478c0e60>,12,14,[8 2],15,15,29,0,15
1,<environment.Job instance at 0x1514ffdb7d20>,32,3,[1 7],44,429,432,385,429
1,<environment.Job instance at 0x1514ffd8b460>,42,16,[10  1],56,433,449,377,433
1,<environment.Job instance at 0x1514ffdb70a0>,2,12,[5 2],4,4,16,0,4
1,<environment.Job instance at 0x151544cb48c0>,6,3,[2 9],12,16,19,4,12
1,<environment.Job instance at 0x151544cb42d0>,7,1,[8 2],14,19,20,5,14
1,<environment.Job instance at 0x151544cb4b90>,8,3,[7 1],16,16,19,0,16
1,<environment.Job instance at 0x151544cb4dc0>,9,3,[ 2 10],19,20,23,1,19
1,<environment.Job instance at 0x151544cb4d70>,10,3,[7 2],21,23,26,2,21
1,<environment.Job instance at 0x151544cb4780>,12,3,[1 6],26,26,29,0,26
1,<environment.Job instance at 0x151544cb4820>,13,13,[1 5],27,29,42,2,27
1,<environment.Job instance at 0x151544cb4960>,18,18,[1 8],33,42,60,9,34
1,<environment.Job instance at 0x151546beb820>,19,17,[10  2],35,60,77,25,48
1,<environment.Job instance at 0x151544c873c0>,40,15,[10  1],66,77,92,11,66
1,<environment.Job instance at 0x1514fff9a320>,45,2,[5 2],73,92,94,19,78
1,<environment.Job instance at 0x1514fff9ae10>,47,3,[2 5],75,92,95,17,78
1,<environment.Job instance at 0x1514fff9a640>,48,12,[5 2],76,94,106,18,78
1,<environment.Job instance at 0x1514fff9a410>,49,14,[2 8],78,95,109,17,80
1,<environment.Job instance at 0x1514fff9a690>,51,16,[7 1],81,106,122,25,95
1,<environment.Job instance at 0x1514fff9beb0>,61,14,[2 8],94,110,124,16,110
1,<environment.Job instance at 0x1514fff9bbe0>,64,14,[9 1],99,124,138,25,117
1,<environment.Job instance at 0x1514fff9be60>,69,15,[7 2],106,138,153,32,137
1,<environment.Job instance at 0x1514ff72b960>,75,17,[8 1],113,153,170,40,143
1,<environment.Job instance at 0x1514ffa589b0>,4,17,[6 2],6,6,23,0,6
1,<environment.Job instance at 0x1514ffa58b90>,10,15,[5 2],13,23,38,10,13
1,<environment.Job instance at 0x1514ffa4b1e0>,11,2,[7 1],14,38,40,24,14
1,<environment.Job instance at 0x1514ffa4b370>,12,1,[1 6],16,16,17,0,16
1,<environment.Job instance at 0x1514ffa4b460>,13,2,[6 2],17,40,42,23,17
1,<environment.Job instance at 0x1514ffa4b5f0>,14,2,[10  2],19,42,44,23,19
1,<environment.Job instance at 0x1514ffa4b6e0>,15,2,[2 7],23,23,25,0,23
1,<environment.Job instance at 0x1514ffa4b870>,16,3,[8 1],24,44,47,20,24
1,<environment.Job instance at 0x1514ffa4b9b0>,17,1,[8 2],26,47,48,21,26
1,<environment.Job instance at 0x1514ffa74550>,26,12,[8 1],40,48,60,8,40
1,<environment.Job instance at 0x1514ffa74690>,27,12,[7 1],41,60,72,19,44
1,<environment.Job instance at 0x151546b85780>,41,14,[ 1 10],63,72,86,9,65
1,<environment.Job instance at 0x151546b85af0>,43,14,[2 9],68,86,100,18,71
1,<environment.Job instance at 0x14f79a3be640>,0,12,[2 5],1,1,13,0,1
1,<environment.Job instance at 0x14f79a3be460>,1,3,[1 9],2,13,16,11,2
1,<environment.Job instance at 0x14f792858190>,6,18,[8 1],7,7,25,0,7
1,<environment.Job instance at 0x14f792858af0>,8,13,[6 1],9,25,38,16,14
1,<environment.Job instance at 0x14f7928331e0>,17,17,[6 1],23,38,55,15,34
1,<environment.Job instance at 0x14f792823d70>,27,2,[2 7],36,36,38,0,36
1,<environment.Job instance at 0x14f7928237d0>,29,16,[10  2],39,55,71,16,42
1,<environment.Job instance at 0x14f79106ebe0>,4,15,[5 1],5,5,20,0,5
1,<environment.Job instance at 0x14f790d9cc30>,11,3,[5 2],16,16,19,0,16
1,<environment.Job instance at 0x14f790d9c5a0>,12,15,[9 2],17,20,35,3,17
1,<environment.Job instance at 0x14f790d9cd20>,13,18,[2 6],18,35,53,17,24
1,<environment.Job instance at 0x14f790d9c320>,10,1,[8 1],14,86,87,72,86
1,<environment.Job instance at 0x14f798229280>,5,18,[8 1],7,7,25,0,7
1,<environment.Job instance at 0x14f7982291e0>,6,1,[5 2],8,25,26,17,8
1,<environment.Job instance at 0x14f798229410>,8,3,[1 7],10,10,13,0,10
1,<environment.Job instance at 0x14f798229d70>,11,2,[5 2],15,25,27,10,15
1,<environment.Job instance at 0x14f798207a50>,13,12,[7 1],18,27,39,9,18
1,<environment.Job instance at 0x14f798207820>,16,17,[7 1],22,39,56,17,28
1,<environment.Job instance at 0x14f79824a960>,22,14,[8 2],32,56,70,24,41
1,<environment.Job instance at 0x14f79824a690>,29,13,[5 2],41,70,83,29,58
1,<environment.Job instance at 0x14f793488640>,42,16,[7 2],64,83,99,19,70
1,<environment.Job instance at 0x14f793488d70>,44,18,[5 2],67,99,117,32,88
1,<environment.Job instance at 0x14f7930cb0a0>,50,15,[8 2],76,117,132,41,103
1,<environment.Job instance at 0x14f7930cb410>,51,17,[10  1],78,132,149,54,120
1,<environment.Job instance at 0x14f7934760a0>,78,14,[1 6],122,477,491,355,477
1,<environment.Job instance at 0x14f74bbde3c0>,1,26,[9 1],4,4,30,0,4
1,<environment.Job instance at 0x14f74bbde320>,5,12,[5 2],8,30,42,22,13
1,<environment.Job instance at 0x14f78c012c30>,10,15,[2 8],18,30,45,12,18
1,<environment.Job instance at 0x14f78c012640>,16,3,[2 9],27,45,48,18,27
1,<environment.Job instance at 0x14f74bbdb460>,22,16,[2 6],36,48,64,12,36
1,<environment.Job instance at 0x14f74bbdb050>,24,2,[8 2],38,42,44,4,38
1,<environment.Job instance at 0x14f74bbdb870>,25,14,[9 1],40,64,78,24,49
1,<environment.Job instance at 0x14f74bbdb320>,32,15,[10  1],49,78,93,29,71
1,<environment.Job instance at 0x14f798276690>,43,3,[1 6],64,93,96,29,82
1,<environment.Job instance at 0x14f798276050>,44,16,[1 5],65,96,112,31,83
1,<environment.Job instance at 0x14f798276410>,49,3,[6 1],70,134,137,64,134
1,<environment.Job instance at 0x14f798270a00>,65,12,[6 1],92,156,168,64,156
1,<environment.Job instance at 0x14f74bb20870>,73,3,[1 7],103,168,171,65,168
1,<environment.Job instance at 0x14f78c0332d0>,0,13,[5 1],1,1,14,0,1
1,<environment.Job instance at 0x14f79a242b90>,2,14,[6 1],3,14,28,11,3
1,<environment.Job instance at 0x14f7926cd550>,7,13,[10  1],8,28,41,20,12
1,<environment.Job instance at 0x14f7926cd7d0>,14,16,[10  1],19,41,57,22,28
1,<environment.Job instance at 0x14f7931b4dc0>,30,3,[2 6],46,57,60,11,46
1,<environment.Job instance at 0x14f7931b2050>,31,18,[1 5],47,60,78,13,49
1,<environment.Job instance at 0x14f7931b2550>,32,16,[1 5],51,60,76,9,52
1,<environment.Job instance at 0x14f74b93efa0>,40,3,[10  2],63,78,81,15,63
1,<environment.Job instance at 0x14f793161870>,41,2,[1 6],67,81,83,14,67
1,<environment.Job instance at 0x14f79257ce60>,43,16,[2 7],71,83,99,12,76
1,<environment.Job instance at 0x14f799862460>,53,27,[1 7],85,100,127,15,100
1,<environment.Job instance at 0x14f74b8bc460>,60,17,[1 9],94,127,144,33,119
1,<environment.Job instance at 0x14f74b4b2230>,65,13,[10  1],105,144,157,39,132
1,<environment.Job instance at 0x14f790d79870>,55,17,[2 8],87,159,176,72,159
1,<environment.Job instance at 0x14f74b3a09b0>,86,18,[5 1],138,172,190,34,172
1,<environment.Job instance at 0x14f74b38f2d0>,1,17,[9 2],3,3,20,0,3
1,<environment.Job instance at 0x14f74b93e8c0>,12,3,[7 1],18,20,23,2,18
1,<environment.Job instance at 0x14f74b93eb40>,14,14,[1 5],21,21,35,0,21
1,<environment.Job instance at 0x14f74b93e5f0>,15,12,[2 6],23,35,47,12,23
1,<environment.Job instance at 0x14f74b849640>,18,25,[8 1],29,29,54,0,29
1,<environment.Job instance at 0x14f74b8492d0>,19,16,[8 1],30,54,70,24,44
1,<environment.Job instance at 0x14f74b8495f0>,26,16,[1 9],39,69,85,30,69
1,<environment.Job instance at 0x14f74b6d8820>,34,19,[2 5],50,85,104,35,78
1,<environment.Job instance at 0x14f74b6d8d20>,35,17,[2 9],51,104,121,53,100
1,<environment.Job instance at 0x14f7947b6e60>,41,3,[2 7],59,121,124,62,101
1,<environment.Job instance at 0x14f79983ff50>,47,16,[ 2 10],65,132,148,67,132
1,<environment.Job instance at 0x14f79983f820>,51,2,[7 2],70,148,150,78,132
1,<environment.Job instance at 0x14f79983f230>,54,1,[8 1],74,150,151,76,133
1,<environment.Job instance at 0x14f7978a3730>,63,15,[5 2],86,151,166,65,150
1,<environment.Job instance at 0x14f7978a3870>,65,15,[7 2],89,166,181,77,154
1,<environment.Job instance at 0x14f78c0b5910>,72,17,[2 5],97,183,200,86,183
1,<environment.Job instance at 0x14f78c0b5140>,74,15,[9 2],100,200,215,100,186
1,<environment.Job instance at 0x14f78c0b5f50>,78,17,[9 1],106,215,232,109,203
1,<environment.Job instance at 0x14f78c06c820>,0,14,[2 9],1,1,15,0,1
1,<environment.Job instance at 0x14f78c06ca00>,8,3,[5 2],9,15,18,6,10
1,<environment.Job instance at 0x14f78c06c870>,12,13,[7 2],14,18,31,4,14
1,<environment.Job instance at 0x14f799c85050>,14,15,[ 2 10],16,31,46,15,18
1,<environment.Job instance at 0x14f74b3b8fa0>,21,18,[6 1],25,46,64,21,35
1,<environment.Job instance at 0x14f790d496e0>,26,16,[6 2],31,64,80,33,51
1,<environment.Job instance at 0x14f799996c30>,40,15,[10  2],54,80,95,26,66
1,<environment.Job instance at 0x14f74b801f00>,46,2,[1 9],62,95,97,33,71
1,<environment.Job instance at 0x14f74b947aa0>,47,14,[1 6],63,97,111,34,85
1,<environment.Job instance at 0x14f74b75fe60>,56,12,[5 2],77,97,109,20,93
1,<environment.Job instance at 0x14f74bb70fa0>,1,12,[6 2],3,4,16,1,4
1,<environment.Job instance at 0x14f7926aafa0>,5,14,[7 1],8,16,30,8,8
1,<environment.Job instance at 0x14f78c02f050>,11,3,[5 2],14,30,33,16,14
1,<environment.Job instance at 0x14f78c0190f0>,12,16,[7 1],15,33,49,18,20
1,<environment.Job instance at 0x14f78c03f870>,16,26,[1 6],21,51,77,30,51
1,<environment.Job instance at 0x14f798347550>,19,23,[9 1],26,51,74,25,51
1,<environment.Job instance at 0x14f78c0195f0>,9,16,[1 8],12,746,762,734,746
1,<environment.Job instance at 0x14f796613910>,0,12,[2 8],1,1,13,0,1
1,<environment.Job instance at 0x14f74b2fe5f0>,5,12,[2 8],8,13,25,5,8
1,<environment.Job instance at 0x14f74b2fe8c0>,10,13,[8 2],16,16,29,0,16
1,<environment.Job instance at 0x14f74b300730>,20,21,[9 1],31,31,52,0,31
1,<environment.Job instance at 0x14f74b300aa0>,22,15,[10  2],33,52,67,19,38
1,<environment.Job instance at 0x14f74b3028c0>,34,16,[9 2],50,67,83,17,54
1,<environment.Job instance at 0x14f74b304af0>,53,17,[5 1],74,83,100,9,77
1,<environment.Job instance at 0x14f74b306370>,57,26,[8 1],78,100,126,22,97
1,<environment.Job instance at 0x14f74b306870>,63,16,[5 2],84,126,142,42,119
1,<environment.Job instance at 0x14f74b306820>,65,13,[2 8],87,119,132,32,119
1,<environment.Job instance at 0x14f74b310d20>,0,16,[7 1],1,1,17,0,1
1,<environment.Job instance at 0x14f74b306c30>,9,15,[6 1],15,17,32,2,15
1,<environment.Job instance at 0x14f74b88d9b0>,11,17,[8 1],17,32,49,15,20
1,<environment.Job instance at 0x14f7979134b0>,21,15,[8 1],29,49,64,20,37
1,<environment.Job instance at 0x14f7931cc370>,26,13,[7 2],40,64,77,24,49
1,<environment.Job instance at 0x14f7934bdc80>,34,3,[1 9],51,51,54,0,51
1,<environment.Job instance at 0x14f7983647d0>,35,17,[1 5],52,54,71,2,52
1,<environment.Job instance at 0x14f74bbc2a00>,36,3,[8 1],54,77,80,23,54
1,<environment.Job instance at 0x14f74bbc2460>,44,3,[10  1],68,80,83,12,68
1,<environment.Job instance at 0x14f74b84aeb0>,46,3,[7 2],71,83,86,12,71
1,<environment.Job instance at 0x14f74b84a780>,48,15,[ 2 10],74,86,101,12,81
1,<environment.Job instance at 0x14f7982897d0>,97,16,[2 6],138,948,964,810,948
1,<environment.Job instance at 0x14f74b590e10>,0,14,[5 2],4,4,18,0,4
1,<environment.Job instance at 0x14f74b495d20>,5,21,[10  2],12,18,39,6,12
1,<environment.Job instance at 0x14f74b527320>,15,12,[5 2],29,39,51,10,31
1,<environment.Job instance at 0x14f7908bc190>,26,18,[8 1],48,51,69,3,48
1,<environment.Job instance at 0x14f7934aab90>,35,17,[6 2],62,69,86,7,64
1,<environment.Job instance at 0x14f790b0e5f0>,42,1,[1 9],70,86,87,16,70
1,<environment.Job instance at 0x14f7931ffa00>,43,2,[2 6],71,71,73,0,71
1,<environment.Job instance at 0x14f7931ff8c0>,44,3,[ 2 10],72,87,90,15,72
1,<environment.Job instance at 0x14f74b5a37d0>,45,13,[2 8],73,73,86,0,73
1,<environment.Job instance at 0x14f793149730>,47,3,[1 6],77,90,93,13,77
1,<environment.Job instance at 0x14f74b4dda50>,50,14,[ 2 10],80,93,107,13,80
1,<environment.Job instance at 0x14f79279f0a0>,0,19,[5 2],1,1,20,0,1
1,<environment.Job instance at 0x14f79107b3c0>,6,15,[8 2],7,20,35,13,8
1,<environment.Job instance at 0x14f74b266820>,3,2,[10  1],6,6,8,0,6
1,<environment.Job instance at 0x14f74b86cb40>,4,16,[10  2],7,8,24,1,7
1,<environment.Job instance at 0x14f74b86cf50>,11,16,[5 2],16,24,40,8,17
1,<environment.Job instance at 0x14f793183230>,2,3,[1 7],3,3,6,0,3
1,<environment.Job instance at 0x14f79825cc80>,6,1,[1 5],8,8,9,0,8
1,<environment.Job instance at 0x14f74ba73460>,12,3,[2 5],14,14,17,0,14
1,<environment.Job instance at 0x14f7918ba320>,13,18,[10  1],15,17,35,2,15
1,<environment.Job instance at 0x14f74b5ed280>,28,14,[2 8],35,539,553,504,539
1,<environment.Job instance at 0x14f79279ab40>,29,15,[8 2],36,539,554,503,539
1,<environment.Job instance at 0x14f7966021e0>,39,14,[10  1],49,554,568,505,548
1,<environment.Job instance at 0x14f74b635820>,45,12,[7 2],57,568,580,511,551
1,<environment.Job instance at 0x14f74b6355a0>,47,17,[6 2],61,580,597,519,568
1,<environment.Job instance at 0x14f792812aa0>,51,1,[8 1],65,597,598,532,569
1,<environment.Job instance at 0x14f792812af0>,52,18,[10  1],66,598,616,532,587
1,<environment.Job instance at 0x14f798243e10>,61,14,[9 2],79,616,630,537,605
1,<environment.Job instance at 0x14f74b3cb190>,76,17,[ 2 10],98,630,647,532,626
1,<environment.Job instance at 0x14f79254baa0>,84,13,[8 1],106,647,660,541,639
1,<environment.Job instance at 0x14f74b87b4b0>,86,2,[ 1 10],108,660,662,552,639
1,<environment.Job instance at 0x14f74b87b320>,87,1,[5 1],109,662,663,553,639
1,<environment.Job instance at 0x14f74b87beb0>,88,3,[5 2],110,662,665,552,639
1,<environment.Job instance at 0x14f792573d70>,89,17,[6 2],114,665,682,551,653
1,<environment.Job instance at 0x14f792573c30>,91,15,[10  2],116,682,697,566,668
1,<environment.Job instance at 0x14f792573f00>,1,17,[2 9],3,3,20,0,3
1,<environment.Job instance at 0x14f7978a2f00>,17,3,[7 2],25,33,36,8,33
1,<environment.Job instance at 0x14f7978a2e10>,18,3,[1 6],27,33,36,6,33
1,<environment.Job instance at 0x14f7978b5190>,20,2,[8 1],33,36,38,3,33
1,<environment.Job instance at 0x14f7978b5690>,21,3,[9 2],34,38,41,4,38
1,<environment.Job instance at 0x14f7978b5500>,23,2,[10  1],37,41,43,4,38
1,<environment.Job instance at 0x14f7978b56e0>,24,13,[1 8],38,43,56,5,38
1,<environment.Job instance at 0x14f7978b5b90>,25,3,[5 1],40,43,46,3,42
1,<environment.Job instance at 0x14f7978b5eb0>,27,2,[7 2],44,46,48,2,44
1,<environment.Job instance at 0x14f7978b5fa0>,28,12,[2 8],45,56,68,11,45
1,<environment.Job instance at 0x14f7978b5e60>,29,14,[10  2],46,68,82,22,53
1,<environment.Job instance at 0x14f7978a71e0>,31,12,[6 1],50,53,65,3,53
1,<environment.Job instance at 0x14f7978a7140>,33,14,[9 2],53,82,96,29,67
1,<environment.Job instance at 0x14f7978a7690>,40,16,[9 2],63,96,112,33,91
1,<environment.Job instance at 0x14f7978b7140>,46,2,[10  1],72,112,114,40,98
1,<environment.Job instance at 0x14f7978b7870>,52,13,[2 8],83,114,127,31,98
1,<environment.Job instance at 0x14f7978b79b0>,55,3,[2 9],87,127,130,40,102
1,<environment.Job instance at 0x14f7978b7af0>,57,18,[7 2],90,130,148,40,119
1,<environment.Job instance at 0x14f7978abe10>,0,13,[7 2],1,1,14,0,1
1,<environment.Job instance at 0x14f74ba5e730>,8,18,[10  2],12,14,32,2,12
1,<environment.Job instance at 0x14f7982a8190>,19,15,[7 1],27,32,47,5,27
1,<environment.Job instance at 0x14f7982a80f0>,20,13,[5 2],33,47,60,14,33
1,<environment.Job instance at 0x14f7982a8b40>,23,14,[7 1],39,60,74,21,46
1,<environment.Job instance at 0x14f7982a8960>,28,14,[10  2],49,74,88,25,59
1,<environment.Job instance at 0x14f7934e63c0>,36,17,[6 1],63,88,105,25,76
1,<environment.Job instance at 0x14f74bb13aa0>,0,17,[10  2],1,1,18,0,1
1,<environment.Job instance at 0x14f7931070f0>,12,2,[2 5],16,18,20,2,16
1,<environment.Job instance at 0x14f7931e7b90>,13,3,[1 9],17,20,23,3,17
1,<environment.Job instance at 0x14f7931e7230>,16,3,[1 9],22,23,26,1,22
1,<environment.Job instance at 0x14f7931e74b0>,17,1,[9 1],23,23,24,0,23
1,<environment.Job instance at 0x14f7931e7d70>,18,3,[1 7],24,26,29,2,24
1,<environment.Job instance at 0x14f79477f280>,0,16,[ 2 10],3,3,19,0,3
1,<environment.Job instance at 0x14f792562280>,1,13,[8 1],4,19,32,15,4
1,<environment.Job instance at 0x14f7925621e0>,2,2,[2 6],5,19,21,14,5
1,<environment.Job instance at 0x14f74b56c730>,8,13,[1 9],14,21,34,7,14
1,<environment.Job instance at 0x14f74b56ce10>,17,15,[10  1],26,34,49,8,26
1,<environment.Job instance at 0x14f74b55e2d0>,18,17,[6 1],28,49,66,21,37
1,<environment.Job instance at 0x14f74b55e7d0>,25,12,[5 2],36,66,78,30,49
1,<environment.Job instance at 0x14f74b55e5f0>,27,1,[6 2],40,78,79,38,50
1,<environment.Job instance at 0x14f74b55e3c0>,28,16,[7 1],41,79,95,38,66
1,<environment.Job instance at 0x14f74b55ec30>,30,2,[1 8],43,66,68,23,66
1,<environment.Job instance at 0x14f74b55ec80>,33,15,[7 2],48,95,110,47,81
1,<environment.Job instance at 0x14f74b549140>,37,2,[8 2],53,110,112,57,83
1,<environment.Job instance at 0x14f74b549050>,38,14,[2 8],54,83,97,29,83
1,<environment.Job instance at 0x14f74b5493c0>,41,14,[9 1],59,112,126,53,106
1,<environment.Job instance at 0x14f74b549d20>,48,13,[6 1],68,126,139,58,118
1,<environment.Job instance at 0x14f74b57b0f0>,60,3,[2 6],88,126,129,38,118
1,<environment.Job instance at 0x14f74b57d370>,68,12,[1 7],99,129,141,30,125
1,<environment.Job instance at 0x14f74b57d460>,70,2,[2 7],101,141,143,40,127
1,<environment.Job instance at 0x14f74b57d3c0>,72,15,[5 2],103,139,154,36,127
1,<environment.Job instance at 0x14f74b57d0a0>,73,2,[7 1],104,154,156,50,127
1,<environment.Job instance at 0x14f7925dfd20>,77,2,[2 7],113,143,145,30,127
1,<environment.Job instance at 0x14f7925dfa50>,78,3,[8 1],114,156,159,42,131
1,<environment.Job instance at 0x14f79792a050>,82,3,[2 7],121,145,148,24,132
1,<environment.Job instance at 0x14f792614b90>,86,15,[2 8],128,148,163,20,136
1,<environment.Job instance at 0x14f7926146e0>,88,12,[8 1],130,159,171,29,158
1,<environment.Job instance at 0x14f74b55e4b0>,20,15,[5 2],30,214,229,184,214
1,<environment.Job instance at 0x14f78c125280>,3,3,[1 7],7,8,11,1,8
1,<environment.Job instance at 0x14f78c1257d0>,7,1,[1 6],16,16,17,0,16
1,<environment.Job instance at 0x14f78c125230>,8,14,[2 9],18,18,32,0,18
1,<environment.Job instance at 0x14f79280b320>,13,3,[6 2],23,32,35,9,23
1,<environment.Job instance at 0x14f79280b870>,15,1,[2 9],28,35,36,7,28
1,<environment.Job instance at 0x14f79280be10>,16,18,[2 7],29,36,54,7,29
1,<environment.Job instance at 0x14f79794d0f0>,0,3,[10  1],1,1,4,0,1
1,<environment.Job instance at 0x14f74b5a5d70>,6,13,[1 9],7,7,20,0,7
1,<environment.Job instance at 0x14f74b58e3c0>,8,3,[5 1],11,11,14,0,11
1,<environment.Job instance at 0x14f74b58ebe0>,15,2,[1 8],19,20,22,1,19
1,<environment.Job instance at 0x14f74b58ec30>,20,13,[8 2],24,24,37,0,24
1,<environment.Job instance at 0x14f74b598e10>,32,13,[ 1 10],41,41,54,0,41
1,<environment.Job instance at 0x14f74b584640>,36,3,[ 1 10],46,54,57,8,46
1,<environment.Job instance at 0x14f74b584b90>,45,16,[5 1],59,72,88,13,72
1,<environment.Job instance at 0x14f74b584d20>,47,13,[2 5],62,72,85,10,72
1,<environment.Job instance at 0x14f74b597b40>,54,13,[7 2],74,88,101,14,75
1,<environment.Job instance at 0x14f74b5b95a0>,62,14,[2 5],82,100,114,18,100
1,<environment.Job instance at 0x14f74b5ac050>,75,18,[5 2],100,101,119,1,101
1,<environment.Job instance at 0x14f74b5c2cd0>,78,13,[9 2],108,119,132,11,108
1,<environment.Job instance at 0x14f74b34dfa0>,81,15,[5 2],112,132,147,20,119
1,<environment.Job instance at 0x1543fec69c30>,0,12,[2 5],1,1,13,0,1
1,<environment.Job instance at 0x1543f70fd690>,6,18,[8 1],7,8,26,1,8
1,<environment.Job instance at 0x1543f793e050>,17,17,[6 1],23,26,43,3,23
1,<environment.Job instance at 0x1543f7045d20>,30,15,[2 9],40,52,67,12,52
1,<environment.Job instance at 0x1543f53e4d70>,6,18,[2 6],8,16,34,8,16
1,<environment.Job instance at 0x1543f7dee500>,0,17,[7 1],2,2,19,0,2
1,<environment.Job instance at 0x1543fcb82370>,3,12,[7 2],7,19,31,12,14
1,<environment.Job instance at 0x1543fcb23dc0>,9,14,[8 1],16,31,45,15,17
1,<environment.Job instance at 0x1543fcb23cd0>,13,13,[5 2],21,45,58,24,38
1,<environment.Job instance at 0x1543f569d5a0>,28,18,[5 2],47,54,72,7,54
1,<environment.Job instance at 0x1543f569d230>,31,12,[2 9],53,72,84,19,68
1,<environment.Job instance at 0x1543f569df50>,35,17,[10  1],58,84,101,26,72
1,<environment.Job instance at 0x1543fca9caa0>,54,14,[7 2],87,101,115,14,93
1,<environment.Job instance at 0x1543fca9c1e0>,59,18,[6 2],96,115,133,19,105
1,<environment.Job instance at 0x1543f56a5f00>,61,3,[5 1],100,133,136,33,107
1,<environment.Job instance at 0x1543f56a5370>,62,14,[1 6],102,107,121,5,107
1,<environment.Job instance at 0x1543f56a5b90>,68,3,[6 2],111,136,139,25,111
1,<environment.Job instance at 0x1543f56a5140>,70,3,[1 7],113,121,124,8,113
1,<environment.Job instance at 0x1543f7ddf320>,71,2,[9 2],115,139,141,24,115
1,<environment.Job instance at 0x1543f7ddfb40>,73,3,[1 7],118,124,127,6,118
1,<environment.Job instance at 0x1543f7ae4f50>,74,14,[1 6],119,127,141,8,119
1,<environment.Job instance at 0x1543ec2f7230>,77,26,[9 1],124,141,167,17,138
1,<environment.Job instance at 0x1543ec2fb9b0>,87,16,[2 8],139,167,183,28,158
1,<environment.Job instance at 0x1543f40cd050>,0,2,[1 9],1,1,3,0,1
1,<environment.Job instance at 0x1543f40cdc80>,3,16,[2 6],6,6,22,0,6
1,<environment.Job instance at 0x1543f40cd0a0>,6,14,[9 1],10,22,36,12,10
1,<environment.Job instance at 0x1543f41335f0>,13,15,[10  1],19,36,51,17,22
1,<environment.Job instance at 0x1543f409e5a0>,65,15,[7 1],87,1592,1607,1505,1592
1,<environment.Job instance at 0x1543f40aa460>,72,17,[9 1],96,1632,1649,1536,1632
1,<environment.Job instance at 0x1543cfdc0c80>,76,12,[9 2],100,1649,1661,1549,1635
1,<environment.Job instance at 0x1543cfdc0690>,80,16,[10  2],104,1661,1677,1557,1648
1,<environment.Job instance at 0x1543cfdc0910>,85,13,[5 1],111,1677,1690,1566,1675
1,<environment.Job instance at 0x1543cfdc0be0>,87,14,[6 1],113,1690,1704,1577,1685
1,<environment.Job instance at 0x1543cfdc06e0>,92,13,[10  1],118,1704,1717,1586,1702
1,<environment.Job instance at 0x1543f53b5dc0>,94,1,[ 2 10],120,1717,1718,1597,1711
1,<environment.Job instance at 0x1543f53b5320>,99,16,[10  1],129,1728,1744,1599,1728
1,<environment.Job instance at 0x1543ec3b10f0>,102,12,[7 1],134,1744,1756,1610,1729
1,<environment.Job instance at 0x1543f40aed70>,110,14,[2 5],148,1756,1770,1608,1756
1,<environment.Job instance at 0x1543f40acf00>,53,15,[1 8],72,1809,1824,1737,1809
1,<environment.Job instance at 0x1543f41b6190>,0,12,[1 5],1,2,14,1,2
1,<environment.Job instance at 0x1543cfd11640>,4,18,[1 5],7,10,28,3,10
1,<environment.Job instance at 0x1543cfd106e0>,11,2,[ 1 10],20,28,30,8,20
1,<environment.Job instance at 0x1543cfd130f0>,12,16,[ 2 10],22,30,46,8,22
1,<environment.Job instance at 0x1543cfd139b0>,13,3,[10  2],23,46,49,23,23
1,<environment.Job instance at 0x1543cfd13fa0>,14,2,[1 6],27,49,51,22,27
1,<environment.Job instance at 0x1543cfd13af0>,15,3,[1 9],28,51,54,23,28
1,<environment.Job instance at 0x1543f41a0640>,24,14,[2 8],43,54,68,11,43
1,<environment.Job instance at 0x1543fc166320>,33,17,[1 9],54,68,85,14,60
1,<environment.Job instance at 0x1543fc166690>,38,13,[10  1],65,85,98,20,69
1,<environment.Job instance at 0x1543ec1212d0>,46,1,[8 1],79,121,122,42,121
1,<environment.Job instance at 0x1543f6e601e0>,47,3,[1 9],81,121,124,40,121
1,<environment.Job instance at 0x1543fc105870>,48,1,[2 9],84,124,125,40,121
1,<environment.Job instance at 0x1543fc105dc0>,50,12,[7 1],86,122,134,36,121
1,<environment.Job instance at 0x1543ec329370>,0,17,[2 9],1,2,19,1,2
1,<environment.Job instance at 0x1543cffbde10>,5,12,[ 1 10],7,19,31,12,7
1,<environment.Job instance at 0x1543f40d0a00>,18,13,[2 8],23,31,44,8,23
1,<environment.Job instance at 0x1543f40d08c0>,23,17,[10  1],30,44,61,14,32
1,<environment.Job instance at 0x1543f6e91c80>,28,15,[5 2],36,61,76,25,58
1,<environment.Job instance at 0x1543f41757d0>,43,17,[9 1],56,76,93,20,64
1,<environment.Job instance at 0x1543fe10ac30>,60,16,[6 1],77,127,143,50,127
1,<environment.Job instance at 0x1543fc449c80>,66,13,[2 9],83,128,141,45,128
1,<environment.Job instance at 0x1543ec0385a0>,70,13,[10  1],89,143,156,54,128
1,<environment.Job instance at 0x1543cfe3a9b0>,77,3,[2 7],96,156,159,60,154
1,<environment.Job instance at 0x1543cfe3a730>,79,17,[1 8],98,159,176,61,157
1,<environment.Job instance at 0x1543f53e84b0>,83,2,[2 5],102,176,178,74,172
1,<environment.Job instance at 0x1543ec2020a0>,87,3,[10  2],107,178,181,71,172
1,<environment.Job instance at 0x1543ec202c80>,88,3,[2 5],109,181,184,72,172
1,<environment.Job instance at 0x1543ec202730>,89,17,[1 7],110,184,201,74,172
1,<environment.Job instance at 0x1543ec202870>,90,3,[7 2],111,172,175,61,172
1,<environment.Job instance at 0x1543ec202190>,91,2,[2 9],112,201,203,89,174
1,<environment.Job instance at 0x1543ec202780>,93,18,[6 1],115,181,199,66,174
1,<environment.Job instance at 0x1543ec202a50>,94,15,[2 9],116,203,218,87,189
1,<environment.Job instance at 0x1543ec202e60>,98,16,[6 2],121,218,234,97,208
1,<environment.Job instance at 0x1543fc147f50>,115,14,[5 2],149,266,280,117,266
1,<environment.Job instance at 0x1543fc1713c0>,59,13,[2 8],76,310,323,234,310
1,<environment.Job instance at 0x1543f70c6460>,0,15,[ 2 10],2,2,17,0,2
1,<environment.Job instance at 0x1543cfe51f00>,7,16,[2 9],10,17,33,7,10
1,<environment.Job instance at 0x1543f40d7dc0>,21,2,[10  2],28,33,35,5,28
1,<environment.Job instance at 0x1543f40f9d20>,22,2,[1 7],29,35,37,6,29
1,<environment.Job instance at 0x1543fcb05c30>,23,3,[2 8],30,37,40,7,30
1,<environment.Job instance at 0x1543cfcd20f0>,24,2,[6 2],31,35,37,4,31
1,<environment.Job instance at 0x1543f4039780>,25,1,[7 1],34,37,38,3,34
1,<environment.Job instance at 0x1543f4039fa0>,26,2,[5 2],35,38,40,3,35
1,<environment.Job instance at 0x1543f4039b40>,27,15,[1 9],36,40,55,4,36
1,<environment.Job instance at 0x1543fcaf95f0>,37,15,[6 1],52,52,67,0,52
1,<environment.Job instance at 0x1543f565f0f0>,39,17,[10  1],56,67,84,11,56
1,<environment.Job instance at 0x1543f40d3910>,80,3,[9 1],116,423,426,307,423
1,<environment.Job instance at 0x1543f40d3fa0>,81,12,[9 1],117,426,438,309,423
1,<environment.Job instance at 0x1543f40d3d70>,83,16,[9 2],120,438,454,318,425
1,<environment.Job instance at 0x1543f40d3460>,84,3,[ 2 10],121,454,457,333,428
1,<environment.Job instance at 0x1543f40d3410>,85,15,[6 1],123,457,472,334,443
1,<environment.Job instance at 0x1543f40ca0f0>,99,3,[2 9],141,461,464,320,461
1,<environment.Job instance at 0x1543f40ca640>,102,17,[5 1],144,472,489,328,469
1,<environment.Job instance at 0x1543f59213c0>,54,12,[2 8],78,525,537,447,525
1,<environment.Job instance at 0x1543f40ce4b0>,1,21,[9 2],2,2,23,0,2
1,<environment.Job instance at 0x1543f590f8c0>,2,17,[7 2],3,23,40,20,12
1,<environment.Job instance at 0x1543cfb83780>,15,15,[6 2],22,40,55,18,36
1,<environment.Job instance at 0x1543cfb83eb0>,25,17,[5 2],34,55,72,21,48
1,<environment.Job instance at 0x1543cfb858c0>,28,1,[2 7],38,48,49,10,48
1,<environment.Job instance at 0x1543cfb85320>,29,2,[2 6],39,49,51,10,48
1,<environment.Job instance at 0x1543cfb857d0>,30,17,[5 2],40,55,72,15,48
1,<environment.Job instance at 0x1543cfb875f0>,38,15,[2 5],50,72,87,22,63
1,<environment.Job instance at 0x1543cfb87690>,42,16,[8 2],55,72,88,17,71
1,<environment.Job instance at 0x1543cfb87cd0>,48,14,[1 8],63,87,101,24,77
1,<environment.Job instance at 0x1543cfb89280>,52,3,[2 6],67,101,104,34,78
1,<environment.Job instance at 0x1543cfb897d0>,55,15,[6 1],75,88,103,13,80
1,<environment.Job instance at 0x1543cfb8a500>,61,16,[2 5],81,104,120,23,95
1,<environment.Job instance at 0x1543cfb8a6e0>,64,2,[1 7],84,120,122,36,95
1,<environment.Job instance at 0x1543cfb8a780>,65,1,[6 2],87,103,104,16,95
1,<environment.Job instance at 0x1543cfb8a820>,66,3,[5 2],88,104,107,16,95
1,<environment.Job instance at 0x1543cfb8a7d0>,67,15,[8 1],89,107,122,18,95
1,<environment.Job instance at 0x1543cfb8c1e0>,72,13,[7 2],100,122,135,22,106
1,<environment.Job instance at 0x1543cfbf5d70>,89,18,[1 7],126,130,148,4,130
1,<environment.Job instance at 0x1543cfb94c30>,1,3,[2 7],2,2,5,0,2
1,<environment.Job instance at 0x1543f70978c0>,3,3,[10  1],7,7,10,0,7
1,<environment.Job instance at 0x1543f7097cd0>,10,3,[2 7],14,14,17,0,14
1,<environment.Job instance at 0x1543f7097eb0>,11,1,[7 1],15,15,16,0,15
1,<environment.Job instance at 0x1543f7097730>,12,2,[7 2],16,16,18,0,16
1,<environment.Job instance at 0x1543f53b7780>,13,13,[10  1],18,18,31,0,18
1,<environment.Job instance at 0x1543f40a3b90>,17,1,[9 1],22,31,32,9,22
1,<environment.Job instance at 0x1543ec3acb90>,28,17,[10  1],38,38,55,0,38
1,<environment.Job instance at 0x1543ec3acbe0>,30,1,[8 2],40,55,56,15,40
1,<environment.Job instance at 0x1543ec3ac550>,31,2,[2 6],41,55,57,14,41
1,<environment.Job instance at 0x1543ec3ac050>,32,3,[1 9],42,57,60,15,42
1,<environment.Job instance at 0x1543ec3acaf0>,36,1,[5 1],47,56,57,9,47
1,<environment.Job instance at 0x1543f7975960>,37,16,[2 6],48,60,76,12,48
1,<environment.Job instance at 0x1543f79750f0>,39,14,[5 2],54,63,77,9,63
1,<environment.Job instance at 0x1543f79755f0>,47,14,[2 5],67,76,90,9,70
1,<environment.Job instance at 0x1543f7a10a00>,48,13,[1 5],71,77,90,6,73
1,<environment.Job instance at 0x1543f7a101e0>,53,13,[2 9],77,90,103,13,78
1,<environment.Job instance at 0x1543f6f01b90>,66,2,[2 8],100,141,143,41,141
1,<environment.Job instance at 0x1543cffbdaa0>,69,3,[6 2],106,141,144,35,141
1,<environment.Job instance at 0x1543f590fa00>,70,12,[2 9],107,144,156,37,141
1,<environment.Job instance at 0x1543f6f75690>,71,2,[5 1],108,144,146,36,143
1,<environment.Job instance at 0x1543cfcce910>,74,17,[6 2],112,156,173,44,144
1,<environment.Job instance at 0x1543f6f25d70>,1,1,[1 5],2,3,4,1,3
1,<environment.Job instance at 0x1543f6f25140>,3,3,[5 1],4,4,7,0,4
1,<environment.Job instance at 0x1543f6f25320>,4,3,[1 7],5,5,8,0,5
1,<environment.Job instance at 0x1543f6f25280>,5,3,[10  2],7,8,11,1,7
1,<environment.Job instance at 0x1543ec0978c0>,6,17,[9 2],9,11,28,2,9
1,<environment.Job instance at 0x1543cfdc00f0>,9,1,[8 1],16,28,29,12,16
1,<environment.Job instance at 0x1543cfda1b90>,10,15,[7 1],17,29,44,12,17
1,<environment.Job instance at 0x1543ec0f7870>,22,13,[1 9],31,31,44,0,31
1,<environment.Job instance at 0x1543f7d63c80>,24,15,[9 1],34,44,59,10,38
1,<environment.Job instance at 0x1543cfcd2be0>,35,15,[8 2],47,59,74,12,50
1,<environment.Job instance at 0x1543f7018e60>,47,15,[9 1],62,74,89,12,65
1,<environment.Job instance at 0x1543f56a00a0>,48,12,[6 1],63,118,130,55,118
1,<environment.Job instance at 0x1543f6e58320>,53,14,[ 2 10],68,130,144,62,128
1,<environment.Job instance at 0x1543cf985280>,62,15,[10  1],83,144,159,61,135
1,<environment.Job instance at 0x1543cf9859b0>,63,3,[1 8],85,159,162,74,137
1,<environment.Job instance at 0x1543fe4cf4b0>,71,16,[7 2],94,159,175,65,146
1,<environment.Job instance at 0x1543fcb32370>,0,3,[10  1],1,1,4,0,1
1,<environment.Job instance at 0x1543f70ae690>,1,14,[6 1],3,4,18,1,3
1,<environment.Job instance at 0x1543cfcc39b0>,10,17,[5 2],20,20,37,0,20
1,<environment.Job instance at 0x1543cfcd5fa0>,29,16,[5 2],46,46,62,0,46
1,<environment.Job instance at 0x1543cffcc730>,4,17,[7 2],6,6,23,0,6
1,<environment.Job instance at 0x1543cffcc4b0>,7,16,[6 1],10,23,39,13,11
1,<environment.Job instance at 0x1543cfff90a0>,27,18,[10  1],35,39,57,4,35
1,<environment.Job instance at 0x1543cffde4b0>,36,2,[8 2],48,82,84,34,82
1,<environment.Job instance at 0x1543cffde050>,37,14,[9 2],49,84,98,35,82
1,<environment.Job instance at 0x1543cffde820>,41,16,[8 1],54,98,114,44,91
1,<environment.Job instance at 0x1543cfd6ac30>,52,3,[2 6],68,99,102,31,99
1,<environment.Job instance at 0x1543cfd6a910>,53,14,[10  1],69,114,128,45,99
1,<environment.Job instance at 0x1543cfce9d70>,65,1,[8 1],85,128,129,43,122
1,<environment.Job instance at 0x1543cfd50460>,71,3,[7 1],91,129,132,38,122
1,<environment.Job instance at 0x1543cfd50d70>,72,3,[8 2],92,132,135,40,122
1,<environment.Job instance at 0x1543cfd506e0>,74,22,[5 1],96,136,158,40,136
1,<environment.Job instance at 0x1543cf9e2960>,79,13,[8 1],105,158,171,53,148
1,<environment.Job instance at 0x1543cf9e2780>,90,17,[ 2 10],118,171,188,53,159
1,<environment.Job instance at 0x1543cfd7f320>,92,18,[2 5],120,188,206,68,186
1,<environment.Job instance at 0x1543f41e5c30>,103,17,[6 2],134,200,217,66,200
1,<environment.Job instance at 0x1543f6f28730>,105,15,[10  2],136,217,232,81,208
1,<environment.Job instance at 0x1543cfefecd0>,115,14,[1 7],149,329,343,180,329
1,<environment.Job instance at 0x1543cfa17c30>,7,2,[2 9],12,13,15,1,13
1,<environment.Job instance at 0x1543cfa0f230>,9,3,[7 1],14,14,17,0,14
1,<environment.Job instance at 0x1543ec0a5730>,10,2,[ 1 10],15,17,19,2,15
1,<environment.Job instance at 0x1543fc44fd20>,24,3,[7 2],35,367,370,332,367
1,<environment.Job instance at 0x1543fc44f870>,25,3,[1 6],37,368,371,331,368
1,<environment.Job instance at 0x1543fc44f320>,26,2,[1 6],39,371,373,332,369
1,<environment.Job instance at 0x1543fc44f140>,27,2,[8 1],43,372,374,329,372
1,<environment.Job instance at 0x1543fcba1f00>,29,1,[2 8],46,374,375,328,374
1,<environment.Job instance at 0x1543fcba1eb0>,31,13,[1 8],48,375,388,327,374
1,<environment.Job instance at 0x1543cfeecd20>,35,12,[2 8],55,388,400,333,379
1,<environment.Job instance at 0x1543cfeecaa0>,36,14,[10  2],56,400,414,344,386
1,<environment.Job instance at 0x1543cfeec550>,38,12,[6 1],60,386,398,326,386
1,<environment.Job instance at 0x1543cfeec370>,40,14,[9 2],63,414,428,351,399
1,<environment.Job instance at 0x1543cfeec230>,46,18,[1 7],72,430,448,358,430
1,<environment.Job instance at 0x1543f56b48c0>,58,18,[2 9],91,448,466,357,441
1,<environment.Job instance at 0x1543f6e3e7d0>,64,18,[7 2],100,466,484,366,455
1,<environment.Job instance at 0x1543f70693c0>,68,3,[ 1 10],105,484,487,379,479
1,<environment.Job instance at 0x1543f6e92910>,18,17,[ 1 10],26,500,517,474,500
1,<environment.Job instance at 0x1543fdc78460>,76,17,[9 1],114,517,534,403,506
1,<environment.Job instance at 0x1543ec10d870>,80,17,[7 2],121,534,551,413,523
1,<environment.Job instance at 0x1543cfef9230>,83,18,[8 1],127,551,569,424,542
1,<environment.Job instance at 0x1543cfaf8f00>,95,13,[ 1 10],147,741,754,594,741
1,<environment.Job instance at 0x1543fcb66230>,0,13,[7 2],1,1,14,0,1
1,<environment.Job instance at 0x1543f6e46370>,12,12,[5 2],17,17,29,0,17
1,<environment.Job instance at 0x1543f6e46af0>,17,17,[7 1],25,29,46,4,25
1,<environment.Job instance at 0x1543f6e46d70>,19,15,[7 1],27,46,61,19,33
1,<environment.Job instance at 0x1543f6e55640>,25,17,[6 2],45,61,78,16,49
1,<environment.Job instance at 0x1543f6e40370>,36,17,[6 1],63,78,95,15,68
1,<environment.Job instance at 0x1543f6e407d0>,40,13,[7 2],71,95,108,24,79
1,<environment.Job instance at 0x1543f6e40d70>,45,1,[9 1],81,108,109,27,81
1,<environment.Job instance at 0x1543f6e52140>,48,16,[5 2],85,109,125,24,104
1,<environment.Job instance at 0x1543f6e520a0>,54,18,[8 2],92,125,143,33,114
1,<environment.Job instance at 0x1543f6e27c80>,77,14,[8 2],125,143,157,18,131
1,<environment.Job instance at 0x1543fc475230>,12,2,[1 8],15,15,17,0,15
1,<environment.Job instance at 0x1543fc4753c0>,13,16,[10  1],16,17,33,1,16
1,<environment.Job instance at 0x1543f7ad4640>,28,15,[2 8],35,190,205,155,190
1,<environment.Job instance at 0x1543cfba75a0>,35,15,[7 2],46,193,208,147,193
1,<environment.Job instance at 0x1543cfba7410>,36,13,[ 2 10],48,208,221,160,199
1,<environment.Job instance at 0x1543cfba7c80>,44,14,[2 7],63,221,235,158,210
1,<environment.Job instance at 0x1543cfba7780>,47,18,[6 1],66,221,239,155,219
1,<environment.Job instance at 0x1543cfba70a0>,52,18,[8 1],72,239,257,167,228
1,<environment.Job instance at 0x1543cfe2a820>,54,16,[6 2],75,257,273,182,244
1,<environment.Job instance at 0x1543cfe2ab90>,65,12,[5 2],94,273,285,179,256
1,<environment.Job instance at 0x1543cfee6a50>,70,1,[8 2],104,285,286,181,282
1,<environment.Job instance at 0x1543cfee65f0>,72,3,[ 2 10],109,286,289,177,284
1,<environment.Job instance at 0x1543cfee67d0>,75,3,[1 6],116,289,292,173,285
1,<environment.Job instance at 0x1543cfee64b0>,76,13,[1 5],117,292,305,175,286
1,<environment.Job instance at 0x1543cfee6140>,81,18,[1 8],123,305,323,182,294
1,<environment.Job instance at 0x1543cfee6fa0>,84,12,[8 1],127,294,306,167,294
1,<environment.Job instance at 0x1543ec149320>,87,13,[8 1],134,308,321,174,308
1,<environment.Job instance at 0x1543cfee5410>,89,17,[2 7],138,323,340,185,317
1,<environment.Job instance at 0x1543cfbcb190>,94,13,[1 9],144,340,353,196,324
1,<environment.Job instance at 0x1543ec0a3f00>,3,15,[10  1],6,6,21,0,6
1,<environment.Job instance at 0x1543ec0a30a0>,4,17,[6 1],8,21,38,13,9
1,<environment.Job instance at 0x1543fcaf7780>,6,15,[5 2],10,38,53,28,24
1,<environment.Job instance at 0x1543cfef9370>,16,2,[1 8],23,25,27,2,25
1,<environment.Job instance at 0x1543cfef9aa0>,17,2,[ 1 10],26,53,55,27,26
1,<environment.Job instance at 0x1543cfef9a50>,18,15,[2 9],27,55,70,28,41
1,<environment.Job instance at 0x1543ec384e10>,24,14,[2 8],34,70,84,36,55
1,<environment.Job instance at 0x1543ec3840f0>,27,14,[9 1],39,84,98,45,69
1,<environment.Job instance at 0x1543ec3842d0>,32,15,[7 2],46,98,113,52,84
1,<environment.Job instance at 0x1543cf9e5870>,38,17,[8 1],53,113,130,60,101
1,<environment.Job instance at 0x1543cf9e5c80>,41,16,[8 1],60,130,146,70,117
1,<environment.Job instance at 0x1543ec153820>,52,17,[6 2],76,146,163,70,144
1,<environment.Job instance at 0x1543fc1c7d70>,71,1,[10  1],107,163,164,56,149
1,<environment.Job instance at 0x1543f4128280>,74,12,[8 1],110,164,176,54,151
1,<environment.Job instance at 0x1543f7045cd0>,75,12,[7 1],111,176,188,65,165
1,<environment.Job instance at 0x1543cff0bdc0>,88,3,[1 8],130,194,197,64,194
1,<environment.Job instance at 0x1543cff0b3c0>,91,14,[2 9],138,197,211,59,194
1,<environment.Job instance at 0x1543f7dc4cd0>,99,18,[2 7],149,211,229,62,206
1,<environment.Job instance at 0x1543fcaf7140>,7,13,[6 2],11,314,327,303,314
1,<environment.Job instance at 0x1543cfb13190>,0,13,[ 1 10],1,1,14,0,1
1,<environment.Job instance at 0x1543ec0d3870>,3,13,[1 5],5,14,27,9,5
1,<environment.Job instance at 0x1543ec0d3f50>,4,3,[ 1 10],6,27,30,21,6
1,<environment.Job instance at 0x1543ec0c2230>,38,16,[8 1],55,115,131,60,115
1,<environment.Job instance at 0x1543ec0c2370>,43,18,[5 2],60,131,149,71,121
1,<environment.Job instance at 0x1543f6fb9e60>,46,13,[9 2],68,149,162,81,133
1,<environment.Job instance at 0x1543f6fb91e0>,48,18,[2 6],71,162,180,91,161
1,<environment.Job instance at 0x1543f7a3ef50>,21,12,[2 7],33,2695,2707,2662,2695
1,<environment.Job instance at 0x1543cfeff640>,2,18,[8 2],3,3,21,0,3
1,<environment.Job instance at 0x1543f7a5b690>,4,17,[8 1],6,21,38,15,9
1,<environment.Job instance at 0x14f6965ae640>,0,12,[2 5],1,1,13,0,1
1,<environment.Job instance at 0x14f68ea3f0a0>,6,18,[8 1],7,7,25,0,7
1,<environment.Job instance at 0x14f68ea3f320>,7,1,[2 6],8,13,14,5,8
1,<environment.Job instance at 0x14f68ea3f050>,8,13,[6 1],9,25,38,16,10
1,<environment.Job instance at 0x14f68ea48a00>,10,13,[2 8],12,14,27,2,12
1,<environment.Job instance at 0x14f68ea23640>,17,17,[6 1],23,38,55,15,26
1,<environment.Job instance at 0x14f68cd01c30>,29,16,[10  2],39,55,71,16,42
1,<environment.Job instance at 0x14f68f428e10>,0,13,[5 2],1,1,14,0,1
1,<environment.Job instance at 0x14f6881088c0>,5,12,[7 1],11,14,26,3,11
1,<environment.Job instance at 0x14f688108e60>,6,20,[8 2],12,26,46,14,18
1,<environment.Job instance at 0x14f688108c80>,13,16,[7 2],24,46,62,22,33
1,<environment.Job instance at 0x14f6880de690>,21,15,[8 2],36,62,77,26,48
1,<environment.Job instance at 0x14f688108d20>,18,12,[2 9],33,401,413,368,401
1,<environment.Job instance at 0x14f6881ca730>,0,2,[1 7],1,2,4,1,2
1,<environment.Job instance at 0x14f6881ca7d0>,1,1,[1 5],2,4,5,2,2
1,<environment.Job instance at 0x14f6881b99b0>,2,18,[8 2],3,3,21,0,3
1,<environment.Job instance at 0x14f68f709f00>,6,17,[2 9],7,21,38,14,9
1,<environment.Job instance at 0x14f68f709230>,9,3,[6 1],10,21,24,11,10
1,<environment.Job instance at 0x14f647a2ce10>,14,1,[6 2],18,38,39,20,18
1,<environment.Job instance at 0x14f647a2c230>,15,2,[2 8],19,19,21,0,19
1,<environment.Job instance at 0x14f647a2c820>,16,1,[6 2],21,39,40,18,21
1,<environment.Job instance at 0x14f647a2caf0>,19,2,[10  1],24,40,42,16,24
1,<environment.Job instance at 0x14f647a2c5a0>,20,2,[2 7],26,38,40,12,26
1,<environment.Job instance at 0x14f6881f8cd0>,21,1,[5 2],27,42,43,15,27
1,<environment.Job instance at 0x14f688250960>,22,1,[2 5],28,42,43,14,28
1,<environment.Job instance at 0x14f688250190>,23,2,[ 1 10],30,43,45,13,30
1,<environment.Job instance at 0x14f688250320>,24,3,[2 5],31,45,48,14,31
1,<environment.Job instance at 0x14f688250410>,25,12,[6 1],32,45,57,13,32
1,<environment.Job instance at 0x14f688250af0>,26,2,[5 2],33,57,59,24,33
1,<environment.Job instance at 0x14f6882503c0>,33,3,[1 7],43,48,51,5,43
1,<environment.Job instance at 0x14f6881f75a0>,37,1,[6 2],49,59,60,10,49
1,<environment.Job instance at 0x14f6881f7190>,39,1,[1 7],51,51,52,0,51
1,<environment.Job instance at 0x14f6881f79b0>,40,3,[2 7],52,52,55,0,52
1,<environment.Job instance at 0x14f6881f77d0>,41,2,[1 5],53,55,57,2,53
1,<environment.Job instance at 0x14f6881f9550>,43,1,[2 5],56,57,58,1,56
1,<environment.Job instance at 0x14f6881f9aa0>,44,15,[7 1],57,60,75,3,57
1,<environment.Job instance at 0x14f6881f9410>,55,12,[9 2],70,89,101,19,89
1,<environment.Job instance at 0x14f6881b8c30>,59,16,[10  2],74,101,117,27,89
1,<environment.Job instance at 0x14f6880fca50>,64,13,[5 1],81,128,141,47,128
1,<environment.Job instance at 0x14f6880fc500>,66,14,[6 1],83,141,155,58,131
1,<environment.Job instance at 0x14f6880fceb0>,68,14,[2 8],85,134,148,49,134
1,<environment.Job instance at 0x14f6880fc5a0>,71,13,[10  1],88,155,168,67,142
1,<environment.Job instance at 0x14f693b2b280>,78,16,[10  1],99,168,184,69,155
1,<environment.Job instance at 0x14f64757f050>,91,12,[1 5],121,227,239,106,227
1,<environment.Job instance at 0x14f6475611e0>,95,18,[1 5],127,227,245,100,227
1,<environment.Job instance at 0x14f64759db40>,98,3,[2 9],134,245,248,111,227
1,<environment.Job instance at 0x14f647567c30>,99,1,[10  2],135,248,249,113,227
1,<environment.Job instance at 0x14f647572e10>,102,2,[ 1 10],140,249,251,109,227
1,<environment.Job instance at 0x14f6476ab1e0>,105,2,[1 6],147,251,253,104,236
1,<environment.Job instance at 0x14f68e9a8b90>,107,16,[2 7],151,253,269,102,240
1,<environment.Job instance at 0x14f6881f94b0>,50,14,[1 6],65,277,291,212,277
1,<environment.Job instance at 0x14f6475616e0>,2,14,[2 8],3,3,17,0,3
1,<environment.Job instance at 0x14f64764e6e0>,5,21,[1 8],6,17,38,11,9
1,<environment.Job instance at 0x14f64764efa0>,8,2,[ 1 10],10,38,40,28,11
1,<environment.Job instance at 0x14f64764eaa0>,9,3,[9 2],12,17,20,5,12
1,<environment.Job instance at 0x14f64764e460>,10,2,[5 1],13,13,15,0,13
1,<environment.Job instance at 0x14f64764e7d0>,13,2,[2 9],17,40,42,23,17
1,<environment.Job instance at 0x14f647853eb0>,20,15,[2 7],30,42,57,12,35
1,<environment.Job instance at 0x14f647853cd0>,23,3,[6 2],37,42,45,5,37
1,<environment.Job instance at 0x14f68cabed70>,28,12,[7 1],46,46,58,0,46
1,<environment.Job instance at 0x14f647a3fc30>,9,13,[6 1],14,14,27,0,14
1,<environment.Job instance at 0x14f647a0caa0>,12,3,[5 1],17,27,30,10,17
1,<environment.Job instance at 0x14f647a0c8c0>,14,13,[2 6],19,19,32,0,19
1,<environment.Job instance at 0x14f647b34e10>,0,17,[1 6],1,1,18,0,1
1,<environment.Job instance at 0x14f6881ea1e0>,2,13,[2 9],6,18,31,12,6
1,<environment.Job instance at 0x14f688061c30>,8,15,[10  1],13,31,46,18,17
1,<environment.Job instance at 0x14f6880614b0>,14,2,[2 6],19,46,48,27,19
1,<environment.Job instance at 0x14f688061280>,17,12,[6 2],23,46,58,23,31
1,<environment.Job instance at 0x14f694553500>,21,14,[7 1],28,58,72,30,47
1,<environment.Job instance at 0x14f694553fa0>,23,14,[9 2],30,72,86,42,58
1,<environment.Job instance at 0x14f694422910>,28,16,[7 1],35,86,102,51,73
1,<environment.Job instance at 0x14f68e8fc6e0>,33,16,[2 9],42,86,102,44,73
1,<environment.Job instance at 0x14f647aa1460>,34,23,[2 6],44,114,137,70,114
1,<environment.Job instance at 0x14f694543e60>,0,12,[2 8],1,1,13,0,1
1,<environment.Job instance at 0x14f694453960>,1,27,[5 2],2,3,30,1,3
1,<environment.Job instance at 0x14f69441bfa0>,8,18,[9 1],13,30,48,17,19
1,<environment.Job instance at 0x14f68f6ca870>,20,21,[9 1],31,48,69,17,40
1,<environment.Job instance at 0x14f68821e0f0>,21,16,[1 6],32,40,56,8,40
1,<environment.Job instance at 0x14f688230690>,22,15,[10  2],33,69,84,36,55
1,<environment.Job instance at 0x14f68815ed70>,32,12,[9 1],47,84,96,37,67
1,<environment.Job instance at 0x14f6944ff190>,34,16,[9 2],50,96,112,46,83
1,<environment.Job instance at 0x14f6944ffb90>,36,15,[6 1],53,112,127,59,108
1,<environment.Job instance at 0x14f6477e8370>,49,18,[2 9],70,112,130,42,109
1,<environment.Job instance at 0x14f68e99f0a0>,53,17,[5 1],74,127,144,53,115
1,<environment.Job instance at 0x14f68e984460>,61,21,[9 2],82,144,165,62,136
1,<environment.Job instance at 0x14f68e967320>,62,17,[7 2],83,165,182,82,153
1,<environment.Job instance at 0x14f68e972640>,69,16,[5 2],93,182,198,89,175
1,<environment.Job instance at 0x14f68e8e6230>,0,16,[2 5],1,2,18,1,2
1,<environment.Job instance at 0x14f68e8e69b0>,2,12,[ 1 10],3,18,30,15,3
1,<environment.Job instance at 0x14f6474c19b0>,6,15,[8 1],9,30,45,21,16
1,<environment.Job instance at 0x14f6474c1e10>,11,13,[7 2],20,45,58,25,32
1,<environment.Job instance at 0x14f6474c5230>,28,18,[1 7],46,53,71,7,53
1,<environment.Job instance at 0x14f6474d4960>,1,18,[8 1],8,8,26,0,8
1,<environment.Job instance at 0x14f68e9eb8c0>,6,12,[2 9],17,17,29,0,17
1,<environment.Job instance at 0x14f68e9eb870>,10,17,[6 2],22,29,46,7,22
1,<environment.Job instance at 0x14f64791ad20>,20,13,[2 8],33,33,46,0,33
1,<environment.Job instance at 0x14f694454b40>,22,3,[1 6],37,46,49,9,37
1,<environment.Job instance at 0x14f694454f00>,25,14,[ 2 10],40,49,63,9,40
1,<environment.Job instance at 0x14f647887c30>,0,16,[5 1],1,1,17,0,1
1,<environment.Job instance at 0x14f647887e10>,3,15,[5 1],6,8,23,2,8
1,<environment.Job instance at 0x14f6477da5a0>,6,18,[8 2],9,23,41,14,13
1,<environment.Job instance at 0x14f69445fd70>,1,17,[6 1],2,2,19,0,2
1,<environment.Job instance at 0x14f693aa8410>,5,17,[2 7],8,8,25,0,8
1,<environment.Job instance at 0x14f693aa8500>,6,12,[5 1],9,19,31,10,9
1,<environment.Job instance at 0x14f693aa85f0>,9,17,[6 1],15,31,48,16,22
1,<environment.Job instance at 0x14f693a89a00>,24,15,[7 2],32,48,63,16,34
1,<environment.Job instance at 0x14f693aba370>,34,17,[7 2],46,167,184,121,167
1,<environment.Job instance at 0x14f693aba500>,35,13,[2 5],47,173,186,126,173
1,<environment.Job instance at 0x14f693a92320>,57,18,[10  1],75,186,204,111,177
1,<environment.Job instance at 0x14f693a92c30>,72,14,[2 8],95,204,218,109,192
1,<environment.Job instance at 0x14f693a92d20>,73,15,[8 2],96,204,219,108,192
1,<environment.Job instance at 0x14f68e876460>,89,12,[7 2],117,219,231,102,212
1,<environment.Job instance at 0x14f6881f50a0>,95,1,[8 1],125,231,232,106,231
1,<environment.Job instance at 0x14f6881f5140>,96,18,[10  1],126,232,250,106,231
1,<environment.Job instance at 0x14f64771bc30>,97,1,[8 2],127,250,251,123,231
1,<environment.Job instance at 0x14f64771bf50>,101,3,[7 1],131,251,254,120,231
1,<environment.Job instance at 0x14f688279a50>,102,3,[8 2],132,254,257,122,231
1,<environment.Job instance at 0x14f647705910>,105,14,[9 2],139,257,271,118,242
1,<environment.Job instance at 0x14f6477140a0>,112,12,[9 1],148,271,283,123,256
1,<environment.Job instance at 0x14f693a89140>,20,1,[7 2],28,305,306,277,305
1,<environment.Job instance at 0x14f68cf76320>,3,16,[1 9],4,5,21,1,5
1,<environment.Job instance at 0x14f68cf76a00>,5,13,[8 1],6,6,19,0,6
1,<environment.Job instance at 0x14f68cf76a50>,6,1,[6 1],7,19,20,12,7
1,<environment.Job instance at 0x14f68cf76820>,8,1,[5 1],9,20,21,11,9
1,<environment.Job instance at 0x14f68cf76fa0>,9,3,[5 2],10,21,24,11,10
1,<environment.Job instance at 0x14f68cf761e0>,10,17,[6 2],14,24,41,10,14
1,<environment.Job instance at 0x14f68cf76c30>,12,15,[10  2],16,41,56,25,27
1,<environment.Job instance at 0x14f68cf76c80>,16,12,[1 8],20,27,39,7,27
1,<environment.Job instance at 0x14f68cf765f0>,19,14,[2 5],26,56,70,30,41
1,<environment.Job instance at 0x14f68e882690>,20,2,[1 8],27,70,72,43,43
1,<environment.Job instance at 0x14f68e8823c0>,21,1,[5 1],28,56,57,28,43
1,<environment.Job instance at 0x14f68e882960>,22,14,[1 7],29,72,86,43,57
1,<environment.Job instance at 0x14f68e882910>,24,2,[6 2],33,57,59,24,57
1,<environment.Job instance at 0x14f68e8824b0>,25,2,[1 5],34,59,61,25,57
1,<environment.Job instance at 0x14f68e882cd0>,32,3,[7 1],44,61,64,17,59
1,<environment.Job instance at 0x14f64731dc80>,7,17,[ 1 10],15,15,32,0,15
1,<environment.Job instance at 0x14f6943fcaa0>,10,13,[7 2],21,32,45,11,21
1,<environment.Job instance at 0x14f6882edd20>,18,18,[10  2],32,45,63,13,34
1,<environment.Job instance at 0x14f68f6c8140>,27,17,[7 1],45,63,80,18,53
1,<environment.Job instance at 0x14f6472e3a50>,33,14,[7 1],59,80,94,21,73
1,<environment.Job instance at 0x14f68cabd4b0>,40,17,[1 9],71,78,95,7,78
1,<environment.Job instance at 0x14f6944e65a0>,46,17,[6 1],83,94,111,11,88
1,<environment.Job instance at 0x14f6881425a0>,50,13,[7 2],91,111,124,20,95
1,<environment.Job instance at 0x14f68f65d9b0>,58,16,[5 2],105,124,140,19,111
1,<environment.Job instance at 0x14f68f65d5a0>,64,18,[8 2],112,140,158,28,129
1,<environment.Job instance at 0x14f6476cbaa0>,73,18,[7 2],129,158,176,29,148
1,<environment.Job instance at 0x14f6882c9e10>,87,14,[8 2],145,176,190,31,161
1,<environment.Job instance at 0x14f647ac8f50>,0,17,[10  2],1,1,18,0,1
1,<environment.Job instance at 0x14f64798d9b0>,15,1,[2 9],19,19,20,0,19
1,<environment.Job instance at 0x14f64798dfa0>,20,16,[10  1],26,26,42,0,26
1,<environment.Job instance at 0x14f6478ab280>,3,15,[10  1],6,6,21,0,6
1,<environment.Job instance at 0x14f6478abb40>,4,17,[6 1],8,21,38,13,15
1,<environment.Job instance at 0x14f6478ab370>,11,12,[5 2],16,38,50,22,30
1,<environment.Job instance at 0x14f68816fbe0>,19,15,[7 2],28,50,65,22,36
1,<environment.Job instance at 0x14f68816f280>,20,13,[9 1],29,65,78,36,49
1,<environment.Job instance at 0x14f68816f4b0>,22,24,[9 2],31,78,102,47,73
1,<environment.Job instance at 0x14f694469960>,32,15,[7 2],46,102,117,56,88
1,<environment.Job instance at 0x14f68e8ec0f0>,52,17,[6 2],76,117,134,41,105
1,<environment.Job instance at 0x14f68e8ecd20>,58,15,[5 2],83,134,149,51,120
1,<environment.Job instance at 0x14f68e8ff230>,72,15,[2 8],108,120,135,12,120
1,<environment.Job instance at 0x14f694488eb0>,83,3,[1 8],124,146,149,22,146
1,<environment.Job instance at 0x14f694488a00>,85,1,[7 2],126,149,150,23,146
1,<environment.Job instance at 0x14f69448f820>,86,3,[1 7],127,149,152,22,146
1,<environment.Job instance at 0x14f68f2e8230>,89,14,[ 1 10],133,152,166,19,147
1,<environment.Job instance at 0x14f68e8ca190>,91,14,[2 9],138,166,180,28,155
1,<environment.Job instance at 0x14f647997500>,99,18,[2 7],149,190,208,41,190
1,<environment.Job instance at 0x14f68816fc30>,15,1,[1 7],22,208,209,186,203
1,<environment.Job instance at 0x14f64798d550>,1,16,[9 2],2,2,18,0,2
1,<environment.Job instance at 0x14f693b65960>,11,23,[5 2],14,18,41,4,17
1,<environment.Job instance at 0x14f68f6dfd20>,21,14,[9 1],26,41,55,15,32
1,<environment.Job instance at 0x14f68f6dfc30>,22,16,[5 1],28,55,71,27,42
1,<environment.Job instance at 0x14f647ae8960>,29,1,[9 2],39,71,72,32,56
1,<environment.Job instance at 0x14f647ae8e60>,30,17,[2 5],43,72,89,29,60
1,<environment.Job instance at 0x14f647ae8820>,35,16,[10  2],50,89,105,39,76
1,<environment.Job instance at 0x14f64741b410>,43,16,[10  1],60,105,121,45,92
1,<environment.Job instance at 0x14f69280df00>,47,15,[8 2],64,121,136,57,109
1,<environment.Job instance at 0x14f69280d640>,48,3,[ 2 10],65,136,139,71,111
1,<environment.Job instance at 0x14f69280de60>,49,14,[1 5],66,121,135,55,111
1,<environment.Job instance at 0x14f6882d53c0>,57,3,[1 7],76,139,142,63,129
1,<environment.Job instance at 0x14f68e727370>,58,2,[9 2],77,139,141,62,129
1,<environment.Job instance at 0x14f68821fa00>,59,2,[7 1],78,141,143,63,129
1,<environment.Job instance at 0x14f68e727b40>,60,1,[1 6],79,135,136,56,129
1,<environment.Job instance at 0x14f68e727e10>,61,27,[2 7],80,142,169,62,140
1,<environment.Job instance at 0x14f647be4f50>,64,3,[5 1],83,143,146,60,140
1,<environment.Job instance at 0x14f647be44b0>,65,15,[7 2],84,146,161,62,140
1,<environment.Job instance at 0x14f647be4dc0>,66,2,[1 6],87,169,171,82,142
1,<environment.Job instance at 0x14f647be4280>,69,2,[2 8],95,171,173,76,160
1,<environment.Job instance at 0x14f68e985e60>,72,3,[2 8],100,173,176,73,160
1,<environment.Job instance at 0x14f647be4910>,73,3,[10  1],101,176,179,75,160
1,<environment.Job instance at 0x14f6479dea00>,74,2,[1 6],102,179,181,77,160
1,<environment.Job instance at 0x14f6479def00>,75,2,[5 2],103,161,163,58,160
1,<environment.Job instance at 0x14f6474fba00>,76,1,[5 1],104,163,164,59,160
1,<environment.Job instance at 0x14f694453e60>,77,3,[8 1],105,164,167,59,160
1,<environment.Job instance at 0x14f68f283d20>,95,3,[6 2],127,186,189,59,186
1,<environment.Job instance at 0x14f68e9d9280>,97,3,[1 7],130,186,189,56,186
1,<environment.Job instance at 0x14f68e9d9d20>,98,2,[2 7],132,189,191,57,186
1,<environment.Job instance at 0x14f68e9d9b90>,100,2,[5 1],134,189,191,55,187
1,<environment.Job instance at 0x14f6477cc4b0>,102,1,[ 1 10],138,191,192,53,188
1,<environment.Job instance at 0x14f6477ccbe0>,103,3,[10  2],139,192,195,53,188
1,<environment.Job instance at 0x14f6477cc500>,104,1,[1 7],140,195,196,55,188
1,<environment.Job instance at 0x14f68f30c230>,107,22,[2 8],144,198,220,54,198
1,<environment.Job instance at 0x14f647605460>,118,16,[5 1],159,241,257,82,241
1,<environment.Job instance at 0x14f68e8310a0>,0,13,[2 5],2,2,15,0,2
1,<environment.Job instance at 0x14f68cfdb4b0>,5,13,[2 5],12,12,25,0,12
1,<environment.Job instance at 0x14f68cfdb690>,7,13,[7 2],14,15,28,1,14
1,<environment.Job instance at 0x14f68cfdb5a0>,8,14,[7 1],15,28,42,13,16
1,<environment.Job instance at 0x14f68cfdbe60>,15,14,[2 5],22,25,39,3,22
1,<environment.Job instance at 0x14f68cfc6690>,20,15,[9 2],30,42,57,12,33
1,<environment.Job instance at 0x14f68cfc69b0>,23,16,[8 1],35,57,73,22,50
1,<environment.Job instance at 0x14f68cff05a0>,33,18,[2 6],51,57,75,6,51
1,<environment.Job instance at 0x14f68cff07d0>,34,15,[5 2],52,73,88,21,65
1,<environment.Job instance at 0x14f68cff0aa0>,40,12,[5 2],58,75,87,17,65
1,<environment.Job instance at 0x14f68cff0550>,41,3,[9 2],60,88,91,28,65
1,<environment.Job instance at 0x14f68cff0dc0>,43,1,[10  1],65,91,92,26,66
1,<environment.Job instance at 0x14f68cfb8230>,44,14,[6 1],66,92,106,26,77
1,<environment.Job instance at 0x14f68cfb8320>,45,12,[2 8],67,92,104,25,77
1,<environment.Job instance at 0x14f68cfb8370>,46,2,[2 6],69,104,106,35,77
1,<environment.Job instance at 0x14f68f666230>,51,2,[2 6],78,106,108,28,82
1,<environment.Job instance at 0x14f68cfe1050>,53,3,[6 2],82,106,109,24,83
1,<environment.Job instance at 0x14f68809e140>,56,1,[2 6],87,108,109,21,103
1,<environment.Job instance at 0x14f647639be0>,57,2,[9 1],88,109,111,21,103
1,<environment.Job instance at 0x14f68809e820>,58,16,[ 1 10],90,111,127,21,103
1,<environment.Job instance at 0x14f68809e5f0>,59,18,[10  1],91,127,145,36,116
1,<environment.Job instance at 0x14f68cfdc640>,0,3,[1 9],1,1,4,0,1
1,<environment.Job instance at 0x14f647a675a0>,5,1,[1 6],8,8,9,0,8
1,<environment.Job instance at 0x14f647a670f0>,6,1,[2 7],9,9,10,0,9
1,<environment.Job instance at 0x14f647a67690>,7,2,[ 1 10],10,10,12,0,10
1,<environment.Job instance at 0x14f647a67500>,8,1,[7 1],11,12,13,1,11
1,<environment.Job instance at 0x14f647a67140>,9,2,[9 1],12,13,15,1,12
1,<environment.Job instance at 0x14f647a67fa0>,10,1,[5 1],14,15,16,1,14
1,<environment.Job instance at 0x14f647a675f0>,11,1,[2 7],15,15,16,0,15
1,<environment.Job instance at 0x14f68e764b90>,12,15,[5 1],16,16,31,0,16
1,<environment.Job instance at 0x14f68e764aa0>,15,13,[ 2 10],19,31,44,12,19
1,<environment.Job instance at 0x14f647a7da50>,28,13,[5 2],39,44,57,5,39
1,<environment.Job instance at 0x14f647a7d0f0>,29,13,[9 2],40,57,70,17,49
1,<environment.Job instance at 0x14f647a7d6e0>,33,17,[1 8],45,64,81,19,64
1,<environment.Job instance at 0x14f68d0125f0>,42,21,[10  1],55,81,102,26,73
1,<environment.Job instance at 0x14f68d012870>,50,15,[10  1],65,102,117,37,88
1,<environment.Job instance at 0x14f647705f00>,51,17,[1 9],68,117,134,49,106
1,<environment.Job instance at 0x14f647705230>,55,18,[7 1],75,127,145,52,127
1,<environment.Job instance at 0x14f647705140>,64,13,[6 1],84,224,237,140,224
1,<environment.Job instance at 0x14f68f36f910>,72,12,[ 1 10],96,237,249,141,237
1,<environment.Job instance at 0x14f68f36fdc0>,77,21,[5 2],104,318,339,214,318
1,<environment.Job instance at 0x14f68cf8d4b0>,95,1,[1 7],129,339,340,210,339
1,<environment.Job instance at 0x14f68f679aa0>,97,3,[10  1],132,341,344,209,341
1,<environment.Job instance at 0x14f68f679870>,101,27,[6 1],139,345,372,206,345
1,<environment.Job instance at 0x14f68831ec30>,7,3,[8 2],10,10,13,0,10
1,<environment.Job instance at 0x14f68831efa0>,8,2,[8 1],13,13,15,0,13
1,<environment.Job instance at 0x14f68831ee10>,10,3,[1 9],16,16,19,0,16
1,<environment.Job instance at 0x14f68832b7d0>,14,3,[1 6],23,23,26,0,23
1,<environment.Job instance at 0x14f68832b8c0>,15,13,[2 9],25,26,39,1,25
1,<environment.Job instance at 0x14f68832ba00>,16,12,[10  1],26,39,51,13,27
1,<environment.Job instance at 0x14f688315370>,24,23,[1 9],34,51,74,17,46
1,<environment.Job instance at 0x14f688315f50>,34,3,[2 8],48,74,77,26,48
1,<environment.Job instance at 0x14f688315e60>,35,1,[5 1],49,51,52,2,49
1,<environment.Job instance at 0x14f688325af0>,43,2,[5 1],60,60,62,0,60
1,<environment.Job instance at 0x14f688325f50>,46,15,[1 8],64,77,92,13,64
1,<environment.Job instance at 0x14f6882f36e0>,51,18,[2 7],75,92,110,17,84
1,<environment.Job instance at 0x14f6882f3d70>,57,13,[9 2],85,110,123,25,94
1,<environment.Job instance at 0x14f6882f3fa0>,61,17,[8 1],92,123,140,31,111
1,<environment.Job instance at 0x14f6882f4050>,63,18,[2 7],95,123,141,28,117
1,<environment.Job instance at 0x14f6882f47d0>,70,12,[7 2],104,225,237,121,225
1,<environment.Job instance at 0x14f6882f4f00>,80,15,[10  2],116,237,252,121,225
1,<environment.Job instance at 0x14f6883308c0>,97,17,[1 8],141,252,269,111,251
1,<environment.Job instance at 0x14f68e8035f0>,101,3,[8 2],147,281,284,134,281
1,<environment.Job instance at 0x14f68e803d70>,102,3,[2 5],148,281,284,133,281
1,<environment.Job instance at 0x14f68e803d20>,103,3,[9 1],150,284,287,134,281
1,<environment.Job instance at 0x14f68e803690>,104,2,[8 2],151,287,289,136,281
1,<environment.Job instance at 0x14f68e803af0>,105,1,[8 1],152,289,290,137,281
1,<environment.Job instance at 0x14f68e803870>,106,23,[7 1],153,290,313,137,284
1,<environment.Job instance at 0x14f68e8037d0>,107,22,[5 2],154,330,352,176,330
1,<environment.Job instance at 0x14ec877d8c30>,0,12,[2 5],1,1,13,0,1
1,<environment.Job instance at 0x14ec7fc48550>,6,18,[8 1],7,7,25,0,7
1,<environment.Job instance at 0x14ec7fc482d0>,8,13,[6 1],9,25,38,16,16
1,<environment.Job instance at 0x14ec86e03370>,17,17,[6 1],23,38,55,15,31
1,<environment.Job instance at 0x14ec7fbbb730>,29,16,[10  2],39,55,71,16,42
1,<environment.Job instance at 0x14ec84c80e10>,1,2,[9 2],2,2,4,0,2
1,<environment.Job instance at 0x14ec84c80280>,2,3,[5 2],3,4,7,1,3
1,<environment.Job instance at 0x14ec6cadacd0>,3,16,[7 2],4,7,23,3,4
1,<environment.Job instance at 0x14ec86c6f910>,5,18,[5 2],7,23,41,16,12
1,<environment.Job instance at 0x14ec86c6fe60>,11,15,[8 2],16,41,56,25,36
1,<environment.Job instance at 0x14ec6cfaf2d0>,8,15,[1 8],12,12,27,0,12
1,<environment.Job instance at 0x14ec84c987d0>,12,17,[9 2],18,18,35,0,18
1,<environment.Job instance at 0x14ec8765ca00>,20,15,[7 1],27,35,50,8,28
1,<environment.Job instance at 0x14ec856012d0>,31,12,[9 2],40,50,62,10,40
1,<environment.Job instance at 0x14ec85601be0>,35,16,[10  2],44,62,78,18,49
1,<environment.Job instance at 0x14ec86c57190>,47,13,[10  1],58,78,91,20,73
1,<environment.Job instance at 0x14ec876ddc80>,54,16,[10  1],69,91,107,22,84
1,<environment.Job instance at 0x14ec876701e0>,57,12,[7 1],74,107,119,33,90
1,<environment.Job instance at 0x14ec7c0989b0>,62,18,[2 6],84,107,125,23,98
1,<environment.Job instance at 0x14ec6c77cd20>,77,26,[2 8],108,125,151,17,122
1,<environment.Job instance at 0x14ec6c87caf0>,85,3,[10  2],124,152,155,28,152
1,<environment.Job instance at 0x14ec6c8d0f50>,94,21,[1 8],136,168,189,32,168
1,<environment.Job instance at 0x14ec6c8d0050>,95,17,[2 8],137,189,206,52,177
1,<environment.Job instance at 0x14ec6c8d86e0>,106,2,[1 8],157,233,235,76,233
1,<environment.Job instance at 0x14ec6c8749b0>,109,15,[2 7],160,235,250,75,233
1,<environment.Job instance at 0x14ec6c9ba5a0>,112,3,[6 2],167,241,244,74,241
1,<environment.Job instance at 0x14ec6c83da50>,79,16,[ 2 10],112,310,326,198,310
1,<environment.Job instance at 0x14ec6c8b58c0>,3,12,[7 1],6,10,22,4,10
1,<environment.Job instance at 0x14ec6c8b51e0>,11,13,[8 2],17,22,35,5,17
1,<environment.Job instance at 0x14ec7fb2e690>,12,18,[5 1],18,35,53,17,24
1,<environment.Job instance at 0x14ec7fb2eb40>,16,17,[9 2],23,53,70,30,42
1,<environment.Job instance at 0x14ec85650d70>,34,16,[8 1],50,70,86,20,58
1,<environment.Job instance at 0x14ec6ca755f0>,35,16,[1 6],51,58,74,7,58
1,<environment.Job instance at 0x14ec6ca75730>,36,2,[10  2],53,86,88,33,59
1,<environment.Job instance at 0x14ec85645d70>,37,3,[1 7],54,74,77,20,59
1,<environment.Job instance at 0x14ec85650370>,38,14,[9 2],56,88,102,32,73
1,<environment.Job instance at 0x14ec876e0190>,47,12,[1 7],67,90,102,23,90
1,<environment.Job instance at 0x14ec7fafcd20>,50,17,[2 9],71,102,119,31,90
1,<environment.Job instance at 0x14ec6c7de8c0>,53,17,[5 2],74,119,136,45,107
1,<environment.Job instance at 0x14ec6c894dc0>,64,14,[8 2],87,136,150,49,131
1,<environment.Job instance at 0x14ec6c87a6e0>,73,17,[10  1],100,150,167,50,138
1,<environment.Job instance at 0x14ec6ceab7d0>,78,15,[5 2],106,167,182,61,159
1,<environment.Job instance at 0x14ec6c77cb40>,85,14,[2 6],115,185,199,70,185
1,<environment.Job instance at 0x14ec6c85d280>,87,17,[2 5],117,199,216,82,188
1,<environment.Job instance at 0x14ec6c8a1d70>,89,15,[9 2],120,216,231,96,212
1,<environment.Job instance at 0x14ec7c056c30>,104,13,[2 6],139,231,244,92,230
1,<environment.Job instance at 0x14ec6cd936e0>,108,17,[2 7],145,244,261,99,232
1,<environment.Job instance at 0x14ec6cc7baa0>,120,13,[10  1],159,261,274,102,256
1,<environment.Job instance at 0x14ec7fa36c30>,2,13,[7 2],4,4,17,0,4
1,<environment.Job instance at 0x14ec84d4baf0>,6,3,[2 5],9,10,13,1,10
1,<environment.Job instance at 0x14ec84d4bb90>,9,2,[2 9],12,17,19,5,12
1,<environment.Job instance at 0x14ec6caa9820>,10,2,[2 7],13,13,15,0,13
1,<environment.Job instance at 0x14ec6caa97d0>,11,18,[6 1],15,17,35,2,15
1,<environment.Job instance at 0x14ec6caa9230>,13,2,[10  1],17,35,37,18,17
1,<environment.Job instance at 0x14ec6caa9fa0>,14,22,[2 6],19,37,59,18,32
1,<environment.Job instance at 0x14ec6cc7d640>,20,1,[8 1],27,41,42,14,41
1,<environment.Job instance at 0x14ec6cc7daf0>,21,1,[5 1],29,42,43,13,41
1,<environment.Job instance at 0x14ec6cc7d4b0>,22,2,[7 2],30,43,45,13,41
1,<environment.Job instance at 0x14ec6cc7df50>,18,2,[9 1],24,269,271,245,269
1,<environment.Job instance at 0x14ec6cc7deb0>,33,14,[5 2],49,273,287,224,273
1,<environment.Job instance at 0x14ec804a9410>,2,13,[2 5],8,8,21,0,8
1,<environment.Job instance at 0x14ec7fb0ac30>,0,3,[2 9],1,1,4,0,1
1,<environment.Job instance at 0x14ec7fae3460>,2,1,[10  1],3,4,5,1,3
1,<environment.Job instance at 0x14ec7fae3f00>,3,17,[5 1],4,5,22,1,4
1,<environment.Job instance at 0x14ec6c86a0a0>,12,17,[7 2],13,22,39,9,13
1,<environment.Job instance at 0x14ec7faee050>,13,16,[5 2],14,39,55,25,26
1,<environment.Job instance at 0x14ec8060c3c0>,19,16,[5 2],23,39,55,16,26
1,<environment.Job instance at 0x14ec6c88bc80>,29,16,[2 7],37,775,791,738,775
1,<environment.Job instance at 0x14ec8090bf00>,58,14,[1 8],73,791,805,718,785
1,<environment.Job instance at 0x14ec6cfda1e0>,70,3,[9 1],90,795,798,705,795
1,<environment.Job instance at 0x14ec6cfda460>,71,16,[2 5],91,805,821,714,796
1,<environment.Job instance at 0x14ec7c165410>,74,2,[1 7],94,821,823,727,796
1,<environment.Job instance at 0x14ec7c152190>,75,1,[6 2],97,798,799,701,796
1,<environment.Job instance at 0x14ec7c165fa0>,76,3,[5 2],98,799,802,701,796
1,<environment.Job instance at 0x14ec7f96ba50>,77,15,[8 1],99,802,817,703,796
1,<environment.Job instance at 0x14ec7f96b190>,78,3,[2 7],100,823,826,723,801
1,<environment.Job instance at 0x14ec7f96b230>,79,2,[8 2],102,817,819,715,801
1,<environment.Job instance at 0x14ec7f96b140>,80,14,[2 9],107,826,840,719,821
1,<environment.Job instance at 0x14ec7f96bdc0>,90,3,[1 9],121,840,843,719,821
1,<environment.Job instance at 0x14ec7f96b780>,91,17,[1 5],122,843,860,721,831
1,<environment.Job instance at 0x14ec85778780>,93,1,[1 8],125,860,861,735,832
1,<environment.Job instance at 0x14ec85778460>,95,2,[2 6],130,861,863,731,834
1,<environment.Job instance at 0x14ec808e7410>,104,15,[ 2 10],144,863,878,719,857
1,<environment.Job instance at 0x14ec808e7730>,113,18,[5 2],157,878,896,721,870
1,<environment.Job instance at 0x14ec7e481730>,2,25,[9 1],3,3,28,0,3
1,<environment.Job instance at 0x14ec7c142a50>,6,13,[10  1],8,28,41,20,12
1,<environment.Job instance at 0x14ec6c6eedc0>,26,2,[1 7],34,41,43,7,34
1,<environment.Job instance at 0x14ec6c6f02d0>,27,3,[2 9],35,43,46,8,35
1,<environment.Job instance at 0x14ec6c6f0460>,28,2,[6 1],36,41,43,5,36
1,<environment.Job instance at 0x14ec6c6f05a0>,29,1,[5 1],37,43,44,6,37
1,<environment.Job instance at 0x14ec6c6f06e0>,30,16,[2 6],38,46,62,8,38
1,<environment.Job instance at 0x14ec6c6f0910>,32,14,[5 2],44,49,63,5,49
1,<environment.Job instance at 0x14ec6c6f0fa0>,37,21,[10  2],52,63,84,11,55
1,<environment.Job instance at 0x14ec6c6f2820>,45,3,[2 9],66,88,91,22,88
1,<environment.Job instance at 0x14ec6c6f28c0>,46,13,[2 9],67,91,104,24,88
1,<environment.Job instance at 0x14ec6c6f4fa0>,63,12,[2 9],97,104,116,7,97
1,<environment.Job instance at 0x14ec6c6f6320>,65,3,[9 1],99,116,119,17,101
1,<environment.Job instance at 0x14ec6c6f6550>,67,17,[6 2],102,119,136,17,107
1,<environment.Job instance at 0x14ec6c6f7320>,77,13,[2 8],113,119,132,6,113
1,<environment.Job instance at 0x14ec6c700730>,0,13,[1 9],1,1,14,0,1
1,<environment.Job instance at 0x14ec6c6f76e0>,2,15,[9 1],4,4,19,0,4
1,<environment.Job instance at 0x14ec805e49b0>,7,19,[5 2],11,19,38,8,13
1,<environment.Job instance at 0x14ec7e16a1e0>,13,15,[8 2],17,38,53,21,24
1,<environment.Job instance at 0x14ec6c91fd20>,7,2,[5 1],10,11,13,1,11
1,<environment.Job instance at 0x14ec6c882a00>,12,3,[9 1],18,18,21,0,18
1,<environment.Job instance at 0x14ec6c882640>,15,2,[ 1 10],22,22,24,0,22
1,<environment.Job instance at 0x14ec7c042320>,18,1,[7 2],26,26,27,0,26
1,<environment.Job instance at 0x14ec856558c0>,0,3,[5 1],1,1,4,0,1
1,<environment.Job instance at 0x14ec6ce416e0>,4,12,[7 2],7,7,19,0,7
1,<environment.Job instance at 0x14ec6cb22d70>,6,17,[6 2],11,19,36,8,12
1,<environment.Job instance at 0x14ec6caeb230>,10,1,[8 1],15,36,37,21,15
1,<environment.Job instance at 0x14ec6caeb3c0>,11,18,[10  1],16,37,55,21,26
1,<environment.Job instance at 0x14ec6caebc80>,20,14,[9 2],29,55,69,26,48
1,<environment.Job instance at 0x14ec6caff230>,37,18,[2 5],50,69,87,19,64
1,<environment.Job instance at 0x14ec6caeb410>,13,2,[7 1],18,228,230,210,228
1,<environment.Job instance at 0x14ec6caecdc0>,0,18,[2 9],1,3,21,2,3
1,<environment.Job instance at 0x14ec6cb24370>,2,3,[1 9],4,21,24,17,4
1,<environment.Job instance at 0x14ec6cb24410>,3,3,[2 7],6,24,27,18,6
1,<environment.Job instance at 0x14ec6caec0f0>,4,3,[2 9],7,27,30,20,7
1,<environment.Job instance at 0x14ec6caec0a0>,6,18,[7 2],10,30,48,20,22
1,<environment.Job instance at 0x14ec85703870>,13,13,[6 1],18,48,61,30,32
1,<environment.Job instance at 0x14ec804a9820>,18,17,[9 1],24,61,78,37,51
1,<environment.Job instance at 0x14ec6ccd2140>,22,17,[7 2],31,78,95,47,66
1,<environment.Job instance at 0x14ec6ccd2af0>,25,18,[8 1],37,95,113,58,88
1,<environment.Job instance at 0x14ec7fbe8780>,37,13,[ 1 10],57,113,126,56,98
1,<environment.Job instance at 0x14ec7fbe8d70>,39,13,[7 2],61,126,139,65,110
1,<environment.Job instance at 0x14ec84ccaaf0>,45,14,[6 2],70,139,153,69,128
1,<environment.Job instance at 0x14ec84cca6e0>,47,18,[10  2],72,153,171,81,142
1,<environment.Job instance at 0x14ec84ccaa00>,51,12,[5 2],77,171,183,94,170
1,<environment.Job instance at 0x14ec84ccab90>,56,17,[7 1],85,183,200,98,171
1,<environment.Job instance at 0x14ec84cd2af0>,62,14,[7 1],99,200,214,101,197
1,<environment.Job instance at 0x14ec84cd2aa0>,64,17,[6 2],105,214,231,109,202
1,<environment.Job instance at 0x14ec84cd27d0>,67,14,[10  2],109,231,245,122,224
1,<environment.Job instance at 0x14ec6caee050>,75,17,[6 1],123,245,262,122,233
1,<environment.Job instance at 0x14ec6ccc7780>,79,13,[7 2],131,263,276,132,263
1,<environment.Job instance at 0x14ec84cd8f50>,87,16,[5 2],145,276,292,131,270
1,<environment.Job instance at 0x14ec84cd8230>,93,18,[8 2],152,292,310,140,281
1,<environment.Job instance at 0x14ec84cd8e10>,102,18,[7 2],169,310,328,141,300
1,<environment.Job instance at 0x14ec81bb30f0>,6,2,[10  1],7,7,9,0,7
1,<environment.Job instance at 0x14ec80504b40>,5,1,[2 8],6,9,10,3,8
1,<environment.Job instance at 0x14ec81bbdcd0>,12,14,[8 2],15,15,29,0,15
1,<environment.Job instance at 0x14ec84fc75a0>,23,12,[1 7],32,36,48,4,36
1,<environment.Job instance at 0x14ec6caff5f0>,27,2,[7 1],39,39,41,0,39
1,<environment.Job instance at 0x14ec6caff910>,28,3,[1 6],40,48,51,8,40
1,<environment.Job instance at 0x14ec6caff190>,29,1,[6 1],41,41,42,0,41
1,<environment.Job instance at 0x14ec6cb03370>,30,1,[1 5],42,51,52,9,42
1,<environment.Job instance at 0x14ec6cb03be0>,31,2,[1 7],43,52,54,9,43
1,<environment.Job instance at 0x14ec6cb03730>,32,3,[1 7],44,54,57,10,44
1,<environment.Job instance at 0x14ec6cb03050>,33,1,[1 8],45,57,58,12,45
1,<environment.Job instance at 0x14ec7fb0e5a0>,34,2,[2 5],46,58,60,12,46
1,<environment.Job instance at 0x14ec7fb0e230>,35,3,[1 9],47,60,63,13,47
1,<environment.Job instance at 0x14ec6cd964b0>,37,1,[2 9],49,63,64,14,49
1,<environment.Job instance at 0x14ec6cd96280>,38,3,[1 9],52,64,67,12,52
1,<environment.Job instance at 0x14ec6c8333c0>,0,16,[ 2 10],3,3,19,0,3
1,<environment.Job instance at 0x14ec6c4c3d70>,1,13,[8 1],4,19,32,15,11
1,<environment.Job instance at 0x14ec6cb85a50>,20,15,[5 2],30,32,47,2,30
1,<environment.Job instance at 0x14ec6cb85b90>,21,13,[6 2],31,47,60,16,31
1,<environment.Job instance at 0x14ec6cb85f50>,24,3,[2 5],35,35,38,0,35
1,<environment.Job instance at 0x14ec6cb85fa0>,25,12,[5 2],36,60,72,24,43
1,<environment.Job instance at 0x14ec6cba2320>,28,16,[7 1],41,72,88,31,59
1,<environment.Job instance at 0x14ec6cba2460>,33,15,[7 2],48,88,103,40,74
1,<environment.Job instance at 0x14ec6cba2e60>,44,3,[1 7],64,85,88,21,85
1,<environment.Job instance at 0x14ec6cb6a320>,46,15,[7 2],66,103,118,37,89
1,<environment.Job instance at 0x14ec6cb6a5a0>,51,15,[2 8],72,90,105,18,90
1,<environment.Job instance at 0x14ec6cb6aaf0>,55,16,[8 1],80,118,134,38,105
1,<environment.Job instance at 0x14ec6cb7ecd0>,66,17,[6 2],96,134,151,38,123
1,<environment.Job instance at 0x14ec6cb86280>,72,15,[5 2],103,151,166,48,145
1,<environment.Job instance at 0x14ec84ce3230>,88,12,[8 1],130,166,178,36,149
1,<environment.Job instance at 0x14ec6cf44d70>,89,12,[7 1],131,178,190,47,161
1,<environment.Job instance at 0x14ec7fb795a0>,97,3,[1 8],144,198,201,54,198
1,<environment.Job instance at 0x14ec7fb79410>,100,3,[1 7],147,201,204,54,198
1,<environment.Job instance at 0x14ec6cb89730>,103,14,[ 1 10],153,204,218,51,198
1,<environment.Job instance at 0x14ec6cb89690>,105,14,[2 9],158,218,232,60,203
1,<environment.Job instance at 0x14ec6cb6a640>,0,13,[2 5],2,2,15,0,2
1,<environment.Job instance at 0x14ec6c6f2cd0>,5,13,[2 5],12,13,26,1,13
1,<environment.Job instance at 0x14ec80882910>,7,13,[7 2],14,15,28,1,14
1,<environment.Job instance at 0x14ec80882550>,8,14,[7 1],15,28,42,13,17
1,<environment.Job instance at 0x14ec7f97a7d0>,15,14,[2 5],22,26,40,4,22
1,<environment.Job instance at 0x14ec7f97aa50>,20,15,[9 2],30,42,57,12,30
1,<environment.Job instance at 0x14ec7f97ad20>,23,16,[8 1],35,57,73,22,45
1,<environment.Job instance at 0x14ec7e224e60>,34,15,[5 2],52,73,88,21,63
1,<environment.Job instance at 0x14ec7e224870>,35,13,[1 6],53,63,76,10,63
1,<environment.Job instance at 0x14ec81bac1e0>,40,12,[5 2],58,76,88,18,63
1,<environment.Job instance at 0x14ec7c129190>,4,15,[5 1],6,7,22,1,7
1,<environment.Job instance at 0x14ec7c129690>,8,3,[ 1 10],10,22,25,12,10
1,<environment.Job instance at 0x14ec7c129d70>,13,22,[5 2],19,25,47,6,20
1,<environment.Job instance at 0x14ec7c108550>,20,13,[5 2],29,41,54,12,41
1,<environment.Job instance at 0x14ec7c108780>,25,17,[1 8],35,47,64,12,46
1,<environment.Job instance at 0x14ec7c108aa0>,29,3,[2 9],40,64,67,24,46
1,<environment.Job instance at 0x14ec7c108b90>,30,3,[1 6],41,67,70,26,46
1,<environment.Job instance at 0x14ec6cfbc320>,35,14,[1 8],47,70,84,23,59
1,<environment.Job instance at 0x14ec6cfbc820>,42,15,[10  1],55,84,99,29,70
1,<environment.Job instance at 0x14ec7c11f370>,56,13,[6 1],74,99,112,25,92
1,<environment.Job instance at 0x14ec6cd05870>,64,12,[ 1 10],86,112,124,26,110
1,<environment.Job instance at 0x14ec6c8151e0>,71,14,[2 5],96,124,138,28,117
1,<environment.Job instance at 0x14ec7c12b730>,86,2,[7 1],118,138,140,20,138
1,<environment.Job instance at 0x14ec7c12bcd0>,87,1,[1 7],119,143,144,24,143
1,<environment.Job instance at 0x14ec7c105dc0>,89,3,[10  1],122,144,147,22,143
1,<environment.Job instance at 0x14ec805d05a0>,90,2,[5 1],124,147,149,23,144
1,<environment.Job instance at 0x14ec805d0dc0>,91,16,[1 5],127,147,163,20,146
1,<environment.Job instance at 0x14ec805d0870>,95,3,[9 2],133,164,167,31,164
1,<environment.Job instance at 0x14ec805d05f0>,96,3,[5 1],135,167,170,32,166
1,<environment.Job instance at 0x14ec7c122730>,1,3,[1 6],3,4,7,1,4
1,<environment.Job instance at 0x14ec86c51780>,2,13,[2 9],5,7,20,2,5
1,<environment.Job instance at 0x14ec86c51d20>,3,12,[10  1],6,20,32,14,7
1,<environment.Job instance at 0x14ec86c51460>,11,23,[1 9],14,44,67,30,44
1,<environment.Job instance at 0x14ec86c49730>,35,3,[10  1],48,67,70,19,48
1,<environment.Job instance at 0x14ec86c49dc0>,36,2,[2 7],52,70,72,18,52
1,<environment.Job instance at 0x14ec86c490f0>,37,1,[9 2],54,72,73,18,54
1,<environment.Job instance at 0x14ec86c49640>,38,18,[2 7],55,73,91,18,62
1,<environment.Job instance at 0x14ec7f9f98c0>,44,13,[9 2],65,91,104,26,75
1,<environment.Job instance at 0x14ec7f9f9cd0>,48,17,[8 1],72,104,121,32,92
1,<environment.Job instance at 0x14ec7f9f9730>,50,18,[2 7],75,104,122,29,93
1,<environment.Job instance at 0x14ec6cf96960>,0,3,[6 2],1,1,4,0,1
1,<environment.Job instance at 0x14ec7e476dc0>,4,2,[6 2],6,6,8,0,6
1,<environment.Job instance at 0x14ec7e476be0>,5,3,[2 7],7,7,10,0,7
1,<environment.Job instance at 0x14ec7e1a8190>,61,16,[2 6],101,1206,1222,1105,1206
1,<environment.Job instance at 0x14ec7e1a8cd0>,74,13,[1 7],124,1222,1235,1098,1217
1,<environment.Job instance at 0x14ec7e1a11e0>,80,3,[9 2],130,1222,1225,1092,1217
1,<environment.Job instance at 0x14ec7e1a1500>,84,3,[2 8],136,1235,1238,1099,1226
1,<environment.Job instance at 0x14ec7e1a1690>,85,14,[1 6],138,1238,1252,1100,1226
1,<environment.Job instance at 0x14ec7e1a16e0>,86,2,[6 2],139,1226,1228,1087,1226
1,<environment.Job instance at 0x14ec7e1a1780>,87,1,[2 6],140,1252,1253,1112,1226
1,<environment.Job instance at 0x14ec7e1a1730>,88,3,[7 1],141,1228,1231,1087,1226
1,<environment.Job instance at 0x14ec7e1a1aa0>,89,3,[1 7],143,1253,1256,1110,1227
1,<environment.Job instance at 0x14ec7e1a1a00>,90,15,[10  2],144,1256,1271,1112,1242
1,<environment.Job instance at 0x14ec7e1c8550>,102,18,[2 9],160,1271,1289,1111,1260
1,<environment.Job instance at 0x1509d3129c30>,0,12,[2 5],1,1,13,0,1
1,<environment.Job instance at 0x1509cb5bdf50>,6,18,[8 1],7,7,25,0,7
1,<environment.Job instance at 0x1509cb5b6f00>,8,13,[6 1],9,25,38,16,17
1,<environment.Job instance at 0x1509cb59c1e0>,17,17,[6 1],23,38,55,15,26
1,<environment.Job instance at 0x1509cb58cb90>,29,16,[10  2],39,55,71,16,42
1,<environment.Job instance at 0x1509c9dbcbe0>,1,15,[1 7],5,5,20,0,5
1,<environment.Job instance at 0x1509c9dbc870>,4,2,[ 2 10],11,20,22,9,11
1,<environment.Job instance at 0x1509c9dbcf50>,8,2,[2 9],15,22,24,7,15
1,<environment.Job instance at 0x1509c9dbc640>,10,19,[ 1 10],18,24,43,6,18
1,<environment.Job instance at 0x1509c9dbc8c0>,11,2,[9 1],19,43,45,24,19
1,<environment.Job instance at 0x1509c98a80f0>,12,3,[5 2],20,45,48,25,20
1,<environment.Job instance at 0x1509c98a8500>,13,2,[ 1 10],21,48,50,27,21
1,<environment.Job instance at 0x1509c98a8780>,14,13,[ 2 10],22,50,63,28,34
1,<environment.Job instance at 0x1509c98a8b40>,19,14,[10  1],29,63,77,34,48
1,<environment.Job instance at 0x1509c9b271e0>,27,18,[8 1],38,77,95,39,66
1,<environment.Job instance at 0x1509c98a7cd0>,32,16,[9 1],46,95,111,49,82
1,<environment.Job instance at 0x1509c9b11050>,51,14,[2 8],79,111,125,32,96
1,<environment.Job instance at 0x1509cb336050>,56,14,[6 1],87,111,125,24,96
1,<environment.Job instance at 0x1509c9b57aa0>,57,15,[2 8],88,125,140,37,119
1,<environment.Job instance at 0x1509cbf974b0>,63,3,[ 2 10],95,140,143,45,133
1,<environment.Job instance at 0x1509c07bd960>,76,3,[10  1],116,371,374,255,371
1,<environment.Job instance at 0x1509c07bde10>,77,3,[10  2],117,374,377,257,371
1,<environment.Job instance at 0x1509c07bd1e0>,81,18,[8 2],123,377,395,254,372
1,<environment.Job instance at 0x1509d0ff4640>,86,15,[7 2],128,397,412,269,397
1,<environment.Job instance at 0x1509d0ff4370>,90,3,[2 8],132,398,401,266,398
1,<environment.Job instance at 0x1509d0ff4820>,98,2,[10  1],144,419,421,275,419
1,<environment.Job instance at 0x1509d0ff4780>,99,2,[2 7],146,421,423,275,420
1,<environment.Job instance at 0x1509d0ff4050>,103,3,[2 5],151,423,426,272,421
1,<environment.Job instance at 0x1509d0ff4aa0>,104,12,[6 1],152,422,434,270,422
1,<environment.Job instance at 0x1509cbf77dc0>,111,15,[1 8],162,426,441,264,423
1,<environment.Job instance at 0x1509cbf77910>,113,19,[2 9],166,441,460,275,437
1,<environment.Job instance at 0x1509cbf77550>,117,2,[1 5],170,460,462,290,437
1,<environment.Job instance at 0x1509cbf77c80>,119,3,[2 7],172,462,465,290,440
1,<environment.Job instance at 0x1509cbf778c0>,120,2,[1 5],173,460,462,287,440
1,<environment.Job instance at 0x1509d298ea50>,0,1,[2 6],1,1,2,0,1
1,<environment.Job instance at 0x1509d298ef00>,2,17,[2 7],4,4,21,0,4
1,<environment.Job instance at 0x1509c8057af0>,3,14,[1 6],5,21,35,16,6
1,<environment.Job instance at 0x1509c8057780>,5,3,[5 1],7,8,11,1,8
1,<environment.Job instance at 0x1509c80573c0>,8,12,[9 2],10,21,33,11,10
1,<environment.Job instance at 0x1509c80571e0>,12,16,[10  2],14,35,51,21,22
1,<environment.Job instance at 0x1509c02d55a0>,24,13,[10  1],28,51,64,23,35
1,<environment.Job instance at 0x1509c02d06e0>,31,16,[10  1],39,64,80,25,51
1,<environment.Job instance at 0x1509c02d0910>,34,12,[7 1],44,80,92,36,63
1,<environment.Job instance at 0x1509c80edeb0>,43,3,[5 2],60,92,95,32,66
1,<environment.Job instance at 0x1509c80ed910>,44,12,[1 5],61,80,92,19,66
1,<environment.Job instance at 0x1509c80ed8c0>,45,13,[7 2],62,95,108,33,79
1,<environment.Job instance at 0x1509d297d960>,54,26,[2 8],78,105,131,27,105
1,<environment.Job instance at 0x1509cb551e60>,60,16,[2 7],91,131,147,40,118
1,<environment.Job instance at 0x1509c02fcd70>,69,2,[5 2],104,118,120,14,118
1,<environment.Job instance at 0x1509c05f8050>,70,27,[1 7],105,147,174,42,145
1,<environment.Job instance at 0x1509c0110f50>,80,15,[2 8],122,174,189,52,163
1,<environment.Job instance at 0x1509c0147c80>,82,13,[10  1],125,189,202,64,176
1,<environment.Job instance at 0x1509c01cd0a0>,0,14,[1 5],1,1,15,0,1
1,<environment.Job instance at 0x1509c01fce60>,3,17,[2 8],6,15,32,9,6
1,<environment.Job instance at 0x1509c01fcbe0>,5,16,[8 1],10,10,26,0,10
1,<environment.Job instance at 0x1509c01fc780>,6,16,[1 6],11,32,48,21,19
1,<environment.Job instance at 0x1509c01fb7d0>,16,13,[1 9],24,48,61,24,32
1,<environment.Job instance at 0x1509c01f8960>,22,3,[6 2],32,61,64,29,48
1,<environment.Job instance at 0x1509c01f8460>,23,2,[6 2],33,64,66,31,48
1,<environment.Job instance at 0x1509c01f82d0>,24,17,[5 2],34,66,83,32,54
1,<environment.Job instance at 0x1509c01f5320>,33,16,[ 2 10],45,83,99,38,71
1,<environment.Job instance at 0x1509c01f5550>,35,14,[8 2],47,99,113,52,88
1,<environment.Job instance at 0x1509d067b050>,44,17,[10  1],60,113,130,53,105
1,<environment.Job instance at 0x1509cb3205a0>,49,15,[5 2],66,130,145,64,119
1,<environment.Job instance at 0x1509cb320640>,51,15,[7 2],69,145,160,76,131
1,<environment.Job instance at 0x1509cb3203c0>,56,14,[2 6],75,131,145,56,131
1,<environment.Job instance at 0x1509c019fe60>,58,17,[2 5],77,145,162,68,143
1,<environment.Job instance at 0x1509c011bd20>,70,13,[6 1],94,160,173,66,150
1,<environment.Job instance at 0x1509c01bce60>,81,16,[6 1],107,255,271,148,255
1,<environment.Job instance at 0x1509c01bc4b0>,87,13,[2 9],113,257,270,144,257
1,<environment.Job instance at 0x1509c01fe6e0>,91,13,[10  1],119,271,284,152,259
1,<environment.Job instance at 0x1509c01599b0>,105,13,[7 2],134,360,373,226,360
1,<environment.Job instance at 0x1509c010e140>,110,17,[1 7],140,374,391,234,374
1,<environment.Job instance at 0x1509c816b870>,114,18,[6 1],145,382,400,237,382
1,<environment.Job instance at 0x1509c01b9cd0>,119,16,[6 2],151,400,416,249,393
1,<environment.Job instance at 0x1509c03f1870>,133,15,[10  2],174,428,443,254,428
1,<environment.Job instance at 0x1509c9dc0e10>,0,2,[6 2],1,1,3,0,1
1,<environment.Job instance at 0x1509c9dc0410>,1,1,[7 1],4,5,6,1,5
1,<environment.Job instance at 0x1509c9dc0d20>,3,15,[1 9],6,6,21,0,6
1,<environment.Job instance at 0x1509c07bf500>,13,15,[6 1],22,22,37,0,22
1,<environment.Job instance at 0x1509c06f4550>,15,17,[10  1],26,37,54,11,26
1,<environment.Job instance at 0x1509c8021370>,35,13,[8 2],56,212,225,156,212
1,<environment.Job instance at 0x1509c809e820>,57,12,[9 1],87,229,241,142,229
1,<environment.Job instance at 0x1509c02fa2d0>,59,16,[9 2],90,245,261,155,245
1,<environment.Job instance at 0x1509c02fa870>,61,15,[6 1],93,261,276,168,249
1,<environment.Job instance at 0x1509c8181c80>,74,18,[2 9],110,261,279,151,261
1,<environment.Job instance at 0x1509c05ec1e0>,83,3,[2 5],119,279,282,160,272
1,<environment.Job instance at 0x1509c01d80a0>,90,13,[2 8],127,293,306,166,293
1,<environment.Job instance at 0x1509c01d7550>,91,3,[7 2],128,299,302,171,299
1,<environment.Job instance at 0x1509d25f2140>,92,17,[ 2 10],129,306,323,177,305
1,<environment.Job instance at 0x1509c064de60>,101,3,[2 9],143,323,326,180,323
1,<environment.Job instance at 0x1509c05fd5f0>,107,1,[1 5],151,343,344,192,343
1,<environment.Job instance at 0x1509c07b9e60>,111,2,[2 6],156,344,346,188,343
1,<environment.Job instance at 0x1509c07b9d70>,113,1,[2 7],158,346,347,188,343
1,<environment.Job instance at 0x1509c07b9500>,115,17,[5 2],160,343,360,183,343
1,<environment.Job instance at 0x1509c07b9f00>,119,14,[1 9],166,360,374,194,352
1,<environment.Job instance at 0x1509c07b9fa0>,121,18,[10  2],168,374,392,206,363
1,<environment.Job instance at 0x1509d0f937d0>,127,16,[8 2],175,392,408,217,389
1,<environment.Job instance at 0x1509c8021dc0>,27,27,[1 9],43,429,456,386,429
1,<environment.Job instance at 0x1509cc26b780>,0,16,[7 1],1,1,17,0,1
1,<environment.Job instance at 0x1509cb59c2d0>,7,3,[1 9],8,8,11,0,8
1,<environment.Job instance at 0x1509cb59c500>,9,15,[6 1],15,17,32,2,15
1,<environment.Job instance at 0x1509c05ef500>,11,17,[8 1],17,32,49,15,21
1,<environment.Job instance at 0x1509c81575f0>,21,15,[8 1],29,49,64,20,36
1,<environment.Job instance at 0x1509c05107d0>,34,3,[1 9],51,51,54,0,51
1,<environment.Job instance at 0x1509c05100f0>,35,17,[1 5],52,54,71,2,52
1,<environment.Job instance at 0x1509cb3eae10>,39,2,[2 6],60,71,73,11,60
1,<environment.Job instance at 0x1509c051daa0>,40,1,[1 5],61,64,65,3,62
1,<environment.Job instance at 0x1509cb3c5f50>,41,3,[7 2],63,65,68,2,63
1,<environment.Job instance at 0x1509cb3c51e0>,42,1,[2 8],64,73,74,9,64
1,<environment.Job instance at 0x1509c9adc820>,49,1,[1 9],75,79,80,4,79
1,<environment.Job instance at 0x1509c05e6370>,50,3,[6 2],76,80,83,4,79
1,<environment.Job instance at 0x1509c9adcb90>,48,15,[ 2 10],74,304,319,230,304
1,<environment.Job instance at 0x1509cf199640>,105,22,[2 9],153,976,998,823,976
1,<environment.Job instance at 0x1509cf199640>,2,2,[2 8],10,10,12,0,10
1,<environment.Job instance at 0x1509c9b15dc0>,3,1,[7 1],13,13,14,0,13
1,<environment.Job instance at 0x1509c0068a50>,4,2,[2 6],14,14,16,0,14
1,<environment.Job instance at 0x1509c0068820>,5,3,[6 2],16,16,19,0,16
1,<environment.Job instance at 0x1509c0068aa0>,6,12,[2 9],17,19,31,2,17
1,<environment.Job instance at 0x1509c0068e10>,10,17,[6 2],22,31,48,9,22
1,<environment.Job instance at 0x1509c006ad20>,20,13,[2 8],33,33,46,0,33
1,<environment.Job instance at 0x1509c006c3c0>,25,14,[ 2 10],40,48,62,8,40
1,<environment.Job instance at 0x1509c006cd20>,39,16,[ 2 10],63,187,203,124,187
1,<environment.Job instance at 0x1509c006ce10>,42,3,[10  2],67,203,206,136,187
1,<environment.Job instance at 0x1509c006ceb0>,43,17,[9 2],69,206,223,137,194
1,<environment.Job instance at 0x1509c006e320>,47,15,[7 1],77,223,238,146,212
1,<environment.Job instance at 0x1509c006e730>,54,17,[5 2],85,238,255,153,230
1,<environment.Job instance at 0x1509c006e9b0>,57,17,[8 1],89,255,272,166,243
1,<environment.Job instance at 0x1509c006ef00>,66,19,[5 2],101,272,291,171,265
1,<environment.Job instance at 0x1509c0071460>,72,15,[8 2],107,291,306,184,277
1,<environment.Job instance at 0x1509c0071780>,77,16,[1 5],113,277,293,164,277
1,<environment.Job instance at 0x1509c04fbe60>,4,17,[7 2],6,6,23,0,6
1,<environment.Job instance at 0x1509c023c1e0>,7,16,[6 1],10,23,39,13,20
1,<environment.Job instance at 0x150983ed5140>,24,2,[ 1 10],32,39,41,7,32
1,<environment.Job instance at 0x1509cbeebcd0>,27,18,[10  1],35,41,59,6,35
1,<environment.Job instance at 0x1509d05e7d70>,1,16,[7 2],2,2,18,0,2
1,<environment.Job instance at 0x1509c9b346e0>,10,13,[1 8],18,18,31,0,18
1,<environment.Job instance at 0x1509c9b34b90>,14,12,[2 8],25,31,43,6,25
1,<environment.Job instance at 0x1509c9b34d20>,15,14,[10  2],26,43,57,17,28
1,<environment.Job instance at 0x1509c9b34f00>,17,12,[6 1],30,30,42,0,30
1,<environment.Job instance at 0x1509c9b4c0a0>,19,14,[9 2],33,57,71,24,48
1,<environment.Job instance at 0x1509c9b397d0>,38,13,[2 8],63,71,84,8,63
1,<environment.Job instance at 0x1509c9b39e10>,43,18,[7 2],70,71,89,1,70
1,<environment.Job instance at 0x1509c9b57230>,50,13,[6 1],78,89,102,11,78
1,<environment.Job instance at 0x1509c9b571e0>,59,17,[7 2],91,102,119,11,93
1,<environment.Job instance at 0x1509cb45cd20>,60,13,[8 1],94,119,132,25,103
1,<environment.Job instance at 0x1509c9b57a00>,66,1,[5 1],103,132,133,29,121
1,<environment.Job instance at 0x1509d1013a50>,68,3,[ 2 10],106,133,136,27,121
1,<environment.Job instance at 0x1509cb426aa0>,69,2,[7 1],108,136,138,28,121
1,<environment.Job instance at 0x1509cb426370>,70,2,[ 1 10],111,138,140,27,121
1,<environment.Job instance at 0x150983eb82d0>,71,1,[ 2 10],112,140,141,28,121
1,<environment.Job instance at 0x150983eb8eb0>,72,3,[1 9],114,121,124,7,121
1,<environment.Job instance at 0x1509c02cfd70>,74,13,[ 1 10],117,141,154,24,127
1,<environment.Job instance at 0x150983e8b550>,76,13,[7 2],121,154,167,33,140
1,<environment.Job instance at 0x150983ea9b40>,82,14,[6 2],130,167,181,37,153
1,<environment.Job instance at 0x150983ea9050>,84,18,[10  2],132,181,199,49,170
1,<environment.Job instance at 0x150983ea9320>,88,12,[5 2],137,199,211,62,182
1,<environment.Job instance at 0x150983ebfa00>,95,15,[7 1],147,211,226,64,211
1,<environment.Job instance at 0x150983ebfa50>,101,17,[6 2],165,226,243,61,223
1,<environment.Job instance at 0x150983ebf0f0>,104,14,[10  2],169,243,257,74,237
1,<environment.Job instance at 0x1509c82a68c0>,1,17,[6 1],3,4,21,1,4
1,<environment.Job instance at 0x1509c82a6e60>,5,13,[7 2],11,21,34,10,12
1,<environment.Job instance at 0x1509c018b2d0>,13,16,[5 2],25,34,50,9,27
1,<environment.Job instance at 0x1509d06e03c0>,19,18,[8 2],32,50,68,18,39
1,<environment.Job instance at 0x1509c0187050>,28,18,[7 2],49,68,86,19,60
1,<environment.Job instance at 0x150983eb8190>,42,14,[8 2],65,86,100,21,71
1,<environment.Job instance at 0x1509c81f4640>,0,3,[1 6],2,2,5,0,2
1,<environment.Job instance at 0x1509c8279870>,3,16,[2 6],5,5,21,0,5
1,<environment.Job instance at 0x1509c0508c30>,5,3,[1 8],8,21,24,13,8
1,<environment.Job instance at 0x1509d2f3d8c0>,9,3,[ 2 10],19,24,27,5,19
1,<environment.Job instance at 0x1509cb383870>,12,3,[1 6],26,27,30,1,26
1,<environment.Job instance at 0x1509cbf22910>,13,13,[1 5],27,30,43,3,27
1,<environment.Job instance at 0x1509d0631a00>,18,18,[1 8],33,43,61,10,34
1,<environment.Job instance at 0x1509cbeacf50>,19,17,[10  2],35,61,78,26,49
1,<environment.Job instance at 0x1509c03f0c80>,40,15,[10  1],66,78,93,12,69
1,<environment.Job instance at 0x1509c9aead70>,41,17,[6 1],68,93,110,25,91
1,<environment.Job instance at 0x150983ed5230>,43,15,[5 2],70,110,125,40,106
1,<environment.Job instance at 0x1509c006ca00>,48,12,[5 2],76,114,126,38,114
1,<environment.Job instance at 0x1509c006c550>,49,14,[2 8],78,125,139,47,122
1,<environment.Job instance at 0x1509c006ca50>,51,16,[7 1],81,130,146,49,130
1,<environment.Job instance at 0x1509cd509a00>,56,15,[7 2],88,146,161,58,141
1,<environment.Job instance at 0x1509cd509e60>,57,13,[9 1],89,161,174,72,150
1,<environment.Job instance at 0x1509d2166550>,59,24,[9 2],91,174,198,83,171
1,<environment.Job instance at 0x1509cbeec4b0>,63,16,[5 1],98,201,217,103,201
1,<environment.Job instance at 0x1509d105e820>,69,15,[7 2],106,217,232,111,205
1,<environment.Job instance at 0x150983eb8280>,78,16,[8 1],120,232,248,112,225
1,<environment.Job instance at 0x1509cc242910>,89,17,[6 2],136,248,265,112,236
1,<environment.Job instance at 0x1509cc2423c0>,95,15,[5 2],143,265,280,122,258
1,<environment.Job instance at 0x1509cd520cd0>,108,1,[10  1],167,280,281,113,262
1,<environment.Job instance at 0x1509cd520730>,111,12,[8 1],170,281,293,111,264
1,<environment.Job instance at 0x1509c9657a00>,112,12,[7 1],171,293,305,122,276
1,<environment.Job instance at 0x1509c9657e60>,116,16,[1 9],176,281,297,105,276
1,<environment.Job instance at 0x150983fa4af0>,5,3,[1 8],10,10,13,0,10
1,<environment.Job instance at 0x1509c02f1a50>,6,14,[ 1 10],13,13,27,0,13
1,<environment.Job instance at 0x150983fa4be0>,10,3,[1 6],20,27,30,7,20
1,<environment.Job instance at 0x150983f96550>,12,3,[ 2 10],22,30,33,8,22
1,<environment.Job instance at 0x150983f96690>,13,3,[6 2],23,27,30,4,23
1,<environment.Job instance at 0x150983f967d0>,14,1,[9 2],27,33,34,6,27
1,<environment.Job instance at 0x150983f96910>,15,1,[2 9],28,34,35,6,28
1,<environment.Job instance at 0x150983f96a50>,16,18,[2 7],29,35,53,6,29
1,<environment.Job instance at 0x1509cb5b1d20>,0,13,[ 1 10],1,1,14,0,1
1,<environment.Job instance at 0x1509d068c960>,4,3,[ 1 10],6,14,17,8,6
1,<environment.Job instance at 0x1509cb3afb90>,13,16,[5 1],19,34,50,15,34
1,<environment.Job instance at 0x1509cb3af0a0>,15,13,[2 5],22,34,47,12,34
1,<environment.Job instance at 0x1509cb3afb40>,20,13,[2 5],32,47,60,15,39
1,<environment.Job instance at 0x1509cb3afaa0>,22,13,[7 2],34,50,63,16,48
1,<environment.Job instance at 0x1509cb3d64b0>,30,14,[2 5],42,60,74,18,55
1,<environment.Job instance at 0x1509c9b5bc30>,35,15,[9 2],50,74,89,24,60
1,<environment.Job instance at 0x1509c9deb640>,48,18,[2 6],71,89,107,18,82
1,<environment.Job instance at 0x1509c9debd70>,49,15,[5 2],72,89,104,17,85
1,<environment.Job instance at 0x1509c809d4b0>,0,3,[1 9],1,2,5,1,2
1,<environment.Job instance at 0x1509c809d3c0>,2,1,[10  2],5,5,6,0,5
1,<environment.Job instance at 0x1509c809ddc0>,4,3,[8 1],7,7,10,0,7
1,<environment.Job instance at 0x1509c809db90>,5,1,[1 6],8,8,9,0,8
1,<environment.Job instance at 0x1509c809da00>,6,1,[2 7],9,9,10,0,9
1,<environment.Job instance at 0x1509c809d0f0>,8,1,[7 1],11,11,12,0,11
1,<environment.Job instance at 0x1509c809d280>,9,2,[9 1],12,12,14,0,12
1,<environment.Job instance at 0x1509c809d140>,10,1,[5 1],14,14,15,0,14
1,<environment.Job instance at 0x1509cb55e0f0>,11,1,[2 7],15,15,16,0,15
1,<environment.Job instance at 0x1509cb55e320>,12,15,[5 1],16,16,31,0,16
1,<environment.Job instance at 0x1509cb55e7d0>,15,13,[ 2 10],19,31,44,12,20
1,<environment.Job instance at 0x1509cb2a7e60>,19,3,[1 7],26,26,29,0,26
1,<environment.Job instance at 0x1509cb2a7320>,20,1,[5 1],28,29,30,1,28
1,<environment.Job instance at 0x1509cb2a7140>,21,22,[5 2],29,44,66,15,37
1,<environment.Job instance at 0x1509cb2a78c0>,23,2,[1 6],32,44,46,12,37
1,<environment.Job instance at 0x1509cb2a7c30>,24,12,[ 1 10],34,66,78,32,49
1,<environment.Job instance at 0x150983e88960>,30,1,[2 6],41,52,53,11,52
1,<environment.Job instance at 0x150983e885a0>,31,12,[1 8],42,53,65,11,52
1,<environment.Job instance at 0x150983e88a00>,33,17,[1 8],45,78,95,33,66
1,<environment.Job instance at 0x1509c03905f0>,40,2,[ 1 10],53,95,97,42,68
1,<environment.Job instance at 0x1509c0390d20>,41,1,[2 9],54,97,98,43,69
1,<environment.Job instance at 0x1509c0076be0>,42,21,[10  1],55,98,119,43,90
1,<environment.Job instance at 0x1509c0076c30>,50,15,[10  1],65,119,134,54,107
1,<environment.Job instance at 0x1509c0076960>,55,18,[7 1],75,134,152,59,130
1,<environment.Job instance at 0x150983f89410>,64,13,[6 1],84,218,231,134,218
1,<environment.Job instance at 0x1509d05f5be0>,72,12,[ 1 10],96,231,243,135,225
1,<environment.Job instance at 0x1509d05f50f0>,76,2,[1 5],102,243,245,141,231
1,<environment.Job instance at 0x1509d05f5230>,77,21,[5 2],104,252,273,148,252
1,<environment.Job instance at 0x1509d05f55a0>,80,3,[2 9],107,273,276,166,256
1,<environment.Job instance at 0x150983e8b5f0>,81,1,[10  1],108,276,277,168,256
1,<environment.Job instance at 0x150983e8b9b0>,82,2,[2 9],109,277,279,168,259
1,<environment.Job instance at 0x1509c9acbaa0>,99,16,[1 5],137,279,295,142,270
1,<environment.Job instance at 0x150983f36f50>,101,27,[6 1],139,278,305,139,278
1,<environment.Job instance at 0x1509c0403960>,104,3,[5 1],145,305,308,160,283
1,<environment.Job instance at 0x150983f6b690>,2,13,[2 9],5,5,18,0,5
1,<environment.Job instance at 0x1509c06b8b90>,3,12,[10  1],6,18,30,12,8
1,<environment.Job instance at 0x1509c02c60f0>,9,1,[6 2],12,30,31,18,12
1,<environment.Job instance at 0x1509c9db5190>,11,23,[1 9],14,31,54,17,25
1,<environment.Job instance at 0x1509c057c3c0>,25,3,[ 2 10],33,54,57,21,42
1,<environment.Job instance at 0x1509c057cd70>,26,1,[8 2],35,57,58,22,52
1,<environment.Job instance at 0x1509c057cb90>,33,15,[1 8],44,72,87,28,72
1,<environment.Job instance at 0x1509c057c690>,38,18,[2 7],55,87,105,32,86
1,<environment.Job instance at 0x1509d2166dc0>,44,13,[9 2],65,105,118,40,97
1,<environment.Job instance at 0x1509c9db5b90>,14,17,[1 9],18,118,135,100,109
1,<environment.Job instance at 0x1509d102b190>,53,3,[6 1],80,128,131,48,128
1,<environment.Job instance at 0x1509d102b9b0>,57,12,[7 2],84,189,201,105,189
1,<environment.Job instance at 0x1509cf17a4b0>,63,3,[2 6],91,189,192,98,189
1,<environment.Job instance at 0x1509c0593550>,67,15,[10  2],96,201,216,105,189
1,<environment.Job instance at 0x1509c9acbeb0>,72,12,[2 9],101,216,228,115,209
1,<environment.Job instance at 0x1509c9b46500>,83,17,[2 8],120,228,245,108,216
1,<environment.Job instance at 0x1509c0665fa0>,1,20,[1 9],2,11,31,9,11
1,<environment.Job instance at 0x1509cb29b8c0>,8,3,[2 8],13,31,34,18,13
1,<environment.Job instance at 0x1509cb29b5a0>,12,23,[10  2],18,34,57,16,28
1,<environment.Job instance at 0x1509cf192af0>,30,18,[9 2],46,57,75,11,46
1,<environment.Job instance at 0x1509cb56ef00>,36,14,[7 1],55,75,89,20,60
1,<environment.Job instance at 0x1509d0635f00>,42,15,[8 1],67,89,104,22,82
1,<environment.Job instance at 0x1509c03d6d20>,51,17,[5 1],84,104,121,20,92
1,<environment.Job instance at 0x1509c05fe4b0>,60,2,[6 2],101,121,123,20,101
1,<environment.Job instance at 0x1509c060caa0>,88,21,[1 8],140,767,788,627,767
1,<environment.Job instance at 0x1509cb3aa5f0>,91,21,[10  2],144,788,809,644,780
1,<environment.Job instance at 0x1509c0465fa0>,99,12,[10  2],155,809,821,654,795
1,<environment.Job instance at 0x1509c9ba0460>,106,13,[7 1],164,821,834,657,811
1,<environment.Job instance at 0x1509cb4e19b0>,114,17,[5 1],174,834,851,660,833
1,<environment.Job instance at 0x1509d0f75be0>,117,13,[8 2],178,851,864,673,835
1,<environment.Job instance at 0x1509cb5d70a0>,90,15,[2 6],143,863,878,720,863
1,<environment.Job instance at 0x1509c9deb2d0>,0,2,[6 1],2,2,4,0,2
1,<environment.Job instance at 0x1509c9bae910>,1,18,[6 2],3,4,22,1,4
1,<environment.Job instance at 0x1509c81a9190>,11,13,[6 2],19,22,35,3,19
1,<environment.Job instance at 0x1509c81a9370>,12,16,[2 9],20,35,51,15,22
1,<environment.Job instance at 0x1509c81a9fa0>,17,17,[9 1],25,51,68,26,39
1,<environment.Job instance at 0x1509c81a97d0>,25,1,[8 1],37,68,69,31,57
1,<environment.Job instance at 0x1509c81a9460>,26,13,[1 6],38,57,70,19,57
1,<environment.Job instance at 0x1509c81a9dc0>,27,18,[2 5],39,70,88,31,59
1,<environment.Job instance at 0x1509c81b5050>,28,13,[9 1],40,88,101,48,72
1,<environment.Job instance at 0x1509c81b5730>,30,3,[7 2],46,75,78,29,75
1,<environment.Job instance at 0x1509c81b56e0>,32,3,[ 2 10],49,101,104,52,76
1,<environment.Job instance at 0x1509c81b5dc0>,33,2,[1 8],50,88,90,38,76
1,<environment.Job instance at 0x1509c81b5550>,34,12,[2 9],51,104,116,53,87
1,<environment.Job instance at 0x1509c81b51e0>,35,18,[7 2],53,116,134,63,107
1,<environment.Job instance at 0x1509c81b55f0>,43,15,[7 1],67,134,149,67,120
1,<environment.Job instance at 0x1509c0065370>,63,17,[ 2 10],99,239,256,140,239
1,<environment.Job instance at 0x1509c9b77190>,75,3,[6 2],119,258,261,139,258
1,<environment.Job instance at 0x1509cbf70aa0>,77,2,[8 1],122,261,263,139,258
1,<environment.Job instance at 0x1509cbf70a50>,78,3,[ 1 10],124,263,266,139,258
1,<environment.Job instance at 0x1509cbf707d0>,79,15,[9 2],126,266,281,140,258
1,<environment.Job instance at 0x1509cbf709b0>,85,17,[7 1],133,281,298,148,276
1,<environment.Job instance at 0x1509cbf68410>,88,14,[7 1],138,298,312,160,283
1,<environment.Job instance at 0x1509cbf68550>,89,13,[5 2],139,312,325,173,298
1,<environment.Job instance at 0x1509cbf686e0>,96,15,[8 2],149,325,340,176,315
1,<environment.Job instance at 0x1509cbf68f50>,107,19,[1 8],164,338,357,174,338
1,<environment.Job instance at 0x1458b5efcc30>,0,12,[2 5],1,1,13,0,1
1,<environment.Job instance at 0x1458ae3a5780>,6,18,[8 1],7,7,25,0,7
1,<environment.Job instance at 0x1458ae3a5f00>,8,13,[6 1],9,25,38,16,12
1,<environment.Job instance at 0x1458b5ea28c0>,17,17,[6 1],23,38,55,15,26
1,<environment.Job instance at 0x1458ae367550>,29,16,[10  2],39,55,71,16,42
1,<environment.Job instance at 0x1458b3d46140>,1,3,[5 2],2,3,6,1,3
1,<environment.Job instance at 0x1458b3d46280>,3,2,[ 2 10],4,6,8,2,4
1,<environment.Job instance at 0x1458b34d0be0>,5,17,[ 2 10],6,8,25,2,6
1,<environment.Job instance at 0x1458b33d9500>,14,3,[ 2 10],17,25,28,8,17
1,<environment.Job instance at 0x1458b36d9280>,15,14,[10  1],19,28,42,9,19
1,<environment.Job instance at 0x1458ac417c30>,20,3,[6 1],24,42,45,18,32
1,<environment.Job instance at 0x1458acbb9cd0>,23,18,[8 1],28,45,63,17,36
1,<environment.Job instance at 0x1458ae29feb0>,24,16,[1 6],29,44,60,15,44
1,<environment.Job instance at 0x1458ae29f140>,25,17,[1 6],31,60,77,29,58
1,<environment.Job instance at 0x1458acbab140>,31,12,[1 5],42,77,89,35,70
1,<environment.Job instance at 0x1458ae2da550>,41,2,[1 6],57,89,91,32,72
1,<environment.Job instance at 0x1458ae2da910>,42,18,[7 2],59,72,90,13,72
1,<environment.Job instance at 0x1458ac3ff460>,44,18,[10  1],66,91,109,25,80
1,<environment.Job instance at 0x14586f6a1050>,2,16,[9 1],3,3,19,0,3
1,<environment.Job instance at 0x14586f3add20>,5,14,[7 2],7,19,33,12,15
1,<environment.Job instance at 0x14586f63a960>,10,18,[6 2],16,33,51,17,22
1,<environment.Job instance at 0x14586f591c30>,28,26,[9 1],44,51,77,7,48
1,<environment.Job instance at 0x14586f689050>,32,12,[5 2],48,77,89,29,61
1,<environment.Job instance at 0x14586f58a640>,38,16,[2 8],59,81,97,22,81
1,<environment.Job instance at 0x14586f5bc2d0>,41,2,[1 5],65,97,99,32,87
1,<environment.Job instance at 0x14586f5e2cd0>,43,3,[2 9],67,99,102,32,87
1,<environment.Job instance at 0x14586f5b3f50>,46,2,[1 9],71,102,104,31,90
1,<environment.Job instance at 0x14586f660690>,49,16,[2 6],76,104,120,28,91
1,<environment.Job instance at 0x14586f598c80>,59,15,[10  1],89,120,135,31,106
1,<environment.Job instance at 0x1458b5760230>,0,2,[10  2],2,2,4,0,2
1,<environment.Job instance at 0x14586f0d1960>,4,16,[10  1],9,9,25,0,9
1,<environment.Job instance at 0x14586f0d1fa0>,7,12,[7 1],14,25,37,11,14
1,<environment.Job instance at 0x14586f780780>,18,13,[7 2],32,37,50,5,32
1,<environment.Job instance at 0x14586f7e2f50>,21,18,[1 5],37,43,61,6,43
1,<environment.Job instance at 0x14586f01fe60>,28,2,[ 1 10],50,61,63,11,50
1,<environment.Job instance at 0x14586f01fdc0>,29,16,[ 2 10],52,63,79,11,52
1,<environment.Job instance at 0x14586f1a19b0>,31,2,[1 6],57,79,81,22,57
1,<environment.Job instance at 0x1458b33b52d0>,32,3,[1 9],58,81,84,23,58
1,<environment.Job instance at 0x14586f600460>,38,2,[7 2],70,79,81,9,70
1,<environment.Job instance at 0x14586f32a0a0>,41,14,[2 8],73,84,98,11,73
1,<environment.Job instance at 0x1458b3dc6230>,48,3,[9 2],82,98,101,16,87
1,<environment.Job instance at 0x1458b5eff050>,50,17,[1 9],84,101,118,17,89
1,<environment.Job instance at 0x1458b55277d0>,53,15,[2 8],92,118,133,26,104
1,<environment.Job instance at 0x1458b53a6fa0>,67,12,[7 1],116,125,137,9,125
1,<environment.Job instance at 0x14586efe8b90>,6,14,[8 2],7,7,21,0,7
1,<environment.Job instance at 0x14586ef10910>,14,1,[5 2],19,21,22,2,19
1,<environment.Job instance at 0x14586ef73fa0>,15,17,[10  1],20,22,39,2,20
1,<environment.Job instance at 0x14586f03bd20>,24,2,[2 9],31,39,41,8,31
1,<environment.Job instance at 0x14586f03b0f0>,25,2,[1 5],32,41,43,9,32
1,<environment.Job instance at 0x14586f1b5e60>,26,16,[1 8],33,43,59,10,33
1,<environment.Job instance at 0x14586f1b3eb0>,27,14,[2 6],35,59,73,24,44
1,<environment.Job instance at 0x14586f7705f0>,41,13,[6 1],54,55,68,1,55
1,<environment.Job instance at 0x14586f182dc0>,46,13,[2 6],59,73,86,14,59
1,<environment.Job instance at 0x14586ee42370>,4,17,[1 6],11,11,28,0,11
1,<environment.Job instance at 0x14586ee42730>,6,13,[2 9],16,28,41,12,18
1,<environment.Job instance at 0x14586ee42af0>,12,15,[10  1],23,41,56,18,27
1,<environment.Job instance at 0x14586ee44690>,21,12,[6 2],33,56,68,23,49
1,<environment.Job instance at 0x14586ee44960>,25,14,[7 1],38,68,82,30,63
1,<environment.Job instance at 0x14586ee449b0>,27,14,[9 2],40,82,96,42,69
1,<environment.Job instance at 0x14586ee46460>,39,23,[9 1],56,96,119,40,90
1,<environment.Job instance at 0x14586ee46690>,44,3,[6 1],63,119,122,56,97
1,<environment.Job instance at 0x14586ee46af0>,48,3,[1 6],67,97,100,30,97
1,<environment.Job instance at 0x14586ee48410>,53,13,[2 5],78,134,147,56,134
1,<environment.Job instance at 0x14586ee48230>,54,2,[1 8],79,147,149,68,135
1,<environment.Job instance at 0x14586ee48c30>,62,16,[9 1],94,280,296,186,280
1,<environment.Job instance at 0x14586ee4a780>,71,16,[2 9],110,296,312,186,290
1,<environment.Job instance at 0x14586ee4adc0>,81,13,[7 1],122,299,312,177,299
1,<environment.Job instance at 0x14586ee4c0f0>,85,2,[10  2],128,312,314,184,301
1,<environment.Job instance at 0x14586ee4c190>,86,2,[1 7],129,314,316,185,301
1,<environment.Job instance at 0x14586ee4c050>,87,3,[2 8],130,316,319,186,301
1,<environment.Job instance at 0x14586ee4c140>,88,2,[6 2],131,314,316,183,301
1,<environment.Job instance at 0x14586ee4c410>,89,1,[7 1],134,316,317,182,301
1,<environment.Job instance at 0x14586ee4c690>,90,2,[5 2],135,317,319,182,301
1,<environment.Job instance at 0x14586ee4c870>,91,15,[1 9],136,319,334,183,305
1,<environment.Job instance at 0x14586ee4c910>,92,3,[6 1],137,319,322,182,306
1,<environment.Job instance at 0x14586ee4caf0>,93,2,[ 1 10],138,334,336,196,307
1,<environment.Job instance at 0x14586ee4caa0>,94,1,[7 1],139,322,323,183,307
1,<environment.Job instance at 0x14586ee4ceb0>,99,1,[6 1],146,323,324,177,309
1,<environment.Job instance at 0x14586ee4cf00>,100,3,[8 1],148,324,327,176,309
1,<environment.Job instance at 0x14586ee4f1e0>,101,15,[6 1],152,336,351,184,329
1,<environment.Job instance at 0x14586ee4f190>,103,17,[10  1],156,351,368,195,339
1,<environment.Job instance at 0x14586ee4f4b0>,108,14,[2 6],163,419,433,256,419
1,<environment.Job instance at 0x14586eeba500>,119,3,[ 1 10],181,439,442,258,439
1,<environment.Job instance at 0x14586eeba2d0>,120,1,[8 2],182,442,443,260,439
1,<environment.Job instance at 0x14586f1d4c80>,121,18,[9 1],183,443,461,260,439
1,<environment.Job instance at 0x14586eea45f0>,123,13,[8 2],186,461,474,275,457
1,<environment.Job instance at 0x14586eeba050>,118,12,[2 8],178,478,490,300,478
1,<environment.Job instance at 0x1458b3dfbeb0>,5,1,[1 7],10,10,11,0,10
1,<environment.Job instance at 0x1458b3dfb730>,6,21,[9 1],11,11,32,0,11
1,<environment.Job instance at 0x1458ae2662d0>,18,12,[9 1],27,32,44,5,27
1,<environment.Job instance at 0x1458ae27a050>,50,2,[2 9],65,136,138,71,136
1,<environment.Job instance at 0x1458ae27a1e0>,51,13,[2 8],67,138,151,71,136
1,<environment.Job instance at 0x1458ae27a4b0>,52,3,[7 2],68,138,141,70,136
1,<environment.Job instance at 0x1458ae27a410>,53,17,[ 2 10],69,151,168,82,139
1,<environment.Job instance at 0x1458ae27a2d0>,54,1,[1 8],72,168,169,96,140
1,<environment.Job instance at 0x1458ae27a910>,55,16,[5 2],73,168,184,95,159
1,<environment.Job instance at 0x1458ae28a5a0>,65,16,[2 7],87,189,205,102,189
1,<environment.Job instance at 0x14586f4e8910>,30,14,[ 1 10],44,205,219,161,205
1,<environment.Job instance at 0x1458ae187730>,76,17,[5 2],100,219,236,119,210
1,<environment.Job instance at 0x14586ef30780>,82,18,[10  2],108,236,254,128,225
1,<environment.Job instance at 0x1458b3e137d0>,87,17,[7 1],114,254,271,140,243
1,<environment.Job instance at 0x14586f266190>,89,3,[1 5],118,254,257,136,243
1,<environment.Job instance at 0x1458aebe0d70>,92,16,[7 1],121,271,287,150,259
1,<environment.Job instance at 0x1458ae197870>,101,15,[6 1],135,289,304,154,289
1,<environment.Job instance at 0x1458a8070780>,103,17,[8 1],137,304,321,167,300
1,<environment.Job instance at 0x1458af079dc0>,107,16,[2 5],141,316,332,175,316
1,<environment.Job instance at 0x14586eefd5f0>,109,12,[ 1 10],143,332,344,189,316
1,<environment.Job instance at 0x14586f773780>,113,15,[8 1],149,344,359,195,340
1,<environment.Job instance at 0x14586f7fb7d0>,118,13,[7 2],160,359,372,199,359
1,<environment.Job instance at 0x14586f7a35f0>,134,1,[2 8],184,362,363,178,362
1,<environment.Job instance at 0x14586f7a3640>,135,18,[1 7],186,363,381,177,362
1,<environment.Job instance at 0x1458ac91c370>,77,2,[5 1],102,436,438,334,436
1,<environment.Job instance at 0x14586f5a2730>,2,15,[ 2 10],4,4,19,0,4
1,<environment.Job instance at 0x14586f5a2320>,3,1,[1 9],5,19,20,14,5
1,<environment.Job instance at 0x14586f5a23c0>,4,3,[6 2],6,20,23,14,6
1,<environment.Job instance at 0x14586f59d780>,58,21,[10  2],82,803,824,721,803
1,<environment.Job instance at 0x14586f652370>,61,14,[2 5],87,824,838,737,818
1,<environment.Job instance at 0x14586f76ca00>,67,13,[2 9],97,838,851,741,830
1,<environment.Job instance at 0x1458ac91ca50>,68,12,[5 2],99,866,878,767,866
1,<environment.Job instance at 0x1458ac91c320>,70,20,[9 1],101,878,898,777,872
1,<environment.Job instance at 0x1458aed33690>,79,18,[8 1],118,898,916,780,896
1,<environment.Job instance at 0x14586f4051e0>,88,17,[6 2],132,926,943,794,926
1,<environment.Job instance at 0x14586f0d9aa0>,98,13,[2 8],143,940,953,797,940
1,<environment.Job instance at 0x14586f74a320>,2,16,[1 7],3,3,19,0,3
1,<environment.Job instance at 0x1458b3476140>,3,17,[5 2],5,5,22,0,5
1,<environment.Job instance at 0x14586efb1af0>,10,15,[9 1],14,22,37,8,14
1,<environment.Job instance at 0x14586efa7320>,26,16,[1 5],33,33,49,0,33
1,<environment.Job instance at 0x14586efa7be0>,33,15,[9 1],42,42,57,0,42
1,<environment.Job instance at 0x1458b3e6d3c0>,39,14,[ 2 10],48,57,71,9,48
1,<environment.Job instance at 0x14586ef9a7d0>,48,15,[10  1],63,71,86,8,63
1,<environment.Job instance at 0x14586ef9a640>,49,3,[1 8],65,86,89,21,65
1,<environment.Job instance at 0x14586f2bc7d0>,57,16,[7 2],74,86,102,12,74
1,<environment.Job instance at 0x14586eebaa00>,14,2,[2 6],22,25,27,3,25
1,<environment.Job instance at 0x14586eeba4b0>,17,2,[5 1],27,28,30,1,28
1,<environment.Job instance at 0x14586f0770f0>,19,1,[10  1],29,30,31,1,30
1,<environment.Job instance at 0x14586f077dc0>,21,3,[ 2 10],31,31,34,0,31
1,<environment.Job instance at 0x14586f077140>,22,17,[2 9],33,34,51,1,33
1,<environment.Job instance at 0x14586ee58c80>,30,2,[1 5],41,51,53,10,41
1,<environment.Job instance at 0x14586eec6a50>,31,12,[5 1],42,42,54,0,42
1,<environment.Job instance at 0x14586eec6820>,33,3,[1 7],45,53,56,8,45
1,<environment.Job instance at 0x14586eec6280>,35,1,[6 1],49,54,55,5,49
1,<environment.Job instance at 0x14586eec6f00>,36,13,[1 6],50,56,69,6,51
1,<environment.Job instance at 0x14586eec6960>,38,17,[6 1],52,55,72,3,52
1,<environment.Job instance at 0x14586eec61e0>,42,17,[2 7],58,69,86,11,58
1,<environment.Job instance at 0x14586ecd8c80>,43,12,[5 1],59,78,90,19,78
1,<environment.Job instance at 0x14586ecd8af0>,46,17,[6 1],65,90,107,25,78
1,<environment.Job instance at 0x14586eed6e10>,52,26,[2 7],72,109,135,37,109
1,<environment.Job instance at 0x14586eed6550>,55,15,[8 1],76,110,125,34,110
1,<environment.Job instance at 0x14586ee4f4b0>,59,1,[ 2 10],80,135,136,55,126
1,<environment.Job instance at 0x14586ee4f230>,60,2,[2 5],81,136,138,55,126
1,<environment.Job instance at 0x14586ee4fb40>,61,15,[7 2],82,136,151,54,126
1,<environment.Job instance at 0x14586ecd8960>,44,16,[1 7],61,271,287,210,271
1,<environment.Job instance at 0x14586f1d40a0>,85,17,[1 5],116,300,317,184,300
1,<environment.Job instance at 0x14586f1d44b0>,87,1,[1 5],118,300,301,182,300
1,<environment.Job instance at 0x14586f1d4820>,89,2,[7 1],120,301,303,181,300
1,<environment.Job instance at 0x14586f1d40f0>,93,3,[2 5],124,303,306,179,300
1,<environment.Job instance at 0x14586f1d41e0>,94,18,[10  1],125,317,335,192,306
1,<environment.Job instance at 0x14586f0dde60>,0,16,[8 2],1,1,17,0,1
1,<environment.Job instance at 0x1458aefa6910>,6,12,[9 1],8,17,29,9,8
1,<environment.Job instance at 0x1458ae295b40>,16,18,[2 5],20,29,47,9,22
1,<environment.Job instance at 0x1458af0501e0>,20,16,[1 9],24,47,63,23,34
1,<environment.Job instance at 0x14586ecd3aa0>,28,3,[5 2],35,35,38,0,35
1,<environment.Job instance at 0x14586f7945a0>,29,15,[10  2],36,63,78,27,49
1,<environment.Job instance at 0x1458b3ddea00>,42,2,[1 5],54,78,80,24,61
1,<environment.Job instance at 0x14586f7f9e10>,44,1,[9 1],58,61,62,3,61
1,<environment.Job instance at 0x14586f7f9d20>,45,2,[9 1],59,78,80,19,61
1,<environment.Job instance at 0x14586f7f9550>,46,2,[6 2],60,80,82,20,61
1,<environment.Job instance at 0x1458ac8e97d0>,48,17,[2 9],63,82,99,19,70
1,<environment.Job instance at 0x1458b53c2410>,59,3,[1 6],79,373,376,294,373
1,<environment.Job instance at 0x1458b53c2910>,60,3,[2 6],80,376,379,296,373
1,<environment.Job instance at 0x1458b53c2190>,61,3,[2 5],81,379,382,298,373
1,<environment.Job instance at 0x1458b53c23c0>,62,16,[7 2],82,373,389,291,373
1,<environment.Job instance at 0x1458b53c2050>,63,12,[9 1],83,389,401,306,384
1,<environment.Job instance at 0x1458b535caf0>,75,12,[2 8],105,401,413,296,388
1,<environment.Job instance at 0x1458b535c550>,76,14,[10  2],106,413,427,307,398
1,<environment.Job instance at 0x1458b535c370>,80,14,[9 2],113,427,441,314,421
1,<environment.Job instance at 0x1458aec52eb0>,85,14,[10  1],121,441,455,320,435
1,<environment.Job instance at 0x1458aec52910>,87,16,[9 2],123,455,471,332,446
1,<environment.Job instance at 0x1458ae0773c0>,99,13,[2 8],143,471,484,328,464
1,<environment.Job instance at 0x1458ae077af0>,101,3,[2 7],146,484,487,338,469
1,<environment.Job instance at 0x1458ae077dc0>,104,18,[7 2],150,471,489,321,469
1,<environment.Job instance at 0x1458ae077690>,106,2,[9 1],152,489,491,337,486
1,<environment.Job instance at 0x1458aec4c5f0>,119,1,[10  2],169,1743,1744,1574,1743
1,<environment.Job instance at 0x1458aec4c460>,120,17,[7 2],171,1744,1761,1573,1743
1,<environment.Job instance at 0x1458aec4ce10>,123,18,[8 1],177,1761,1779,1584,1753
1,<environment.Job instance at 0x1458b3dae7d0>,2,3,[1 9],4,4,7,0,4
1,<environment.Job instance at 0x1458ae22f190>,3,17,[ 1 10],5,7,24,2,6
1,<environment.Job instance at 0x14586f3b40f0>,4,13,[ 1 10],7,24,37,17,8
1,<environment.Job instance at 0x14586f3b4320>,6,13,[7 2],11,37,50,26,32
1,<environment.Job instance at 0x14586f3b4be0>,18,12,[5 2],27,50,62,23,46
1,<environment.Job instance at 0x14586f39f410>,27,3,[1 9],44,62,65,18,51
1,<environment.Job instance at 0x14586f39f500>,28,1,[1 7],47,52,53,5,52
1,<environment.Job instance at 0x14586f39faa0>,29,14,[7 1],49,62,76,13,52
1,<environment.Job instance at 0x14586f39fb40>,31,17,[6 2],55,77,94,22,77
1,<environment.Job instance at 0x14586ee6abe0>,45,18,[2 8],78,92,110,14,92
1,<environment.Job instance at 0x14586ee55d70>,54,16,[5 2],95,95,111,0,95
1,<environment.Job instance at 0x14586f7b7d20>,1,16,[ 1 10],3,3,19,0,3
1,<environment.Job instance at 0x14586f381eb0>,2,20,[10  2],4,19,39,15,10
1,<environment.Job instance at 0x14586f6020f0>,10,15,[7 2],16,39,54,23,25
1,<environment.Job instance at 0x14586f602eb0>,14,16,[6 1],24,54,70,30,45
1,<environment.Job instance at 0x14586eeab820>,25,18,[2 8],39,56,74,17,56
1,<environment.Job instance at 0x14586eeab1e0>,27,18,[8 1],42,70,88,28,64
1,<environment.Job instance at 0x14586f7a2780>,36,3,[2 7],56,74,77,18,68
1,<environment.Job instance at 0x14586f7a2e10>,37,14,[1 9],58,77,91,19,68
1,<environment.Job instance at 0x14586f7a2d20>,40,12,[5 2],64,91,103,27,74
1,<environment.Job instance at 0x14586f774730>,48,3,[7 2],81,103,106,22,81
1,<environment.Job instance at 0x1458ae242af0>,51,13,[1 5],87,91,104,4,87
1,<environment.Job instance at 0x1458aec36e10>,56,18,[1 8],93,104,122,11,98
1,<environment.Job instance at 0x14586f3c8a00>,57,17,[10  2],95,122,139,27,110
1,<environment.Job instance at 0x1458aec83960>,62,13,[8 1],104,139,152,35,123
1,<environment.Job instance at 0x14586ed13500>,63,2,[2 6],105,139,141,34,123
1,<environment.Job instance at 0x14586f6300a0>,64,17,[2 7],108,141,158,33,129
1,<environment.Job instance at 0x14586f706230>,78,15,[10  1],126,295,310,169,295
1,<environment.Job instance at 0x14586f595410>,79,17,[6 1],128,310,327,182,304
1,<environment.Job instance at 0x14586f3b16e0>,87,14,[2 8],138,318,332,180,318
1,<environment.Job instance at 0x14586f080af0>,89,16,[7 1],141,327,343,186,321
1,<environment.Job instance at 0x14586ecc1690>,94,15,[7 2],148,343,358,195,329
1,<environment.Job instance at 0x14586ecc1730>,95,13,[9 1],149,358,371,209,342
1,<environment.Job instance at 0x14586ecbee60>,98,2,[8 2],153,371,373,218,344
1,<environment.Job instance at 0x14586ecbe9b0>,99,14,[2 8],154,344,358,190,344
1,<environment.Job instance at 0x14586f155230>,107,15,[7 2],166,373,388,207,359
1,<environment.Job instance at 0x1458ac40f8c0>,4,17,[6 2],6,6,23,0,6
1,<environment.Job instance at 0x14586f290b40>,11,2,[7 1],14,23,25,9,14
1,<environment.Job instance at 0x14586f290f50>,12,1,[1 6],16,16,17,0,16
1,<environment.Job instance at 0x14586f2903c0>,13,2,[6 2],17,25,27,8,17
1,<environment.Job instance at 0x14586f290c30>,14,2,[10  2],19,27,29,8,19
1,<environment.Job instance at 0x14586f290780>,15,2,[2 7],23,23,25,0,23
1,<environment.Job instance at 0x14586f290820>,16,3,[8 1],24,29,32,5,24
1,<environment.Job instance at 0x14586efc5870>,18,3,[8 2],28,32,35,4,28
1,<environment.Job instance at 0x14586efc56e0>,20,3,[2 7],31,31,34,0,31
1,<environment.Job instance at 0x14586efc5730>,24,15,[2 8],38,38,53,0,38
1,<environment.Job instance at 0x14586efc5e60>,27,12,[7 1],41,46,58,5,46
1,<environment.Job instance at 0x1458ae210690>,61,15,[ 1 10],93,2015,2030,1922,2015
1,<environment.Job instance at 0x1458b53c5960>,1,2,[1 6],2,2,4,0,2
1,<environment.Job instance at 0x14586f465a00>,6,13,[1 9],7,7,20,0,7
1,<environment.Job instance at 0x14586f464550>,15,2,[1 8],19,20,22,1,19
1,<environment.Job instance at 0x14586f4649b0>,19,2,[7 1],23,23,25,0,23
1,<environment.Job instance at 0x14586f464b90>,20,13,[8 2],24,25,38,1,24
1,<environment.Job instance at 0x14586f4499b0>,31,1,[1 7],40,40,41,0,40
1,<environment.Job instance at 0x14586f449af0>,32,13,[ 1 10],41,41,54,0,41
1,<environment.Job instance at 0x14586f449e60>,35,13,[1 5],45,54,67,9,45
1,<environment.Job instance at 0x14586f467640>,45,16,[5 1],59,152,168,93,152
1,<environment.Job instance at 0x14586f467410>,47,13,[2 5],62,152,165,90,152
1,<environment.Job instance at 0x14586f467a00>,53,12,[2 7],73,165,177,92,155
1,<environment.Job instance at 0x14586f467be0>,54,13,[7 2],74,168,181,94,166
1,<environment.Job instance at 0x14586f43e550>,62,14,[2 5],82,177,191,95,166
1,<environment.Job instance at 0x14586eceb0a0>,67,15,[9 2],90,191,206,101,177
1,<environment.Job instance at 0x14586ecf7960>,71,3,[8 2],96,181,184,85,179
1,<environment.Job instance at 0x14586ecf74b0>,74,3,[5 1],99,184,187,85,179
1,<environment.Job instance at 0x14586f61e2d0>,82,13,[1 6],113,198,211,85,198
1,<environment.Job instance at 0x14586f6135a0>,87,12,[5 2],118,206,218,88,198
1,<environment.Job instance at 0x14586f795050>,92,12,[2 8],127,2047,2059,1920,2047
1,<environment.Job instance at 0x14586f7955f0>,4,17,[8 1],6,7,24,1,7
1,<environment.Job instance at 0x14586ec05050>,6,3,[9 1],8,24,27,16,8
1,<environment.Job instance at 0x14586ec05370>,7,3,[9 1],9,27,30,18,9
1,<environment.Job instance at 0x1458aec37500>,7,3,[8 2],10,10,13,0,10
1,<environment.Job instance at 0x1458aec37e10>,15,13,[2 9],25,25,38,0,25
1,<environment.Job instance at 0x1458aec109b0>,24,23,[1 9],34,38,61,4,38
1,<environment.Job instance at 0x1458aec2e3c0>,31,2,[6 1],42,51,53,9,51
1,<environment.Job instance at 0x1458aec2bdc0>,62,16,[1 8],93,172,188,79,172
1,<environment.Job instance at 0x1458aec081e0>,64,16,[1 8],96,188,204,92,185
1,<environment.Job instance at 0x1458aec10c30>,27,17,[1 9],38,1529,1546,1491,1529
1,<environment.Job instance at 0x1458aec1a7d0>,3,3,[1 5],5,5,8,0,5
1,<environment.Job instance at 0x14586f7a0550>,5,3,[2 7],7,8,11,1,7
1,<environment.Job instance at 0x14586eebb820>,41,3,[7 1],61,459,462,398,459
1,<environment.Job instance at 0x14586ecc7140>,43,14,[7 1],65,462,476,397,459
1,<environment.Job instance at 0x14586ecc7aa0>,44,3,[ 2 10],67,476,479,409,460
1,<environment.Job instance at 0x14586ecc7730>,45,3,[6 2],68,479,482,411,460
1,<environment.Job instance at 0x1458b3dbff00>,54,3,[1 6],86,481,484,395,481
1,<environment.Job instance at 0x14586f1c5640>,58,17,[5 1],94,482,499,388,481
1,<environment.Job instance at 0x1458aed339b0>,69,2,[2 7],115,503,505,388,503
1,<environment.Job instance at 0x1458aed33910>,70,18,[5 1],118,508,526,390,508
1,<environment.Job instance at 0x1458ad3fc6e0>,77,13,[8 2],127,531,544,404,531
1,<environment.Job instance at 0x1458ad3fc910>,81,13,[6 1],131,574,587,443,574
1,<environment.Job instance at 0x1458af087280>,90,15,[10  2],144,598,613,454,598
1,<environment.Job instance at 0x1458af087d70>,95,21,[1 8],150,631,652,481,631
1,<environment.Job instance at 0x1458af087320>,103,3,[9 1],162,632,635,470,632
1,<environment.Job instance at 0x1458af087a50>,104,3,[2 6],163,652,655,489,632
1,<environment.Job instance at 0x1458af087c30>,106,12,[10  2],165,655,667,490,638
1,<environment.Job instance at 0x14586f2753c0>,111,1,[5 1],171,667,668,496,656
1,<environment.Job instance at 0x14586f275f00>,113,13,[7 1],174,668,681,494,656
1,<environment.Job instance at 0x14586f275780>,114,3,[2 8],175,667,670,492,656
1,<environment.Job instance at 0x14586f2751e0>,115,2,[5 2],177,681,683,504,656
1,<environment.Job instance at 0x1458aed7a9b0>,2,14,[1 9],4,4,18,0,4
1,<environment.Job instance at 0x1458aed7a780>,3,13,[1 9],6,18,31,12,6
1,<environment.Job instance at 0x1458aed7a5a0>,11,13,[6 2],19,31,44,12,20
1,<environment.Job instance at 0x1458ae176910>,13,19,[2 7],21,31,50,10,24
1,<environment.Job instance at 0x1458ae176a00>,17,17,[9 1],25,50,67,25,38
1,<environment.Job instance at 0x1458ae176b40>,21,16,[ 1 10],32,67,83,35,54
1,<environment.Job instance at 0x1458aec26140>,28,13,[9 1],40,83,96,43,67
1,<environment.Job instance at 0x1458aec26d20>,30,3,[7 2],46,96,99,50,73
1,<environment.Job instance at 0x1458aec262d0>,34,12,[2 9],51,99,111,48,87
1,<environment.Job instance at 0x1458aec26a00>,35,18,[7 2],53,111,129,58,100
1,<environment.Job instance at 0x1458aed45960>,43,15,[7 1],67,129,144,62,116
1,<environment.Job instance at 0x1458ae1f24b0>,56,16,[6 2],90,144,160,54,134
1,<environment.Job instance at 0x1458ae1f2050>,62,15,[5 2],98,160,175,62,152
1,<environment.Job instance at 0x14586efd4e10>,71,18,[6 1],111,175,193,64,168
1,<environment.Job instance at 0x14586efd40a0>,72,17,[7 1],112,193,210,81,181
1,<environment.Job instance at 0x14586f1db820>,79,15,[9 2],126,210,225,84,197
1,<environment.Job instance at 0x14586f7b7c80>,86,2,[10  1],136,225,227,89,225
1,<environment.Job instance at 0x14586f405230>,88,14,[7 1],138,227,241,89,225
1,<environment.Job instance at 0x14586f5288c0>,91,15,[6 2],141,241,256,100,241
1,<environment.Job instance at 0x14586f7b2550>,96,15,[8 2],149,256,271,107,252
1,<environment.Job instance at 0x1458ae15af00>,103,15,[2 8],157,269,284,112,269
1,<environment.Job instance at 0x1458b2175e10>,108,2,[9 1],165,284,286,119,269
1,<environment.Job instance at 0x1458b3e3ab40>,118,15,[1 9],179,302,317,123,302
1,<environment.Job instance at 0x14586f657eb0>,120,22,[1 5],181,317,339,136,314
1,<environment.Job instance at 0x14586f657cd0>,122,18,[8 1],188,332,350,144,332
1,<environment.Job instance at 0x1458ae176e10>,26,13,[1 6],38,367,380,329,367
1,<environment.Job instance at 0x14586f663190>,4,13,[1 7],7,7,20,0,7
1,<environment.Job instance at 0x14586f663aa0>,5,15,[5 1],10,10,25,0,10
1,<environment.Job instance at 0x14586f663a50>,8,14,[5 1],16,20,34,4,18
1,<environment.Job instance at 0x14586f663b90>,11,16,[6 1],19,34,50,15,25
1,<environment.Job instance at 0x14586f0056e0>,27,2,[6 2],42,50,52,8,46
1,<environment.Job instance at 0x14586f0058c0>,29,14,[10  1],45,52,66,7,46
1,<environment.Job instance at 0x14586f005e10>,32,18,[5 1],48,66,84,18,58
1,<environment.Job instance at 0x14586f005780>,33,14,[5 2],53,66,80,13,62
1,<environment.Job instance at 0x14586ed198c0>,37,18,[10  2],57,84,102,27,73
1,<environment.Job instance at 0x14586ed19aa0>,42,13,[10  1],67,102,115,35,86
1,<environment.Job instance at 0x14586ed19410>,45,16,[10  2],74,115,131,41,102
1,<environment.Job instance at 0x14586ed19190>,47,1,[7 2],77,131,132,54,103
1,<environment.Job instance at 0x14586f5a7280>,48,3,[2 9],78,132,135,54,106
1,<environment.Job instance at 0x14586f5a74b0>,49,2,[2 6],81,135,137,54,108
1,<environment.Job instance at 0x14586f5a7050>,50,2,[5 1],82,132,134,50,108
1,<environment.Job instance at 0x14586f5a7730>,51,18,[5 1],83,134,152,51,123
1,<environment.Job instance at 0x14586f7e3cd0>,59,3,[6 2],93,152,155,59,126
1,<environment.Job instance at 0x1458ae3767d0>,72,12,[8 2],110,155,167,45,138
1,<environment.Job instance at 0x14586f5fc0f0>,73,16,[2 5],111,140,156,29,140
1,<environment.Job instance at 0x1458ae2c3370>,78,17,[2 9],116,167,184,51,156
1,<environment.Job instance at 0x147379ea4640>,0,12,[2 5],1,2,14,1,2
1,<environment.Job instance at 0x1473723142d0>,6,18,[8 1],7,7,25,0,7
1,<environment.Job instance at 0x147370860f00>,17,17,[6 1],23,25,42,2,23
1,<environment.Job instance at 0x1473723181e0>,24,12,[ 1 10],32,42,54,10,32
1,<environment.Job instance at 0x14737230f780>,29,16,[10  2],39,54,70,15,41
1,<environment.Job instance at 0x1473703bf410>,0,2,[ 1 10],1,2,4,1,2
1,<environment.Job instance at 0x1473703bf190>,2,1,[1 7],3,4,5,1,3
1,<environment.Job instance at 0x1473703bf730>,4,15,[1 7],5,5,20,0,5
1,<environment.Job instance at 0x1473703bfb90>,6,14,[10  1],9,20,34,11,9
1,<environment.Job instance at 0x14737082fe10>,14,18,[8 1],18,34,52,16,23
1,<environment.Job instance at 0x14737082fe60>,19,16,[9 1],26,52,68,26,39
1,<environment.Job instance at 0x14737082feb0>,20,15,[9 2],30,68,83,38,54
1,<environment.Job instance at 0x14737088c2d0>,38,14,[2 8],59,83,97,24,81
1,<environment.Job instance at 0x147370898c80>,43,14,[6 1],67,87,101,20,87
1,<environment.Job instance at 0x1473708985f0>,45,16,[1 7],69,99,115,30,99
1,<environment.Job instance at 0x14737082f820>,16,17,[1 6],21,1691,1708,1670,1691
1,<environment.Job instance at 0x1473371cb780>,0,14,[1 6],2,2,16,0,2
1,<environment.Job instance at 0x14733751a140>,12,14,[1 6],19,19,33,0,19
1,<environment.Job instance at 0x14733751a960>,15,26,[9 1],24,24,50,0,24
1,<environment.Job instance at 0x1473375193c0>,21,3,[8 1],33,50,53,17,33
1,<environment.Job instance at 0x147337519f50>,24,15,[2 8],38,50,65,12,38
1,<environment.Job instance at 0x147337519550>,25,16,[2 8],39,65,81,26,52
1,<environment.Job instance at 0x147337517190>,36,16,[2 6],56,100,116,44,100
1,<environment.Job instance at 0x1473708c0640>,83,1,[7 2],118,391,392,273,391
1,<environment.Job instance at 0x147379d2b460>,0,12,[1 5],1,1,13,0,1
1,<environment.Job instance at 0x147379d2b1e0>,1,13,[7 2],2,4,17,2,4
1,<environment.Job instance at 0x1473792f95a0>,14,2,[1 6],27,27,29,0,27
1,<environment.Job instance at 0x147379332aa0>,15,3,[1 9],28,29,32,1,28
1,<environment.Job instance at 0x147379332dc0>,16,16,[2 7],31,32,48,1,31
1,<environment.Job instance at 0x14737934b640>,24,14,[2 8],43,48,62,5,43
1,<environment.Job instance at 0x14737934baa0>,26,27,[1 7],45,62,89,17,60
1,<environment.Job instance at 0x147378eb5820>,34,3,[9 2],55,62,65,7,61
1,<environment.Job instance at 0x147378eb5b90>,35,2,[2 9],57,89,91,32,68
1,<environment.Job instance at 0x14737976b230>,37,1,[5 1],63,73,74,10,73
1,<environment.Job instance at 0x147378eb50a0>,38,13,[10  1],65,91,104,26,75
1,<environment.Job instance at 0x147378eb51e0>,39,2,[1 8],67,104,106,37,77
1,<environment.Job instance at 0x147379e63eb0>,40,1,[10  2],68,106,107,38,78
1,<environment.Job instance at 0x147379e639b0>,41,3,[2 8],69,107,110,38,81
1,<environment.Job instance at 0x14737a009dc0>,42,15,[2 7],70,110,125,40,106
1,<environment.Job instance at 0x147379d397d0>,46,1,[8 1],79,108,109,29,108
1,<environment.Job instance at 0x147379d39370>,47,3,[1 9],81,125,128,44,108
1,<environment.Job instance at 0x147372ce1a50>,50,12,[7 1],86,113,125,27,113
1,<environment.Job instance at 0x14733777eaf0>,3,17,[9 1],6,6,23,0,6
1,<environment.Job instance at 0x147337093410>,9,13,[6 1],14,23,36,9,19
1,<environment.Job instance at 0x1473370dc230>,0,26,[1 6],1,2,28,1,2
1,<environment.Job instance at 0x1473370dcc80>,3,23,[9 1],6,6,29,0,6
1,<environment.Job instance at 0x147377443280>,15,2,[7 1],21,29,31,8,21
1,<environment.Job instance at 0x147377443be0>,16,3,[9 1],26,31,34,5,26
1,<environment.Job instance at 0x147377443320>,17,13,[2 5],28,34,47,6,28
1,<environment.Job instance at 0x147372fda410>,1,21,[9 2],2,2,23,0,2
1,<environment.Job instance at 0x147372fda910>,2,17,[7 2],3,23,40,20,11
1,<environment.Job instance at 0x147370b5d0a0>,15,15,[6 2],22,40,55,18,36
1,<environment.Job instance at 0x14737091f0f0>,22,1,[1 5],31,36,37,5,36
1,<environment.Job instance at 0x147372c4b820>,27,1,[ 1 10],37,55,56,18,37
1,<environment.Job instance at 0x14737216a730>,28,1,[2 7],38,38,39,0,38
1,<environment.Job instance at 0x14737216a8c0>,29,2,[2 6],39,39,41,0,39
1,<environment.Job instance at 0x14737216ae10>,30,17,[5 2],40,56,73,16,44
1,<environment.Job instance at 0x14737216a5a0>,38,15,[2 5],50,71,86,21,71
1,<environment.Job instance at 0x1473376a5960>,42,16,[8 2],55,74,90,19,74
1,<environment.Job instance at 0x147337422e60>,46,16,[7 1],61,90,106,29,84
1,<environment.Job instance at 0x147337422460>,48,14,[1 8],63,101,115,38,101
1,<environment.Job instance at 0x1473376a7be0>,57,17,[8 1],77,106,123,29,104
1,<environment.Job instance at 0x14733706fe60>,63,12,[ 1 10],83,123,135,40,119
1,<environment.Job instance at 0x147336e85140>,67,15,[8 1],89,135,150,46,121
1,<environment.Job instance at 0x1473376bb050>,70,14,[2 9],97,135,149,38,129
1,<environment.Job instance at 0x147337624a00>,81,17,[1 5],112,149,166,37,143
1,<environment.Job instance at 0x147336efacd0>,90,3,[10  1],128,166,169,38,155
1,<environment.Job instance at 0x147370925460>,0,14,[5 2],4,4,18,0,4
1,<environment.Job instance at 0x147370917050>,5,21,[10  2],12,18,39,6,12
1,<environment.Job instance at 0x147336ee7410>,15,12,[5 2],29,39,51,10,32
1,<environment.Job instance at 0x14737091cdc0>,18,3,[5 1],33,39,42,6,33
1,<environment.Job instance at 0x147372fc79b0>,25,2,[1 6],46,49,51,3,49
1,<environment.Job instance at 0x147336f6f5a0>,30,3,[6 2],56,56,59,0,56
1,<environment.Job instance at 0x147336f6f820>,31,12,[2 9],57,59,71,2,57
1,<environment.Job instance at 0x1473374255a0>,35,17,[6 2],62,71,88,9,62
1,<environment.Job instance at 0x147372127c80>,50,14,[ 2 10],80,88,102,8,81
1,<environment.Job instance at 0x147337426fa0>,64,16,[ 2 10],103,338,354,235,338
1,<environment.Job instance at 0x1473703dc0f0>,0,16,[5 1],1,2,18,1,2
1,<environment.Job instance at 0x1473703dcb40>,3,15,[5 1],6,7,22,1,7
1,<environment.Job instance at 0x147336dddfa0>,6,18,[8 2],9,22,40,13,11
1,<environment.Job instance at 0x147336de1640>,12,2,[2 6],15,18,20,3,18
1,<environment.Job instance at 0x147336de1820>,5,13,[2 5],7,7,20,0,7
1,<environment.Job instance at 0x147336c6d0a0>,7,16,[6 1],10,10,26,0,10
1,<environment.Job instance at 0x147336c309b0>,15,1,[5 2],22,26,27,4,22
1,<environment.Job instance at 0x147336c6f5f0>,3,1,[8 1],4,27,28,23,23
1,<environment.Job instance at 0x147336c74370>,18,17,[1 5],26,28,45,2,28
1,<environment.Job instance at 0x147336f21c30>,27,18,[10  1],35,45,63,10,35
1,<environment.Job instance at 0x147377d8bbe0>,41,16,[8 1],54,82,98,28,82
1,<environment.Job instance at 0x147377d8bf00>,43,15,[8 2],56,98,113,42,84
1,<environment.Job instance at 0x147377d8ba00>,51,16,[1 6],66,110,126,44,110
1,<environment.Job instance at 0x147377d8b5a0>,53,14,[10  1],69,126,140,57,111
1,<environment.Job instance at 0x147336f2bbe0>,59,12,[7 2],77,113,125,36,112
1,<environment.Job instance at 0x147336f2bc80>,62,13,[ 2 10],82,140,153,58,125
1,<environment.Job instance at 0x147336e29f00>,66,18,[10  1],86,153,171,67,142
1,<environment.Job instance at 0x147336e155f0>,75,14,[9 2],99,171,185,72,156
1,<environment.Job instance at 0x147336e15dc0>,76,16,[8 2],101,185,201,84,172
1,<environment.Job instance at 0x147336e15730>,79,13,[8 1],105,201,214,96,185
1,<environment.Job instance at 0x147372193410>,0,26,[5 2],2,2,28,0,2
1,<environment.Job instance at 0x14733742a280>,3,14,[10  2],6,28,42,22,13
1,<environment.Job instance at 0x1473773810f0>,17,12,[5 1],28,42,54,14,33
1,<environment.Job instance at 0x147379324320>,25,18,[2 9],41,42,60,1,41
1,<environment.Job instance at 0x147370b61fa0>,26,13,[2 8],43,60,73,17,45
1,<environment.Job instance at 0x1473721a0be0>,31,18,[7 2],50,60,78,10,52
1,<environment.Job instance at 0x147337045a50>,38,13,[6 1],58,78,91,20,77
1,<environment.Job instance at 0x1473373d71e0>,45,14,[2 8],68,82,96,14,82
1,<environment.Job instance at 0x147372f6e910>,47,17,[7 2],71,91,108,20,82
1,<environment.Job instance at 0x1473372997d0>,48,13,[8 1],74,108,121,34,92
1,<environment.Job instance at 0x147372213aa0>,61,17,[ 1 10],95,121,138,26,118
1,<environment.Job instance at 0x1473773783c0>,72,18,[10  2],112,138,156,26,127
1,<environment.Job instance at 0x147377378b40>,76,12,[5 2],117,156,168,39,146
1,<environment.Job instance at 0x1473371f36e0>,83,15,[7 1],127,168,183,41,154
1,<environment.Job instance at 0x1473377f2870>,94,17,[1 9],151,176,193,25,176
1,<environment.Job instance at 0x1473374c0780>,103,18,[2 8],168,193,211,25,190
1,<environment.Job instance at 0x1473374c0c30>,104,13,[7 2],171,201,214,30,201
1,<environment.Job instance at 0x147377e4b140>,112,16,[5 2],185,214,230,29,209
1,<environment.Job instance at 0x147377e4b910>,118,18,[8 2],192,230,248,38,225
1,<environment.Job instance at 0x14733742a460>,6,18,[1 6],11,1755,1773,1744,1755
1,<environment.Job instance at 0x1473720c9910>,0,3,[2 5],4,4,7,0,4
1,<environment.Job instance at 0x14733742a190>,1,2,[2 5],6,6,8,0,6
1,<environment.Job instance at 0x147372cddb40>,3,18,[7 2],9,9,27,0,9
1,<environment.Job instance at 0x147372ce9be0>,17,14,[8 2],25,27,41,2,25
1,<environment.Job instance at 0x147372cb0e60>,68,3,[2 7],95,2168,2171,2073,2168
1,<environment.Job instance at 0x1473722bfb90>,4,17,[6 1],8,8,25,0,8
1,<environment.Job instance at 0x1473722bf320>,6,15,[5 2],10,25,40,15,11
1,<environment.Job instance at 0x1473722bfd20>,11,12,[5 2],16,25,37,9,16
1,<environment.Job instance at 0x1473722bb0a0>,18,15,[2 9],27,40,55,13,31
1,<environment.Job instance at 0x147336e0ddc0>,24,14,[2 8],34,55,69,21,40
1,<environment.Job instance at 0x1473708365f0>,37,15,[2 8],52,69,84,17,65
1,<environment.Job instance at 0x147370836af0>,42,2,[6 2],61,73,75,12,73
1,<environment.Job instance at 0x147377d7bd20>,44,3,[2 8],66,84,87,18,75
1,<environment.Job instance at 0x147377d7b1e0>,46,3,[2 6],68,87,90,19,75
1,<environment.Job instance at 0x147377d7b690>,47,2,[5 2],69,80,82,11,80
1,<environment.Job instance at 0x147377d7b550>,48,2,[ 2 10],72,90,92,18,81
1,<environment.Job instance at 0x147377d7b870>,50,1,[2 5],74,92,93,18,81
1,<environment.Job instance at 0x147377d7bfa0>,51,2,[5 1],75,82,84,7,81
1,<environment.Job instance at 0x147377d62960>,52,17,[6 2],76,92,109,16,81
1,<environment.Job instance at 0x147377d62e10>,53,1,[9 1],77,109,110,32,81
1,<environment.Job instance at 0x147378edef50>,54,12,[1 7],79,93,105,14,81
1,<environment.Job instance at 0x14737220f050>,55,1,[7 1],80,84,85,4,81
1,<environment.Job instance at 0x14737220f8c0>,56,2,[2 7],81,105,107,24,81
1,<environment.Job instance at 0x14737610d140>,59,2,[7 1],84,85,87,1,84
1,<environment.Job instance at 0x147370849410>,60,1,[1 6],86,107,108,21,86
1,<environment.Job instance at 0x1473721480a0>,61,2,[6 2],87,87,89,0,87
1,<environment.Job instance at 0x147336c74b40>,62,2,[10  2],89,110,112,21,89
1,<environment.Job instance at 0x1473722baf50>,74,12,[8 1],110,112,124,2,110
1,<environment.Job instance at 0x1473722ba0a0>,75,12,[7 1],111,124,136,13,116
1,<environment.Job instance at 0x14733776e280>,108,16,[9 2],162,465,481,303,465
1,<environment.Job instance at 0x147336fe5690>,119,2,[2 9],176,487,489,311,487
1,<environment.Job instance at 0x147336fe5e10>,120,3,[9 1],177,489,492,312,487
1,<environment.Job instance at 0x147336fe5c30>,121,17,[2 6],178,492,509,314,488
1,<environment.Job instance at 0x147337603820>,0,17,[2 5],3,4,21,1,4
1,<environment.Job instance at 0x147337603be0>,5,16,[10  2],10,21,37,11,10
1,<environment.Job instance at 0x14737734e8c0>,13,16,[10  1],20,37,53,17,24
1,<environment.Job instance at 0x147372cb7af0>,19,14,[1 5],26,53,67,27,47
1,<environment.Job instance at 0x147372cb76e0>,28,2,[9 2],37,53,55,16,51
1,<environment.Job instance at 0x147372cb74b0>,29,2,[7 1],38,55,57,17,51
1,<environment.Job instance at 0x147372cb7190>,30,1,[1 6],39,67,68,28,51
1,<environment.Job instance at 0x147372cb7870>,31,27,[2 7],40,68,95,28,66
1,<environment.Job instance at 0x14733728bb90>,37,16,[2 7],50,266,282,216,266
1,<environment.Job instance at 0x147372cf9190>,73,3,[10  2],99,282,285,183,267
1,<environment.Job instance at 0x147372cf9fa0>,75,13,[ 1 10],101,285,298,184,269
1,<environment.Job instance at 0x147370607230>,88,16,[5 1],119,298,314,179,286
1,<environment.Job instance at 0x147372ce17d0>,92,3,[1 7],125,298,301,173,286
1,<environment.Job instance at 0x147372cf97d0>,94,3,[9 2],128,314,317,186,288
1,<environment.Job instance at 0x1473375e8e60>,95,13,[2 5],132,301,314,169,288
1,<environment.Job instance at 0x147372cf9870>,96,12,[2 7],133,317,329,184,310
1,<environment.Job instance at 0x147377368dc0>,113,16,[8 1],155,319,335,164,319
1,<environment.Job instance at 0x147336ec65f0>,121,13,[9 2],168,335,348,167,333
1,<environment.Job instance at 0x1473371cf4b0>,123,18,[2 6],171,348,366,177,344
1,<environment.Job instance at 0x14733729be10>,1,3,[2 5],4,4,7,0,4
1,<environment.Job instance at 0x14733739b2d0>,7,2,[7 2],12,12,14,0,12
1,<environment.Job instance at 0x14733739b4b0>,11,16,[1 8],17,21,37,4,21
1,<environment.Job instance at 0x14733739b0a0>,12,3,[5 1],19,21,24,2,21
1,<environment.Job instance at 0x14733739b910>,14,1,[5 2],22,24,25,2,22
1,<environment.Job instance at 0x14733739ba50>,15,3,[6 2],23,25,28,2,23
1,<environment.Job instance at 0x14733739bb90>,16,18,[1 7],24,37,55,13,27
1,<environment.Job instance at 0x14733739bfa0>,19,1,[8 1],28,28,29,0,28
1,<environment.Job instance at 0x1473373988c0>,26,3,[1 6],37,55,58,18,37
1,<environment.Job instance at 0x147337398a50>,27,1,[7 1],38,38,39,0,38
1,<environment.Job instance at 0x147337398b90>,28,13,[7 1],39,39,52,0,39
1,<environment.Job instance at 0x147337398dc0>,30,14,[10  2],42,58,72,16,43
1,<environment.Job instance at 0x1473373b5af0>,41,18,[8 2],53,72,90,19,67
1,<environment.Job instance at 0x1473373b5b40>,43,17,[8 1],56,90,107,34,78
1,<environment.Job instance at 0x14733739b460>,1,2,[8 2],2,3,5,1,3
1,<environment.Job instance at 0x1473375864b0>,6,1,[1 7],9,12,13,3,12
1,<environment.Job instance at 0x1473375819b0>,10,16,[1 5],17,17,33,0,17
1,<environment.Job instance at 0x14733759dc30>,15,3,[5 1],25,25,28,0,25
1,<environment.Job instance at 0x147336e4ba00>,1,2,[8 1],3,5,7,2,5
1,<environment.Job instance at 0x147336fe4a50>,5,15,[2 6],8,8,23,0,8
1,<environment.Job instance at 0x147336fe48c0>,6,3,[7 2],10,10,13,0,10
1,<environment.Job instance at 0x147336fe0410>,17,2,[7 2],32,54,56,22,54
1,<environment.Job instance at 0x147336fe04b0>,19,3,[1 5],35,54,57,19,54
1,<environment.Job instance at 0x147336fe0500>,20,2,[6 2],36,56,58,20,54
1,<environment.Job instance at 0x147336fe05a0>,21,3,[2 7],37,57,60,20,54
1,<environment.Job instance at 0x147336fe4f50>,13,12,[1 6],24,454,466,430,454
1,<environment.Job instance at 0x147336fcd140>,77,16,[2 6],131,2746,2762,2615,2746
1,<environment.Job instance at 0x147336fd6780>,3,3,[2 8],5,5,8,0,5
1,<environment.Job instance at 0x14737213b640>,13,13,[8 2],18,19,32,1,19
1,<environment.Job instance at 0x14737211fe10>,17,18,[6 2],23,32,50,9,26
1,<environment.Job instance at 0x147372ffc500>,19,13,[1 9],26,50,63,24,38
1,<environment.Job instance at 0x147337796be0>,25,3,[5 2],37,63,66,26,46
1,<environment.Job instance at 0x147372cf9780>,26,2,[ 1 10],38,66,68,28,47
1,<environment.Job instance at 0x1473376c3820>,27,13,[6 2],39,68,81,29,52
1,<environment.Job instance at 0x147377421e60>,29,19,[2 7],41,68,87,27,58
1,<environment.Job instance at 0x147337299320>,30,2,[1 6],42,63,65,21,59
1,<environment.Job instance at 0x1473370f0a00>,33,17,[9 1],45,87,104,42,75
1,<environment.Job instance at 0x147372188b40>,35,2,[10  2],48,104,106,56,88
1,<environment.Job instance at 0x14737428f320>,36,3,[10  1],51,106,109,55,88
1,<environment.Job instance at 0x1473376856e0>,37,16,[ 1 10],52,109,125,57,96
1,<environment.Job instance at 0x147372250c80>,38,2,[2 5],53,125,127,72,98
1,<environment.Job instance at 0x1473376202d0>,41,1,[8 1],57,125,126,68,98
1,<environment.Job instance at 0x1473721e2af0>,42,13,[1 6],58,127,140,69,111
1,<environment.Job instance at 0x147337425190>,44,13,[9 1],60,127,140,67,121
1,<environment.Job instance at 0x1473374256e0>,45,17,[2 8],65,140,157,75,131
1,<environment.Job instance at 0x147337425870>,50,12,[2 9],71,157,169,86,140
1,<environment.Job instance at 0x147337425d70>,51,18,[7 2],73,169,187,96,158
1,<environment.Job instance at 0x147379325dc0>,59,15,[7 1],87,187,202,100,173
1,<environment.Job instance at 0x14737216a190>,72,16,[6 2],110,202,218,92,194
1,<environment.Job instance at 0x14737216af00>,80,3,[10  2],120,218,221,98,196
1,<environment.Job instance at 0x14737216a320>,81,1,[8 2],121,221,222,100,196
1,<environment.Job instance at 0x14737216afa0>,83,3,[ 2 10],124,222,225,98,197
1,<environment.Job instance at 0x14737216a230>,86,1,[2 9],130,199,200,69,199
1,<environment.Job instance at 0x14737216ae60>,87,18,[6 1],131,225,243,94,214
1,<environment.Job instance at 0x147336e5f910>,88,17,[7 1],132,243,260,111,234
1,<environment.Job instance at 0x147336e5f1e0>,95,15,[9 2],146,260,275,114,246
1,<environment.Job instance at 0x147336e5fd70>,100,18,[1 8],152,246,264,94,246
1,<environment.Job instance at 0x147370608320>,116,3,[1 9],174,275,278,101,271
1,<environment.Job instance at 0x147370608be0>,119,15,[2 8],177,278,293,101,272
1,<environment.Job instance at 0x147336fc0870>,1,2,[2 6],3,3,5,0,3
1,<environment.Job instance at 0x147336fc0e10>,2,18,[8 1],8,8,26,0,8
1,<environment.Job instance at 0x147336fc0a00>,9,15,[5 1],20,26,41,6,21
1,<environment.Job instance at 0x147336ddd280>,12,14,[5 1],26,34,48,8,34
1,<environment.Job instance at 0x14733752bdc0>,52,3,[2 9],88,218,221,130,218
1,<environment.Job instance at 0x14733752baa0>,53,2,[2 6],91,221,223,130,218
1,<environment.Job instance at 0x1473376032d0>,55,18,[5 1],93,218,236,125,218
1,<environment.Job instance at 0x147337603cd0>,56,3,[9 2],95,236,239,141,218
1,<environment.Job instance at 0x1473376035a0>,57,12,[2 7],96,223,235,127,218
1,<environment.Job instance at 0x147337603b90>,60,3,[1 9],99,239,242,140,218
1,<environment.Job instance at 0x14737737c730>,76,12,[8 2],120,242,254,122,229
1,<environment.Job instance at 0x147336e14370>,80,14,[2 7],124,242,256,118,241
1,<environment.Job instance at 0x147336e14410>,86,13,[2 5],132,256,269,124,245
1,<environment.Job instance at 0x1473720e65a0>,102,14,[1 8],153,313,327,160,313
1,<environment.Job instance at 0x147336e55370>,106,3,[5 2],159,313,316,154,313
1,<environment.Job instance at 0x1473372a4500>,108,12,[2 7],161,327,339,166,313
1,<environment.Job instance at 0x147336ce5f00>,119,3,[5 1],178,344,347,166,344
1,<environment.Job instance at 0x147336ce5500>,120,1,[1 6],179,344,345,165,344
1,<environment.Job instance at 0x147336ce5050>,121,16,[1 8],180,345,361,165,344
1,<environment.Job instance at 0x147372199550>,0,13,[10  2],1,1,14,0,1
1,<environment.Job instance at 0x147370606640>,13,16,[2 8],16,16,32,0,16
1,<environment.Job instance at 0x14733772abe0>,17,18,[1 8],20,32,50,12,30
1,<environment.Job instance at 0x147336cc1c30>,31,3,[7 1],40,42,45,2,42
1,<environment.Job instance at 0x147336cc1e60>,34,28,[2 6],43,50,78,7,49
